t_id, iteration_count, request_count, request_start_time, request_end_time, request_processing_time
2,269,1,3578692074,3578692113,39
2,272,2,3578692226,3578692265,39
2,273,3,3578692277,3578692313,36
2,276,4,3578692429,3578692466,37
2,277,5,3578692479,3578692511,32
2,277,6,3578692479,3578692517,38
2,279,7,3578692580,3578692618,38
2,280,8,3578692631,3578692664,33
2,281,9,3578692682,3578692712,30
2,281,10,3578692682,3578692718,36
2,283,11,3578692783,3578692819,36
2,283,12,3578692783,3578692822,39
2,284,13,3578692834,3578692864,30
2,285,14,3578692885,3578692912,27
2,285,15,3578692885,3578692918,33
2,287,16,3578692986,3578693020,34
2,287,17,3578692986,3578693022,36
2,288,18,3578693036,3578693064,28
2,289,19,3578693087,3578693112,25
2,289,20,3578693087,3578693118,31
2,291,21,3578693188,3578693219,31
2,291,22,3578693188,3578693222,34
2,292,23,3578693239,3578693264,25
2,292,24,3578693239,3578693278,39
2,293,25,3578693290,3578693312,22
2,293,26,3578693290,3578693318,28
2,293,27,3578693290,3578693329,39
2,295,28,3578693391,3578693419,28
2,295,29,3578693391,3578693421,30
2,296,30,3578693442,3578693464,22
2,296,31,3578693442,3578693478,36
2,296,32,3578693442,3578693480,38
2,297,33,3578693492,3578693510,18
2,297,34,3578693492,3578693517,25
2,297,35,3578693492,3578693527,35
2,299,36,3578693593,3578693618,25
2,299,37,3578693593,3578693621,28
2,300,38,3578693644,3578693664,20
2,300,39,3578693644,3578693677,33
2,300,40,3578693644,3578693680,36
2,300,41,3578693644,3578693682,38
2,301,42,3578693695,3578693711,16
2,301,43,3578693695,3578693717,22
2,301,44,3578693695,3578693728,33
2,301,45,3578693695,3578693734,39
2,303,46,3578693797,3578693819,22
2,303,47,3578693797,3578693821,24
2,304,48,3578693848,3578693863,15
2,304,49,3578693848,3578693878,30
2,304,50,3578693848,3578693880,32
2,304,51,3578693848,3578693883,35
2,305,52,3578693898,3578693912,14
2,305,53,3578693898,3578693917,19
2,305,54,3578693898,3578693929,31
2,305,55,3578693898,3578693935,37
2,305,56,3578693898,3578693937,39
2,307,57,3578694000,3578694020,20
2,307,58,3578694000,3578694021,21
2,307,59,3578694000,3578694038,38
2,308,60,3578694051,3578694063,12
2,308,61,3578694051,3578694078,27
2,308,62,3578694051,3578694080,29
2,308,63,3578694051,3578694083,32
2,309,64,3578694101,3578694111,10
2,309,65,3578694101,3578694116,15
2,309,66,3578694101,3578694129,28
2,309,67,3578694101,3578694134,33
2,309,68,3578694101,3578694137,36
2,311,69,3578694202,3578694219,17
2,311,70,3578694202,3578694220,18
2,311,71,3578694202,3578694238,36
2,312,72,3578694253,3578694263,10
2,312,73,3578694253,3578694278,25
2,312,74,3578694253,3578694281,28
2,312,75,3578694253,3578694283,30
2,312,76,3578694253,3578694291,38
2,313,77,3578694304,3578694312,8
2,313,78,3578694304,3578694317,13
2,313,79,3578694304,3578694329,25
2,313,80,3578694304,3578694335,31
2,313,81,3578694304,3578694337,33
2,315,82,3578694405,3578694419,14
2,315,83,3578694405,3578694420,15
2,315,84,3578694405,3578694437,32
2,316,85,3578694456,3578694463,7
2,316,86,3578694456,3578694478,22
2,316,87,3578694456,3578694482,26
2,316,88,3578694456,3578694483,27
2,316,89,3578694456,3578694491,35
2,317,90,3578694507,3578694511,4
2,317,91,3578694507,3578694516,9
2,317,92,3578694507,3578694529,22
2,317,93,3578694507,3578694534,27
2,317,94,3578694507,3578694537,30
2,319,95,3578694609,3578694619,10
2,319,96,3578694609,3578694620,11
2,319,97,3578694609,3578694637,28
2,320,98,3578694659,3578694663,4
2,320,99,3578694659,3578694678,19
2,320,100,3578694659,3578694681,22
2,320,101,3578694659,3578694682,23
2,320,102,3578694659,3578694690,31
2,321,103,3578694710,3578694711,1
2,321,104,3578694710,3578694716,6
2,321,105,3578694710,3578694729,19
2,321,106,3578694710,3578694733,23
2,321,107,3578694710,3578694736,26
2,322,108,3578694761,3578694797,36
2,323,109,3578694812,3578694819,7
2,323,110,3578694812,3578694820,8
2,323,111,3578694812,3578694836,24
2,323,112,3578694812,3578694849,37
2,324,113,3578694863,3578694863,0
2,324,114,3578694863,3578694878,15
2,324,115,3578694863,3578694882,19
2,324,116,3578694863,3578694883,20
2,324,117,3578694863,3578694891,28
2,324,118,3578694863,3578694912,49
2,325,119,3578694914,3578694916,2
2,325,120,3578694914,3578694929,15
2,325,121,3578694914,3578694934,20
2,325,122,3578694914,3578694936,22
2,326,123,3578694965,3578694997,32
2,327,124,3578695016,3578695019,3
2,327,125,3578695016,3578695020,4
2,327,126,3578695016,3578695037,21
2,327,127,3578695016,3578695049,33
2,327,128,3578695016,3578695063,47
2,328,129,3578695067,3578695078,11
2,328,130,3578695067,3578695082,15
2,328,131,3578695067,3578695083,16
2,328,132,3578695067,3578695091,24
2,328,133,3578695067,3578695111,44
2,328,134,3578695067,3578695116,49
2,329,135,3578695117,3578695128,11
2,329,136,3578695117,3578695133,16
2,329,137,3578695117,3578695136,19
2,330,138,3578695168,3578695197,29
2,331,139,3578695219,3578695219,0
2,331,140,3578695219,3578695221,2
2,331,141,3578695219,3578695236,17
2,331,142,3578695219,3578695249,30
2,331,143,3578695219,3578695264,45
2,332,144,3578695270,3578695278,8
2,332,145,3578695270,3578695282,12
2,332,146,3578695270,3578695283,13
2,332,147,3578695270,3578695291,21
2,332,148,3578695270,3578695312,42
2,332,149,3578695270,3578695317,47
2,333,150,3578695321,3578695329,8
2,333,151,3578695321,3578695334,13
2,333,152,3578695321,3578695337,16
2,334,153,3578695372,3578695397,25
2,334,154,3578695372,3578695419,47
2,334,155,3578695372,3578695421,49
2,335,156,3578695423,3578695437,14
2,335,157,3578695423,3578695449,26
2,335,158,3578695423,3578695464,41
2,336,159,3578695474,3578695477,3
2,336,160,3578695474,3578695481,7
2,336,161,3578695474,3578695482,8
2,336,162,3578695474,3578695490,16
2,336,163,3578695474,3578695511,37
2,336,164,3578695474,3578695516,42
2,337,165,3578695525,3578695528,3
2,337,166,3578695525,3578695534,9
2,337,167,3578695525,3578695536,11
2,338,168,3578695576,3578695596,20
2,338,169,3578695576,3578695620,44
2,338,170,3578695576,3578695620,44
2,339,171,3578695627,3578695636,9
2,339,172,3578695627,3578695648,21
2,339,173,3578695627,3578695663,36
2,339,174,3578695627,3578695677,50
2,340,175,3578695678,3578695681,3
2,340,176,3578695678,3578695681,3
2,340,177,3578695678,3578695689,11
2,340,178,3578695678,3578695709,31
2,340,179,3578695678,3578695711,33
2,340,180,3578695678,3578695716,38
2,340,181,3578695678,3578695728,50
2,341,182,3578695728,3578695734,6
2,341,183,3578695728,3578695736,8
2,342,184,3578695779,3578695796,17
2,342,185,3578695779,3578695811,32
2,342,186,3578695779,3578695820,41
2,342,187,3578695779,3578695820,41
2,343,188,3578695830,3578695836,6
2,343,189,3578695830,3578695848,18
2,343,190,3578695830,3578695863,33
2,343,191,3578695830,3578695877,47
2,344,192,3578695881,3578695882,1
2,344,193,3578695881,3578695882,1
2,344,194,3578695881,3578695890,9
2,344,195,3578695881,3578695909,28
2,344,196,3578695881,3578695912,31
2,344,197,3578695881,3578695916,35
2,344,198,3578695881,3578695928,47
2,345,199,3578695931,3578695934,3
2,345,200,3578695931,3578695936,5
2,346,201,3578695982,3578695996,14
2,346,202,3578695982,3578696010,28
2,346,203,3578695982,3578696020,38
2,346,204,3578695982,3578696020,38
2,347,205,3578696033,3578696037,4
2,347,206,3578696033,3578696048,15
2,347,207,3578696033,3578696063,30
2,347,208,3578696033,3578696078,45
2,347,209,3578696033,3578696082,49
2,347,210,3578696033,3578696082,49
2,348,211,3578696083,3578696090,7
2,348,212,3578696083,3578696109,26
2,348,213,3578696083,3578696111,28
2,348,214,3578696083,3578696114,31
2,348,215,3578696083,3578696115,32
2,348,216,3578696083,3578696127,44
2,349,217,3578696134,3578696135,1
2,349,218,3578696134,3578696136,2
2,350,219,3578696185,3578696196,11
2,350,220,3578696185,3578696211,26
2,350,221,3578696185,3578696221,36
2,350,222,3578696185,3578696221,36
2,351,223,3578696236,3578696236,0
2,351,224,3578696236,3578696248,12
2,351,225,3578696236,3578696264,28
2,351,226,3578696236,3578696277,41
2,351,227,3578696236,3578696281,45
2,351,228,3578696236,3578696281,45
2,352,229,3578696287,3578696290,3
2,352,230,3578696287,3578696309,22
2,352,231,3578696287,3578696311,24
2,352,232,3578696287,3578696315,28
2,352,233,3578696287,3578696317,30
2,352,234,3578696287,3578696327,40
2,352,235,3578696287,3578696334,47
2,352,236,3578696287,3578696336,49
2,353,237,3578696338,3578696368,30
2,354,238,3578696389,3578696397,8
2,354,239,3578696389,3578696411,22
2,354,240,3578696389,3578696421,32
2,354,241,3578696389,3578696421,32
2,354,242,3578696389,3578696437,48
2,355,243,3578696440,3578696449,9
2,355,244,3578696440,3578696463,23
2,355,245,3578696440,3578696468,28
2,355,246,3578696440,3578696477,37
2,355,247,3578696440,3578696481,41
2,355,248,3578696440,3578696482,42
2,355,249,3578696440,3578696490,50
2,356,250,3578696491,3578696508,17
2,356,251,3578696491,3578696511,20
2,356,252,3578696491,3578696515,24
2,356,253,3578696491,3578696516,25
2,356,254,3578696491,3578696527,36
2,356,255,3578696491,3578696533,42
2,356,256,3578696491,3578696535,44
2,357,257,3578696542,3578696567,25
2,358,258,3578696593,3578696596,3
2,358,259,3578696593,3578696609,16
2,358,260,3578696593,3578696619,26
2,358,261,3578696593,3578696619,26
2,358,262,3578696593,3578696636,43
2,359,263,3578696644,3578696648,4
2,359,264,3578696644,3578696662,18
2,359,265,3578696644,3578696668,24
2,359,266,3578696644,3578696678,34
2,359,267,3578696644,3578696681,37
2,359,268,3578696644,3578696683,39
2,359,269,3578696644,3578696691,47
2,360,270,3578696695,3578696708,13
2,360,271,3578696695,3578696712,17
2,360,272,3578696695,3578696715,20
2,360,273,3578696695,3578696716,21
2,360,274,3578696695,3578696727,32
2,360,275,3578696695,3578696734,39
2,360,276,3578696695,3578696735,40
2,361,277,3578696746,3578696766,20
2,361,278,3578696746,3578696796,50
2,362,279,3578696797,3578696810,13
2,362,280,3578696797,3578696819,22
2,362,281,3578696797,3578696820,23
2,362,282,3578696797,3578696836,39
2,363,283,3578696848,3578696848,0
2,363,284,3578696848,3578696862,14
2,363,285,3578696848,3578696868,20
2,363,286,3578696848,3578696878,30
2,363,287,3578696848,3578696881,33
2,363,288,3578696848,3578696883,35
2,363,289,3578696848,3578696891,43
2,364,290,3578696899,3578696908,9
2,364,291,3578696899,3578696912,13
2,364,292,3578696899,3578696915,16
2,364,293,3578696899,3578696916,17
2,364,294,3578696899,3578696927,28
2,364,295,3578696899,3578696935,36
2,364,296,3578696899,3578696935,36
2,365,297,3578696950,3578696966,16
2,365,298,3578696950,3578696995,45
2,366,299,3578697001,3578697009,8
2,366,300,3578697001,3578697020,19
2,366,301,3578697001,3578697020,19
2,366,302,3578697001,3578697037,36
2,366,303,3578697001,3578697048,47
2,367,304,3578697052,3578697063,11
2,367,305,3578697052,3578697067,15
2,367,306,3578697052,3578697077,25
2,367,307,3578697052,3578697078,26
2,367,308,3578697052,3578697082,30
2,367,309,3578697052,3578697083,31
2,367,310,3578697052,3578697091,39
2,368,311,3578697103,3578697108,5
2,368,312,3578697103,3578697112,9
2,368,313,3578697103,3578697114,11
2,368,314,3578697103,3578697116,13
2,368,315,3578697103,3578697128,25
2,368,316,3578697103,3578697135,32
2,368,317,3578697103,3578697136,33
2,369,318,3578697154,3578697166,12
2,369,319,3578697154,3578697177,23
2,370,320,3578697205,3578697209,4
2,370,321,3578697205,3578697220,15
2,370,322,3578697205,3578697221,16
2,370,323,3578697205,3578697228,23
2,370,324,3578697205,3578697237,32
2,370,325,3578697205,3578697248,43
2,371,326,3578697256,3578697263,7
2,371,327,3578697256,3578697268,12
2,371,328,3578697256,3578697276,20
2,371,329,3578697256,3578697278,22
2,371,330,3578697256,3578697282,26
2,371,331,3578697256,3578697283,27
2,371,332,3578697256,3578697290,34
2,372,333,3578697307,3578697308,1
2,372,334,3578697307,3578697312,5
2,372,335,3578697307,3578697315,8
2,372,336,3578697307,3578697317,10
2,372,337,3578697307,3578697328,21
2,372,338,3578697307,3578697335,28
2,372,339,3578697307,3578697336,29
2,373,340,3578697358,3578697366,8
2,373,341,3578697358,3578697377,19
2,374,342,3578697409,3578697410,1
2,374,343,3578697409,3578697420,11
2,374,344,3578697409,3578697421,12
2,374,345,3578697409,3578697428,19
2,374,346,3578697409,3578697431,22
2,374,347,3578697409,3578697437,28
2,374,348,3578697409,3578697448,39
2,375,349,3578697460,3578697463,3
2,375,350,3578697460,3578697468,8
2,375,351,3578697460,3578697476,16
2,375,352,3578697460,3578697478,18
2,375,353,3578697460,3578697481,21
2,375,354,3578697460,3578697483,23
2,375,355,3578697460,3578697491,31
2,375,356,3578697460,3578697508,48
2,376,357,3578697511,3578697511,0
2,376,358,3578697511,3578697513,2
2,376,359,3578697511,3578697516,5
2,376,360,3578697511,3578697527,16
2,376,361,3578697511,3578697534,23
2,376,362,3578697511,3578697535,24
2,377,363,3578697561,3578697566,5
2,377,364,3578697561,3578697576,15
2,377,365,3578697561,3578697581,20
2,377,366,3578697561,3578697609,48
2,378,367,3578697613,3578697620,7
2,378,368,3578697613,3578697620,7
2,378,369,3578697613,3578697628,15
2,378,370,3578697613,3578697629,16
2,378,371,3578697613,3578697635,22
2,378,372,3578697613,3578697647,34
2,378,373,3578697613,3578697663,50
2,379,374,3578697664,3578697668,4
2,379,375,3578697664,3578697676,12
2,379,376,3578697664,3578697678,14
2,379,377,3578697664,3578697682,18
2,379,378,3578697664,3578697684,20
2,379,379,3578697664,3578697691,27
2,379,380,3578697664,3578697708,44
2,379,381,3578697664,3578697711,47
2,379,382,3578697664,3578697714,50
2,380,383,3578697715,3578697716,1
2,380,384,3578697715,3578697727,12
2,380,385,3578697715,3578697734,19
2,380,386,3578697715,3578697735,20
2,381,387,3578697766,3578697766,0
2,381,388,3578697766,3578697777,11
2,381,389,3578697766,3578697782,16
2,381,390,3578697766,3578697795,29
2,381,391,3578697766,3578697809,43
2,382,392,3578697817,3578697820,3
2,382,393,3578697817,3578697821,4
2,382,394,3578697817,3578697827,10
2,382,395,3578697817,3578697830,13
2,382,396,3578697817,3578697836,19
2,382,397,3578697817,3578697847,30
2,382,398,3578697817,3578697863,46
2,383,399,3578697868,3578697868,0
2,383,400,3578697868,3578697876,8
2,383,401,3578697868,3578697877,9
2,383,402,3578697868,3578697882,14
2,383,403,3578697868,3578697884,16
2,383,404,3578697868,3578697891,23
2,383,405,3578697868,3578697908,40
2,383,406,3578697868,3578697912,44
2,383,407,3578697868,3578697913,45
2,383,408,3578697868,3578697916,48
2,384,409,3578697919,3578697927,8
2,384,410,3578697919,3578697934,15
2,384,411,3578697919,3578697935,16
2,384,412,3578697919,3578697966,47
2,385,413,3578697970,3578697976,6
2,385,414,3578697970,3578697982,12
2,385,415,3578697970,3578697995,25
2,385,416,3578697970,3578698009,39
2,385,417,3578697970,3578698020,50
2,386,418,3578698021,3578698021,0
2,386,419,3578698021,3578698028,7
2,386,420,3578698021,3578698030,9
2,386,421,3578698021,3578698037,16
2,386,422,3578698021,3578698038,17
2,386,423,3578698021,3578698048,27
2,386,424,3578698021,3578698063,42
2,386,425,3578698021,3578698068,47
2,387,426,3578698072,3578698077,5
2,387,427,3578698072,3578698078,6
2,387,428,3578698072,3578698083,11
2,387,429,3578698072,3578698084,12
2,387,430,3578698072,3578698091,19
2,387,431,3578698072,3578698108,36
2,387,432,3578698072,3578698111,39
2,387,433,3578698072,3578698114,42
2,387,434,3578698072,3578698116,44
2,388,435,3578698123,3578698128,5
2,388,436,3578698123,3578698135,12
2,388,437,3578698123,3578698135,12
2,388,438,3578698123,3578698166,43
2,389,439,3578698174,3578698177,3
2,389,440,3578698174,3578698181,7
2,389,441,3578698174,3578698195,21
2,389,442,3578698174,3578698209,35
2,389,443,3578698174,3578698220,46
2,389,444,3578698174,3578698221,47
2,390,445,3578698225,3578698227,2
2,390,446,3578698225,3578698230,5
2,390,447,3578698225,3578698237,12
2,390,448,3578698225,3578698238,13
2,390,449,3578698225,3578698248,23
2,390,450,3578698225,3578698264,39
2,390,451,3578698225,3578698267,42
2,391,452,3578698276,3578698277,1
2,391,453,3578698276,3578698277,1
2,391,454,3578698276,3578698284,8
2,391,455,3578698276,3578698284,8
2,391,456,3578698276,3578698291,15
2,391,457,3578698276,3578698291,15
2,391,458,3578698276,3578698308,32
2,391,459,3578698276,3578698311,35
2,391,460,3578698276,3578698314,38
2,391,461,3578698276,3578698317,41
2,392,462,3578698327,3578698328,1
2,392,463,3578698327,3578698335,8
2,392,464,3578698327,3578698335,8
2,392,465,3578698327,3578698366,39
2,392,466,3578698327,3578698376,49
2,393,467,3578698379,3578698382,3
2,393,468,3578698379,3578698395,16
2,393,469,3578698379,3578698409,30
2,393,470,3578698379,3578698420,41
2,393,471,3578698379,3578698421,42
2,393,472,3578698379,3578698427,48
2,394,473,3578698430,3578698430,0
2,394,474,3578698430,3578698436,6
2,394,475,3578698430,3578698439,9
2,394,476,3578698430,3578698443,13
2,394,477,3578698430,3578698448,18
2,394,478,3578698430,3578698463,33
2,394,479,3578698430,3578698468,38
2,394,480,3578698430,3578698477,47
2,394,481,3578698430,3578698478,48
2,395,482,3578698481,3578698483,2
2,395,483,3578698481,3578698484,3
2,395,484,3578698481,3578698489,8
2,395,485,3578698481,3578698507,26
2,395,486,3578698481,3578698511,30
2,395,487,3578698481,3578698513,32
2,395,488,3578698481,3578698516,35
2,395,489,3578698481,3578698527,46
2,396,490,3578698532,3578698535,3
2,396,491,3578698532,3578698535,3
2,396,492,3578698532,3578698566,34
2,396,493,3578698532,3578698575,43
2,396,494,3578698532,3578698581,49
2,397,495,3578698583,3578698596,13
2,397,496,3578698583,3578698609,26
2,397,497,3578698583,3578698620,37
2,397,498,3578698583,3578698620,37
2,397,499,3578698583,3578698627,44
2,397,500,3578698583,3578698629,46
2,398,501,3578698634,3578698636,2
2,398,502,3578698634,3578698638,4
2,398,503,3578698634,3578698642,8
2,398,504,3578698634,3578698647,13
2,398,505,3578698634,3578698662,28
2,398,506,3578698634,3578698667,33
2,398,507,3578698634,3578698678,44
2,398,508,3578698634,3578698678,44
2,398,509,3578698634,3578698683,49
2,399,510,3578698685,3578698685,0
2,399,511,3578698685,3578698689,4
2,399,512,3578698685,3578698696,11
2,399,513,3578698685,3578698707,22
2,399,514,3578698685,3578698711,26
2,399,515,3578698685,3578698712,27
2,399,516,3578698685,3578698716,31
2,399,517,3578698685,3578698727,42
2,400,518,3578698736,3578698736,0
2,400,519,3578698736,3578698736,0
2,400,520,3578698736,3578698766,30
2,400,521,3578698736,3578698776,40
2,400,522,3578698736,3578698782,46
2,401,523,3578698787,3578698796,9
2,401,524,3578698787,3578698808,21
2,401,525,3578698787,3578698820,33
2,401,526,3578698787,3578698820,33
2,401,527,3578698787,3578698828,41
2,401,528,3578698787,3578698829,42
2,401,529,3578698787,3578698837,50
2,402,530,3578698838,3578698838,0
2,402,531,3578698838,3578698842,4
2,402,532,3578698838,3578698847,9
2,402,533,3578698838,3578698862,24
2,402,534,3578698838,3578698866,28
2,402,535,3578698838,3578698877,39
2,402,536,3578698838,3578698878,40
2,402,537,3578698838,3578698883,45
2,402,538,3578698838,3578698884,46
2,403,539,3578698889,3578698890,1
2,403,540,3578698889,3578698896,7
2,403,541,3578698889,3578698907,18
2,403,542,3578698889,3578698912,23
2,403,543,3578698889,3578698913,24
2,403,544,3578698889,3578698916,27
2,403,545,3578698889,3578698928,39
2,403,546,3578698889,3578698935,46
2,403,547,3578698889,3578698936,47
2,404,548,3578698940,3578698949,9
2,404,549,3578698940,3578698965,25
2,404,550,3578698940,3578698977,37
2,404,551,3578698940,3578698981,41
2,405,552,3578698991,3578698995,4
2,405,553,3578698991,3578699009,18
2,405,554,3578698991,3578699020,29
2,405,555,3578698991,3578699020,29
2,405,556,3578698991,3578699027,36
2,405,557,3578698991,3578699029,38
2,405,558,3578698991,3578699036,45
2,405,559,3578698991,3578699037,46
2,406,560,3578699042,3578699043,1
2,406,561,3578699042,3578699047,5
2,406,562,3578699042,3578699063,21
2,406,563,3578699042,3578699066,24
2,406,564,3578699042,3578699078,36
2,406,565,3578699042,3578699078,36
2,406,566,3578699042,3578699083,41
2,406,567,3578699042,3578699084,42
2,406,568,3578699042,3578699090,48
2,407,569,3578699093,3578699096,3
2,407,570,3578699093,3578699101,8
2,407,571,3578699093,3578699107,14
2,407,572,3578699093,3578699111,18
2,407,573,3578699093,3578699113,20
2,407,574,3578699093,3578699116,23
2,407,575,3578699093,3578699127,34
2,407,576,3578699093,3578699135,42
2,407,577,3578699093,3578699137,44
2,408,578,3578699144,3578699149,5
2,408,579,3578699144,3578699167,23
2,408,580,3578699144,3578699177,33
2,408,581,3578699144,3578699182,38
2,409,582,3578699195,3578699195,0
2,409,583,3578699195,3578699209,14
2,409,584,3578699195,3578699220,25
2,409,585,3578699195,3578699220,25
2,409,586,3578699195,3578699228,33
2,409,587,3578699195,3578699230,35
2,409,588,3578699195,3578699236,41
2,409,589,3578699195,3578699238,43
2,409,590,3578699195,3578699243,48
2,410,591,3578699246,3578699247,1
2,410,592,3578699246,3578699263,17
2,410,593,3578699246,3578699267,21
2,410,594,3578699246,3578699278,32
2,410,595,3578699246,3578699278,32
2,410,596,3578699246,3578699283,37
2,410,597,3578699246,3578699285,39
2,410,598,3578699246,3578699290,44
2,411,599,3578699297,3578699297,0
2,411,600,3578699297,3578699301,4
2,411,601,3578699297,3578699307,10
2,411,602,3578699297,3578699311,14
2,411,603,3578699297,3578699314,17
2,411,604,3578699297,3578699317,20
2,411,605,3578699297,3578699328,31
2,411,606,3578699297,3578699335,38
2,411,607,3578699297,3578699336,39
2,412,608,3578699348,3578699349,1
2,412,609,3578699348,3578699366,18
2,412,610,3578699348,3578699376,28
2,412,611,3578699348,3578699382,34
2,412,612,3578699348,3578699395,47
2,413,613,3578699399,3578699404,5
2,413,614,3578699399,3578699408,9
2,413,615,3578699399,3578699420,21
2,413,616,3578699399,3578699420,21
2,413,617,3578699399,3578699427,28
2,413,618,3578699399,3578699430,31
2,413,619,3578699399,3578699437,38
2,413,620,3578699399,3578699437,38
2,413,621,3578699399,3578699443,44
2,413,622,3578699399,3578699447,48
2,414,623,3578699451,3578699464,13
2,414,624,3578699451,3578699468,17
2,414,625,3578699451,3578699478,27
2,414,626,3578699451,3578699479,28
2,414,627,3578699451,3578699483,32
2,414,628,3578699451,3578699484,33
2,414,629,3578699451,3578699490,39
2,414,630,3578699451,3578699496,45
2,414,631,3578699451,3578699501,50
2,415,632,3578699502,3578699507,5
2,415,633,3578699502,3578699511,9
2,415,634,3578699502,3578699512,10
2,415,635,3578699502,3578699516,14
2,415,636,3578699502,3578699528,26
2,415,637,3578699502,3578699534,32
2,415,638,3578699502,3578699535,33
2,415,639,3578699502,3578699548,46
2,416,640,3578699553,3578699555,2
2,416,641,3578699553,3578699566,13
2,416,642,3578699553,3578699576,23
2,416,643,3578699553,3578699581,28
2,416,644,3578699553,3578699595,42
2,417,645,3578699604,3578699604,0
2,417,646,3578699604,3578699608,4
2,417,647,3578699604,3578699619,15
2,417,648,3578699604,3578699619,15
2,417,649,3578699604,3578699626,22
2,417,650,3578699604,3578699628,24
2,417,651,3578699604,3578699635,31
2,417,652,3578699604,3578699636,32
2,417,653,3578699604,3578699642,38
2,417,654,3578699604,3578699646,42
2,418,655,3578699655,3578699662,7
2,418,656,3578699655,3578699666,11
2,418,657,3578699655,3578699678,23
2,418,658,3578699655,3578699680,25
2,418,659,3578699655,3578699683,28
2,418,660,3578699655,3578699685,30
2,418,661,3578699655,3578699690,35
2,418,662,3578699655,3578699696,41
2,418,663,3578699655,3578699701,46
2,419,664,3578699706,3578699707,1
2,419,665,3578699706,3578699707,1
2,419,666,3578699706,3578699711,5
2,419,667,3578699706,3578699712,6
2,419,668,3578699706,3578699716,10
2,419,669,3578699706,3578699728,22
2,419,670,3578699706,3578699735,29
2,419,671,3578699706,3578699736,30
2,419,672,3578699706,3578699748,42
2,419,673,3578699706,3578699755,49
2,420,674,3578699757,3578699766,9
2,420,675,3578699757,3578699775,18
2,420,676,3578699757,3578699781,24
2,420,677,3578699757,3578699795,38
2,420,678,3578699757,3578699804,47
2,421,679,3578699808,3578699808,0
2,421,680,3578699808,3578699809,1
2,421,681,3578699808,3578699820,12
2,421,682,3578699808,3578699820,12
2,421,683,3578699808,3578699827,19
2,421,684,3578699808,3578699829,21
2,421,685,3578699808,3578699837,29
2,421,686,3578699808,3578699837,29
2,421,687,3578699808,3578699843,35
2,421,688,3578699808,3578699846,38
2,422,689,3578699860,3578699862,2
2,422,690,3578699860,3578699867,7
2,422,691,3578699860,3578699878,18
2,422,692,3578699860,3578699880,20
2,422,693,3578699860,3578699883,23
2,422,694,3578699860,3578699885,25
2,422,695,3578699860,3578699890,30
2,422,696,3578699860,3578699891,31
2,422,697,3578699860,3578699896,36
2,422,698,3578699860,3578699901,41
2,422,699,3578699860,3578699907,47
2,422,700,3578699860,3578699908,48
2,423,701,3578699912,3578699912,0
2,423,702,3578699912,3578699913,1
2,423,703,3578699912,3578699916,4
2,423,704,3578699912,3578699928,16
2,423,705,3578699912,3578699935,23
2,423,706,3578699912,3578699935,23
2,423,707,3578699912,3578699948,36
2,423,708,3578699912,3578699955,43
2,424,709,3578699963,3578699965,2
2,424,710,3578699963,3578699977,14
2,424,711,3578699963,3578699982,19
2,424,712,3578699963,3578699996,33
2,424,713,3578699963,3578700003,40
2,424,714,3578699963,3578700008,45
2,424,715,3578699963,3578700009,46
2,424,716,3578699963,3578700011,48
2,425,717,3578700014,3578700019,5
2,425,718,3578700014,3578700020,6
2,425,719,3578700014,3578700028,14
2,425,720,3578700014,3578700029,15
2,425,721,3578700014,3578700036,22
2,425,722,3578700014,3578700038,24
2,425,723,3578700014,3578700043,29
2,425,724,3578700014,3578700046,32
2,425,725,3578700014,3578700061,47
2,425,726,3578700014,3578700064,50
2,426,727,3578700065,3578700067,2
2,426,728,3578700065,3578700078,13
2,426,729,3578700065,3578700080,15
2,426,730,3578700065,3578700083,18
2,426,731,3578700065,3578700086,21
2,426,732,3578700065,3578700089,24
2,426,733,3578700065,3578700091,26
2,426,734,3578700065,3578700096,31
2,426,735,3578700065,3578700101,36
2,426,736,3578700065,3578700107,42
2,426,737,3578700065,3578700107,42
2,426,738,3578700065,3578700112,47
2,426,739,3578700065,3578700113,48
2,426,740,3578700065,3578700113,48
2,427,741,3578700117,3578700117,0
2,427,742,3578700117,3578700127,10
2,427,743,3578700117,3578700130,13
2,427,744,3578700117,3578700135,18
2,427,745,3578700117,3578700135,18
2,427,746,3578700117,3578700147,30
2,427,747,3578700117,3578700155,38
2,427,748,3578700117,3578700167,50
2,428,749,3578700168,3578700176,8
2,428,750,3578700168,3578700182,14
2,428,751,3578700168,3578700195,27
2,428,752,3578700168,3578700203,35
2,428,753,3578700168,3578700208,40
2,428,754,3578700168,3578700209,41
2,428,755,3578700168,3578700211,43
2,429,756,3578700219,3578700220,1
2,429,757,3578700219,3578700220,1
2,429,758,3578700219,3578700228,9
2,429,759,3578700219,3578700230,11
2,429,760,3578700219,3578700236,17
2,429,761,3578700219,3578700237,18
2,429,762,3578700219,3578700243,24
2,429,763,3578700219,3578700246,27
2,429,764,3578700219,3578700262,43
2,429,765,3578700219,3578700264,45
2,429,766,3578700219,3578700268,49
2,430,767,3578700271,3578700278,7
2,430,768,3578700271,3578700281,10
2,430,769,3578700271,3578700282,11
2,430,770,3578700271,3578700285,14
2,430,771,3578700271,3578700290,19
2,430,772,3578700271,3578700292,21
2,430,773,3578700271,3578700296,25
2,430,774,3578700271,3578700301,30
2,430,775,3578700271,3578700307,36
2,430,776,3578700271,3578700308,37
2,430,777,3578700271,3578700312,41
2,430,778,3578700271,3578700312,41
2,430,779,3578700271,3578700314,43
2,430,780,3578700271,3578700317,46
2,431,781,3578700322,3578700328,6
2,431,782,3578700322,3578700331,9
2,431,783,3578700322,3578700335,13
2,431,784,3578700322,3578700336,14
2,431,785,3578700322,3578700348,26
2,431,786,3578700322,3578700355,33
2,431,787,3578700322,3578700366,44
2,432,788,3578700373,3578700377,4
2,432,789,3578700373,3578700382,9
2,432,790,3578700373,3578700395,22
2,432,791,3578700373,3578700403,30
2,432,792,3578700373,3578700408,35
2,432,793,3578700373,3578700409,36
2,432,794,3578700373,3578700411,38
2,432,795,3578700373,3578700417,44
2,432,796,3578700373,3578700419,46
2,432,797,3578700373,3578700421,48
2,433,798,3578700424,3578700428,4
2,433,799,3578700424,3578700431,7
2,433,800,3578700424,3578700436,12
2,433,801,3578700424,3578700436,12
2,433,802,3578700424,3578700437,13
2,433,803,3578700424,3578700444,20
2,433,804,3578700424,3578700446,22
2,433,805,3578700424,3578700462,38
2,433,806,3578700424,3578700464,40
2,433,807,3578700424,3578700469,45
2,434,808,3578700475,3578700477,2
2,434,809,3578700475,3578700480,5
2,434,810,3578700475,3578700482,7
2,434,811,3578700475,3578700485,10
2,434,812,3578700475,3578700489,14
2,434,813,3578700475,3578700492,17
2,434,814,3578700475,3578700495,20
2,434,815,3578700475,3578700500,25
2,434,816,3578700475,3578700507,32
2,434,817,3578700475,3578700507,32
2,434,818,3578700475,3578700511,36
2,434,819,3578700475,3578700511,36
2,434,820,3578700475,3578700512,37
2,434,821,3578700475,3578700516,41
2,434,822,3578700475,3578700517,42
2,435,823,3578700526,3578700527,1
2,435,824,3578700526,3578700530,4
2,435,825,3578700526,3578700534,8
2,435,826,3578700526,3578700535,9
2,435,827,3578700526,3578700547,21
2,435,828,3578700526,3578700554,28
2,435,829,3578700526,3578700565,39
2,435,830,3578700526,3578700567,41
2,435,831,3578700526,3578700575,49
2,436,832,3578700577,3578700581,4
2,436,833,3578700577,3578700595,18
2,436,834,3578700577,3578700602,25
2,436,835,3578700577,3578700608,31
2,436,836,3578700577,3578700608,31
2,436,837,3578700577,3578700610,33
2,436,838,3578700577,3578700617,40
2,436,839,3578700577,3578700620,43
2,436,840,3578700577,3578700621,44
2,437,841,3578700629,3578700629,0
2,437,842,3578700629,3578700629,0
2,437,843,3578700629,3578700636,7
2,437,844,3578700629,3578700636,7
2,437,845,3578700629,3578700637,8
2,437,846,3578700629,3578700643,14
2,437,847,3578700629,3578700646,17
2,437,848,3578700629,3578700662,33
2,437,849,3578700629,3578700663,34
2,437,850,3578700629,3578700668,39
2,437,851,3578700629,3578700677,48
2,437,852,3578700629,3578700679,50
2,438,853,3578700680,3578700682,2
2,438,854,3578700680,3578700685,5
2,438,855,3578700680,3578700689,9
2,438,856,3578700680,3578700691,11
2,438,857,3578700680,3578700695,15
2,438,858,3578700680,3578700700,20
2,438,859,3578700680,3578700707,27
2,438,860,3578700680,3578700707,27
2,438,861,3578700680,3578700711,31
2,438,862,3578700680,3578700712,32
2,438,863,3578700680,3578700712,32
2,438,864,3578700680,3578700716,36
2,438,865,3578700680,3578700716,36
2,438,866,3578700680,3578700726,46
2,438,867,3578700680,3578700730,50
2,439,868,3578700732,3578700734,2
2,439,869,3578700732,3578700735,3
2,439,870,3578700732,3578700748,16
2,439,871,3578700732,3578700754,22
2,439,872,3578700732,3578700765,33
2,439,873,3578700732,3578700767,35
2,439,874,3578700732,3578700776,44
2,439,875,3578700732,3578700781,49
2,440,876,3578700783,3578700795,12
2,440,877,3578700783,3578700803,20
2,440,878,3578700783,3578700808,25
2,440,879,3578700783,3578700809,26
2,440,880,3578700783,3578700810,27
2,440,881,3578700783,3578700817,34
2,440,882,3578700783,3578700820,37
2,440,883,3578700783,3578700821,38
2,440,884,3578700783,3578700828,45
2,440,885,3578700783,3578700830,47
2,441,886,3578700834,3578700836,2
2,441,887,3578700834,3578700837,3
2,441,888,3578700834,3578700838,4
2,441,889,3578700834,3578700842,8
2,441,890,3578700834,3578700846,12
2,441,891,3578700834,3578700862,28
2,441,892,3578700834,3578700863,29
2,441,893,3578700834,3578700869,35
2,441,894,3578700834,3578700877,43
2,441,895,3578700834,3578700880,46
2,441,896,3578700834,3578700882,48
2,442,897,3578700885,3578700885,0
2,442,898,3578700885,3578700889,4
2,442,899,3578700885,3578700891,6
2,442,900,3578700885,3578700895,10
2,442,901,3578700885,3578700899,14
2,442,902,3578700885,3578700907,22
2,442,903,3578700885,3578700907,22
2,442,904,3578700885,3578700912,27
2,442,905,3578700885,3578700912,27
2,442,906,3578700885,3578700913,28
2,442,907,3578700885,3578700916,31
2,442,908,3578700885,3578700916,31
2,442,909,3578700885,3578700922,37
2,442,910,3578700885,3578700926,41
2,442,911,3578700885,3578700930,45
2,442,912,3578700885,3578700935,50
2,443,913,3578700937,3578700937,0
2,443,914,3578700937,3578700948,11
2,443,915,3578700937,3578700954,17
2,443,916,3578700937,3578700966,29
2,443,917,3578700937,3578700967,30
2,443,918,3578700937,3578700976,39
2,443,919,3578700937,3578700981,44
2,444,920,3578700989,3578700995,6
2,444,921,3578700989,3578701003,14
2,444,922,3578700989,3578701008,19
2,444,923,3578700989,3578701008,19
2,444,924,3578700989,3578701010,21
2,444,925,3578700989,3578701017,28
2,444,926,3578700989,3578701020,31
2,444,927,3578700989,3578701022,33
2,444,928,3578700989,3578701028,39
2,444,929,3578700989,3578701030,41
2,444,930,3578700989,3578701036,47
2,444,931,3578700989,3578701036,47
2,444,932,3578700989,3578701037,48
2,445,933,3578701041,3578701043,2
2,445,934,3578701041,3578701046,5
2,445,935,3578701041,3578701062,21
2,445,936,3578701041,3578701063,22
2,445,937,3578701041,3578701069,28
2,445,938,3578701041,3578701076,35
2,445,939,3578701041,3578701079,38
2,445,940,3578701041,3578701082,41
2,445,941,3578701041,3578701085,44
2,445,942,3578701041,3578701090,49
2,445,943,3578701041,3578701091,50
2,446,944,3578701093,3578701095,2
2,446,945,3578701093,3578701100,7
2,446,946,3578701093,3578701107,14
2,446,947,3578701093,3578701108,15
2,446,948,3578701093,3578701111,18
2,446,949,3578701093,3578701112,19
2,446,950,3578701093,3578701113,20
2,446,951,3578701093,3578701116,23
2,446,952,3578701093,3578701117,24
2,446,953,3578701093,3578701122,29
2,446,954,3578701093,3578701127,34
2,446,955,3578701093,3578701130,37
2,446,956,3578701093,3578701134,41
2,446,957,3578701093,3578701136,43
2,447,958,3578701145,3578701149,4
2,447,959,3578701145,3578701155,10
2,447,960,3578701145,3578701166,21
2,447,961,3578701145,3578701167,22
2,447,962,3578701145,3578701177,32
2,447,963,3578701145,3578701181,36
2,447,964,3578701145,3578701195,50
2,448,965,3578701197,3578701204,7
2,448,966,3578701197,3578701208,11
2,448,967,3578701197,3578701209,12
2,448,968,3578701197,3578701211,14
2,448,969,3578701197,3578701217,20
2,448,970,3578701197,3578701221,24
2,448,971,3578701197,3578701221,24
2,448,972,3578701197,3578701225,28
2,448,973,3578701197,3578701229,32
2,448,974,3578701197,3578701230,33
2,448,975,3578701197,3578701236,39
2,448,976,3578701197,3578701237,40
2,448,977,3578701197,3578701238,41
2,448,978,3578701197,3578701243,46
2,448,979,3578701197,3578701246,49
2,449,980,3578701249,3578701262,13
2,449,981,3578701249,3578701264,15
2,449,982,3578701249,3578701269,20
2,449,983,3578701249,3578701276,27
2,449,984,3578701249,3578701279,30
2,449,985,3578701249,3578701281,32
2,449,986,3578701249,3578701285,36
2,449,987,3578701249,3578701290,41
2,449,988,3578701249,3578701291,42
2,449,989,3578701249,3578701295,46
2,450,990,3578701300,3578701301,1
2,450,991,3578701300,3578701307,7
2,450,992,3578701300,3578701307,7
2,450,993,3578701300,3578701312,12
2,450,994,3578701300,3578701312,12
2,450,995,3578701300,3578701313,13
2,450,996,3578701300,3578701316,16
2,450,997,3578701300,3578701316,16
2,450,998,3578701300,3578701323,23
2,450,999,3578701300,3578701327,27
2,450,1000,3578701300,3578701331,31
2,450,1001,3578701300,3578701335,35
2,450,1002,3578701300,3578701336,36
2,450,1003,3578701300,3578701349,49
2,451,1004,3578701352,3578701355,3
2,451,1005,3578701352,3578701367,15
2,451,1006,3578701352,3578701367,15
2,451,1007,3578701352,3578701377,25
2,451,1008,3578701352,3578701381,29
2,451,1009,3578701352,3578701396,44
2,452,1010,3578701404,3578701404,0
2,452,1011,3578701404,3578701409,5
2,452,1012,3578701404,3578701409,5
2,452,1013,3578701404,3578701411,7
2,452,1014,3578701404,3578701417,13
2,452,1015,3578701404,3578701421,17
2,452,1016,3578701404,3578701421,17
2,452,1017,3578701404,3578701425,21
2,452,1018,3578701404,3578701428,24
2,452,1019,3578701404,3578701429,25
2,452,1020,3578701404,3578701430,26
2,452,1021,3578701404,3578701436,32
2,452,1022,3578701404,3578701437,33
2,452,1023,3578701404,3578701438,34
2,452,1024,3578701404,3578701443,39
2,452,1025,3578701404,3578701446,42
2,453,1026,3578701455,3578701462,7
2,453,1027,3578701455,3578701463,8
2,453,1028,3578701455,3578701469,14
2,453,1029,3578701455,3578701477,22
2,453,1030,3578701455,3578701480,25
2,453,1031,3578701455,3578701482,27
2,453,1032,3578701455,3578701486,31
2,453,1033,3578701455,3578701489,34
2,453,1034,3578701455,3578701491,36
2,453,1035,3578701455,3578701495,40
2,453,1036,3578701455,3578701501,46
2,454,1037,3578701507,3578701507,0
2,454,1038,3578701507,3578701507,0
2,454,1039,3578701507,3578701510,3
2,454,1040,3578701507,3578701510,3
2,454,1041,3578701507,3578701512,5
2,454,1042,3578701507,3578701515,8
2,454,1043,3578701507,3578701516,9
2,454,1044,3578701507,3578701521,14
2,454,1045,3578701507,3578701526,19
2,454,1046,3578701507,3578701530,23
2,454,1047,3578701507,3578701533,26
2,454,1048,3578701507,3578701535,28
2,454,1049,3578701507,3578701547,40
2,454,1050,3578701507,3578701554,47
2,455,1051,3578701559,3578701566,7
2,455,1052,3578701559,3578701566,7
2,455,1053,3578701559,3578701577,18
2,455,1054,3578701559,3578701580,21
2,455,1055,3578701559,3578701595,36
2,455,1056,3578701559,3578701602,43
2,455,1057,3578701559,3578701608,49
2,455,1058,3578701559,3578701609,50
2,456,1059,3578701611,3578701611,0
2,456,1060,3578701611,3578701616,5
2,456,1061,3578701611,3578701620,9
2,456,1062,3578701611,3578701621,10
2,456,1063,3578701611,3578701625,14
2,456,1064,3578701611,3578701627,16
2,456,1065,3578701611,3578701627,16
2,456,1066,3578701611,3578701629,18
2,456,1067,3578701611,3578701636,25
2,456,1068,3578701611,3578701636,25
2,456,1069,3578701611,3578701636,25
2,456,1070,3578701611,3578701642,31
2,456,1071,3578701611,3578701646,35
2,456,1072,3578701611,3578701661,50
2,457,1073,3578701662,3578701662,0
2,457,1074,3578701662,3578701668,6
2,457,1075,3578701662,3578701679,17
2,457,1076,3578701662,3578701682,20
2,457,1077,3578701662,3578701685,23
2,457,1078,3578701662,3578701689,27
2,457,1079,3578701662,3578701691,29
2,457,1080,3578701662,3578701695,33
2,457,1081,3578701662,3578701700,38
2,457,1082,3578701662,3578701707,45
2,457,1083,3578701662,3578701707,45
2,457,1084,3578701662,3578701710,48
2,457,1085,3578701662,3578701711,49
2,458,1086,3578701714,3578701714,0
2,458,1087,3578701714,3578701715,1
2,458,1088,3578701714,3578701716,2
2,458,1089,3578701714,3578701721,7
2,458,1090,3578701714,3578701727,13
2,458,1091,3578701714,3578701730,16
2,458,1092,3578701714,3578701732,18
2,458,1093,3578701714,3578701733,19
2,458,1094,3578701714,3578701735,21
2,458,1095,3578701714,3578701748,34
2,458,1096,3578701714,3578701754,40
2,459,1097,3578701766,3578701766,0
2,459,1098,3578701766,3578701766,0
2,459,1099,3578701766,3578701778,12
2,459,1100,3578701766,3578701781,15
2,459,1101,3578701766,3578701795,29
2,459,1102,3578701766,3578701803,37
2,459,1103,3578701766,3578701809,43
2,459,1104,3578701766,3578701809,43
2,459,1105,3578701766,3578701810,44
2,459,1106,3578701766,3578701816,50
2,460,1107,3578701817,3578701820,3
2,460,1108,3578701817,3578701820,3
2,460,1109,3578701817,3578701824,7
2,460,1110,3578701817,3578701827,10
2,460,1111,3578701817,3578701828,11
2,460,1112,3578701817,3578701829,12
2,460,1113,3578701817,3578701836,19
2,460,1114,3578701817,3578701837,20
2,460,1115,3578701817,3578701837,20
2,460,1116,3578701817,3578701842,25
2,460,1117,3578701817,3578701846,29
2,460,1118,3578701817,3578701861,44
2,460,1119,3578701817,3578701862,45
2,461,1120,3578701869,3578701869,0
2,461,1121,3578701869,3578701880,11
2,461,1122,3578701869,3578701882,13
2,461,1123,3578701869,3578701884,15
2,461,1124,3578701869,3578701886,17
2,461,1125,3578701869,3578701890,21
2,461,1126,3578701869,3578701891,22
2,461,1127,3578701869,3578701895,26
2,461,1128,3578701869,3578701901,32
2,461,1129,3578701869,3578701907,38
2,461,1130,3578701869,3578701907,38
2,461,1131,3578701869,3578701911,42
2,461,1132,3578701869,3578701912,43
2,461,1133,3578701869,3578701913,44
2,461,1134,3578701869,3578701915,46
2,461,1135,3578701869,3578701916,47
2,462,1136,3578701921,3578701921,0
2,462,1137,3578701921,3578701927,6
2,462,1138,3578701921,3578701930,9
2,462,1139,3578701921,3578701932,11
2,462,1140,3578701921,3578701933,12
2,462,1141,3578701921,3578701935,14
2,462,1142,3578701921,3578701948,27
2,462,1143,3578701921,3578701954,33
2,462,1144,3578701921,3578701966,45
2,462,1145,3578701921,3578701966,45
2,463,1146,3578701972,3578701977,5
2,463,1147,3578701972,3578701981,9
2,463,1148,3578701972,3578701996,24
2,463,1149,3578701972,3578702002,30
2,463,1150,3578701972,3578702009,37
2,463,1151,3578701972,3578702009,37
2,463,1152,3578701972,3578702010,38
2,463,1153,3578701972,3578702016,44
2,463,1154,3578701972,3578702019,47
2,463,1155,3578701972,3578702021,49
2,464,1156,3578702024,3578702024,0
2,464,1157,3578702024,3578702027,3
2,464,1158,3578702024,3578702028,4
2,464,1159,3578702024,3578702029,5
2,464,1160,3578702024,3578702036,12
2,464,1161,3578702024,3578702036,12
2,464,1162,3578702024,3578702037,13
2,464,1163,3578702024,3578702042,18
2,464,1164,3578702024,3578702046,22
2,464,1165,3578702024,3578702062,38
2,464,1166,3578702024,3578702063,39
2,464,1167,3578702024,3578702068,44
2,465,1168,3578702076,3578702078,2
2,465,1169,3578702076,3578702079,3
2,465,1170,3578702076,3578702082,6
2,465,1171,3578702076,3578702085,9
2,465,1172,3578702076,3578702087,11
2,465,1173,3578702076,3578702090,14
2,465,1174,3578702076,3578702092,16
2,465,1175,3578702076,3578702095,19
2,465,1176,3578702076,3578702100,24
2,465,1177,3578702076,3578702107,31
2,465,1178,3578702076,3578702107,31
2,465,1179,3578702076,3578702111,35
2,465,1180,3578702076,3578702112,36
2,465,1181,3578702076,3578702113,37
2,465,1182,3578702076,3578702115,39
2,465,1183,3578702076,3578702116,40
2,465,1184,3578702076,3578702122,46
2,466,1185,3578702127,3578702128,1
2,466,1186,3578702127,3578702131,4
2,466,1187,3578702127,3578702131,4
2,466,1188,3578702127,3578702133,6
2,466,1189,3578702127,3578702136,9
2,466,1190,3578702127,3578702148,21
2,466,1191,3578702127,3578702155,28
2,466,1192,3578702127,3578702166,39
2,466,1193,3578702127,3578702166,39
2,467,1194,3578702179,3578702179,0
2,467,1195,3578702179,3578702181,2
2,467,1196,3578702179,3578702196,17
2,467,1197,3578702179,3578702203,24
2,467,1198,3578702179,3578702209,30
2,467,1199,3578702179,3578702209,30
2,467,1200,3578702179,3578702211,32
2,467,1201,3578702179,3578702216,37
2,467,1202,3578702179,3578702219,40
2,467,1203,3578702179,3578702221,42
2,467,1204,3578702179,3578702225,46
2,467,1205,3578702179,3578702226,47
2,467,1206,3578702179,3578702227,48
2,468,1207,3578702230,3578702230,0
2,468,1208,3578702230,3578702236,6
2,468,1209,3578702230,3578702236,6
2,468,1210,3578702230,3578702237,7
2,468,1211,3578702230,3578702238,8
2,468,1212,3578702230,3578702242,12
2,468,1213,3578702230,3578702246,16
2,468,1214,3578702230,3578702263,33
2,468,1215,3578702230,3578702263,33
2,468,1216,3578702230,3578702268,38
2,468,1217,3578702230,3578702278,48
2,468,1218,3578702230,3578702279,49
2,469,1219,3578702282,3578702282,0
2,469,1220,3578702282,3578702284,2
2,469,1221,3578702282,3578702286,4
2,469,1222,3578702282,3578702290,8
2,469,1223,3578702282,3578702291,9
2,469,1224,3578702282,3578702294,12
2,469,1225,3578702282,3578702301,19
2,469,1226,3578702282,3578702307,25
2,469,1227,3578702282,3578702307,25
2,469,1228,3578702282,3578702311,29
2,469,1229,3578702282,3578702311,29
2,469,1230,3578702282,3578702314,32
2,469,1231,3578702282,3578702316,34
2,469,1232,3578702282,3578702317,35
2,469,1233,3578702282,3578702322,40
2,469,1234,3578702282,3578702327,45
2,469,1235,3578702282,3578702331,49
2,469,1236,3578702282,3578702331,49
2,470,1237,3578702334,3578702334,0
2,470,1238,3578702334,3578702335,1
2,470,1239,3578702334,3578702339,5
2,470,1240,3578702334,3578702348,14
2,470,1241,3578702334,3578702355,21
2,470,1242,3578702334,3578702366,32
2,470,1243,3578702334,3578702367,33
2,470,1244,3578702334,3578702378,44
2,470,1245,3578702334,3578702381,47
2,471,1246,3578702386,3578702396,10
2,471,1247,3578702386,3578702403,17
2,471,1248,3578702386,3578702409,23
2,471,1249,3578702386,3578702409,23
2,471,1250,3578702386,3578702410,24
2,471,1251,3578702386,3578702416,30
2,471,1252,3578702386,3578702420,34
2,471,1253,3578702386,3578702421,35
2,471,1254,3578702386,3578702425,39
2,471,1255,3578702386,3578702427,41
2,471,1256,3578702386,3578702427,41
2,471,1257,3578702386,3578702429,43
2,472,1258,3578702438,3578702438,0
2,472,1259,3578702438,3578702438,0
2,472,1260,3578702438,3578702438,0
2,472,1261,3578702438,3578702439,1
2,472,1262,3578702438,3578702442,4
2,472,1263,3578702438,3578702446,8
2,472,1264,3578702438,3578702463,25
2,472,1265,3578702438,3578702464,26
2,472,1266,3578702438,3578702467,29
2,472,1267,3578702438,3578702469,31
2,472,1268,3578702438,3578702478,40
2,472,1269,3578702438,3578702479,41
2,472,1270,3578702438,3578702483,45
2,472,1271,3578702438,3578702484,46
2,472,1272,3578702438,3578702486,48
2,473,1273,3578702489,3578702489,0
2,473,1274,3578702489,3578702491,2
2,473,1275,3578702489,3578702494,5
2,473,1276,3578702489,3578702499,10
2,473,1277,3578702489,3578702506,17
2,473,1278,3578702489,3578702507,18
2,473,1279,3578702489,3578702510,21
2,473,1280,3578702489,3578702511,22
2,473,1281,3578702489,3578702512,23
2,473,1282,3578702489,3578702515,26
2,473,1283,3578702489,3578702516,27
2,473,1284,3578702489,3578702521,32
2,473,1285,3578702489,3578702527,38
2,473,1286,3578702489,3578702530,41
2,473,1287,3578702489,3578702531,42
2,473,1288,3578702489,3578702533,44
2,473,1289,3578702489,3578702534,45
2,473,1290,3578702489,3578702537,48
2,474,1291,3578702541,3578702547,6
2,474,1292,3578702541,3578702554,13
2,474,1293,3578702541,3578702565,24
2,474,1294,3578702541,3578702565,24
2,474,1295,3578702541,3578702577,36
2,474,1296,3578702541,3578702581,40
2,475,1297,3578702593,3578702593,0
2,475,1298,3578702593,3578702595,2
2,475,1299,3578702593,3578702602,9
2,475,1300,3578702593,3578702608,15
2,475,1301,3578702593,3578702608,15
2,475,1302,3578702593,3578702609,16
2,475,1303,3578702593,3578702615,22
2,475,1304,3578702593,3578702619,26
2,475,1305,3578702593,3578702621,28
2,475,1306,3578702593,3578702624,31
2,475,1307,3578702593,3578702626,33
2,475,1308,3578702593,3578702626,33
2,475,1309,3578702593,3578702628,35
2,475,1310,3578702593,3578702637,44
2,475,1311,3578702593,3578702637,44
2,475,1312,3578702593,3578702637,44
2,475,1313,3578702593,3578702637,44
2,475,1314,3578702593,3578702641,48
2,475,1315,3578702593,3578702642,49
2,476,1316,3578702645,3578702646,1
2,476,1317,3578702645,3578702661,16
2,476,1318,3578702645,3578702662,17
2,476,1319,3578702645,3578702666,21
2,476,1320,3578702645,3578702667,22
2,476,1321,3578702645,3578702678,33
2,476,1322,3578702645,3578702680,35
2,476,1323,3578702645,3578702682,37
2,476,1324,3578702645,3578702684,39
2,476,1325,3578702645,3578702687,42
2,476,1326,3578702645,3578702688,43
2,476,1327,3578702645,3578702691,46
2,476,1328,3578702645,3578702694,49
2,477,1329,3578702697,3578702700,3
2,477,1330,3578702697,3578702706,9
2,477,1331,3578702697,3578702707,10
2,477,1332,3578702697,3578702710,13
2,477,1333,3578702697,3578702711,14
2,477,1334,3578702697,3578702712,15
2,477,1335,3578702697,3578702716,19
2,477,1336,3578702697,3578702716,19
2,477,1337,3578702697,3578702721,24
2,477,1338,3578702697,3578702726,29
2,477,1339,3578702697,3578702730,33
2,477,1340,3578702697,3578702730,33
2,477,1341,3578702697,3578702733,36
2,477,1342,3578702697,3578702735,38
2,477,1343,3578702697,3578702737,40
2,478,1344,3578702749,3578702749,0
2,478,1345,3578702749,3578702754,5
2,478,1346,3578702749,3578702766,17
2,478,1347,3578702749,3578702766,17
2,478,1348,3578702749,3578702777,28
2,478,1349,3578702749,3578702781,32
2,478,1350,3578702749,3578702792,43
2,478,1351,3578702749,3578702795,46
2,479,1352,3578702801,3578702802,1
2,479,1353,3578702801,3578702808,7
2,479,1354,3578702801,3578702808,7
2,479,1355,3578702801,3578702810,9
2,479,1356,3578702801,3578702815,14
2,479,1357,3578702801,3578702820,19
2,479,1358,3578702801,3578702821,20
2,479,1359,3578702801,3578702824,23
2,479,1360,3578702801,3578702826,25
2,479,1361,3578702801,3578702826,25
2,479,1362,3578702801,3578702829,28
2,479,1363,3578702801,3578702837,36
2,479,1364,3578702801,3578702837,36
2,479,1365,3578702801,3578702838,37
2,479,1366,3578702801,3578702838,37
2,479,1367,3578702801,3578702841,40
2,479,1368,3578702801,3578702841,40
2,479,1369,3578702801,3578702845,44
2,479,1370,3578702801,3578702846,45
2,480,1371,3578702853,3578702862,9
2,480,1372,3578702853,3578702862,9
2,480,1373,3578702853,3578702866,13
2,480,1374,3578702853,3578702868,15
2,480,1375,3578702853,3578702878,25
2,480,1376,3578702853,3578702879,26
2,480,1377,3578702853,3578702883,30
2,480,1378,3578702853,3578702884,31
2,480,1379,3578702853,3578702887,34
2,480,1380,3578702853,3578702889,36
2,480,1381,3578702853,3578702890,37
2,480,1382,3578702853,3578702894,41
2,480,1383,3578702853,3578702900,47
2,481,1384,3578702904,3578702905,1
2,481,1385,3578702904,3578702907,3
2,481,1386,3578702904,3578702912,8
2,481,1387,3578702904,3578702912,8
2,481,1388,3578702904,3578702914,10
2,481,1389,3578702904,3578702915,11
2,481,1390,3578702904,3578702916,12
2,481,1391,3578702904,3578702921,17
2,481,1392,3578702904,3578702927,23
2,481,1393,3578702904,3578702930,26
2,481,1394,3578702904,3578702931,27
2,481,1395,3578702904,3578702934,30
2,481,1396,3578702904,3578702935,31
2,481,1397,3578702904,3578702937,33
2,481,1398,3578702904,3578702948,44
2,481,1399,3578702904,3578702954,50
2,482,1400,3578702956,3578702966,10
2,482,1401,3578702956,3578702966,10
2,482,1402,3578702956,3578702976,20
2,482,1403,3578702956,3578702981,25
2,482,1404,3578702956,3578702991,35
2,482,1405,3578702956,3578702995,39
2,482,1406,3578702956,3578703002,46
2,483,1407,3578703008,3578703008,0
2,483,1408,3578703008,3578703009,1
2,483,1409,3578703008,3578703010,2
2,483,1410,3578703008,3578703015,7
2,483,1411,3578703008,3578703021,13
2,483,1412,3578703008,3578703022,14
2,483,1413,3578703008,3578703025,17
2,483,1414,3578703008,3578703026,18
2,483,1415,3578703008,3578703028,20
2,483,1416,3578703008,3578703029,21
2,483,1417,3578703008,3578703037,29
2,483,1418,3578703008,3578703037,29
2,483,1419,3578703008,3578703038,30
2,483,1420,3578703008,3578703038,30
2,483,1421,3578703008,3578703041,33
2,483,1422,3578703008,3578703041,33
2,483,1423,3578703008,3578703045,37
2,483,1424,3578703008,3578703046,38
2,484,1425,3578703060,3578703062,2
2,484,1426,3578703060,3578703064,4
2,484,1427,3578703060,3578703067,7
2,484,1428,3578703060,3578703068,8
2,484,1429,3578703060,3578703078,18
2,484,1430,3578703060,3578703079,19
2,484,1431,3578703060,3578703083,23
2,484,1432,3578703060,3578703084,24
2,484,1433,3578703060,3578703087,27
2,484,1434,3578703060,3578703090,30
2,484,1435,3578703060,3578703091,31
2,484,1436,3578703060,3578703094,34
2,484,1437,3578703060,3578703100,40
2,484,1438,3578703060,3578703106,46
2,484,1439,3578703060,3578703107,47
2,485,1440,3578703112,3578703112,0
2,485,1441,3578703112,3578703112,0
2,485,1442,3578703112,3578703114,2
2,485,1443,3578703112,3578703116,4
2,485,1444,3578703112,3578703116,4
2,485,1445,3578703112,3578703122,10
2,485,1446,3578703112,3578703127,15
2,485,1447,3578703112,3578703131,19
2,485,1448,3578703112,3578703131,19
2,485,1449,3578703112,3578703133,21
2,485,1450,3578703112,3578703136,24
2,485,1451,3578703112,3578703138,26
2,485,1452,3578703112,3578703148,36
2,485,1453,3578703112,3578703152,40
2,485,1454,3578703112,3578703155,43
2,486,1455,3578703164,3578703165,1
2,486,1456,3578703164,3578703166,2
2,486,1457,3578703164,3578703177,13
2,486,1458,3578703164,3578703181,17
2,486,1459,3578703164,3578703192,28
2,486,1460,3578703164,3578703195,31
2,486,1461,3578703164,3578703202,38
2,486,1462,3578703164,3578703204,40
2,486,1463,3578703164,3578703208,44
2,486,1464,3578703164,3578703209,45
2,486,1465,3578703164,3578703210,46
2,487,1466,3578703216,3578703216,0
2,487,1467,3578703216,3578703221,5
2,487,1468,3578703216,3578703222,6
2,487,1469,3578703216,3578703224,8
2,487,1470,3578703216,3578703227,11
2,487,1471,3578703216,3578703227,11
2,487,1472,3578703216,3578703230,14
2,487,1473,3578703216,3578703236,20
2,487,1474,3578703216,3578703237,21
2,487,1475,3578703216,3578703238,22
2,487,1476,3578703216,3578703239,23
2,487,1477,3578703216,3578703241,25
2,487,1478,3578703216,3578703242,26
2,487,1479,3578703216,3578703244,28
2,487,1480,3578703216,3578703247,31
2,487,1481,3578703216,3578703249,33
2,487,1482,3578703216,3578703261,45
2,487,1483,3578703216,3578703263,47
2,487,1484,3578703216,3578703266,50
2,488,1485,3578703269,3578703269,0
2,488,1486,3578703269,3578703277,8
2,488,1487,3578703269,3578703279,10
2,488,1488,3578703269,3578703283,14
2,488,1489,3578703269,3578703284,15
2,488,1490,3578703269,3578703287,18
2,488,1491,3578703269,3578703290,21
2,488,1492,3578703269,3578703291,22
2,488,1493,3578703269,3578703295,26
2,488,1494,3578703269,3578703300,31
2,488,1495,3578703269,3578703306,37
2,488,1496,3578703269,3578703307,38
2,488,1497,3578703269,3578703311,42
2,488,1498,3578703269,3578703312,43
2,488,1499,3578703269,3578703313,44
2,488,1500,3578703269,3578703317,48
2,488,1501,3578703269,3578703317,48
2,489,1502,3578703321,3578703321,0
2,489,1503,3578703321,3578703327,6
2,489,1504,3578703321,3578703330,9
2,489,1505,3578703321,3578703331,10
2,489,1506,3578703321,3578703333,12
2,489,1507,3578703321,3578703335,14
2,489,1508,3578703321,3578703337,16
2,489,1509,3578703321,3578703348,27
2,489,1510,3578703321,3578703351,30
2,489,1511,3578703321,3578703355,34
2,489,1512,3578703321,3578703367,46
2,489,1513,3578703321,3578703367,46
2,490,1514,3578703373,3578703377,4
2,490,1515,3578703373,3578703382,9
2,490,1516,3578703373,3578703392,19
2,490,1517,3578703373,3578703395,22
2,490,1518,3578703373,3578703402,29
2,490,1519,3578703373,3578703404,31
2,490,1520,3578703373,3578703408,35
2,490,1521,3578703373,3578703409,36
2,490,1522,3578703373,3578703410,37
2,490,1523,3578703373,3578703416,43
2,490,1524,3578703373,3578703421,48
2,490,1525,3578703373,3578703422,49
2,491,1526,3578703425,3578703425,0
2,491,1527,3578703425,3578703427,2
2,491,1528,3578703425,3578703427,2
2,491,1529,3578703425,3578703430,5
2,491,1530,3578703425,3578703436,11
2,491,1531,3578703425,3578703437,12
2,491,1532,3578703425,3578703437,12
2,491,1533,3578703425,3578703439,14
2,491,1534,3578703425,3578703441,16
2,491,1535,3578703425,3578703442,17
2,491,1536,3578703425,3578703445,20
2,491,1537,3578703425,3578703447,22
2,491,1538,3578703425,3578703449,24
2,491,1539,3578703425,3578703462,37
2,491,1540,3578703425,3578703463,38
2,491,1541,3578703425,3578703466,41
2,491,1542,3578703425,3578703467,42
2,492,1543,3578703477,3578703477,0
2,492,1544,3578703477,3578703478,1
2,492,1545,3578703477,3578703482,5
2,492,1546,3578703477,3578703483,6
2,492,1547,3578703477,3578703486,9
2,492,1548,3578703477,3578703489,12
2,492,1549,3578703477,3578703490,13
2,492,1550,3578703477,3578703494,17
2,492,1551,3578703477,3578703498,21
2,492,1552,3578703477,3578703504,27
2,492,1553,3578703477,3578703506,29
2,492,1554,3578703477,3578703508,31
2,492,1555,3578703477,3578703511,34
2,492,1556,3578703477,3578703511,34
2,492,1557,3578703477,3578703512,35
2,492,1558,3578703477,3578703516,39
2,492,1559,3578703477,3578703516,39
2,492,1560,3578703477,3578703520,43
2,492,1561,3578703477,3578703527,50
2,493,1562,3578703529,3578703530,1
2,493,1563,3578703529,3578703530,1
2,493,1564,3578703529,3578703533,4
2,493,1565,3578703529,3578703534,5
2,493,1566,3578703529,3578703537,8
2,493,1567,3578703529,3578703547,18
2,493,1568,3578703529,3578703550,21
2,493,1569,3578703529,3578703554,25
2,493,1570,3578703529,3578703566,37
2,493,1571,3578703529,3578703566,37
2,493,1572,3578703529,3578703576,47
2,494,1573,3578703581,3578703581,0
2,494,1574,3578703581,3578703591,10
2,494,1575,3578703581,3578703601,20
2,494,1576,3578703581,3578703603,22
2,494,1577,3578703581,3578703607,26
2,494,1578,3578703581,3578703609,28
2,494,1579,3578703581,3578703609,28
2,494,1580,3578703581,3578703615,34
2,494,1581,3578703581,3578703621,40
2,494,1582,3578703581,3578703622,41
2,494,1583,3578703581,3578703624,43
2,494,1584,3578703581,3578703626,45
2,494,1585,3578703581,3578703627,46
2,495,1586,3578703633,3578703636,3
2,495,1587,3578703633,3578703636,3
2,495,1588,3578703633,3578703636,3
2,495,1589,3578703633,3578703638,5
2,495,1590,3578703633,3578703640,7
2,495,1591,3578703633,3578703641,8
2,495,1592,3578703633,3578703643,10
2,495,1593,3578703633,3578703646,13
2,495,1594,3578703633,3578703649,16
2,495,1595,3578703633,3578703661,28
2,495,1596,3578703633,3578703662,29
2,495,1597,3578703633,3578703665,32
2,495,1598,3578703633,3578703667,34
2,495,1599,3578703633,3578703677,44
2,495,1600,3578703633,3578703678,45
2,495,1601,3578703633,3578703682,49
2,496,1602,3578703685,3578703685,0
2,496,1603,3578703685,3578703686,1
2,496,1604,3578703685,3578703688,3
2,496,1605,3578703685,3578703690,5
2,496,1606,3578703685,3578703694,9
2,496,1607,3578703685,3578703699,14
2,496,1608,3578703685,3578703704,19
2,496,1609,3578703685,3578703705,20
2,496,1610,3578703685,3578703708,23
2,496,1611,3578703685,3578703710,25
2,496,1612,3578703685,3578703711,26
2,496,1613,3578703685,3578703712,27
2,496,1614,3578703685,3578703716,31
2,496,1615,3578703685,3578703716,31
2,496,1616,3578703685,3578703721,36
2,496,1617,3578703685,3578703726,41
2,496,1618,3578703685,3578703730,45
2,496,1619,3578703685,3578703731,46
2,496,1620,3578703685,3578703733,48
2,496,1621,3578703685,3578703735,50
2,497,1622,3578703737,3578703737,0
2,497,1623,3578703737,3578703748,11
2,497,1624,3578703737,3578703750,13
2,497,1625,3578703737,3578703754,17
2,497,1626,3578703737,3578703757,20
2,497,1627,3578703737,3578703765,28
2,497,1628,3578703737,3578703766,29
2,497,1629,3578703737,3578703776,39
2,497,1630,3578703737,3578703781,44
2,498,1631,3578703789,3578703791,2
2,498,1632,3578703789,3578703801,12
2,498,1633,3578703789,3578703803,14
2,498,1634,3578703789,3578703808,19
2,498,1635,3578703789,3578703808,19
2,498,1636,3578703789,3578703809,20
2,498,1637,3578703789,3578703810,21
2,498,1638,3578703789,3578703815,26
2,498,1639,3578703789,3578703820,31
2,498,1640,3578703789,3578703821,32
2,498,1641,3578703789,3578703824,35
2,498,1642,3578703789,3578703826,37
2,498,1643,3578703789,3578703826,37
2,498,1644,3578703789,3578703836,47
2,498,1645,3578703789,3578703837,48
2,498,1646,3578703789,3578703838,49
2,498,1647,3578703789,3578703838,49
2,499,1648,3578703840,3578703841,1
2,499,1649,3578703840,3578703841,1
2,499,1650,3578703840,3578703844,4
2,499,1651,3578703840,3578703846,6
2,499,1652,3578703840,3578703849,9
2,499,1653,3578703840,3578703859,19
2,499,1654,3578703840,3578703861,21
2,499,1655,3578703840,3578703862,22
2,499,1656,3578703840,3578703865,25
2,499,1657,3578703840,3578703867,27
2,499,1658,3578703840,3578703876,36
2,499,1659,3578703840,3578703878,38
2,499,1660,3578703840,3578703882,42
2,499,1661,3578703840,3578703884,44
2,499,1662,3578703840,3578703886,46
2,499,1663,3578703840,3578703888,48
2,499,1664,3578703840,3578703890,50
2,500,1665,3578703892,3578703894,2
2,500,1666,3578703892,3578703900,8
2,500,1667,3578703892,3578703903,11
2,500,1668,3578703892,3578703905,13
2,500,1669,3578703892,3578703908,16
2,500,1670,3578703892,3578703911,19
2,500,1671,3578703892,3578703912,20
2,500,1672,3578703892,3578703913,21
2,500,1673,3578703892,3578703915,23
2,500,1674,3578703892,3578703916,24
2,500,1675,3578703892,3578703921,29
2,500,1676,3578703892,3578703926,34
2,500,1677,3578703892,3578703930,38
2,500,1678,3578703892,3578703931,39
2,500,1679,3578703892,3578703932,40
2,500,1680,3578703892,3578703935,43
2,500,1681,3578703892,3578703937,45
2,501,1682,3578703943,3578703948,5
2,501,1683,3578703943,3578703951,8
2,501,1684,3578703943,3578703954,11
2,501,1685,3578703943,3578703957,14
2,501,1686,3578703943,3578703965,22
2,501,1687,3578703943,3578703966,23
2,501,1688,3578703943,3578703976,33
2,501,1689,3578703943,3578703981,38
2,501,1690,3578703943,3578703990,47
2,502,1691,3578703995,3578703995,0
2,502,1692,3578703995,3578704001,6
2,502,1693,3578703995,3578704003,8
2,502,1694,3578703995,3578704008,13
2,502,1695,3578703995,3578704008,13
2,502,1696,3578703995,3578704008,13
2,502,1697,3578703995,3578704011,16
2,502,1698,3578703995,3578704015,20
2,502,1699,3578703995,3578704020,25
2,502,1700,3578703995,3578704021,26
2,502,1701,3578703995,3578704025,30
2,502,1702,3578703995,3578704026,31
2,502,1703,3578703995,3578704028,33
2,502,1704,3578703995,3578704036,41
2,502,1705,3578703995,3578704037,42
2,502,1706,3578703995,3578704038,43
2,502,1707,3578703995,3578704038,43
2,502,1708,3578703995,3578704040,45
2,502,1709,3578703995,3578704041,46
2,502,1710,3578703995,3578704045,50
2,503,1711,3578704047,3578704047,0
2,503,1712,3578704047,3578704049,2
2,503,1713,3578704047,3578704059,12
2,503,1714,3578704047,3578704061,14
2,503,1715,3578704047,3578704062,15
2,503,1716,3578704047,3578704064,17
2,503,1717,3578704047,3578704066,19
2,503,1718,3578704047,3578704067,20
2,503,1719,3578704047,3578704077,30
2,503,1720,3578704047,3578704078,31
2,503,1721,3578704047,3578704082,35
2,503,1722,3578704047,3578704084,37
2,503,1723,3578704047,3578704087,40
2,503,1724,3578704047,3578704090,43
2,503,1725,3578704047,3578704090,43
2,503,1726,3578704047,3578704094,47
2,504,1727,3578704098,3578704099,1
2,504,1728,3578704098,3578704104,6
2,504,1729,3578704098,3578704106,8
2,504,1730,3578704098,3578704108,10
2,504,1731,3578704098,3578704112,14
2,504,1732,3578704098,3578704112,14
2,504,1733,3578704098,3578704113,15
2,504,1734,3578704098,3578704115,17
2,504,1735,3578704098,3578704116,18
2,504,1736,3578704098,3578704121,23
2,504,1737,3578704098,3578704128,30
2,504,1738,3578704098,3578704130,32
2,504,1739,3578704098,3578704131,33
2,504,1740,3578704098,3578704133,35
2,504,1741,3578704098,3578704135,37
2,504,1742,3578704098,3578704138,40
2,505,1743,3578704150,3578704150,0
2,505,1744,3578704150,3578704151,1
2,505,1745,3578704150,3578704155,5
2,505,1746,3578704150,3578704158,8
2,505,1747,3578704150,3578704166,16
2,505,1748,3578704150,3578704167,17
2,505,1749,3578704150,3578704177,27
2,505,1750,3578704150,3578704181,31
2,505,1751,3578704150,3578704191,41
2,505,1752,3578704150,3578704195,45
2,506,1753,3578704202,3578704202,0
2,506,1754,3578704202,3578704203,1
2,506,1755,3578704202,3578704208,6
2,506,1756,3578704202,3578704208,6
2,506,1757,3578704202,3578704208,6
2,506,1758,3578704202,3578704210,8
2,506,1759,3578704202,3578704216,14
2,506,1760,3578704202,3578704221,19
2,506,1761,3578704202,3578704221,19
2,506,1762,3578704202,3578704225,23
2,506,1763,3578704202,3578704226,24
2,506,1764,3578704202,3578704227,25
2,506,1765,3578704202,3578704235,33
2,506,1766,3578704202,3578704237,35
2,506,1767,3578704202,3578704238,36
2,506,1768,3578704202,3578704239,37
2,506,1769,3578704202,3578704240,38
2,506,1770,3578704202,3578704242,40
2,506,1771,3578704202,3578704245,43
2,506,1772,3578704202,3578704246,44
2,506,1773,3578704202,3578704249,47
2,507,1774,3578704254,3578704259,5
2,507,1775,3578704254,3578704261,7
2,507,1776,3578704254,3578704262,8
2,507,1777,3578704254,3578704264,10
2,507,1778,3578704254,3578704267,13
2,507,1779,3578704254,3578704267,13
2,507,1780,3578704254,3578704278,24
2,507,1781,3578704254,3578704279,25
2,507,1782,3578704254,3578704281,27
2,507,1783,3578704254,3578704284,30
2,507,1784,3578704254,3578704286,32
2,507,1785,3578704254,3578704290,36
2,507,1786,3578704254,3578704291,37
2,507,1787,3578704254,3578704294,40
2,507,1788,3578704254,3578704300,46
2,507,1789,3578704254,3578704303,49
2,508,1790,3578704306,3578704306,0
2,508,1791,3578704306,3578704308,2
2,508,1792,3578704306,3578704311,5
2,508,1793,3578704306,3578704312,6
2,508,1794,3578704306,3578704314,8
2,508,1795,3578704306,3578704314,8
2,508,1796,3578704306,3578704317,11
2,508,1797,3578704306,3578704317,11
2,508,1798,3578704306,3578704321,15
2,508,1799,3578704306,3578704327,21
2,508,1800,3578704306,3578704329,23
2,508,1801,3578704306,3578704331,25
2,508,1802,3578704306,3578704332,26
2,508,1803,3578704306,3578704335,29
2,508,1804,3578704306,3578704337,31
2,508,1805,3578704306,3578704348,42
2,508,1806,3578704306,3578704352,46
2,508,1807,3578704306,3578704355,49
2,509,1808,3578704358,3578704359,1
2,509,1809,3578704358,3578704367,9
2,509,1810,3578704358,3578704367,9
2,509,1811,3578704358,3578704377,19
2,509,1812,3578704358,3578704381,23
2,509,1813,3578704358,3578704391,33
2,509,1814,3578704358,3578704395,37
2,509,1815,3578704358,3578704400,42
2,509,1816,3578704358,3578704403,45
2,509,1817,3578704358,3578704408,50
2,510,1818,3578704410,3578704410,0
2,510,1819,3578704410,3578704410,0
2,510,1820,3578704410,3578704411,1
2,510,1821,3578704410,3578704415,5
2,510,1822,3578704410,3578704416,6
2,510,1823,3578704410,3578704421,11
2,510,1824,3578704410,3578704422,12
2,510,1825,3578704410,3578704424,14
2,510,1826,3578704410,3578704427,17
2,510,1827,3578704410,3578704427,17
2,510,1828,3578704410,3578704436,26
2,510,1829,3578704410,3578704437,27
2,510,1830,3578704410,3578704438,28
2,510,1831,3578704410,3578704438,28
2,510,1832,3578704410,3578704442,32
2,510,1833,3578704410,3578704442,32
2,510,1834,3578704410,3578704445,35
2,510,1835,3578704410,3578704446,36
2,510,1836,3578704410,3578704450,40
2,510,1837,3578704410,3578704458,48
2,511,1838,3578704462,3578704462,0
2,511,1839,3578704462,3578704462,0
2,511,1840,3578704462,3578704464,2
2,511,1841,3578704462,3578704467,5
2,511,1842,3578704462,3578704468,6
2,511,1843,3578704462,3578704477,15
2,511,1844,3578704462,3578704478,16
2,511,1845,3578704462,3578704481,19
2,511,1846,3578704462,3578704484,22
2,511,1847,3578704462,3578704487,25
2,511,1848,3578704462,3578704490,28
2,511,1849,3578704462,3578704490,28
2,511,1850,3578704462,3578704495,33
2,511,1851,3578704462,3578704500,38
2,511,1852,3578704462,3578704503,41
2,511,1853,3578704462,3578704507,45
2,511,1854,3578704462,3578704508,46
2,511,1855,3578704462,3578704511,49
2,511,1856,3578704462,3578704511,49
2,512,1857,3578704514,3578704514,0
2,512,1858,3578704514,3578704514,0
2,512,1859,3578704514,3578704516,2
2,512,1860,3578704514,3578704516,2
2,512,1861,3578704514,3578704520,6
2,512,1862,3578704514,3578704527,13
2,512,1863,3578704514,3578704529,15
2,512,1864,3578704514,3578704530,16
2,512,1865,3578704514,3578704531,17
2,512,1866,3578704514,3578704534,20
2,512,1867,3578704514,3578704537,23
2,512,1868,3578704514,3578704547,33
2,512,1869,3578704514,3578704550,36
2,512,1870,3578704514,3578704554,40
2,512,1871,3578704514,3578704559,45
2,513,1872,3578704566,3578704566,0
2,513,1873,3578704566,3578704566,0
2,513,1874,3578704566,3578704576,10
2,513,1875,3578704566,3578704581,15
2,513,1876,3578704566,3578704590,24
2,513,1877,3578704566,3578704595,29
2,513,1878,3578704566,3578704600,34
2,513,1879,3578704566,3578704602,36
2,513,1880,3578704566,3578704607,41
2,513,1881,3578704566,3578704607,41
2,513,1882,3578704566,3578704608,42
2,513,1883,3578704566,3578704610,44
2,513,1884,3578704566,3578704614,48
2,513,1885,3578704566,3578704615,49
2,514,1886,3578704618,3578704620,2
2,514,1887,3578704618,3578704621,3
2,514,1888,3578704618,3578704624,6
2,514,1889,3578704618,3578704626,8
2,514,1890,3578704618,3578704626,8
2,514,1891,3578704618,3578704635,17
2,514,1892,3578704618,3578704637,19
2,514,1893,3578704618,3578704638,20
2,514,1894,3578704618,3578704640,22
2,514,1895,3578704618,3578704641,23
2,514,1896,3578704618,3578704644,26
2,514,1897,3578704618,3578704646,28
2,514,1898,3578704618,3578704648,30
2,514,1899,3578704618,3578704658,40
2,514,1900,3578704618,3578704660,42
2,514,1901,3578704618,3578704661,43
2,514,1902,3578704618,3578704663,45
2,514,1903,3578704618,3578704666,48
2,514,1904,3578704618,3578704666,48
2,515,1905,3578704671,3578704677,6
2,515,1906,3578704671,3578704678,7
2,515,1907,3578704671,3578704682,11
2,515,1908,3578704671,3578704684,13
2,515,1909,3578704671,3578704686,15
2,515,1910,3578704671,3578704689,18
2,515,1911,3578704671,3578704690,19
2,515,1912,3578704671,3578704695,24
2,515,1913,3578704671,3578704700,29
2,515,1914,3578704671,3578704703,32
2,515,1915,3578704671,3578704707,36
2,515,1916,3578704671,3578704708,37
2,515,1917,3578704671,3578704711,40
2,515,1918,3578704671,3578704712,41
2,515,1919,3578704671,3578704713,42
2,515,1920,3578704671,3578704715,44
2,515,1921,3578704671,3578704716,45
2,515,1922,3578704671,3578704716,45
2,516,1923,3578704723,3578704723,0
2,516,1924,3578704723,3578704726,3
2,516,1925,3578704723,3578704730,7
2,516,1926,3578704723,3578704730,7
2,516,1927,3578704723,3578704735,12
2,516,1928,3578704723,3578704737,14
2,516,1929,3578704723,3578704748,25
2,516,1930,3578704723,3578704751,28
2,516,1931,3578704723,3578704754,31
2,516,1932,3578704723,3578704760,37
2,516,1933,3578704723,3578704765,42
2,516,1934,3578704723,3578704766,43
2,517,1935,3578704775,3578704777,2
2,517,1936,3578704775,3578704781,6
2,517,1937,3578704775,3578704790,15
2,517,1938,3578704775,3578704795,20
2,517,1939,3578704775,3578704800,25
2,517,1940,3578704775,3578704803,28
2,517,1941,3578704775,3578704807,32
2,517,1942,3578704775,3578704807,32
2,517,1943,3578704775,3578704809,34
2,517,1944,3578704775,3578704810,35
2,517,1945,3578704775,3578704814,39
2,517,1946,3578704775,3578704815,40
2,517,1947,3578704775,3578704820,45
2,517,1948,3578704775,3578704820,45
2,517,1949,3578704775,3578704821,46
2,517,1950,3578704775,3578704824,49
2,518,1951,3578704827,3578704827,0
2,518,1952,3578704827,3578704827,0
2,518,1953,3578704827,3578704835,8
2,518,1954,3578704827,3578704837,10
2,518,1955,3578704827,3578704838,11
2,518,1956,3578704827,3578704840,13
2,518,1957,3578704827,3578704841,14
2,518,1958,3578704827,3578704844,17
2,518,1959,3578704827,3578704846,19
2,518,1960,3578704827,3578704849,22
2,518,1961,3578704827,3578704858,31
2,518,1962,3578704827,3578704860,33
2,518,1963,3578704827,3578704860,33
2,518,1964,3578704827,3578704862,35
2,518,1965,3578704827,3578704865,38
2,518,1966,3578704827,3578704866,39
2,519,1967,3578704879,3578704879,0
2,519,1968,3578704879,3578704879,0
2,519,1969,3578704879,3578704882,3
2,519,1970,3578704879,3578704884,5
2,519,1971,3578704879,3578704886,7
2,519,1972,3578704879,3578704890,11
2,519,1973,3578704879,3578704890,11
2,519,1974,3578704879,3578704895,16
2,519,1975,3578704879,3578704901,22
2,519,1976,3578704879,3578704903,24
2,519,1977,3578704879,3578704907,28
2,519,1978,3578704879,3578704908,29
2,519,1979,3578704879,3578704911,32
2,519,1980,3578704879,3578704912,33
2,519,1981,3578704879,3578704914,35
2,519,1982,3578704879,3578704915,36
2,519,1983,3578704879,3578704916,37
2,519,1984,3578704879,3578704916,37
2,519,1985,3578704879,3578704921,42
2,519,1986,3578704879,3578704926,47
2,520,1987,3578704931,3578704931,0
2,520,1988,3578704931,3578704931,0
2,520,1989,3578704931,3578704935,4
2,520,1990,3578704931,3578704936,5
2,520,1991,3578704931,3578704947,16
2,520,1992,3578704931,3578704951,20
2,520,1993,3578704931,3578704954,23
2,520,1994,3578704931,3578704960,29
2,520,1995,3578704931,3578704965,34
2,520,1996,3578704931,3578704966,35
2,520,1997,3578704931,3578704977,46
2,521,1998,3578704983,3578704983,0
2,521,1999,3578704983,3578704990,7
2,521,2000,3578704983,3578704995,12
2,521,2001,3578704983,3578705000,17
2,521,2002,3578704983,3578705003,20
2,521,2003,3578704983,3578705007,24
2,521,2004,3578704983,3578705007,24
2,521,2005,3578704983,3578705009,26
2,521,2006,3578704983,3578705011,28
2,521,2007,3578704983,3578705014,31
2,521,2008,3578704983,3578705014,31
2,521,2009,3578704983,3578705020,37
2,521,2010,3578704983,3578705020,37
2,521,2011,3578704983,3578705022,39
2,521,2012,3578704983,3578705023,40
2,521,2013,3578704983,3578705025,42
2,521,2014,3578704983,3578705027,44
2,521,2015,3578704983,3578705028,45
2,522,2016,3578705035,3578705035,0
2,522,2017,3578705035,3578705036,1
2,522,2018,3578705035,3578705037,2
2,522,2019,3578705035,3578705038,3
2,522,2020,3578705035,3578705040,5
2,522,2021,3578705035,3578705041,6
2,522,2022,3578705035,3578705044,9
2,522,2023,3578705035,3578705046,11
2,522,2024,3578705035,3578705049,14
2,522,2025,3578705035,3578705058,23
2,522,2026,3578705035,3578705060,25
2,522,2027,3578705035,3578705061,26
2,522,2028,3578705035,3578705064,29
2,522,2029,3578705035,3578705066,31
2,522,2030,3578705035,3578705067,32
2,522,2031,3578705035,3578705078,43
2,522,2032,3578705035,3578705079,44
2,522,2033,3578705035,3578705082,47
2,522,2034,3578705035,3578705084,49
2,523,2035,3578705087,3578705087,0
2,523,2036,3578705087,3578705090,3
2,523,2037,3578705087,3578705090,3
2,523,2038,3578705087,3578705095,8
2,523,2039,3578705087,3578705101,14
2,523,2040,3578705087,3578705103,16
2,523,2041,3578705087,3578705107,20
2,523,2042,3578705087,3578705108,21
2,523,2043,3578705087,3578705111,24
2,523,2044,3578705087,3578705112,25
2,523,2045,3578705087,3578705113,26
2,523,2046,3578705087,3578705115,28
2,523,2047,3578705087,3578705116,29
2,523,2048,3578705087,3578705116,29
2,523,2049,3578705087,3578705121,34
2,523,2050,3578705087,3578705127,40
2,523,2051,3578705087,3578705130,43
2,523,2052,3578705087,3578705130,43
2,523,2053,3578705087,3578705131,44
2,523,2054,3578705087,3578705135,48
2,524,2055,3578705139,3578705139,0
2,524,2056,3578705139,3578705148,9
2,524,2057,3578705139,3578705151,12
2,524,2058,3578705139,3578705154,15
2,524,2059,3578705139,3578705160,21
2,524,2060,3578705139,3578705165,26
2,524,2061,3578705139,3578705166,27
2,524,2062,3578705139,3578705177,38
2,524,2063,3578705139,3578705181,42
2,525,2064,3578705191,3578705191,0
2,525,2065,3578705191,3578705195,4
2,525,2066,3578705191,3578705200,9
2,525,2067,3578705191,3578705203,12
2,525,2068,3578705191,3578705207,16
2,525,2069,3578705191,3578705208,17
2,525,2070,3578705191,3578705209,18
2,525,2071,3578705191,3578705211,20
2,525,2072,3578705191,3578705215,24
2,525,2073,3578705191,3578705216,25
2,525,2074,3578705191,3578705220,29
2,525,2075,3578705191,3578705221,30
2,525,2076,3578705191,3578705221,30
2,525,2077,3578705191,3578705222,31
2,525,2078,3578705191,3578705226,35
2,525,2079,3578705191,3578705227,36
2,525,2080,3578705191,3578705229,38
2,525,2081,3578705191,3578705235,44
2,525,2082,3578705191,3578705237,46
2,525,2083,3578705191,3578705237,46
2,525,2084,3578705191,3578705237,46
2,525,2085,3578705191,3578705240,49
2,526,2086,3578705244,3578705244,0
2,526,2087,3578705244,3578705244,0
2,526,2088,3578705244,3578705246,2
2,526,2089,3578705244,3578705249,5
2,526,2090,3578705244,3578705259,15
2,526,2091,3578705244,3578705260,16
2,526,2092,3578705244,3578705261,17
2,526,2093,3578705244,3578705263,19
2,526,2094,3578705244,3578705267,23
2,526,2095,3578705244,3578705267,23
2,526,2096,3578705244,3578705279,35
2,526,2097,3578705244,3578705279,35
2,526,2098,3578705244,3578705283,39
2,526,2099,3578705244,3578705284,40
2,526,2100,3578705244,3578705286,42
2,526,2101,3578705244,3578705290,46
2,526,2102,3578705244,3578705291,47
2,527,2103,3578705296,3578705296,0
2,527,2104,3578705296,3578705301,5
2,527,2105,3578705296,3578705303,7
2,527,2106,3578705296,3578705307,11
2,527,2107,3578705296,3578705308,12
2,527,2108,3578705296,3578705311,15
2,527,2109,3578705296,3578705311,15
2,527,2110,3578705296,3578705313,17
2,527,2111,3578705296,3578705315,19
2,527,2112,3578705296,3578705317,21
2,527,2113,3578705296,3578705317,21
2,527,2114,3578705296,3578705321,25
2,527,2115,3578705296,3578705328,32
2,527,2116,3578705296,3578705329,33
2,527,2117,3578705296,3578705331,35
2,527,2118,3578705296,3578705331,35
2,527,2119,3578705296,3578705335,39
2,527,2120,3578705296,3578705339,43
2,528,2121,3578705349,3578705349,0
2,528,2122,3578705349,3578705351,2
2,528,2123,3578705349,3578705355,6
2,528,2124,3578705349,3578705360,11
2,528,2125,3578705349,3578705367,18
2,528,2126,3578705349,3578705367,18
2,528,2127,3578705349,3578705377,28
2,528,2128,3578705349,3578705382,33
2,528,2129,3578705349,3578705390,41
2,528,2130,3578705349,3578705395,46
2,529,2131,3578705401,3578705401,0
2,529,2132,3578705401,3578705403,2
2,529,2133,3578705401,3578705407,6
2,529,2134,3578705401,3578705408,7
2,529,2135,3578705401,3578705409,8
2,529,2136,3578705401,3578705411,10
2,529,2137,3578705401,3578705415,14
2,529,2138,3578705401,3578705416,15
2,529,2139,3578705401,3578705419,18
2,529,2140,3578705401,3578705420,19
2,529,2141,3578705401,3578705422,21
2,529,2142,3578705401,3578705423,22
2,529,2143,3578705401,3578705426,25
2,529,2144,3578705401,3578705427,26
2,529,2145,3578705401,3578705428,27
2,529,2146,3578705401,3578705435,34
2,529,2147,3578705401,3578705436,35
2,529,2148,3578705401,3578705437,36
2,529,2149,3578705401,3578705438,37
2,529,2150,3578705401,3578705441,40
2,529,2151,3578705401,3578705442,41
2,529,2152,3578705401,3578705444,43
2,529,2153,3578705401,3578705446,45
2,529,2154,3578705401,3578705449,48
2,530,2155,3578705454,3578705459,5
2,530,2156,3578705454,3578705460,6
2,530,2157,3578705454,3578705461,7
2,530,2158,3578705454,3578705464,10
2,530,2159,3578705454,3578705467,13
2,530,2160,3578705454,3578705468,14
2,530,2161,3578705454,3578705479,25
2,530,2162,3578705454,3578705479,25
2,530,2163,3578705454,3578705482,28
2,530,2164,3578705454,3578705484,30
2,530,2165,3578705454,3578705486,32
2,530,2166,3578705454,3578705490,36
2,530,2167,3578705454,3578705490,36
2,530,2168,3578705454,3578705496,42
2,530,2169,3578705454,3578705501,47
2,530,2170,3578705454,3578705503,49
2,531,2171,3578705506,3578705506,0
2,531,2172,3578705506,3578705507,1
2,531,2173,3578705506,3578705510,4
2,531,2174,3578705506,3578705511,5
2,531,2175,3578705506,3578705513,7
2,531,2176,3578705506,3578705515,9
2,531,2177,3578705506,3578705515,9
2,531,2178,3578705506,3578705516,10
2,531,2179,3578705506,3578705520,14
2,531,2180,3578705506,3578705527,21
2,531,2181,3578705506,3578705530,24
2,531,2182,3578705506,3578705530,24
2,531,2183,3578705506,3578705531,25
2,531,2184,3578705506,3578705534,28
2,531,2185,3578705506,3578705538,32
2,531,2186,3578705506,3578705547,41
2,531,2187,3578705506,3578705550,44
2,531,2188,3578705506,3578705554,48
2,532,2189,3578705558,3578705558,0
2,532,2190,3578705558,3578705566,8
2,532,2191,3578705558,3578705566,8
2,532,2192,3578705558,3578705576,18
2,532,2193,3578705558,3578705581,23
2,532,2194,3578705558,3578705590,32
2,532,2195,3578705558,3578705595,37
2,532,2196,3578705558,3578705599,41
2,532,2197,3578705558,3578705602,44
2,532,2198,3578705558,3578705607,49
2,532,2199,3578705558,3578705607,49
2,533,2200,3578705610,3578705610,0
2,533,2201,3578705610,3578705611,1
2,533,2202,3578705610,3578705613,3
2,533,2203,3578705610,3578705615,5
2,533,2204,3578705610,3578705619,9
2,533,2205,3578705610,3578705620,10
2,533,2206,3578705610,3578705621,11
2,533,2207,3578705610,3578705622,12
2,533,2208,3578705610,3578705625,15
2,533,2209,3578705610,3578705626,16
2,533,2210,3578705610,3578705627,17
2,533,2211,3578705610,3578705635,25
2,533,2212,3578705610,3578705635,25
2,533,2213,3578705610,3578705637,27
2,533,2214,3578705610,3578705637,27
2,533,2215,3578705610,3578705640,30
2,533,2216,3578705610,3578705641,31
2,533,2217,3578705610,3578705643,33
2,533,2218,3578705610,3578705646,36
2,533,2219,3578705610,3578705648,38
2,533,2220,3578705610,3578705659,49
2,533,2221,3578705610,3578705659,49
2,533,2222,3578705610,3578705660,50
2,534,2223,3578705661,3578705662,1
2,534,2224,3578705661,3578705665,4
2,534,2225,3578705661,3578705667,6
2,534,2226,3578705661,3578705678,17
2,534,2227,3578705661,3578705679,18
2,534,2228,3578705661,3578705683,22
2,534,2229,3578705661,3578705684,23
2,534,2230,3578705661,3578705686,25
2,534,2231,3578705661,3578705690,29
2,534,2232,3578705661,3578705690,29
2,534,2233,3578705661,3578705696,35
2,534,2234,3578705661,3578705701,40
2,534,2235,3578705661,3578705703,42
2,534,2236,3578705661,3578705706,45
2,534,2237,3578705661,3578705707,46
2,534,2238,3578705661,3578705710,49
2,534,2239,3578705661,3578705711,50
2,535,2240,3578705713,3578705713,0
2,535,2241,3578705713,3578705714,1
2,535,2242,3578705713,3578705716,3
2,535,2243,3578705713,3578705716,3
2,535,2244,3578705713,3578705721,8
2,535,2245,3578705713,3578705727,14
2,535,2246,3578705713,3578705730,17
2,535,2247,3578705713,3578705730,17
2,535,2248,3578705713,3578705731,18
2,535,2249,3578705713,3578705735,22
2,535,2250,3578705713,3578705738,25
2,535,2251,3578705713,3578705748,35
2,535,2252,3578705713,3578705750,37
2,535,2253,3578705713,3578705754,41
2,535,2254,3578705713,3578705759,46
2,536,2255,3578705765,3578705765,0
2,536,2256,3578705765,3578705766,1
2,536,2257,3578705765,3578705776,11
2,536,2258,3578705765,3578705781,16
2,536,2259,3578705765,3578705783,18
2,536,2260,3578705765,3578705790,25
2,536,2261,3578705765,3578705795,30
2,536,2262,3578705765,3578705799,34
2,536,2263,3578705765,3578705803,38
2,536,2264,3578705765,3578705807,42
2,536,2265,3578705765,3578705807,42
2,536,2266,3578705765,3578705809,44
2,536,2267,3578705765,3578705812,47
2,536,2268,3578705765,3578705813,48
2,536,2269,3578705765,3578705814,49
2,537,2270,3578705817,3578705819,2
2,537,2271,3578705817,3578705819,2
2,537,2272,3578705817,3578705820,3
2,537,2273,3578705817,3578705822,5
2,537,2274,3578705817,3578705825,8
2,537,2275,3578705817,3578705826,9
2,537,2276,3578705817,3578705827,10
2,537,2277,3578705817,3578705835,18
2,537,2278,3578705817,3578705835,18
2,537,2279,3578705817,3578705836,19
2,537,2280,3578705817,3578705838,21
2,537,2281,3578705817,3578705840,23
2,537,2282,3578705817,3578705841,24
2,537,2283,3578705817,3578705842,25
2,537,2284,3578705817,3578705846,29
2,537,2285,3578705817,3578705849,32
2,537,2286,3578705817,3578705859,42
2,537,2287,3578705817,3578705860,43
2,537,2288,3578705817,3578705861,44
2,537,2289,3578705817,3578705862,45
2,537,2290,3578705817,3578705865,48
2,537,2291,3578705817,3578705867,50
2,538,2292,3578705869,3578705878,9
2,538,2293,3578705869,3578705879,10
2,538,2294,3578705869,3578705883,14
2,538,2295,3578705869,3578705883,14
2,538,2296,3578705869,3578705884,15
2,538,2297,3578705869,3578705886,17
2,538,2298,3578705869,3578705889,20
2,538,2299,3578705869,3578705891,22
2,538,2300,3578705869,3578705896,27
2,538,2301,3578705869,3578705901,32
2,538,2302,3578705869,3578705904,35
2,538,2303,3578705869,3578705905,36
2,538,2304,3578705869,3578705907,38
2,538,2305,3578705869,3578705911,42
2,538,2306,3578705869,3578705912,43
2,538,2307,3578705869,3578705913,44
2,538,2308,3578705869,3578705915,46
2,538,2309,3578705869,3578705915,46
2,538,2310,3578705869,3578705916,47
2,539,2311,3578705921,3578705922,1
2,539,2312,3578705921,3578705927,6
2,539,2313,3578705921,3578705929,8
2,539,2314,3578705921,3578705930,9
2,539,2315,3578705921,3578705931,10
2,539,2316,3578705921,3578705935,14
2,539,2317,3578705921,3578705939,18
2,539,2318,3578705921,3578705948,27
2,539,2319,3578705921,3578705950,29
2,539,2320,3578705921,3578705954,33
2,539,2321,3578705921,3578705959,38
2,539,2322,3578705921,3578705966,45
2,539,2323,3578705921,3578705966,45
2,540,2324,3578705973,3578705977,4
2,540,2325,3578705973,3578705981,8
2,540,2326,3578705973,3578705984,11
2,540,2327,3578705973,3578705990,17
2,540,2328,3578705973,3578705995,22
2,540,2329,3578705973,3578706000,27
2,540,2330,3578705973,3578706003,30
2,540,2331,3578705973,3578706007,34
2,540,2332,3578705973,3578706007,34
2,540,2333,3578705973,3578706009,36
2,540,2334,3578705973,3578706011,38
2,540,2335,3578705973,3578706013,40
2,540,2336,3578705973,3578706015,42
2,540,2337,3578705973,3578706019,46
2,540,2338,3578705973,3578706020,47
2,540,2339,3578705973,3578706020,47
2,540,2340,3578705973,3578706022,49
2,541,2341,3578706025,3578706025,0
2,541,2342,3578706025,3578706026,1
2,541,2343,3578706025,3578706027,2
2,541,2344,3578706025,3578706035,10
2,541,2345,3578706025,3578706036,11
2,541,2346,3578706025,3578706037,12
2,541,2347,3578706025,3578706038,13
2,541,2348,3578706025,3578706040,15
2,541,2349,3578706025,3578706041,16
2,541,2350,3578706025,3578706043,18
2,541,2351,3578706025,3578706045,20
2,541,2352,3578706025,3578706049,24
2,541,2353,3578706025,3578706059,34
2,541,2354,3578706025,3578706060,35
2,541,2355,3578706025,3578706061,36
2,541,2356,3578706025,3578706063,38
2,541,2357,3578706025,3578706066,41
2,541,2358,3578706025,3578706067,42
2,542,2359,3578706077,3578706079,2
2,542,2360,3578706077,3578706079,2
2,542,2361,3578706077,3578706083,6
2,542,2362,3578706077,3578706083,6
2,542,2363,3578706077,3578706084,7
2,542,2364,3578706077,3578706086,9
2,542,2365,3578706077,3578706089,12
2,542,2366,3578706077,3578706090,13
2,542,2367,3578706077,3578706096,19
2,542,2368,3578706077,3578706100,23
2,542,2369,3578706077,3578706104,27
2,542,2370,3578706077,3578706105,28
2,542,2371,3578706077,3578706107,30
2,542,2372,3578706077,3578706112,35
2,542,2373,3578706077,3578706112,35
2,542,2374,3578706077,3578706113,36
2,542,2375,3578706077,3578706114,37
2,542,2376,3578706077,3578706115,38
2,542,2377,3578706077,3578706115,38
2,542,2378,3578706077,3578706122,45
2,543,2379,3578706130,3578706130,0
2,543,2380,3578706130,3578706130,0
2,543,2381,3578706130,3578706130,0
2,543,2382,3578706130,3578706131,1
2,543,2383,3578706130,3578706135,5
2,543,2384,3578706130,3578706138,8
2,543,2385,3578706130,3578706148,18
2,543,2386,3578706130,3578706150,20
2,543,2387,3578706130,3578706155,25
2,543,2388,3578706130,3578706158,28
2,543,2389,3578706130,3578706166,36
2,543,2390,3578706130,3578706166,36
2,543,2391,3578706130,3578706177,47
2,544,2392,3578706182,3578706182,0
2,544,2393,3578706182,3578706184,2
2,544,2394,3578706182,3578706190,8
2,544,2395,3578706182,3578706195,13
2,544,2396,3578706182,3578706200,18
2,544,2397,3578706182,3578706203,21
2,544,2398,3578706182,3578706207,25
2,544,2399,3578706182,3578706207,25
2,544,2400,3578706182,3578706208,26
2,544,2401,3578706182,3578706211,29
2,544,2402,3578706182,3578706215,33
2,544,2403,3578706182,3578706216,34
2,544,2404,3578706182,3578706219,37
2,544,2405,3578706182,3578706220,38
2,544,2406,3578706182,3578706221,39
2,544,2407,3578706182,3578706223,41
2,544,2408,3578706182,3578706224,42
2,544,2409,3578706182,3578706227,45
2,544,2410,3578706182,3578706227,45
2,545,2411,3578706234,3578706235,1
2,545,2412,3578706234,3578706236,2
2,545,2413,3578706234,3578706237,3
2,545,2414,3578706234,3578706238,4
2,545,2415,3578706234,3578706240,6
2,545,2416,3578706234,3578706242,8
2,545,2417,3578706234,3578706243,9
2,545,2418,3578706234,3578706246,12
2,545,2419,3578706234,3578706249,15
2,545,2420,3578706234,3578706258,24
2,545,2421,3578706234,3578706260,26
2,545,2422,3578706234,3578706261,27
2,545,2423,3578706234,3578706263,29
2,545,2424,3578706234,3578706267,33
2,545,2425,3578706234,3578706268,34
2,545,2426,3578706234,3578706279,45
2,545,2427,3578706234,3578706279,45
2,545,2428,3578706234,3578706283,49
2,545,2429,3578706234,3578706283,49
2,545,2430,3578706234,3578706284,50
2,546,2431,3578706286,3578706286,0
2,546,2432,3578706286,3578706290,4
2,546,2433,3578706286,3578706290,4
2,546,2434,3578706286,3578706296,10
2,546,2435,3578706286,3578706301,15
2,546,2436,3578706286,3578706303,17
2,546,2437,3578706286,3578706306,20
2,546,2438,3578706286,3578706307,21
2,546,2439,3578706286,3578706311,25
2,546,2440,3578706286,3578706314,28
2,546,2441,3578706286,3578706315,29
2,546,2442,3578706286,3578706317,31
2,546,2443,3578706286,3578706317,31
2,546,2444,3578706286,3578706322,36
2,546,2445,3578706286,3578706327,41
2,546,2446,3578706286,3578706329,43
2,546,2447,3578706286,3578706331,45
2,546,2448,3578706286,3578706331,45
2,546,2449,3578706286,3578706335,49
2,547,2450,3578706339,3578706339,0
2,547,2451,3578706339,3578706348,9
2,547,2452,3578706339,3578706350,11
2,547,2453,3578706339,3578706355,16
2,547,2454,3578706339,3578706358,19
2,547,2455,3578706339,3578706367,28
2,547,2456,3578706339,3578706367,28
2,547,2457,3578706339,3578706377,38
2,547,2458,3578706339,3578706382,43
2,547,2459,3578706339,3578706383,44
2,548,2460,3578706392,3578706392,0
2,548,2461,3578706392,3578706392,0
2,548,2462,3578706392,3578706395,3
2,548,2463,3578706392,3578706400,8
2,548,2464,3578706392,3578706404,12
2,548,2465,3578706392,3578706407,15
2,548,2466,3578706392,3578706408,16
2,548,2467,3578706392,3578706409,17
2,548,2468,3578706392,3578706411,19
2,548,2469,3578706392,3578706414,22
2,548,2470,3578706392,3578706416,24
2,548,2471,3578706392,3578706419,27
2,548,2472,3578706392,3578706421,29
2,548,2473,3578706392,3578706422,30
2,548,2474,3578706392,3578706423,31
2,548,2475,3578706392,3578706425,33
2,548,2476,3578706392,3578706428,36
2,548,2477,3578706392,3578706428,36
2,548,2478,3578706392,3578706434,42
2,548,2479,3578706392,3578706436,44
2,548,2480,3578706392,3578706438,46
2,548,2481,3578706392,3578706438,46
2,548,2482,3578706392,3578706441,49
2,548,2483,3578706392,3578706442,50
2,549,2484,3578706445,3578706445,0
2,549,2485,3578706445,3578706445,0
2,549,2486,3578706445,3578706449,4
2,549,2487,3578706445,3578706459,14
2,549,2488,3578706445,3578706460,15
2,549,2489,3578706445,3578706461,16
2,549,2490,3578706445,3578706464,19
2,549,2491,3578706445,3578706466,21
2,549,2492,3578706445,3578706468,23
2,549,2493,3578706445,3578706479,34
2,549,2494,3578706445,3578706480,35
2,549,2495,3578706445,3578706482,37
2,549,2496,3578706445,3578706484,39
2,549,2497,3578706445,3578706484,39
2,549,2498,3578706445,3578706487,42
2,549,2499,3578706445,3578706489,44
2,549,2500,3578706445,3578706490,45
2,550,2501,3578706498,3578706498,0
2,550,2502,3578706498,3578706502,4
2,550,2503,3578706498,3578706506,8
2,550,2504,3578706498,3578706507,9
2,550,2505,3578706498,3578706511,13
2,550,2506,3578706498,3578706513,15
2,550,2507,3578706498,3578706513,15
2,550,2508,3578706498,3578706515,17
2,550,2509,3578706498,3578706516,18
2,550,2510,3578706498,3578706521,23
2,550,2511,3578706498,3578706526,28
2,550,2512,3578706498,3578706529,31
2,550,2513,3578706498,3578706530,32
2,550,2514,3578706498,3578706531,33
2,550,2515,3578706498,3578706534,36
2,550,2516,3578706498,3578706538,40
2,550,2517,3578706498,3578706546,48
2,551,2518,3578706551,3578706551,0
2,551,2519,3578706551,3578706554,3
2,551,2520,3578706551,3578706557,6
2,551,2521,3578706551,3578706566,15
2,551,2522,3578706551,3578706566,15
2,551,2523,3578706551,3578706576,25
2,551,2524,3578706551,3578706581,30
2,551,2525,3578706551,3578706582,31
2,551,2526,3578706551,3578706589,38
2,551,2527,3578706551,3578706590,39
2,551,2528,3578706551,3578706591,40
2,551,2529,3578706551,3578706595,44
2,551,2530,3578706551,3578706599,48
2,552,2531,3578706603,3578706603,0
2,552,2532,3578706603,3578706606,3
2,552,2533,3578706603,3578706607,4
2,552,2534,3578706603,3578706608,5
2,552,2535,3578706603,3578706610,7
2,552,2536,3578706603,3578706613,10
2,552,2537,3578706603,3578706615,12
2,552,2538,3578706603,3578706618,15
2,552,2539,3578706603,3578706619,16
2,552,2540,3578706603,3578706620,17
2,552,2541,3578706603,3578706623,20
2,552,2542,3578706603,3578706623,20
2,552,2543,3578706603,3578706626,23
2,552,2544,3578706603,3578706627,24
2,552,2545,3578706603,3578706634,31
2,552,2546,3578706603,3578706636,33
2,552,2547,3578706603,3578706636,33
2,552,2548,3578706603,3578706637,34
2,552,2549,3578706603,3578706640,37
2,552,2550,3578706603,3578706641,38
2,552,2551,3578706603,3578706642,39
2,552,2552,3578706603,3578706643,40
2,552,2553,3578706603,3578706646,43
2,552,2554,3578706603,3578706649,46
2,553,2555,3578706655,3578706658,3
2,553,2556,3578706655,3578706659,4
2,553,2557,3578706655,3578706660,5
2,553,2558,3578706655,3578706662,7
2,553,2559,3578706655,3578706666,11
2,553,2560,3578706655,3578706666,11
2,553,2561,3578706655,3578706678,23
2,553,2562,3578706655,3578706680,25
2,553,2563,3578706655,3578706683,28
2,553,2564,3578706655,3578706684,29
2,553,2565,3578706655,3578706684,29
2,553,2566,3578706655,3578706686,31
2,553,2567,3578706655,3578706689,34
2,553,2568,3578706655,3578706691,36
2,553,2569,3578706655,3578706696,41
2,553,2570,3578706655,3578706703,48
2,554,2571,3578706708,3578706708,0
2,554,2572,3578706708,3578706708,0
2,554,2573,3578706708,3578706710,2
2,554,2574,3578706708,3578706711,3
2,554,2575,3578706708,3578706713,5
2,554,2576,3578706708,3578706713,5
2,554,2577,3578706708,3578706716,8
2,554,2578,3578706708,3578706716,8
2,554,2579,3578706708,3578706721,13
2,554,2580,3578706708,3578706727,19
2,554,2581,3578706708,3578706730,22
2,554,2582,3578706708,3578706730,22
2,554,2583,3578706708,3578706732,24
2,554,2584,3578706708,3578706735,27
2,554,2585,3578706708,3578706738,30
2,554,2586,3578706708,3578706748,40
2,554,2587,3578706708,3578706749,41
2,554,2588,3578706708,3578706754,46
2,554,2589,3578706708,3578706757,49
2,555,2590,3578706761,3578706766,5
2,555,2591,3578706761,3578706766,5
2,555,2592,3578706761,3578706776,15
2,555,2593,3578706761,3578706781,20
2,555,2594,3578706761,3578706782,21
2,555,2595,3578706761,3578706790,29
2,555,2596,3578706761,3578706790,29
2,555,2597,3578706761,3578706792,31
2,555,2598,3578706761,3578706795,34
2,555,2599,3578706761,3578706797,36
2,555,2600,3578706761,3578706799,38
2,555,2601,3578706761,3578706802,41
2,555,2602,3578706761,3578706806,45
2,555,2603,3578706761,3578706807,46
2,555,2604,3578706761,3578706808,47
2,555,2605,3578706761,3578706810,49
2,556,2606,3578706814,3578706814,0
2,556,2607,3578706814,3578706815,1
2,556,2608,3578706814,3578706818,4
2,556,2609,3578706814,3578706820,6
2,556,2610,3578706814,3578706820,6
2,556,2611,3578706814,3578706823,9
2,556,2612,3578706814,3578706824,10
2,556,2613,3578706814,3578706826,12
2,556,2614,3578706814,3578706826,12
2,556,2615,3578706814,3578706834,20
2,556,2616,3578706814,3578706835,21
2,556,2617,3578706814,3578706836,22
2,556,2618,3578706814,3578706838,24
2,556,2619,3578706814,3578706840,26
2,556,2620,3578706814,3578706841,27
2,556,2621,3578706814,3578706842,28
2,556,2622,3578706814,3578706843,29
2,556,2623,3578706814,3578706847,33
2,556,2624,3578706814,3578706849,35
2,556,2625,3578706814,3578706858,44
2,556,2626,3578706814,3578706860,46
2,556,2627,3578706814,3578706861,47
2,556,2628,3578706814,3578706862,48
2,557,2629,3578706867,3578706867,0
2,557,2630,3578706867,3578706867,0
2,557,2631,3578706867,3578706878,11
2,557,2632,3578706867,3578706880,13
2,557,2633,3578706867,3578706882,15
2,557,2634,3578706867,3578706883,16
2,557,2635,3578706867,3578706884,17
2,557,2636,3578706867,3578706886,19
2,557,2637,3578706867,3578706890,23
2,557,2638,3578706867,3578706890,23
2,557,2639,3578706867,3578706896,29
2,557,2640,3578706867,3578706900,33
2,557,2641,3578706867,3578706903,36
2,557,2642,3578706867,3578706906,39
2,557,2643,3578706867,3578706908,41
2,557,2644,3578706867,3578706911,44
2,557,2645,3578706867,3578706912,45
2,557,2646,3578706867,3578706914,47
2,557,2647,3578706867,3578706916,49
2,557,2648,3578706867,3578706916,49
2,558,2649,3578706919,3578706921,2
2,558,2650,3578706919,3578706926,7
2,558,2651,3578706919,3578706929,10
2,558,2652,3578706919,3578706930,11
2,558,2653,3578706919,3578706932,13
2,558,2654,3578706919,3578706935,16
2,558,2655,3578706919,3578706938,19
2,558,2656,3578706919,3578706948,29
2,558,2657,3578706919,3578706950,31
2,558,2658,3578706919,3578706954,35
2,558,2659,3578706919,3578706958,39
2,558,2660,3578706919,3578706965,46
2,558,2661,3578706919,3578706966,47
2,559,2662,3578706971,3578706977,6
2,559,2663,3578706971,3578706981,10
2,559,2664,3578706971,3578706983,12
2,559,2665,3578706971,3578706990,19
2,559,2666,3578706971,3578706990,19
2,559,2667,3578706971,3578706992,21
2,559,2668,3578706971,3578706995,24
2,559,2669,3578706971,3578706997,26
2,559,2670,3578706971,3578707000,29
2,559,2671,3578706971,3578707003,32
2,559,2672,3578706971,3578707006,35
2,559,2673,3578706971,3578707007,36
2,559,2674,3578706971,3578707008,37
2,559,2675,3578706971,3578707010,39
2,559,2676,3578706971,3578707013,42
2,559,2677,3578706971,3578707016,45
2,559,2678,3578706971,3578707018,47
2,559,2679,3578706971,3578707019,48
2,559,2680,3578706971,3578707021,50
2,560,2681,3578707023,3578707024,1
2,560,2682,3578707023,3578707025,2
2,560,2683,3578707023,3578707026,3
2,560,2684,3578707023,3578707027,4
2,560,2685,3578707023,3578707033,10
2,560,2686,3578707023,3578707037,14
2,560,2687,3578707023,3578707037,14
2,560,2688,3578707023,3578707038,15
2,560,2689,3578707023,3578707040,17
2,560,2690,3578707023,3578707041,18
2,560,2691,3578707023,3578707042,19
2,560,2692,3578707023,3578707043,20
2,560,2693,3578707023,3578707047,24
2,560,2694,3578707023,3578707049,26
2,560,2695,3578707023,3578707058,35
2,560,2696,3578707023,3578707060,37
2,560,2697,3578707023,3578707061,38
2,560,2698,3578707023,3578707063,40
2,560,2699,3578707023,3578707066,43
2,560,2700,3578707023,3578707066,43
2,561,2701,3578707076,3578707078,2
2,561,2702,3578707076,3578707080,4
2,561,2703,3578707076,3578707083,7
2,561,2704,3578707076,3578707083,7
2,561,2705,3578707076,3578707084,8
2,561,2706,3578707076,3578707086,10
2,561,2707,3578707076,3578707090,14
2,561,2708,3578707076,3578707090,14
2,561,2709,3578707076,3578707096,20
2,561,2710,3578707076,3578707099,23
2,561,2711,3578707076,3578707103,27
2,561,2712,3578707076,3578707106,30
2,561,2713,3578707076,3578707108,32
2,561,2714,3578707076,3578707111,35
2,561,2715,3578707076,3578707111,35
2,561,2716,3578707076,3578707114,38
2,561,2717,3578707076,3578707114,38
2,561,2718,3578707076,3578707116,40
2,561,2719,3578707076,3578707116,40
2,561,2720,3578707076,3578707121,45
2,562,2721,3578707129,3578707129,0
2,562,2722,3578707129,3578707129,0
2,562,2723,3578707129,3578707130,1
2,562,2724,3578707129,3578707131,2
2,562,2725,3578707129,3578707136,7
2,562,2726,3578707129,3578707137,8
2,562,2727,3578707129,3578707148,19
2,562,2728,3578707129,3578707150,21
2,562,2729,3578707129,3578707154,25
2,562,2730,3578707129,3578707157,28
2,562,2731,3578707129,3578707166,37
2,562,2732,3578707129,3578707167,38
2,562,2733,3578707129,3578707177,48
2,563,2734,3578707182,3578707182,0
2,563,2735,3578707182,3578707183,1
2,563,2736,3578707182,3578707190,8
2,563,2737,3578707182,3578707190,8
2,563,2738,3578707182,3578707191,9
2,563,2739,3578707182,3578707195,13
2,563,2740,3578707182,3578707197,15
2,563,2741,3578707182,3578707200,18
2,563,2742,3578707182,3578707204,22
2,563,2743,3578707182,3578707206,24
2,563,2744,3578707182,3578707207,25
2,563,2745,3578707182,3578707209,27
2,563,2746,3578707182,3578707211,29
2,563,2747,3578707182,3578707214,32
2,563,2748,3578707182,3578707215,33
2,563,2749,3578707182,3578707219,37
2,563,2750,3578707182,3578707220,38
2,563,2751,3578707182,3578707220,38
2,563,2752,3578707182,3578707224,42
2,563,2753,3578707182,3578707225,43
2,563,2754,3578707182,3578707227,45
2,563,2755,3578707182,3578707227,45
2,564,2756,3578707234,3578707234,0
2,564,2757,3578707234,3578707237,3
2,564,2758,3578707234,3578707237,3
2,564,2759,3578707234,3578707237,3
2,564,2760,3578707234,3578707240,6
2,564,2761,3578707234,3578707242,8
2,564,2762,3578707234,3578707243,9
2,564,2763,3578707234,3578707243,9
2,564,2764,3578707234,3578707247,13
2,564,2765,3578707234,3578707250,16
2,564,2766,3578707234,3578707259,25
2,564,2767,3578707234,3578707260,26
2,564,2768,3578707234,3578707261,27
2,564,2769,3578707234,3578707263,29
2,564,2770,3578707234,3578707267,33
2,564,2771,3578707234,3578707267,33
2,564,2772,3578707234,3578707279,45
2,564,2773,3578707234,3578707280,46
2,564,2774,3578707234,3578707283,49
2,564,2775,3578707234,3578707284,50
2,565,2776,3578707287,3578707287,0
2,565,2777,3578707287,3578707287,0
2,565,2778,3578707287,3578707290,3
2,565,2779,3578707287,3578707290,3
2,565,2780,3578707287,3578707296,9
2,565,2781,3578707287,3578707300,13
2,565,2782,3578707287,3578707304,17
2,565,2783,3578707287,3578707306,19
2,565,2784,3578707287,3578707308,21
2,565,2785,3578707287,3578707311,24
2,565,2786,3578707287,3578707312,25
2,565,2787,3578707287,3578707313,26
2,565,2788,3578707287,3578707314,27
2,565,2789,3578707287,3578707316,29
2,565,2790,3578707287,3578707317,30
2,565,2791,3578707287,3578707321,34
2,565,2792,3578707287,3578707327,40
2,565,2793,3578707287,3578707329,42
2,565,2794,3578707287,3578707331,44
2,565,2795,3578707287,3578707332,45
2,565,2796,3578707287,3578707336,49
2,565,2797,3578707287,3578707337,50
2,566,2798,3578707340,3578707348,8
2,566,2799,3578707340,3578707350,10
2,566,2800,3578707340,3578707353,13
2,566,2801,3578707340,3578707355,15
2,566,2802,3578707340,3578707358,18
2,566,2803,3578707340,3578707366,26
2,566,2804,3578707340,3578707367,27
2,566,2805,3578707340,3578707377,37
2,566,2806,3578707340,3578707381,41
2,566,2807,3578707340,3578707382,42
2,567,2808,3578707392,3578707392,0
2,567,2809,3578707392,3578707392,0
2,567,2810,3578707392,3578707392,0
2,567,2811,3578707392,3578707396,4
2,567,2812,3578707392,3578707397,5
2,567,2813,3578707392,3578707399,7
2,567,2814,3578707392,3578707404,12
2,567,2815,3578707392,3578707405,13
2,567,2816,3578707392,3578707407,15
2,567,2817,3578707392,3578707407,15
2,567,2818,3578707392,3578707410,18
2,567,2819,3578707392,3578707411,19
2,567,2820,3578707392,3578707415,23
2,567,2821,3578707392,3578707416,24
2,567,2822,3578707392,3578707418,26
2,567,2823,3578707392,3578707419,27
2,567,2824,3578707392,3578707421,29
2,567,2825,3578707392,3578707424,32
2,567,2826,3578707392,3578707426,34
2,567,2827,3578707392,3578707427,35
2,567,2828,3578707392,3578707427,35
2,567,2829,3578707392,3578707433,41
2,567,2830,3578707392,3578707436,44
2,567,2831,3578707392,3578707437,45
2,567,2832,3578707392,3578707437,45
2,567,2833,3578707392,3578707441,49
2,567,2834,3578707392,3578707442,50
2,568,2835,3578707445,3578707445,0
2,568,2836,3578707445,3578707445,0
2,568,2837,3578707445,3578707447,2
2,568,2838,3578707445,3578707459,14
2,568,2839,3578707445,3578707460,15
2,568,2840,3578707445,3578707461,16
2,568,2841,3578707445,3578707463,18
2,568,2842,3578707445,3578707468,23
2,568,2843,3578707445,3578707468,23
2,568,2844,3578707445,3578707479,34
2,568,2845,3578707445,3578707480,35
2,568,2846,3578707445,3578707483,38
2,568,2847,3578707445,3578707483,38
2,568,2848,3578707445,3578707484,39
2,568,2849,3578707445,3578707486,41
2,568,2850,3578707445,3578707490,45
2,568,2851,3578707445,3578707490,45
2,569,2852,3578707497,3578707497,0
2,569,2853,3578707497,3578707498,1
2,569,2854,3578707497,3578707502,5
2,569,2855,3578707497,3578707506,9
2,569,2856,3578707497,3578707507,10
2,569,2857,3578707497,3578707510,13
2,569,2858,3578707497,3578707510,13
2,569,2859,3578707497,3578707512,15
2,569,2860,3578707497,3578707513,16
2,569,2861,3578707497,3578707515,18
2,569,2862,3578707497,3578707516,19
2,569,2863,3578707497,3578707520,23
2,569,2864,3578707497,3578707526,29
2,569,2865,3578707497,3578707529,32
2,569,2866,3578707497,3578707531,34
2,569,2867,3578707497,3578707535,38
2,569,2868,3578707497,3578707537,40
2,569,2869,3578707497,3578707547,50
2,570,2870,3578707549,3578707549,0
2,570,2871,3578707549,3578707553,4
2,570,2872,3578707549,3578707554,5
2,570,2873,3578707549,3578707557,8
2,570,2874,3578707549,3578707566,17
2,570,2875,3578707549,3578707566,17
2,570,2876,3578707549,3578707575,26
2,570,2877,3578707549,3578707581,32
2,570,2878,3578707549,3578707581,32
2,570,2879,3578707549,3578707589,40
2,570,2880,3578707549,3578707590,41
2,570,2881,3578707549,3578707591,42
2,570,2882,3578707549,3578707595,46
2,570,2883,3578707549,3578707596,47
2,570,2884,3578707549,3578707599,50
2,571,2885,3578707602,3578707603,1
2,571,2886,3578707602,3578707604,2
2,571,2887,3578707602,3578707606,4
2,571,2888,3578707602,3578707607,5
2,571,2889,3578707602,3578707608,6
2,571,2890,3578707602,3578707610,8
2,571,2891,3578707602,3578707614,12
2,571,2892,3578707602,3578707615,13
2,571,2893,3578707602,3578707619,17
2,571,2894,3578707602,3578707619,17
2,571,2895,3578707602,3578707620,18
2,571,2896,3578707602,3578707623,21
2,571,2897,3578707602,3578707624,22
2,571,2898,3578707602,3578707626,24
2,571,2899,3578707602,3578707626,24
2,571,2900,3578707602,3578707634,32
2,571,2901,3578707602,3578707635,33
2,571,2902,3578707602,3578707636,34
2,571,2903,3578707602,3578707637,35
2,571,2904,3578707602,3578707640,38
2,571,2905,3578707602,3578707641,39
2,571,2906,3578707602,3578707642,40
2,571,2907,3578707602,3578707643,41
2,571,2908,3578707602,3578707646,44
2,572,2909,3578707654,3578707658,4
2,572,2910,3578707654,3578707659,5
2,572,2911,3578707654,3578707660,6
2,572,2912,3578707654,3578707662,8
2,572,2913,3578707654,3578707666,12
2,572,2914,3578707654,3578707668,14
2,572,2915,3578707654,3578707679,25
2,572,2916,3578707654,3578707681,27
2,572,2917,3578707654,3578707683,29
2,572,2918,3578707654,3578707684,30
2,572,2919,3578707654,3578707685,31
2,572,2920,3578707654,3578707686,32
2,572,2921,3578707654,3578707690,36
2,572,2922,3578707654,3578707690,36
2,572,2923,3578707654,3578707697,43
2,572,2924,3578707654,3578707699,45
2,572,2925,3578707654,3578707702,48
2,573,2926,3578707707,3578707707,0
2,573,2927,3578707707,3578707707,0
2,573,2928,3578707707,3578707709,2
2,573,2929,3578707707,3578707710,3
2,573,2930,3578707707,3578707711,4
2,573,2931,3578707707,3578707712,5
2,573,2932,3578707707,3578707713,6
2,573,2933,3578707707,3578707716,9
2,573,2934,3578707707,3578707716,9
2,573,2935,3578707707,3578707721,14
2,573,2936,3578707707,3578707727,20
2,573,2937,3578707707,3578707729,22
2,573,2938,3578707707,3578707731,24
2,573,2939,3578707707,3578707735,28
2,573,2940,3578707707,3578707736,29
2,573,2941,3578707707,3578707748,41
2,573,2942,3578707707,3578707749,42
2,573,2943,3578707707,3578707753,46
2,573,2944,3578707707,3578707754,47
2,574,2945,3578707760,3578707760,0
2,574,2946,3578707760,3578707760,0
2,574,2947,3578707760,3578707766,6
2,574,2948,3578707760,3578707766,6
2,574,2949,3578707760,3578707776,16
2,574,2950,3578707760,3578707781,21
2,574,2951,3578707760,3578707781,21
2,574,2952,3578707760,3578707789,29
2,574,2953,3578707760,3578707789,29
2,574,2954,3578707760,3578707790,30
2,574,2955,3578707760,3578707795,35
2,574,2956,3578707760,3578707797,37
2,574,2957,3578707760,3578707799,39
2,574,2958,3578707760,3578707803,43
2,574,2959,3578707760,3578707804,44
2,574,2960,3578707760,3578707806,46
2,574,2961,3578707760,3578707806,46
2,574,2962,3578707760,3578707808,48
2,574,2963,3578707760,3578707810,50
2,575,2964,3578707813,3578707815,2
2,575,2965,3578707813,3578707815,2
2,575,2966,3578707813,3578707818,5
2,575,2967,3578707813,3578707819,6
2,575,2968,3578707813,3578707819,6
2,575,2969,3578707813,3578707823,10
2,575,2970,3578707813,3578707825,12
2,575,2971,3578707813,3578707826,13
2,575,2972,3578707813,3578707827,14
2,575,2973,3578707813,3578707834,21
2,575,2974,3578707813,3578707835,22
2,575,2975,3578707813,3578707836,23
2,575,2976,3578707813,3578707840,27
2,575,2977,3578707813,3578707842,29
2,575,2978,3578707813,3578707842,29
2,575,2979,3578707813,3578707846,33
2,575,2980,3578707813,3578707858,45
2,575,2981,3578707813,3578707860,47
2,575,2982,3578707813,3578707861,48
2,576,2983,3578707866,3578707866,0
2,576,2984,3578707866,3578707866,0
2,576,2985,3578707866,3578707867,1
2,576,2986,3578707866,3578707878,12
2,576,2987,3578707866,3578707880,14
2,576,2988,3578707866,3578707883,17
2,576,2989,3578707866,3578707883,17
2,576,2990,3578707866,3578707884,18
2,576,2991,3578707866,3578707886,20
2,576,2992,3578707866,3578707890,24
2,576,2993,3578707866,3578707890,24
2,576,2994,3578707866,3578707897,31
2,576,2995,3578707866,3578707899,33
2,576,2996,3578707866,3578707903,37
2,576,2997,3578707866,3578707906,40
2,576,2998,3578707866,3578707907,41
2,576,2999,3578707866,3578707908,42
2,576,3000,3578707866,3578707911,45
2,576,3001,3578707866,3578707912,46
2,576,3002,3578707866,3578707912,46
2,576,3003,3578707866,3578707913,47
2,576,3004,3578707866,3578707916,50
2,577,3005,3578707918,3578707918,0
2,577,3006,3578707918,3578707921,3
2,577,3007,3578707918,3578707927,9
2,577,3008,3578707918,3578707930,12
2,577,3009,3578707918,3578707932,14
2,577,3010,3578707918,3578707935,17
2,577,3011,3578707918,3578707937,19
2,577,3012,3578707918,3578707949,31
2,577,3013,3578707918,3578707950,32
2,577,3014,3578707918,3578707953,35
2,577,3015,3578707918,3578707954,36
2,577,3016,3578707918,3578707957,39
2,577,3017,3578707918,3578707959,41
2,577,3018,3578707918,3578707965,47
2,577,3019,3578707918,3578707966,48
2,578,3020,3578707971,3578707977,6
2,578,3021,3578707971,3578707981,10
2,578,3022,3578707971,3578707981,10
2,578,3023,3578707971,3578707989,18
2,578,3024,3578707971,3578707990,19
2,578,3025,3578707971,3578707991,20
2,578,3026,3578707971,3578707995,24
2,578,3027,3578707971,3578707997,26
2,578,3028,3578707971,3578708000,29
2,578,3029,3578707971,3578708004,33
2,578,3030,3578707971,3578708004,33
2,578,3031,3578707971,3578708006,35
2,578,3032,3578707971,3578708007,36
2,578,3033,3578707971,3578708009,38
2,578,3034,3578707971,3578708011,40
2,578,3035,3578707971,3578708014,43
2,578,3036,3578707971,3578708014,43
2,578,3037,3578707971,3578708019,48
2,578,3038,3578707971,3578708020,49
2,578,3039,3578707971,3578708020,49
2,579,3040,3578708024,3578708024,0
2,579,3041,3578708024,3578708024,0
2,579,3042,3578708024,3578708027,3
2,579,3043,3578708024,3578708027,3
2,579,3044,3578708024,3578708034,10
2,579,3045,3578708024,3578708036,12
2,579,3046,3578708024,3578708037,13
2,579,3047,3578708024,3578708040,16
2,579,3048,3578708024,3578708041,17
2,579,3049,3578708024,3578708042,18
2,579,3050,3578708024,3578708043,19
2,579,3051,3578708024,3578708046,22
2,579,3052,3578708024,3578708058,34
2,579,3053,3578708024,3578708060,36
2,579,3054,3578708024,3578708061,37
2,579,3055,3578708024,3578708063,39
2,579,3056,3578708024,3578708067,43
2,579,3057,3578708024,3578708067,43
2,580,3058,3578708077,3578708079,2
2,580,3059,3578708077,3578708081,4
2,580,3060,3578708077,3578708083,6
2,580,3061,3578708077,3578708084,7
2,580,3062,3578708077,3578708084,7
2,580,3063,3578708077,3578708087,10
2,580,3064,3578708077,3578708090,13
2,580,3065,3578708077,3578708090,13
2,580,3066,3578708077,3578708096,19
2,580,3067,3578708077,3578708100,23
2,580,3068,3578708077,3578708102,25
2,580,3069,3578708077,3578708106,29
2,580,3070,3578708077,3578708107,30
2,580,3071,3578708077,3578708109,32
2,580,3072,3578708077,3578708111,34
2,580,3073,3578708077,3578708111,34
2,580,3074,3578708077,3578708113,36
2,580,3075,3578708077,3578708113,36
2,580,3076,3578708077,3578708113,36
2,580,3077,3578708077,3578708115,38
2,580,3078,3578708077,3578708115,38
2,580,3079,3578708077,3578708121,44
2,580,3080,3578708077,3578708127,50
2,581,3081,3578708130,3578708130,0
2,581,3082,3578708130,3578708131,1
2,581,3083,3578708130,3578708135,5
2,581,3084,3578708130,3578708138,8
2,581,3085,3578708130,3578708149,19
2,581,3086,3578708130,3578708150,20
2,581,3087,3578708130,3578708153,23
2,581,3088,3578708130,3578708154,24
2,581,3089,3578708130,3578708157,27
2,581,3090,3578708130,3578708159,29
2,581,3091,3578708130,3578708164,34
2,581,3092,3578708130,3578708166,36
2,581,3093,3578708130,3578708167,37
2,581,3094,3578708130,3578708177,47
2,582,3095,3578708184,3578708184,0
2,582,3096,3578708184,3578708184,0
2,582,3097,3578708184,3578708189,5
2,582,3098,3578708184,3578708190,6
2,582,3099,3578708184,3578708191,7
2,582,3100,3578708184,3578708195,11
2,582,3101,3578708184,3578708196,12
2,582,3102,3578708184,3578708200,16
2,582,3103,3578708184,3578708204,20
2,582,3104,3578708184,3578708205,21
2,582,3105,3578708184,3578708207,23
2,582,3106,3578708184,3578708207,23
2,582,3107,3578708184,3578708209,25
2,582,3108,3578708184,3578708211,27
2,582,3109,3578708184,3578708214,30
2,582,3110,3578708184,3578708216,32
2,582,3111,3578708184,3578708218,34
2,582,3112,3578708184,3578708219,35
2,582,3113,3578708184,3578708219,35
2,582,3114,3578708184,3578708223,39
2,582,3115,3578708184,3578708225,41
2,582,3116,3578708184,3578708227,43
2,582,3117,3578708184,3578708228,44
2,583,3118,3578708236,3578708236,0
2,583,3119,3578708236,3578708236,0
2,583,3120,3578708236,3578708236,0
2,583,3121,3578708236,3578708237,1
2,583,3122,3578708236,3578708240,4
2,583,3123,3578708236,3578708242,6
2,583,3124,3578708236,3578708242,6
2,583,3125,3578708236,3578708243,7
2,583,3126,3578708236,3578708246,10
2,583,3127,3578708236,3578708258,22
2,583,3128,3578708236,3578708260,24
2,583,3129,3578708236,3578708261,25
2,583,3130,3578708236,3578708263,27
2,583,3131,3578708236,3578708266,30
2,583,3132,3578708236,3578708267,31
2,583,3133,3578708236,3578708268,32
2,583,3134,3578708236,3578708278,42
2,583,3135,3578708236,3578708280,44
2,583,3136,3578708236,3578708284,48
2,583,3137,3578708236,3578708284,48
2,583,3138,3578708236,3578708284,48
2,583,3139,3578708236,3578708286,50
2,584,3140,3578708289,3578708289,0
2,584,3141,3578708289,3578708291,2
2,584,3142,3578708289,3578708297,8
2,584,3143,3578708289,3578708300,11
2,584,3144,3578708289,3578708304,15
2,584,3145,3578708289,3578708305,16
2,584,3146,3578708289,3578708307,18
2,584,3147,3578708289,3578708308,19
2,584,3148,3578708289,3578708311,22
2,584,3149,3578708289,3578708312,23
2,584,3150,3578708289,3578708313,24
2,584,3151,3578708289,3578708313,24
2,584,3152,3578708289,3578708314,25
2,584,3153,3578708289,3578708316,27
2,584,3154,3578708289,3578708317,28
2,584,3155,3578708289,3578708321,32
2,584,3156,3578708289,3578708328,39
2,584,3157,3578708289,3578708330,41
2,584,3158,3578708289,3578708332,43
2,584,3159,3578708289,3578708335,46
2,584,3160,3578708289,3578708338,49
2,585,3161,3578708342,3578708349,7
2,585,3162,3578708342,3578708350,8
2,585,3163,3578708342,3578708353,11
2,585,3164,3578708342,3578708355,13
2,585,3165,3578708342,3578708357,15
2,585,3166,3578708342,3578708359,17
2,585,3167,3578708342,3578708364,22
2,585,3168,3578708342,3578708367,25
2,585,3169,3578708342,3578708367,25
2,585,3170,3578708342,3578708367,25
2,585,3171,3578708342,3578708371,29
2,585,3172,3578708342,3578708376,34
2,585,3173,3578708342,3578708382,40
2,585,3174,3578708342,3578708382,40
2,585,3175,3578708342,3578708388,46
2,585,3176,3578708342,3578708391,49
2,585,3177,3578708342,3578708392,50
2,586,3178,3578708395,3578708395,0
2,586,3179,3578708395,3578708397,2
2,586,3180,3578708395,3578708400,5
2,586,3181,3578708395,3578708404,9
2,586,3182,3578708395,3578708404,9
2,586,3183,3578708395,3578708407,12
2,586,3184,3578708395,3578708407,12
2,586,3185,3578708395,3578708408,13
2,586,3186,3578708395,3578708411,16
2,586,3187,3578708395,3578708415,20
2,586,3188,3578708395,3578708416,21
2,586,3189,3578708395,3578708418,23
2,586,3190,3578708395,3578708419,24
2,586,3191,3578708395,3578708419,24
2,586,3192,3578708395,3578708423,28
2,586,3193,3578708395,3578708425,30
2,586,3194,3578708395,3578708427,32
2,586,3195,3578708395,3578708427,32
2,586,3196,3578708395,3578708434,39
2,586,3197,3578708395,3578708436,41
2,586,3198,3578708395,3578708437,42
2,586,3199,3578708395,3578708438,43
2,586,3200,3578708395,3578708441,46
2,586,3201,3578708395,3578708442,47
2,586,3202,3578708395,3578708442,47
2,586,3203,3578708395,3578708443,48
2,587,3204,3578708447,3578708448,1
2,587,3205,3578708447,3578708459,12
2,587,3206,3578708447,3578708460,13
2,587,3207,3578708447,3578708461,14
2,587,3208,3578708447,3578708464,17
2,587,3209,3578708447,3578708466,19
2,587,3210,3578708447,3578708467,20
2,587,3211,3578708447,3578708468,21
2,587,3212,3578708447,3578708479,32
2,587,3213,3578708447,3578708480,33
2,587,3214,3578708447,3578708483,36
2,587,3215,3578708447,3578708484,37
2,587,3216,3578708447,3578708484,37
2,587,3217,3578708447,3578708487,40
2,587,3218,3578708447,3578708489,42
2,587,3219,3578708447,3578708491,44
2,588,3220,3578708500,3578708500,0
2,588,3221,3578708500,3578708500,0
2,588,3222,3578708500,3578708502,2
2,588,3223,3578708500,3578708506,6
2,588,3224,3578708500,3578708507,7
2,588,3225,3578708500,3578708508,8
2,588,3226,3578708500,3578708510,10
2,588,3227,3578708500,3578708511,11
2,588,3228,3578708500,3578708512,12
2,588,3229,3578708500,3578708512,12
2,588,3230,3578708500,3578708512,12
2,588,3231,3578708500,3578708515,15
2,588,3232,3578708500,3578708516,16
2,588,3233,3578708500,3578708520,20
2,588,3234,3578708500,3578708527,27
2,588,3235,3578708500,3578708530,30
2,588,3236,3578708500,3578708531,31
2,588,3237,3578708500,3578708534,34
2,588,3238,3578708500,3578708537,37
2,588,3239,3578708500,3578708548,48
2,588,3240,3578708500,3578708549,49
2,589,3241,3578708553,3578708553,0
2,589,3242,3578708553,3578708554,1
2,589,3243,3578708553,3578708557,4
2,589,3244,3578708553,3578708558,5
2,589,3245,3578708553,3578708563,10
2,589,3246,3578708553,3578708565,12
2,589,3247,3578708553,3578708565,12
2,589,3248,3578708553,3578708566,13
2,589,3249,3578708553,3578708568,15
2,589,3250,3578708553,3578708570,17
2,589,3251,3578708553,3578708576,23
2,589,3252,3578708553,3578708580,27
2,589,3253,3578708553,3578708580,27
2,589,3254,3578708553,3578708588,35
2,589,3255,3578708553,3578708589,36
2,589,3256,3578708553,3578708590,37
2,589,3257,3578708553,3578708596,43
2,589,3258,3578708553,3578708596,43
2,589,3259,3578708553,3578708598,45
2,589,3260,3578708553,3578708603,50
2,590,3261,3578708606,3578708606,0
2,590,3262,3578708606,3578708606,0
2,590,3263,3578708606,3578708607,1
2,590,3264,3578708606,3578708608,2
2,590,3265,3578708606,3578708610,4
2,590,3266,3578708606,3578708613,7
2,590,3267,3578708606,3578708615,9
2,590,3268,3578708606,3578708619,13
2,590,3269,3578708606,3578708619,13
2,590,3270,3578708606,3578708620,14
2,590,3271,3578708606,3578708622,16
2,590,3272,3578708606,3578708623,17
2,590,3273,3578708606,3578708626,20
2,590,3274,3578708606,3578708626,20
2,590,3275,3578708606,3578708634,28
2,590,3276,3578708606,3578708636,30
2,590,3277,3578708606,3578708636,30
2,590,3278,3578708606,3578708637,31
2,590,3279,3578708606,3578708641,35
2,590,3280,3578708606,3578708642,36
2,590,3281,3578708606,3578708643,37
2,590,3282,3578708606,3578708646,40
2,591,3283,3578708659,3578708659,0
2,591,3284,3578708659,3578708659,0
2,591,3285,3578708659,3578708660,1
2,591,3286,3578708659,3578708662,3
2,591,3287,3578708659,3578708665,6
2,591,3288,3578708659,3578708667,8
2,591,3289,3578708659,3578708667,8
2,591,3290,3578708659,3578708679,20
2,591,3291,3578708659,3578708680,21
2,591,3292,3578708659,3578708683,24
2,591,3293,3578708659,3578708684,25
2,591,3294,3578708659,3578708684,25
2,591,3295,3578708659,3578708687,28
2,591,3296,3578708659,3578708690,31
2,591,3297,3578708659,3578708697,38
2,591,3298,3578708659,3578708698,39
2,591,3299,3578708659,3578708703,44
2,591,3300,3578708659,3578708706,47
2,591,3301,3578708659,3578708707,48
2,591,3302,3578708659,3578708707,48
2,592,3303,3578708712,3578708712,0
2,592,3304,3578708712,3578708712,0
2,592,3305,3578708712,3578708712,0
2,592,3306,3578708712,3578708712,0
2,592,3307,3578708712,3578708713,1
2,592,3308,3578708712,3578708716,4
2,592,3309,3578708712,3578708716,4
2,592,3310,3578708712,3578708721,9
2,592,3311,3578708712,3578708727,15
2,592,3312,3578708712,3578708730,18
2,592,3313,3578708712,3578708731,19
2,592,3314,3578708712,3578708735,23
2,592,3315,3578708712,3578708737,25
2,592,3316,3578708712,3578708748,36
2,592,3317,3578708712,3578708749,37
2,592,3318,3578708712,3578708752,40
2,592,3319,3578708712,3578708754,42
2,592,3320,3578708712,3578708757,45
2,592,3321,3578708712,3578708758,46
2,593,3322,3578708765,3578708765,0
2,593,3323,3578708765,3578708766,1
2,593,3324,3578708765,3578708766,1
2,593,3325,3578708765,3578708766,1
2,593,3326,3578708765,3578708769,4
2,593,3327,3578708765,3578708771,6
2,593,3328,3578708765,3578708776,11
2,593,3329,3578708765,3578708781,16
2,593,3330,3578708765,3578708781,16
2,593,3331,3578708765,3578708788,23
2,593,3332,3578708765,3578708790,25
2,593,3333,3578708765,3578708791,26
2,593,3334,3578708765,3578708795,30
2,593,3335,3578708765,3578708795,30
2,593,3336,3578708765,3578708799,34
2,593,3337,3578708765,3578708804,39
2,593,3338,3578708765,3578708804,39
2,593,3339,3578708765,3578708806,41
2,593,3340,3578708765,3578708807,42
2,593,3341,3578708765,3578708809,44
2,593,3342,3578708765,3578708810,45
2,593,3343,3578708765,3578708813,48
2,594,3344,3578708817,3578708817,0
2,594,3345,3578708817,3578708818,1
2,594,3346,3578708817,3578708818,1
2,594,3347,3578708817,3578708819,2
2,594,3348,3578708817,3578708822,5
2,594,3349,3578708817,3578708824,7
2,594,3350,3578708817,3578708826,9
2,594,3351,3578708817,3578708826,9
2,594,3352,3578708817,3578708834,17
2,594,3353,3578708817,3578708837,20
2,594,3354,3578708817,3578708837,20
2,594,3355,3578708817,3578708837,20
2,594,3356,3578708817,3578708840,23
2,594,3357,3578708817,3578708842,25
2,594,3358,3578708817,3578708842,25
2,594,3359,3578708817,3578708846,29
2,594,3360,3578708817,3578708859,42
2,594,3361,3578708817,3578708860,43
2,594,3362,3578708817,3578708861,44
2,594,3363,3578708817,3578708862,45
2,594,3364,3578708817,3578708864,47
2,594,3365,3578708817,3578708867,50
2,595,3366,3578708870,3578708870,0
2,595,3367,3578708870,3578708880,10
2,595,3368,3578708870,3578708884,14
2,595,3369,3578708870,3578708884,14
2,595,3370,3578708870,3578708885,15
2,595,3371,3578708870,3578708887,17
2,595,3372,3578708870,3578708889,19
2,595,3373,3578708870,3578708897,27
2,595,3374,3578708870,3578708900,30
2,595,3375,3578708870,3578708902,32
2,595,3376,3578708870,3578708905,35
2,595,3377,3578708870,3578708907,37
2,595,3378,3578708870,3578708908,38
2,595,3379,3578708870,3578708911,41
2,595,3380,3578708870,3578708912,42
2,595,3381,3578708870,3578708912,42
2,595,3382,3578708870,3578708912,42
2,595,3383,3578708870,3578708913,43
2,595,3384,3578708870,3578708915,45
2,595,3385,3578708870,3578708915,45
2,596,3386,3578708923,3578708923,0
2,596,3387,3578708923,3578708926,3
2,596,3388,3578708923,3578708931,8
2,596,3389,3578708923,3578708931,8
2,596,3390,3578708923,3578708935,12
2,596,3391,3578708923,3578708948,25
2,596,3392,3578708923,3578708950,27
2,596,3393,3578708923,3578708952,29
2,596,3394,3578708923,3578708954,31
2,596,3395,3578708923,3578708958,35
2,596,3396,3578708923,3578708958,35
2,596,3397,3578708923,3578708963,40
2,596,3398,3578708923,3578708965,42
2,596,3399,3578708923,3578708966,43
2,596,3400,3578708923,3578708967,44
2,596,3401,3578708923,3578708968,45
2,596,3402,3578708923,3578708971,48
2,597,3403,3578708976,3578708977,1
2,597,3404,3578708976,3578708980,4
2,597,3405,3578708976,3578708981,5
2,597,3406,3578708976,3578708988,12
2,597,3407,3578708976,3578708989,13
2,597,3408,3578708976,3578708990,14
2,597,3409,3578708976,3578708995,19
2,597,3410,3578708976,3578708995,19
2,597,3411,3578708976,3578709000,24
2,597,3412,3578708976,3578709003,27
2,597,3413,3578708976,3578709004,28
2,597,3414,3578708976,3578709006,30
2,597,3415,3578708976,3578709007,31
2,597,3416,3578708976,3578709008,32
2,597,3417,3578708976,3578709010,34
2,597,3418,3578708976,3578709013,37
2,597,3419,3578708976,3578709015,39
2,597,3420,3578708976,3578709018,42
2,597,3421,3578708976,3578709018,42
2,597,3422,3578708976,3578709019,43
2,597,3423,3578708976,3578709022,46
2,597,3424,3578708976,3578709024,48
2,598,3425,3578709029,3578709029,0
2,598,3426,3578709029,3578709029,0
2,598,3427,3578709029,3578709035,6
2,598,3428,3578709029,3578709036,7
2,598,3429,3578709029,3578709036,7
2,598,3430,3578709029,3578709038,9
2,598,3431,3578709029,3578709040,11
2,598,3432,3578709029,3578709041,12
2,598,3433,3578709029,3578709042,13
2,598,3434,3578709029,3578709043,14
2,598,3435,3578709029,3578709046,17
2,598,3436,3578709029,3578709059,30
2,598,3437,3578709029,3578709060,31
2,598,3438,3578709029,3578709061,32
2,598,3439,3578709029,3578709064,35
2,598,3440,3578709029,3578709064,35
2,598,3441,3578709029,3578709066,37
2,598,3442,3578709029,3578709068,39
2,598,3443,3578709029,3578709076,47
2,599,3444,3578709082,3578709082,0
2,599,3445,3578709082,3578709082,0
2,599,3446,3578709082,3578709084,2
2,599,3447,3578709082,3578709084,2
2,599,3448,3578709082,3578709084,2
2,599,3449,3578709082,3578709089,7
2,599,3450,3578709082,3578709089,7
2,599,3451,3578709082,3578709097,15
2,599,3452,3578709082,3578709100,18
2,599,3453,3578709082,3578709103,21
2,599,3454,3578709082,3578709105,23
2,599,3455,3578709082,3578709107,25
2,599,3456,3578709082,3578709108,26
2,599,3457,3578709082,3578709111,29
2,599,3458,3578709082,3578709112,30
2,599,3459,3578709082,3578709112,30
2,599,3460,3578709082,3578709113,31
2,599,3461,3578709082,3578709113,31
2,599,3462,3578709082,3578709115,33
2,599,3463,3578709082,3578709116,34
2,599,3464,3578709082,3578709121,39
2,599,3465,3578709082,3578709127,45
2,599,3466,3578709082,3578709127,45
2,599,3467,3578709082,3578709130,48
2,599,3468,3578709082,3578709131,49
2,600,3469,3578709135,3578709135,0
2,600,3470,3578709135,3578709148,13
2,600,3471,3578709135,3578709150,15
2,600,3472,3578709135,3578709153,18
2,600,3473,3578709135,3578709154,19
2,600,3474,3578709135,3578709157,22
2,600,3475,3578709135,3578709158,23
2,600,3476,3578709135,3578709163,28
2,600,3477,3578709135,3578709166,31
2,600,3478,3578709135,3578709166,31
2,600,3479,3578709135,3578709167,32
2,600,3480,3578709135,3578709169,34
2,600,3481,3578709135,3578709171,36
2,600,3482,3578709135,3578709177,42
2,600,3483,3578709135,3578709178,43
2,600,3484,3578709135,3578709181,46
2,600,3485,3578709135,3578709181,46
2,601,3486,3578709188,3578709189,1
2,601,3487,3578709188,3578709190,2
2,601,3488,3578709188,3578709191,3
2,601,3489,3578709188,3578709195,7
2,601,3490,3578709188,3578709196,8
2,601,3491,3578709188,3578709200,12
2,601,3492,3578709188,3578709203,15
2,601,3493,3578709188,3578709205,17
2,601,3494,3578709188,3578709206,18
2,601,3495,3578709188,3578709207,19
2,601,3496,3578709188,3578709208,20
2,601,3497,3578709188,3578709210,22
2,601,3498,3578709188,3578709214,26
2,601,3499,3578709188,3578709216,28
2,601,3500,3578709188,3578709218,30
2,601,3501,3578709188,3578709218,30
2,601,3502,3578709188,3578709219,31
2,601,3503,3578709188,3578709222,34
2,601,3504,3578709188,3578709225,37
2,601,3505,3578709188,3578709227,39
2,601,3506,3578709188,3578709228,40
2,601,3507,3578709188,3578709234,46
2,601,3508,3578709188,3578709236,48
2,601,3509,3578709188,3578709237,49
2,601,3510,3578709188,3578709237,49
2,602,3511,3578709241,3578709241,0
2,602,3512,3578709241,3578709242,1
2,602,3513,3578709241,3578709242,1
2,602,3514,3578709241,3578709243,2
2,602,3515,3578709241,3578709246,5
2,602,3516,3578709241,3578709258,17
2,602,3517,3578709241,3578709260,19
2,602,3518,3578709241,3578709261,20
2,602,3519,3578709241,3578709264,23
2,602,3520,3578709241,3578709265,24
2,602,3521,3578709241,3578709267,26
2,602,3522,3578709241,3578709268,27
2,602,3523,3578709241,3578709276,35
2,602,3524,3578709241,3578709279,38
2,602,3525,3578709241,3578709280,39
2,602,3526,3578709241,3578709281,40
2,602,3527,3578709241,3578709283,42
2,602,3528,3578709241,3578709284,43
2,602,3529,3578709241,3578709285,44
2,602,3530,3578709241,3578709289,48
2,602,3531,3578709241,3578709290,49
2,603,3532,3578709294,3578709297,3
2,603,3533,3578709294,3578709300,6
2,603,3534,3578709294,3578709304,10
2,603,3535,3578709294,3578709305,11
2,603,3536,3578709294,3578709307,13
2,603,3537,3578709294,3578709309,15
2,603,3538,3578709294,3578709312,18
2,603,3539,3578709294,3578709312,18
2,603,3540,3578709294,3578709313,19
2,603,3541,3578709294,3578709313,19
2,603,3542,3578709294,3578709313,19
2,603,3543,3578709294,3578709316,22
2,603,3544,3578709294,3578709317,23
2,603,3545,3578709294,3578709322,28
2,603,3546,3578709294,3578709327,33
2,603,3547,3578709294,3578709327,33
2,603,3548,3578709294,3578709331,37
2,603,3549,3578709294,3578709331,37
2,603,3550,3578709294,3578709335,41
2,603,3551,3578709294,3578709338,44
2,604,3552,3578709347,3578709348,1
2,604,3553,3578709347,3578709350,3
2,604,3554,3578709347,3578709354,7
2,604,3555,3578709347,3578709355,8
2,604,3556,3578709347,3578709357,10
2,604,3557,3578709347,3578709358,11
2,604,3558,3578709347,3578709363,16
2,604,3559,3578709347,3578709366,19
2,604,3560,3578709347,3578709367,20
2,604,3561,3578709347,3578709367,20
2,604,3562,3578709347,3578709369,22
2,604,3563,3578709347,3578709371,24
2,604,3564,3578709347,3578709377,30
2,604,3565,3578709347,3578709378,31
2,604,3566,3578709347,3578709380,33
2,604,3567,3578709347,3578709381,34
2,604,3568,3578709347,3578709389,42
2,604,3569,3578709347,3578709390,43
2,604,3570,3578709347,3578709391,44
2,604,3571,3578709347,3578709395,48
2,604,3572,3578709347,3578709396,49
2,605,3573,3578709400,3578709400,0
2,605,3574,3578709400,3578709403,3
2,605,3575,3578709400,3578709405,5
2,605,3576,3578709400,3578709406,6
2,605,3577,3578709400,3578709407,7
2,605,3578,3578709400,3578709408,8
2,605,3579,3578709400,3578709411,11
2,605,3580,3578709400,3578709415,15
2,605,3581,3578709400,3578709416,16
2,605,3582,3578709400,3578709419,19
2,605,3583,3578709400,3578709419,19
2,605,3584,3578709400,3578709419,19
2,605,3585,3578709400,3578709422,22
2,605,3586,3578709400,3578709425,25
2,605,3587,3578709400,3578709427,27
2,605,3588,3578709400,3578709428,28
2,605,3589,3578709400,3578709436,36
2,605,3590,3578709400,3578709436,36
2,605,3591,3578709400,3578709437,37
2,605,3592,3578709400,3578709441,41
2,605,3593,3578709400,3578709442,42
2,605,3594,3578709400,3578709442,42
2,605,3595,3578709400,3578709443,43
2,605,3596,3578709400,3578709446,46
2,606,3597,3578709453,3578709458,5
2,606,3598,3578709453,3578709460,7
2,606,3599,3578709453,3578709461,8
2,606,3600,3578709453,3578709463,10
2,606,3601,3578709453,3578709465,12
2,606,3602,3578709453,3578709467,14
2,606,3603,3578709453,3578709467,14
2,606,3604,3578709453,3578709475,22
2,606,3605,3578709453,3578709478,25
2,606,3606,3578709453,3578709480,27
2,606,3607,3578709453,3578709481,28
2,606,3608,3578709453,3578709483,30
2,606,3609,3578709453,3578709484,31
2,606,3610,3578709453,3578709484,31
2,606,3611,3578709453,3578709485,32
2,606,3612,3578709453,3578709489,36
2,606,3613,3578709453,3578709490,37
2,606,3614,3578709453,3578709497,44
2,606,3615,3578709453,3578709500,47
2,607,3616,3578709506,3578709506,0
2,607,3617,3578709506,3578709506,0
2,607,3618,3578709506,3578709507,1
2,607,3619,3578709506,3578709508,2
2,607,3620,3578709506,3578709511,5
2,607,3621,3578709506,3578709512,6
2,607,3622,3578709506,3578709512,6
2,607,3623,3578709506,3578709513,7
2,607,3624,3578709506,3578709515,9
2,607,3625,3578709506,3578709516,10
2,607,3626,3578709506,3578709522,16
2,607,3627,3578709506,3578709526,20
2,607,3628,3578709506,3578709526,20
2,607,3629,3578709506,3578709530,24
2,607,3630,3578709506,3578709531,25
2,607,3631,3578709506,3578709534,28
2,607,3632,3578709506,3578709537,31
2,607,3633,3578709506,3578709547,41
2,607,3634,3578709506,3578709549,43
2,607,3635,3578709506,3578709553,47
2,607,3636,3578709506,3578709554,48
2,608,3637,3578709559,3578709559,0
2,608,3638,3578709559,3578709559,0
2,608,3639,3578709559,3578709562,3
2,608,3640,3578709559,3578709564,5
2,608,3641,3578709559,3578709566,7
2,608,3642,3578709559,3578709566,7
2,608,3643,3578709559,3578709567,8
2,608,3644,3578709559,3578709570,11
2,608,3645,3578709559,3578709576,17
2,608,3646,3578709559,3578709577,18
2,608,3647,3578709559,3578709581,22
2,608,3648,3578709559,3578709581,22
2,608,3649,3578709559,3578709589,30
2,608,3650,3578709559,3578709590,31
2,608,3651,3578709559,3578709590,31
2,608,3652,3578709559,3578709595,36
2,608,3653,3578709559,3578709599,40
2,608,3654,3578709559,3578709603,44
2,608,3655,3578709559,3578709603,44
2,608,3656,3578709559,3578709606,47
2,608,3657,3578709559,3578709608,49
2,608,3658,3578709559,3578709609,50
2,609,3659,3578709612,3578709613,1
2,609,3660,3578709612,3578709615,3
2,609,3661,3578709612,3578709617,5
2,609,3662,3578709612,3578709618,6
2,609,3663,3578709612,3578709620,8
2,609,3664,3578709612,3578709621,9
2,609,3665,3578709612,3578709623,11
2,609,3666,3578709612,3578709626,14
2,609,3667,3578709612,3578709628,16
2,609,3668,3578709612,3578709635,23
2,609,3669,3578709612,3578709636,24
2,609,3670,3578709612,3578709637,25
2,609,3671,3578709612,3578709641,29
2,609,3672,3578709612,3578709641,29
2,609,3673,3578709612,3578709643,31
2,609,3674,3578709612,3578709643,31
2,609,3675,3578709612,3578709646,34
2,609,3676,3578709612,3578709658,46
2,609,3677,3578709612,3578709659,47
2,609,3678,3578709612,3578709660,48
2,610,3679,3578709665,3578709665,0
2,610,3680,3578709665,3578709665,0
2,610,3681,3578709665,3578709667,2
2,610,3682,3578709665,3578709667,2
2,610,3683,3578709665,3578709676,11
2,610,3684,3578709665,3578709678,13
2,610,3685,3578709665,3578709680,15
2,610,3686,3578709665,3578709682,17
2,610,3687,3578709665,3578709684,19
2,610,3688,3578709665,3578709684,19
2,610,3689,3578709665,3578709685,20
2,610,3690,3578709665,3578709686,21
2,610,3691,3578709665,3578709689,24
2,610,3692,3578709665,3578709690,25
2,610,3693,3578709665,3578709697,32
2,610,3694,3578709665,3578709699,34
2,610,3695,3578709665,3578709704,39
2,610,3696,3578709665,3578709706,41
2,610,3697,3578709665,3578709707,42
2,610,3698,3578709665,3578709707,42
2,610,3699,3578709665,3578709711,46
2,610,3700,3578709665,3578709712,47
2,610,3701,3578709665,3578709712,47
2,611,3702,3578709718,3578709718,0
2,611,3703,3578709718,3578709718,0
2,611,3704,3578709718,3578709722,4
2,611,3705,3578709718,3578709726,8
2,611,3706,3578709718,3578709726,8
2,611,3707,3578709718,3578709731,13
2,611,3708,3578709718,3578709732,14
2,611,3709,3578709718,3578709735,17
2,611,3710,3578709718,3578709737,19
2,611,3711,3578709718,3578709737,19
2,611,3712,3578709718,3578709748,30
2,611,3713,3578709718,3578709750,32
2,611,3714,3578709718,3578709753,35
2,611,3715,3578709718,3578709754,36
2,611,3716,3578709718,3578709757,39
2,611,3717,3578709718,3578709757,39
2,611,3718,3578709718,3578709763,45
2,611,3719,3578709718,3578709765,47
2,611,3720,3578709718,3578709766,48
2,611,3721,3578709718,3578709766,48
2,611,3722,3578709718,3578709767,49
2,612,3723,3578709771,3578709772,1
2,612,3724,3578709771,3578709776,5
2,612,3725,3578709771,3578709776,5
2,612,3726,3578709771,3578709780,9
2,612,3727,3578709771,3578709781,10
2,612,3728,3578709771,3578709790,19
2,612,3729,3578709771,3578709790,19
2,612,3730,3578709771,3578709790,19
2,612,3731,3578709771,3578709795,24
2,612,3732,3578709771,3578709799,28
2,612,3733,3578709771,3578709803,32
2,612,3734,3578709771,3578709803,32
2,612,3735,3578709771,3578709806,35
2,612,3736,3578709771,3578709809,38
2,612,3737,3578709771,3578709811,40
2,612,3738,3578709771,3578709813,42
2,612,3739,3578709771,3578709815,44
2,612,3740,3578709771,3578709817,46
2,612,3741,3578709771,3578709818,47
2,612,3742,3578709771,3578709820,49
2,613,3743,3578709824,3578709824,0
2,613,3744,3578709824,3578709824,0
2,613,3745,3578709824,3578709826,2
2,613,3746,3578709824,3578709827,3
2,613,3747,3578709824,3578709836,12
2,613,3748,3578709824,3578709837,13
2,613,3749,3578709824,3578709838,14
2,613,3750,3578709824,3578709841,17
2,613,3751,3578709824,3578709841,17
2,613,3752,3578709824,3578709843,19
2,613,3753,3578709824,3578709843,19
2,613,3754,3578709824,3578709846,22
2,613,3755,3578709824,3578709858,34
2,613,3756,3578709824,3578709860,36
2,613,3757,3578709824,3578709861,37
2,613,3758,3578709824,3578709862,38
2,613,3759,3578709824,3578709864,40
2,613,3760,3578709824,3578709866,42
2,613,3761,3578709824,3578709867,43
2,614,3762,3578709877,3578709877,0
2,614,3763,3578709877,3578709878,1
2,614,3764,3578709877,3578709880,3
2,614,3765,3578709877,3578709882,5
2,614,3766,3578709877,3578709884,7
2,614,3767,3578709877,3578709884,7
2,614,3768,3578709877,3578709884,7
2,614,3769,3578709877,3578709885,8
2,614,3770,3578709877,3578709889,12
2,614,3771,3578709877,3578709889,12
2,614,3772,3578709877,3578709890,13
2,614,3773,3578709877,3578709897,20
2,614,3774,3578709877,3578709899,22
2,614,3775,3578709877,3578709905,28
2,614,3776,3578709877,3578709906,29
2,614,3777,3578709877,3578709907,30
2,614,3778,3578709877,3578709907,30
2,614,3779,3578709877,3578709912,35
2,614,3780,3578709877,3578709913,36
2,614,3781,3578709877,3578709914,37
2,614,3782,3578709877,3578709916,39
2,614,3783,3578709877,3578709917,40
2,614,3784,3578709877,3578709923,46
2,614,3785,3578709877,3578709926,49
2,614,3786,3578709877,3578709927,50
2,615,3787,3578709930,3578709931,1
2,615,3788,3578709930,3578709932,2
2,615,3789,3578709930,3578709935,5
2,615,3790,3578709930,3578709936,6
2,615,3791,3578709930,3578709937,7
2,615,3792,3578709930,3578709948,18
2,615,3793,3578709930,3578709950,20
2,615,3794,3578709930,3578709953,23
2,615,3795,3578709930,3578709954,24
2,615,3796,3578709930,3578709956,26
2,615,3797,3578709930,3578709957,27
2,615,3798,3578709930,3578709963,33
2,615,3799,3578709930,3578709965,35
2,615,3800,3578709930,3578709966,36
2,615,3801,3578709930,3578709967,37
2,615,3802,3578709930,3578709971,41
2,615,3803,3578709930,3578709976,46
2,615,3804,3578709930,3578709976,46
2,615,3805,3578709930,3578709980,50
2,616,3806,3578709983,3578709983,0
2,616,3807,3578709983,3578709990,7
2,616,3808,3578709983,3578709990,7
2,616,3809,3578709983,3578709990,7
2,616,3810,3578709983,3578709995,12
2,616,3811,3578709983,3578710000,17
2,616,3812,3578709983,3578710003,20
2,616,3813,3578709983,3578710003,20
2,616,3814,3578709983,3578710006,23
2,616,3815,3578709983,3578710008,25
2,616,3816,3578709983,3578710010,27
2,616,3817,3578709983,3578710013,30
2,616,3818,3578709983,3578710015,32
2,616,3819,3578709983,3578710017,34
2,616,3820,3578709983,3578710019,36
2,616,3821,3578709983,3578710020,37
2,616,3822,3578709983,3578710022,39
2,616,3823,3578709983,3578710025,42
2,616,3824,3578709983,3578710027,44
2,616,3825,3578709983,3578710028,45
2,617,3826,3578710036,3578710037,1
2,617,3827,3578710036,3578710037,1
2,617,3828,3578710036,3578710037,1
2,617,3829,3578710036,3578710040,4
2,617,3830,3578710036,3578710041,5
2,617,3831,3578710036,3578710043,7
2,617,3832,3578710036,3578710043,7
2,617,3833,3578710036,3578710046,10
2,617,3834,3578710036,3578710058,22
2,617,3835,3578710036,3578710060,24
2,617,3836,3578710036,3578710061,25
2,617,3837,3578710036,3578710063,27
2,617,3838,3578710036,3578710065,29
2,617,3839,3578710036,3578710068,32
2,617,3840,3578710036,3578710076,40
2,617,3841,3578710036,3578710079,43
2,617,3842,3578710036,3578710080,44
2,617,3843,3578710036,3578710083,47
2,617,3844,3578710036,3578710083,47
2,617,3845,3578710036,3578710084,48
2,617,3846,3578710036,3578710085,49
2,618,3847,3578710088,3578710088,0
2,618,3848,3578710088,3578710088,0
2,618,3849,3578710088,3578710090,2
2,618,3850,3578710088,3578710091,3
2,618,3851,3578710088,3578710091,3
2,618,3852,3578710088,3578710097,9
2,618,3853,3578710088,3578710100,12
2,618,3854,3578710088,3578710104,16
2,618,3855,3578710088,3578710106,18
2,618,3856,3578710088,3578710107,19
2,618,3857,3578710088,3578710108,20
2,618,3858,3578710088,3578710111,23
2,618,3859,3578710088,3578710112,24
2,618,3860,3578710088,3578710113,25
2,618,3861,3578710088,3578710114,26
2,618,3862,3578710088,3578710114,26
2,618,3863,3578710088,3578710115,27
2,618,3864,3578710088,3578710117,29
2,618,3865,3578710088,3578710123,35
2,618,3866,3578710088,3578710127,39
2,618,3867,3578710088,3578710128,40
2,618,3868,3578710088,3578710130,42
2,618,3869,3578710088,3578710131,43
2,618,3870,3578710088,3578710135,47
2,618,3871,3578710088,3578710136,48
2,618,3872,3578710088,3578710138,50
2,619,3873,3578710141,3578710148,7
2,619,3874,3578710141,3578710150,9
2,619,3875,3578710141,3578710153,12
2,619,3876,3578710141,3578710154,13
2,619,3877,3578710141,3578710157,16
2,619,3878,3578710141,3578710157,16
2,619,3879,3578710141,3578710163,22
2,619,3880,3578710141,3578710165,24
2,619,3881,3578710141,3578710165,24
2,619,3882,3578710141,3578710168,27
2,619,3883,3578710141,3578710171,30
2,619,3884,3578710141,3578710176,35
2,619,3885,3578710141,3578710177,36
2,619,3886,3578710141,3578710181,40
2,619,3887,3578710141,3578710190,49
2,620,3888,3578710194,3578710194,0
2,620,3889,3578710194,3578710195,1
2,620,3890,3578710194,3578710200,6
2,620,3891,3578710194,3578710203,9
2,620,3892,3578710194,3578710203,9
2,620,3893,3578710194,3578710207,13
2,620,3894,3578710194,3578710208,14
2,620,3895,3578710194,3578710210,16
2,620,3896,3578710194,3578710214,20
2,620,3897,3578710194,3578710216,22
2,620,3898,3578710194,3578710217,23
2,620,3899,3578710194,3578710219,25
2,620,3900,3578710194,3578710220,26
2,620,3901,3578710194,3578710222,28
2,620,3902,3578710194,3578710225,31
2,620,3903,3578710194,3578710227,33
2,620,3904,3578710194,3578710227,33
2,620,3905,3578710194,3578710237,43
2,620,3906,3578710194,3578710237,43
2,620,3907,3578710194,3578710237,43
2,620,3908,3578710194,3578710241,47
2,620,3909,3578710194,3578710242,48
2,620,3910,3578710194,3578710243,49
2,620,3911,3578710194,3578710243,49
2,620,3912,3578710194,3578710244,50
2,621,3913,3578710247,3578710247,0
2,621,3914,3578710247,3578710257,10
2,621,3915,3578710247,3578710260,13
2,621,3916,3578710247,3578710260,13
2,621,3917,3578710247,3578710263,16
2,621,3918,3578710247,3578710265,18
2,621,3919,3578710247,3578710267,20
2,621,3920,3578710247,3578710268,21
2,621,3921,3578710247,3578710276,29
2,621,3922,3578710247,3578710278,31
2,621,3923,3578710247,3578710280,33
2,621,3924,3578710247,3578710282,35
2,621,3925,3578710247,3578710283,36
2,621,3926,3578710247,3578710285,38
2,621,3927,3578710247,3578710285,38
2,621,3928,3578710247,3578710286,39
2,621,3929,3578710247,3578710288,41
2,621,3930,3578710247,3578710290,43
2,621,3931,3578710247,3578710291,44
2,621,3932,3578710247,3578710291,44
2,621,3933,3578710247,3578710293,46
2,621,3934,3578710247,3578710297,50
2,622,3935,3578710301,3578710301,0
2,622,3936,3578710301,3578710304,3
2,622,3937,3578710301,3578710306,5
2,622,3938,3578710301,3578710307,6
2,622,3939,3578710301,3578710308,7
2,622,3940,3578710301,3578710311,10
2,622,3941,3578710301,3578710313,12
2,622,3942,3578710301,3578710313,12
2,622,3943,3578710301,3578710314,13
2,622,3944,3578710301,3578710317,16
2,622,3945,3578710301,3578710317,16
2,622,3946,3578710301,3578710323,22
2,622,3947,3578710301,3578710327,26
2,622,3948,3578710301,3578710327,26
2,622,3949,3578710301,3578710331,30
2,622,3950,3578710301,3578710332,31
2,622,3951,3578710301,3578710335,34
2,622,3952,3578710301,3578710336,35
2,622,3953,3578710301,3578710338,37
2,622,3954,3578710301,3578710344,43
2,622,3955,3578710301,3578710348,47
2,622,3956,3578710301,3578710350,49
2,623,3957,3578710354,3578710354,0
2,623,3958,3578710354,3578710355,1
2,623,3959,3578710354,3578710357,3
2,623,3960,3578710354,3578710357,3
2,623,3961,3578710354,3578710365,11
2,623,3962,3578710354,3578710367,13
2,623,3963,3578710354,3578710368,14
2,623,3964,3578710354,3578710371,17
2,623,3965,3578710354,3578710376,22
2,623,3966,3578710354,3578710378,24
2,623,3967,3578710354,3578710380,26
2,623,3968,3578710354,3578710382,28
2,623,3969,3578710354,3578710390,36
2,623,3970,3578710354,3578710391,37
2,623,3971,3578710354,3578710394,40
2,623,3972,3578710354,3578710395,41
2,623,3973,3578710354,3578710400,46
2,623,3974,3578710354,3578710404,50
2,623,3975,3578710354,3578710404,50
2,624,3976,3578710406,3578710406,0
2,624,3977,3578710406,3578710408,2
2,624,3978,3578710406,3578710410,4
2,624,3979,3578710406,3578710414,8
2,624,3980,3578710406,3578710415,9
2,624,3981,3578710406,3578710418,12
2,624,3982,3578710406,3578710418,12
2,624,3983,3578710406,3578710419,13
2,624,3984,3578710406,3578710422,16
2,624,3985,3578710406,3578710426,20
2,624,3986,3578710406,3578710427,21
2,624,3987,3578710406,3578710428,22
2,624,3988,3578710406,3578710433,27
2,624,3989,3578710406,3578710436,30
2,624,3990,3578710406,3578710437,31
2,624,3991,3578710406,3578710438,32
2,624,3992,3578710406,3578710441,35
2,624,3993,3578710406,3578710442,36
2,624,3994,3578710406,3578710443,37
2,624,3995,3578710406,3578710443,37
2,624,3996,3578710406,3578710443,37
2,624,3997,3578710406,3578710446,40
2,625,3998,3578710459,3578710459,0
2,625,3999,3578710459,3578710460,1
2,625,4000,3578710459,3578710461,2
2,625,4001,3578710459,3578710463,4
2,625,4002,3578710459,3578710465,6
2,625,4003,3578710459,3578710467,8
2,625,4004,3578710459,3578710468,9
2,625,4005,3578710459,3578710477,18
2,625,4006,3578710459,3578710478,19
2,625,4007,3578710459,3578710480,21
2,625,4008,3578710459,3578710482,23
2,625,4009,3578710459,3578710483,24
2,625,4010,3578710459,3578710484,25
2,625,4011,3578710459,3578710485,26
2,625,4012,3578710459,3578710488,29
2,625,4013,3578710459,3578710491,32
2,625,4014,3578710459,3578710491,32
2,625,4015,3578710459,3578710494,35
2,625,4016,3578710459,3578710497,38
2,625,4017,3578710459,3578710501,42
2,625,4018,3578710459,3578710505,46
2,625,4019,3578710459,3578710507,48
2,625,4020,3578710459,3578710508,49
2,625,4021,3578710459,3578710508,49
2,626,4022,3578710513,3578710513,0
2,626,4023,3578710513,3578710513,0
2,626,4024,3578710513,3578710513,0
2,626,4025,3578710513,3578710513,0
2,626,4026,3578710513,3578710513,0
2,626,4027,3578710513,3578710516,3
2,626,4028,3578710513,3578710516,3
2,626,4029,3578710513,3578710522,9
2,626,4030,3578710513,3578710526,13
2,626,4031,3578710513,3578710527,14
2,626,4032,3578710513,3578710529,16
2,626,4033,3578710513,3578710531,18
2,626,4034,3578710513,3578710534,21
2,626,4035,3578710513,3578710535,22
2,626,4036,3578710513,3578710537,24
2,626,4037,3578710513,3578710543,30
2,626,4038,3578710513,3578710547,34
2,626,4039,3578710513,3578710549,36
2,626,4040,3578710513,3578710552,39
2,626,4041,3578710513,3578710554,41
2,626,4042,3578710513,3578710555,42
2,626,4043,3578710513,3578710557,44
2,627,4044,3578710567,3578710567,0
2,627,4045,3578710567,3578710567,0
2,627,4046,3578710567,3578710568,1
2,627,4047,3578710567,3578710570,3
2,627,4048,3578710567,3578710576,9
2,627,4049,3578710567,3578710577,10
2,627,4050,3578710567,3578710581,14
2,627,4051,3578710567,3578710581,14
2,627,4052,3578710567,3578710589,22
2,627,4053,3578710567,3578710590,23
2,627,4054,3578710567,3578710591,24
2,627,4055,3578710567,3578710594,27
2,627,4056,3578710567,3578710595,28
2,627,4057,3578710567,3578710600,33
2,627,4058,3578710567,3578710603,36
2,627,4059,3578710567,3578710603,36
2,627,4060,3578710567,3578710606,39
2,627,4061,3578710567,3578710609,42
2,627,4062,3578710567,3578710609,42
2,627,4063,3578710567,3578710614,47
2,628,4064,3578710620,3578710620,0
2,628,4065,3578710620,3578710620,0
2,628,4066,3578710620,3578710620,0
2,628,4067,3578710620,3578710621,1
2,628,4068,3578710620,3578710624,4
2,628,4069,3578710620,3578710626,6
2,628,4070,3578710620,3578710627,7
2,628,4071,3578710620,3578710634,14
2,628,4072,3578710620,3578710636,16
2,628,4073,3578710620,3578710637,17
2,628,4074,3578710620,3578710637,17
2,628,4075,3578710620,3578710640,20
2,628,4076,3578710620,3578710641,21
2,628,4077,3578710620,3578710642,22
2,628,4078,3578710620,3578710642,22
2,628,4079,3578710620,3578710643,23
2,628,4080,3578710620,3578710646,26
2,628,4081,3578710620,3578710658,38
2,628,4082,3578710620,3578710659,39
2,628,4083,3578710620,3578710660,40
2,628,4084,3578710620,3578710662,42
2,628,4085,3578710620,3578710666,46
2,628,4086,3578710620,3578710667,47
2,629,4087,3578710673,3578710677,4
2,629,4088,3578710673,3578710679,6
2,629,4089,3578710673,3578710680,7
2,629,4090,3578710673,3578710683,10
2,629,4091,3578710673,3578710684,11
2,629,4092,3578710673,3578710684,11
2,629,4093,3578710673,3578710685,12
2,629,4094,3578710673,3578710688,15
2,629,4095,3578710673,3578710691,18
2,629,4096,3578710673,3578710691,18
2,629,4097,3578710673,3578710694,21
2,629,4098,3578710673,3578710697,24
2,629,4099,3578710673,3578710701,28
2,629,4100,3578710673,3578710704,31
2,629,4101,3578710673,3578710707,34
2,629,4102,3578710673,3578710708,35
2,629,4103,3578710673,3578710708,35
2,629,4104,3578710673,3578710711,38
2,629,4105,3578710673,3578710711,38
2,629,4106,3578710673,3578710712,39
2,629,4107,3578710673,3578710713,40
2,629,4108,3578710673,3578710713,40
2,629,4109,3578710673,3578710715,42
2,629,4110,3578710673,3578710717,44
2,629,4111,3578710673,3578710722,49
2,630,4112,3578710727,3578710727,0
2,630,4113,3578710727,3578710727,0
2,630,4114,3578710727,3578710730,3
2,630,4115,3578710727,3578710732,5
2,630,4116,3578710727,3578710735,8
2,630,4117,3578710727,3578710735,8
2,630,4118,3578710727,3578710737,10
2,630,4119,3578710727,3578710744,17
2,630,4120,3578710727,3578710748,21
2,630,4121,3578710727,3578710749,22
2,630,4122,3578710727,3578710752,25
2,630,4123,3578710727,3578710754,27
2,630,4124,3578710727,3578710756,29
2,630,4125,3578710727,3578710757,30
2,630,4126,3578710727,3578710762,35
2,630,4127,3578710727,3578710764,37
2,630,4128,3578710727,3578710767,40
2,630,4129,3578710727,3578710767,40
2,630,4130,3578710727,3578710771,44
2,630,4131,3578710727,3578710776,49
2,630,4132,3578710727,3578710776,49
2,631,4133,3578710780,3578710780,0
2,631,4134,3578710780,3578710780,0
2,631,4135,3578710780,3578710789,9
2,631,4136,3578710780,3578710789,9
2,631,4137,3578710780,3578710790,10
2,631,4138,3578710780,3578710793,13
2,631,4139,3578710780,3578710800,20
2,631,4140,3578710780,3578710802,22
2,631,4141,3578710780,3578710803,23
2,631,4142,3578710780,3578710807,27
2,631,4143,3578710780,3578710808,28
2,631,4144,3578710780,3578710810,30
2,631,4145,3578710780,3578710813,33
2,631,4146,3578710780,3578710818,38
2,631,4147,3578710780,3578710818,38
2,631,4148,3578710780,3578710819,39
2,631,4149,3578710780,3578710822,42
2,631,4150,3578710780,3578710824,44
2,631,4151,3578710780,3578710826,46
2,631,4152,3578710780,3578710827,47
2,632,4153,3578710833,3578710834,1
2,632,4154,3578710833,3578710835,2
2,632,4155,3578710833,3578710837,4
2,632,4156,3578710833,3578710837,4
2,632,4157,3578710833,3578710840,7
2,632,4158,3578710833,3578710841,8
2,632,4159,3578710833,3578710842,9
2,632,4160,3578710833,3578710842,9
2,632,4161,3578710833,3578710843,10
2,632,4162,3578710833,3578710846,13
2,632,4163,3578710833,3578710851,18
2,632,4164,3578710833,3578710857,24
2,632,4165,3578710833,3578710860,27
2,632,4166,3578710833,3578710861,28
2,632,4167,3578710833,3578710864,31
2,632,4168,3578710833,3578710866,33
2,632,4169,3578710833,3578710867,34
2,632,4170,3578710833,3578710876,43
2,632,4171,3578710833,3578710879,46
2,632,4172,3578710833,3578710880,47
2,632,4173,3578710833,3578710882,49
2,633,4174,3578710886,3578710886,0
2,633,4175,3578710886,3578710886,0
2,633,4176,3578710886,3578710886,0
2,633,4177,3578710886,3578710886,0
2,633,4178,3578710886,3578710888,2
2,633,4179,3578710886,3578710891,5
2,633,4180,3578710886,3578710892,6
2,633,4181,3578710886,3578710894,8
2,633,4182,3578710886,3578710897,11
2,633,4183,3578710886,3578710901,15
2,633,4184,3578710886,3578710904,18
2,633,4185,3578710886,3578710907,21
2,633,4186,3578710886,3578710908,22
2,633,4187,3578710886,3578710908,22
2,633,4188,3578710886,3578710911,25
2,633,4189,3578710886,3578710912,26
2,633,4190,3578710886,3578710913,27
2,633,4191,3578710886,3578710913,27
2,633,4192,3578710886,3578710913,27
2,633,4193,3578710886,3578710916,30
2,633,4194,3578710886,3578710917,31
2,633,4195,3578710886,3578710922,36
2,633,4196,3578710886,3578710927,41
2,633,4197,3578710886,3578710927,41
2,633,4198,3578710886,3578710930,44
2,633,4199,3578710886,3578710932,46
2,633,4200,3578710886,3578710935,49
2,633,4201,3578710886,3578710936,50
2,634,4202,3578710939,3578710943,4
2,634,4203,3578710939,3578710949,10
2,634,4204,3578710939,3578710950,11
2,634,4205,3578710939,3578710951,12
2,634,4206,3578710939,3578710954,15
2,634,4207,3578710939,3578710955,16
2,634,4208,3578710939,3578710957,18
2,634,4209,3578710939,3578710963,24
2,634,4210,3578710939,3578710965,26
2,634,4211,3578710939,3578710967,28
2,634,4212,3578710939,3578710968,29
2,634,4213,3578710939,3578710972,33
2,634,4214,3578710939,3578710976,37
2,634,4215,3578710939,3578710977,38
2,634,4216,3578710939,3578710980,41
2,634,4217,3578710939,3578710981,42
2,634,4218,3578710939,3578710989,50
2,635,4219,3578710992,3578710992,0
2,635,4220,3578710992,3578710992,0
2,635,4221,3578710992,3578710993,1
2,635,4222,3578710992,3578710995,3
2,635,4223,3578710992,3578711002,10
2,635,4224,3578710992,3578711003,11
2,635,4225,3578710992,3578711006,14
2,635,4226,3578710992,3578711008,16
2,635,4227,3578710992,3578711010,18
2,635,4228,3578710992,3578711013,21
2,635,4229,3578710992,3578711017,25
2,635,4230,3578710992,3578711019,27
2,635,4231,3578710992,3578711020,28
2,635,4232,3578710992,3578711022,30
2,635,4233,3578710992,3578711024,32
2,635,4234,3578710992,3578711027,35
2,635,4235,3578710992,3578711027,35
2,635,4236,3578710992,3578711033,41
2,635,4237,3578710992,3578711036,44
2,635,4238,3578710992,3578711037,45
2,635,4239,3578710992,3578711037,45
2,635,4240,3578710992,3578711041,49
2,635,4241,3578710992,3578711042,50
2,636,4242,3578711045,3578711045,0
2,636,4243,3578711045,3578711045,0
2,636,4244,3578711045,3578711045,0
2,636,4245,3578711045,3578711046,1
2,636,4246,3578711045,3578711051,6
2,636,4247,3578711045,3578711054,9
2,636,4248,3578711045,3578711058,13
2,636,4249,3578711045,3578711060,15
2,636,4250,3578711045,3578711060,15
2,636,4251,3578711045,3578711064,19
2,636,4252,3578711045,3578711065,20
2,636,4253,3578711045,3578711066,21
2,636,4254,3578711045,3578711067,22
2,636,4255,3578711045,3578711077,32
2,636,4256,3578711045,3578711079,34
2,636,4257,3578711045,3578711080,35
2,636,4258,3578711045,3578711083,38
2,636,4259,3578711045,3578711084,39
2,636,4260,3578711045,3578711085,40
2,636,4261,3578711045,3578711088,43
2,636,4262,3578711045,3578711090,45
2,636,4263,3578711045,3578711090,45
2,636,4264,3578711045,3578711092,47
2,636,4265,3578711045,3578711093,48
2,637,4266,3578711098,3578711098,0
2,637,4267,3578711098,3578711100,2
2,637,4268,3578711098,3578711104,6
2,637,4269,3578711098,3578711107,9
2,637,4270,3578711098,3578711107,9
2,637,4271,3578711098,3578711108,10
2,637,4272,3578711098,3578711111,13
2,637,4273,3578711098,3578711112,14
2,637,4274,3578711098,3578711113,15
2,637,4275,3578711098,3578711113,15
2,637,4276,3578711098,3578711114,16
2,637,4277,3578711098,3578711115,17
2,637,4278,3578711098,3578711117,19
2,637,4279,3578711098,3578711122,24
2,637,4280,3578711098,3578711127,29
2,637,4281,3578711098,3578711128,30
2,637,4282,3578711098,3578711131,33
2,637,4283,3578711098,3578711133,35
2,637,4284,3578711098,3578711133,35
2,637,4285,3578711098,3578711135,37
2,637,4286,3578711098,3578711136,38
2,637,4287,3578711098,3578711143,45
2,638,4288,3578711151,3578711151,0
2,638,4289,3578711151,3578711151,0
2,638,4290,3578711151,3578711153,2
2,638,4291,3578711151,3578711155,4
2,638,4292,3578711151,3578711155,4
2,638,4293,3578711151,3578711158,7
2,638,4294,3578711151,3578711163,12
2,638,4295,3578711151,3578711165,14
2,638,4296,3578711151,3578711167,16
2,638,4297,3578711151,3578711167,16
2,638,4298,3578711151,3578711171,20
2,638,4299,3578711151,3578711176,25
2,638,4300,3578711151,3578711177,26
2,638,4301,3578711151,3578711181,30
2,638,4302,3578711151,3578711181,30
2,638,4303,3578711151,3578711189,38
2,638,4304,3578711151,3578711190,39
2,638,4305,3578711151,3578711191,40
2,638,4306,3578711151,3578711194,43
2,638,4307,3578711151,3578711195,44
2,639,4308,3578711204,3578711204,0
2,639,4309,3578711204,3578711204,0
2,639,4310,3578711204,3578711206,2
2,639,4311,3578711204,3578711209,5
2,639,4312,3578711204,3578711211,7
2,639,4313,3578711204,3578711214,10
2,639,4314,3578711204,3578711216,12
2,639,4315,3578711204,3578711217,13
2,639,4316,3578711204,3578711218,14
2,639,4317,3578711204,3578711220,16
2,639,4318,3578711204,3578711222,18
2,639,4319,3578711204,3578711225,21
2,639,4320,3578711204,3578711227,23
2,639,4321,3578711204,3578711228,24
2,639,4322,3578711204,3578711234,30
2,639,4323,3578711204,3578711236,32
2,639,4324,3578711204,3578711236,32
2,639,4325,3578711204,3578711237,33
2,639,4326,3578711204,3578711241,37
2,639,4327,3578711204,3578711241,37
2,639,4328,3578711204,3578711242,38
2,639,4329,3578711204,3578711242,38
2,639,4330,3578711204,3578711244,40
2,639,4331,3578711204,3578711246,42
2,639,4332,3578711204,3578711252,48
2,639,4333,3578711204,3578711254,50
2,640,4334,3578711257,3578711258,1
2,640,4335,3578711257,3578711260,3
2,640,4336,3578711257,3578711261,4
2,640,4337,3578711257,3578711264,7
2,640,4338,3578711257,3578711266,9
2,640,4339,3578711257,3578711267,10
2,640,4340,3578711257,3578711267,10
2,640,4341,3578711257,3578711276,19
2,640,4342,3578711257,3578711279,22
2,640,4343,3578711257,3578711280,23
2,640,4344,3578711257,3578711283,26
2,640,4345,3578711257,3578711283,26
2,640,4346,3578711257,3578711285,28
2,640,4347,3578711257,3578711286,29
2,640,4348,3578711257,3578711288,31
2,640,4349,3578711257,3578711290,33
2,640,4350,3578711257,3578711291,34
2,640,4351,3578711257,3578711291,34
2,640,4352,3578711257,3578711294,37
2,640,4353,3578711257,3578711297,40
2,640,4354,3578711257,3578711301,44
2,640,4355,3578711257,3578711304,47
2,640,4356,3578711257,3578711307,50
2,641,4357,3578711310,3578711310,0
2,641,4358,3578711310,3578711310,0
2,641,4359,3578711310,3578711310,0
2,641,4360,3578711310,3578711311,1
2,641,4361,3578711310,3578711313,3
2,641,4362,3578711310,3578711313,3
2,641,4363,3578711310,3578711313,3
2,641,4364,3578711310,3578711314,4
2,641,4365,3578711310,3578711316,6
2,641,4366,3578711310,3578711316,6
2,641,4367,3578711310,3578711322,12
2,641,4368,3578711310,3578711327,17
2,641,4369,3578711310,3578711328,18
2,641,4370,3578711310,3578711330,20
2,641,4371,3578711310,3578711333,23
2,641,4372,3578711310,3578711333,23
2,641,4373,3578711310,3578711335,25
2,641,4374,3578711310,3578711338,28
2,641,4375,3578711310,3578711343,33
2,641,4376,3578711310,3578711349,39
2,641,4377,3578711310,3578711350,40
2,641,4378,3578711310,3578711353,43
2,641,4379,3578711310,3578711355,45
2,641,4380,3578711310,3578711356,46
2,641,4381,3578711310,3578711358,48
2,642,4382,3578711364,3578711364,0
2,642,4383,3578711364,3578711365,1
2,642,4384,3578711364,3578711367,3
2,642,4385,3578711364,3578711368,4
2,642,4386,3578711364,3578711371,7
2,642,4387,3578711364,3578711376,12
2,642,4388,3578711364,3578711377,13
2,642,4389,3578711364,3578711380,16
2,642,4390,3578711364,3578711381,17
2,642,4391,3578711364,3578711389,25
2,642,4392,3578711364,3578711390,26
2,642,4393,3578711364,3578711392,28
2,642,4394,3578711364,3578711393,29
2,642,4395,3578711364,3578711396,32
2,642,4396,3578711364,3578711398,34
2,642,4397,3578711364,3578711400,36
2,642,4398,3578711364,3578711403,39
2,642,4399,3578711364,3578711403,39
2,642,4400,3578711364,3578711406,42
2,642,4401,3578711364,3578711408,44
2,642,4402,3578711364,3578711410,46
2,643,4403,3578711418,3578711418,0
2,643,4404,3578711418,3578711418,0
2,643,4405,3578711418,3578711418,0
2,643,4406,3578711418,3578711418,0
2,643,4407,3578711418,3578711420,2
2,643,4408,3578711418,3578711423,5
2,643,4409,3578711418,3578711424,6
2,643,4410,3578711418,3578711427,9
2,643,4411,3578711418,3578711428,10
2,643,4412,3578711418,3578711433,15
2,643,4413,3578711418,3578711436,18
2,643,4414,3578711418,3578711436,18
2,643,4415,3578711418,3578711437,19
2,643,4416,3578711418,3578711441,23
2,643,4417,3578711418,3578711441,23
2,643,4418,3578711418,3578711442,24
2,643,4419,3578711418,3578711442,24
2,643,4420,3578711418,3578711444,26
2,643,4421,3578711418,3578711445,27
2,643,4422,3578711418,3578711452,34
2,643,4423,3578711418,3578711455,37
2,643,4424,3578711418,3578711459,41
2,643,4425,3578711418,3578711461,43
2,643,4426,3578711418,3578711461,43
2,643,4427,3578711418,3578711464,46
2,643,4428,3578711418,3578711466,48
2,643,4429,3578711418,3578711467,49
2,643,4430,3578711418,3578711468,50
2,644,4431,3578711471,3578711476,5
2,644,4432,3578711471,3578711479,8
2,644,4433,3578711471,3578711480,9
2,644,4434,3578711471,3578711483,12
2,644,4435,3578711471,3578711484,13
2,644,4436,3578711471,3578711485,14
2,644,4437,3578711471,3578711486,15
2,644,4438,3578711471,3578711489,18
2,644,4439,3578711471,3578711490,19
2,644,4440,3578711471,3578711491,20
2,644,4441,3578711471,3578711492,21
2,644,4442,3578711471,3578711493,22
2,644,4443,3578711471,3578711497,26
2,644,4444,3578711471,3578711502,31
2,644,4445,3578711471,3578711505,34
2,644,4446,3578711471,3578711507,36
2,644,4447,3578711471,3578711507,36
2,644,4448,3578711471,3578711507,36
2,644,4449,3578711471,3578711508,37
2,644,4450,3578711471,3578711510,39
2,644,4451,3578711471,3578711512,41
2,644,4452,3578711471,3578711512,41
2,644,4453,3578711471,3578711513,42
2,644,4454,3578711471,3578711513,42
2,644,4455,3578711471,3578711514,43
2,644,4456,3578711471,3578711516,45
2,644,4457,3578711471,3578711517,46
2,645,4458,3578711524,3578711524,0
2,645,4459,3578711524,3578711526,2
2,645,4460,3578711524,3578711527,3
2,645,4461,3578711524,3578711529,5
2,645,4462,3578711524,3578711531,7
2,645,4463,3578711524,3578711531,7
2,645,4464,3578711524,3578711535,11
2,645,4465,3578711524,3578711537,13
2,645,4466,3578711524,3578711542,18
2,645,4467,3578711524,3578711549,25
2,645,4468,3578711524,3578711549,25
2,645,4469,3578711524,3578711551,27
2,645,4470,3578711524,3578711554,30
2,645,4471,3578711524,3578711555,31
2,645,4472,3578711524,3578711557,33
2,645,4473,3578711524,3578711560,36
2,645,4474,3578711524,3578711562,38
2,645,4475,3578711524,3578711565,41
2,645,4476,3578711524,3578711565,41
2,645,4477,3578711524,3578711568,44
2,645,4478,3578711524,3578711570,46
2,646,4479,3578711578,3578711578,0
2,646,4480,3578711578,3578711578,0
2,646,4481,3578711578,3578711581,3
2,646,4482,3578711578,3578711581,3
2,646,4483,3578711578,3578711587,9
2,646,4484,3578711578,3578711590,12
2,646,4485,3578711578,3578711591,13
2,646,4486,3578711578,3578711593,15
2,646,4487,3578711578,3578711595,17
2,646,4488,3578711578,3578711597,19
2,646,4489,3578711578,3578711599,21
2,646,4490,3578711578,3578711603,25
2,646,4491,3578711578,3578711603,25
2,646,4492,3578711578,3578711606,28
2,646,4493,3578711578,3578711609,31
2,646,4494,3578711578,3578711609,31
2,646,4495,3578711578,3578711614,36
2,646,4496,3578711578,3578711616,38
2,646,4497,3578711578,3578711617,39
2,646,4498,3578711578,3578711618,40
2,646,4499,3578711578,3578711619,41
2,646,4500,3578711578,3578711622,44
2,646,4501,3578711578,3578711624,46
2,646,4502,3578711578,3578711626,48
2,646,4503,3578711578,3578711627,49
2,647,4504,3578711631,3578711633,2
2,647,4505,3578711631,3578711636,5
2,647,4506,3578711631,3578711636,5
2,647,4507,3578711631,3578711636,5
2,647,4508,3578711631,3578711641,10
2,647,4509,3578711631,3578711641,10
2,647,4510,3578711631,3578711641,10
2,647,4511,3578711631,3578711641,10
2,647,4512,3578711631,3578711643,12
2,647,4513,3578711631,3578711650,19
2,647,4514,3578711631,3578711653,22
2,647,4515,3578711631,3578711659,28
2,647,4516,3578711631,3578711660,29
2,647,4517,3578711631,3578711662,31
2,647,4518,3578711631,3578711665,34
2,647,4519,3578711631,3578711666,35
2,647,4520,3578711631,3578711667,36
2,647,4521,3578711631,3578711676,45
2,647,4522,3578711631,3578711680,49
2,647,4523,3578711631,3578711680,49
2,648,4524,3578711685,3578711685,0
2,648,4525,3578711685,3578711685,0
2,648,4526,3578711685,3578711685,0
2,648,4527,3578711685,3578711686,1
2,648,4528,3578711685,3578711688,3
2,648,4529,3578711685,3578711690,5
2,648,4530,3578711685,3578711691,6
2,648,4531,3578711685,3578711692,7
2,648,4532,3578711685,3578711693,8
2,648,4533,3578711685,3578711696,11
2,648,4534,3578711685,3578711703,18
2,648,4535,3578711685,3578711704,19
2,648,4536,3578711685,3578711707,22
2,648,4537,3578711685,3578711707,22
2,648,4538,3578711685,3578711707,22
2,648,4539,3578711685,3578711708,23
2,648,4540,3578711685,3578711710,25
2,648,4541,3578711685,3578711711,26
2,648,4542,3578711685,3578711712,27
2,648,4543,3578711685,3578711713,28
2,648,4544,3578711685,3578711713,28
2,648,4545,3578711685,3578711714,29
2,648,4546,3578711685,3578711714,29
2,648,4547,3578711685,3578711716,31
2,648,4548,3578711685,3578711717,32
2,648,4549,3578711685,3578711723,38
2,648,4550,3578711685,3578711726,41
2,648,4551,3578711685,3578711727,42
2,648,4552,3578711685,3578711730,45
2,648,4553,3578711685,3578711732,47
2,648,4554,3578711685,3578711733,48
2,648,4555,3578711685,3578711734,49
2,648,4556,3578711685,3578711735,50
2,649,4557,3578711738,3578711738,0
2,649,4558,3578711738,3578711743,5
2,649,4559,3578711738,3578711748,10
2,649,4560,3578711738,3578711749,11
2,649,4561,3578711738,3578711752,14
2,649,4562,3578711738,3578711754,16
2,649,4563,3578711738,3578711756,18
2,649,4564,3578711738,3578711757,19
2,649,4565,3578711738,3578711760,22
2,649,4566,3578711738,3578711762,24
2,649,4567,3578711738,3578711764,26
2,649,4568,3578711738,3578711766,28
2,649,4569,3578711738,3578711767,29
2,649,4570,3578711738,3578711768,30
2,649,4571,3578711738,3578711771,33
2,649,4572,3578711738,3578711775,37
2,649,4573,3578711738,3578711781,43
2,649,4574,3578711738,3578711781,43
2,650,4575,3578711791,3578711791,0
2,650,4576,3578711791,3578711791,0
2,650,4577,3578711791,3578711791,0
2,650,4578,3578711791,3578711793,2
2,650,4579,3578711791,3578711795,4
2,650,4580,3578711791,3578711798,7
2,650,4581,3578711791,3578711798,7
2,650,4582,3578711791,3578711802,11
2,650,4583,3578711791,3578711803,12
2,650,4584,3578711791,3578711806,15
2,650,4585,3578711791,3578711809,18
2,650,4586,3578711791,3578711810,19
2,650,4587,3578711791,3578711813,22
2,650,4588,3578711791,3578711816,25
2,650,4589,3578711791,3578711817,26
2,650,4590,3578711791,3578711818,27
2,650,4591,3578711791,3578711820,29
2,650,4592,3578711791,3578711822,31
2,650,4593,3578711791,3578711823,32
2,650,4594,3578711791,3578711827,36
2,650,4595,3578711791,3578711827,36
2,650,4596,3578711791,3578711833,42
2,650,4597,3578711791,3578711835,44
2,650,4598,3578711791,3578711836,45
2,650,4599,3578711791,3578711837,46
2,650,4600,3578711791,3578711840,49
2,650,4601,3578711791,3578711841,50
2,651,4602,3578711844,3578711844,0
2,651,4603,3578711844,3578711844,0
2,651,4604,3578711844,3578711844,0
2,651,4605,3578711844,3578711846,2
2,651,4606,3578711844,3578711851,7
2,651,4607,3578711844,3578711853,9
2,651,4608,3578711844,3578711860,16
2,651,4609,3578711844,3578711861,17
2,651,4610,3578711844,3578711862,18
2,651,4611,3578711844,3578711865,21
2,651,4612,3578711844,3578711866,22
2,651,4613,3578711844,3578711868,24
2,651,4614,3578711844,3578711868,24
2,651,4615,3578711844,3578711876,32
2,651,4616,3578711844,3578711880,36
2,651,4617,3578711844,3578711881,37
2,651,4618,3578711844,3578711883,39
2,651,4619,3578711844,3578711884,40
2,651,4620,3578711844,3578711884,40
2,651,4621,3578711844,3578711886,42
2,651,4622,3578711844,3578711888,44
2,651,4623,3578711844,3578711889,45
2,651,4624,3578711844,3578711891,47
2,651,4625,3578711844,3578711891,47
2,652,4626,3578711898,3578711898,0
2,652,4627,3578711898,3578711904,6
2,652,4628,3578711898,3578711905,7
2,652,4629,3578711898,3578711907,9
2,652,4630,3578711898,3578711907,9
2,652,4631,3578711898,3578711907,9
2,652,4632,3578711898,3578711908,10
2,652,4633,3578711898,3578711910,12
2,652,4634,3578711898,3578711912,14
2,652,4635,3578711898,3578711912,14
2,652,4636,3578711898,3578711913,15
2,652,4637,3578711898,3578711913,15
2,652,4638,3578711898,3578711914,16
2,652,4639,3578711898,3578711914,16
2,652,4640,3578711898,3578711917,19
2,652,4641,3578711898,3578711917,19
2,652,4642,3578711898,3578711918,20
2,652,4643,3578711898,3578711922,24
2,652,4644,3578711898,3578711926,28
2,652,4645,3578711898,3578711926,28
2,652,4646,3578711898,3578711930,32
2,652,4647,3578711898,3578711933,35
2,652,4648,3578711898,3578711933,35
2,652,4649,3578711898,3578711934,36
2,652,4650,3578711898,3578711938,40
2,652,4651,3578711898,3578711943,45
2,653,4652,3578711951,3578711951,0
2,653,4653,3578711951,3578711951,0
2,653,4654,3578711951,3578711952,1
2,653,4655,3578711951,3578711954,3
2,653,4656,3578711951,3578711956,5
2,653,4657,3578711951,3578711957,6
2,653,4658,3578711951,3578711960,9
2,653,4659,3578711951,3578711963,12
2,653,4660,3578711951,3578711965,14
2,653,4661,3578711951,3578711966,15
2,653,4662,3578711951,3578711967,16
2,653,4663,3578711951,3578711968,17
2,653,4664,3578711951,3578711971,20
2,653,4665,3578711951,3578711976,25
2,653,4666,3578711951,3578711980,29
2,653,4667,3578711951,3578711980,29
2,653,4668,3578711951,3578711987,36
2,653,4669,3578711951,3578711990,39
2,653,4670,3578711951,3578711993,42
2,653,4671,3578711951,3578711995,44
2,653,4672,3578711951,3578712000,49
2,654,4673,3578712004,3578712004,0
2,654,4674,3578712004,3578712004,0
2,654,4675,3578712004,3578712006,2
2,654,4676,3578712004,3578712008,4
2,654,4677,3578712004,3578712011,7
2,654,4678,3578712004,3578712013,9
2,654,4679,3578712004,3578712016,12
2,654,4680,3578712004,3578712017,13
2,654,4681,3578712004,3578712018,14
2,654,4682,3578712004,3578712019,15
2,654,4683,3578712004,3578712022,18
2,654,4684,3578712004,3578712025,21
2,654,4685,3578712004,3578712027,23
2,654,4686,3578712004,3578712028,24
2,654,4687,3578712004,3578712033,29
2,654,4688,3578712004,3578712037,33
2,654,4689,3578712004,3578712037,33
2,654,4690,3578712004,3578712037,33
2,654,4691,3578712004,3578712041,37
2,654,4692,3578712004,3578712041,37
2,654,4693,3578712004,3578712042,38
2,654,4694,3578712004,3578712043,39
2,654,4695,3578712004,3578712043,39
2,654,4696,3578712004,3578712046,42
2,654,4697,3578712004,3578712051,47
2,654,4698,3578712004,3578712053,49
2,655,4699,3578712057,3578712058,1
2,655,4700,3578712057,3578712060,3
2,655,4701,3578712057,3578712061,4
2,655,4702,3578712057,3578712063,6
2,655,4703,3578712057,3578712065,8
2,655,4704,3578712057,3578712067,10
2,655,4705,3578712057,3578712068,11
2,655,4706,3578712057,3578712068,11
2,655,4707,3578712057,3578712070,13
2,655,4708,3578712057,3578712077,20
2,655,4709,3578712057,3578712080,23
2,655,4710,3578712057,3578712081,24
2,655,4711,3578712057,3578712084,27
2,655,4712,3578712057,3578712085,28
2,655,4713,3578712057,3578712087,30
2,655,4714,3578712057,3578712089,32
2,655,4715,3578712057,3578712091,34
2,655,4716,3578712057,3578712092,35
2,655,4717,3578712057,3578712094,37
2,655,4718,3578712057,3578712097,40
2,655,4719,3578712057,3578712104,47
2,655,4720,3578712057,3578712105,48
2,655,4721,3578712057,3578712106,49
2,656,4722,3578712110,3578712110,0
2,656,4723,3578712110,3578712111,1
2,656,4724,3578712110,3578712111,1
2,656,4725,3578712110,3578712111,1
2,656,4726,3578712110,3578712111,1
2,656,4727,3578712110,3578712113,3
2,656,4728,3578712110,3578712113,3
2,656,4729,3578712110,3578712114,4
2,656,4730,3578712110,3578712114,4
2,656,4731,3578712110,3578712115,5
2,656,4732,3578712110,3578712117,7
2,656,4733,3578712110,3578712117,7
2,656,4734,3578712110,3578712118,8
2,656,4735,3578712110,3578712122,12
2,656,4736,3578712110,3578712126,16
2,656,4737,3578712110,3578712128,18
2,656,4738,3578712110,3578712129,19
2,656,4739,3578712110,3578712132,22
2,656,4740,3578712110,3578712133,23
2,656,4741,3578712110,3578712134,24
2,656,4742,3578712110,3578712138,28
2,656,4743,3578712110,3578712143,33
2,656,4744,3578712110,3578712149,39
2,656,4745,3578712110,3578712150,40
2,656,4746,3578712110,3578712153,43
2,656,4747,3578712110,3578712154,44
2,656,4748,3578712110,3578712157,47
2,657,4749,3578712163,3578712163,0
2,657,4750,3578712163,3578712163,0
2,657,4751,3578712163,3578712166,3
2,657,4752,3578712163,3578712166,3
2,657,4753,3578712163,3578712167,4
2,657,4754,3578712163,3578712167,4
2,657,4755,3578712163,3578712172,9
2,657,4756,3578712163,3578712176,13
2,657,4757,3578712163,3578712176,13
2,657,4758,3578712163,3578712181,18
2,657,4759,3578712163,3578712181,18
2,657,4760,3578712163,3578712189,26
2,657,4761,3578712163,3578712191,28
2,657,4762,3578712163,3578712191,28
2,657,4763,3578712163,3578712194,31
2,657,4764,3578712163,3578712195,32
2,657,4765,3578712163,3578712200,37
2,657,4766,3578712163,3578712203,40
2,657,4767,3578712163,3578712204,41
2,657,4768,3578712163,3578712206,43
2,657,4769,3578712163,3578712209,46
2,657,4770,3578712163,3578712210,47
2,658,4771,3578712217,3578712217,0
2,658,4772,3578712217,3578712217,0
2,658,4773,3578712217,3578712217,0
2,658,4774,3578712217,3578712218,1
2,658,4775,3578712217,3578712219,2
2,658,4776,3578712217,3578712222,5
2,658,4777,3578712217,3578712222,5
2,658,4778,3578712217,3578712224,7
2,658,4779,3578712217,3578712227,10
2,658,4780,3578712217,3578712227,10
2,658,4781,3578712217,3578712234,17
2,658,4782,3578712217,3578712236,19
2,658,4783,3578712217,3578712237,20
2,658,4784,3578712217,3578712238,21
2,658,4785,3578712217,3578712241,24
2,658,4786,3578712217,3578712242,25
2,658,4787,3578712217,3578712242,25
2,658,4788,3578712217,3578712243,26
2,658,4789,3578712217,3578712243,26
2,658,4790,3578712217,3578712246,29
2,658,4791,3578712217,3578712250,33
2,658,4792,3578712217,3578712253,36
2,658,4793,3578712217,3578712259,42
2,658,4794,3578712217,3578712260,43
2,658,4795,3578712217,3578712261,44
2,658,4796,3578712217,3578712264,47
2,658,4797,3578712217,3578712264,47
2,659,4798,3578712271,3578712271,0
2,659,4799,3578712271,3578712271,0
2,659,4800,3578712271,3578712271,0
2,659,4801,3578712271,3578712271,0
2,659,4802,3578712271,3578712277,6
2,659,4803,3578712271,3578712281,10
2,659,4804,3578712271,3578712283,12
2,659,4805,3578712271,3578712285,14
2,659,4806,3578712271,3578712288,17
2,659,4807,3578712271,3578712288,17
2,659,4808,3578712271,3578712291,20
2,659,4809,3578712271,3578712291,20
2,659,4810,3578712271,3578712293,22
2,659,4811,3578712271,3578712298,27
2,659,4812,3578712271,3578712305,34
2,659,4813,3578712271,3578712305,34
2,659,4814,3578712271,3578712307,36
2,659,4815,3578712271,3578712308,37
2,659,4816,3578712271,3578712309,38
2,659,4817,3578712271,3578712309,38
2,659,4818,3578712271,3578712311,40
2,659,4819,3578712271,3578712312,41
2,659,4820,3578712271,3578712313,42
2,659,4821,3578712271,3578712313,42
2,659,4822,3578712271,3578712314,43
2,659,4823,3578712271,3578712314,43
2,659,4824,3578712271,3578712315,44
2,659,4825,3578712271,3578712317,46
2,659,4826,3578712271,3578712317,46
2,659,4827,3578712271,3578712319,48
2,660,4828,3578712324,3578712324,0
2,660,4829,3578712324,3578712327,3
2,660,4830,3578712324,3578712327,3
2,660,4831,3578712324,3578712329,5
2,660,4832,3578712324,3578712332,8
2,660,4833,3578712324,3578712332,8
2,660,4834,3578712324,3578712335,11
2,660,4835,3578712324,3578712335,11
2,660,4836,3578712324,3578712337,13
2,660,4837,3578712324,3578712344,20
2,660,4838,3578712324,3578712349,25
2,660,4839,3578712324,3578712350,26
2,660,4840,3578712324,3578712352,28
2,660,4841,3578712324,3578712355,31
2,660,4842,3578712324,3578712357,33
2,660,4843,3578712324,3578712360,36
2,660,4844,3578712324,3578712363,39
2,660,4845,3578712324,3578712366,42
2,660,4846,3578712324,3578712367,43
2,660,4847,3578712324,3578712367,43
2,660,4848,3578712324,3578712369,45
2,660,4849,3578712324,3578712371,47
2,660,4850,3578712324,3578712373,49
2,661,4851,3578712379,3578712379,0
2,661,4852,3578712379,3578712379,0
2,661,4853,3578712379,3578712380,1
2,661,4854,3578712379,3578712381,2
2,661,4855,3578712379,3578712389,10
2,661,4856,3578712379,3578712391,12
2,661,4857,3578712379,3578712391,12
2,661,4858,3578712379,3578712393,14
2,661,4859,3578712379,3578712395,16
2,661,4860,3578712379,3578712399,20
2,661,4861,3578712379,3578712400,21
2,661,4862,3578712379,3578712403,24
2,661,4863,3578712379,3578712404,25
2,661,4864,3578712379,3578712406,27
2,661,4865,3578712379,3578712408,29
2,661,4866,3578712379,3578712410,31
2,661,4867,3578712379,3578712414,35
2,661,4868,3578712379,3578712419,40
2,661,4869,3578712379,3578712419,40
2,661,4870,3578712379,3578712420,41
2,661,4871,3578712379,3578712422,43
2,661,4872,3578712379,3578712422,43
2,661,4873,3578712379,3578712424,45
2,661,4874,3578712379,3578712427,48
2,661,4875,3578712379,3578712427,48
2,662,4876,3578712432,3578712434,2
2,662,4877,3578712432,3578712437,5
2,662,4878,3578712432,3578712437,5
2,662,4879,3578712432,3578712442,10
2,662,4880,3578712432,3578712442,10
2,662,4881,3578712432,3578712442,10
2,662,4882,3578712432,3578712443,11
2,662,4883,3578712432,3578712443,11
2,662,4884,3578712432,3578712446,14
2,662,4885,3578712432,3578712451,19
2,662,4886,3578712432,3578712454,22
2,662,4887,3578712432,3578712458,26
2,662,4888,3578712432,3578712460,28
2,662,4889,3578712432,3578712461,29
2,662,4890,3578712432,3578712464,32
2,662,4891,3578712432,3578712464,32
2,662,4892,3578712432,3578712467,35
2,662,4893,3578712432,3578712468,36
2,662,4894,3578712432,3578712469,37
2,662,4895,3578712432,3578712470,38
2,662,4896,3578712432,3578712477,45
2,662,4897,3578712432,3578712480,48
2,662,4898,3578712432,3578712481,49
2,663,4899,3578712486,3578712486,0
2,663,4900,3578712486,3578712486,0
2,663,4901,3578712486,3578712486,0
2,663,4902,3578712486,3578712487,1
2,663,4903,3578712486,3578712487,1
2,663,4904,3578712486,3578712489,3
2,663,4905,3578712486,3578712490,4
2,663,4906,3578712486,3578712490,4
2,663,4907,3578712486,3578712493,7
2,663,4908,3578712486,3578712497,11
2,663,4909,3578712486,3578712503,17
2,663,4910,3578712486,3578712504,18
2,663,4911,3578712486,3578712507,21
2,663,4912,3578712486,3578712507,21
2,663,4913,3578712486,3578712507,21
2,663,4914,3578712486,3578712510,24
2,663,4915,3578712486,3578712511,25
2,663,4916,3578712486,3578712512,26
2,663,4917,3578712486,3578712512,26
2,663,4918,3578712486,3578712512,26
2,663,4919,3578712486,3578712513,27
2,663,4920,3578712486,3578712514,28
2,663,4921,3578712486,3578712515,29
2,663,4922,3578712486,3578712515,29
2,663,4923,3578712486,3578712518,32
2,663,4924,3578712486,3578712522,36
2,663,4925,3578712486,3578712525,39
2,663,4926,3578712486,3578712527,41
2,663,4927,3578712486,3578712530,44
2,663,4928,3578712486,3578712532,46
2,663,4929,3578712486,3578712532,46
2,663,4930,3578712486,3578712534,48
2,663,4931,3578712486,3578712535,49
2,664,4932,3578712539,3578712539,0
2,664,4933,3578712539,3578712543,4
2,664,4934,3578712539,3578712548,9
2,664,4935,3578712539,3578712549,10
2,664,4936,3578712539,3578712552,13
2,664,4937,3578712539,3578712554,15
2,664,4938,3578712539,3578712557,18
2,664,4939,3578712539,3578712562,23
2,664,4940,3578712539,3578712563,24
2,664,4941,3578712539,3578712564,25
2,664,4942,3578712539,3578712567,28
2,664,4943,3578712539,3578712567,28
2,664,4944,3578712539,3578712567,28
2,664,4945,3578712539,3578712570,31
2,664,4946,3578712539,3578712573,34
2,664,4947,3578712539,3578712576,37
2,664,4948,3578712539,3578712576,37
2,664,4949,3578712539,3578712581,42
2,664,4950,3578712539,3578712581,42
2,664,4951,3578712539,3578712588,49
2,665,4952,3578712593,3578712593,0
2,665,4953,3578712593,3578712593,0
2,665,4954,3578712593,3578712593,0
2,665,4955,3578712593,3578712594,1
2,665,4956,3578712593,3578712595,2
2,665,4957,3578712593,3578712598,5
2,665,4958,3578712593,3578712602,9
2,665,4959,3578712593,3578712602,9
2,665,4960,3578712593,3578712606,13
2,665,4961,3578712593,3578712608,15
2,665,4962,3578712593,3578712609,16
2,665,4963,3578712593,3578712613,20
2,665,4964,3578712593,3578712619,26
2,665,4965,3578712593,3578712619,26
2,665,4966,3578712593,3578712620,27
2,665,4967,3578712593,3578712621,28
2,665,4968,3578712593,3578712621,28
2,665,4969,3578712593,3578712623,30
2,665,4970,3578712593,3578712626,33
2,665,4971,3578712593,3578712626,33
2,665,4972,3578712593,3578712633,40
2,665,4973,3578712593,3578712635,42
2,665,4974,3578712593,3578712636,43
2,665,4975,3578712593,3578712641,48
2,665,4976,3578712593,3578712641,48
2,665,4977,3578712593,3578712642,49
2,665,4978,3578712593,3578712642,49
2,665,4979,3578712593,3578712643,50
2,666,4980,3578712647,3578712647,0
2,666,4981,3578712647,3578712650,3
2,666,4982,3578712647,3578712652,5
2,666,4983,3578712647,3578712657,10
2,666,4984,3578712647,3578712659,12
2,666,4985,3578712647,3578712660,13
2,666,4986,3578712647,3578712662,15
2,666,4987,3578712647,3578712664,17
2,666,4988,3578712647,3578712666,19
2,666,4989,3578712647,3578712668,21
2,666,4990,3578712647,3578712668,21
2,666,4991,3578712647,3578712669,22
2,666,4992,3578712647,3578712676,29
2,666,4993,3578712647,3578712680,33
2,666,4994,3578712647,3578712682,35
2,666,4995,3578712647,3578712683,36
2,666,4996,3578712647,3578712684,37
2,666,4997,3578712647,3578712684,37
2,666,4998,3578712647,3578712687,40
2,666,4999,3578712647,3578712687,40
2,666,5000,3578712647,3578712689,42
2,666,5001,3578712647,3578712690,43
2,666,5002,3578712647,3578712690,43
2,666,5003,3578712647,3578712692,45
2,667,5004,3578712701,3578712701,0
2,667,5005,3578712701,3578712704,3
2,667,5006,3578712701,3578712705,4
2,667,5007,3578712701,3578712707,6
2,667,5008,3578712701,3578712708,7
2,667,5009,3578712701,3578712708,7
2,667,5010,3578712701,3578712711,10
2,667,5011,3578712701,3578712711,10
2,667,5012,3578712701,3578712711,10
2,667,5013,3578712701,3578712712,11
2,667,5014,3578712701,3578712712,11
2,667,5015,3578712701,3578712713,12
2,667,5016,3578712701,3578712714,13
2,667,5017,3578712701,3578712716,15
2,667,5018,3578712701,3578712716,15
2,667,5019,3578712701,3578712718,17
2,667,5020,3578712701,3578712726,25
2,667,5021,3578712701,3578712726,25
2,667,5022,3578712701,3578712729,28
2,667,5023,3578712701,3578712731,30
2,667,5024,3578712701,3578712732,31
2,667,5025,3578712701,3578712734,33
2,667,5026,3578712701,3578712735,34
2,667,5027,3578712701,3578712736,35
2,667,5028,3578712701,3578712743,42
2,667,5029,3578712701,3578712748,47
2,667,5030,3578712701,3578712749,48
2,667,5031,3578712701,3578712751,50
2,668,5032,3578712754,3578712754,0
2,668,5033,3578712754,3578712755,1
2,668,5034,3578712754,3578712757,3
2,668,5035,3578712754,3578712758,4
2,668,5036,3578712754,3578712762,8
2,668,5037,3578712754,3578712763,9
2,668,5038,3578712754,3578712766,12
2,668,5039,3578712754,3578712767,13
2,668,5040,3578712754,3578712768,14
2,668,5041,3578712754,3578712772,18
2,668,5042,3578712754,3578712773,19
2,668,5043,3578712754,3578712776,22
2,668,5044,3578712754,3578712776,22
2,668,5045,3578712754,3578712780,26
2,668,5046,3578712754,3578712780,26
2,668,5047,3578712754,3578712788,34
2,668,5048,3578712754,3578712790,36
2,668,5049,3578712754,3578712791,37
2,668,5050,3578712754,3578712794,40
2,668,5051,3578712754,3578712795,41
2,668,5052,3578712754,3578712795,41
2,668,5053,3578712754,3578712799,45
2,668,5054,3578712754,3578712802,48
2,668,5055,3578712754,3578712803,49
2,669,5056,3578712808,3578712808,0
2,669,5057,3578712808,3578712808,0
2,669,5058,3578712808,3578712810,2
2,669,5059,3578712808,3578712813,5
2,669,5060,3578712808,3578712815,7
2,669,5061,3578712808,3578712818,10
2,669,5062,3578712808,3578712819,11
2,669,5063,3578712808,3578712820,12
2,669,5064,3578712808,3578712821,13
2,669,5065,3578712808,3578712822,14
2,669,5066,3578712808,3578712824,16
2,669,5067,3578712808,3578712826,18
2,669,5068,3578712808,3578712826,18
2,669,5069,3578712808,3578712834,26
2,669,5070,3578712808,3578712835,27
2,669,5071,3578712808,3578712837,29
2,669,5072,3578712808,3578712838,30
2,669,5073,3578712808,3578712841,33
2,669,5074,3578712808,3578712841,33
2,669,5075,3578712808,3578712842,34
2,669,5076,3578712808,3578712842,34
2,669,5077,3578712808,3578712843,35
2,669,5078,3578712808,3578712846,38
2,669,5079,3578712808,3578712850,42
2,669,5080,3578712808,3578712853,45
2,669,5081,3578712808,3578712858,50
2,670,5082,3578712862,3578712862,0
2,670,5083,3578712862,3578712862,0
2,670,5084,3578712862,3578712864,2
2,670,5085,3578712862,3578712867,5
2,670,5086,3578712862,3578712867,5
2,670,5087,3578712862,3578712869,7
2,670,5088,3578712862,3578712869,7
2,670,5089,3578712862,3578712876,14
2,670,5090,3578712862,3578712880,18
2,670,5091,3578712862,3578712882,20
2,670,5092,3578712862,3578712883,21
2,670,5093,3578712862,3578712884,22
2,670,5094,3578712862,3578712884,22
2,670,5095,3578712862,3578712887,25
2,670,5096,3578712862,3578712888,26
2,670,5097,3578712862,3578712889,27
2,670,5098,3578712862,3578712890,28
2,670,5099,3578712862,3578712890,28
2,670,5100,3578712862,3578712892,30
2,670,5101,3578712862,3578712893,31
2,670,5102,3578712862,3578712897,35
2,670,5103,3578712862,3578712904,42
2,670,5104,3578712862,3578712905,43
2,670,5105,3578712862,3578712907,45
2,670,5106,3578712862,3578712908,46
2,670,5107,3578712862,3578712908,46
2,670,5108,3578712862,3578712910,48
2,670,5109,3578712862,3578712911,49
2,670,5110,3578712862,3578712912,50
2,671,5111,3578712915,3578712915,0
2,671,5112,3578712915,3578712915,0
2,671,5113,3578712915,3578712915,0
2,671,5114,3578712915,3578712915,0
2,671,5115,3578712915,3578712915,0
2,671,5116,3578712915,3578712916,1
2,671,5117,3578712915,3578712917,2
2,671,5118,3578712915,3578712925,10
2,671,5119,3578712915,3578712927,12
2,671,5120,3578712915,3578712930,15
2,671,5121,3578712915,3578712932,17
2,671,5122,3578712915,3578712933,18
2,671,5123,3578712915,3578712934,19
2,671,5124,3578712915,3578712935,20
2,671,5125,3578712915,3578712937,22
2,671,5126,3578712915,3578712943,28
2,671,5127,3578712915,3578712948,33
2,671,5128,3578712915,3578712950,35
2,671,5129,3578712915,3578712952,37
2,671,5130,3578712915,3578712954,39
2,671,5131,3578712915,3578712955,40
2,671,5132,3578712915,3578712957,42
2,671,5133,3578712915,3578712959,44
2,671,5134,3578712915,3578712963,48
2,671,5135,3578712915,3578712963,48
2,672,5136,3578712968,3578712968,0
2,672,5137,3578712968,3578712968,0
2,672,5138,3578712968,3578712968,0
2,672,5139,3578712968,3578712972,4
2,672,5140,3578712968,3578712972,4
2,672,5141,3578712968,3578712976,8
2,672,5142,3578712968,3578712976,8
2,672,5143,3578712968,3578712980,12
2,672,5144,3578712968,3578712981,13
2,672,5145,3578712968,3578712988,20
2,672,5146,3578712968,3578712990,22
2,672,5147,3578712968,3578712991,23
2,672,5148,3578712968,3578712995,27
2,672,5149,3578712968,3578712995,27
2,672,5150,3578712968,3578712998,30
2,672,5151,3578712968,3578713000,32
2,672,5152,3578712968,3578713002,34
2,672,5153,3578712968,3578713003,35
2,672,5154,3578712968,3578713006,38
2,672,5155,3578712968,3578713008,40
2,672,5156,3578712968,3578713010,42
2,672,5157,3578712968,3578713014,46
2,672,5158,3578712968,3578713014,46
2,673,5159,3578713022,3578713022,0
2,673,5160,3578713022,3578713022,0
2,673,5161,3578713022,3578713022,0
2,673,5162,3578713022,3578713022,0
2,673,5163,3578713022,3578713022,0
2,673,5164,3578713022,3578713025,3
2,673,5165,3578713022,3578713026,4
2,673,5166,3578713022,3578713027,5
2,673,5167,3578713022,3578713033,11
2,673,5168,3578713022,3578713036,14
2,673,5169,3578713022,3578713037,15
2,673,5170,3578713022,3578713038,16
2,673,5171,3578713022,3578713041,19
2,673,5172,3578713022,3578713042,20
2,673,5173,3578713022,3578713042,20
2,673,5174,3578713022,3578713042,20
2,673,5175,3578713022,3578713042,20
2,673,5176,3578713022,3578713046,24
2,673,5177,3578713022,3578713051,29
2,673,5178,3578713022,3578713053,31
2,673,5179,3578713022,3578713057,35
2,673,5180,3578713022,3578713061,39
2,673,5181,3578713022,3578713061,39
2,673,5182,3578713022,3578713065,43
2,673,5183,3578713022,3578713067,45
2,673,5184,3578713022,3578713067,45
2,673,5185,3578713022,3578713069,47
2,673,5186,3578713022,3578713070,48
2,674,5187,3578713076,3578713077,1
2,674,5188,3578713076,3578713080,4
2,674,5189,3578713076,3578713082,6
2,674,5190,3578713076,3578713083,7
2,674,5191,3578713076,3578713084,8
2,674,5192,3578713076,3578713084,8
2,674,5193,3578713076,3578713084,8
2,674,5194,3578713076,3578713087,11
2,674,5195,3578713076,3578713087,11
2,674,5196,3578713076,3578713090,14
2,674,5197,3578713076,3578713090,14
2,674,5198,3578713076,3578713091,15
2,674,5199,3578713076,3578713092,16
2,674,5200,3578713076,3578713093,17
2,674,5201,3578713076,3578713097,21
2,674,5202,3578713076,3578713103,27
2,674,5203,3578713076,3578713105,29
2,674,5204,3578713076,3578713107,31
2,674,5205,3578713076,3578713107,31
2,674,5206,3578713076,3578713108,32
2,674,5207,3578713076,3578713111,35
2,674,5208,3578713076,3578713111,35
2,674,5209,3578713076,3578713113,37
2,674,5210,3578713076,3578713113,37
2,674,5211,3578713076,3578713114,38
2,674,5212,3578713076,3578713114,38
2,674,5213,3578713076,3578713115,39
2,674,5214,3578713076,3578713116,40
2,674,5215,3578713076,3578713118,42
2,674,5216,3578713076,3578713122,46
2,674,5217,3578713076,3578713125,49
2,675,5218,3578713129,3578713129,0
2,675,5219,3578713129,3578713130,1
2,675,5220,3578713129,3578713132,3
2,675,5221,3578713129,3578713133,4
2,675,5222,3578713129,3578713134,5
2,675,5223,3578713129,3578713135,6
2,675,5224,3578713129,3578713135,6
2,675,5225,3578713129,3578713138,9
2,675,5226,3578713129,3578713143,14
2,675,5227,3578713129,3578713149,20
2,675,5228,3578713129,3578713150,21
2,675,5229,3578713129,3578713153,24
2,675,5230,3578713129,3578713154,25
2,675,5231,3578713129,3578713156,27
2,675,5232,3578713129,3578713157,28
2,675,5233,3578713129,3578713159,30
2,675,5234,3578713129,3578713163,34
2,675,5235,3578713129,3578713164,35
2,675,5236,3578713129,3578713165,36
2,675,5237,3578713129,3578713167,38
2,675,5238,3578713129,3578713167,38
2,675,5239,3578713129,3578713167,38
2,675,5240,3578713129,3578713168,39
2,675,5241,3578713129,3578713173,44
2,675,5242,3578713129,3578713173,44
2,675,5243,3578713129,3578713176,47
2,675,5244,3578713129,3578713177,48
2,676,5245,3578713182,3578713182,0
2,676,5246,3578713182,3578713182,0
2,676,5247,3578713182,3578713189,7
2,676,5248,3578713182,3578713190,8
2,676,5249,3578713182,3578713190,8
2,676,5250,3578713182,3578713194,12
2,676,5251,3578713182,3578713195,13
2,676,5252,3578713182,3578713200,18
2,676,5253,3578713182,3578713203,21
2,676,5254,3578713182,3578713203,21
2,676,5255,3578713182,3578713206,24
2,676,5256,3578713182,3578713208,26
2,676,5257,3578713182,3578713210,28
2,676,5258,3578713182,3578713214,32
2,676,5259,3578713182,3578713216,34
2,676,5260,3578713182,3578713219,37
2,676,5261,3578713182,3578713221,39
2,676,5262,3578713182,3578713221,39
2,676,5263,3578713182,3578713221,39
2,676,5264,3578713182,3578713222,40
2,676,5265,3578713182,3578713225,43
2,676,5266,3578713182,3578713227,45
2,676,5267,3578713182,3578713227,45
2,677,5268,3578713235,3578713235,0
2,677,5269,3578713235,3578713236,1
2,677,5270,3578713235,3578713236,1
2,677,5271,3578713235,3578713236,1
2,677,5272,3578713235,3578713237,2
2,677,5273,3578713235,3578713241,6
2,677,5274,3578713235,3578713242,7
2,677,5275,3578713235,3578713242,7
2,677,5276,3578713235,3578713242,7
2,677,5277,3578713235,3578713243,8
2,677,5278,3578713235,3578713246,11
2,677,5279,3578713235,3578713251,16
2,677,5280,3578713235,3578713253,18
2,677,5281,3578713235,3578713257,22
2,677,5282,3578713235,3578713261,26
2,677,5283,3578713235,3578713261,26
2,677,5284,3578713235,3578713265,30
2,677,5285,3578713235,3578713267,32
2,677,5286,3578713235,3578713267,32
2,677,5287,3578713235,3578713269,34
2,677,5288,3578713235,3578713271,36
2,677,5289,3578713235,3578713276,41
2,677,5290,3578713235,3578713281,46
2,677,5291,3578713235,3578713281,46
2,677,5292,3578713235,3578713283,48
2,677,5293,3578713235,3578713283,48
2,677,5294,3578713235,3578713284,49
2,677,5295,3578713235,3578713284,49
2,678,5296,3578713289,3578713289,0
2,678,5297,3578713289,3578713289,0
2,678,5298,3578713289,3578713289,0
2,678,5299,3578713289,3578713290,1
2,678,5300,3578713289,3578713290,1
2,678,5301,3578713289,3578713290,1
2,678,5302,3578713289,3578713292,3
2,678,5303,3578713289,3578713294,5
2,678,5304,3578713289,3578713297,8
2,678,5305,3578713289,3578713303,14
2,678,5306,3578713289,3578713305,16
2,678,5307,3578713289,3578713307,18
2,678,5308,3578713289,3578713308,19
2,678,5309,3578713289,3578713308,19
2,678,5310,3578713289,3578713310,21
2,678,5311,3578713289,3578713312,23
2,678,5312,3578713289,3578713312,23
2,678,5313,3578713289,3578713313,24
2,678,5314,3578713289,3578713314,25
2,678,5315,3578713289,3578713314,25
2,678,5316,3578713289,3578713314,25
2,678,5317,3578713289,3578713317,28
2,678,5318,3578713289,3578713317,28
2,678,5319,3578713289,3578713317,28
2,678,5320,3578713289,3578713322,33
2,678,5321,3578713289,3578713325,36
2,678,5322,3578713289,3578713327,38
2,678,5323,3578713289,3578713331,42
2,678,5324,3578713289,3578713332,43
2,678,5325,3578713289,3578713333,44
2,678,5326,3578713289,3578713334,45
2,678,5327,3578713289,3578713335,46
2,678,5328,3578713289,3578713335,46
2,678,5329,3578713289,3578713338,49
2,679,5330,3578713342,3578713343,1
2,679,5331,3578713342,3578713348,6
2,679,5332,3578713342,3578713351,9
2,679,5333,3578713342,3578713353,11
2,679,5334,3578713342,3578713355,13
2,679,5335,3578713342,3578713356,14
2,679,5336,3578713342,3578713359,17
2,679,5337,3578713342,3578713363,21
2,679,5338,3578713342,3578713366,24
2,679,5339,3578713342,3578713366,24
2,679,5340,3578713342,3578713367,25
2,679,5341,3578713342,3578713367,25
2,679,5342,3578713342,3578713369,27
2,679,5343,3578713342,3578713373,31
2,679,5344,3578713342,3578713376,34
2,679,5345,3578713342,3578713376,34
2,679,5346,3578713342,3578713380,38
2,679,5347,3578713342,3578713382,40
2,679,5348,3578713342,3578713389,47
2,679,5349,3578713342,3578713392,50
2,680,5350,3578713395,3578713395,0
2,680,5351,3578713395,3578713395,0
2,680,5352,3578713395,3578713395,0
2,680,5353,3578713395,3578713398,3
2,680,5354,3578713395,3578713399,4
2,680,5355,3578713395,3578713403,8
2,680,5356,3578713395,3578713403,8
2,680,5357,3578713395,3578713406,11
2,680,5358,3578713395,3578713408,13
2,680,5359,3578713395,3578713414,19
2,680,5360,3578713395,3578713416,21
2,680,5361,3578713395,3578713420,25
2,680,5362,3578713395,3578713421,26
2,680,5363,3578713395,3578713421,26
2,680,5364,3578713395,3578713421,26
2,680,5365,3578713395,3578713422,27
2,680,5366,3578713395,3578713426,31
2,680,5367,3578713395,3578713427,32
2,680,5368,3578713395,3578713427,32
2,680,5369,3578713395,3578713433,38
2,680,5370,3578713395,3578713436,41
2,680,5371,3578713395,3578713436,41
2,680,5372,3578713395,3578713437,42
2,680,5373,3578713395,3578713437,42
2,680,5374,3578713395,3578713438,43
2,680,5375,3578713395,3578713442,47
2,680,5376,3578713395,3578713442,47
2,680,5377,3578713395,3578713442,47
2,680,5378,3578713395,3578713442,47
2,680,5379,3578713395,3578713443,48
2,681,5380,3578713449,3578713449,0
2,681,5381,3578713449,3578713451,2
2,681,5382,3578713449,3578713453,4
2,681,5383,3578713449,3578713457,8
2,681,5384,3578713449,3578713461,12
2,681,5385,3578713449,3578713461,12
2,681,5386,3578713449,3578713465,16
2,681,5387,3578713449,3578713467,18
2,681,5388,3578713449,3578713468,19
2,681,5389,3578713449,3578713469,20
2,681,5390,3578713449,3578713471,22
2,681,5391,3578713449,3578713477,28
2,681,5392,3578713449,3578713481,32
2,681,5393,3578713449,3578713481,32
2,681,5394,3578713449,3578713483,34
2,681,5395,3578713449,3578713484,35
2,681,5396,3578713449,3578713484,35
2,681,5397,3578713449,3578713484,35
2,681,5398,3578713449,3578713487,38
2,681,5399,3578713449,3578713487,38
2,681,5400,3578713449,3578713487,38
2,681,5401,3578713449,3578713490,41
2,681,5402,3578713449,3578713490,41
2,681,5403,3578713449,3578713490,41
2,681,5404,3578713449,3578713493,44
2,681,5405,3578713449,3578713495,46
2,681,5406,3578713449,3578713497,48
2,682,5407,3578713502,3578713503,1
2,682,5408,3578713502,3578713504,2
2,682,5409,3578713502,3578713506,4
2,682,5410,3578713502,3578713507,5
2,682,5411,3578713502,3578713507,5
2,682,5412,3578713502,3578713509,7
2,682,5413,3578713502,3578713510,8
2,682,5414,3578713502,3578713510,8
2,682,5415,3578713502,3578713512,10
2,682,5416,3578713502,3578713512,10
2,682,5417,3578713502,3578713512,10
2,682,5418,3578713502,3578713515,13
2,682,5419,3578713502,3578713516,14
2,682,5420,3578713502,3578713517,15
2,682,5421,3578713502,3578713521,19
2,682,5422,3578713502,3578713524,22
2,682,5423,3578713502,3578713526,24
2,682,5424,3578713502,3578713530,28
2,682,5425,3578713502,3578713532,30
2,682,5426,3578713502,3578713532,30
2,682,5427,3578713502,3578713534,32
2,682,5428,3578713502,3578713534,32
2,682,5429,3578713502,3578713535,33
2,682,5430,3578713502,3578713537,35
2,682,5431,3578713502,3578713542,40
2,682,5432,3578713502,3578713548,46
2,682,5433,3578713502,3578713550,48
2,682,5434,3578713502,3578713552,50
2,683,5435,3578713555,3578713555,0
2,683,5436,3578713555,3578713555,0
2,683,5437,3578713555,3578713557,2
2,683,5438,3578713555,3578713558,3
2,683,5439,3578713555,3578713562,7
2,683,5440,3578713555,3578713565,10
2,683,5441,3578713555,3578713566,11
2,683,5442,3578713555,3578713566,11
2,683,5443,3578713555,3578713566,11
2,683,5444,3578713555,3578713568,13
2,683,5445,3578713555,3578713572,17
2,683,5446,3578713555,3578713575,20
2,683,5447,3578713555,3578713576,21
2,683,5448,3578713555,3578713580,25
2,683,5449,3578713555,3578713582,27
2,683,5450,3578713555,3578713588,33
2,683,5451,3578713555,3578713590,35
2,683,5452,3578713555,3578713591,36
2,683,5453,3578713555,3578713594,39
2,683,5454,3578713555,3578713594,39
2,683,5455,3578713555,3578713595,40
2,683,5456,3578713555,3578713599,44
2,683,5457,3578713555,3578713602,47
2,683,5458,3578713555,3578713602,47
2,684,5459,3578713609,3578713609,0
2,684,5460,3578713609,3578713609,0
2,684,5461,3578713609,3578713610,1
2,684,5462,3578713609,3578713613,4
2,684,5463,3578713609,3578713615,6
2,684,5464,3578713609,3578713618,9
2,684,5465,3578713609,3578713619,10
2,684,5466,3578713609,3578713620,11
2,684,5467,3578713609,3578713620,11
2,684,5468,3578713609,3578713621,12
2,684,5469,3578713609,3578713624,15
2,684,5470,3578713609,3578713626,17
2,684,5471,3578713609,3578713626,17
2,684,5472,3578713609,3578713634,25
2,684,5473,3578713609,3578713635,26
2,684,5474,3578713609,3578713636,27
2,684,5475,3578713609,3578713636,27
2,684,5476,3578713609,3578713637,28
2,684,5477,3578713609,3578713638,29
2,684,5478,3578713609,3578713640,31
2,684,5479,3578713609,3578713640,31
2,684,5480,3578713609,3578713641,32
2,684,5481,3578713609,3578713641,32
2,684,5482,3578713609,3578713643,34
2,684,5483,3578713609,3578713646,37
2,684,5484,3578713609,3578713650,41
2,684,5485,3578713609,3578713652,43
2,684,5486,3578713609,3578713657,48
2,685,5487,3578713664,3578713664,0
2,685,5488,3578713664,3578713664,0
2,685,5489,3578713664,3578713664,0
2,685,5490,3578713664,3578713666,2
2,685,5491,3578713664,3578713667,3
2,685,5492,3578713664,3578713669,5
2,685,5493,3578713664,3578713670,6
2,685,5494,3578713664,3578713676,12
2,685,5495,3578713664,3578713681,17
2,685,5496,3578713664,3578713682,18
2,685,5497,3578713664,3578713684,20
2,685,5498,3578713664,3578713684,20
2,685,5499,3578713664,3578713684,20
2,685,5500,3578713664,3578713687,23
2,685,5501,3578713664,3578713687,23
2,685,5502,3578713664,3578713688,24
2,685,5503,3578713664,3578713690,26
2,685,5504,3578713664,3578713690,26
2,685,5505,3578713664,3578713690,26
2,685,5506,3578713664,3578713694,30
2,685,5507,3578713664,3578713696,32
2,685,5508,3578713664,3578713702,38
2,685,5509,3578713664,3578713704,40
2,685,5510,3578713664,3578713707,43
2,685,5511,3578713664,3578713707,43
2,685,5512,3578713664,3578713707,43
2,685,5513,3578713664,3578713710,46
2,685,5514,3578713664,3578713710,46
2,685,5515,3578713664,3578713710,46
2,685,5516,3578713664,3578713712,48
2,685,5517,3578713664,3578713712,48
2,685,5518,3578713664,3578713712,48
2,685,5519,3578713664,3578713713,49
2,686,5520,3578713718,3578713718,0
2,686,5521,3578713718,3578713718,0
2,686,5522,3578713718,3578713718,0
2,686,5523,3578713718,3578713721,3
2,686,5524,3578713718,3578713724,6
2,686,5525,3578713718,3578713727,9
2,686,5526,3578713718,3578713730,12
2,686,5527,3578713718,3578713732,14
2,686,5528,3578713718,3578713734,16
2,686,5529,3578713718,3578713735,17
2,686,5530,3578713718,3578713736,18
2,686,5531,3578713718,3578713737,19
2,686,5532,3578713718,3578713742,24
2,686,5533,3578713718,3578713748,30
2,686,5534,3578713718,3578713750,32
2,686,5535,3578713718,3578713752,34
2,686,5536,3578713718,3578713754,36
2,686,5537,3578713718,3578713756,38
2,686,5538,3578713718,3578713759,41
2,686,5539,3578713718,3578713762,44
2,686,5540,3578713718,3578713763,45
2,686,5541,3578713718,3578713764,46
2,686,5542,3578713718,3578713765,47
2,686,5543,3578713718,3578713765,47
2,686,5544,3578713718,3578713766,48
2,686,5545,3578713718,3578713767,49
2,687,5546,3578713772,3578713772,0
2,687,5547,3578713772,3578713773,1
2,687,5548,3578713772,3578713775,3
2,687,5549,3578713772,3578713777,5
2,687,5550,3578713772,3578713780,8
2,687,5551,3578713772,3578713782,10
2,687,5552,3578713772,3578713790,18
2,687,5553,3578713772,3578713791,19
2,687,5554,3578713772,3578713794,22
2,687,5555,3578713772,3578713794,22
2,687,5556,3578713772,3578713796,24
2,687,5557,3578713772,3578713798,26
2,687,5558,3578713772,3578713799,27
2,687,5559,3578713772,3578713803,31
2,687,5560,3578713772,3578713806,34
2,687,5561,3578713772,3578713809,37
2,687,5562,3578713772,3578713811,39
2,687,5563,3578713772,3578713814,42
2,687,5564,3578713772,3578713815,43
2,687,5565,3578713772,3578713818,46
2,687,5566,3578713772,3578713819,47
2,687,5567,3578713772,3578713820,48
2,687,5568,3578713772,3578713820,48
2,687,5569,3578713772,3578713821,49
2,688,5570,3578713861,3578713861,0
2,688,5571,3578713861,3578713861,0
2,688,5572,3578713861,3578713861,0
2,688,5573,3578713861,3578713861,0
2,688,5574,3578713861,3578713861,0
2,688,5575,3578713861,3578713861,0
2,688,5576,3578713861,3578713861,0
2,688,5577,3578713861,3578713861,0
2,688,5578,3578713861,3578713861,0
2,688,5579,3578713861,3578713861,0
2,688,5580,3578713861,3578713861,0
2,688,5581,3578713861,3578713861,0
2,688,5582,3578713861,3578713861,0
2,688,5583,3578713861,3578713861,0
2,688,5584,3578713861,3578713861,0
2,688,5585,3578713861,3578713861,0
2,688,5586,3578713861,3578713861,0
2,688,5587,3578713861,3578713861,0
2,688,5588,3578713861,3578713861,0
2,688,5589,3578713861,3578713864,3
2,688,5590,3578713861,3578713866,5
2,688,5591,3578713861,3578713866,5
2,688,5592,3578713861,3578713869,8
2,688,5593,3578713861,3578713870,9
2,688,5594,3578713861,3578713876,15
2,688,5595,3578713861,3578713881,20
2,688,5596,3578713861,3578713882,21
2,688,5597,3578713861,3578713883,22
2,688,5598,3578713861,3578713883,22
2,688,5599,3578713861,3578713884,23
2,688,5600,3578713861,3578713887,26
2,688,5601,3578713861,3578713888,27
2,688,5602,3578713861,3578713888,27
2,688,5603,3578713861,3578713890,29
2,688,5604,3578713861,3578713890,29
2,688,5605,3578713861,3578713890,29
2,688,5606,3578713861,3578713894,33
2,688,5607,3578713861,3578713897,36
2,688,5608,3578713861,3578713903,42
2,688,5609,3578713861,3578713905,44
2,688,5610,3578713861,3578713907,46
2,688,5611,3578713861,3578713907,46
2,688,5612,3578713861,3578713908,47
2,688,5613,3578713861,3578713910,49
2,689,5614,3578713916,3578713916,0
2,689,5615,3578713916,3578713916,0
2,689,5616,3578713916,3578713916,0
2,689,5617,3578713916,3578713916,0
2,689,5618,3578713916,3578713916,0
2,689,5619,3578713916,3578713916,0
2,689,5620,3578713916,3578713916,0
2,689,5621,3578713916,3578713916,0
2,689,5622,3578713916,3578713917,1
2,689,5623,3578713916,3578713921,5
2,689,5624,3578713916,3578713926,10
2,689,5625,3578713916,3578713927,11
2,689,5626,3578713916,3578713929,13
2,689,5627,3578713916,3578713931,15
2,689,5628,3578713916,3578713935,19
2,689,5629,3578713916,3578713935,19
2,689,5630,3578713916,3578713935,19
2,689,5631,3578713916,3578713937,21
2,689,5632,3578713916,3578713942,26
2,689,5633,3578713916,3578713948,32
2,689,5634,3578713916,3578713950,34
2,689,5635,3578713916,3578713952,36
2,689,5636,3578713916,3578713955,39
2,689,5637,3578713916,3578713956,40
2,689,5638,3578713916,3578713958,42
2,689,5639,3578713916,3578713959,43
2,689,5640,3578713916,3578713963,47
2,689,5641,3578713916,3578713965,49
2,689,5642,3578713916,3578713966,50
2,690,5643,3578713969,3578713969,0
2,690,5644,3578713969,3578713969,0
2,690,5645,3578713969,3578713969,0
2,690,5646,3578713969,3578713972,3
2,690,5647,3578713969,3578713974,5
2,690,5648,3578713969,3578713976,7
2,690,5649,3578713969,3578713978,9
2,690,5650,3578713969,3578713980,11
2,690,5651,3578713969,3578713982,13
2,690,5652,3578713969,3578713986,17
2,690,5653,3578713969,3578713989,20
2,690,5654,3578713969,3578713990,21
2,690,5655,3578713969,3578713991,22
2,690,5656,3578713969,3578713994,25
2,690,5657,3578713969,3578713995,26
2,690,5658,3578713969,3578713995,26
2,690,5659,3578713969,3578713997,28
2,690,5660,3578713969,3578714000,31
2,690,5661,3578713969,3578714002,33
2,690,5662,3578713969,3578714002,33
2,690,5663,3578713969,3578714006,37
2,690,5664,3578713969,3578714008,39
2,690,5665,3578713969,3578714010,41
2,690,5666,3578713969,3578714013,44
2,690,5667,3578713969,3578714015,46
2,690,5668,3578713969,3578714019,50
2,691,5669,3578714022,3578714022,0
2,691,5670,3578714022,3578714022,0
2,691,5671,3578714022,3578714022,0
2,691,5672,3578714022,3578714023,1
2,691,5673,3578714022,3578714025,3
2,691,5674,3578714022,3578714027,5
2,691,5675,3578714022,3578714027,5
2,691,5676,3578714022,3578714034,12
2,691,5677,3578714022,3578714035,13
2,691,5678,3578714022,3578714036,14
2,691,5679,3578714022,3578714036,14
2,691,5680,3578714022,3578714037,15
2,691,5681,3578714022,3578714038,16
2,691,5682,3578714022,3578714041,19
2,691,5683,3578714022,3578714041,19
2,691,5684,3578714022,3578714042,20
2,691,5685,3578714022,3578714042,20
2,691,5686,3578714022,3578714042,20
2,691,5687,3578714022,3578714046,24
2,691,5688,3578714022,3578714048,26
2,691,5689,3578714022,3578714051,29
2,691,5690,3578714022,3578714053,31
2,691,5691,3578714022,3578714056,34
2,691,5692,3578714022,3578714060,38
2,691,5693,3578714022,3578714061,39
2,691,5694,3578714022,3578714065,43
2,691,5695,3578714022,3578714066,44
2,691,5696,3578714022,3578714066,44
2,691,5697,3578714022,3578714069,47
2,691,5698,3578714022,3578714070,48
2,692,5699,3578714075,3578714076,1
2,692,5700,3578714075,3578714081,6
2,692,5701,3578714075,3578714081,6
2,692,5702,3578714075,3578714084,9
2,692,5703,3578714075,3578714084,9
2,692,5704,3578714075,3578714084,9
2,692,5705,3578714075,3578714087,12
2,692,5706,3578714075,3578714087,12
2,692,5707,3578714075,3578714088,13
2,692,5708,3578714075,3578714090,15
2,692,5709,3578714075,3578714090,15
2,692,5710,3578714075,3578714090,15
2,692,5711,3578714075,3578714093,18
2,692,5712,3578714075,3578714094,19
2,692,5713,3578714075,3578714096,21
2,692,5714,3578714075,3578714103,28
2,692,5715,3578714075,3578714105,30
2,692,5716,3578714075,3578714106,31
2,692,5717,3578714075,3578714107,32
2,692,5718,3578714075,3578714108,33
2,692,5719,3578714075,3578714110,35
2,692,5720,3578714075,3578714112,37
2,692,5721,3578714075,3578714112,37
2,692,5722,3578714075,3578714113,38
2,692,5723,3578714075,3578714113,38
2,692,5724,3578714075,3578714113,38
2,692,5725,3578714075,3578714114,39
2,692,5726,3578714075,3578714115,40
2,692,5727,3578714075,3578714116,41
2,692,5728,3578714075,3578714117,42
2,693,5729,3578714128,3578714128,0
2,693,5730,3578714128,3578714128,0
2,693,5731,3578714128,3578714129,1
2,693,5732,3578714128,3578714131,3
2,693,5733,3578714128,3578714134,6
2,693,5734,3578714128,3578714135,7
2,693,5735,3578714128,3578714135,7
2,693,5736,3578714128,3578714138,10
2,693,5737,3578714128,3578714143,15
2,693,5738,3578714128,3578714148,20
2,693,5739,3578714128,3578714150,22
2,693,5740,3578714128,3578714153,25
2,693,5741,3578714128,3578714154,26
2,693,5742,3578714128,3578714157,29
2,693,5743,3578714128,3578714158,30
2,693,5744,3578714128,3578714159,31
2,693,5745,3578714128,3578714163,35
2,693,5746,3578714128,3578714165,37
2,693,5747,3578714128,3578714166,38
2,693,5748,3578714128,3578714166,38
2,693,5749,3578714128,3578714166,38
2,693,5750,3578714128,3578714168,40
2,693,5751,3578714128,3578714173,45
2,693,5752,3578714128,3578714173,45
2,693,5753,3578714128,3578714178,50
2,694,5754,3578714182,3578714182,0
2,694,5755,3578714182,3578714186,4
2,694,5756,3578714182,3578714189,7
2,694,5757,3578714182,3578714190,8
2,694,5758,3578714182,3578714191,9
2,694,5759,3578714182,3578714193,11
2,694,5760,3578714182,3578714195,13
2,694,5761,3578714182,3578714196,14
2,694,5762,3578714182,3578714197,15
2,694,5763,3578714182,3578714198,16
2,694,5764,3578714182,3578714199,17
2,694,5765,3578714182,3578714204,22
2,694,5766,3578714182,3578714207,25
2,694,5767,3578714182,3578714208,26
2,694,5768,3578714182,3578714214,32
2,694,5769,3578714182,3578714219,37
2,694,5770,3578714182,3578714219,37
2,694,5771,3578714182,3578714222,40
2,694,5772,3578714182,3578714222,40
2,694,5773,3578714182,3578714225,43
2,694,5774,3578714182,3578714227,45
2,694,5775,3578714182,3578714227,45
2,695,5776,3578714236,3578714236,0
2,695,5777,3578714236,3578714236,0
2,695,5778,3578714236,3578714237,1
2,695,5779,3578714236,3578714237,1
2,695,5780,3578714236,3578714237,1
2,695,5781,3578714236,3578714238,2
2,695,5782,3578714236,3578714241,5
2,695,5783,3578714236,3578714242,6
2,695,5784,3578714236,3578714242,6
2,695,5785,3578714236,3578714242,6
2,695,5786,3578714236,3578714243,7
2,695,5787,3578714236,3578714246,10
2,695,5788,3578714236,3578714249,13
2,695,5789,3578714236,3578714250,14
2,695,5790,3578714236,3578714251,15
2,695,5791,3578714236,3578714253,17
2,695,5792,3578714236,3578714257,21
2,695,5793,3578714236,3578714260,24
2,695,5794,3578714236,3578714261,25
2,695,5795,3578714236,3578714265,29
2,695,5796,3578714236,3578714267,31
2,695,5797,3578714236,3578714268,32
2,695,5798,3578714236,3578714269,33
2,695,5799,3578714236,3578714270,34
2,695,5800,3578714236,3578714277,41
2,695,5801,3578714236,3578714281,45
2,695,5802,3578714236,3578714281,45
2,695,5803,3578714236,3578714284,48
2,695,5804,3578714236,3578714284,48
2,695,5805,3578714236,3578714284,48
2,696,5806,3578714290,3578714290,0
2,696,5807,3578714290,3578714290,0
2,696,5808,3578714290,3578714290,0
2,696,5809,3578714290,3578714290,0
2,696,5810,3578714290,3578714290,0
2,696,5811,3578714290,3578714290,0
2,696,5812,3578714290,3578714292,2
2,696,5813,3578714290,3578714294,4
2,696,5814,3578714290,3578714297,7
2,696,5815,3578714290,3578714304,14
2,696,5816,3578714290,3578714305,15
2,696,5817,3578714290,3578714307,17
2,696,5818,3578714290,3578714307,17
2,696,5819,3578714290,3578714308,18
2,696,5820,3578714290,3578714309,19
2,696,5821,3578714290,3578714312,22
2,696,5822,3578714290,3578714313,23
2,696,5823,3578714290,3578714313,23
2,696,5824,3578714290,3578714314,24
2,696,5825,3578714290,3578714315,25
2,696,5826,3578714290,3578714317,27
2,696,5827,3578714290,3578714317,27
2,696,5828,3578714290,3578714317,27
2,696,5829,3578714290,3578714326,36
2,696,5830,3578714290,3578714327,37
2,696,5831,3578714290,3578714329,39
2,696,5832,3578714290,3578714331,41
2,696,5833,3578714290,3578714334,44
2,696,5834,3578714290,3578714335,45
2,696,5835,3578714290,3578714336,46
2,696,5836,3578714290,3578714337,47
2,697,5837,3578714344,3578714344,0
2,697,5838,3578714344,3578714348,4
2,697,5839,3578714344,3578714350,6
2,697,5840,3578714344,3578714353,9
2,697,5841,3578714344,3578714355,11
2,697,5842,3578714344,3578714356,12
2,697,5843,3578714344,3578714358,14
2,697,5844,3578714344,3578714360,16
2,697,5845,3578714344,3578714363,19
2,697,5846,3578714344,3578714365,21
2,697,5847,3578714344,3578714367,23
2,697,5848,3578714344,3578714367,23
2,697,5849,3578714344,3578714369,25
2,697,5850,3578714344,3578714373,29
2,697,5851,3578714344,3578714373,29
2,697,5852,3578714344,3578714377,33
2,697,5853,3578714344,3578714381,37
2,697,5854,3578714344,3578714386,42
2,697,5855,3578714344,3578714389,45
2,697,5856,3578714344,3578714390,46
2,697,5857,3578714344,3578714391,47
2,697,5858,3578714344,3578714393,49
2,698,5859,3578714398,3578714398,0
2,698,5860,3578714398,3578714398,0
2,698,5861,3578714398,3578714398,0
2,698,5862,3578714398,3578714398,0
2,698,5863,3578714398,3578714400,2
2,698,5864,3578714398,3578714403,5
2,698,5865,3578714398,3578714407,9
2,698,5866,3578714398,3578714408,10
2,698,5867,3578714398,3578714410,12
2,698,5868,3578714398,3578714414,16
2,698,5869,3578714398,3578714418,20
2,698,5870,3578714398,3578714420,22
2,698,5871,3578714398,3578714422,24
2,698,5872,3578714398,3578714423,25
2,698,5873,3578714398,3578714425,27
2,698,5874,3578714398,3578714427,29
2,698,5875,3578714398,3578714427,29
2,698,5876,3578714398,3578714434,36
2,698,5877,3578714398,3578714436,38
2,698,5878,3578714398,3578714436,38
2,698,5879,3578714398,3578714437,39
2,698,5880,3578714398,3578714437,39
2,698,5881,3578714398,3578714438,40
2,698,5882,3578714398,3578714441,43
2,698,5883,3578714398,3578714442,44
2,698,5884,3578714398,3578714442,44
2,698,5885,3578714398,3578714442,44
2,698,5886,3578714398,3578714443,45
2,698,5887,3578714398,3578714446,48
2,699,5888,3578714452,3578714452,0
2,699,5889,3578714452,3578714452,0
2,699,5890,3578714452,3578714452,0
2,699,5891,3578714452,3578714453,1
2,699,5892,3578714452,3578714453,1
2,699,5893,3578714452,3578714457,5
2,699,5894,3578714452,3578714460,8
2,699,5895,3578714452,3578714461,9
2,699,5896,3578714452,3578714464,12
2,699,5897,3578714452,3578714467,15
2,699,5898,3578714452,3578714468,16
2,699,5899,3578714452,3578714468,16
2,699,5900,3578714452,3578714471,19
2,699,5901,3578714452,3578714477,25
2,699,5902,3578714452,3578714481,29
2,699,5903,3578714452,3578714482,30
2,699,5904,3578714452,3578714484,32
2,699,5905,3578714452,3578714484,32
2,699,5906,3578714452,3578714485,33
2,699,5907,3578714452,3578714485,33
2,699,5908,3578714452,3578714487,35
2,699,5909,3578714452,3578714487,35
2,699,5910,3578714452,3578714488,36
2,699,5911,3578714452,3578714490,38
2,699,5912,3578714452,3578714490,38
2,699,5913,3578714452,3578714490,38
2,699,5914,3578714452,3578714493,41
2,699,5915,3578714452,3578714494,42
2,699,5916,3578714452,3578714497,45
2,700,5917,3578714506,3578714506,0
2,700,5918,3578714506,3578714506,0
2,700,5919,3578714506,3578714506,0
2,700,5920,3578714506,3578714506,0
2,700,5921,3578714506,3578714506,0
2,700,5922,3578714506,3578714507,1
2,700,5923,3578714506,3578714508,2
2,700,5924,3578714506,3578714512,6
2,700,5925,3578714506,3578714513,7
2,700,5926,3578714506,3578714513,7
2,700,5927,3578714506,3578714513,7
2,700,5928,3578714506,3578714514,8
2,700,5929,3578714506,3578714515,9
2,700,5930,3578714506,3578714516,10
2,700,5931,3578714506,3578714517,11
2,700,5932,3578714506,3578714520,14
2,700,5933,3578714506,3578714524,18
2,700,5934,3578714506,3578714527,21
2,700,5935,3578714506,3578714530,24
2,700,5936,3578714506,3578714532,26
2,700,5937,3578714506,3578714533,27
2,700,5938,3578714506,3578714534,28
2,700,5939,3578714506,3578714535,29
2,700,5940,3578714506,3578714537,31
2,700,5941,3578714506,3578714543,37
2,700,5942,3578714506,3578714549,43
2,700,5943,3578714506,3578714549,43
2,700,5944,3578714506,3578714552,46
2,700,5945,3578714506,3578714554,48
2,700,5946,3578714506,3578714555,49
2,701,5947,3578714559,3578714559,0
2,701,5948,3578714559,3578714559,0
2,701,5949,3578714559,3578714559,0
2,701,5950,3578714559,3578714562,3
2,701,5951,3578714559,3578714565,6
2,701,5952,3578714559,3578714566,7
2,701,5953,3578714559,3578714568,9
2,701,5954,3578714559,3578714572,13
2,701,5955,3578714559,3578714573,14
2,701,5956,3578714559,3578714575,16
2,701,5957,3578714559,3578714577,18
2,701,5958,3578714559,3578714580,21
2,701,5959,3578714559,3578714585,26
2,701,5960,3578714559,3578714588,29
2,701,5961,3578714559,3578714590,31
2,701,5962,3578714559,3578714592,33
2,701,5963,3578714559,3578714596,37
2,701,5964,3578714559,3578714597,38
2,701,5965,3578714559,3578714597,38
2,701,5966,3578714559,3578714599,40
2,701,5967,3578714559,3578714602,43
2,701,5968,3578714559,3578714602,43
2,701,5969,3578714559,3578714607,48
2,701,5970,3578714559,3578714608,49
2,701,5971,3578714559,3578714609,50
2,702,5972,3578714613,3578714613,0
2,702,5973,3578714613,3578714617,4
2,702,5974,3578714613,3578714620,7
2,702,5975,3578714613,3578714621,8
2,702,5976,3578714613,3578714622,9
2,702,5977,3578714613,3578714623,10
2,702,5978,3578714613,3578714625,12
2,702,5979,3578714613,3578714626,13
2,702,5980,3578714613,3578714634,21
2,702,5981,3578714613,3578714635,22
2,702,5982,3578714613,3578714636,23
2,702,5983,3578714613,3578714636,23
2,702,5984,3578714613,3578714636,23
2,702,5985,3578714613,3578714637,24
2,702,5986,3578714613,3578714641,28
2,702,5987,3578714613,3578714641,28
2,702,5988,3578714613,3578714641,28
2,702,5989,3578714613,3578714641,28
2,702,5990,3578714613,3578714643,30
2,702,5991,3578714613,3578714646,33
2,702,5992,3578714613,3578714648,35
2,702,5993,3578714613,3578714649,36
2,702,5994,3578714613,3578714650,37
2,702,5995,3578714613,3578714652,39
2,702,5996,3578714613,3578714652,39
2,702,5997,3578714613,3578714655,42
2,702,5998,3578714613,3578714657,44
2,702,5999,3578714613,3578714659,46
2,702,6000,3578714613,3578714660,47
2,703,6001,3578714667,3578714667,0
2,703,6002,3578714667,3578714667,0
2,703,6003,3578714667,3578714667,0
2,703,6004,3578714667,3578714668,1
2,703,6005,3578714667,3578714671,4
2,703,6006,3578714667,3578714677,10
2,703,6007,3578714667,3578714681,14
2,703,6008,3578714667,3578714682,15
2,703,6009,3578714667,3578714683,16
2,703,6010,3578714667,3578714684,17
2,703,6011,3578714667,3578714685,18
2,703,6012,3578714667,3578714685,18
2,703,6013,3578714667,3578714687,20
2,703,6014,3578714667,3578714688,21
2,703,6015,3578714667,3578714688,21
2,703,6016,3578714667,3578714690,23
2,703,6017,3578714667,3578714690,23
2,703,6018,3578714667,3578714694,27
2,703,6019,3578714667,3578714694,27
2,703,6020,3578714667,3578714697,30
2,703,6021,3578714667,3578714704,37
2,703,6022,3578714667,3578714704,37
2,703,6023,3578714667,3578714705,38
2,703,6024,3578714667,3578714707,40
2,703,6025,3578714667,3578714707,40
2,703,6026,3578714667,3578714709,42
2,703,6027,3578714667,3578714711,44
2,703,6028,3578714667,3578714711,44
2,703,6029,3578714667,3578714713,46
2,703,6030,3578714667,3578714713,46
2,703,6031,3578714667,3578714714,47
2,703,6032,3578714667,3578714715,48
2,703,6033,3578714667,3578714716,49
2,703,6034,3578714667,3578714716,49
2,704,6035,3578714721,3578714721,0
2,704,6036,3578714721,3578714721,0
2,704,6037,3578714721,3578714724,3
2,704,6038,3578714721,3578714726,5
2,704,6039,3578714721,3578714730,9
2,704,6040,3578714721,3578714732,11
2,704,6041,3578714721,3578714733,12
2,704,6042,3578714721,3578714734,13
2,704,6043,3578714721,3578714735,14
2,704,6044,3578714721,3578714737,16
2,704,6045,3578714721,3578714743,22
2,704,6046,3578714721,3578714749,28
2,704,6047,3578714721,3578714750,29
2,704,6048,3578714721,3578714752,31
2,704,6049,3578714721,3578714754,33
2,704,6050,3578714721,3578714755,34
2,704,6051,3578714721,3578714756,35
2,704,6052,3578714721,3578714758,37
2,704,6053,3578714721,3578714759,38
2,704,6054,3578714721,3578714759,38
2,704,6055,3578714721,3578714762,41
2,704,6056,3578714721,3578714765,44
2,704,6057,3578714721,3578714766,45
2,704,6058,3578714721,3578714768,47
2,705,6059,3578714776,3578714776,0
2,705,6060,3578714776,3578714776,0
2,705,6061,3578714776,3578714776,0
2,705,6062,3578714776,3578714777,1
2,705,6063,3578714776,3578714780,4
2,705,6064,3578714776,3578714786,10
2,705,6065,3578714776,3578714788,12
2,705,6066,3578714776,3578714790,14
2,705,6067,3578714776,3578714790,14
2,705,6068,3578714776,3578714796,20
2,705,6069,3578714776,3578714797,21
2,705,6070,3578714776,3578714799,23
2,705,6071,3578714776,3578714802,26
2,705,6072,3578714776,3578714802,26
2,705,6073,3578714776,3578714807,31
2,705,6074,3578714776,3578714809,33
2,705,6075,3578714776,3578714811,35
2,705,6076,3578714776,3578714813,37
2,705,6077,3578714776,3578714815,39
2,705,6078,3578714776,3578714817,41
2,705,6079,3578714776,3578714821,45
2,705,6080,3578714776,3578714823,47
2,705,6081,3578714776,3578714823,47
2,705,6082,3578714776,3578714826,50
2,706,6083,3578714831,3578714831,0
2,706,6084,3578714831,3578714834,3
2,706,6085,3578714831,3578714835,4
2,706,6086,3578714831,3578714836,5
2,706,6087,3578714831,3578714836,5
2,706,6088,3578714831,3578714838,7
2,706,6089,3578714831,3578714841,10
2,706,6090,3578714831,3578714841,10
2,706,6091,3578714831,3578714841,10
2,706,6092,3578714831,3578714841,10
2,706,6093,3578714831,3578714842,11
2,706,6094,3578714831,3578714846,15
2,706,6095,3578714831,3578714849,18
2,706,6096,3578714831,3578714851,20
2,706,6097,3578714831,3578714852,21
2,706,6098,3578714831,3578714853,22
2,706,6099,3578714831,3578714855,24
2,706,6100,3578714831,3578714857,26
2,706,6101,3578714831,3578714860,29
2,706,6102,3578714831,3578714861,30
2,706,6103,3578714831,3578714864,33
2,706,6104,3578714831,3578714866,35
2,706,6105,3578714831,3578714866,35
2,706,6106,3578714831,3578714869,38
2,706,6107,3578714831,3578714871,40
2,706,6108,3578714831,3578714877,46
2,707,6109,3578714885,3578714885,0
2,707,6110,3578714885,3578714885,0
2,707,6111,3578714885,3578714885,0
2,707,6112,3578714885,3578714886,1
2,707,6113,3578714885,3578714887,2
2,707,6114,3578714885,3578714888,3
2,707,6115,3578714885,3578714888,3
2,707,6116,3578714885,3578714890,5
2,707,6117,3578714885,3578714890,5
2,707,6118,3578714885,3578714894,9
2,707,6119,3578714885,3578714897,12
2,707,6120,3578714885,3578714904,19
2,707,6121,3578714885,3578714904,19
2,707,6122,3578714885,3578714905,20
2,707,6123,3578714885,3578714907,22
2,707,6124,3578714885,3578714907,22
2,707,6125,3578714885,3578714909,24
2,707,6126,3578714885,3578714912,27
2,707,6127,3578714885,3578714912,27
2,707,6128,3578714885,3578714913,28
2,707,6129,3578714885,3578714914,29
2,707,6130,3578714885,3578714914,29
2,707,6131,3578714885,3578714914,29
2,707,6132,3578714885,3578714916,31
2,707,6133,3578714885,3578714916,31
2,707,6134,3578714885,3578714918,33
2,707,6135,3578714885,3578714921,36
2,707,6136,3578714885,3578714926,41
2,707,6137,3578714885,3578714926,41
2,707,6138,3578714885,3578714929,44
2,707,6139,3578714885,3578714931,46
2,707,6140,3578714885,3578714933,48
2,707,6141,3578714885,3578714934,49
2,708,6142,3578714939,3578714939,0
2,708,6143,3578714939,3578714939,0
2,708,6144,3578714939,3578714943,4
2,708,6145,3578714939,3578714949,10
2,708,6146,3578714939,3578714950,11
2,708,6147,3578714939,3578714951,12
2,708,6148,3578714939,3578714955,16
2,708,6149,3578714939,3578714955,16
2,708,6150,3578714939,3578714956,17
2,708,6151,3578714939,3578714957,18
2,708,6152,3578714939,3578714959,20
2,708,6153,3578714939,3578714959,20
2,708,6154,3578714939,3578714963,24
2,708,6155,3578714939,3578714965,26
2,708,6156,3578714939,3578714966,27
2,708,6157,3578714939,3578714968,29
2,708,6158,3578714939,3578714972,33
2,708,6159,3578714939,3578714973,34
2,708,6160,3578714939,3578714976,37
2,708,6161,3578714939,3578714977,38
2,708,6162,3578714939,3578714980,41
2,708,6163,3578714939,3578714986,47
2,708,6164,3578714939,3578714988,49
2,709,6165,3578714993,3578714993,0
2,709,6166,3578714993,3578714996,3
2,709,6167,3578714993,3578714997,4
2,709,6168,3578714993,3578715000,7
2,709,6169,3578714993,3578715002,9
2,709,6170,3578714993,3578715002,9
2,709,6171,3578714993,3578715008,15
2,709,6172,3578714993,3578715009,16
2,709,6173,3578714993,3578715010,17
2,709,6174,3578714993,3578715013,20
2,709,6175,3578714993,3578715018,25
2,709,6176,3578714993,3578715020,27
2,709,6177,3578714993,3578715021,28
2,709,6178,3578714993,3578715023,30
2,709,6179,3578714993,3578715024,31
2,709,6180,3578714993,3578715026,33
2,709,6181,3578714993,3578715027,34
2,709,6182,3578714993,3578715035,42
2,709,6183,3578714993,3578715035,42
2,709,6184,3578714993,3578715036,43
2,709,6185,3578714993,3578715036,43
2,709,6186,3578714993,3578715037,44
2,709,6187,3578714993,3578715037,44
2,709,6188,3578714993,3578715041,48
2,709,6189,3578714993,3578715042,49
2,709,6190,3578714993,3578715042,49
2,709,6191,3578714993,3578715042,49
2,709,6192,3578714993,3578715043,50
2,710,6193,3578715047,3578715047,0
2,710,6194,3578715047,3578715048,1
2,710,6195,3578715047,3578715050,3
2,710,6196,3578715047,3578715051,4
2,710,6197,3578715047,3578715053,6
2,710,6198,3578715047,3578715055,8
2,710,6199,3578715047,3578715057,10
2,710,6200,3578715047,3578715060,13
2,710,6201,3578715047,3578715061,14
2,710,6202,3578715047,3578715064,17
2,710,6203,3578715047,3578715066,19
2,710,6204,3578715047,3578715067,20
2,710,6205,3578715047,3578715068,21
2,710,6206,3578715047,3578715071,24
2,710,6207,3578715047,3578715077,30
2,710,6208,3578715047,3578715081,34
2,710,6209,3578715047,3578715083,36
2,710,6210,3578715047,3578715084,37
2,710,6211,3578715047,3578715086,39
2,710,6212,3578715047,3578715087,40
2,710,6213,3578715047,3578715088,41
2,710,6214,3578715047,3578715089,42
2,710,6215,3578715047,3578715090,43
2,710,6216,3578715047,3578715090,43
2,710,6217,3578715047,3578715091,44
2,710,6218,3578715047,3578715094,47
2,711,6219,3578715101,3578715104,3
2,711,6220,3578715101,3578715104,3
2,711,6221,3578715101,3578715104,3
2,711,6222,3578715101,3578715106,5
2,711,6223,3578715101,3578715107,6
2,711,6224,3578715101,3578715107,6
2,711,6225,3578715101,3578715109,8
2,711,6226,3578715101,3578715112,11
2,711,6227,3578715101,3578715113,12
2,711,6228,3578715101,3578715113,12
2,711,6229,3578715101,3578715113,12
2,711,6230,3578715101,3578715114,13
2,711,6231,3578715101,3578715115,14
2,711,6232,3578715101,3578715116,15
2,711,6233,3578715101,3578715117,16
2,711,6234,3578715101,3578715121,20
2,711,6235,3578715101,3578715126,25
2,711,6236,3578715101,3578715127,26
2,711,6237,3578715101,3578715130,29
2,711,6238,3578715101,3578715131,30
2,711,6239,3578715101,3578715133,32
2,711,6240,3578715101,3578715135,34
2,711,6241,3578715101,3578715136,35
2,711,6242,3578715101,3578715137,36
2,711,6243,3578715101,3578715143,42
2,711,6244,3578715101,3578715149,48
2,711,6245,3578715101,3578715150,49
2,712,6246,3578715155,3578715155,0
2,712,6247,3578715155,3578715155,0
2,712,6248,3578715155,3578715155,0
2,712,6249,3578715155,3578715157,2
2,712,6250,3578715155,3578715158,3
2,712,6251,3578715155,3578715159,4
2,712,6252,3578715155,3578715159,4
2,712,6253,3578715155,3578715163,8
2,712,6254,3578715155,3578715166,11
2,712,6255,3578715155,3578715166,11
2,712,6256,3578715155,3578715167,12
2,712,6257,3578715155,3578715173,18
2,712,6258,3578715155,3578715176,21
2,712,6259,3578715155,3578715176,21
2,712,6260,3578715155,3578715180,25
2,712,6261,3578715155,3578715186,31
2,712,6262,3578715155,3578715189,34
2,712,6263,3578715155,3578715190,35
2,712,6264,3578715155,3578715191,36
2,712,6265,3578715155,3578715196,41
2,712,6266,3578715155,3578715197,42
2,712,6267,3578715155,3578715199,44
2,712,6268,3578715155,3578715200,45
2,712,6269,3578715155,3578715203,48
2,712,6270,3578715155,3578715203,48
2,713,6271,3578715209,3578715209,0
2,713,6272,3578715209,3578715209,0
2,713,6273,3578715209,3578715210,1
2,713,6274,3578715209,3578715214,5
2,713,6275,3578715209,3578715218,9
2,713,6276,3578715209,3578715220,11
2,713,6277,3578715209,3578715221,12
2,713,6278,3578715209,3578715223,14
2,713,6279,3578715209,3578715225,16
2,713,6280,3578715209,3578715227,18
2,713,6281,3578715209,3578715227,18
2,713,6282,3578715209,3578715234,25
2,713,6283,3578715209,3578715235,26
2,713,6284,3578715209,3578715236,27
2,713,6285,3578715209,3578715237,28
2,713,6286,3578715209,3578715237,28
2,713,6287,3578715209,3578715238,29
2,713,6288,3578715209,3578715241,32
2,713,6289,3578715209,3578715242,33
2,713,6290,3578715209,3578715242,33
2,713,6291,3578715209,3578715242,33
2,713,6292,3578715209,3578715242,33
2,713,6293,3578715209,3578715246,37
2,713,6294,3578715209,3578715248,39
2,713,6295,3578715209,3578715249,40
2,713,6296,3578715209,3578715251,42
2,713,6297,3578715209,3578715252,43
2,713,6298,3578715209,3578715253,44
2,713,6299,3578715209,3578715255,46
2,713,6300,3578715209,3578715257,48
2,714,6301,3578715263,3578715263,0
2,714,6302,3578715263,3578715263,0
2,714,6303,3578715263,3578715265,2
2,714,6304,3578715263,3578715267,4
2,714,6305,3578715263,3578715268,5
2,714,6306,3578715263,3578715269,6
2,714,6307,3578715263,3578715271,8
2,714,6308,3578715263,3578715277,14
2,714,6309,3578715263,3578715281,18
2,714,6310,3578715263,3578715284,21
2,714,6311,3578715263,3578715284,21
2,714,6312,3578715263,3578715285,22
2,714,6313,3578715263,3578715287,24
2,714,6314,3578715263,3578715287,24
2,714,6315,3578715263,3578715288,25
2,714,6316,3578715263,3578715290,27
2,714,6317,3578715263,3578715290,27
2,714,6318,3578715263,3578715290,27
2,714,6319,3578715263,3578715294,31
2,714,6320,3578715263,3578715298,35
2,714,6321,3578715263,3578715304,41
2,714,6322,3578715263,3578715304,41
2,714,6323,3578715263,3578715306,43
2,714,6324,3578715263,3578715306,43
2,714,6325,3578715263,3578715307,44
2,714,6326,3578715263,3578715307,44
2,714,6327,3578715263,3578715309,46
2,714,6328,3578715263,3578715312,49
2,714,6329,3578715263,3578715313,50
2,715,6330,3578715317,3578715317,0
2,715,6331,3578715317,3578715317,0
2,715,6332,3578715317,3578715317,0
2,715,6333,3578715317,3578715317,0
2,715,6334,3578715317,3578715317,0
2,715,6335,3578715317,3578715317,0
2,715,6336,3578715317,3578715318,1
2,715,6337,3578715317,3578715322,5
2,715,6338,3578715317,3578715326,9
2,715,6339,3578715317,3578715327,10
2,715,6340,3578715317,3578715329,12
2,715,6341,3578715317,3578715331,14
2,715,6342,3578715317,3578715333,16
2,715,6343,3578715317,3578715334,17
2,715,6344,3578715317,3578715337,20
2,715,6345,3578715317,3578715337,20
2,715,6346,3578715317,3578715343,26
2,715,6347,3578715317,3578715349,32
2,715,6348,3578715317,3578715350,33
2,715,6349,3578715317,3578715352,35
2,715,6350,3578715317,3578715355,38
2,715,6351,3578715317,3578715355,38
2,715,6352,3578715317,3578715357,40
2,715,6353,3578715317,3578715359,42
2,715,6354,3578715317,3578715360,43
2,715,6355,3578715317,3578715363,46
2,715,6356,3578715317,3578715366,49
2,715,6357,3578715317,3578715367,50
2,716,6358,3578715370,3578715371,1
2,716,6359,3578715370,3578715373,3
2,716,6360,3578715370,3578715376,6
2,716,6361,3578715370,3578715377,7
2,716,6362,3578715370,3578715385,15
2,716,6363,3578715370,3578715389,19
2,716,6364,3578715370,3578715390,20
2,716,6365,3578715370,3578715391,21
2,716,6366,3578715370,3578715394,24
2,716,6367,3578715370,3578715396,26
2,716,6368,3578715370,3578715400,30
2,716,6369,3578715370,3578715400,30
2,716,6370,3578715370,3578715403,33
2,716,6371,3578715370,3578715407,37
2,716,6372,3578715370,3578715409,39
2,716,6373,3578715370,3578715410,40
2,716,6374,3578715370,3578715415,45
2,716,6375,3578715370,3578715416,46
2,716,6376,3578715370,3578715418,48
2,717,6377,3578715425,3578715425,0
2,717,6378,3578715425,3578715425,0
2,717,6379,3578715425,3578715425,0
2,717,6380,3578715425,3578715425,0
2,717,6381,3578715425,3578715427,2
2,717,6382,3578715425,3578715427,2
2,717,6383,3578715425,3578715435,10
2,717,6384,3578715425,3578715435,10
2,717,6385,3578715425,3578715436,11
2,717,6386,3578715425,3578715437,12
2,717,6387,3578715425,3578715438,13
2,717,6388,3578715425,3578715438,13
2,717,6389,3578715425,3578715441,16
2,717,6390,3578715425,3578715442,17
2,717,6391,3578715425,3578715443,18
2,717,6392,3578715425,3578715443,18
2,717,6393,3578715425,3578715446,21
2,717,6394,3578715425,3578715448,23
2,717,6395,3578715425,3578715450,25
2,717,6396,3578715425,3578715450,25
2,717,6397,3578715425,3578715453,28
2,717,6398,3578715425,3578715453,28
2,717,6399,3578715425,3578715455,30
2,717,6400,3578715425,3578715457,32
2,717,6401,3578715425,3578715462,37
2,717,6402,3578715425,3578715462,37
2,717,6403,3578715425,3578715465,40
2,717,6404,3578715425,3578715466,41
2,717,6405,3578715425,3578715468,43
2,717,6406,3578715425,3578715468,43
2,717,6407,3578715425,3578715468,43
2,717,6408,3578715425,3578715472,47
2,718,6409,3578715479,3578715479,0
2,718,6410,3578715479,3578715480,1
2,718,6411,3578715479,3578715480,1
2,718,6412,3578715479,3578715482,3
2,718,6413,3578715479,3578715483,4
2,718,6414,3578715479,3578715484,5
2,718,6415,3578715479,3578715485,6
2,718,6416,3578715479,3578715486,7
2,718,6417,3578715479,3578715487,8
2,718,6418,3578715479,3578715488,9
2,718,6419,3578715479,3578715489,10
2,718,6420,3578715479,3578715489,10
2,718,6421,3578715479,3578715489,10
2,718,6422,3578715479,3578715493,14
2,718,6423,3578715479,3578715494,15
2,718,6424,3578715479,3578715497,18
2,718,6425,3578715479,3578715503,24
2,718,6426,3578715479,3578715503,24
2,718,6427,3578715479,3578715506,27
2,718,6428,3578715479,3578715506,27
2,718,6429,3578715479,3578715506,27
2,718,6430,3578715479,3578715507,28
2,718,6431,3578715479,3578715509,30
2,718,6432,3578715479,3578715510,31
2,718,6433,3578715479,3578715511,32
2,718,6434,3578715479,3578715513,34
2,718,6435,3578715479,3578715513,34
2,718,6436,3578715479,3578715513,34
2,718,6437,3578715479,3578715515,36
2,718,6438,3578715479,3578715516,37
2,718,6439,3578715479,3578715516,37
2,718,6440,3578715479,3578715516,37
2,718,6441,3578715479,3578715521,42
2,718,6442,3578715479,3578715524,45
2,718,6443,3578715479,3578715527,48
2,719,6444,3578715533,3578715533,0
2,719,6445,3578715533,3578715533,0
2,719,6446,3578715533,3578715533,0
2,719,6447,3578715533,3578715535,2
2,719,6448,3578715533,3578715535,2
2,719,6449,3578715533,3578715537,4
2,719,6450,3578715533,3578715542,9
2,719,6451,3578715533,3578715548,15
2,719,6452,3578715533,3578715549,16
2,719,6453,3578715533,3578715552,19
2,719,6454,3578715533,3578715554,21
2,719,6455,3578715533,3578715554,21
2,719,6456,3578715533,3578715555,22
2,719,6457,3578715533,3578715556,23
2,719,6458,3578715533,3578715558,25
2,719,6459,3578715533,3578715560,27
2,719,6460,3578715533,3578715562,29
2,719,6461,3578715533,3578715565,32
2,719,6462,3578715533,3578715566,33
2,719,6463,3578715533,3578715568,35
2,719,6464,3578715533,3578715568,35
2,719,6465,3578715533,3578715571,38
2,719,6466,3578715533,3578715572,39
2,719,6467,3578715533,3578715575,42
2,719,6468,3578715533,3578715576,43
2,719,6469,3578715533,3578715581,48
2,720,6470,3578715587,3578715587,0
2,720,6471,3578715587,3578715588,1
2,720,6472,3578715587,3578715590,3
2,720,6473,3578715587,3578715590,3
2,720,6474,3578715587,3578715593,6
2,720,6475,3578715587,3578715596,9
2,720,6476,3578715587,3578715599,12
2,720,6477,3578715587,3578715600,13
2,720,6478,3578715587,3578715602,15
2,720,6479,3578715587,3578715606,19
2,720,6480,3578715587,3578715609,22
2,720,6481,3578715587,3578715610,23
2,720,6482,3578715587,3578715613,26
2,720,6483,3578715587,3578715617,30
2,720,6484,3578715587,3578715620,33
2,720,6485,3578715587,3578715621,34
2,720,6486,3578715587,3578715621,34
2,720,6487,3578715587,3578715623,36
2,720,6488,3578715587,3578715623,36
2,720,6489,3578715587,3578715626,39
2,720,6490,3578715587,3578715627,40
2,720,6491,3578715587,3578715634,47
2,720,6492,3578715587,3578715634,47
2,720,6493,3578715587,3578715636,49
2,720,6494,3578715587,3578715636,49
2,720,6495,3578715587,3578715637,50
2,721,6496,3578715642,3578715642,0
2,721,6497,3578715642,3578715642,0
2,721,6498,3578715642,3578715642,0
2,721,6499,3578715642,3578715643,1
2,721,6500,3578715642,3578715645,3
2,721,6501,3578715642,3578715647,5
2,721,6502,3578715642,3578715648,6
2,721,6503,3578715642,3578715650,8
2,721,6504,3578715642,3578715651,9
2,721,6505,3578715642,3578715653,11
2,721,6506,3578715642,3578715654,12
2,721,6507,3578715642,3578715657,15
2,721,6508,3578715642,3578715661,19
2,721,6509,3578715642,3578715662,20
2,721,6510,3578715642,3578715665,23
2,721,6511,3578715642,3578715665,23
2,721,6512,3578715642,3578715667,25
2,721,6513,3578715642,3578715667,25
2,721,6514,3578715642,3578715668,26
2,721,6515,3578715642,3578715670,28
2,721,6516,3578715642,3578715671,29
2,721,6517,3578715642,3578715678,36
2,721,6518,3578715642,3578715680,38
2,721,6519,3578715642,3578715680,38
2,721,6520,3578715642,3578715683,41
2,721,6521,3578715642,3578715683,41
2,721,6522,3578715642,3578715684,42
2,721,6523,3578715642,3578715685,43
2,721,6524,3578715642,3578715687,45
2,721,6525,3578715642,3578715687,45
2,721,6526,3578715642,3578715688,46
2,721,6527,3578715642,3578715689,47
2,721,6528,3578715642,3578715690,48
2,721,6529,3578715642,3578715690,48
2,722,6530,3578715696,3578715696,0
2,722,6531,3578715696,3578715696,0
2,722,6532,3578715696,3578715697,1
2,722,6533,3578715696,3578715702,6
2,722,6534,3578715696,3578715703,7
2,722,6535,3578715696,3578715705,9
2,722,6536,3578715696,3578715706,10
2,722,6537,3578715696,3578715706,10
2,722,6538,3578715696,3578715707,11
2,722,6539,3578715696,3578715709,13
2,722,6540,3578715696,3578715710,14
2,722,6541,3578715696,3578715712,16
2,722,6542,3578715696,3578715713,17
2,722,6543,3578715696,3578715713,17
2,722,6544,3578715696,3578715713,17
2,722,6545,3578715696,3578715715,19
2,722,6546,3578715696,3578715716,20
2,722,6547,3578715696,3578715716,20
2,722,6548,3578715696,3578715717,21
2,722,6549,3578715696,3578715721,25
2,722,6550,3578715696,3578715724,28
2,722,6551,3578715696,3578715727,31
2,722,6552,3578715696,3578715729,33
2,722,6553,3578715696,3578715731,35
2,722,6554,3578715696,3578715732,36
2,722,6555,3578715696,3578715735,39
2,722,6556,3578715696,3578715735,39
2,722,6557,3578715696,3578715737,41
2,722,6558,3578715696,3578715742,46
2,723,6559,3578715751,3578715751,0
2,723,6560,3578715751,3578715751,0
2,723,6561,3578715751,3578715752,1
2,723,6562,3578715751,3578715754,3
2,723,6563,3578715751,3578715754,3
2,723,6564,3578715751,3578715756,5
2,723,6565,3578715751,3578715756,5
2,723,6566,3578715751,3578715758,7
2,723,6567,3578715751,3578715760,9
2,723,6568,3578715751,3578715762,11
2,723,6569,3578715751,3578715765,14
2,723,6570,3578715751,3578715766,15
2,723,6571,3578715751,3578715767,16
2,723,6572,3578715751,3578715768,17
2,723,6573,3578715751,3578715771,20
2,723,6574,3578715751,3578715772,21
2,723,6575,3578715751,3578715775,24
2,723,6576,3578715751,3578715776,25
2,723,6577,3578715751,3578715781,30
2,723,6578,3578715751,3578715786,35
2,723,6579,3578715751,3578715788,37
2,723,6580,3578715751,3578715790,39
2,723,6581,3578715751,3578715792,41
2,723,6582,3578715751,3578715796,45
2,723,6583,3578715751,3578715796,45
2,723,6584,3578715751,3578715796,45
2,723,6585,3578715751,3578715799,48
2,723,6586,3578715751,3578715800,49
2,724,6587,3578715805,3578715805,0
2,724,6588,3578715805,3578715805,0
2,724,6589,3578715805,3578715806,1
2,724,6590,3578715805,3578715808,3
2,724,6591,3578715805,3578715810,5
2,724,6592,3578715805,3578715813,8
2,724,6593,3578715805,3578715817,12
2,724,6594,3578715805,3578715819,14
2,724,6595,3578715805,3578715820,15
2,724,6596,3578715805,3578715821,16
2,724,6597,3578715805,3578715823,18
2,724,6598,3578715805,3578715824,19
2,724,6599,3578715805,3578715826,21
2,724,6600,3578715805,3578715827,22
2,724,6601,3578715805,3578715834,29
2,724,6602,3578715805,3578715834,29
2,724,6603,3578715805,3578715836,31
2,724,6604,3578715805,3578715837,32
2,724,6605,3578715805,3578715838,33
2,724,6606,3578715805,3578715839,34
2,724,6607,3578715805,3578715840,35
2,724,6608,3578715805,3578715841,36
2,724,6609,3578715805,3578715843,38
2,724,6610,3578715805,3578715843,38
2,724,6611,3578715805,3578715846,41
2,724,6612,3578715805,3578715847,42
2,724,6613,3578715805,3578715848,43
2,724,6614,3578715805,3578715850,45
2,724,6615,3578715805,3578715851,46
2,724,6616,3578715805,3578715853,48
2,724,6617,3578715805,3578715854,49
2,725,6618,3578715859,3578715859,0
2,725,6619,3578715859,3578715861,2
2,725,6620,3578715859,3578715862,3
2,725,6621,3578715859,3578715865,6
2,725,6622,3578715859,3578715865,6
2,725,6623,3578715859,3578715866,7
2,725,6624,3578715859,3578715867,8
2,725,6625,3578715859,3578715869,10
2,725,6626,3578715859,3578715870,11
2,725,6627,3578715859,3578715871,12
2,725,6628,3578715859,3578715876,17
2,725,6629,3578715859,3578715878,19
2,725,6630,3578715859,3578715880,21
2,725,6631,3578715859,3578715880,21
2,725,6632,3578715859,3578715882,23
2,725,6633,3578715859,3578715883,24
2,725,6634,3578715859,3578715885,26
2,725,6635,3578715859,3578715887,28
2,725,6636,3578715859,3578715888,29
2,725,6637,3578715859,3578715889,30
2,725,6638,3578715859,3578715889,30
2,725,6639,3578715859,3578715890,31
2,725,6640,3578715859,3578715894,35
2,725,6641,3578715859,3578715897,38
2,725,6642,3578715859,3578715903,44
2,725,6643,3578715859,3578715904,45
2,725,6644,3578715859,3578715906,47
2,725,6645,3578715859,3578715906,47
2,725,6646,3578715859,3578715906,47
2,725,6647,3578715859,3578715907,48
2,726,6648,3578715913,3578715913,0
2,726,6649,3578715913,3578715913,0
2,726,6650,3578715913,3578715913,0
2,726,6651,3578715913,3578715913,0
2,726,6652,3578715913,3578715913,0
2,726,6653,3578715913,3578715913,0
2,726,6654,3578715913,3578715914,1
2,726,6655,3578715913,3578715915,2
2,726,6656,3578715913,3578715916,3
2,726,6657,3578715913,3578715917,4
2,726,6658,3578715913,3578715921,8
2,726,6659,3578715913,3578715925,12
2,726,6660,3578715913,3578715927,14
2,726,6661,3578715913,3578715930,17
2,726,6662,3578715913,3578715932,19
2,726,6663,3578715913,3578715933,20
2,726,6664,3578715913,3578715935,22
2,726,6665,3578715913,3578715935,22
2,726,6666,3578715913,3578715937,24
2,726,6667,3578715913,3578715942,29
2,726,6668,3578715913,3578715948,35
2,726,6669,3578715913,3578715950,37
2,726,6670,3578715913,3578715952,39
2,726,6671,3578715913,3578715954,41
2,726,6672,3578715913,3578715954,41
2,726,6673,3578715913,3578715956,43
2,726,6674,3578715913,3578715956,43
2,726,6675,3578715913,3578715958,45
2,726,6676,3578715913,3578715960,47
2,726,6677,3578715913,3578715963,50
2,727,6678,3578715967,3578715967,0
2,727,6679,3578715967,3578715967,0
2,727,6680,3578715967,3578715967,0
2,727,6681,3578715967,3578715968,1
2,727,6682,3578715967,3578715972,5
2,727,6683,3578715967,3578715972,5
2,727,6684,3578715967,3578715976,9
2,727,6685,3578715967,3578715976,9
2,727,6686,3578715967,3578715980,13
2,727,6687,3578715967,3578715986,19
2,727,6688,3578715967,3578715988,21
2,727,6689,3578715967,3578715990,23
2,727,6690,3578715967,3578715991,24
2,727,6691,3578715967,3578715994,27
2,727,6692,3578715967,3578715996,29
2,727,6693,3578715967,3578715996,29
2,727,6694,3578715967,3578715997,30
2,727,6695,3578715967,3578716000,33
2,727,6696,3578715967,3578716000,33
2,727,6697,3578715967,3578716002,35
2,727,6698,3578715967,3578716002,35
2,727,6699,3578715967,3578716006,39
2,727,6700,3578715967,3578716009,42
2,727,6701,3578715967,3578716011,44
2,727,6702,3578715967,3578716013,46
2,727,6703,3578715967,3578716017,50
2,728,6704,3578716021,3578716021,0
2,728,6705,3578716021,3578716021,0
2,728,6706,3578716021,3578716021,0
2,728,6707,3578716021,3578716023,2
2,728,6708,3578716021,3578716024,3
2,728,6709,3578716021,3578716026,5
2,728,6710,3578716021,3578716028,7
2,728,6711,3578716021,3578716034,13
2,728,6712,3578716021,3578716035,14
2,728,6713,3578716021,3578716036,15
2,728,6714,3578716021,3578716036,15
2,728,6715,3578716021,3578716038,17
2,728,6716,3578716021,3578716039,18
2,728,6717,3578716021,3578716040,19
2,728,6718,3578716021,3578716041,20
2,728,6719,3578716021,3578716043,22
2,728,6720,3578716021,3578716043,22
2,728,6721,3578716021,3578716046,25
2,728,6722,3578716021,3578716047,26
2,728,6723,3578716021,3578716049,28
2,728,6724,3578716021,3578716050,29
2,728,6725,3578716021,3578716051,30
2,728,6726,3578716021,3578716054,33
2,728,6727,3578716021,3578716054,33
2,728,6728,3578716021,3578716057,36
2,728,6729,3578716021,3578716061,40
2,728,6730,3578716021,3578716061,40
2,728,6731,3578716021,3578716065,44
2,728,6732,3578716021,3578716066,45
2,728,6733,3578716021,3578716067,46
2,728,6734,3578716021,3578716067,46
2,728,6735,3578716021,3578716069,48
2,728,6736,3578716021,3578716070,49
2,729,6737,3578716075,3578716075,0
2,729,6738,3578716075,3578716077,2
2,729,6739,3578716075,3578716077,2
2,729,6740,3578716075,3578716080,5
2,729,6741,3578716075,3578716081,6
2,729,6742,3578716075,3578716083,8
2,729,6743,3578716075,3578716084,9
2,729,6744,3578716075,3578716084,9
2,729,6745,3578716075,3578716088,13
2,729,6746,3578716075,3578716088,13
2,729,6747,3578716075,3578716089,14
2,729,6748,3578716075,3578716090,15
2,729,6749,3578716075,3578716090,15
2,729,6750,3578716075,3578716094,19
2,729,6751,3578716075,3578716095,20
2,729,6752,3578716075,3578716097,22
2,729,6753,3578716075,3578716103,28
2,729,6754,3578716075,3578716103,28
2,729,6755,3578716075,3578716105,30
2,729,6756,3578716075,3578716106,31
2,729,6757,3578716075,3578716106,31
2,729,6758,3578716075,3578716107,32
2,729,6759,3578716075,3578716110,35
2,729,6760,3578716075,3578716111,36
2,729,6761,3578716075,3578716112,37
2,729,6762,3578716075,3578716113,38
2,729,6763,3578716075,3578716113,38
2,729,6764,3578716075,3578716113,38
2,729,6765,3578716075,3578716114,39
2,729,6766,3578716075,3578716115,40
2,729,6767,3578716075,3578716116,41
2,729,6768,3578716075,3578716117,42
2,729,6769,3578716075,3578716121,46
2,730,6770,3578716128,3578716128,0
2,730,6771,3578716128,3578716128,0
2,730,6772,3578716128,3578716129,1
2,730,6773,3578716128,3578716131,3
2,730,6774,3578716128,3578716134,6
2,730,6775,3578716128,3578716135,7
2,730,6776,3578716128,3578716136,8
2,730,6777,3578716128,3578716138,10
2,730,6778,3578716128,3578716143,15
2,730,6779,3578716128,3578716148,20
2,730,6780,3578716128,3578716150,22
2,730,6781,3578716128,3578716152,24
2,730,6782,3578716128,3578716154,26
2,730,6783,3578716128,3578716154,26
2,730,6784,3578716128,3578716156,28
2,730,6785,3578716128,3578716156,28
2,730,6786,3578716128,3578716158,30
2,730,6787,3578716128,3578716160,32
2,730,6788,3578716128,3578716163,35
2,730,6789,3578716128,3578716166,38
2,730,6790,3578716128,3578716166,38
2,730,6791,3578716128,3578716167,39
2,730,6792,3578716128,3578716168,40
2,730,6793,3578716128,3578716172,44
2,730,6794,3578716128,3578716173,45
2,730,6795,3578716128,3578716176,48
2,730,6796,3578716128,3578716177,49
2,731,6797,3578716183,3578716183,0
2,731,6798,3578716183,3578716186,3
2,731,6799,3578716183,3578716189,6
2,731,6800,3578716183,3578716190,7
2,731,6801,3578716183,3578716190,7
2,731,6802,3578716183,3578716194,11
2,731,6803,3578716183,3578716195,12
2,731,6804,3578716183,3578716196,13
2,731,6805,3578716183,3578716196,13
2,731,6806,3578716183,3578716197,14
2,731,6807,3578716183,3578716200,17
2,731,6808,3578716183,3578716200,17
2,731,6809,3578716183,3578716203,20
2,731,6810,3578716183,3578716204,21
2,731,6811,3578716183,3578716206,23
2,731,6812,3578716183,3578716208,25
2,731,6813,3578716183,3578716210,27
2,731,6814,3578716183,3578716214,31
2,731,6815,3578716183,3578716217,34
2,731,6816,3578716183,3578716219,36
2,731,6817,3578716183,3578716221,38
2,731,6818,3578716183,3578716221,38
2,731,6819,3578716183,3578716223,40
2,731,6820,3578716183,3578716224,41
2,731,6821,3578716183,3578716227,44
2,731,6822,3578716183,3578716228,45
2,732,6823,3578716238,3578716238,0
2,732,6824,3578716238,3578716238,0
2,732,6825,3578716238,3578716238,0
2,732,6826,3578716238,3578716238,0
2,732,6827,3578716238,3578716238,0
2,732,6828,3578716238,3578716239,1
2,732,6829,3578716238,3578716240,2
2,732,6830,3578716238,3578716241,3
2,732,6831,3578716238,3578716242,4
2,732,6832,3578716238,3578716243,5
2,732,6833,3578716238,3578716244,6
2,732,6834,3578716238,3578716247,9
2,732,6835,3578716238,3578716247,9
2,732,6836,3578716238,3578716249,11
2,732,6837,3578716238,3578716250,12
2,732,6838,3578716238,3578716252,14
2,732,6839,3578716238,3578716253,15
2,732,6840,3578716238,3578716254,16
2,732,6841,3578716238,3578716257,19
2,732,6842,3578716238,3578716261,23
2,732,6843,3578716238,3578716261,23
2,732,6844,3578716238,3578716265,27
2,732,6845,3578716238,3578716265,27
2,732,6846,3578716238,3578716267,29
2,732,6847,3578716238,3578716267,29
2,732,6848,3578716238,3578716269,31
2,732,6849,3578716238,3578716271,33
2,732,6850,3578716238,3578716273,35
2,732,6851,3578716238,3578716277,39
2,732,6852,3578716238,3578716277,39
2,732,6853,3578716238,3578716280,42
2,732,6854,3578716238,3578716281,43
2,732,6855,3578716238,3578716282,44
2,732,6856,3578716238,3578716283,45
2,732,6857,3578716238,3578716284,46
2,732,6858,3578716238,3578716285,47
2,732,6859,3578716238,3578716287,49
2,732,6860,3578716238,3578716287,49
2,733,6861,3578716293,3578716293,0
2,733,6862,3578716293,3578716293,0
2,733,6863,3578716293,3578716293,0
2,733,6864,3578716293,3578716293,0
2,733,6865,3578716293,3578716294,1
2,733,6866,3578716293,3578716294,1
2,733,6867,3578716293,3578716297,4
2,733,6868,3578716293,3578716302,9
2,733,6869,3578716293,3578716303,10
2,733,6870,3578716293,3578716306,13
2,733,6871,3578716293,3578716306,13
2,733,6872,3578716293,3578716307,14
2,733,6873,3578716293,3578716307,14
2,733,6874,3578716293,3578716309,16
2,733,6875,3578716293,3578716311,18
2,733,6876,3578716293,3578716313,20
2,733,6877,3578716293,3578716313,20
2,733,6878,3578716293,3578716313,20
2,733,6879,3578716293,3578716313,20
2,733,6880,3578716293,3578716316,23
2,733,6881,3578716293,3578716316,23
2,733,6882,3578716293,3578716317,24
2,733,6883,3578716293,3578716321,28
2,733,6884,3578716293,3578716325,32
2,733,6885,3578716293,3578716328,35
2,733,6886,3578716293,3578716330,37
2,733,6887,3578716293,3578716332,39
2,733,6888,3578716293,3578716334,41
2,733,6889,3578716293,3578716335,42
2,733,6890,3578716293,3578716335,42
2,733,6891,3578716293,3578716338,45
2,734,6892,3578716347,3578716347,0
2,734,6893,3578716347,3578716348,1
2,734,6894,3578716347,3578716351,4
2,734,6895,3578716347,3578716353,6
2,734,6896,3578716347,3578716354,7
2,734,6897,3578716347,3578716355,8
2,734,6898,3578716347,3578716355,8
2,734,6899,3578716347,3578716356,9
2,734,6900,3578716347,3578716358,11
2,734,6901,3578716347,3578716360,13
2,734,6902,3578716347,3578716363,16
2,734,6903,3578716347,3578716366,19
2,734,6904,3578716347,3578716367,20
2,734,6905,3578716347,3578716369,22
2,734,6906,3578716347,3578716369,22
2,734,6907,3578716347,3578716372,25
2,734,6908,3578716347,3578716373,26
2,734,6909,3578716347,3578716376,29
2,734,6910,3578716347,3578716380,33
2,734,6911,3578716347,3578716386,39
2,734,6912,3578716347,3578716389,42
2,734,6913,3578716347,3578716391,44
2,734,6914,3578716347,3578716394,47
2,734,6915,3578716347,3578716394,47
2,734,6916,3578716347,3578716396,49
2,734,6917,3578716347,3578716396,49
2,734,6918,3578716347,3578716397,50
2,735,6919,3578716401,3578716401,0
2,735,6920,3578716401,3578716401,0
2,735,6921,3578716401,3578716403,2
2,735,6922,3578716401,3578716404,3
2,735,6923,3578716401,3578716406,5
2,735,6924,3578716401,3578716408,7
2,735,6925,3578716401,3578716410,9
2,735,6926,3578716401,3578716414,13
2,735,6927,3578716401,3578716418,17
2,735,6928,3578716401,3578716419,18
2,735,6929,3578716401,3578716421,20
2,735,6930,3578716401,3578716422,21
2,735,6931,3578716401,3578716423,22
2,735,6932,3578716401,3578716424,23
2,735,6933,3578716401,3578716427,26
2,735,6934,3578716401,3578716427,26
2,735,6935,3578716401,3578716434,33
2,735,6936,3578716401,3578716435,34
2,735,6937,3578716401,3578716436,35
2,735,6938,3578716401,3578716437,36
2,735,6939,3578716401,3578716438,37
2,735,6940,3578716401,3578716440,39
2,735,6941,3578716401,3578716441,40
2,735,6942,3578716401,3578716442,41
2,735,6943,3578716401,3578716443,42
2,735,6944,3578716401,3578716444,43
2,735,6945,3578716401,3578716447,46
2,735,6946,3578716401,3578716447,46
2,735,6947,3578716401,3578716450,49
2,735,6948,3578716401,3578716450,49
2,736,6949,3578716456,3578716456,0
2,736,6950,3578716456,3578716456,0
2,736,6951,3578716456,3578716456,0
2,736,6952,3578716456,3578716457,1
2,736,6953,3578716456,3578716461,5
2,736,6954,3578716456,3578716462,6
2,736,6955,3578716456,3578716465,9
2,736,6956,3578716456,3578716465,9
2,736,6957,3578716456,3578716467,11
2,736,6958,3578716456,3578716468,12
2,736,6959,3578716456,3578716470,14
2,736,6960,3578716456,3578716473,17
2,736,6961,3578716456,3578716476,20
2,736,6962,3578716456,3578716478,22
2,736,6963,3578716456,3578716480,24
2,736,6964,3578716456,3578716481,25
2,736,6965,3578716456,3578716484,28
2,736,6966,3578716456,3578716487,31
2,736,6967,3578716456,3578716488,32
2,736,6968,3578716456,3578716488,32
2,736,6969,3578716456,3578716490,34
2,736,6970,3578716456,3578716490,34
2,736,6971,3578716456,3578716491,35
2,736,6972,3578716456,3578716494,38
2,736,6973,3578716456,3578716494,38
2,736,6974,3578716456,3578716497,41
2,736,6975,3578716456,3578716503,47
2,737,6976,3578716513,3578716513,0
2,737,6977,3578716513,3578716513,0
2,737,6978,3578716513,3578716513,0
2,737,6979,3578716513,3578716513,0
2,737,6980,3578716513,3578716513,0
2,737,6981,3578716513,3578716513,0
2,737,6982,3578716513,3578716513,0
2,737,6983,3578716513,3578716513,0
2,737,6984,3578716513,3578716513,0
2,737,6985,3578716513,3578716513,0
2,737,6986,3578716513,3578716513,0
2,737,6987,3578716513,3578716515,2
2,737,6988,3578716513,3578716516,3
2,737,6989,3578716513,3578716516,3
2,737,6990,3578716513,3578716520,7
2,737,6991,3578716513,3578716525,12
2,737,6992,3578716513,3578716527,14
2,737,6993,3578716513,3578716530,17
2,737,6994,3578716513,3578716532,19
2,737,6995,3578716513,3578716533,20
2,737,6996,3578716513,3578716534,21
2,737,6997,3578716513,3578716534,21
2,737,6998,3578716513,3578716537,24
2,737,6999,3578716513,3578716542,29
2,737,7000,3578716513,3578716549,36
2,737,7001,3578716513,3578716550,37
2,737,7002,3578716513,3578716552,39
2,737,7003,3578716513,3578716552,39
2,737,7004,3578716513,3578716554,41
2,737,7005,3578716513,3578716556,43
2,737,7006,3578716513,3578716556,43
2,737,7007,3578716513,3578716557,44
2,737,7008,3578716513,3578716559,46
2,737,7009,3578716513,3578716563,50
2,738,7010,3578716567,3578716567,0
2,738,7011,3578716567,3578716567,0
2,738,7012,3578716567,3578716567,0
2,738,7013,3578716567,3578716568,1
2,738,7014,3578716567,3578716571,4
2,738,7015,3578716567,3578716572,5
2,738,7016,3578716567,3578716575,8
2,738,7017,3578716567,3578716581,14
2,738,7018,3578716567,3578716585,18
2,738,7019,3578716567,3578716589,22
2,738,7020,3578716567,3578716591,24
2,738,7021,3578716567,3578716591,24
2,738,7022,3578716567,3578716593,26
2,738,7023,3578716567,3578716594,27
2,738,7024,3578716567,3578716595,28
2,738,7025,3578716567,3578716595,28
2,738,7026,3578716567,3578716596,29
2,738,7027,3578716567,3578716599,32
2,738,7028,3578716567,3578716599,32
2,738,7029,3578716567,3578716602,35
2,738,7030,3578716567,3578716602,35
2,738,7031,3578716567,3578716606,39
2,738,7032,3578716567,3578716608,41
2,738,7033,3578716567,3578716609,42
2,738,7034,3578716567,3578716613,46
2,738,7035,3578716567,3578716617,50
2,739,7036,3578716621,3578716621,0
2,739,7037,3578716621,3578716621,0
2,739,7038,3578716621,3578716621,0
2,739,7039,3578716621,3578716622,1
2,739,7040,3578716621,3578716623,2
2,739,7041,3578716621,3578716626,5
2,739,7042,3578716621,3578716626,5
2,739,7043,3578716621,3578716634,13
2,739,7044,3578716621,3578716635,14
2,739,7045,3578716621,3578716635,14
2,739,7046,3578716621,3578716637,16
2,739,7047,3578716621,3578716637,16
2,739,7048,3578716621,3578716640,19
2,739,7049,3578716621,3578716640,19
2,739,7050,3578716621,3578716641,20
2,739,7051,3578716621,3578716643,22
2,739,7052,3578716621,3578716643,22
2,739,7053,3578716621,3578716646,25
2,739,7054,3578716621,3578716646,25
2,739,7055,3578716621,3578716649,28
2,739,7056,3578716621,3578716652,31
2,739,7057,3578716621,3578716653,32
2,739,7058,3578716621,3578716654,33
2,739,7059,3578716621,3578716657,36
2,739,7060,3578716621,3578716660,39
2,739,7061,3578716621,3578716661,40
2,739,7062,3578716621,3578716663,42
2,739,7063,3578716621,3578716665,44
2,739,7064,3578716621,3578716666,45
2,739,7065,3578716621,3578716667,46
2,739,7066,3578716621,3578716667,46
2,739,7067,3578716621,3578716669,48
2,740,7068,3578716675,3578716675,0
2,740,7069,3578716675,3578716676,1
2,740,7070,3578716675,3578716678,3
2,740,7071,3578716675,3578716680,5
2,740,7072,3578716675,3578716681,6
2,740,7073,3578716675,3578716681,6
2,740,7074,3578716675,3578716684,9
2,740,7075,3578716675,3578716687,12
2,740,7076,3578716675,3578716688,13
2,740,7077,3578716675,3578716688,13
2,740,7078,3578716675,3578716690,15
2,740,7079,3578716675,3578716690,15
2,740,7080,3578716675,3578716691,16
2,740,7081,3578716675,3578716695,20
2,740,7082,3578716675,3578716695,20
2,740,7083,3578716675,3578716698,23
2,740,7084,3578716675,3578716703,28
2,740,7085,3578716675,3578716703,28
2,740,7086,3578716675,3578716706,31
2,740,7087,3578716675,3578716707,32
2,740,7088,3578716675,3578716707,32
2,740,7089,3578716675,3578716708,33
2,740,7090,3578716675,3578716709,34
2,740,7091,3578716675,3578716711,36
2,740,7092,3578716675,3578716711,36
2,740,7093,3578716675,3578716712,37
2,740,7094,3578716675,3578716712,37
2,740,7095,3578716675,3578716713,38
2,740,7096,3578716675,3578716714,39
2,740,7097,3578716675,3578716716,41
2,740,7098,3578716675,3578716717,42
2,740,7099,3578716675,3578716717,42
2,740,7100,3578716675,3578716721,46
2,740,7101,3578716675,3578716724,49
2,741,7102,3578716729,3578716729,0
2,741,7103,3578716729,3578716730,1
2,741,7104,3578716729,3578716732,3
2,741,7105,3578716729,3578716733,4
2,741,7106,3578716729,3578716734,5
2,741,7107,3578716729,3578716735,6
2,741,7108,3578716729,3578716737,8
2,741,7109,3578716729,3578716742,13
2,741,7110,3578716729,3578716749,20
2,741,7111,3578716729,3578716750,21
2,741,7112,3578716729,3578716752,23
2,741,7113,3578716729,3578716753,24
2,741,7114,3578716729,3578716754,25
2,741,7115,3578716729,3578716755,26
2,741,7116,3578716729,3578716756,27
2,741,7117,3578716729,3578716759,30
2,741,7118,3578716729,3578716762,33
2,741,7119,3578716729,3578716765,36
2,741,7120,3578716729,3578716765,36
2,741,7121,3578716729,3578716768,39
2,741,7122,3578716729,3578716768,39
2,741,7123,3578716729,3578716771,42
2,741,7124,3578716729,3578716772,43
2,741,7125,3578716729,3578716775,46
2,741,7126,3578716729,3578716776,47
2,742,7127,3578716783,3578716783,0
2,742,7128,3578716783,3578716786,3
2,742,7129,3578716783,3578716789,6
2,742,7130,3578716783,3578716790,7
2,742,7131,3578716783,3578716790,7
2,742,7132,3578716783,3578716792,9
2,742,7133,3578716783,3578716794,11
2,742,7134,3578716783,3578716795,12
2,742,7135,3578716783,3578716795,12
2,742,7136,3578716783,3578716796,13
2,742,7137,3578716783,3578716799,16
2,742,7138,3578716783,3578716799,16
2,742,7139,3578716783,3578716802,19
2,742,7140,3578716783,3578716802,19
2,742,7141,3578716783,3578716807,24
2,742,7142,3578716783,3578716808,25
2,742,7143,3578716783,3578716810,27
2,742,7144,3578716783,3578716813,30
2,742,7145,3578716783,3578716818,35
2,742,7146,3578716783,3578716820,37
2,742,7147,3578716783,3578716820,37
2,742,7148,3578716783,3578716821,38
2,742,7149,3578716783,3578716822,39
2,742,7150,3578716783,3578716823,40
2,742,7151,3578716783,3578716826,43
2,742,7152,3578716783,3578716826,43
2,743,7153,3578716838,3578716838,0
2,743,7154,3578716838,3578716838,0
2,743,7155,3578716838,3578716838,0
2,743,7156,3578716838,3578716838,0
2,743,7157,3578716838,3578716838,0
2,743,7158,3578716838,3578716840,2
2,743,7159,3578716838,3578716841,3
2,743,7160,3578716838,3578716841,3
2,743,7161,3578716838,3578716841,3
2,743,7162,3578716838,3578716843,5
2,743,7163,3578716838,3578716844,6
2,743,7164,3578716838,3578716846,8
2,743,7165,3578716838,3578716847,9
2,743,7166,3578716838,3578716848,10
2,743,7167,3578716838,3578716851,13
2,743,7168,3578716838,3578716853,15
2,743,7169,3578716838,3578716854,16
2,743,7170,3578716838,3578716857,19
2,743,7171,3578716838,3578716860,22
2,743,7172,3578716838,3578716861,23
2,743,7173,3578716838,3578716864,26
2,743,7174,3578716838,3578716865,27
2,743,7175,3578716838,3578716866,28
2,743,7176,3578716838,3578716867,29
2,743,7177,3578716838,3578716869,31
2,743,7178,3578716838,3578716869,31
2,743,7179,3578716838,3578716874,36
2,743,7180,3578716838,3578716877,39
2,743,7181,3578716838,3578716878,40
2,743,7182,3578716838,3578716878,40
2,743,7183,3578716838,3578716880,42
2,743,7184,3578716838,3578716880,42
2,743,7185,3578716838,3578716881,43
2,743,7186,3578716838,3578716883,45
2,743,7187,3578716838,3578716884,46
2,743,7188,3578716838,3578716884,46
2,743,7189,3578716838,3578716888,50
2,743,7190,3578716838,3578716888,50
2,744,7191,3578716892,3578716892,0
2,744,7192,3578716892,3578716892,0
2,744,7193,3578716892,3578716892,0
2,744,7194,3578716892,3578716894,2
2,744,7195,3578716892,3578716894,2
2,744,7196,3578716892,3578716895,3
2,744,7197,3578716892,3578716896,4
2,744,7198,3578716892,3578716898,6
2,744,7199,3578716892,3578716902,10
2,744,7200,3578716892,3578716904,12
2,744,7201,3578716892,3578716907,15
2,744,7202,3578716892,3578716907,15
2,744,7203,3578716892,3578716909,17
2,744,7204,3578716892,3578716910,18
2,744,7205,3578716892,3578716912,20
2,744,7206,3578716892,3578716912,20
2,744,7207,3578716892,3578716912,20
2,744,7208,3578716892,3578716913,21
2,744,7209,3578716892,3578716913,21
2,744,7210,3578716892,3578716914,22
2,744,7211,3578716892,3578716916,24
2,744,7212,3578716892,3578716917,25
2,744,7213,3578716892,3578716917,25
2,744,7214,3578716892,3578716919,27
2,744,7215,3578716892,3578716921,29
2,744,7216,3578716892,3578716926,34
2,744,7217,3578716892,3578716928,36
2,744,7218,3578716892,3578716929,37
2,744,7219,3578716892,3578716931,39
2,744,7220,3578716892,3578716933,41
2,744,7221,3578716892,3578716934,42
2,744,7222,3578716892,3578716935,43
2,744,7223,3578716892,3578716936,44
2,745,7224,3578716946,3578716946,0
2,745,7225,3578716946,3578716950,4
2,745,7226,3578716946,3578716951,5
2,745,7227,3578716946,3578716952,6
2,745,7228,3578716946,3578716953,7
2,745,7229,3578716946,3578716954,8
2,745,7230,3578716946,3578716955,9
2,745,7231,3578716946,3578716956,10
2,745,7232,3578716946,3578716957,11
2,745,7233,3578716946,3578716959,13
2,745,7234,3578716946,3578716964,18
2,745,7235,3578716946,3578716965,19
2,745,7236,3578716946,3578716966,20
2,745,7237,3578716946,3578716968,22
2,745,7238,3578716946,3578716968,22
2,745,7239,3578716946,3578716971,25
2,745,7240,3578716946,3578716972,26
2,745,7241,3578716946,3578716976,30
2,745,7242,3578716946,3578716976,30
2,745,7243,3578716946,3578716981,35
2,745,7244,3578716946,3578716985,39
2,745,7245,3578716946,3578716990,44
2,745,7246,3578716946,3578716991,45
2,745,7247,3578716946,3578716991,45
2,745,7248,3578716946,3578716993,47
2,745,7249,3578716946,3578716994,48
2,745,7250,3578716946,3578716995,49
2,745,7251,3578716946,3578716995,49
2,745,7252,3578716946,3578716996,50
2,746,7253,3578717001,3578717001,0
2,746,7254,3578717001,3578717001,0
2,746,7255,3578717001,3578717002,1
2,746,7256,3578717001,3578717003,2
2,746,7257,3578717001,3578717007,6
2,746,7258,3578717001,3578717009,8
2,746,7259,3578717001,3578717010,9
2,746,7260,3578717001,3578717013,12
2,746,7261,3578717001,3578717018,17
2,746,7262,3578717001,3578717020,19
2,746,7263,3578717001,3578717020,19
2,746,7264,3578717001,3578717021,20
2,746,7265,3578717001,3578717022,21
2,746,7266,3578717001,3578717024,23
2,746,7267,3578717001,3578717025,24
2,746,7268,3578717001,3578717028,27
2,746,7269,3578717001,3578717034,33
2,746,7270,3578717001,3578717036,35
2,746,7271,3578717001,3578717036,35
2,746,7272,3578717001,3578717038,37
2,746,7273,3578717001,3578717040,39
2,746,7274,3578717001,3578717040,39
2,746,7275,3578717001,3578717041,40
2,746,7276,3578717001,3578717042,41
2,746,7277,3578717001,3578717043,42
2,746,7278,3578717001,3578717043,42
2,746,7279,3578717001,3578717046,45
2,746,7280,3578717001,3578717047,46
2,746,7281,3578717001,3578717050,49
2,746,7282,3578717001,3578717050,49
2,746,7283,3578717001,3578717051,50
2,747,7284,3578717056,3578717056,0
2,747,7285,3578717056,3578717056,0
2,747,7286,3578717056,3578717057,1
2,747,7287,3578717056,3578717060,4
2,747,7288,3578717056,3578717061,5
2,747,7289,3578717056,3578717065,9
2,747,7290,3578717056,3578717065,9
2,747,7291,3578717056,3578717066,10
2,747,7292,3578717056,3578717067,11
2,747,7293,3578717056,3578717068,12
2,747,7294,3578717056,3578717069,13
2,747,7295,3578717056,3578717074,18
2,747,7296,3578717056,3578717076,20
2,747,7297,3578717056,3578717077,21
2,747,7298,3578717056,3578717078,22
2,747,7299,3578717056,3578717080,24
2,747,7300,3578717056,3578717081,25
2,747,7301,3578717056,3578717081,25
2,747,7302,3578717056,3578717082,26
2,747,7303,3578717056,3578717085,29
2,747,7304,3578717056,3578717087,31
2,747,7305,3578717056,3578717088,32
2,747,7306,3578717056,3578717088,32
2,747,7307,3578717056,3578717090,34
2,747,7308,3578717056,3578717091,35
2,747,7309,3578717056,3578717094,38
2,747,7310,3578717056,3578717095,39
2,747,7311,3578717056,3578717096,40
2,747,7312,3578717056,3578717096,40
2,747,7313,3578717056,3578717098,42
2,747,7314,3578717056,3578717098,42
2,747,7315,3578717056,3578717103,47
2,747,7316,3578717056,3578717103,47
2,748,7317,3578717110,3578717110,0
2,748,7318,3578717110,3578717110,0
2,748,7319,3578717110,3578717110,0
2,748,7320,3578717110,3578717110,0
2,748,7321,3578717110,3578717110,0
2,748,7322,3578717110,3578717111,1
2,748,7323,3578717110,3578717113,3
2,748,7324,3578717110,3578717113,3
2,748,7325,3578717110,3578717114,4
2,748,7326,3578717110,3578717116,6
2,748,7327,3578717110,3578717117,7
2,748,7328,3578717110,3578717120,10
2,748,7329,3578717110,3578717121,11
2,748,7330,3578717110,3578717125,15
2,748,7331,3578717110,3578717130,20
2,748,7332,3578717110,3578717132,22
2,748,7333,3578717110,3578717133,23
2,748,7334,3578717110,3578717135,25
2,748,7335,3578717110,3578717135,25
2,748,7336,3578717110,3578717138,28
2,748,7337,3578717110,3578717143,33
2,748,7338,3578717110,3578717150,40
2,748,7339,3578717110,3578717151,41
2,748,7340,3578717110,3578717153,43
2,748,7341,3578717110,3578717153,43
2,748,7342,3578717110,3578717154,44
2,748,7343,3578717110,3578717155,45
2,748,7344,3578717110,3578717155,45
2,748,7345,3578717110,3578717159,49
2,749,7346,3578717165,3578717165,0
2,749,7347,3578717165,3578717166,1
2,749,7348,3578717165,3578717167,2
2,749,7349,3578717165,3578717168,3
2,749,7350,3578717165,3578717172,7
2,749,7351,3578717165,3578717173,8
2,749,7352,3578717165,3578717176,11
2,749,7353,3578717165,3578717177,12
2,749,7354,3578717165,3578717181,16
2,749,7355,3578717165,3578717186,21
2,749,7356,3578717165,3578717190,25
2,749,7357,3578717165,3578717190,25
2,749,7358,3578717165,3578717191,26
2,749,7359,3578717165,3578717194,29
2,749,7360,3578717165,3578717194,29
2,749,7361,3578717165,3578717195,30
2,749,7362,3578717165,3578717195,30
2,749,7363,3578717165,3578717196,31
2,749,7364,3578717165,3578717199,34
2,749,7365,3578717165,3578717199,34
2,749,7366,3578717165,3578717200,35
2,749,7367,3578717165,3578717203,38
2,749,7368,3578717165,3578717203,38
2,749,7369,3578717165,3578717207,42
2,749,7370,3578717165,3578717209,44
2,749,7371,3578717165,3578717211,46
2,749,7372,3578717165,3578717214,49
2,750,7373,3578717221,3578717221,0
2,750,7374,3578717221,3578717221,0
2,750,7375,3578717221,3578717221,0
2,750,7376,3578717221,3578717221,0
2,750,7377,3578717221,3578717222,1
2,750,7378,3578717221,3578717224,3
2,750,7379,3578717221,3578717227,6
2,750,7380,3578717221,3578717227,6
2,750,7381,3578717221,3578717234,13
2,750,7382,3578717221,3578717236,15
2,750,7383,3578717221,3578717237,16
2,750,7384,3578717221,3578717238,17
2,750,7385,3578717221,3578717238,17
2,750,7386,3578717221,3578717241,20
2,750,7387,3578717221,3578717241,20
2,750,7388,3578717221,3578717242,21
2,750,7389,3578717221,3578717242,21
2,750,7390,3578717221,3578717243,22
2,750,7391,3578717221,3578717243,22
2,750,7392,3578717221,3578717247,26
2,750,7393,3578717221,3578717247,26
2,750,7394,3578717221,3578717250,29
2,750,7395,3578717221,3578717250,29
2,750,7396,3578717221,3578717254,33
2,750,7397,3578717221,3578717255,34
2,750,7398,3578717221,3578717257,36
2,750,7399,3578717221,3578717260,39
2,750,7400,3578717221,3578717261,40
2,750,7401,3578717221,3578717264,43
2,750,7402,3578717221,3578717265,44
2,750,7403,3578717221,3578717268,47
2,750,7404,3578717221,3578717268,47
2,750,7405,3578717221,3578717269,48
2,750,7406,3578717221,3578717269,48
2,751,7407,3578717275,3578717275,0
2,751,7408,3578717275,3578717277,2
2,751,7409,3578717275,3578717278,3
2,751,7410,3578717275,3578717279,4
2,751,7411,3578717275,3578717281,6
2,751,7412,3578717275,3578717281,6
2,751,7413,3578717275,3578717281,6
2,751,7414,3578717275,3578717282,7
2,751,7415,3578717275,3578717285,10
2,751,7416,3578717275,3578717288,13
2,751,7417,3578717275,3578717288,13
2,751,7418,3578717275,3578717289,14
2,751,7419,3578717275,3578717291,16
2,751,7420,3578717275,3578717294,19
2,751,7421,3578717275,3578717295,20
2,751,7422,3578717275,3578717296,21
2,751,7423,3578717275,3578717298,23
2,751,7424,3578717275,3578717299,24
2,751,7425,3578717275,3578717302,27
2,751,7426,3578717275,3578717303,28
2,751,7427,3578717275,3578717303,28
2,751,7428,3578717275,3578717307,32
2,751,7429,3578717275,3578717307,32
2,751,7430,3578717275,3578717308,33
2,751,7431,3578717275,3578717311,36
2,751,7432,3578717275,3578717312,37
2,751,7433,3578717275,3578717312,37
2,751,7434,3578717275,3578717313,38
2,751,7435,3578717275,3578717314,39
2,751,7436,3578717275,3578717317,42
2,751,7437,3578717275,3578717317,42
2,751,7438,3578717275,3578717318,43
2,751,7439,3578717275,3578717319,44
2,751,7440,3578717275,3578717321,46
2,752,7441,3578717329,3578717329,0
2,752,7442,3578717329,3578717329,0
2,752,7443,3578717329,3578717330,1
2,752,7444,3578717329,3578717332,3
2,752,7445,3578717329,3578717333,4
2,752,7446,3578717329,3578717335,6
2,752,7447,3578717329,3578717335,6
2,752,7448,3578717329,3578717338,9
2,752,7449,3578717329,3578717343,14
2,752,7450,3578717329,3578717350,21
2,752,7451,3578717329,3578717352,23
2,752,7452,3578717329,3578717352,23
2,752,7453,3578717329,3578717353,24
2,752,7454,3578717329,3578717354,25
2,752,7455,3578717329,3578717355,26
2,752,7456,3578717329,3578717355,26
2,752,7457,3578717329,3578717356,27
2,752,7458,3578717329,3578717360,31
2,752,7459,3578717329,3578717363,34
2,752,7460,3578717329,3578717367,38
2,752,7461,3578717329,3578717368,39
2,752,7462,3578717329,3578717369,40
2,752,7463,3578717329,3578717369,40
2,752,7464,3578717329,3578717372,43
2,752,7465,3578717329,3578717373,44
2,752,7466,3578717329,3578717376,47
2,752,7467,3578717329,3578717376,47
2,753,7468,3578717383,3578717383,0
2,753,7469,3578717383,3578717386,3
2,753,7470,3578717383,3578717390,7
2,753,7471,3578717383,3578717391,8
2,753,7472,3578717383,3578717391,8
2,753,7473,3578717383,3578717394,11
2,753,7474,3578717383,3578717395,12
2,753,7475,3578717383,3578717395,12
2,753,7476,3578717383,3578717397,14
2,753,7477,3578717383,3578717400,17
2,753,7478,3578717383,3578717400,17
2,753,7479,3578717383,3578717400,17
2,753,7480,3578717383,3578717403,20
2,753,7481,3578717383,3578717404,21
2,753,7482,3578717383,3578717407,24
2,753,7483,3578717383,3578717408,25
2,753,7484,3578717383,3578717411,28
2,753,7485,3578717383,3578717414,31
2,753,7486,3578717383,3578717418,35
2,753,7487,3578717383,3578717420,37
2,753,7488,3578717383,3578717421,38
2,753,7489,3578717383,3578717421,38
2,753,7490,3578717383,3578717423,40
2,753,7491,3578717383,3578717424,41
2,753,7492,3578717383,3578717427,44
2,753,7493,3578717383,3578717428,45
2,754,7494,3578717437,3578717437,0
2,754,7495,3578717437,3578717437,0
2,754,7496,3578717437,3578717437,0
2,754,7497,3578717437,3578717437,0
2,754,7498,3578717437,3578717438,1
2,754,7499,3578717437,3578717441,4
2,754,7500,3578717437,3578717441,4
2,754,7501,3578717437,3578717442,5
2,754,7502,3578717437,3578717442,5
2,754,7503,3578717437,3578717442,5
2,754,7504,3578717437,3578717443,6
2,754,7505,3578717437,3578717447,10
2,754,7506,3578717437,3578717447,10
2,754,7507,3578717437,3578717450,13
2,754,7508,3578717437,3578717450,13
2,754,7509,3578717437,3578717453,16
2,754,7510,3578717437,3578717454,17
2,754,7511,3578717437,3578717455,18
2,754,7512,3578717437,3578717456,19
2,754,7513,3578717437,3578717457,20
2,754,7514,3578717437,3578717460,23
2,754,7515,3578717437,3578717462,25
2,754,7516,3578717437,3578717465,28
2,754,7517,3578717437,3578717466,29
2,754,7518,3578717437,3578717467,30
2,754,7519,3578717437,3578717467,30
2,754,7520,3578717437,3578717468,31
2,754,7521,3578717437,3578717470,33
2,754,7522,3578717437,3578717474,37
2,754,7523,3578717437,3578717477,40
2,754,7524,3578717437,3578717478,41
2,754,7525,3578717437,3578717479,42
2,754,7526,3578717437,3578717481,44
2,754,7527,3578717437,3578717481,44
2,754,7528,3578717437,3578717481,44
2,754,7529,3578717437,3578717482,45
2,754,7530,3578717437,3578717484,47
2,754,7531,3578717437,3578717485,48
2,755,7532,3578717491,3578717491,0
2,755,7533,3578717491,3578717491,0
2,755,7534,3578717491,3578717491,0
2,755,7535,3578717491,3578717491,0
2,755,7536,3578717491,3578717491,0
2,755,7537,3578717491,3578717493,2
2,755,7538,3578717491,3578717493,2
2,755,7539,3578717491,3578717494,3
2,755,7540,3578717491,3578717494,3
2,755,7541,3578717491,3578717497,6
2,755,7542,3578717491,3578717499,8
2,755,7543,3578717491,3578717501,10
2,755,7544,3578717491,3578717502,11
2,755,7545,3578717491,3578717503,12
2,755,7546,3578717491,3578717505,14
2,755,7547,3578717491,3578717506,15
2,755,7548,3578717491,3578717507,16
2,755,7549,3578717491,3578717508,17
2,755,7550,3578717491,3578717509,18
2,755,7551,3578717491,3578717510,19
2,755,7552,3578717491,3578717511,20
2,755,7553,3578717491,3578717511,20
2,755,7554,3578717491,3578717512,21
2,755,7555,3578717491,3578717513,22
2,755,7556,3578717491,3578717515,24
2,755,7557,3578717491,3578717516,25
2,755,7558,3578717491,3578717517,26
2,755,7559,3578717491,3578717518,27
2,755,7560,3578717491,3578717520,29
2,755,7561,3578717491,3578717524,33
2,755,7562,3578717491,3578717527,36
2,755,7563,3578717491,3578717529,38
2,755,7564,3578717491,3578717532,41
2,755,7565,3578717491,3578717534,43
2,755,7566,3578717491,3578717535,44
2,755,7567,3578717491,3578717536,45
2,756,7568,3578717545,3578717545,0
2,756,7569,3578717545,3578717549,4
2,756,7570,3578717545,3578717551,6
2,756,7571,3578717545,3578717552,7
2,756,7572,3578717545,3578717552,7
2,756,7573,3578717545,3578717553,8
2,756,7574,3578717545,3578717554,9
2,756,7575,3578717545,3578717555,10
2,756,7576,3578717545,3578717555,10
2,756,7577,3578717545,3578717559,14
2,756,7578,3578717545,3578717562,17
2,756,7579,3578717545,3578717566,21
2,756,7580,3578717545,3578717567,22
2,756,7581,3578717545,3578717568,23
2,756,7582,3578717545,3578717568,23
2,756,7583,3578717545,3578717571,26
2,756,7584,3578717545,3578717572,27
2,756,7585,3578717545,3578717575,30
2,756,7586,3578717545,3578717576,31
2,756,7587,3578717545,3578717583,38
2,756,7588,3578717545,3578717585,40
2,756,7589,3578717545,3578717589,44
2,756,7590,3578717545,3578717590,45
2,756,7591,3578717545,3578717590,45
2,756,7592,3578717545,3578717592,47
2,756,7593,3578717545,3578717595,50
2,757,7594,3578717600,3578717600,0
2,757,7595,3578717600,3578717600,0
2,757,7596,3578717600,3578717600,0
2,757,7597,3578717600,3578717600,0
2,757,7598,3578717600,3578717600,0
2,757,7599,3578717600,3578717602,2
2,757,7600,3578717600,3578717603,3
2,757,7601,3578717600,3578717606,6
2,757,7602,3578717600,3578717608,8
2,757,7603,3578717600,3578717610,10
2,757,7604,3578717600,3578717613,13
2,757,7605,3578717600,3578717617,17
2,757,7606,3578717600,3578717620,20
2,757,7607,3578717600,3578717621,21
2,757,7608,3578717600,3578717622,22
2,757,7609,3578717600,3578717624,24
2,757,7610,3578717600,3578717626,26
2,757,7611,3578717600,3578717626,26
2,757,7612,3578717600,3578717634,34
2,757,7613,3578717600,3578717635,35
2,757,7614,3578717600,3578717636,36
2,757,7615,3578717600,3578717637,37
2,757,7616,3578717600,3578717637,37
2,757,7617,3578717600,3578717640,40
2,757,7618,3578717600,3578717641,41
2,757,7619,3578717600,3578717641,41
2,757,7620,3578717600,3578717641,41
2,757,7621,3578717600,3578717642,42
2,757,7622,3578717600,3578717643,43
2,757,7623,3578717600,3578717646,46
2,757,7624,3578717600,3578717646,46
2,757,7625,3578717600,3578717648,48
2,757,7626,3578717600,3578717650,50
2,758,7627,3578717654,3578717654,0
2,758,7628,3578717654,3578717654,0
2,758,7629,3578717654,3578717654,0
2,758,7630,3578717654,3578717655,1
2,758,7631,3578717654,3578717657,3
2,758,7632,3578717654,3578717659,5
2,758,7633,3578717654,3578717662,8
2,758,7634,3578717654,3578717664,10
2,758,7635,3578717654,3578717665,11
2,758,7636,3578717654,3578717666,12
2,758,7637,3578717654,3578717667,13
2,758,7638,3578717654,3578717667,13
2,758,7639,3578717654,3578717669,15
2,758,7640,3578717654,3578717675,21
2,758,7641,3578717654,3578717677,23
2,758,7642,3578717654,3578717677,23
2,758,7643,3578717654,3578717679,25
2,758,7644,3578717654,3578717681,27
2,758,7645,3578717654,3578717681,27
2,758,7646,3578717654,3578717681,27
2,758,7647,3578717654,3578717682,28
2,758,7648,3578717654,3578717685,31
2,758,7649,3578717654,3578717687,33
2,758,7650,3578717654,3578717689,35
2,758,7651,3578717654,3578717689,35
2,758,7652,3578717654,3578717689,35
2,758,7653,3578717654,3578717691,37
2,758,7654,3578717654,3578717692,38
2,758,7655,3578717654,3578717693,39
2,758,7656,3578717654,3578717694,40
2,758,7657,3578717654,3578717695,41
2,758,7658,3578717654,3578717697,43
2,758,7659,3578717654,3578717698,44
2,758,7660,3578717654,3578717701,47
2,758,7661,3578717654,3578717702,48
2,758,7662,3578717654,3578717703,49
2,759,7663,3578717709,3578717709,0
2,759,7664,3578717709,3578717709,0
2,759,7665,3578717709,3578717709,0
2,759,7666,3578717709,3578717709,0
2,759,7667,3578717709,3578717710,1
2,759,7668,3578717709,3578717711,2
2,759,7669,3578717709,3578717711,2
2,759,7670,3578717709,3578717711,2
2,759,7671,3578717709,3578717712,3
2,759,7672,3578717709,3578717712,3
2,759,7673,3578717709,3578717713,4
2,759,7674,3578717709,3578717716,7
2,759,7675,3578717709,3578717717,8
2,759,7676,3578717709,3578717717,8
2,759,7677,3578717709,3578717718,9
2,759,7678,3578717709,3578717722,13
2,759,7679,3578717709,3578717725,16
2,759,7680,3578717709,3578717728,19
2,759,7681,3578717709,3578717729,20
2,759,7682,3578717709,3578717731,22
2,759,7683,3578717709,3578717732,23
2,759,7684,3578717709,3578717734,25
2,759,7685,3578717709,3578717735,26
2,759,7686,3578717709,3578717737,28
2,759,7687,3578717709,3578717742,33
2,759,7688,3578717709,3578717749,40
2,759,7689,3578717709,3578717751,42
2,759,7690,3578717709,3578717752,43
2,759,7691,3578717709,3578717752,43
2,759,7692,3578717709,3578717753,44
2,759,7693,3578717709,3578717754,45
2,759,7694,3578717709,3578717756,47
2,759,7695,3578717709,3578717756,47
2,759,7696,3578717709,3578717758,49
2,759,7697,3578717709,3578717759,50
2,760,7698,3578717764,3578717764,0
2,760,7699,3578717764,3578717765,1
2,760,7700,3578717764,3578717767,3
2,760,7701,3578717764,3578717768,4
2,760,7702,3578717764,3578717768,4
2,760,7703,3578717764,3578717772,8
2,760,7704,3578717764,3578717775,11
2,760,7705,3578717764,3578717776,12
2,760,7706,3578717764,3578717777,13
2,760,7707,3578717764,3578717783,19
2,760,7708,3578717764,3578717783,19
2,760,7709,3578717764,3578717786,22
2,760,7710,3578717764,3578717789,25
2,760,7711,3578717764,3578717789,25
2,760,7712,3578717764,3578717790,26
2,760,7713,3578717764,3578717793,29
2,760,7714,3578717764,3578717794,30
2,760,7715,3578717764,3578717795,31
2,760,7716,3578717764,3578717795,31
2,760,7717,3578717764,3578717796,32
2,760,7718,3578717764,3578717798,34
2,760,7719,3578717764,3578717799,35
2,760,7720,3578717764,3578717799,35
2,760,7721,3578717764,3578717802,38
2,760,7722,3578717764,3578717803,39
2,760,7723,3578717764,3578717806,42
2,760,7724,3578717764,3578717808,44
2,760,7725,3578717764,3578717810,46
2,760,7726,3578717764,3578717813,49
2,761,7727,3578717818,3578717818,0
2,761,7728,3578717818,3578717820,2
2,761,7729,3578717818,3578717821,3
2,761,7730,3578717818,3578717822,4
2,761,7731,3578717818,3578717823,5
2,761,7732,3578717818,3578717826,8
2,761,7733,3578717818,3578717826,8
2,761,7734,3578717818,3578717834,16
2,761,7735,3578717818,3578717835,17
2,761,7736,3578717818,3578717837,19
2,761,7737,3578717818,3578717838,20
2,761,7738,3578717818,3578717840,22
2,761,7739,3578717818,3578717841,23
2,761,7740,3578717818,3578717841,23
2,761,7741,3578717818,3578717842,24
2,761,7742,3578717818,3578717843,25
2,761,7743,3578717818,3578717846,28
2,761,7744,3578717818,3578717848,30
2,761,7745,3578717818,3578717850,32
2,761,7746,3578717818,3578717851,33
2,761,7747,3578717818,3578717853,35
2,761,7748,3578717818,3578717854,36
2,761,7749,3578717818,3578717855,37
2,761,7750,3578717818,3578717856,38
2,761,7751,3578717818,3578717860,42
2,761,7752,3578717818,3578717862,44
2,761,7753,3578717818,3578717864,46
2,761,7754,3578717818,3578717865,47
2,761,7755,3578717818,3578717866,48
2,761,7756,3578717818,3578717867,49
2,762,7757,3578717873,3578717873,0
2,762,7758,3578717873,3578717873,0
2,762,7759,3578717873,3578717876,3
2,762,7760,3578717873,3578717877,4
2,762,7761,3578717873,3578717877,4
2,762,7762,3578717873,3578717879,6
2,762,7763,3578717873,3578717880,7
2,762,7764,3578717873,3578717881,8
2,762,7765,3578717873,3578717882,9
2,762,7766,3578717873,3578717883,10
2,762,7767,3578717873,3578717884,11
2,762,7768,3578717873,3578717888,15
2,762,7769,3578717873,3578717889,16
2,762,7770,3578717873,3578717889,16
2,762,7771,3578717873,3578717890,17
2,762,7772,3578717873,3578717891,18
2,762,7773,3578717873,3578717894,21
2,762,7774,3578717873,3578717894,21
2,762,7775,3578717873,3578717895,22
2,762,7776,3578717873,3578717896,23
2,762,7777,3578717873,3578717899,26
2,762,7778,3578717873,3578717901,28
2,762,7779,3578717873,3578717902,29
2,762,7780,3578717873,3578717905,32
2,762,7781,3578717873,3578717905,32
2,762,7782,3578717873,3578717908,35
2,762,7783,3578717873,3578717910,37
2,762,7784,3578717873,3578717910,37
2,762,7785,3578717873,3578717911,38
2,762,7786,3578717873,3578717911,38
2,762,7787,3578717873,3578717912,39
2,762,7788,3578717873,3578717913,40
2,762,7789,3578717873,3578717913,40
2,762,7790,3578717873,3578717913,40
2,762,7791,3578717873,3578717915,42
2,762,7792,3578717873,3578717916,43
2,762,7793,3578717873,3578717917,44
2,762,7794,3578717873,3578717919,46
2,762,7795,3578717873,3578717921,48
2,763,7796,3578717928,3578717928,0
2,763,7797,3578717928,3578717928,0
2,763,7798,3578717928,3578717930,2
2,763,7799,3578717928,3578717932,4
2,763,7800,3578717928,3578717933,5
2,763,7801,3578717928,3578717935,7
2,763,7802,3578717928,3578717936,8
2,763,7803,3578717928,3578717937,9
2,763,7804,3578717928,3578717942,14
2,763,7805,3578717928,3578717950,22
2,763,7806,3578717928,3578717952,24
2,763,7807,3578717928,3578717952,24
2,763,7808,3578717928,3578717952,24
2,763,7809,3578717928,3578717953,25
2,763,7810,3578717928,3578717954,26
2,763,7811,3578717928,3578717955,27
2,763,7812,3578717928,3578717956,28
2,763,7813,3578717928,3578717959,31
2,763,7814,3578717928,3578717963,35
2,763,7815,3578717928,3578717966,38
2,763,7816,3578717928,3578717967,39
2,763,7817,3578717928,3578717968,40
2,763,7818,3578717928,3578717971,43
2,763,7819,3578717928,3578717976,48
2,763,7820,3578717928,3578717977,49
2,763,7821,3578717928,3578717978,50
2,764,7822,3578717983,3578717983,0
2,764,7823,3578717983,3578717984,1
2,764,7824,3578717983,3578717986,3
2,764,7825,3578717983,3578717989,6
2,764,7826,3578717983,3578717989,6
2,764,7827,3578717983,3578717994,11
2,764,7828,3578717983,3578717994,11
2,764,7829,3578717983,3578717995,12
2,764,7830,3578717983,3578717996,13
2,764,7831,3578717983,3578717996,13
2,764,7832,3578717983,3578717999,16
2,764,7833,3578717983,3578717999,16
2,764,7834,3578717983,3578718000,17
2,764,7835,3578717983,3578718002,19
2,764,7836,3578717983,3578718003,20
2,764,7837,3578717983,3578718006,23
2,764,7838,3578717983,3578718008,25
2,764,7839,3578717983,3578718010,27
2,764,7840,3578717983,3578718013,30
2,764,7841,3578717983,3578718013,30
2,764,7842,3578717983,3578718019,36
2,764,7843,3578717983,3578718021,38
2,764,7844,3578717983,3578718021,38
2,764,7845,3578717983,3578718022,39
2,764,7846,3578717983,3578718025,42
2,764,7847,3578717983,3578718025,42
2,764,7848,3578717983,3578718027,44
2,765,7849,3578718037,3578718037,0
2,765,7850,3578718037,3578718037,0
2,765,7851,3578718037,3578718037,0
2,765,7852,3578718037,3578718037,0
2,765,7853,3578718037,3578718038,1
2,765,7854,3578718037,3578718040,3
2,765,7855,3578718037,3578718041,4
2,765,7856,3578718037,3578718041,4
2,765,7857,3578718037,3578718042,5
2,765,7858,3578718037,3578718042,5
2,765,7859,3578718037,3578718042,5
2,765,7860,3578718037,3578718046,9
2,765,7861,3578718037,3578718047,10
2,765,7862,3578718037,3578718050,13
2,765,7863,3578718037,3578718050,13
2,765,7864,3578718037,3578718051,14
2,765,7865,3578718037,3578718053,16
2,765,7866,3578718037,3578718054,17
2,765,7867,3578718037,3578718055,18
2,765,7868,3578718037,3578718057,20
2,765,7869,3578718037,3578718060,23
2,765,7870,3578718037,3578718062,25
2,765,7871,3578718037,3578718065,28
2,765,7872,3578718037,3578718065,28
2,765,7873,3578718037,3578718066,29
2,765,7874,3578718037,3578718066,29
2,765,7875,3578718037,3578718069,32
2,765,7876,3578718037,3578718076,39
2,765,7877,3578718037,3578718076,39
2,765,7878,3578718037,3578718077,40
2,765,7879,3578718037,3578718079,42
2,765,7880,3578718037,3578718080,43
2,765,7881,3578718037,3578718081,44
2,765,7882,3578718037,3578718082,45
2,765,7883,3578718037,3578718083,46
2,765,7884,3578718037,3578718084,47
2,766,7885,3578718091,3578718091,0
2,766,7886,3578718091,3578718091,0
2,766,7887,3578718091,3578718091,0
2,766,7888,3578718091,3578718091,0
2,766,7889,3578718091,3578718091,0
2,766,7890,3578718091,3578718093,2
2,766,7891,3578718091,3578718094,3
2,766,7892,3578718091,3578718095,4
2,766,7893,3578718091,3578718097,6
2,766,7894,3578718091,3578718099,8
2,766,7895,3578718091,3578718100,9
2,766,7896,3578718091,3578718101,10
2,766,7897,3578718091,3578718102,11
2,766,7898,3578718091,3578718106,15
2,766,7899,3578718091,3578718106,15
2,766,7900,3578718091,3578718108,17
2,766,7901,3578718091,3578718108,17
2,766,7902,3578718091,3578718109,18
2,766,7903,3578718091,3578718110,19
2,766,7904,3578718091,3578718111,20
2,766,7905,3578718091,3578718112,21
2,766,7906,3578718091,3578718113,22
2,766,7907,3578718091,3578718113,22
2,766,7908,3578718091,3578718113,22
2,766,7909,3578718091,3578718113,22
2,766,7910,3578718091,3578718113,22
2,766,7911,3578718091,3578718115,24
2,766,7912,3578718091,3578718117,26
2,766,7913,3578718091,3578718117,26
2,766,7914,3578718091,3578718119,28
2,766,7915,3578718091,3578718121,30
2,766,7916,3578718091,3578718125,34
2,766,7917,3578718091,3578718129,38
2,766,7918,3578718091,3578718130,39
2,766,7919,3578718091,3578718132,41
2,766,7920,3578718091,3578718133,42
2,766,7921,3578718091,3578718135,44
2,766,7922,3578718091,3578718136,45
2,766,7923,3578718091,3578718138,47
2,767,7924,3578718145,3578718145,0
2,767,7925,3578718145,3578718150,5
2,767,7926,3578718145,3578718152,7
2,767,7927,3578718145,3578718152,7
2,767,7928,3578718145,3578718152,7
2,767,7929,3578718145,3578718153,8
2,767,7930,3578718145,3578718154,9
2,767,7931,3578718145,3578718155,10
2,767,7932,3578718145,3578718156,11
2,767,7933,3578718145,3578718159,14
2,767,7934,3578718145,3578718163,18
2,767,7935,3578718145,3578718165,20
2,767,7936,3578718145,3578718168,23
2,767,7937,3578718145,3578718168,23
2,767,7938,3578718145,3578718173,28
2,767,7939,3578718145,3578718176,31
2,767,7940,3578718145,3578718177,32
2,767,7941,3578718145,3578718178,33
2,767,7942,3578718145,3578718182,37
2,767,7943,3578718145,3578718184,39
2,767,7944,3578718145,3578718186,41
2,767,7945,3578718145,3578718188,43
2,767,7946,3578718145,3578718190,45
2,767,7947,3578718145,3578718191,46
2,767,7948,3578718145,3578718194,49
2,767,7949,3578718145,3578718195,50
2,768,7950,3578718199,3578718199,0
2,768,7951,3578718199,3578718199,0
2,768,7952,3578718199,3578718199,0
2,768,7953,3578718199,3578718199,0
2,768,7954,3578718199,3578718200,1
2,768,7955,3578718199,3578718204,5
2,768,7956,3578718199,3578718204,5
2,768,7957,3578718199,3578718206,7
2,768,7958,3578718199,3578718209,10
2,768,7959,3578718199,3578718210,11
2,768,7960,3578718199,3578718213,14
2,768,7961,3578718199,3578718214,15
2,768,7962,3578718199,3578718219,20
2,768,7963,3578718199,3578718220,21
2,768,7964,3578718199,3578718221,22
2,768,7965,3578718199,3578718222,23
2,768,7966,3578718199,3578718225,26
2,768,7967,3578718199,3578718227,28
2,768,7968,3578718199,3578718228,29
2,768,7969,3578718199,3578718233,34
2,768,7970,3578718199,3578718234,35
2,768,7971,3578718199,3578718236,37
2,768,7972,3578718199,3578718237,38
2,768,7973,3578718199,3578718238,39
2,768,7974,3578718199,3578718241,42
2,768,7975,3578718199,3578718241,42
2,768,7976,3578718199,3578718242,43
2,768,7977,3578718199,3578718242,43
2,768,7978,3578718199,3578718242,43
2,768,7979,3578718199,3578718242,43
2,768,7980,3578718199,3578718247,48
2,769,7981,3578718254,3578718254,0
2,769,7982,3578718254,3578718254,0
2,769,7983,3578718254,3578718254,0
2,769,7984,3578718254,3578718254,0
2,769,7985,3578718254,3578718254,0
2,769,7986,3578718254,3578718255,1
2,769,7987,3578718254,3578718257,3
2,769,7988,3578718254,3578718260,6
2,769,7989,3578718254,3578718263,9
2,769,7990,3578718254,3578718265,11
2,769,7991,3578718254,3578718265,11
2,769,7992,3578718254,3578718267,13
2,769,7993,3578718254,3578718268,14
2,769,7994,3578718254,3578718270,16
2,769,7995,3578718254,3578718277,23
2,769,7996,3578718254,3578718277,23
2,769,7997,3578718254,3578718279,25
2,769,7998,3578718254,3578718280,26
2,769,7999,3578718254,3578718281,27
2,769,8000,3578718254,3578718281,27
2,769,8001,3578718254,3578718282,28
2,769,8002,3578718254,3578718282,28
2,769,8003,3578718254,3578718285,31
2,769,8004,3578718254,3578718287,33
2,769,8005,3578718254,3578718290,36
2,769,8006,3578718254,3578718291,37
2,769,8007,3578718254,3578718291,37
2,769,8008,3578718254,3578718291,37
2,769,8009,3578718254,3578718294,40
2,769,8010,3578718254,3578718296,42
2,769,8011,3578718254,3578718297,43
2,769,8012,3578718254,3578718298,44
2,769,8013,3578718254,3578718301,47
2,769,8014,3578718254,3578718302,48
2,769,8015,3578718254,3578718304,50
2,770,8016,3578718309,3578718309,0
2,770,8017,3578718309,3578718309,0
2,770,8018,3578718309,3578718309,0
2,770,8019,3578718309,3578718309,0
2,770,8020,3578718309,3578718310,1
2,770,8021,3578718309,3578718310,1
2,770,8022,3578718309,3578718312,3
2,770,8023,3578718309,3578718312,3
2,770,8024,3578718309,3578718312,3
2,770,8025,3578718309,3578718313,4
2,770,8026,3578718309,3578718313,4
2,770,8027,3578718309,3578718313,4
2,770,8028,3578718309,3578718316,7
2,770,8029,3578718309,3578718317,8
2,770,8030,3578718309,3578718317,8
2,770,8031,3578718309,3578718318,9
2,770,8032,3578718309,3578718319,10
2,770,8033,3578718309,3578718321,12
2,770,8034,3578718309,3578718325,16
2,770,8035,3578718309,3578718329,20
2,770,8036,3578718309,3578718330,21
2,770,8037,3578718309,3578718331,22
2,770,8038,3578718309,3578718334,25
2,770,8039,3578718309,3578718336,27
2,770,8040,3578718309,3578718338,29
2,770,8041,3578718309,3578718343,34
2,770,8042,3578718309,3578718350,41
2,770,8043,3578718309,3578718351,42
2,770,8044,3578718309,3578718352,43
2,770,8045,3578718309,3578718353,44
2,770,8046,3578718309,3578718354,45
2,770,8047,3578718309,3578718355,46
2,770,8048,3578718309,3578718355,46
2,770,8049,3578718309,3578718356,47
2,771,8050,3578718363,3578718363,0
2,771,8051,3578718363,3578718363,0
2,771,8052,3578718363,3578718366,3
2,771,8053,3578718363,3578718366,3
2,771,8054,3578718363,3578718368,5
2,771,8055,3578718363,3578718369,6
2,771,8056,3578718363,3578718369,6
2,771,8057,3578718363,3578718373,10
2,771,8058,3578718363,3578718376,13
2,771,8059,3578718363,3578718377,14
2,771,8060,3578718363,3578718378,15
2,771,8061,3578718363,3578718382,19
2,771,8062,3578718363,3578718385,22
2,771,8063,3578718363,3578718389,26
2,771,8064,3578718363,3578718391,28
2,771,8065,3578718363,3578718391,28
2,771,8066,3578718363,3578718393,30
2,771,8067,3578718363,3578718395,32
2,771,8068,3578718363,3578718395,32
2,771,8069,3578718363,3578718396,33
2,771,8070,3578718363,3578718399,36
2,771,8071,3578718363,3578718399,36
2,771,8072,3578718363,3578718400,37
2,771,8073,3578718363,3578718403,40
2,771,8074,3578718363,3578718403,40
2,771,8075,3578718363,3578718406,43
2,771,8076,3578718363,3578718408,45
2,771,8077,3578718363,3578718410,47
2,772,8078,3578718418,3578718418,0
2,772,8079,3578718418,3578718418,0
2,772,8080,3578718418,3578718419,1
2,772,8081,3578718418,3578718421,3
2,772,8082,3578718418,3578718421,3
2,772,8083,3578718418,3578718422,4
2,772,8084,3578718418,3578718427,9
2,772,8085,3578718418,3578718428,10
2,772,8086,3578718418,3578718433,15
2,772,8087,3578718418,3578718435,17
2,772,8088,3578718418,3578718437,19
2,772,8089,3578718418,3578718438,20
2,772,8090,3578718418,3578718439,21
2,772,8091,3578718418,3578718440,22
2,772,8092,3578718418,3578718441,23
2,772,8093,3578718418,3578718442,24
2,772,8094,3578718418,3578718443,25
2,772,8095,3578718418,3578718443,25
2,772,8096,3578718418,3578718443,25
2,772,8097,3578718418,3578718446,28
2,772,8098,3578718418,3578718447,29
2,772,8099,3578718418,3578718450,32
2,772,8100,3578718418,3578718451,33
2,772,8101,3578718418,3578718452,34
2,772,8102,3578718418,3578718453,35
2,772,8103,3578718418,3578718455,37
2,772,8104,3578718418,3578718455,37
2,772,8105,3578718418,3578718457,39
2,772,8106,3578718418,3578718460,42
2,772,8107,3578718418,3578718463,45
2,772,8108,3578718418,3578718465,47
2,772,8109,3578718418,3578718465,47
2,772,8110,3578718418,3578718467,49
2,772,8111,3578718418,3578718468,50
2,773,8112,3578718473,3578718473,0
2,773,8113,3578718473,3578718473,0
2,773,8114,3578718473,3578718476,3
2,773,8115,3578718473,3578718477,4
2,773,8116,3578718473,3578718478,5
2,773,8117,3578718473,3578718479,6
2,773,8118,3578718473,3578718480,7
2,773,8119,3578718473,3578718481,8
2,773,8120,3578718473,3578718483,10
2,773,8121,3578718473,3578718483,10
2,773,8122,3578718473,3578718484,11
2,773,8123,3578718473,3578718486,13
2,773,8124,3578718473,3578718490,17
2,773,8125,3578718473,3578718490,17
2,773,8126,3578718473,3578718491,18
2,773,8127,3578718473,3578718491,18
2,773,8128,3578718473,3578718493,20
2,773,8129,3578718473,3578718494,21
2,773,8130,3578718473,3578718495,22
2,773,8131,3578718473,3578718495,22
2,773,8132,3578718473,3578718496,23
2,773,8133,3578718473,3578718499,26
2,773,8134,3578718473,3578718501,28
2,773,8135,3578718473,3578718502,29
2,773,8136,3578718473,3578718504,31
2,773,8137,3578718473,3578718506,33
2,773,8138,3578718473,3578718507,34
2,773,8139,3578718473,3578718508,35
2,773,8140,3578718473,3578718508,35
2,773,8141,3578718473,3578718509,36
2,773,8142,3578718473,3578718510,37
2,773,8143,3578718473,3578718511,38
2,773,8144,3578718473,3578718511,38
2,773,8145,3578718473,3578718512,39
2,773,8146,3578718473,3578718513,40
2,773,8147,3578718473,3578718513,40
2,773,8148,3578718473,3578718513,40
2,773,8149,3578718473,3578718513,40
2,773,8150,3578718473,3578718516,43
2,773,8151,3578718473,3578718517,44
2,773,8152,3578718473,3578718517,44
2,773,8153,3578718473,3578718517,44
2,773,8154,3578718473,3578718520,47
2,773,8155,3578718473,3578718521,48
2,774,8156,3578718528,3578718528,0
2,774,8157,3578718528,3578718528,0
2,774,8158,3578718528,3578718530,2
2,774,8159,3578718528,3578718532,4
2,774,8160,3578718528,3578718533,5
2,774,8161,3578718528,3578718535,7
2,774,8162,3578718528,3578718535,7
2,774,8163,3578718528,3578718537,9
2,774,8164,3578718528,3578718542,14
2,774,8165,3578718528,3578718549,21
2,774,8166,3578718528,3578718551,23
2,774,8167,3578718528,3578718551,23
2,774,8168,3578718528,3578718552,24
2,774,8169,3578718528,3578718552,24
2,774,8170,3578718528,3578718554,26
2,774,8171,3578718528,3578718555,27
2,774,8172,3578718528,3578718556,28
2,774,8173,3578718528,3578718559,31
2,774,8174,3578718528,3578718562,34
2,774,8175,3578718528,3578718565,37
2,774,8176,3578718528,3578718566,38
2,774,8177,3578718528,3578718567,39
2,774,8178,3578718528,3578718568,40
2,774,8179,3578718528,3578718568,40
2,774,8180,3578718528,3578718569,41
2,774,8181,3578718528,3578718572,44
2,774,8182,3578718528,3578718575,47
2,774,8183,3578718528,3578718576,48
2,774,8184,3578718528,3578718577,49
2,775,8185,3578718584,3578718584,0
2,775,8186,3578718584,3578718584,0
2,775,8187,3578718584,3578718585,1
2,775,8188,3578718584,3578718588,4
2,775,8189,3578718584,3578718590,6
2,775,8190,3578718584,3578718591,7
2,775,8191,3578718584,3578718593,9
2,775,8192,3578718584,3578718595,11
2,775,8193,3578718584,3578718595,11
2,775,8194,3578718584,3578718595,11
2,775,8195,3578718584,3578718599,15
2,775,8196,3578718584,3578718599,15
2,775,8197,3578718584,3578718600,16
2,775,8198,3578718584,3578718602,18
2,775,8199,3578718584,3578718602,18
2,775,8200,3578718584,3578718606,22
2,775,8201,3578718584,3578718608,24
2,775,8202,3578718584,3578718609,25
2,775,8203,3578718584,3578718613,29
2,775,8204,3578718584,3578718617,33
2,775,8205,3578718584,3578718617,33
2,775,8206,3578718584,3578718619,35
2,775,8207,3578718584,3578718620,36
2,775,8208,3578718584,3578718620,36
2,775,8209,3578718584,3578718621,37
2,775,8210,3578718584,3578718623,39
2,775,8211,3578718584,3578718626,42
2,775,8212,3578718584,3578718626,42
2,775,8213,3578718584,3578718634,50
2,776,8214,3578718638,3578718638,0
2,776,8215,3578718638,3578718638,0
2,776,8216,3578718638,3578718638,0
2,776,8217,3578718638,3578718638,0
2,776,8218,3578718638,3578718640,2
2,776,8219,3578718638,3578718641,3
2,776,8220,3578718638,3578718641,3
2,776,8221,3578718638,3578718641,3
2,776,8222,3578718638,3578718642,4
2,776,8223,3578718638,3578718643,5
2,776,8224,3578718638,3578718646,8
2,776,8225,3578718638,3578718649,11
2,776,8226,3578718638,3578718650,12
2,776,8227,3578718638,3578718651,13
2,776,8228,3578718638,3578718652,14
2,776,8229,3578718638,3578718653,15
2,776,8230,3578718638,3578718655,17
2,776,8231,3578718638,3578718656,18
2,776,8232,3578718638,3578718659,21
2,776,8233,3578718638,3578718662,24
2,776,8234,3578718638,3578718664,26
2,776,8235,3578718638,3578718665,27
2,776,8236,3578718638,3578718666,28
2,776,8237,3578718638,3578718667,29
2,776,8238,3578718638,3578718669,31
2,776,8239,3578718638,3578718670,32
2,776,8240,3578718638,3578718676,38
2,776,8241,3578718638,3578718677,39
2,776,8242,3578718638,3578718678,40
2,776,8243,3578718638,3578718680,42
2,776,8244,3578718638,3578718681,43
2,776,8245,3578718638,3578718682,44
2,776,8246,3578718638,3578718682,44
2,776,8247,3578718638,3578718683,45
2,776,8248,3578718638,3578718684,46
2,776,8249,3578718638,3578718686,48
2,777,8250,3578718693,3578718693,0
2,777,8251,3578718693,3578718693,0
2,777,8252,3578718693,3578718693,0
2,777,8253,3578718693,3578718693,0
2,777,8254,3578718693,3578718694,1
2,777,8255,3578718693,3578718695,2
2,777,8256,3578718693,3578718695,2
2,777,8257,3578718693,3578718696,3
2,777,8258,3578718693,3578718698,5
2,777,8259,3578718693,3578718701,8
2,777,8260,3578718693,3578718702,9
2,777,8261,3578718693,3578718704,11
2,777,8262,3578718693,3578718707,14
2,777,8263,3578718693,3578718707,14
2,777,8264,3578718693,3578718708,15
2,777,8265,3578718693,3578718708,15
2,777,8266,3578718693,3578718709,16
2,777,8267,3578718693,3578718711,18
2,777,8268,3578718693,3578718711,18
2,777,8269,3578718693,3578718712,19
2,777,8270,3578718693,3578718712,19
2,777,8271,3578718693,3578718712,19
2,777,8272,3578718693,3578718713,20
2,777,8273,3578718693,3578718713,20
2,777,8274,3578718693,3578718714,21
2,777,8275,3578718693,3578718716,23
2,777,8276,3578718693,3578718717,24
2,777,8277,3578718693,3578718717,24
2,777,8278,3578718693,3578718718,25
2,777,8279,3578718693,3578718719,26
2,777,8280,3578718693,3578718721,28
2,777,8281,3578718693,3578718725,32
2,777,8282,3578718693,3578718728,35
2,777,8283,3578718693,3578718730,37
2,777,8284,3578718693,3578718731,38
2,777,8285,3578718693,3578718734,41
2,777,8286,3578718693,3578718734,41
2,777,8287,3578718693,3578718735,42
2,777,8288,3578718693,3578718737,44
2,777,8289,3578718693,3578718742,49
2,778,8290,3578718747,3578718749,2
2,778,8291,3578718747,3578718751,4
2,778,8292,3578718747,3578718751,4
2,778,8293,3578718747,3578718752,5
2,778,8294,3578718747,3578718753,6
2,778,8295,3578718747,3578718754,7
2,778,8296,3578718747,3578718755,8
2,778,8297,3578718747,3578718757,10
2,778,8298,3578718747,3578718762,15
2,778,8299,3578718747,3578718765,18
2,778,8300,3578718747,3578718766,19
2,778,8301,3578718747,3578718767,20
2,778,8302,3578718747,3578718767,20
2,778,8303,3578718747,3578718768,21
2,778,8304,3578718747,3578718769,22
2,778,8305,3578718747,3578718772,25
2,778,8306,3578718747,3578718776,29
2,778,8307,3578718747,3578718778,31
2,778,8308,3578718747,3578718782,35
2,778,8309,3578718747,3578718786,39
2,778,8310,3578718747,3578718788,41
2,778,8311,3578718747,3578718790,43
2,778,8312,3578718747,3578718790,43
2,778,8313,3578718747,3578718793,46
2,778,8314,3578718747,3578718794,47
2,778,8315,3578718747,3578718795,48
2,778,8316,3578718747,3578718796,49
2,778,8317,3578718747,3578718796,49
2,779,8318,3578718803,3578718803,0
2,779,8319,3578718803,3578718803,0
2,779,8320,3578718803,3578718803,0
2,779,8321,3578718803,3578718803,0
2,779,8322,3578718803,3578718803,0
2,779,8323,3578718803,3578718806,3
2,779,8324,3578718803,3578718808,5
2,779,8325,3578718803,3578718810,7
2,779,8326,3578718803,3578718814,11
2,779,8327,3578718803,3578718817,14
2,779,8328,3578718803,3578718817,14
2,779,8329,3578718803,3578718820,17
2,779,8330,3578718803,3578718820,17
2,779,8331,3578718803,3578718820,17
2,779,8332,3578718803,3578718822,19
2,779,8333,3578718803,3578718823,20
2,779,8334,3578718803,3578718826,23
2,779,8335,3578718803,3578718826,23
2,779,8336,3578718803,3578718829,26
2,779,8337,3578718803,3578718834,31
2,779,8338,3578718803,3578718836,33
2,779,8339,3578718803,3578718837,34
2,779,8340,3578718803,3578718837,34
2,779,8341,3578718803,3578718838,35
2,779,8342,3578718803,3578718840,37
2,779,8343,3578718803,3578718841,38
2,779,8344,3578718803,3578718841,38
2,779,8345,3578718803,3578718842,39
2,779,8346,3578718803,3578718843,40
2,779,8347,3578718803,3578718846,43
2,779,8348,3578718803,3578718847,44
2,779,8349,3578718803,3578718850,47
2,779,8350,3578718803,3578718850,47
2,780,8351,3578718858,3578718858,0
2,780,8352,3578718858,3578718858,0
2,780,8353,3578718858,3578718858,0
2,780,8354,3578718858,3578718858,0
2,780,8355,3578718858,3578718860,2
2,780,8356,3578718858,3578718862,4
2,780,8357,3578718858,3578718864,6
2,780,8358,3578718858,3578718865,7
2,780,8359,3578718858,3578718866,8
2,780,8360,3578718858,3578718867,9
2,780,8361,3578718858,3578718869,11
2,780,8362,3578718858,3578718869,11
2,780,8363,3578718858,3578718875,17
2,780,8364,3578718858,3578718877,19
2,780,8365,3578718858,3578718878,20
2,780,8366,3578718858,3578718880,22
2,780,8367,3578718858,3578718880,22
2,780,8368,3578718858,3578718881,23
2,780,8369,3578718858,3578718882,24
2,780,8370,3578718858,3578718883,25
2,780,8371,3578718858,3578718885,27
2,780,8372,3578718858,3578718885,27
2,780,8373,3578718858,3578718886,28
2,780,8374,3578718858,3578718890,32
2,780,8375,3578718858,3578718890,32
2,780,8376,3578718858,3578718891,33
2,780,8377,3578718858,3578718892,34
2,780,8378,3578718858,3578718893,35
2,780,8379,3578718858,3578718894,36
2,780,8380,3578718858,3578718895,37
2,780,8381,3578718858,3578718896,38
2,780,8382,3578718858,3578718896,38
2,780,8383,3578718858,3578718898,40
2,780,8384,3578718858,3578718901,43
2,780,8385,3578718858,3578718904,46
2,780,8386,3578718858,3578718907,49
2,780,8387,3578718858,3578718907,49
2,781,8388,3578718912,3578718912,0
2,781,8389,3578718912,3578718912,0
2,781,8390,3578718912,3578718912,0
2,781,8391,3578718912,3578718912,0
2,781,8392,3578718912,3578718912,0
2,781,8393,3578718912,3578718912,0
2,781,8394,3578718912,3578718912,0
2,781,8395,3578718912,3578718912,0
2,781,8396,3578718912,3578718913,1
2,781,8397,3578718912,3578718913,1
2,781,8398,3578718912,3578718913,1
2,781,8399,3578718912,3578718916,4
2,781,8400,3578718912,3578718917,5
2,781,8401,3578718912,3578718917,5
2,781,8402,3578718912,3578718918,6
2,781,8403,3578718912,3578718920,8
2,781,8404,3578718912,3578718922,10
2,781,8405,3578718912,3578718926,14
2,781,8406,3578718912,3578718927,15
2,781,8407,3578718912,3578718931,19
2,781,8408,3578718912,3578718934,22
2,781,8409,3578718912,3578718934,22
2,781,8410,3578718912,3578718936,24
2,781,8411,3578718912,3578718936,24
2,781,8412,3578718912,3578718943,31
2,781,8413,3578718912,3578718950,38
2,781,8414,3578718912,3578718951,39
2,781,8415,3578718912,3578718951,39
2,781,8416,3578718912,3578718952,40
2,781,8417,3578718912,3578718953,41
2,781,8418,3578718912,3578718954,42
2,781,8419,3578718912,3578718956,44
2,781,8420,3578718912,3578718958,46
2,782,8421,3578718967,3578718967,0
2,782,8422,3578718967,3578718967,0
2,782,8423,3578718967,3578718967,0
2,782,8424,3578718967,3578718967,0
2,782,8425,3578718967,3578718968,1
2,782,8426,3578718967,3578718968,1
2,782,8427,3578718967,3578718969,2
2,782,8428,3578718967,3578718971,4
2,782,8429,3578718967,3578718977,10
2,782,8430,3578718967,3578718978,11
2,782,8431,3578718967,3578718982,15
2,782,8432,3578718967,3578718984,17
2,782,8433,3578718967,3578718986,19
2,782,8434,3578718967,3578718986,19
2,782,8435,3578718967,3578718988,21
2,782,8436,3578718967,3578718990,23
2,782,8437,3578718967,3578718991,24
2,782,8438,3578718967,3578718993,26
2,782,8439,3578718967,3578718993,26
2,782,8440,3578718967,3578718995,28
2,782,8441,3578718967,3578718996,29
2,782,8442,3578718967,3578718999,32
2,782,8443,3578718967,3578719000,33
2,782,8444,3578718967,3578719000,33
2,782,8445,3578718967,3578719002,35
2,782,8446,3578718967,3578719002,35
2,782,8447,3578718967,3578719006,39
2,782,8448,3578718967,3578719008,41
2,782,8449,3578718967,3578719010,43
2,782,8450,3578718967,3578719013,46
2,782,8451,3578718967,3578719013,46
2,782,8452,3578718967,3578719017,50
2,783,8453,3578719022,3578719022,0
2,783,8454,3578719022,3578719022,0
2,783,8455,3578719022,3578719022,0
2,783,8456,3578719022,3578719022,0
2,783,8457,3578719022,3578719022,0
2,783,8458,3578719022,3578719024,2
2,783,8459,3578719022,3578719026,4
2,783,8460,3578719022,3578719027,5
2,783,8461,3578719022,3578719029,7
2,783,8462,3578719022,3578719034,12
2,783,8463,3578719022,3578719034,12
2,783,8464,3578719022,3578719037,15
2,783,8465,3578719022,3578719037,15
2,783,8466,3578719022,3578719038,16
2,783,8467,3578719022,3578719038,16
2,783,8468,3578719022,3578719041,19
2,783,8469,3578719022,3578719041,19
2,783,8470,3578719022,3578719042,20
2,783,8471,3578719022,3578719043,21
2,783,8472,3578719022,3578719047,25
2,783,8473,3578719022,3578719047,25
2,783,8474,3578719022,3578719050,28
2,783,8475,3578719022,3578719050,28
2,783,8476,3578719022,3578719054,32
2,783,8477,3578719022,3578719054,32
2,783,8478,3578719022,3578719055,33
2,783,8479,3578719022,3578719057,35
2,783,8480,3578719022,3578719060,38
2,783,8481,3578719022,3578719063,41
2,783,8482,3578719022,3578719065,43
2,783,8483,3578719022,3578719065,43
2,783,8484,3578719022,3578719067,45
2,783,8485,3578719022,3578719068,46
2,783,8486,3578719022,3578719069,47
2,784,8487,3578719077,3578719077,0
2,784,8488,3578719077,3578719079,2
2,784,8489,3578719077,3578719079,2
2,784,8490,3578719077,3578719079,2
2,784,8491,3578719077,3578719081,4
2,784,8492,3578719077,3578719081,4
2,784,8493,3578719077,3578719082,5
2,784,8494,3578719077,3578719082,5
2,784,8495,3578719077,3578719084,7
2,784,8496,3578719077,3578719085,8
2,784,8497,3578719077,3578719085,8
2,784,8498,3578719077,3578719086,9
2,784,8499,3578719077,3578719090,13
2,784,8500,3578719077,3578719091,14
2,784,8501,3578719077,3578719091,14
2,784,8502,3578719077,3578719091,14
2,784,8503,3578719077,3578719093,16
2,784,8504,3578719077,3578719095,18
2,784,8505,3578719077,3578719095,18
2,784,8506,3578719077,3578719096,19
2,784,8507,3578719077,3578719099,22
2,784,8508,3578719077,3578719101,24
2,784,8509,3578719077,3578719102,25
2,784,8510,3578719077,3578719104,27
2,784,8511,3578719077,3578719107,30
2,784,8512,3578719077,3578719107,30
2,784,8513,3578719077,3578719108,31
2,784,8514,3578719077,3578719108,31
2,784,8515,3578719077,3578719109,32
2,784,8516,3578719077,3578719111,34
2,784,8517,3578719077,3578719111,34
2,784,8518,3578719077,3578719112,35
2,784,8519,3578719077,3578719112,35
2,784,8520,3578719077,3578719113,36
2,784,8521,3578719077,3578719113,36
2,784,8522,3578719077,3578719114,37
2,784,8523,3578719077,3578719114,37
2,784,8524,3578719077,3578719116,39
2,784,8525,3578719077,3578719116,39
2,784,8526,3578719077,3578719117,40
2,784,8527,3578719077,3578719118,41
2,784,8528,3578719077,3578719119,42
2,784,8529,3578719077,3578719122,45
2,784,8530,3578719077,3578719125,48
2,785,8531,3578719131,3578719131,0
2,785,8532,3578719131,3578719132,1
2,785,8533,3578719131,3578719134,3
2,785,8534,3578719131,3578719135,4
2,785,8535,3578719131,3578719135,4
2,785,8536,3578719131,3578719136,5
2,785,8537,3578719131,3578719138,7
2,785,8538,3578719131,3578719143,12
2,785,8539,3578719131,3578719150,19
2,785,8540,3578719131,3578719151,20
2,785,8541,3578719131,3578719153,22
2,785,8542,3578719131,3578719154,23
2,785,8543,3578719131,3578719154,23
2,785,8544,3578719131,3578719155,24
2,785,8545,3578719131,3578719157,26
2,785,8546,3578719131,3578719159,28
2,785,8547,3578719131,3578719163,32
2,785,8548,3578719131,3578719166,35
2,785,8549,3578719131,3578719166,35
2,785,8550,3578719131,3578719167,36
2,785,8551,3578719131,3578719167,36
2,785,8552,3578719131,3578719168,37
2,785,8553,3578719131,3578719169,38
2,785,8554,3578719131,3578719173,42
2,785,8555,3578719131,3578719176,45
2,785,8556,3578719131,3578719177,46
2,785,8557,3578719131,3578719178,47
2,786,8558,3578719186,3578719186,0
2,786,8559,3578719186,3578719186,0
2,786,8560,3578719186,3578719186,0
2,786,8561,3578719186,3578719189,3
2,786,8562,3578719186,3578719191,5
2,786,8563,3578719186,3578719191,5
2,786,8564,3578719186,3578719193,7
2,786,8565,3578719186,3578719194,8
2,786,8566,3578719186,3578719196,10
2,786,8567,3578719186,3578719196,10
2,786,8568,3578719186,3578719200,14
2,786,8569,3578719186,3578719200,14
2,786,8570,3578719186,3578719200,14
2,786,8571,3578719186,3578719203,17
2,786,8572,3578719186,3578719204,18
2,786,8573,3578719186,3578719206,20
2,786,8574,3578719186,3578719208,22
2,786,8575,3578719186,3578719210,24
2,786,8576,3578719186,3578719213,27
2,786,8577,3578719186,3578719214,28
2,786,8578,3578719186,3578719217,31
2,786,8579,3578719186,3578719218,32
2,786,8580,3578719186,3578719219,33
2,786,8581,3578719186,3578719220,34
2,786,8582,3578719186,3578719222,36
2,786,8583,3578719186,3578719224,38
2,786,8584,3578719186,3578719227,41
2,786,8585,3578719186,3578719227,41
2,786,8586,3578719186,3578719229,43
2,786,8587,3578719186,3578719234,48
2,786,8588,3578719186,3578719234,48
2,787,8589,3578719240,3578719240,0
2,787,8590,3578719240,3578719240,0
2,787,8591,3578719240,3578719240,0
2,787,8592,3578719240,3578719240,0
2,787,8593,3578719240,3578719240,0
2,787,8594,3578719240,3578719240,0
2,787,8595,3578719240,3578719242,2
2,787,8596,3578719240,3578719242,2
2,787,8597,3578719240,3578719242,2
2,787,8598,3578719240,3578719242,2
2,787,8599,3578719240,3578719243,3
2,787,8600,3578719240,3578719247,7
2,787,8601,3578719240,3578719249,9
2,787,8602,3578719240,3578719251,11
2,787,8603,3578719240,3578719252,12
2,787,8604,3578719240,3578719254,14
2,787,8605,3578719240,3578719255,15
2,787,8606,3578719240,3578719255,15
2,787,8607,3578719240,3578719257,17
2,787,8608,3578719240,3578719260,20
2,787,8609,3578719240,3578719263,23
2,787,8610,3578719240,3578719264,24
2,787,8611,3578719240,3578719265,25
2,787,8612,3578719240,3578719267,27
2,787,8613,3578719240,3578719268,28
2,787,8614,3578719240,3578719269,29
2,787,8615,3578719240,3578719269,29
2,787,8616,3578719240,3578719276,36
2,787,8617,3578719240,3578719278,38
2,787,8618,3578719240,3578719280,40
2,787,8619,3578719240,3578719280,40
2,787,8620,3578719240,3578719281,41
2,787,8621,3578719240,3578719283,43
2,787,8622,3578719240,3578719283,43
2,787,8623,3578719240,3578719284,44
2,787,8624,3578719240,3578719284,44
2,787,8625,3578719240,3578719285,45
2,787,8626,3578719240,3578719286,46
2,788,8627,3578719294,3578719294,0
2,788,8628,3578719294,3578719294,0
2,788,8629,3578719294,3578719294,0
2,788,8630,3578719294,3578719295,1
2,788,8631,3578719294,3578719295,1
2,788,8632,3578719294,3578719295,1
2,788,8633,3578719294,3578719296,2
2,788,8634,3578719294,3578719299,5
2,788,8635,3578719294,3578719301,7
2,788,8636,3578719294,3578719302,8
2,788,8637,3578719294,3578719306,12
2,788,8638,3578719294,3578719307,13
2,788,8639,3578719294,3578719308,14
2,788,8640,3578719294,3578719309,15
2,788,8641,3578719294,3578719309,15
2,788,8642,3578719294,3578719310,16
2,788,8643,3578719294,3578719311,17
2,788,8644,3578719294,3578719311,17
2,788,8645,3578719294,3578719313,19
2,788,8646,3578719294,3578719313,19
2,788,8647,3578719294,3578719313,19
2,788,8648,3578719294,3578719313,19
2,788,8649,3578719294,3578719313,19
2,788,8650,3578719294,3578719316,22
2,788,8651,3578719294,3578719316,22
2,788,8652,3578719294,3578719317,23
2,788,8653,3578719294,3578719318,24
2,788,8654,3578719294,3578719320,26
2,788,8655,3578719294,3578719322,28
2,788,8656,3578719294,3578719323,29
2,788,8657,3578719294,3578719325,31
2,788,8658,3578719294,3578719327,33
2,788,8659,3578719294,3578719331,37
2,788,8660,3578719294,3578719332,38
2,788,8661,3578719294,3578719334,40
2,788,8662,3578719294,3578719335,41
2,788,8663,3578719294,3578719335,41
2,788,8664,3578719294,3578719336,42
2,788,8665,3578719294,3578719338,44
2,788,8666,3578719294,3578719339,45
2,788,8667,3578719294,3578719343,49
2,789,8668,3578719349,3578719351,2
2,789,8669,3578719349,3578719351,2
2,789,8670,3578719349,3578719352,3
2,789,8671,3578719349,3578719354,5
2,789,8672,3578719349,3578719355,6
2,789,8673,3578719349,3578719355,6
2,789,8674,3578719349,3578719357,8
2,789,8675,3578719349,3578719360,11
2,789,8676,3578719349,3578719363,14
2,789,8677,3578719349,3578719365,16
2,789,8678,3578719349,3578719367,18
2,789,8679,3578719349,3578719368,19
2,789,8680,3578719349,3578719368,19
2,789,8681,3578719349,3578719368,19
2,789,8682,3578719349,3578719369,20
2,789,8683,3578719349,3578719373,24
2,789,8684,3578719349,3578719376,27
2,789,8685,3578719349,3578719376,27
2,789,8686,3578719349,3578719378,29
2,789,8687,3578719349,3578719381,32
2,789,8688,3578719349,3578719385,36
2,789,8689,3578719349,3578719386,37
2,789,8690,3578719349,3578719386,37
2,789,8691,3578719349,3578719389,40
2,789,8692,3578719349,3578719390,41
2,789,8693,3578719349,3578719392,43
2,789,8694,3578719349,3578719394,45
2,789,8695,3578719349,3578719394,45
2,789,8696,3578719349,3578719395,46
2,789,8697,3578719349,3578719396,47
2,790,8698,3578719405,3578719405,0
2,790,8699,3578719405,3578719405,0
2,790,8700,3578719405,3578719405,0
2,790,8701,3578719405,3578719405,0
2,790,8702,3578719405,3578719405,0
2,790,8703,3578719405,3578719407,2
2,790,8704,3578719405,3578719410,5
2,790,8705,3578719405,3578719413,8
2,790,8706,3578719405,3578719414,9
2,790,8707,3578719405,3578719417,12
2,790,8708,3578719405,3578719418,13
2,790,8709,3578719405,3578719419,14
2,790,8710,3578719405,3578719420,15
2,790,8711,3578719405,3578719421,16
2,790,8712,3578719405,3578719422,17
2,790,8713,3578719405,3578719427,22
2,790,8714,3578719405,3578719427,22
2,790,8715,3578719405,3578719429,24
2,790,8716,3578719405,3578719430,25
2,790,8717,3578719405,3578719434,29
2,790,8718,3578719405,3578719434,29
2,790,8719,3578719405,3578719437,32
2,790,8720,3578719405,3578719438,33
2,790,8721,3578719405,3578719439,34
2,790,8722,3578719405,3578719440,35
2,790,8723,3578719405,3578719441,36
2,790,8724,3578719405,3578719442,37
2,790,8725,3578719405,3578719442,37
2,790,8726,3578719405,3578719443,38
2,790,8727,3578719405,3578719443,38
2,790,8728,3578719405,3578719447,42
2,790,8729,3578719405,3578719448,43
2,790,8730,3578719405,3578719449,44
2,790,8731,3578719405,3578719452,47
2,790,8732,3578719405,3578719452,47
2,790,8733,3578719405,3578719454,49
2,790,8734,3578719405,3578719455,50
2,791,8735,3578719462,3578719462,0
2,791,8736,3578719462,3578719462,0
2,791,8737,3578719462,3578719462,0
2,791,8738,3578719462,3578719463,1
2,791,8739,3578719462,3578719465,3
2,791,8740,3578719462,3578719466,4
2,791,8741,3578719462,3578719467,5
2,791,8742,3578719462,3578719468,6
2,791,8743,3578719462,3578719469,7
2,791,8744,3578719462,3578719470,8
2,791,8745,3578719462,3578719476,14
2,791,8746,3578719462,3578719479,17
2,791,8747,3578719462,3578719479,17
2,791,8748,3578719462,3578719479,17
2,791,8749,3578719462,3578719481,19
2,791,8750,3578719462,3578719483,21
2,791,8751,3578719462,3578719484,22
2,791,8752,3578719462,3578719484,22
2,791,8753,3578719462,3578719485,23
2,791,8754,3578719462,3578719486,24
2,791,8755,3578719462,3578719491,29
2,791,8756,3578719462,3578719492,30
2,791,8757,3578719462,3578719492,30
2,791,8758,3578719462,3578719492,30
2,791,8759,3578719462,3578719494,32
2,791,8760,3578719462,3578719494,32
2,791,8761,3578719462,3578719495,33
2,791,8762,3578719462,3578719496,34
2,791,8763,3578719462,3578719496,34
2,791,8764,3578719462,3578719498,36
2,791,8765,3578719462,3578719500,38
2,791,8766,3578719462,3578719501,39
2,791,8767,3578719462,3578719502,40
2,791,8768,3578719462,3578719505,43
2,791,8769,3578719462,3578719507,45
2,791,8770,3578719462,3578719507,45
2,791,8771,3578719462,3578719508,46
2,791,8772,3578719462,3578719508,46
2,791,8773,3578719462,3578719509,47
2,791,8774,3578719462,3578719511,49
2,791,8775,3578719462,3578719511,49
2,791,8776,3578719462,3578719512,50
2,792,8777,3578719518,3578719518,0
2,792,8778,3578719518,3578719518,0
2,792,8779,3578719518,3578719518,0
2,792,8780,3578719518,3578719518,0
2,792,8781,3578719518,3578719518,0
2,792,8782,3578719518,3578719518,0
2,792,8783,3578719518,3578719518,0
2,792,8784,3578719518,3578719518,0
2,792,8785,3578719518,3578719518,0
2,792,8786,3578719518,3578719518,0
2,792,8787,3578719518,3578719521,3
2,792,8788,3578719518,3578719522,4
2,792,8789,3578719518,3578719524,6
2,792,8790,3578719518,3578719526,8
2,792,8791,3578719518,3578719531,13
2,792,8792,3578719518,3578719532,14
2,792,8793,3578719518,3578719533,15
2,792,8794,3578719518,3578719534,16
2,792,8795,3578719518,3578719535,17
2,792,8796,3578719518,3578719535,17
2,792,8797,3578719518,3578719535,17
2,792,8798,3578719518,3578719537,19
2,792,8799,3578719518,3578719538,20
2,792,8800,3578719518,3578719543,25
2,792,8801,3578719518,3578719550,32
2,792,8802,3578719518,3578719550,32
2,792,8803,3578719518,3578719551,33
2,792,8804,3578719518,3578719552,34
2,792,8805,3578719518,3578719553,35
2,792,8806,3578719518,3578719554,36
2,792,8807,3578719518,3578719555,37
2,792,8808,3578719518,3578719557,39
2,792,8809,3578719518,3578719559,41
2,792,8810,3578719518,3578719562,44
2,792,8811,3578719518,3578719565,47
2,792,8812,3578719518,3578719565,47
2,792,8813,3578719518,3578719567,49
2,792,8814,3578719518,3578719568,50
2,793,8815,3578719572,3578719572,0
2,793,8816,3578719572,3578719572,0
2,793,8817,3578719572,3578719575,3
2,793,8818,3578719572,3578719576,4
2,793,8819,3578719572,3578719577,5
2,793,8820,3578719572,3578719580,8
2,793,8821,3578719572,3578719584,12
2,793,8822,3578719572,3578719585,13
2,793,8823,3578719572,3578719588,16
2,793,8824,3578719572,3578719590,18
2,793,8825,3578719572,3578719590,18
2,793,8826,3578719572,3578719593,21
2,793,8827,3578719572,3578719594,22
2,793,8828,3578719572,3578719594,22
2,793,8829,3578719572,3578719596,24
2,793,8830,3578719572,3578719599,27
2,793,8831,3578719572,3578719601,29
2,793,8832,3578719572,3578719602,30
2,793,8833,3578719572,3578719602,30
2,793,8834,3578719572,3578719606,34
2,793,8835,3578719572,3578719609,37
2,793,8836,3578719572,3578719610,38
2,793,8837,3578719572,3578719612,40
2,793,8838,3578719572,3578719613,41
2,793,8839,3578719572,3578719615,43
2,793,8840,3578719572,3578719617,45
2,793,8841,3578719572,3578719618,46
2,793,8842,3578719572,3578719619,47
2,793,8843,3578719572,3578719621,49
2,793,8844,3578719572,3578719622,50
2,794,8845,3578719628,3578719628,0
2,794,8846,3578719628,3578719628,0
2,794,8847,3578719628,3578719628,0
2,794,8848,3578719628,3578719629,1
2,794,8849,3578719628,3578719632,4
2,794,8850,3578719628,3578719634,6
2,794,8851,3578719628,3578719636,8
2,794,8852,3578719628,3578719637,9
2,794,8853,3578719628,3578719638,10
2,794,8854,3578719628,3578719639,11
2,794,8855,3578719628,3578719640,12
2,794,8856,3578719628,3578719641,13
2,794,8857,3578719628,3578719642,14
2,794,8858,3578719628,3578719642,14
2,794,8859,3578719628,3578719643,15
2,794,8860,3578719628,3578719646,18
2,794,8861,3578719628,3578719647,19
2,794,8862,3578719628,3578719649,21
2,794,8863,3578719628,3578719651,23
2,794,8864,3578719628,3578719652,24
2,794,8865,3578719628,3578719653,25
2,794,8866,3578719628,3578719654,26
2,794,8867,3578719628,3578719655,27
2,794,8868,3578719628,3578719656,28
2,794,8869,3578719628,3578719659,31
2,794,8870,3578719628,3578719663,35
2,794,8871,3578719628,3578719664,36
2,794,8872,3578719628,3578719666,38
2,794,8873,3578719628,3578719666,38
2,794,8874,3578719628,3578719666,38
2,794,8875,3578719628,3578719668,40
2,794,8876,3578719628,3578719669,41
2,794,8877,3578719628,3578719676,48
2,794,8878,3578719628,3578719679,51
2,795,8879,3578719684,3578719684,0
2,795,8880,3578719684,3578719684,0
2,795,8881,3578719684,3578719684,0
2,795,8882,3578719684,3578719684,0
2,795,8883,3578719684,3578719684,0
2,795,8884,3578719684,3578719684,0
2,795,8885,3578719684,3578719685,1
2,795,8886,3578719684,3578719687,3
2,795,8887,3578719684,3578719691,7
2,795,8888,3578719684,3578719691,7
2,795,8889,3578719684,3578719692,8
2,795,8890,3578719684,3578719692,8
2,795,8891,3578719684,3578719693,9
2,795,8892,3578719684,3578719694,10
2,795,8893,3578719684,3578719695,11
2,795,8894,3578719684,3578719696,12
2,795,8895,3578719684,3578719697,13
2,795,8896,3578719684,3578719698,14
2,795,8897,3578719684,3578719700,16
2,795,8898,3578719684,3578719701,17
2,795,8899,3578719684,3578719701,17
2,795,8900,3578719684,3578719701,17
2,795,8901,3578719684,3578719705,21
2,795,8902,3578719684,3578719706,22
2,795,8903,3578719684,3578719707,23
2,795,8904,3578719684,3578719708,24
2,795,8905,3578719684,3578719708,24
2,795,8906,3578719684,3578719710,26
2,795,8907,3578719684,3578719710,26
2,795,8908,3578719684,3578719711,27
2,795,8909,3578719684,3578719712,28
2,795,8910,3578719684,3578719712,28
2,795,8911,3578719684,3578719712,28
2,795,8912,3578719684,3578719713,29
2,795,8913,3578719684,3578719714,30
2,795,8914,3578719684,3578719714,30
2,795,8915,3578719684,3578719716,32
2,795,8916,3578719684,3578719716,32
2,795,8917,3578719684,3578719716,32
2,795,8918,3578719684,3578719717,33
2,795,8919,3578719684,3578719718,34
2,795,8920,3578719684,3578719722,38
2,795,8921,3578719684,3578719722,38
2,795,8922,3578719684,3578719724,40
2,795,8923,3578719684,3578719727,43
2,795,8924,3578719684,3578719731,47
2,795,8925,3578719684,3578719732,48
2,795,8926,3578719684,3578719733,49
2,795,8927,3578719684,3578719734,50
2,796,8928,3578719738,3578719738,0
2,796,8929,3578719738,3578719738,0
2,796,8930,3578719738,3578719738,0
2,796,8931,3578719738,3578719738,0
2,796,8932,3578719738,3578719738,0
2,796,8933,3578719738,3578719742,4
2,796,8934,3578719738,3578719750,12
2,796,8935,3578719738,3578719750,12
2,796,8936,3578719738,3578719751,13
2,796,8937,3578719738,3578719751,13
2,796,8938,3578719738,3578719753,15
2,796,8939,3578719738,3578719755,17
2,796,8940,3578719738,3578719755,17
2,796,8941,3578719738,3578719756,18
2,796,8942,3578719738,3578719759,21
2,796,8943,3578719738,3578719762,24
2,796,8944,3578719738,3578719765,27
2,796,8945,3578719738,3578719766,28
2,796,8946,3578719738,3578719767,29
2,796,8947,3578719738,3578719767,29
2,796,8948,3578719738,3578719767,29
2,796,8949,3578719738,3578719768,30
2,796,8950,3578719738,3578719771,33
2,796,8951,3578719738,3578719775,37
2,796,8952,3578719738,3578719776,38
2,796,8953,3578719738,3578719778,40
2,796,8954,3578719738,3578719780,42
2,796,8955,3578719738,3578719785,47
2,796,8956,3578719738,3578719785,47
2,796,8957,3578719738,3578719786,48
2,796,8958,3578719738,3578719788,50
2,797,8959,3578719793,3578719793,0
2,797,8960,3578719793,3578719793,0
2,797,8961,3578719793,3578719793,0
2,797,8962,3578719793,3578719794,1
2,797,8963,3578719793,3578719795,2
2,797,8964,3578719793,3578719796,3
2,797,8965,3578719793,3578719798,5
2,797,8966,3578719793,3578719799,6
2,797,8967,3578719793,3578719802,9
2,797,8968,3578719793,3578719802,9
2,797,8969,3578719793,3578719807,14
2,797,8970,3578719793,3578719809,16
2,797,8971,3578719793,3578719810,17
2,797,8972,3578719793,3578719811,18
2,797,8973,3578719793,3578719812,19
2,797,8974,3578719793,3578719813,20
2,797,8975,3578719793,3578719816,23
2,797,8976,3578719793,3578719818,25
2,797,8977,3578719793,3578719819,26
2,797,8978,3578719793,3578719819,26
2,797,8979,3578719793,3578719820,27
2,797,8980,3578719793,3578719822,29
2,797,8981,3578719793,3578719824,31
2,797,8982,3578719793,3578719827,34
2,797,8983,3578719793,3578719827,34
2,797,8984,3578719793,3578719828,35
2,797,8985,3578719793,3578719829,36
2,797,8986,3578719793,3578719833,40
2,797,8987,3578719793,3578719834,41
2,797,8988,3578719793,3578719836,43
2,797,8989,3578719793,3578719836,43
2,797,8990,3578719793,3578719838,45
2,797,8991,3578719793,3578719840,47
2,797,8992,3578719793,3578719841,48
2,797,8993,3578719793,3578719841,48
2,797,8994,3578719793,3578719842,49
2,798,8995,3578719847,3578719847,0
2,798,8996,3578719847,3578719847,0
2,798,8997,3578719847,3578719847,0
2,798,8998,3578719847,3578719848,1
2,798,8999,3578719847,3578719851,4
2,798,9000,3578719847,3578719851,4
2,798,9001,3578719847,3578719853,6
2,798,9002,3578719847,3578719854,7
2,798,9003,3578719847,3578719855,8
2,798,9004,3578719847,3578719857,10
2,798,9005,3578719847,3578719860,13
2,798,9006,3578719847,3578719863,16
2,798,9007,3578719847,3578719865,18
2,798,9008,3578719847,3578719866,19
2,798,9009,3578719847,3578719867,20
2,798,9010,3578719847,3578719867,20
2,798,9011,3578719847,3578719869,22
2,798,9012,3578719847,3578719876,29
2,798,9013,3578719847,3578719878,31
2,798,9014,3578719847,3578719880,33
2,798,9015,3578719847,3578719881,34
2,798,9016,3578719847,3578719881,34
2,798,9017,3578719847,3578719883,36
2,798,9018,3578719847,3578719883,36
2,798,9019,3578719847,3578719885,38
2,798,9020,3578719847,3578719885,38
2,798,9021,3578719847,3578719887,40
2,798,9022,3578719847,3578719892,45
2,798,9023,3578719847,3578719892,45
2,798,9024,3578719847,3578719892,45
2,798,9025,3578719847,3578719894,47
2,798,9026,3578719847,3578719896,49
2,798,9027,3578719847,3578719896,49
2,798,9028,3578719847,3578719897,50
2,799,9029,3578719901,3578719901,0
2,799,9030,3578719901,3578719901,0
2,799,9031,3578719901,3578719901,0
2,799,9032,3578719901,3578719901,0
2,799,9033,3578719901,3578719902,1
2,799,9034,3578719901,3578719905,4
2,799,9035,3578719901,3578719906,5
2,799,9036,3578719901,3578719907,6
2,799,9037,3578719901,3578719907,6
2,799,9038,3578719901,3578719908,7
2,799,9039,3578719901,3578719910,9
2,799,9040,3578719901,3578719910,9
2,799,9041,3578719901,3578719911,10
2,799,9042,3578719901,3578719912,11
2,799,9043,3578719901,3578719913,12
2,799,9044,3578719901,3578719913,12
2,799,9045,3578719901,3578719913,12
2,799,9046,3578719901,3578719913,12
2,799,9047,3578719901,3578719914,13
2,799,9048,3578719901,3578719916,15
2,799,9049,3578719901,3578719917,16
2,799,9050,3578719901,3578719917,16
2,799,9051,3578719901,3578719917,16
2,799,9052,3578719901,3578719919,18
2,799,9053,3578719901,3578719921,20
2,799,9054,3578719901,3578719926,25
2,799,9055,3578719901,3578719928,27
2,799,9056,3578719901,3578719931,30
2,799,9057,3578719901,3578719932,31
2,799,9058,3578719901,3578719933,32
2,799,9059,3578719901,3578719934,33
2,799,9060,3578719901,3578719935,34
2,799,9061,3578719901,3578719935,34
2,799,9062,3578719901,3578719937,36
2,799,9063,3578719901,3578719937,36
2,799,9064,3578719901,3578719938,37
2,799,9065,3578719901,3578719942,41
2,799,9066,3578719901,3578719951,50
2,800,9067,3578719956,3578719956,0
2,800,9068,3578719956,3578719956,0
2,800,9069,3578719956,3578719956,0
2,800,9070,3578719956,3578719956,0
2,800,9071,3578719956,3578719956,0
2,800,9072,3578719956,3578719956,0
2,800,9073,3578719956,3578719963,7
2,800,9074,3578719956,3578719965,9
2,800,9075,3578719956,3578719966,10
2,800,9076,3578719956,3578719966,10
2,800,9077,3578719956,3578719967,11
2,800,9078,3578719956,3578719968,12
2,800,9079,3578719956,3578719968,12
2,800,9080,3578719956,3578719972,16
2,800,9081,3578719956,3578719976,20
2,800,9082,3578719956,3578719976,20
2,800,9083,3578719956,3578719979,23
2,800,9084,3578719956,3578719980,24
2,800,9085,3578719956,3578719985,29
2,800,9086,3578719956,3578719986,30
2,800,9087,3578719956,3578719988,32
2,800,9088,3578719956,3578719990,34
2,800,9089,3578719956,3578719991,35
2,800,9090,3578719956,3578719993,37
2,800,9091,3578719956,3578719995,39
2,800,9092,3578719956,3578719997,41
2,800,9093,3578719956,3578719999,43
2,800,9094,3578719956,3578720000,44
2,800,9095,3578719956,3578720001,45
2,800,9096,3578719956,3578720002,46
2,800,9097,3578719956,3578720002,46
2,801,9098,3578720010,3578720010,0
2,801,9099,3578720010,3578720010,0
2,801,9100,3578720010,3578720010,0
2,801,9101,3578720010,3578720011,1
2,801,9102,3578720010,3578720013,3
2,801,9103,3578720010,3578720013,3
2,801,9104,3578720010,3578720014,4
2,801,9105,3578720010,3578720016,6
2,801,9106,3578720010,3578720019,9
2,801,9107,3578720010,3578720019,9
2,801,9108,3578720010,3578720019,9
2,801,9109,3578720010,3578720020,10
2,801,9110,3578720010,3578720022,12
2,801,9111,3578720010,3578720024,14
2,801,9112,3578720010,3578720027,17
2,801,9113,3578720010,3578720027,17
2,801,9114,3578720010,3578720028,18
2,801,9115,3578720010,3578720028,18
2,801,9116,3578720010,3578720033,23
2,801,9117,3578720010,3578720034,24
2,801,9118,3578720010,3578720036,26
2,801,9119,3578720010,3578720036,26
2,801,9120,3578720010,3578720037,27
2,801,9121,3578720010,3578720039,29
2,801,9122,3578720010,3578720040,30
2,801,9123,3578720010,3578720041,31
2,801,9124,3578720010,3578720042,32
2,801,9125,3578720010,3578720042,32
2,801,9126,3578720010,3578720042,32
2,801,9127,3578720010,3578720043,33
2,801,9128,3578720010,3578720046,36
2,801,9129,3578720010,3578720049,39
2,801,9130,3578720010,3578720050,40
2,801,9131,3578720010,3578720051,41
2,801,9132,3578720010,3578720053,43
2,801,9133,3578720010,3578720054,44
2,801,9134,3578720010,3578720055,45
2,801,9135,3578720010,3578720057,47
2,802,9136,3578720065,3578720065,0
2,802,9137,3578720065,3578720065,0
2,802,9138,3578720065,3578720065,0
2,802,9139,3578720065,3578720066,1
2,802,9140,3578720065,3578720066,1
2,802,9141,3578720065,3578720068,3
2,802,9142,3578720065,3578720069,4
2,802,9143,3578720065,3578720070,5
2,802,9144,3578720065,3578720076,11
2,802,9145,3578720065,3578720079,14
2,802,9146,3578720065,3578720079,14
2,802,9147,3578720065,3578720081,16
2,802,9148,3578720065,3578720081,16
2,802,9149,3578720065,3578720081,16
2,802,9150,3578720065,3578720083,18
2,802,9151,3578720065,3578720084,19
2,802,9152,3578720065,3578720084,19
2,802,9153,3578720065,3578720085,20
2,802,9154,3578720065,3578720085,20
2,802,9155,3578720065,3578720087,22
2,802,9156,3578720065,3578720091,26
2,802,9157,3578720065,3578720092,27
2,802,9158,3578720065,3578720092,27
2,802,9159,3578720065,3578720092,27
2,802,9160,3578720065,3578720094,29
2,802,9161,3578720065,3578720094,29
2,802,9162,3578720065,3578720095,30
2,802,9163,3578720065,3578720096,31
2,802,9164,3578720065,3578720096,31
2,802,9165,3578720065,3578720099,34
2,802,9166,3578720065,3578720100,35
2,802,9167,3578720065,3578720100,35
2,802,9168,3578720065,3578720101,36
2,802,9169,3578720065,3578720102,37
2,802,9170,3578720065,3578720105,40
2,802,9171,3578720065,3578720107,42
2,802,9172,3578720065,3578720107,42
2,802,9173,3578720065,3578720108,43
2,802,9174,3578720065,3578720108,43
2,802,9175,3578720065,3578720109,44
2,802,9176,3578720065,3578720111,46
2,802,9177,3578720065,3578720111,46
2,802,9178,3578720065,3578720112,47
2,802,9179,3578720065,3578720113,48
2,802,9180,3578720065,3578720113,48
2,802,9181,3578720065,3578720114,49
2,802,9182,3578720065,3578720114,49
2,802,9183,3578720065,3578720114,49
2,803,9184,3578720121,3578720121,0
2,803,9185,3578720121,3578720121,0
2,803,9186,3578720121,3578720121,0
2,803,9187,3578720121,3578720121,0
2,803,9188,3578720121,3578720121,0
2,803,9189,3578720121,3578720122,1
2,803,9190,3578720121,3578720125,4
2,803,9191,3578720121,3578720127,6
2,803,9192,3578720121,3578720131,10
2,803,9193,3578720121,3578720132,11
2,803,9194,3578720121,3578720133,12
2,803,9195,3578720121,3578720134,13
2,803,9196,3578720121,3578720135,14
2,803,9197,3578720121,3578720135,14
2,803,9198,3578720121,3578720137,16
2,803,9199,3578720121,3578720138,17
2,803,9200,3578720121,3578720138,17
2,803,9201,3578720121,3578720144,23
2,803,9202,3578720121,3578720150,29
2,803,9203,3578720121,3578720151,30
2,803,9204,3578720121,3578720152,31
2,803,9205,3578720121,3578720152,31
2,803,9206,3578720121,3578720154,33
2,803,9207,3578720121,3578720154,33
2,803,9208,3578720121,3578720155,34
2,803,9209,3578720121,3578720157,36
2,803,9210,3578720121,3578720163,42
2,803,9211,3578720121,3578720165,44
2,803,9212,3578720121,3578720166,45
2,803,9213,3578720121,3578720166,45
2,803,9214,3578720121,3578720167,46
2,803,9215,3578720121,3578720167,46
2,803,9216,3578720121,3578720167,46
2,803,9217,3578720121,3578720169,48
2,804,9218,3578720176,3578720176,0
2,804,9219,3578720176,3578720176,0
2,804,9220,3578720176,3578720176,0
2,804,9221,3578720176,3578720179,3
2,804,9222,3578720176,3578720181,5
2,804,9223,3578720176,3578720185,9
2,804,9224,3578720176,3578720186,10
2,804,9225,3578720176,3578720186,10
2,804,9226,3578720176,3578720189,13
2,804,9227,3578720176,3578720190,14
2,804,9228,3578720176,3578720191,15
2,804,9229,3578720176,3578720194,18
2,804,9230,3578720176,3578720196,20
2,804,9231,3578720176,3578720198,22
2,804,9232,3578720176,3578720200,24
2,804,9233,3578720176,3578720201,25
2,804,9234,3578720176,3578720203,27
2,804,9235,3578720176,3578720204,28
2,804,9236,3578720176,3578720206,30
2,804,9237,3578720176,3578720209,33
2,804,9238,3578720176,3578720211,35
2,804,9239,3578720176,3578720211,35
2,804,9240,3578720176,3578720213,37
2,804,9241,3578720176,3578720213,37
2,804,9242,3578720176,3578720214,38
2,804,9243,3578720176,3578720217,41
2,804,9244,3578720176,3578720218,42
2,804,9245,3578720176,3578720218,42
2,804,9246,3578720176,3578720219,43
2,804,9247,3578720176,3578720221,45
2,804,9248,3578720176,3578720221,45
2,804,9249,3578720176,3578720225,49
2,805,9250,3578720231,3578720231,0
2,805,9251,3578720231,3578720231,0
2,805,9252,3578720231,3578720231,0
2,805,9253,3578720231,3578720231,0
2,805,9254,3578720231,3578720233,2
2,805,9255,3578720231,3578720234,3
2,805,9256,3578720231,3578720236,5
2,805,9257,3578720231,3578720237,6
2,805,9258,3578720231,3578720238,7
2,805,9259,3578720231,3578720239,8
2,805,9260,3578720231,3578720241,10
2,805,9261,3578720231,3578720241,10
2,805,9262,3578720231,3578720242,11
2,805,9263,3578720231,3578720242,11
2,805,9264,3578720231,3578720243,12
2,805,9265,3578720231,3578720243,12
2,805,9266,3578720231,3578720246,15
2,805,9267,3578720231,3578720247,16
2,805,9268,3578720231,3578720249,18
2,805,9269,3578720231,3578720250,19
2,805,9270,3578720231,3578720252,21
2,805,9271,3578720231,3578720253,22
2,805,9272,3578720231,3578720254,23
2,805,9273,3578720231,3578720255,24
2,805,9274,3578720231,3578720257,26
2,805,9275,3578720231,3578720260,29
2,805,9276,3578720231,3578720264,33
2,805,9277,3578720231,3578720265,34
2,805,9278,3578720231,3578720266,35
2,805,9279,3578720231,3578720267,36
2,805,9280,3578720231,3578720268,37
2,805,9281,3578720231,3578720269,38
2,805,9282,3578720231,3578720270,39
2,805,9283,3578720231,3578720276,45
2,805,9284,3578720231,3578720279,48
2,805,9285,3578720231,3578720280,49
2,806,9286,3578720287,3578720287,0
2,806,9287,3578720287,3578720287,0
2,806,9288,3578720287,3578720287,0
2,806,9289,3578720287,3578720287,0
2,806,9290,3578720287,3578720287,0
2,806,9291,3578720287,3578720287,0
2,806,9292,3578720287,3578720287,0
2,806,9293,3578720287,3578720287,0
2,806,9294,3578720287,3578720287,0
2,806,9295,3578720287,3578720291,4
2,806,9296,3578720287,3578720292,5
2,806,9297,3578720287,3578720292,5
2,806,9298,3578720287,3578720293,6
2,806,9299,3578720287,3578720294,7
2,806,9300,3578720287,3578720294,7
2,806,9301,3578720287,3578720296,9
2,806,9302,3578720287,3578720296,9
2,806,9303,3578720287,3578720296,9
2,806,9304,3578720287,3578720299,12
2,806,9305,3578720287,3578720300,13
2,806,9306,3578720287,3578720301,14
2,806,9307,3578720287,3578720302,15
2,806,9308,3578720287,3578720302,15
2,806,9309,3578720287,3578720305,18
2,806,9310,3578720287,3578720307,20
2,806,9311,3578720287,3578720307,20
2,806,9312,3578720287,3578720308,21
2,806,9313,3578720287,3578720308,21
2,806,9314,3578720287,3578720309,22
2,806,9315,3578720287,3578720311,24
2,806,9316,3578720287,3578720311,24
2,806,9317,3578720287,3578720313,26
2,806,9318,3578720287,3578720313,26
2,806,9319,3578720287,3578720314,27
2,806,9320,3578720287,3578720314,27
2,806,9321,3578720287,3578720314,27
2,806,9322,3578720287,3578720317,30
2,806,9323,3578720287,3578720317,30
2,806,9324,3578720287,3578720317,30
2,806,9325,3578720287,3578720318,31
2,806,9326,3578720287,3578720318,31
2,806,9327,3578720287,3578720321,34
2,806,9328,3578720287,3578720322,35
2,806,9329,3578720287,3578720325,38
2,806,9330,3578720287,3578720327,40
2,806,9331,3578720287,3578720331,44
2,806,9332,3578720287,3578720332,45
2,806,9333,3578720287,3578720334,47
2,806,9334,3578720287,3578720335,48
2,806,9335,3578720287,3578720335,48
2,807,9336,3578720343,3578720343,0
2,807,9337,3578720343,3578720343,0
2,807,9338,3578720343,3578720343,0
2,807,9339,3578720343,3578720345,2
2,807,9340,3578720343,3578720351,8
2,807,9341,3578720343,3578720353,10
2,807,9342,3578720343,3578720353,10
2,807,9343,3578720343,3578720354,11
2,807,9344,3578720343,3578720355,12
2,807,9345,3578720343,3578720355,12
2,807,9346,3578720343,3578720357,14
2,807,9347,3578720343,3578720363,20
2,807,9348,3578720343,3578720365,22
2,807,9349,3578720343,3578720366,23
2,807,9350,3578720343,3578720367,24
2,807,9351,3578720343,3578720367,24
2,807,9352,3578720343,3578720368,25
2,807,9353,3578720343,3578720369,26
2,807,9354,3578720343,3578720369,26
2,807,9355,3578720343,3578720373,30
2,807,9356,3578720343,3578720375,32
2,807,9357,3578720343,3578720377,34
2,807,9358,3578720343,3578720379,36
2,807,9359,3578720343,3578720381,38
2,807,9360,3578720343,3578720384,41
2,807,9361,3578720343,3578720386,43
2,807,9362,3578720343,3578720389,46
2,807,9363,3578720343,3578720390,47
2,807,9364,3578720343,3578720391,48
2,808,9365,3578720397,3578720397,0
2,808,9366,3578720397,3578720397,0
2,808,9367,3578720397,3578720397,0
2,808,9368,3578720397,3578720400,3
2,808,9369,3578720397,3578720400,3
2,808,9370,3578720397,3578720404,7
2,808,9371,3578720397,3578720415,18
2,808,9372,3578720397,3578720415,18
2,808,9373,3578720397,3578720415,18
2,808,9374,3578720397,3578720415,18
2,808,9375,3578720397,3578720415,18
2,808,9376,3578720397,3578720415,18
2,808,9377,3578720397,3578720415,18
2,808,9378,3578720397,3578720415,18
2,808,9379,3578720397,3578720415,18
2,808,9380,3578720397,3578720416,19
2,808,9381,3578720397,3578720418,21
2,808,9382,3578720397,3578720419,22
2,808,9383,3578720397,3578720420,23
2,808,9384,3578720397,3578720421,24
2,808,9385,3578720397,3578720422,25
2,808,9386,3578720397,3578720428,31
2,808,9387,3578720397,3578720430,33
2,808,9388,3578720397,3578720430,33
2,808,9389,3578720397,3578720430,33
2,808,9390,3578720397,3578720433,36
2,808,9391,3578720397,3578720434,37
2,808,9392,3578720397,3578720436,39
2,808,9393,3578720397,3578720437,40
2,808,9394,3578720397,3578720438,41
2,808,9395,3578720397,3578720439,42
2,808,9396,3578720397,3578720441,44
2,808,9397,3578720397,3578720442,45
2,808,9398,3578720397,3578720443,46
2,808,9399,3578720397,3578720443,46
2,808,9400,3578720397,3578720444,47
2,808,9401,3578720397,3578720446,49
2,809,9402,3578720452,3578720452,0
2,809,9403,3578720452,3578720452,0
2,809,9404,3578720452,3578720453,1
2,809,9405,3578720452,3578720455,3
2,809,9406,3578720452,3578720455,3
2,809,9407,3578720452,3578720457,5
2,809,9408,3578720452,3578720460,8
2,809,9409,3578720452,3578720464,12
2,809,9410,3578720452,3578720464,12
2,809,9411,3578720452,3578720466,14
2,809,9412,3578720452,3578720467,15
2,809,9413,3578720452,3578720468,16
2,809,9414,3578720452,3578720469,17
2,809,9415,3578720452,3578720470,18
2,809,9416,3578720452,3578720471,19
2,809,9417,3578720452,3578720476,24
2,809,9418,3578720452,3578720479,27
2,809,9419,3578720452,3578720480,28
2,809,9420,3578720452,3578720480,28
2,809,9421,3578720452,3578720481,29
2,809,9422,3578720452,3578720482,30
2,809,9423,3578720452,3578720483,31
2,809,9424,3578720452,3578720484,32
2,809,9425,3578720452,3578720484,32
2,809,9426,3578720452,3578720485,33
2,809,9427,3578720452,3578720485,33
2,809,9428,3578720452,3578720487,35
2,809,9429,3578720452,3578720492,40
2,809,9430,3578720452,3578720492,40
2,809,9431,3578720452,3578720492,40
2,809,9432,3578720452,3578720493,41
2,809,9433,3578720452,3578720494,42
2,809,9434,3578720452,3578720495,43
2,809,9435,3578720452,3578720496,44
2,809,9436,3578720452,3578720496,44
2,809,9437,3578720452,3578720498,46
2,809,9438,3578720452,3578720500,48
2,809,9439,3578720452,3578720501,49
2,810,9440,3578720506,3578720506,0
2,810,9441,3578720506,3578720506,0
2,810,9442,3578720506,3578720506,0
2,810,9443,3578720506,3578720506,0
2,810,9444,3578720506,3578720506,0
2,810,9445,3578720506,3578720507,1
2,810,9446,3578720506,3578720508,2
2,810,9447,3578720506,3578720510,4
2,810,9448,3578720506,3578720511,5
2,810,9449,3578720506,3578720511,5
2,810,9450,3578720506,3578720512,6
2,810,9451,3578720506,3578720512,6
2,810,9452,3578720506,3578720513,7
2,810,9453,3578720506,3578720513,7
2,810,9454,3578720506,3578720516,10
2,810,9455,3578720506,3578720516,10
2,810,9456,3578720506,3578720516,10
2,810,9457,3578720506,3578720518,12
2,810,9458,3578720506,3578720518,12
2,810,9459,3578720506,3578720520,14
2,810,9460,3578720506,3578720525,19
2,810,9461,3578720506,3578720527,21
2,810,9462,3578720506,3578720531,25
2,810,9463,3578720506,3578720531,25
2,810,9464,3578720506,3578720533,27
2,810,9465,3578720506,3578720533,27
2,810,9466,3578720506,3578720534,28
2,810,9467,3578720506,3578720534,28
2,810,9468,3578720506,3578720537,31
2,810,9469,3578720506,3578720537,31
2,810,9470,3578720506,3578720538,32
2,810,9471,3578720506,3578720544,38
2,810,9472,3578720506,3578720550,44
2,810,9473,3578720506,3578720550,44
2,810,9474,3578720506,3578720552,46
2,810,9475,3578720506,3578720552,46
2,810,9476,3578720506,3578720553,47
2,810,9477,3578720506,3578720554,48
2,810,9478,3578720506,3578720555,49
2,810,9479,3578720506,3578720555,49
2,811,9480,3578720561,3578720561,0
2,811,9481,3578720561,3578720562,1
2,811,9482,3578720561,3578720565,4
2,811,9483,3578720561,3578720565,4
2,811,9484,3578720561,3578720566,5
2,811,9485,3578720561,3578720568,7
2,811,9486,3578720561,3578720568,7
2,811,9487,3578720561,3578720571,10
2,811,9488,3578720561,3578720574,13
2,811,9489,3578720561,3578720576,15
2,811,9490,3578720561,3578720578,17
2,811,9491,3578720561,3578720580,19
2,811,9492,3578720561,3578720584,23
2,811,9493,3578720561,3578720585,24
2,811,9494,3578720561,3578720585,24
2,811,9495,3578720561,3578720588,27
2,811,9496,3578720561,3578720590,29
2,811,9497,3578720561,3578720590,29
2,811,9498,3578720561,3578720593,32
2,811,9499,3578720561,3578720594,33
2,811,9500,3578720561,3578720594,33
2,811,9501,3578720561,3578720595,34
2,811,9502,3578720561,3578720599,38
2,811,9503,3578720561,3578720600,39
2,811,9504,3578720561,3578720603,42
2,811,9505,3578720561,3578720604,43
2,811,9506,3578720561,3578720604,43
2,811,9507,3578720561,3578720607,46
2,811,9508,3578720561,3578720608,47
2,811,9509,3578720561,3578720610,49
2,812,9510,3578720616,3578720616,0
2,812,9511,3578720616,3578720616,0
2,812,9512,3578720616,3578720616,0
2,812,9513,3578720616,3578720616,0
2,812,9514,3578720616,3578720616,0
2,812,9515,3578720616,3578720617,1
2,812,9516,3578720616,3578720619,3
2,812,9517,3578720616,3578720619,3
2,812,9518,3578720616,3578720619,3
2,812,9519,3578720616,3578720621,5
2,812,9520,3578720616,3578720627,11
2,812,9521,3578720616,3578720628,12
2,812,9522,3578720616,3578720628,12
2,812,9523,3578720616,3578720629,13
2,812,9524,3578720616,3578720632,16
2,812,9525,3578720616,3578720634,18
2,812,9526,3578720616,3578720636,20
2,812,9527,3578720616,3578720636,20
2,812,9528,3578720616,3578720636,20
2,812,9529,3578720616,3578720638,22
2,812,9530,3578720616,3578720640,24
2,812,9531,3578720616,3578720641,25
2,812,9532,3578720616,3578720642,26
2,812,9533,3578720616,3578720643,27
2,812,9534,3578720616,3578720644,28
2,812,9535,3578720616,3578720646,30
2,812,9536,3578720616,3578720646,30
2,812,9537,3578720616,3578720648,32
2,812,9538,3578720616,3578720652,36
2,812,9539,3578720616,3578720654,38
2,812,9540,3578720616,3578720655,39
2,812,9541,3578720616,3578720657,41
2,812,9542,3578720616,3578720659,43
2,812,9543,3578720616,3578720663,47
2,812,9544,3578720616,3578720663,47
2,812,9545,3578720616,3578720665,49
2,812,9546,3578720616,3578720666,50
2,813,9547,3578720671,3578720671,0
2,813,9548,3578720671,3578720671,0
2,813,9549,3578720671,3578720671,0
2,813,9550,3578720671,3578720671,0
2,813,9551,3578720671,3578720676,5
2,813,9552,3578720671,3578720678,7
2,813,9553,3578720671,3578720679,8
2,813,9554,3578720671,3578720681,10
2,813,9555,3578720671,3578720681,10
2,813,9556,3578720671,3578720681,10
2,813,9557,3578720671,3578720683,12
2,813,9558,3578720671,3578720684,13
2,813,9559,3578720671,3578720684,13
2,813,9560,3578720671,3578720685,14
2,813,9561,3578720671,3578720687,16
2,813,9562,3578720671,3578720692,21
2,813,9563,3578720671,3578720692,21
2,813,9564,3578720671,3578720693,22
2,813,9565,3578720671,3578720693,22
2,813,9566,3578720671,3578720694,23
2,813,9567,3578720671,3578720694,23
2,813,9568,3578720671,3578720695,24
2,813,9569,3578720671,3578720696,25
2,813,9570,3578720671,3578720696,25
2,813,9571,3578720671,3578720699,28
2,813,9572,3578720671,3578720700,29
2,813,9573,3578720671,3578720701,30
2,813,9574,3578720671,3578720702,31
2,813,9575,3578720671,3578720705,34
2,813,9576,3578720671,3578720706,35
2,813,9577,3578720671,3578720706,35
2,813,9578,3578720671,3578720706,35
2,813,9579,3578720671,3578720707,36
2,813,9580,3578720671,3578720709,38
2,813,9581,3578720671,3578720709,38
2,813,9582,3578720671,3578720710,39
2,813,9583,3578720671,3578720712,41
2,813,9584,3578720671,3578720712,41
2,813,9585,3578720671,3578720712,41
2,813,9586,3578720671,3578720712,41
2,813,9587,3578720671,3578720713,42
2,813,9588,3578720671,3578720716,45
2,813,9589,3578720671,3578720717,46
2,813,9590,3578720671,3578720717,46
2,813,9591,3578720671,3578720718,47
2,813,9592,3578720671,3578720719,48
2,814,9593,3578720727,3578720727,0
2,814,9594,3578720727,3578720727,0
2,814,9595,3578720727,3578720727,0
2,814,9596,3578720727,3578720728,1
2,814,9597,3578720727,3578720731,4
2,814,9598,3578720727,3578720731,4
2,814,9599,3578720727,3578720733,6
2,814,9600,3578720727,3578720734,7
2,814,9601,3578720727,3578720734,7
2,814,9602,3578720727,3578720736,9
2,814,9603,3578720727,3578720737,10
2,814,9604,3578720727,3578720737,10
2,814,9605,3578720727,3578720738,11
2,814,9606,3578720727,3578720744,17
2,814,9607,3578720727,3578720749,22
2,814,9608,3578720727,3578720750,23
2,814,9609,3578720727,3578720752,25
2,814,9610,3578720727,3578720752,25
2,814,9611,3578720727,3578720753,26
2,814,9612,3578720727,3578720754,27
2,814,9613,3578720727,3578720755,28
2,814,9614,3578720727,3578720756,29
2,814,9615,3578720727,3578720759,32
2,814,9616,3578720727,3578720762,35
2,814,9617,3578720727,3578720765,38
2,814,9618,3578720727,3578720765,38
2,814,9619,3578720727,3578720766,39
2,814,9620,3578720727,3578720767,40
2,814,9621,3578720727,3578720768,41
2,814,9622,3578720727,3578720771,44
2,814,9623,3578720727,3578720775,48
2,814,9624,3578720727,3578720775,48
2,815,9625,3578720783,3578720783,0
2,815,9626,3578720783,3578720783,0
2,815,9627,3578720783,3578720785,2
2,815,9628,3578720783,3578720785,2
2,815,9629,3578720783,3578720788,5
2,815,9630,3578720783,3578720790,7
2,815,9631,3578720783,3578720793,10
2,815,9632,3578720783,3578720794,11
2,815,9633,3578720783,3578720797,14
2,815,9634,3578720783,3578720799,16
2,815,9635,3578720783,3578720799,16
2,815,9636,3578720783,3578720804,21
2,815,9637,3578720783,3578720804,21
2,815,9638,3578720783,3578720804,21
2,815,9639,3578720783,3578720807,24
2,815,9640,3578720783,3578720808,25
2,815,9641,3578720783,3578720810,27
2,815,9642,3578720783,3578720813,30
2,815,9643,3578720783,3578720813,30
2,815,9644,3578720783,3578720813,30
2,815,9645,3578720783,3578720814,31
2,815,9646,3578720783,3578720816,33
2,815,9647,3578720783,3578720817,34
2,815,9648,3578720783,3578720819,36
2,815,9649,3578720783,3578720819,36
2,815,9650,3578720783,3578720819,36
2,815,9651,3578720783,3578720822,39
2,815,9652,3578720783,3578720824,41
2,815,9653,3578720783,3578720827,44
2,815,9654,3578720783,3578720828,45
2,815,9655,3578720783,3578720828,45
2,815,9656,3578720783,3578720829,46
2,815,9657,3578720783,3578720829,46
2,815,9658,3578720783,3578720833,50
2,816,9659,3578720838,3578720838,0
2,816,9660,3578720838,3578720838,0
2,816,9661,3578720838,3578720838,0
2,816,9662,3578720838,3578720838,0
2,816,9663,3578720838,3578720838,0
2,816,9664,3578720838,3578720840,2
2,816,9665,3578720838,3578720841,3
2,816,9666,3578720838,3578720842,4
2,816,9667,3578720838,3578720843,5
2,816,9668,3578720838,3578720845,7
2,816,9669,3578720838,3578720846,8
2,816,9670,3578720838,3578720847,9
2,816,9671,3578720838,3578720848,10
2,816,9672,3578720838,3578720851,13
2,816,9673,3578720838,3578720851,13
2,816,9674,3578720838,3578720853,15
2,816,9675,3578720838,3578720854,16
2,816,9676,3578720838,3578720854,16
2,816,9677,3578720838,3578720857,19
2,816,9678,3578720838,3578720860,22
2,816,9679,3578720838,3578720863,25
2,816,9680,3578720838,3578720864,26
2,816,9681,3578720838,3578720865,27
2,816,9682,3578720838,3578720866,28
2,816,9683,3578720838,3578720866,28
2,816,9684,3578720838,3578720869,31
2,816,9685,3578720838,3578720870,32
2,816,9686,3578720838,3578720870,32
2,816,9687,3578720838,3578720876,38
2,816,9688,3578720838,3578720879,41
2,816,9689,3578720838,3578720879,41
2,816,9690,3578720838,3578720881,43
2,816,9691,3578720838,3578720882,44
2,816,9692,3578720838,3578720882,44
2,816,9693,3578720838,3578720883,45
2,816,9694,3578720838,3578720883,45
2,816,9695,3578720838,3578720885,47
2,816,9696,3578720838,3578720885,47
2,816,9697,3578720838,3578720887,49
2,817,9698,3578720893,3578720893,0
2,817,9699,3578720893,3578720893,0
2,817,9700,3578720893,3578720893,0
2,817,9701,3578720893,3578720893,0
2,817,9702,3578720893,3578720895,2
2,817,9703,3578720893,3578720895,2
2,817,9704,3578720893,3578720895,2
2,817,9705,3578720893,3578720896,3
2,817,9706,3578720893,3578720900,7
2,817,9707,3578720893,3578720901,8
2,817,9708,3578720893,3578720902,9
2,817,9709,3578720893,3578720906,13
2,817,9710,3578720893,3578720906,13
2,817,9711,3578720893,3578720907,14
2,817,9712,3578720893,3578720907,14
2,817,9713,3578720893,3578720908,15
2,817,9714,3578720893,3578720909,16
2,817,9715,3578720893,3578720909,16
2,817,9716,3578720893,3578720911,18
2,817,9717,3578720893,3578720912,19
2,817,9718,3578720893,3578720912,19
2,817,9719,3578720893,3578720912,19
2,817,9720,3578720893,3578720912,19
2,817,9721,3578720893,3578720913,20
2,817,9722,3578720893,3578720916,23
2,817,9723,3578720893,3578720916,23
2,817,9724,3578720893,3578720916,23
2,817,9725,3578720893,3578720918,25
2,817,9726,3578720893,3578720918,25
2,817,9727,3578720893,3578720921,28
2,817,9728,3578720893,3578720922,29
2,817,9729,3578720893,3578720925,32
2,817,9730,3578720893,3578720927,34
2,817,9731,3578720893,3578720929,36
2,817,9732,3578720893,3578720931,38
2,817,9733,3578720893,3578720932,39
2,817,9734,3578720893,3578720933,40
2,817,9735,3578720893,3578720934,41
2,817,9736,3578720893,3578720934,41
2,817,9737,3578720893,3578720936,43
2,817,9738,3578720893,3578720936,43
2,817,9739,3578720893,3578720938,45
2,817,9740,3578720893,3578720938,45
2,818,9741,3578720948,3578720948,0
2,818,9742,3578720948,3578720950,2
2,818,9743,3578720948,3578720952,4
2,818,9744,3578720948,3578720952,4
2,818,9745,3578720948,3578720953,5
2,818,9746,3578720948,3578720954,6
2,818,9747,3578720948,3578720955,7
2,818,9748,3578720948,3578720956,8
2,818,9749,3578720948,3578720959,11
2,818,9750,3578720948,3578720963,15
2,818,9751,3578720948,3578720965,17
2,818,9752,3578720948,3578720965,17
2,818,9753,3578720948,3578720966,18
2,818,9754,3578720948,3578720967,19
2,818,9755,3578720948,3578720968,20
2,818,9756,3578720948,3578720968,20
2,818,9757,3578720948,3578720972,24
2,818,9758,3578720948,3578720976,28
2,818,9759,3578720948,3578720977,29
2,818,9760,3578720948,3578720978,30
2,818,9761,3578720948,3578720980,32
2,818,9762,3578720948,3578720985,37
2,818,9763,3578720948,3578720986,38
2,818,9764,3578720948,3578720986,38
2,818,9765,3578720948,3578720991,43
2,818,9766,3578720948,3578720993,45
2,818,9767,3578720948,3578720994,46
2,818,9768,3578720948,3578720996,48
2,819,9769,3578721004,3578721004,0
2,819,9770,3578721004,3578721004,0
2,819,9771,3578721004,3578721004,0
2,819,9772,3578721004,3578721004,0
2,819,9773,3578721004,3578721008,4
2,819,9774,3578721004,3578721008,4
2,819,9775,3578721004,3578721010,6
2,819,9776,3578721004,3578721012,8
2,819,9777,3578721004,3578721013,9
2,819,9778,3578721004,3578721014,10
2,819,9779,3578721004,3578721016,12
2,819,9780,3578721004,3578721017,13
2,819,9781,3578721004,3578721019,15
2,819,9782,3578721004,3578721019,15
2,819,9783,3578721004,3578721020,16
2,819,9784,3578721004,3578721022,18
2,819,9785,3578721004,3578721025,21
2,819,9786,3578721004,3578721026,22
2,819,9787,3578721004,3578721028,24
2,819,9788,3578721004,3578721028,24
2,819,9789,3578721004,3578721029,25
2,819,9790,3578721004,3578721029,25
2,819,9791,3578721004,3578721033,29
2,819,9792,3578721004,3578721034,30
2,819,9793,3578721004,3578721037,33
2,819,9794,3578721004,3578721037,33
2,819,9795,3578721004,3578721037,33
2,819,9796,3578721004,3578721041,37
2,819,9797,3578721004,3578721041,37
2,819,9798,3578721004,3578721041,37
2,819,9799,3578721004,3578721042,38
2,819,9800,3578721004,3578721043,39
2,819,9801,3578721004,3578721046,42
2,819,9802,3578721004,3578721046,42
2,819,9803,3578721004,3578721047,43
2,819,9804,3578721004,3578721049,45
2,819,9805,3578721004,3578721051,47
2,819,9806,3578721004,3578721052,48
2,819,9807,3578721004,3578721053,49
2,819,9808,3578721004,3578721054,50
2,820,9809,3578721059,3578721059,0
2,820,9810,3578721059,3578721059,0
2,820,9811,3578721059,3578721060,1
2,820,9812,3578721059,3578721063,4
2,820,9813,3578721059,3578721065,6
2,820,9814,3578721059,3578721066,7
2,820,9815,3578721059,3578721066,7
2,820,9816,3578721059,3578721066,7
2,820,9817,3578721059,3578721070,11
2,820,9818,3578721059,3578721070,11
2,820,9819,3578721059,3578721070,11
2,820,9820,3578721059,3578721076,17
2,820,9821,3578721059,3578721078,19
2,820,9822,3578721059,3578721079,20
2,820,9823,3578721059,3578721081,22
2,820,9824,3578721059,3578721082,23
2,820,9825,3578721059,3578721083,24
2,820,9826,3578721059,3578721083,24
2,820,9827,3578721059,3578721084,25
2,820,9828,3578721059,3578721087,28
2,820,9829,3578721059,3578721092,33
2,820,9830,3578721059,3578721093,34
2,820,9831,3578721059,3578721094,35
2,820,9832,3578721059,3578721095,36
2,820,9833,3578721059,3578721095,36
2,820,9834,3578721059,3578721096,37
2,820,9835,3578721059,3578721096,37
2,820,9836,3578721059,3578721100,41
2,820,9837,3578721059,3578721100,41
2,820,9838,3578721059,3578721102,43
2,820,9839,3578721059,3578721106,47
2,820,9840,3578721059,3578721107,48
2,820,9841,3578721059,3578721107,48
2,820,9842,3578721059,3578721107,48
2,820,9843,3578721059,3578721107,48
2,820,9844,3578721059,3578721108,49
2,820,9845,3578721059,3578721108,49
2,821,9846,3578721115,3578721115,0
2,821,9847,3578721115,3578721115,0
2,821,9848,3578721115,3578721115,0
2,821,9849,3578721115,3578721115,0
2,821,9850,3578721115,3578721115,0
2,821,9851,3578721115,3578721115,0
2,821,9852,3578721115,3578721115,0
2,821,9853,3578721115,3578721116,1
2,821,9854,3578721115,3578721116,1
2,821,9855,3578721115,3578721117,2
2,821,9856,3578721115,3578721118,3
2,821,9857,3578721115,3578721119,4
2,821,9858,3578721115,3578721121,6
2,821,9859,3578721115,3578721122,7
2,821,9860,3578721115,3578721125,10
2,821,9861,3578721115,3578721127,12
2,821,9862,3578721115,3578721129,14
2,821,9863,3578721115,3578721132,17
2,821,9864,3578721115,3578721132,17
2,821,9865,3578721115,3578721134,19
2,821,9866,3578721115,3578721134,19
2,821,9867,3578721115,3578721138,23
2,821,9868,3578721115,3578721138,23
2,821,9869,3578721115,3578721147,32
2,821,9870,3578721115,3578721150,35
2,821,9871,3578721115,3578721151,36
2,821,9872,3578721115,3578721152,37
2,821,9873,3578721115,3578721153,38
2,821,9874,3578721115,3578721154,39
2,821,9875,3578721115,3578721155,40
2,821,9876,3578721115,3578721157,42
2,821,9877,3578721115,3578721159,44
2,821,9878,3578721115,3578721164,49
2,821,9879,3578721115,3578721164,49
2,821,9880,3578721115,3578721165,50
2,822,9881,3578721171,3578721171,0
2,822,9882,3578721171,3578721171,0
2,822,9883,3578721171,3578721171,0
2,822,9884,3578721171,3578721171,0
2,822,9885,3578721171,3578721171,0
2,822,9886,3578721171,3578721173,2
2,822,9887,3578721171,3578721175,4
2,822,9888,3578721171,3578721177,6
2,822,9889,3578721171,3578721178,7
2,822,9890,3578721171,3578721180,9
2,822,9891,3578721171,3578721185,14
2,822,9892,3578721171,3578721186,15
2,822,9893,3578721171,3578721189,18
2,822,9894,3578721171,3578721190,19
2,822,9895,3578721171,3578721194,23
2,822,9896,3578721171,3578721194,23
2,822,9897,3578721171,3578721196,25
2,822,9898,3578721171,3578721199,28
2,822,9899,3578721171,3578721200,29
2,822,9900,3578721171,3578721204,33
2,822,9901,3578721171,3578721204,33
2,822,9902,3578721171,3578721208,37
2,822,9903,3578721171,3578721209,38
2,822,9904,3578721171,3578721213,42
2,822,9905,3578721171,3578721213,42
2,822,9906,3578721171,3578721213,42
2,822,9907,3578721171,3578721214,43
2,822,9908,3578721171,3578721217,46
2,822,9909,3578721171,3578721217,46
2,822,9910,3578721171,3578721219,48
2,822,9911,3578721171,3578721219,48
2,822,9912,3578721171,3578721219,48
2,823,9913,3578721226,3578721226,0
2,823,9914,3578721226,3578721226,0
2,823,9915,3578721226,3578721227,1
2,823,9916,3578721226,3578721229,3
2,823,9917,3578721226,3578721229,3
2,823,9918,3578721226,3578721230,4
2,823,9919,3578721226,3578721233,7
2,823,9920,3578721226,3578721234,8
2,823,9921,3578721226,3578721234,8
2,823,9922,3578721226,3578721237,11
2,823,9923,3578721226,3578721237,11
2,823,9924,3578721226,3578721238,12
2,823,9925,3578721226,3578721240,14
2,823,9926,3578721226,3578721241,15
2,823,9927,3578721226,3578721242,16
2,823,9928,3578721226,3578721242,16
2,823,9929,3578721226,3578721243,17
2,823,9930,3578721226,3578721246,20
2,823,9931,3578721226,3578721247,21
2,823,9932,3578721226,3578721247,21
2,823,9933,3578721226,3578721249,23
2,823,9934,3578721226,3578721251,25
2,823,9935,3578721226,3578721252,26
2,823,9936,3578721226,3578721253,27
2,823,9937,3578721226,3578721254,28
2,823,9938,3578721226,3578721255,29
2,823,9939,3578721226,3578721257,31
2,823,9940,3578721226,3578721260,34
2,823,9941,3578721226,3578721263,37
2,823,9942,3578721226,3578721265,39
2,823,9943,3578721226,3578721266,40
2,823,9944,3578721226,3578721267,41
2,823,9945,3578721226,3578721268,42
2,823,9946,3578721226,3578721269,43
2,823,9947,3578721226,3578721270,44
2,823,9948,3578721226,3578721270,44
2,823,9949,3578721226,3578721276,50
2,824,9950,3578721281,3578721281,0
2,824,9951,3578721281,3578721281,0
2,824,9952,3578721281,3578721281,0
2,824,9953,3578721281,3578721281,0
2,824,9954,3578721281,3578721283,2
2,824,9955,3578721281,3578721284,3
2,824,9956,3578721281,3578721284,3
2,824,9957,3578721281,3578721284,3
2,824,9958,3578721281,3578721285,4
2,824,9959,3578721281,3578721285,4
2,824,9960,3578721281,3578721286,5
2,824,9961,3578721281,3578721287,6
2,824,9962,3578721281,3578721292,11
2,824,9963,3578721281,3578721292,11
2,824,9964,3578721281,3578721293,12
2,824,9965,3578721281,3578721294,13
2,824,9966,3578721281,3578721294,13
2,824,9967,3578721281,3578721294,13
2,824,9968,3578721281,3578721295,14
2,824,9969,3578721281,3578721296,15
2,824,9970,3578721281,3578721296,15
2,824,9971,3578721281,3578721298,17
2,824,9972,3578721281,3578721300,19
2,824,9973,3578721281,3578721300,19
2,824,9974,3578721281,3578721302,21
2,824,9975,3578721281,3578721306,25
2,824,9976,3578721281,3578721306,25
2,824,9977,3578721281,3578721307,26
2,824,9978,3578721281,3578721307,26
2,824,9979,3578721281,3578721307,26
2,824,9980,3578721281,3578721307,26
2,824,9981,3578721281,3578721309,28
2,824,9982,3578721281,3578721310,29
2,824,9983,3578721281,3578721312,31
2,824,9984,3578721281,3578721312,31
2,824,9985,3578721281,3578721312,31
2,824,9986,3578721281,3578721313,32
2,824,9987,3578721281,3578721313,32
2,824,9988,3578721281,3578721314,33
2,824,9989,3578721281,3578721316,35
2,824,9990,3578721281,3578721317,36
2,824,9991,3578721281,3578721317,36
2,824,9992,3578721281,3578721317,36
2,824,9993,3578721281,3578721319,38
2,824,9994,3578721281,3578721321,40
2,824,9995,3578721281,3578721322,41
2,824,9996,3578721281,3578721326,45
2,824,9997,3578721281,3578721328,47
2,824,9998,3578721281,3578721328,47
2,825,9999,3578721336,3578721336,0
2,825,10000,3578721336,3578721336,0
2,825,10001,3578721336,3578721336,0
2,825,10002,3578721336,3578721336,0
2,825,10003,3578721336,3578721337,1
2,825,10004,3578721336,3578721337,1
2,825,10005,3578721336,3578721346,10
2,825,10006,3578721336,3578721350,14
2,825,10007,3578721336,3578721351,15
2,825,10008,3578721336,3578721352,16
2,825,10009,3578721336,3578721353,17
2,825,10010,3578721336,3578721354,18
2,825,10011,3578721336,3578721355,19
2,825,10012,3578721336,3578721355,19
2,825,10013,3578721336,3578721360,24
2,825,10014,3578721336,3578721364,28
2,825,10015,3578721336,3578721365,29
2,825,10016,3578721336,3578721366,30
2,825,10017,3578721336,3578721366,30
2,825,10018,3578721336,3578721368,32
2,825,10019,3578721336,3578721368,32
2,825,10020,3578721336,3578721369,33
2,825,10021,3578721336,3578721369,33
2,825,10022,3578721336,3578721372,36
2,825,10023,3578721336,3578721376,40
2,825,10024,3578721336,3578721377,41
2,825,10025,3578721336,3578721379,43
2,825,10026,3578721336,3578721380,44
2,825,10027,3578721336,3578721385,49
2,826,10028,3578721393,3578721393,0
2,826,10029,3578721393,3578721393,0
2,826,10030,3578721393,3578721393,0
2,826,10031,3578721393,3578721393,0
2,826,10032,3578721393,3578721393,0
2,826,10033,3578721393,3578721394,1
2,826,10034,3578721393,3578721394,1
2,826,10035,3578721393,3578721395,2
2,826,10036,3578721393,3578721396,3
2,826,10037,3578721393,3578721399,6
2,826,10038,3578721393,3578721400,7
2,826,10039,3578721393,3578721404,11
2,826,10040,3578721393,3578721404,11
2,826,10041,3578721393,3578721408,15
2,826,10042,3578721393,3578721409,16
2,826,10043,3578721393,3578721412,19
2,826,10044,3578721393,3578721413,20
2,826,10045,3578721393,3578721413,20
2,826,10046,3578721393,3578721415,22
2,826,10047,3578721393,3578721416,23
2,826,10048,3578721393,3578721418,25
2,826,10049,3578721393,3578721419,26
2,826,10050,3578721393,3578721420,27
2,826,10051,3578721393,3578721420,27
2,826,10052,3578721393,3578721423,30
2,826,10053,3578721393,3578721425,32
2,826,10054,3578721393,3578721427,34
2,826,10055,3578721393,3578721428,35
2,826,10056,3578721393,3578721430,37
2,826,10057,3578721393,3578721430,37
2,826,10058,3578721393,3578721430,37
2,826,10059,3578721393,3578721433,40
2,826,10060,3578721393,3578721433,40
2,826,10061,3578721393,3578721434,41
2,826,10062,3578721393,3578721437,44
2,826,10063,3578721393,3578721437,44
2,826,10064,3578721393,3578721438,45
2,826,10065,3578721393,3578721438,45
2,826,10066,3578721393,3578721441,48
2,826,10067,3578721393,3578721442,49
2,826,10068,3578721393,3578721442,49
2,826,10069,3578721393,3578721443,50
2,827,10070,3578721448,3578721448,0
2,827,10071,3578721448,3578721448,0
2,827,10072,3578721448,3578721449,1
2,827,10073,3578721448,3578721450,2
2,827,10074,3578721448,3578721453,5
2,827,10075,3578721448,3578721453,5
2,827,10076,3578721448,3578721454,6
2,827,10077,3578721448,3578721455,7
2,827,10078,3578721448,3578721457,9
2,827,10079,3578721448,3578721460,12
2,827,10080,3578721448,3578721462,14
2,827,10081,3578721448,3578721465,17
2,827,10082,3578721448,3578721467,19
2,827,10083,3578721448,3578721467,19
2,827,10084,3578721448,3578721468,20
2,827,10085,3578721448,3578721470,22
2,827,10086,3578721448,3578721470,22
2,827,10087,3578721448,3578721470,22
2,827,10088,3578721448,3578721476,28
2,827,10089,3578721448,3578721479,31
2,827,10090,3578721448,3578721479,31
2,827,10091,3578721448,3578721481,33
2,827,10092,3578721448,3578721482,34
2,827,10093,3578721448,3578721483,35
2,827,10094,3578721448,3578721484,36
2,827,10095,3578721448,3578721484,36
2,827,10096,3578721448,3578721484,36
2,827,10097,3578721448,3578721484,36
2,827,10098,3578721448,3578721486,38
2,827,10099,3578721448,3578721486,38
2,827,10100,3578721448,3578721487,39
2,827,10101,3578721448,3578721492,44
2,827,10102,3578721448,3578721492,44
2,827,10103,3578721448,3578721493,45
2,827,10104,3578721448,3578721495,47
2,827,10105,3578721448,3578721495,47
2,827,10106,3578721448,3578721495,47
2,827,10107,3578721448,3578721496,48
2,827,10108,3578721448,3578721496,48
2,827,10109,3578721448,3578721497,49
2,828,10110,3578721504,3578721504,0
2,828,10111,3578721504,3578721504,0
2,828,10112,3578721504,3578721504,0
2,828,10113,3578721504,3578721504,0
2,828,10114,3578721504,3578721505,1
2,828,10115,3578721504,3578721505,1
2,828,10116,3578721504,3578721506,2
2,828,10117,3578721504,3578721507,3
2,828,10118,3578721504,3578721507,3
2,828,10119,3578721504,3578721507,3
2,828,10120,3578721504,3578721508,4
2,828,10121,3578721504,3578721508,4
2,828,10122,3578721504,3578721511,7
2,828,10123,3578721504,3578721511,7
2,828,10124,3578721504,3578721511,7
2,828,10125,3578721504,3578721512,8
2,828,10126,3578721504,3578721513,9
2,828,10127,3578721504,3578721513,9
2,828,10128,3578721504,3578721515,11
2,828,10129,3578721504,3578721516,12
2,828,10130,3578721504,3578721516,12
2,828,10131,3578721504,3578721517,13
2,828,10132,3578721504,3578721519,15
2,828,10133,3578721504,3578721521,17
2,828,10134,3578721504,3578721521,17
2,828,10135,3578721504,3578721524,20
2,828,10136,3578721504,3578721527,23
2,828,10137,3578721504,3578721528,24
2,828,10138,3578721504,3578721531,27
2,828,10139,3578721504,3578721532,28
2,828,10140,3578721504,3578721534,30
2,828,10141,3578721504,3578721534,30
2,828,10142,3578721504,3578721535,31
2,828,10143,3578721504,3578721536,32
2,828,10144,3578721504,3578721537,33
2,828,10145,3578721504,3578721537,33
2,828,10146,3578721504,3578721546,42
2,828,10147,3578721504,3578721550,46
2,828,10148,3578721504,3578721550,46
2,828,10149,3578721504,3578721552,48
2,828,10150,3578721504,3578721552,48
2,828,10151,3578721504,3578721553,49
2,828,10152,3578721504,3578721554,50
2,829,10153,3578721560,3578721560,0
2,829,10154,3578721560,3578721560,0
2,829,10155,3578721560,3578721563,3
2,829,10156,3578721560,3578721564,4
2,829,10157,3578721560,3578721565,5
2,829,10158,3578721560,3578721566,6
2,829,10159,3578721560,3578721568,8
2,829,10160,3578721560,3578721568,8
2,829,10161,3578721560,3578721568,8
2,829,10162,3578721560,3578721568,8
2,829,10163,3578721560,3578721572,12
2,829,10164,3578721560,3578721575,15
2,829,10165,3578721560,3578721576,16
2,829,10166,3578721560,3578721578,18
2,829,10167,3578721560,3578721580,20
2,829,10168,3578721560,3578721584,24
2,829,10169,3578721560,3578721585,25
2,829,10170,3578721560,3578721588,28
2,829,10171,3578721560,3578721590,30
2,829,10172,3578721560,3578721590,30
2,829,10173,3578721560,3578721593,33
2,829,10174,3578721560,3578721595,35
2,829,10175,3578721560,3578721595,35
2,829,10176,3578721560,3578721598,38
2,829,10177,3578721560,3578721599,39
2,829,10178,3578721560,3578721603,43
2,829,10179,3578721560,3578721603,43
2,829,10180,3578721560,3578721603,43
2,829,10181,3578721560,3578721608,48
2,829,10182,3578721560,3578721608,48
2,829,10183,3578721560,3578721609,49
2,830,10184,3578721615,3578721615,0
2,830,10185,3578721615,3578721615,0
2,830,10186,3578721615,3578721615,0
2,830,10187,3578721615,3578721616,1
2,830,10188,3578721615,3578721616,1
2,830,10189,3578721615,3578721617,2
2,830,10190,3578721615,3578721618,3
2,830,10191,3578721615,3578721618,3
2,830,10192,3578721615,3578721620,5
2,830,10193,3578721615,3578721622,7
2,830,10194,3578721615,3578721625,10
2,830,10195,3578721615,3578721626,11
2,830,10196,3578721615,3578721627,12
2,830,10197,3578721615,3578721629,14
2,830,10198,3578721615,3578721629,14
2,830,10199,3578721615,3578721629,14
2,830,10200,3578721615,3578721632,17
2,830,10201,3578721615,3578721632,17
2,830,10202,3578721615,3578721634,19
2,830,10203,3578721615,3578721636,21
2,830,10204,3578721615,3578721637,22
2,830,10205,3578721615,3578721637,22
2,830,10206,3578721615,3578721638,23
2,830,10207,3578721615,3578721638,23
2,830,10208,3578721615,3578721638,23
2,830,10209,3578721615,3578721641,26
2,830,10210,3578721615,3578721641,26
2,830,10211,3578721615,3578721641,26
2,830,10212,3578721615,3578721642,27
2,830,10213,3578721615,3578721643,28
2,830,10214,3578721615,3578721646,31
2,830,10215,3578721615,3578721647,32
2,830,10216,3578721615,3578721647,32
2,830,10217,3578721615,3578721648,33
2,830,10218,3578721615,3578721650,35
2,830,10219,3578721615,3578721651,36
2,830,10220,3578721615,3578721652,37
2,830,10221,3578721615,3578721654,39
2,830,10222,3578721615,3578721655,40
2,830,10223,3578721615,3578721657,42
2,830,10224,3578721615,3578721659,44
2,830,10225,3578721615,3578721662,47
2,830,10226,3578721615,3578721664,49
2,830,10227,3578721615,3578721665,50
2,831,10228,3578721670,3578721670,0
2,831,10229,3578721670,3578721670,0
2,831,10230,3578721670,3578721670,0
2,831,10231,3578721670,3578721670,0
2,831,10232,3578721670,3578721670,0
2,831,10233,3578721670,3578721676,6
2,831,10234,3578721670,3578721678,8
2,831,10235,3578721670,3578721681,11
2,831,10236,3578721670,3578721682,12
2,831,10237,3578721670,3578721683,13
2,831,10238,3578721670,3578721684,14
2,831,10239,3578721670,3578721684,14
2,831,10240,3578721670,3578721684,14
2,831,10241,3578721670,3578721685,15
2,831,10242,3578721670,3578721685,15
2,831,10243,3578721670,3578721685,15
2,831,10244,3578721670,3578721687,17
2,831,10245,3578721670,3578721691,21
2,831,10246,3578721670,3578721692,22
2,831,10247,3578721670,3578721693,23
2,831,10248,3578721670,3578721694,24
2,831,10249,3578721670,3578721695,25
2,831,10250,3578721670,3578721696,26
2,831,10251,3578721670,3578721696,26
2,831,10252,3578721670,3578721696,26
2,831,10253,3578721670,3578721696,26
2,831,10254,3578721670,3578721700,30
2,831,10255,3578721670,3578721701,31
2,831,10256,3578721670,3578721701,31
2,831,10257,3578721670,3578721706,36
2,831,10258,3578721670,3578721706,36
2,831,10259,3578721670,3578721706,36
2,831,10260,3578721670,3578721707,37
2,831,10261,3578721670,3578721707,37
2,831,10262,3578721670,3578721707,37
2,831,10263,3578721670,3578721708,38
2,831,10264,3578721670,3578721709,39
2,831,10265,3578721670,3578721711,41
2,831,10266,3578721670,3578721712,42
2,831,10267,3578721670,3578721712,42
2,831,10268,3578721670,3578721712,42
2,831,10269,3578721670,3578721712,42
2,831,10270,3578721670,3578721713,43
2,831,10271,3578721670,3578721715,45
2,831,10272,3578721670,3578721716,46
2,831,10273,3578721670,3578721717,47
2,831,10274,3578721670,3578721717,47
2,831,10275,3578721670,3578721719,49
2,832,10276,3578721725,3578721725,0
2,832,10277,3578721725,3578721725,0
2,832,10278,3578721725,3578721725,0
2,832,10279,3578721725,3578721727,2
2,832,10280,3578721725,3578721728,3
2,832,10281,3578721725,3578721732,7
2,832,10282,3578721725,3578721732,7
2,832,10283,3578721725,3578721732,7
2,832,10284,3578721725,3578721733,8
2,832,10285,3578721725,3578721735,10
2,832,10286,3578721725,3578721735,10
2,832,10287,3578721725,3578721737,12
2,832,10288,3578721725,3578721737,12
2,832,10289,3578721725,3578721737,12
2,832,10290,3578721725,3578721745,20
2,832,10291,3578721725,3578721749,24
2,832,10292,3578721725,3578721750,25
2,832,10293,3578721725,3578721752,27
2,832,10294,3578721725,3578721752,27
2,832,10295,3578721725,3578721753,28
2,832,10296,3578721725,3578721754,29
2,832,10297,3578721725,3578721755,30
2,832,10298,3578721725,3578721755,30
2,832,10299,3578721725,3578721760,35
2,832,10300,3578721725,3578721764,39
2,832,10301,3578721725,3578721764,39
2,832,10302,3578721725,3578721764,39
2,832,10303,3578721725,3578721766,41
2,832,10304,3578721725,3578721768,43
2,832,10305,3578721725,3578721768,43
2,832,10306,3578721725,3578721768,43
2,832,10307,3578721725,3578721768,43
2,832,10308,3578721725,3578721772,47
2,832,10309,3578721725,3578721775,50
2,833,10310,3578721780,3578721780,0
2,833,10311,3578721780,3578721780,0
2,833,10312,3578721780,3578721780,0
2,833,10313,3578721780,3578721785,5
2,833,10314,3578721780,3578721786,6
2,833,10315,3578721780,3578721786,6
2,833,10316,3578721780,3578721788,8
2,833,10317,3578721780,3578721790,10
2,833,10318,3578721780,3578721790,10
2,833,10319,3578721780,3578721790,10
2,833,10320,3578721780,3578721793,13
2,833,10321,3578721780,3578721794,14
2,833,10322,3578721780,3578721796,16
2,833,10323,3578721780,3578721798,18
2,833,10324,3578721780,3578721799,19
2,833,10325,3578721780,3578721802,22
2,833,10326,3578721780,3578721803,23
2,833,10327,3578721780,3578721803,23
2,833,10328,3578721780,3578721807,27
2,833,10329,3578721780,3578721808,28
2,833,10330,3578721780,3578721809,29
2,833,10331,3578721780,3578721812,32
2,833,10332,3578721780,3578721812,32
2,833,10333,3578721780,3578721813,33
2,833,10334,3578721780,3578721815,35
2,833,10335,3578721780,3578721815,35
2,833,10336,3578721780,3578721817,37
2,833,10337,3578721780,3578721818,38
2,833,10338,3578721780,3578721820,40
2,833,10339,3578721780,3578721822,42
2,833,10340,3578721780,3578721826,46
2,833,10341,3578721780,3578721827,47
2,833,10342,3578721780,3578721827,47
2,833,10343,3578721780,3578721829,49
2,833,10344,3578721780,3578721829,49
2,833,10345,3578721780,3578721829,49
2,834,10346,3578721835,3578721835,0
2,834,10347,3578721835,3578721835,0
2,834,10348,3578721835,3578721835,0
2,834,10349,3578721835,3578721836,1
2,834,10350,3578721835,3578721837,2
2,834,10351,3578721835,3578721837,2
2,834,10352,3578721835,3578721838,3
2,834,10353,3578721835,3578721838,3
2,834,10354,3578721835,3578721840,5
2,834,10355,3578721835,3578721842,7
2,834,10356,3578721835,3578721842,7
2,834,10357,3578721835,3578721842,7
2,834,10358,3578721835,3578721843,8
2,834,10359,3578721835,3578721846,11
2,834,10360,3578721835,3578721847,12
2,834,10361,3578721835,3578721847,12
2,834,10362,3578721835,3578721848,13
2,834,10363,3578721835,3578721849,14
2,834,10364,3578721835,3578721851,16
2,834,10365,3578721835,3578721853,18
2,834,10366,3578721835,3578721854,19
2,834,10367,3578721835,3578721854,19
2,834,10368,3578721835,3578721857,22
2,834,10369,3578721835,3578721860,25
2,834,10370,3578721835,3578721862,27
2,834,10371,3578721835,3578721864,29
2,834,10372,3578721835,3578721865,30
2,834,10373,3578721835,3578721866,31
2,834,10374,3578721835,3578721867,32
2,834,10375,3578721835,3578721869,34
2,834,10376,3578721835,3578721869,34
2,834,10377,3578721835,3578721870,35
2,834,10378,3578721835,3578721875,40
2,834,10379,3578721835,3578721878,43
2,834,10380,3578721835,3578721879,44
2,834,10381,3578721835,3578721880,45
2,834,10382,3578721835,3578721881,46
2,834,10383,3578721835,3578721883,48
2,834,10384,3578721835,3578721884,49
2,834,10385,3578721835,3578721884,49
2,834,10386,3578721835,3578721885,50
2,835,10387,3578721891,3578721891,0
2,835,10388,3578721891,3578721891,0
2,835,10389,3578721891,3578721891,0
2,835,10390,3578721891,3578721891,0
2,835,10391,3578721891,3578721892,1
2,835,10392,3578721891,3578721892,1
2,835,10393,3578721891,3578721893,2
2,835,10394,3578721891,3578721895,4
2,835,10395,3578721891,3578721896,5
2,835,10396,3578721891,3578721896,5
2,835,10397,3578721891,3578721897,6
2,835,10398,3578721891,3578721897,6
2,835,10399,3578721891,3578721900,9
2,835,10400,3578721891,3578721900,9
2,835,10401,3578721891,3578721901,10
2,835,10402,3578721891,3578721901,10
2,835,10403,3578721891,3578721906,15
2,835,10404,3578721891,3578721906,15
2,835,10405,3578721891,3578721906,15
2,835,10406,3578721891,3578721906,15
2,835,10407,3578721891,3578721907,16
2,835,10408,3578721891,3578721907,16
2,835,10409,3578721891,3578721908,17
2,835,10410,3578721891,3578721909,18
2,835,10411,3578721891,3578721912,21
2,835,10412,3578721891,3578721912,21
2,835,10413,3578721891,3578721912,21
2,835,10414,3578721891,3578721913,22
2,835,10415,3578721891,3578721913,22
2,835,10416,3578721891,3578721913,22
2,835,10417,3578721891,3578721915,24
2,835,10418,3578721891,3578721916,25
2,835,10419,3578721891,3578721917,26
2,835,10420,3578721891,3578721918,27
2,835,10421,3578721891,3578721920,29
2,835,10422,3578721891,3578721921,30
2,835,10423,3578721891,3578721921,30
2,835,10424,3578721891,3578721926,35
2,835,10425,3578721891,3578721927,36
2,835,10426,3578721891,3578721929,38
2,835,10427,3578721891,3578721932,41
2,835,10428,3578721891,3578721933,42
2,835,10429,3578721891,3578721933,42
2,835,10430,3578721891,3578721934,43
2,835,10431,3578721891,3578721935,44
2,835,10432,3578721891,3578721935,44
2,835,10433,3578721891,3578721937,46
2,835,10434,3578721891,3578721937,46
2,835,10435,3578721891,3578721937,46
2,836,10436,3578721946,3578721946,0
2,836,10437,3578721946,3578721950,4
2,836,10438,3578721946,3578721950,4
2,836,10439,3578721946,3578721952,6
2,836,10440,3578721946,3578721953,7
2,836,10441,3578721946,3578721953,7
2,836,10442,3578721946,3578721954,8
2,836,10443,3578721946,3578721955,9
2,836,10444,3578721946,3578721956,10
2,836,10445,3578721946,3578721960,14
2,836,10446,3578721946,3578721963,17
2,836,10447,3578721946,3578721965,19
2,836,10448,3578721946,3578721965,19
2,836,10449,3578721946,3578721967,21
2,836,10450,3578721946,3578721967,21
2,836,10451,3578721946,3578721968,22
2,836,10452,3578721946,3578721968,22
2,836,10453,3578721946,3578721968,22
2,836,10454,3578721946,3578721973,27
2,836,10455,3578721946,3578721976,30
2,836,10456,3578721946,3578721977,31
2,836,10457,3578721946,3578721981,35
2,836,10458,3578721946,3578721985,39
2,836,10459,3578721946,3578721986,40
2,836,10460,3578721946,3578721988,42
2,836,10461,3578721946,3578721990,44
2,836,10462,3578721946,3578721990,44
2,836,10463,3578721946,3578721991,45
2,836,10464,3578721946,3578721992,46
2,836,10465,3578721946,3578721995,49
2,837,10466,3578722002,3578722002,0
2,837,10467,3578722002,3578722002,0
2,837,10468,3578722002,3578722002,0
2,837,10469,3578722002,3578722003,1
2,837,10470,3578722002,3578722003,1
2,837,10471,3578722002,3578722004,2
2,837,10472,3578722002,3578722007,5
2,837,10473,3578722002,3578722009,7
2,837,10474,3578722002,3578722012,10
2,837,10475,3578722002,3578722012,10
2,837,10476,3578722002,3578722013,11
2,837,10477,3578722002,3578722015,13
2,837,10478,3578722002,3578722015,13
2,837,10479,3578722002,3578722017,15
2,837,10480,3578722002,3578722018,16
2,837,10481,3578722002,3578722019,17
2,837,10482,3578722002,3578722020,18
2,837,10483,3578722002,3578722022,20
2,837,10484,3578722002,3578722026,24
2,837,10485,3578722002,3578722027,25
2,837,10486,3578722002,3578722028,26
2,837,10487,3578722002,3578722029,27
2,837,10488,3578722002,3578722030,28
2,837,10489,3578722002,3578722030,28
2,837,10490,3578722002,3578722032,30
2,837,10491,3578722002,3578722033,31
2,837,10492,3578722002,3578722033,31
2,837,10493,3578722002,3578722036,34
2,837,10494,3578722002,3578722037,35
2,837,10495,3578722002,3578722038,36
2,837,10496,3578722002,3578722038,36
2,837,10497,3578722002,3578722039,37
2,837,10498,3578722002,3578722041,39
2,837,10499,3578722002,3578722041,39
2,837,10500,3578722002,3578722042,40
2,837,10501,3578722002,3578722042,40
2,837,10502,3578722002,3578722043,41
2,837,10503,3578722002,3578722043,41
2,837,10504,3578722002,3578722046,44
2,837,10505,3578722002,3578722046,44
2,837,10506,3578722002,3578722047,45
2,837,10507,3578722002,3578722050,48
2,837,10508,3578722002,3578722050,48
2,837,10509,3578722002,3578722051,49
2,838,10510,3578722057,3578722057,0
2,838,10511,3578722057,3578722057,0
2,838,10512,3578722057,3578722057,0
2,838,10513,3578722057,3578722057,0
2,838,10514,3578722057,3578722060,3
2,838,10515,3578722057,3578722065,8
2,838,10516,3578722057,3578722065,8
2,838,10517,3578722057,3578722067,10
2,838,10518,3578722057,3578722067,10
2,838,10519,3578722057,3578722069,12
2,838,10520,3578722057,3578722070,13
2,838,10521,3578722057,3578722075,18
2,838,10522,3578722057,3578722079,22
2,838,10523,3578722057,3578722079,22
2,838,10524,3578722057,3578722081,24
2,838,10525,3578722057,3578722081,24
2,838,10526,3578722057,3578722083,26
2,838,10527,3578722057,3578722084,27
2,838,10528,3578722057,3578722084,27
2,838,10529,3578722057,3578722085,28
2,838,10530,3578722057,3578722085,28
2,838,10531,3578722057,3578722086,29
2,838,10532,3578722057,3578722086,29
2,838,10533,3578722057,3578722088,31
2,838,10534,3578722057,3578722093,36
2,838,10535,3578722057,3578722093,36
2,838,10536,3578722057,3578722093,36
2,838,10537,3578722057,3578722096,39
2,838,10538,3578722057,3578722096,39
2,838,10539,3578722057,3578722096,39
2,838,10540,3578722057,3578722096,39
2,838,10541,3578722057,3578722097,40
2,838,10542,3578722057,3578722097,40
2,838,10543,3578722057,3578722097,40
2,838,10544,3578722057,3578722100,43
2,838,10545,3578722057,3578722100,43
2,838,10546,3578722057,3578722101,44
2,838,10547,3578722057,3578722101,44
2,838,10548,3578722057,3578722106,49
2,838,10549,3578722057,3578722106,49
2,839,10550,3578722113,3578722113,0
2,839,10551,3578722113,3578722113,0
2,839,10552,3578722113,3578722113,0
2,839,10553,3578722113,3578722113,0
2,839,10554,3578722113,3578722113,0
2,839,10555,3578722113,3578722113,0
2,839,10556,3578722113,3578722113,0
2,839,10557,3578722113,3578722113,0
2,839,10558,3578722113,3578722114,1
2,839,10559,3578722113,3578722115,2
2,839,10560,3578722113,3578722116,3
2,839,10561,3578722113,3578722117,4
2,839,10562,3578722113,3578722118,5
2,839,10563,3578722113,3578722120,7
2,839,10564,3578722113,3578722121,8
2,839,10565,3578722113,3578722122,9
2,839,10566,3578722113,3578722125,12
2,839,10567,3578722113,3578722127,14
2,839,10568,3578722113,3578722128,15
2,839,10569,3578722113,3578722131,18
2,839,10570,3578722113,3578722134,21
2,839,10571,3578722113,3578722134,21
2,839,10572,3578722113,3578722134,21
2,839,10573,3578722113,3578722135,22
2,839,10574,3578722113,3578722135,22
2,839,10575,3578722113,3578722137,24
2,839,10576,3578722113,3578722138,25
2,839,10577,3578722113,3578722138,25
2,839,10578,3578722113,3578722146,33
2,839,10579,3578722113,3578722151,38
2,839,10580,3578722113,3578722153,40
2,839,10581,3578722113,3578722153,40
2,839,10582,3578722113,3578722154,41
2,839,10583,3578722113,3578722155,42
2,839,10584,3578722113,3578722155,42
2,839,10585,3578722113,3578722157,44
2,840,10586,3578722168,3578722168,0
2,840,10587,3578722168,3578722168,0
2,840,10588,3578722168,3578722168,0
2,840,10589,3578722168,3578722168,0
2,840,10590,3578722168,3578722168,0
2,840,10591,3578722168,3578722168,0
2,840,10592,3578722168,3578722168,0
2,840,10593,3578722168,3578722172,4
2,840,10594,3578722168,3578722176,8
2,840,10595,3578722168,3578722177,9
2,840,10596,3578722168,3578722180,12
2,840,10597,3578722168,3578722181,13
2,840,10598,3578722168,3578722185,17
2,840,10599,3578722168,3578722186,18
2,840,10600,3578722168,3578722186,18
2,840,10601,3578722168,3578722189,21
2,840,10602,3578722168,3578722190,22
2,840,10603,3578722168,3578722190,22
2,840,10604,3578722168,3578722191,23
2,840,10605,3578722168,3578722193,25
2,840,10606,3578722168,3578722194,26
2,840,10607,3578722168,3578722195,27
2,840,10608,3578722168,3578722196,28
2,840,10609,3578722168,3578722200,32
2,840,10610,3578722168,3578722200,32
2,840,10611,3578722168,3578722203,35
2,840,10612,3578722168,3578722204,36
2,840,10613,3578722168,3578722204,36
2,840,10614,3578722168,3578722207,39
2,840,10615,3578722168,3578722209,41
2,840,10616,3578722168,3578722209,41
2,840,10617,3578722168,3578722212,44
2,840,10618,3578722168,3578722213,45
2,840,10619,3578722168,3578722216,48
2,840,10620,3578722168,3578722217,49
2,841,10621,3578722224,3578722224,0
2,841,10622,3578722224,3578722224,0
2,841,10623,3578722224,3578722224,0
2,841,10624,3578722224,3578722224,0
2,841,10625,3578722224,3578722224,0
2,841,10626,3578722224,3578722226,2
2,841,10627,3578722224,3578722227,3
2,841,10628,3578722224,3578722228,4
2,841,10629,3578722224,3578722229,5
2,841,10630,3578722224,3578722230,6
2,841,10631,3578722224,3578722232,8
2,841,10632,3578722224,3578722232,8
2,841,10633,3578722224,3578722234,10
2,841,10634,3578722224,3578722236,12
2,841,10635,3578722224,3578722236,12
2,841,10636,3578722224,3578722237,13
2,841,10637,3578722224,3578722237,13
2,841,10638,3578722224,3578722238,14
2,841,10639,3578722224,3578722239,15
2,841,10640,3578722224,3578722240,16
2,841,10641,3578722224,3578722242,18
2,841,10642,3578722224,3578722242,18
2,841,10643,3578722224,3578722242,18
2,841,10644,3578722224,3578722242,18
2,841,10645,3578722224,3578722243,19
2,841,10646,3578722224,3578722246,22
2,841,10647,3578722224,3578722247,23
2,841,10648,3578722224,3578722247,23
2,841,10649,3578722224,3578722249,25
2,841,10650,3578722224,3578722250,26
2,841,10651,3578722224,3578722252,28
2,841,10652,3578722224,3578722253,29
2,841,10653,3578722224,3578722255,31
2,841,10654,3578722224,3578722255,31
2,841,10655,3578722224,3578722258,34
2,841,10656,3578722224,3578722261,37
2,841,10657,3578722224,3578722265,41
2,841,10658,3578722224,3578722265,41
2,841,10659,3578722224,3578722267,43
2,841,10660,3578722224,3578722267,43
2,841,10661,3578722224,3578722269,45
2,841,10662,3578722224,3578722270,46
2,841,10663,3578722224,3578722270,46
2,842,10664,3578722280,3578722280,0
2,842,10665,3578722280,3578722280,0
2,842,10666,3578722280,3578722280,0
2,842,10667,3578722280,3578722281,1
2,842,10668,3578722280,3578722283,3
2,842,10669,3578722280,3578722283,3
2,842,10670,3578722280,3578722284,4
2,842,10671,3578722280,3578722284,4
2,842,10672,3578722280,3578722285,5
2,842,10673,3578722280,3578722286,6
2,842,10674,3578722280,3578722286,6
2,842,10675,3578722280,3578722287,7
2,842,10676,3578722280,3578722292,12
2,842,10677,3578722280,3578722293,13
2,842,10678,3578722280,3578722293,13
2,842,10679,3578722280,3578722295,15
2,842,10680,3578722280,3578722295,15
2,842,10681,3578722280,3578722295,15
2,842,10682,3578722280,3578722297,17
2,842,10683,3578722280,3578722297,17
2,842,10684,3578722280,3578722297,17
2,842,10685,3578722280,3578722298,18
2,842,10686,3578722280,3578722300,20
2,842,10687,3578722280,3578722301,21
2,842,10688,3578722280,3578722301,21
2,842,10689,3578722280,3578722302,22
2,842,10690,3578722280,3578722306,26
2,842,10691,3578722280,3578722306,26
2,842,10692,3578722280,3578722307,27
2,842,10693,3578722280,3578722307,27
2,842,10694,3578722280,3578722310,30
2,842,10695,3578722280,3578722311,31
2,842,10696,3578722280,3578722312,32
2,842,10697,3578722280,3578722313,33
2,842,10698,3578722280,3578722313,33
2,842,10699,3578722280,3578722313,33
2,842,10700,3578722280,3578722313,33
2,842,10701,3578722280,3578722316,36
2,842,10702,3578722280,3578722317,37
2,842,10703,3578722280,3578722317,37
2,842,10704,3578722280,3578722319,39
2,842,10705,3578722280,3578722321,41
2,842,10706,3578722280,3578722321,41
2,842,10707,3578722280,3578722323,43
2,842,10708,3578722280,3578722325,45
2,842,10709,3578722280,3578722327,47
2,842,10710,3578722280,3578722329,49
2,843,10711,3578722336,3578722336,0
2,843,10712,3578722336,3578722336,0
2,843,10713,3578722336,3578722336,0
2,843,10714,3578722336,3578722336,0
2,843,10715,3578722336,3578722336,0
2,843,10716,3578722336,3578722336,0
2,843,10717,3578722336,3578722337,1
2,843,10718,3578722336,3578722338,2
2,843,10719,3578722336,3578722338,2
2,843,10720,3578722336,3578722346,10
2,843,10721,3578722336,3578722351,15
2,843,10722,3578722336,3578722353,17
2,843,10723,3578722336,3578722354,18
2,843,10724,3578722336,3578722355,19
2,843,10725,3578722336,3578722355,19
2,843,10726,3578722336,3578722355,19
2,843,10727,3578722336,3578722356,20
2,843,10728,3578722336,3578722365,29
2,843,10729,3578722336,3578722367,31
2,843,10730,3578722336,3578722368,32
2,843,10731,3578722336,3578722369,33
2,843,10732,3578722336,3578722369,33
2,843,10733,3578722336,3578722369,33
2,843,10734,3578722336,3578722373,37
2,843,10735,3578722336,3578722376,40
2,843,10736,3578722336,3578722377,41
2,843,10737,3578722336,3578722380,44
2,843,10738,3578722336,3578722381,45
2,843,10739,3578722336,3578722385,49
2,844,10740,3578722392,3578722392,0
2,844,10741,3578722392,3578722392,0
2,844,10742,3578722392,3578722392,0
2,844,10743,3578722392,3578722392,0
2,844,10744,3578722392,3578722392,0
2,844,10745,3578722392,3578722394,2
2,844,10746,3578722392,3578722395,3
2,844,10747,3578722392,3578722396,4
2,844,10748,3578722392,3578722400,8
2,844,10749,3578722392,3578722400,8
2,844,10750,3578722392,3578722403,11
2,844,10751,3578722392,3578722404,12
2,844,10752,3578722392,3578722407,15
2,844,10753,3578722392,3578722409,17
2,844,10754,3578722392,3578722409,17
2,844,10755,3578722392,3578722412,20
2,844,10756,3578722392,3578722413,21
2,844,10757,3578722392,3578722416,24
2,844,10758,3578722392,3578722417,25
2,844,10759,3578722392,3578722418,26
2,844,10760,3578722392,3578722419,27
2,844,10761,3578722392,3578722420,28
2,844,10762,3578722392,3578722420,28
2,844,10763,3578722392,3578722422,30
2,844,10764,3578722392,3578722426,34
2,844,10765,3578722392,3578722428,36
2,844,10766,3578722392,3578722429,37
2,844,10767,3578722392,3578722430,38
2,844,10768,3578722392,3578722430,38
2,844,10769,3578722392,3578722432,40
2,844,10770,3578722392,3578722433,41
2,844,10771,3578722392,3578722434,42
2,844,10772,3578722392,3578722437,45
2,844,10773,3578722392,3578722438,46
2,844,10774,3578722392,3578722438,46
2,844,10775,3578722392,3578722439,47
2,844,10776,3578722392,3578722441,49
2,844,10777,3578722392,3578722442,50
2,845,10778,3578722447,3578722447,0
2,845,10779,3578722447,3578722447,0
2,845,10780,3578722447,3578722447,0
2,845,10781,3578722447,3578722447,0
2,845,10782,3578722447,3578722447,0
2,845,10783,3578722447,3578722447,0
2,845,10784,3578722447,3578722447,0
2,845,10785,3578722447,3578722450,3
2,845,10786,3578722447,3578722450,3
2,845,10787,3578722447,3578722452,5
2,845,10788,3578722447,3578722453,6
2,845,10789,3578722447,3578722455,8
2,845,10790,3578722447,3578722455,8
2,845,10791,3578722447,3578722458,11
2,845,10792,3578722447,3578722461,14
2,845,10793,3578722447,3578722465,18
2,845,10794,3578722447,3578722466,19
2,845,10795,3578722447,3578722467,20
2,845,10796,3578722447,3578722468,21
2,845,10797,3578722447,3578722469,22
2,845,10798,3578722447,3578722470,23
2,845,10799,3578722447,3578722476,29
2,845,10800,3578722447,3578722478,31
2,845,10801,3578722447,3578722479,32
2,845,10802,3578722447,3578722481,34
2,845,10803,3578722447,3578722483,36
2,845,10804,3578722447,3578722483,36
2,845,10805,3578722447,3578722484,37
2,845,10806,3578722447,3578722485,38
2,845,10807,3578722447,3578722486,39
2,845,10808,3578722447,3578722486,39
2,845,10809,3578722447,3578722487,40
2,845,10810,3578722447,3578722487,40
2,845,10811,3578722447,3578722492,45
2,845,10812,3578722447,3578722492,45
2,845,10813,3578722447,3578722493,46
2,845,10814,3578722447,3578722496,49
2,845,10815,3578722447,3578722496,49
2,845,10816,3578722447,3578722496,49
2,845,10817,3578722447,3578722496,49
2,845,10818,3578722447,3578722496,49
2,845,10819,3578722447,3578722497,50
2,846,10820,3578722502,3578722502,0
2,846,10821,3578722502,3578722502,0
2,846,10822,3578722502,3578722502,0
2,846,10823,3578722502,3578722502,0
2,846,10824,3578722502,3578722502,0
2,846,10825,3578722502,3578722505,3
2,846,10826,3578722502,3578722506,4
2,846,10827,3578722502,3578722507,5
2,846,10828,3578722502,3578722507,5
2,846,10829,3578722502,3578722508,6
2,846,10830,3578722502,3578722510,8
2,846,10831,3578722502,3578722510,8
2,846,10832,3578722502,3578722511,9
2,846,10833,3578722502,3578722511,9
2,846,10834,3578722502,3578722512,10
2,846,10835,3578722502,3578722512,10
2,846,10836,3578722502,3578722512,10
2,846,10837,3578722502,3578722513,11
2,846,10838,3578722502,3578722515,13
2,846,10839,3578722502,3578722516,14
2,846,10840,3578722502,3578722516,14
2,846,10841,3578722502,3578722518,16
2,846,10842,3578722502,3578722519,17
2,846,10843,3578722502,3578722520,18
2,846,10844,3578722502,3578722521,19
2,846,10845,3578722502,3578722524,22
2,846,10846,3578722502,3578722526,24
2,846,10847,3578722502,3578722527,25
2,846,10848,3578722502,3578722531,29
2,846,10849,3578722502,3578722532,30
2,846,10850,3578722502,3578722533,31
2,846,10851,3578722502,3578722534,32
2,846,10852,3578722502,3578722534,32
2,846,10853,3578722502,3578722534,32
2,846,10854,3578722502,3578722536,34
2,846,10855,3578722502,3578722536,34
2,846,10856,3578722502,3578722536,34
2,846,10857,3578722502,3578722545,43
2,846,10858,3578722502,3578722550,48
2,846,10859,3578722502,3578722552,50
2,847,10860,3578722558,3578722558,0
2,847,10861,3578722558,3578722558,0
2,847,10862,3578722558,3578722558,0
2,847,10863,3578722558,3578722558,0
2,847,10864,3578722558,3578722558,0
2,847,10865,3578722558,3578722562,4
2,847,10866,3578722558,3578722563,5
2,847,10867,3578722558,3578722564,6
2,847,10868,3578722558,3578722566,8
2,847,10869,3578722558,3578722567,9
2,847,10870,3578722558,3578722567,9
2,847,10871,3578722558,3578722568,10
2,847,10872,3578722558,3578722569,11
2,847,10873,3578722558,3578722571,13
2,847,10874,3578722558,3578722575,17
2,847,10875,3578722558,3578722575,17
2,847,10876,3578722558,3578722578,20
2,847,10877,3578722558,3578722579,21
2,847,10878,3578722558,3578722581,23
2,847,10879,3578722558,3578722584,26
2,847,10880,3578722558,3578722585,27
2,847,10881,3578722558,3578722590,32
2,847,10882,3578722558,3578722590,32
2,847,10883,3578722558,3578722590,32
2,847,10884,3578722558,3578722593,35
2,847,10885,3578722558,3578722594,36
2,847,10886,3578722558,3578722595,37
2,847,10887,3578722558,3578722599,41
2,847,10888,3578722558,3578722599,41
2,847,10889,3578722558,3578722602,44
2,847,10890,3578722558,3578722602,44
2,847,10891,3578722558,3578722607,49
2,848,10892,3578722614,3578722614,0
2,848,10893,3578722614,3578722614,0
2,848,10894,3578722614,3578722614,0
2,848,10895,3578722614,3578722614,0
2,848,10896,3578722614,3578722614,0
2,848,10897,3578722614,3578722616,2
2,848,10898,3578722614,3578722619,5
2,848,10899,3578722614,3578722619,5
2,848,10900,3578722614,3578722620,6
2,848,10901,3578722614,3578722621,7
2,848,10902,3578722614,3578722626,12
2,848,10903,3578722614,3578722627,13
2,848,10904,3578722614,3578722627,13
2,848,10905,3578722614,3578722628,14
2,848,10906,3578722614,3578722629,15
2,848,10907,3578722614,3578722629,15
2,848,10908,3578722614,3578722632,18
2,848,10909,3578722614,3578722633,19
2,848,10910,3578722614,3578722636,22
2,848,10911,3578722614,3578722636,22
2,848,10912,3578722614,3578722636,22
2,848,10913,3578722614,3578722637,23
2,848,10914,3578722614,3578722638,24
2,848,10915,3578722614,3578722640,26
2,848,10916,3578722614,3578722641,27
2,848,10917,3578722614,3578722641,27
2,848,10918,3578722614,3578722642,28
2,848,10919,3578722614,3578722644,30
2,848,10920,3578722614,3578722646,32
2,848,10921,3578722614,3578722646,32
2,848,10922,3578722614,3578722646,32
2,848,10923,3578722614,3578722648,34
2,848,10924,3578722614,3578722650,36
2,848,10925,3578722614,3578722651,37
2,848,10926,3578722614,3578722652,38
2,848,10927,3578722614,3578722654,40
2,848,10928,3578722614,3578722655,41
2,848,10929,3578722614,3578722657,43
2,848,10930,3578722614,3578722660,46
2,848,10931,3578722614,3578722661,47
2,848,10932,3578722614,3578722664,50
2,849,10933,3578722669,3578722669,0
2,849,10934,3578722669,3578722669,0
2,849,10935,3578722669,3578722669,0
2,849,10936,3578722669,3578722669,0
2,849,10937,3578722669,3578722670,1
2,849,10938,3578722669,3578722670,1
2,849,10939,3578722669,3578722676,7
2,849,10940,3578722669,3578722679,10
2,849,10941,3578722669,3578722679,10
2,849,10942,3578722669,3578722681,12
2,849,10943,3578722669,3578722683,14
2,849,10944,3578722669,3578722684,15
2,849,10945,3578722669,3578722685,16
2,849,10946,3578722669,3578722685,16
2,849,10947,3578722669,3578722686,17
2,849,10948,3578722669,3578722687,18
2,849,10949,3578722669,3578722688,19
2,849,10950,3578722669,3578722692,23
2,849,10951,3578722669,3578722693,24
2,849,10952,3578722669,3578722694,25
2,849,10953,3578722669,3578722695,26
2,849,10954,3578722669,3578722696,27
2,849,10955,3578722669,3578722696,27
2,849,10956,3578722669,3578722697,28
2,849,10957,3578722669,3578722697,28
2,849,10958,3578722669,3578722697,28
2,849,10959,3578722669,3578722698,29
2,849,10960,3578722669,3578722700,31
2,849,10961,3578722669,3578722700,31
2,849,10962,3578722669,3578722700,31
2,849,10963,3578722669,3578722701,32
2,849,10964,3578722669,3578722705,36
2,849,10965,3578722669,3578722706,37
2,849,10966,3578722669,3578722707,38
2,849,10967,3578722669,3578722707,38
2,849,10968,3578722669,3578722707,38
2,849,10969,3578722669,3578722708,39
2,849,10970,3578722669,3578722708,39
2,849,10971,3578722669,3578722710,41
2,849,10972,3578722669,3578722710,41
2,849,10973,3578722669,3578722712,43
2,849,10974,3578722669,3578722712,43
2,849,10975,3578722669,3578722712,43
2,849,10976,3578722669,3578722712,43
2,849,10977,3578722669,3578722713,44
2,849,10978,3578722669,3578722713,44
2,849,10979,3578722669,3578722714,45
2,849,10980,3578722669,3578722716,47
2,849,10981,3578722669,3578722717,48
2,849,10982,3578722669,3578722718,49
2,850,10983,3578722726,3578722726,0
2,850,10984,3578722726,3578722726,0
2,850,10985,3578722726,3578722726,0
2,850,10986,3578722726,3578722727,1
2,850,10987,3578722726,3578722727,1
2,850,10988,3578722726,3578722732,6
2,850,10989,3578722726,3578722732,6
2,850,10990,3578722726,3578722734,8
2,850,10991,3578722726,3578722734,8
2,850,10992,3578722726,3578722735,9
2,850,10993,3578722726,3578722735,9
2,850,10994,3578722726,3578722737,11
2,850,10995,3578722726,3578722737,11
2,850,10996,3578722726,3578722745,19
2,850,10997,3578722726,3578722750,24
2,850,10998,3578722726,3578722751,25
2,850,10999,3578722726,3578722752,26
2,850,11000,3578722726,3578722753,27
2,850,11001,3578722726,3578722754,28
2,850,11002,3578722726,3578722754,28
2,850,11003,3578722726,3578722755,29
2,850,11004,3578722726,3578722756,30
2,850,11005,3578722726,3578722757,31
2,850,11006,3578722726,3578722759,33
2,850,11007,3578722726,3578722762,36
2,850,11008,3578722726,3578722764,38
2,850,11009,3578722726,3578722766,40
2,850,11010,3578722726,3578722767,41
2,850,11011,3578722726,3578722768,42
2,850,11012,3578722726,3578722768,42
2,850,11013,3578722726,3578722769,43
2,850,11014,3578722726,3578722772,46
2,850,11015,3578722726,3578722775,49
2,850,11016,3578722726,3578722776,50
2,851,11017,3578722782,3578722782,0
2,851,11018,3578722782,3578722782,0
2,851,11019,3578722782,3578722782,0
2,851,11020,3578722782,3578722784,2
2,851,11021,3578722782,3578722788,6
2,851,11022,3578722782,3578722789,7
2,851,11023,3578722782,3578722789,7
2,851,11024,3578722782,3578722790,8
2,851,11025,3578722782,3578722793,11
2,851,11026,3578722782,3578722795,13
2,851,11027,3578722782,3578722797,15
2,851,11028,3578722782,3578722799,17
2,851,11029,3578722782,3578722799,17
2,851,11030,3578722782,3578722802,20
2,851,11031,3578722782,3578722802,20
2,851,11032,3578722782,3578722807,25
2,851,11033,3578722782,3578722808,26
2,851,11034,3578722782,3578722808,26
2,851,11035,3578722782,3578722809,27
2,851,11036,3578722782,3578722811,29
2,851,11037,3578722782,3578722812,30
2,851,11038,3578722782,3578722813,31
2,851,11039,3578722782,3578722815,33
2,851,11040,3578722782,3578722816,34
2,851,11041,3578722782,3578722818,36
2,851,11042,3578722782,3578722818,36
2,851,11043,3578722782,3578722819,37
2,851,11044,3578722782,3578722820,38
2,851,11045,3578722782,3578722822,40
2,851,11046,3578722782,3578722826,44
2,851,11047,3578722782,3578722827,45
2,851,11048,3578722782,3578722827,45
2,851,11049,3578722782,3578722828,46
2,851,11050,3578722782,3578722830,48
2,852,11051,3578722838,3578722838,0
2,852,11052,3578722838,3578722838,0
2,852,11053,3578722838,3578722838,0
2,852,11054,3578722838,3578722838,0
2,852,11055,3578722838,3578722838,0
2,852,11056,3578722838,3578722838,0
2,852,11057,3578722838,3578722838,0
2,852,11058,3578722838,3578722839,1
2,852,11059,3578722838,3578722841,3
2,852,11060,3578722838,3578722841,3
2,852,11061,3578722838,3578722841,3
2,852,11062,3578722838,3578722841,3
2,852,11063,3578722838,3578722844,6
2,852,11064,3578722838,3578722846,8
2,852,11065,3578722838,3578722846,8
2,852,11066,3578722838,3578722848,10
2,852,11067,3578722838,3578722849,11
2,852,11068,3578722838,3578722851,13
2,852,11069,3578722838,3578722853,15
2,852,11070,3578722838,3578722854,16
2,852,11071,3578722838,3578722854,16
2,852,11072,3578722838,3578722857,19
2,852,11073,3578722838,3578722858,20
2,852,11074,3578722838,3578722860,22
2,852,11075,3578722838,3578722862,24
2,852,11076,3578722838,3578722864,26
2,852,11077,3578722838,3578722866,28
2,852,11078,3578722838,3578722867,29
2,852,11079,3578722838,3578722868,30
2,852,11080,3578722838,3578722868,30
2,852,11081,3578722838,3578722870,32
2,852,11082,3578722838,3578722877,39
2,852,11083,3578722838,3578722879,41
2,852,11084,3578722838,3578722879,41
2,852,11085,3578722838,3578722881,43
2,852,11086,3578722838,3578722884,46
2,852,11087,3578722838,3578722884,46
2,852,11088,3578722838,3578722885,47
2,852,11089,3578722838,3578722886,48
2,852,11090,3578722838,3578722886,48
2,852,11091,3578722838,3578722887,49
2,852,11092,3578722838,3578722887,49
2,853,11093,3578722894,3578722894,0
2,853,11094,3578722894,3578722894,0
2,853,11095,3578722894,3578722896,2
2,853,11096,3578722894,3578722896,2
2,853,11097,3578722894,3578722896,2
2,853,11098,3578722894,3578722896,2
2,853,11099,3578722894,3578722897,3
2,853,11100,3578722894,3578722897,3
2,853,11101,3578722894,3578722897,3
2,853,11102,3578722894,3578722898,4
2,853,11103,3578722894,3578722900,6
2,853,11104,3578722894,3578722900,6
2,853,11105,3578722894,3578722900,6
2,853,11106,3578722894,3578722901,7
2,853,11107,3578722894,3578722906,12
2,853,11108,3578722894,3578722907,13
2,853,11109,3578722894,3578722907,13
2,853,11110,3578722894,3578722907,13
2,853,11111,3578722894,3578722907,13
2,853,11112,3578722894,3578722908,14
2,853,11113,3578722894,3578722908,14
2,853,11114,3578722894,3578722910,16
2,853,11115,3578722894,3578722912,18
2,853,11116,3578722894,3578722912,18
2,853,11117,3578722894,3578722912,18
2,853,11118,3578722894,3578722912,18
2,853,11119,3578722894,3578722913,19
2,853,11120,3578722894,3578722914,20
2,853,11121,3578722894,3578722914,20
2,853,11122,3578722894,3578722914,20
2,853,11123,3578722894,3578722916,22
2,853,11124,3578722894,3578722917,23
2,853,11125,3578722894,3578722919,25
2,853,11126,3578722894,3578722919,25
2,853,11127,3578722894,3578722921,27
2,853,11128,3578722894,3578722926,32
2,853,11129,3578722894,3578722927,33
2,853,11130,3578722894,3578722927,33
2,853,11131,3578722894,3578722932,38
2,853,11132,3578722894,3578722933,39
2,853,11133,3578722894,3578722934,40
2,853,11134,3578722894,3578722934,40
2,853,11135,3578722894,3578722935,41
2,853,11136,3578722894,3578722936,42
2,853,11137,3578722894,3578722937,43
2,854,11138,3578722950,3578722950,0
2,854,11139,3578722950,3578722950,0
2,854,11140,3578722950,3578722952,2
2,854,11141,3578722950,3578722953,3
2,854,11142,3578722950,3578722954,4
2,854,11143,3578722950,3578722954,4
2,854,11144,3578722950,3578722955,5
2,854,11145,3578722950,3578722955,5
2,854,11146,3578722950,3578722957,7
2,854,11147,3578722950,3578722957,7
2,854,11148,3578722950,3578722959,9
2,854,11149,3578722950,3578722963,13
2,854,11150,3578722950,3578722964,14
2,854,11151,3578722950,3578722964,14
2,854,11152,3578722950,3578722965,15
2,854,11153,3578722950,3578722966,16
2,854,11154,3578722950,3578722967,17
2,854,11155,3578722950,3578722967,17
2,854,11156,3578722950,3578722968,18
2,854,11157,3578722950,3578722969,19
2,854,11158,3578722950,3578722972,22
2,854,11159,3578722950,3578722976,26
2,854,11160,3578722950,3578722977,27
2,854,11161,3578722950,3578722978,28
2,854,11162,3578722950,3578722980,30
2,854,11163,3578722950,3578722981,31
2,854,11164,3578722950,3578722985,35
2,854,11165,3578722950,3578722986,36
2,854,11166,3578722950,3578722988,38
2,854,11167,3578722950,3578722989,39
2,854,11168,3578722950,3578722990,40
2,854,11169,3578722950,3578722991,41
2,854,11170,3578722950,3578722993,43
2,854,11171,3578722950,3578722994,44
2,854,11172,3578722950,3578722995,45
2,854,11173,3578722950,3578722997,47
2,854,11174,3578722950,3578722999,49
2,854,11175,3578722950,3578723000,50
2,855,11176,3578723007,3578723007,0
2,855,11177,3578723007,3578723007,0
2,855,11178,3578723007,3578723007,0
2,855,11179,3578723007,3578723008,1
2,855,11180,3578723007,3578723008,1
2,855,11181,3578723007,3578723009,2
2,855,11182,3578723007,3578723011,4
2,855,11183,3578723007,3578723013,6
2,855,11184,3578723007,3578723013,6
2,855,11185,3578723007,3578723014,7
2,855,11186,3578723007,3578723016,9
2,855,11187,3578723007,3578723019,12
2,855,11188,3578723007,3578723019,12
2,855,11189,3578723007,3578723020,13
2,855,11190,3578723007,3578723022,15
2,855,11191,3578723007,3578723026,19
2,855,11192,3578723007,3578723026,19
2,855,11193,3578723007,3578723026,19
2,855,11194,3578723007,3578723028,21
2,855,11195,3578723007,3578723028,21
2,855,11196,3578723007,3578723029,22
2,855,11197,3578723007,3578723032,25
2,855,11198,3578723007,3578723033,26
2,855,11199,3578723007,3578723034,27
2,855,11200,3578723007,3578723036,29
2,855,11201,3578723007,3578723036,29
2,855,11202,3578723007,3578723037,30
2,855,11203,3578723007,3578723037,30
2,855,11204,3578723007,3578723038,31
2,855,11205,3578723007,3578723040,33
2,855,11206,3578723007,3578723041,34
2,855,11207,3578723007,3578723041,34
2,855,11208,3578723007,3578723041,34
2,855,11209,3578723007,3578723042,35
2,855,11210,3578723007,3578723044,37
2,855,11211,3578723007,3578723045,38
2,855,11212,3578723007,3578723046,39
2,855,11213,3578723007,3578723048,41
2,855,11214,3578723007,3578723050,43
2,855,11215,3578723007,3578723050,43
2,855,11216,3578723007,3578723052,45
2,855,11217,3578723007,3578723053,46
2,855,11218,3578723007,3578723053,46
2,855,11219,3578723007,3578723054,47
2,856,11220,3578723063,3578723063,0
2,856,11221,3578723063,3578723063,0
2,856,11222,3578723063,3578723063,0
2,856,11223,3578723063,3578723065,2
2,856,11224,3578723063,3578723066,3
2,856,11225,3578723063,3578723066,3
2,856,11226,3578723063,3578723068,5
2,856,11227,3578723063,3578723069,6
2,856,11228,3578723063,3578723071,8
2,856,11229,3578723063,3578723077,14
2,856,11230,3578723063,3578723078,15
2,856,11231,3578723063,3578723080,17
2,856,11232,3578723063,3578723083,20
2,856,11233,3578723063,3578723084,21
2,856,11234,3578723063,3578723086,23
2,856,11235,3578723063,3578723086,23
2,856,11236,3578723063,3578723087,24
2,856,11237,3578723063,3578723087,24
2,856,11238,3578723063,3578723087,24
2,856,11239,3578723063,3578723092,29
2,856,11240,3578723063,3578723093,30
2,856,11241,3578723063,3578723094,31
2,856,11242,3578723063,3578723096,33
2,856,11243,3578723063,3578723096,33
2,856,11244,3578723063,3578723097,34
2,856,11245,3578723063,3578723097,34
2,856,11246,3578723063,3578723098,35
2,856,11247,3578723063,3578723098,35
2,856,11248,3578723063,3578723098,35
2,856,11249,3578723063,3578723100,37
2,856,11250,3578723063,3578723100,37
2,856,11251,3578723063,3578723101,38
2,856,11252,3578723063,3578723105,42
2,856,11253,3578723063,3578723106,43
2,856,11254,3578723063,3578723107,44
2,856,11255,3578723063,3578723107,44
2,856,11256,3578723063,3578723107,44
2,856,11257,3578723063,3578723108,45
2,856,11258,3578723063,3578723109,46
2,856,11259,3578723063,3578723111,48
2,856,11260,3578723063,3578723112,49
2,856,11261,3578723063,3578723112,49
2,856,11262,3578723063,3578723112,49
2,856,11263,3578723063,3578723113,50
2,857,11264,3578723117,3578723117,0
2,857,11265,3578723117,3578723117,0
2,857,11266,3578723117,3578723117,0
2,857,11267,3578723117,3578723117,0
2,857,11268,3578723117,3578723117,0
2,857,11269,3578723117,3578723118,1
2,857,11270,3578723117,3578723118,1
2,857,11271,3578723117,3578723120,3
2,857,11272,3578723117,3578723122,5
2,857,11273,3578723117,3578723126,9
2,857,11274,3578723117,3578723126,9
2,857,11275,3578723117,3578723128,11
2,857,11276,3578723117,3578723132,15
2,857,11277,3578723117,3578723134,17
2,857,11278,3578723117,3578723134,17
2,857,11279,3578723117,3578723134,17
2,857,11280,3578723117,3578723135,18
2,857,11281,3578723117,3578723138,21
2,857,11282,3578723117,3578723138,21
2,857,11283,3578723117,3578723146,29
2,857,11284,3578723117,3578723150,33
2,857,11285,3578723117,3578723151,34
2,857,11286,3578723117,3578723152,35
2,857,11287,3578723117,3578723153,36
2,857,11288,3578723117,3578723154,37
2,857,11289,3578723117,3578723154,37
2,857,11290,3578723117,3578723155,38
2,857,11291,3578723117,3578723155,38
2,857,11292,3578723117,3578723157,40
2,857,11293,3578723117,3578723159,42
2,857,11294,3578723117,3578723163,46
2,857,11295,3578723117,3578723163,46
2,857,11296,3578723117,3578723165,48
2,857,11297,3578723117,3578723166,49
2,857,11298,3578723117,3578723166,49
2,857,11299,3578723117,3578723167,50
2,858,11300,3578723173,3578723173,0
2,858,11301,3578723173,3578723173,0
2,858,11302,3578723173,3578723173,0
2,858,11303,3578723173,3578723173,0
2,858,11304,3578723173,3578723176,3
2,858,11305,3578723173,3578723176,3
2,858,11306,3578723173,3578723178,5
2,858,11307,3578723173,3578723180,7
2,858,11308,3578723173,3578723181,8
2,858,11309,3578723173,3578723185,12
2,858,11310,3578723173,3578723189,16
2,858,11311,3578723173,3578723190,17
2,858,11312,3578723173,3578723190,17
2,858,11313,3578723173,3578723190,17
2,858,11314,3578723173,3578723193,20
2,858,11315,3578723173,3578723194,21
2,858,11316,3578723173,3578723195,22
2,858,11317,3578723173,3578723197,24
2,858,11318,3578723173,3578723199,26
2,858,11319,3578723173,3578723199,26
2,858,11320,3578723173,3578723202,29
2,858,11321,3578723173,3578723204,31
2,858,11322,3578723173,3578723207,34
2,858,11323,3578723173,3578723207,34
2,858,11324,3578723173,3578723208,35
2,858,11325,3578723173,3578723209,36
2,858,11326,3578723173,3578723211,38
2,858,11327,3578723173,3578723213,40
2,858,11328,3578723173,3578723213,40
2,858,11329,3578723173,3578723215,42
2,858,11330,3578723173,3578723217,44
2,858,11331,3578723173,3578723219,46
2,858,11332,3578723173,3578723219,46
2,858,11333,3578723173,3578723220,47
2,858,11334,3578723173,3578723222,49
2,859,11335,3578723228,3578723228,0
2,859,11336,3578723228,3578723228,0
2,859,11337,3578723228,3578723228,0
2,859,11338,3578723228,3578723228,0
2,859,11339,3578723228,3578723229,1
2,859,11340,3578723228,3578723229,1
2,859,11341,3578723228,3578723230,2
2,859,11342,3578723228,3578723232,4
2,859,11343,3578723228,3578723233,5
2,859,11344,3578723228,3578723234,6
2,859,11345,3578723228,3578723236,8
2,859,11346,3578723228,3578723236,8
2,859,11347,3578723228,3578723237,9
2,859,11348,3578723228,3578723239,11
2,859,11349,3578723228,3578723241,13
2,859,11350,3578723228,3578723241,13
2,859,11351,3578723228,3578723242,14
2,859,11352,3578723228,3578723242,14
2,859,11353,3578723228,3578723242,14
2,859,11354,3578723228,3578723242,14
2,859,11355,3578723228,3578723244,16
2,859,11356,3578723228,3578723246,18
2,859,11357,3578723228,3578723246,18
2,859,11358,3578723228,3578723248,20
2,859,11359,3578723228,3578723250,22
2,859,11360,3578723228,3578723251,23
2,859,11361,3578723228,3578723253,25
2,859,11362,3578723228,3578723255,27
2,859,11363,3578723228,3578723255,27
2,859,11364,3578723228,3578723258,30
2,859,11365,3578723228,3578723260,32
2,859,11366,3578723228,3578723262,34
2,859,11367,3578723228,3578723265,37
2,859,11368,3578723228,3578723266,38
2,859,11369,3578723228,3578723268,40
2,859,11370,3578723228,3578723269,41
2,859,11371,3578723228,3578723269,41
2,859,11372,3578723228,3578723270,42
2,859,11373,3578723228,3578723277,49
2,860,11374,3578723284,3578723284,0
2,860,11375,3578723284,3578723284,0
2,860,11376,3578723284,3578723284,0
2,860,11377,3578723284,3578723284,0
2,860,11378,3578723284,3578723284,0
2,860,11379,3578723284,3578723285,1
2,860,11380,3578723284,3578723285,1
2,860,11381,3578723284,3578723287,3
2,860,11382,3578723284,3578723287,3
2,860,11383,3578723284,3578723288,4
2,860,11384,3578723284,3578723292,8
2,860,11385,3578723284,3578723294,10
2,860,11386,3578723284,3578723296,12
2,860,11387,3578723284,3578723296,12
2,860,11388,3578723284,3578723297,13
2,860,11389,3578723284,3578723298,14
2,860,11390,3578723284,3578723298,14
2,860,11391,3578723284,3578723298,14
2,860,11392,3578723284,3578723298,14
2,860,11393,3578723284,3578723299,15
2,860,11394,3578723284,3578723300,16
2,860,11395,3578723284,3578723301,17
2,860,11396,3578723284,3578723301,17
2,860,11397,3578723284,3578723301,17
2,860,11398,3578723284,3578723305,21
2,860,11399,3578723284,3578723307,23
2,860,11400,3578723284,3578723307,23
2,860,11401,3578723284,3578723307,23
2,860,11402,3578723284,3578723308,24
2,860,11403,3578723284,3578723308,24
2,860,11404,3578723284,3578723310,26
2,860,11405,3578723284,3578723310,26
2,860,11406,3578723284,3578723311,27
2,860,11407,3578723284,3578723313,29
2,860,11408,3578723284,3578723313,29
2,860,11409,3578723284,3578723313,29
2,860,11410,3578723284,3578723313,29
2,860,11411,3578723284,3578723314,30
2,860,11412,3578723284,3578723315,31
2,860,11413,3578723284,3578723316,32
2,860,11414,3578723284,3578723317,33
2,860,11415,3578723284,3578723318,34
2,860,11416,3578723284,3578723318,34
2,860,11417,3578723284,3578723319,35
2,860,11418,3578723284,3578723321,37
2,860,11419,3578723284,3578723322,38
2,860,11420,3578723284,3578723325,41
2,860,11421,3578723284,3578723326,42
2,860,11422,3578723284,3578723329,45
2,860,11423,3578723284,3578723333,49
2,860,11424,3578723284,3578723333,49
2,861,11425,3578723340,3578723340,0
2,861,11426,3578723340,3578723340,0
2,861,11427,3578723340,3578723340,0
2,861,11428,3578723340,3578723340,0
2,861,11429,3578723340,3578723340,0
2,861,11430,3578723340,3578723340,0
2,861,11431,3578723340,3578723346,6
2,861,11432,3578723340,3578723351,11
2,861,11433,3578723340,3578723351,11
2,861,11434,3578723340,3578723353,13
2,861,11435,3578723340,3578723354,14
2,861,11436,3578723340,3578723354,14
2,861,11437,3578723340,3578723355,15
2,861,11438,3578723340,3578723355,15
2,861,11439,3578723340,3578723356,16
2,861,11440,3578723340,3578723357,17
2,861,11441,3578723340,3578723360,20
2,861,11442,3578723340,3578723363,23
2,861,11443,3578723340,3578723364,24
2,861,11444,3578723340,3578723364,24
2,861,11445,3578723340,3578723366,26
2,861,11446,3578723340,3578723366,26
2,861,11447,3578723340,3578723367,27
2,861,11448,3578723340,3578723368,28
2,861,11449,3578723340,3578723369,29
2,861,11450,3578723340,3578723371,31
2,861,11451,3578723340,3578723373,33
2,861,11452,3578723340,3578723377,37
2,861,11453,3578723340,3578723377,37
2,861,11454,3578723340,3578723379,39
2,861,11455,3578723340,3578723380,40
2,861,11456,3578723340,3578723382,42
2,861,11457,3578723340,3578723384,44
2,861,11458,3578723340,3578723386,46
2,861,11459,3578723340,3578723389,49
2,861,11460,3578723340,3578723389,49
2,861,11461,3578723340,3578723390,50
2,862,11462,3578723398,3578723398,0
2,862,11463,3578723398,3578723398,0
2,862,11464,3578723398,3578723398,0
2,862,11465,3578723398,3578723398,0
2,862,11466,3578723398,3578723398,0
2,862,11467,3578723398,3578723399,1
2,862,11468,3578723398,3578723400,2
2,862,11469,3578723398,3578723402,4
2,862,11470,3578723398,3578723404,6
2,862,11471,3578723398,3578723408,10
2,862,11472,3578723398,3578723408,10
2,862,11473,3578723398,3578723408,10
2,862,11474,3578723398,3578723409,11
2,862,11475,3578723398,3578723411,13
2,862,11476,3578723398,3578723413,15
2,862,11477,3578723398,3578723414,16
2,862,11478,3578723398,3578723415,17
2,862,11479,3578723398,3578723416,18
2,862,11480,3578723398,3578723419,21
2,862,11481,3578723398,3578723419,21
2,862,11482,3578723398,3578723419,21
2,862,11483,3578723398,3578723420,22
2,862,11484,3578723398,3578723422,24
2,862,11485,3578723398,3578723423,25
2,862,11486,3578723398,3578723425,27
2,862,11487,3578723398,3578723426,28
2,862,11488,3578723398,3578723427,29
2,862,11489,3578723398,3578723430,32
2,862,11490,3578723398,3578723430,32
2,862,11491,3578723398,3578723430,32
2,862,11492,3578723398,3578723432,34
2,862,11493,3578723398,3578723433,35
2,862,11494,3578723398,3578723434,36
2,862,11495,3578723398,3578723436,38
2,862,11496,3578723398,3578723437,39
2,862,11497,3578723398,3578723438,40
2,862,11498,3578723398,3578723439,41
2,862,11499,3578723398,3578723442,44
2,862,11500,3578723398,3578723442,44
2,862,11501,3578723398,3578723442,44
2,862,11502,3578723398,3578723442,44
2,862,11503,3578723398,3578723442,44
2,862,11504,3578723398,3578723443,45
2,862,11505,3578723398,3578723443,45
2,862,11506,3578723398,3578723446,48
2,862,11507,3578723398,3578723447,49
2,862,11508,3578723398,3578723448,50
2,863,11509,3578723453,3578723453,0
2,863,11510,3578723453,3578723453,0
2,863,11511,3578723453,3578723453,0
2,863,11512,3578723453,3578723453,0
2,863,11513,3578723453,3578723455,2
2,863,11514,3578723453,3578723455,2
2,863,11515,3578723453,3578723457,4
2,863,11516,3578723453,3578723459,6
2,863,11517,3578723453,3578723460,7
2,863,11518,3578723453,3578723462,9
2,863,11519,3578723453,3578723464,11
2,863,11520,3578723453,3578723466,13
2,863,11521,3578723453,3578723467,14
2,863,11522,3578723453,3578723468,15
2,863,11523,3578723453,3578723469,16
2,863,11524,3578723453,3578723470,17
2,863,11525,3578723453,3578723471,18
2,863,11526,3578723453,3578723476,23
2,863,11527,3578723453,3578723478,25
2,863,11528,3578723453,3578723481,28
2,863,11529,3578723453,3578723484,31
2,863,11530,3578723453,3578723484,31
2,863,11531,3578723453,3578723484,31
2,863,11532,3578723453,3578723485,32
2,863,11533,3578723453,3578723485,32
2,863,11534,3578723453,3578723487,34
2,863,11535,3578723453,3578723488,35
2,863,11536,3578723453,3578723488,35
2,863,11537,3578723453,3578723492,39
2,863,11538,3578723453,3578723494,41
2,863,11539,3578723453,3578723494,41
2,863,11540,3578723453,3578723496,43
2,863,11541,3578723453,3578723498,45
2,863,11542,3578723453,3578723498,45
2,863,11543,3578723453,3578723499,46
2,863,11544,3578723453,3578723499,46
2,863,11545,3578723453,3578723500,47
2,863,11546,3578723453,3578723500,47
2,863,11547,3578723453,3578723501,48
2,864,11548,3578723509,3578723509,0
2,864,11549,3578723509,3578723509,0
2,864,11550,3578723509,3578723509,0
2,864,11551,3578723509,3578723509,0
2,864,11552,3578723509,3578723509,0
2,864,11553,3578723509,3578723509,0
2,864,11554,3578723509,3578723509,0
2,864,11555,3578723509,3578723511,2
2,864,11556,3578723509,3578723511,2
2,864,11557,3578723509,3578723512,3
2,864,11558,3578723509,3578723512,3
2,864,11559,3578723509,3578723513,4
2,864,11560,3578723509,3578723513,4
2,864,11561,3578723509,3578723514,5
2,864,11562,3578723509,3578723516,7
2,864,11563,3578723509,3578723516,7
2,864,11564,3578723509,3578723517,8
2,864,11565,3578723509,3578723518,9
2,864,11566,3578723509,3578723518,9
2,864,11567,3578723509,3578723521,12
2,864,11568,3578723509,3578723521,12
2,864,11569,3578723509,3578723524,15
2,864,11570,3578723509,3578723526,17
2,864,11571,3578723509,3578723528,19
2,864,11572,3578723509,3578723531,22
2,864,11573,3578723509,3578723532,23
2,864,11574,3578723509,3578723534,25
2,864,11575,3578723509,3578723534,25
2,864,11576,3578723509,3578723534,25
2,864,11577,3578723509,3578723537,28
2,864,11578,3578723509,3578723537,28
2,864,11579,3578723509,3578723537,28
2,864,11580,3578723509,3578723546,37
2,864,11581,3578723509,3578723550,41
2,864,11582,3578723509,3578723550,41
2,864,11583,3578723509,3578723551,42
2,864,11584,3578723509,3578723553,44
2,864,11585,3578723509,3578723553,44
2,864,11586,3578723509,3578723554,45
2,864,11587,3578723509,3578723555,46
2,864,11588,3578723509,3578723555,46
2,864,11589,3578723509,3578723556,47
2,864,11590,3578723509,3578723556,47
2,865,11591,3578723565,3578723565,0
2,865,11592,3578723565,3578723565,0
2,865,11593,3578723565,3578723565,0
2,865,11594,3578723565,3578723565,0
2,865,11595,3578723565,3578723566,1
2,865,11596,3578723565,3578723566,1
2,865,11597,3578723565,3578723567,2
2,865,11598,3578723565,3578723568,3
2,865,11599,3578723565,3578723570,5
2,865,11600,3578723565,3578723572,7
2,865,11601,3578723565,3578723575,10
2,865,11602,3578723565,3578723575,10
2,865,11603,3578723565,3578723576,11
2,865,11604,3578723565,3578723578,13
2,865,11605,3578723565,3578723579,14
2,865,11606,3578723565,3578723580,15
2,865,11607,3578723565,3578723584,19
2,865,11608,3578723565,3578723588,23
2,865,11609,3578723565,3578723588,23
2,865,11610,3578723565,3578723590,25
2,865,11611,3578723565,3578723590,25
2,865,11612,3578723565,3578723593,28
2,865,11613,3578723565,3578723594,29
2,865,11614,3578723565,3578723594,29
2,865,11615,3578723565,3578723598,33
2,865,11616,3578723565,3578723598,33
2,865,11617,3578723565,3578723599,34
2,865,11618,3578723565,3578723601,36
2,865,11619,3578723565,3578723603,38
2,865,11620,3578723565,3578723607,42
2,865,11621,3578723565,3578723607,42
2,865,11622,3578723565,3578723609,44
2,865,11623,3578723565,3578723609,44
2,865,11624,3578723565,3578723610,45
2,865,11625,3578723565,3578723612,47
2,865,11626,3578723565,3578723612,47
2,865,11627,3578723565,3578723614,49
2,866,11628,3578723621,3578723621,0
2,866,11629,3578723621,3578723621,0
2,866,11630,3578723621,3578723621,0
2,866,11631,3578723621,3578723621,0
2,866,11632,3578723621,3578723621,0
2,866,11633,3578723621,3578723622,1
2,866,11634,3578723621,3578723626,5
2,866,11635,3578723621,3578723626,5
2,866,11636,3578723621,3578723626,5
2,866,11637,3578723621,3578723626,5
2,866,11638,3578723621,3578723628,7
2,866,11639,3578723621,3578723629,8
2,866,11640,3578723621,3578723629,8
2,866,11641,3578723621,3578723631,10
2,866,11642,3578723621,3578723632,11
2,866,11643,3578723621,3578723634,13
2,866,11644,3578723621,3578723635,14
2,866,11645,3578723621,3578723636,15
2,866,11646,3578723621,3578723636,15
2,866,11647,3578723621,3578723637,16
2,866,11648,3578723621,3578723639,18
2,866,11649,3578723621,3578723641,20
2,866,11650,3578723621,3578723641,20
2,866,11651,3578723621,3578723641,20
2,866,11652,3578723621,3578723642,21
2,866,11653,3578723621,3578723642,21
2,866,11654,3578723621,3578723643,22
2,866,11655,3578723621,3578723646,25
2,866,11656,3578723621,3578723646,25
2,866,11657,3578723621,3578723647,26
2,866,11658,3578723621,3578723649,28
2,866,11659,3578723621,3578723650,29
2,866,11660,3578723621,3578723651,30
2,866,11661,3578723621,3578723652,31
2,866,11662,3578723621,3578723653,32
2,866,11663,3578723621,3578723655,34
2,866,11664,3578723621,3578723656,35
2,866,11665,3578723621,3578723658,37
2,866,11666,3578723621,3578723659,38
2,866,11667,3578723621,3578723664,43
2,866,11668,3578723621,3578723665,44
2,866,11669,3578723621,3578723666,45
2,866,11670,3578723621,3578723668,47
2,866,11671,3578723621,3578723669,48
2,866,11672,3578723621,3578723669,48
2,866,11673,3578723621,3578723670,49
2,867,11674,3578723676,3578723677,1
2,867,11675,3578723676,3578723678,2
2,867,11676,3578723676,3578723679,3
2,867,11677,3578723676,3578723681,5
2,867,11678,3578723676,3578723681,5
2,867,11679,3578723676,3578723683,7
2,867,11680,3578723676,3578723683,7
2,867,11681,3578723676,3578723684,8
2,867,11682,3578723676,3578723686,10
2,867,11683,3578723676,3578723686,10
2,867,11684,3578723676,3578723687,11
2,867,11685,3578723676,3578723688,12
2,867,11686,3578723676,3578723694,18
2,867,11687,3578723676,3578723694,18
2,867,11688,3578723676,3578723697,21
2,867,11689,3578723676,3578723697,21
2,867,11690,3578723676,3578723697,21
2,867,11691,3578723676,3578723698,22
2,867,11692,3578723676,3578723698,22
2,867,11693,3578723676,3578723699,23
2,867,11694,3578723676,3578723700,24
2,867,11695,3578723676,3578723701,25
2,867,11696,3578723676,3578723701,25
2,867,11697,3578723676,3578723701,25
2,867,11698,3578723676,3578723705,29
2,867,11699,3578723676,3578723706,30
2,867,11700,3578723676,3578723707,31
2,867,11701,3578723676,3578723707,31
2,867,11702,3578723676,3578723707,31
2,867,11703,3578723676,3578723709,33
2,867,11704,3578723676,3578723709,33
2,867,11705,3578723676,3578723710,34
2,867,11706,3578723676,3578723710,34
2,867,11707,3578723676,3578723712,36
2,867,11708,3578723676,3578723712,36
2,867,11709,3578723676,3578723712,36
2,867,11710,3578723676,3578723713,37
2,867,11711,3578723676,3578723713,37
2,867,11712,3578723676,3578723714,38
2,867,11713,3578723676,3578723715,39
2,867,11714,3578723676,3578723717,41
2,867,11715,3578723676,3578723718,42
2,867,11716,3578723676,3578723718,42
2,867,11717,3578723676,3578723718,42
2,867,11718,3578723676,3578723721,45
2,867,11719,3578723676,3578723722,46
2,867,11720,3578723676,3578723724,48
2,868,11721,3578723733,3578723733,0
2,868,11722,3578723733,3578723733,0
2,868,11723,3578723733,3578723733,0
2,868,11724,3578723733,3578723733,0
2,868,11725,3578723733,3578723734,1
2,868,11726,3578723733,3578723734,1
2,868,11727,3578723733,3578723734,1
2,868,11728,3578723733,3578723737,4
2,868,11729,3578723733,3578723737,4
2,868,11730,3578723733,3578723738,5
2,868,11731,3578723733,3578723745,12
2,868,11732,3578723733,3578723750,17
2,868,11733,3578723733,3578723750,17
2,868,11734,3578723733,3578723752,19
2,868,11735,3578723733,3578723753,20
2,868,11736,3578723733,3578723753,20
2,868,11737,3578723733,3578723754,21
2,868,11738,3578723733,3578723755,22
2,868,11739,3578723733,3578723755,22
2,868,11740,3578723733,3578723755,22
2,868,11741,3578723733,3578723759,26
2,868,11742,3578723733,3578723763,30
2,868,11743,3578723733,3578723764,31
2,868,11744,3578723733,3578723765,32
2,868,11745,3578723733,3578723766,33
2,868,11746,3578723733,3578723767,34
2,868,11747,3578723733,3578723768,35
2,868,11748,3578723733,3578723771,38
2,868,11749,3578723733,3578723776,43
2,868,11750,3578723733,3578723776,43
2,868,11751,3578723733,3578723776,43
2,868,11752,3578723733,3578723778,45
2,868,11753,3578723733,3578723779,46
2,868,11754,3578723733,3578723781,48
2,869,11755,3578723791,3578723791,0
2,869,11756,3578723791,3578723791,0
2,869,11757,3578723791,3578723791,0
2,869,11758,3578723791,3578723791,0
2,869,11759,3578723791,3578723791,0
2,869,11760,3578723791,3578723792,1
2,869,11761,3578723791,3578723793,2
2,869,11762,3578723791,3578723795,4
2,869,11763,3578723791,3578723797,6
2,869,11764,3578723791,3578723799,8
2,869,11765,3578723791,3578723799,8
2,869,11766,3578723791,3578723801,10
2,869,11767,3578723791,3578723803,12
2,869,11768,3578723791,3578723807,16
2,869,11769,3578723791,3578723807,16
2,869,11770,3578723791,3578723808,17
2,869,11771,3578723791,3578723809,18
2,869,11772,3578723791,3578723811,20
2,869,11773,3578723791,3578723812,21
2,869,11774,3578723791,3578723813,22
2,869,11775,3578723791,3578723814,23
2,869,11776,3578723791,3578723816,25
2,869,11777,3578723791,3578723818,27
2,869,11778,3578723791,3578723819,28
2,869,11779,3578723791,3578723820,29
2,869,11780,3578723791,3578723820,29
2,869,11781,3578723791,3578723822,31
2,869,11782,3578723791,3578723826,35
2,869,11783,3578723791,3578723826,35
2,869,11784,3578723791,3578723826,35
2,869,11785,3578723791,3578723827,36
2,869,11786,3578723791,3578723828,37
2,869,11787,3578723791,3578723829,38
2,869,11788,3578723791,3578723829,38
2,869,11789,3578723791,3578723830,39
2,869,11790,3578723791,3578723831,40
2,869,11791,3578723791,3578723834,43
2,869,11792,3578723791,3578723836,45
2,869,11793,3578723791,3578723836,45
2,869,11794,3578723791,3578723837,46
2,869,11795,3578723791,3578723838,47
2,870,11796,3578723848,3578723848,0
2,870,11797,3578723848,3578723848,0
2,870,11798,3578723848,3578723848,0
2,870,11799,3578723848,3578723848,0
2,870,11800,3578723848,3578723848,0
2,870,11801,3578723848,3578723848,0
2,870,11802,3578723848,3578723848,0
2,870,11803,3578723848,3578723848,0
2,870,11804,3578723848,3578723848,0
2,870,11805,3578723848,3578723848,0
2,870,11806,3578723848,3578723849,1
2,870,11807,3578723848,3578723850,2
2,870,11808,3578723848,3578723852,4
2,870,11809,3578723848,3578723853,5
2,870,11810,3578723848,3578723854,6
2,870,11811,3578723848,3578723854,6
2,870,11812,3578723848,3578723857,9
2,870,11813,3578723848,3578723858,10
2,870,11814,3578723848,3578723860,12
2,870,11815,3578723848,3578723861,13
2,870,11816,3578723848,3578723864,16
2,870,11817,3578723848,3578723865,17
2,870,11818,3578723848,3578723866,18
2,870,11819,3578723848,3578723868,20
2,870,11820,3578723848,3578723869,21
2,870,11821,3578723848,3578723870,22
2,870,11822,3578723848,3578723876,28
2,870,11823,3578723848,3578723878,30
2,870,11824,3578723848,3578723879,31
2,870,11825,3578723848,3578723881,33
2,870,11826,3578723848,3578723882,34
2,870,11827,3578723848,3578723883,35
2,870,11828,3578723848,3578723884,36
2,870,11829,3578723848,3578723884,36
2,870,11830,3578723848,3578723885,37
2,870,11831,3578723848,3578723886,38
2,870,11832,3578723848,3578723887,39
2,870,11833,3578723848,3578723888,40
2,870,11834,3578723848,3578723888,40
2,870,11835,3578723848,3578723893,45
2,870,11836,3578723848,3578723894,46
2,870,11837,3578723848,3578723894,46
2,870,11838,3578723848,3578723897,49
2,870,11839,3578723848,3578723897,49
2,870,11840,3578723848,3578723898,50
2,871,11841,3578723905,3578723905,0
2,871,11842,3578723905,3578723905,0
2,871,11843,3578723905,3578723905,0
2,871,11844,3578723905,3578723905,0
2,871,11845,3578723905,3578723905,0
2,871,11846,3578723905,3578723905,0
2,871,11847,3578723905,3578723906,1
2,871,11848,3578723905,3578723906,1
2,871,11849,3578723905,3578723907,2
2,871,11850,3578723905,3578723908,3
2,871,11851,3578723905,3578723908,3
2,871,11852,3578723905,3578723909,4
2,871,11853,3578723905,3578723909,4
2,871,11854,3578723905,3578723910,5
2,871,11855,3578723905,3578723911,6
2,871,11856,3578723905,3578723912,7
2,871,11857,3578723905,3578723912,7
2,871,11858,3578723905,3578723912,7
2,871,11859,3578723905,3578723913,8
2,871,11860,3578723905,3578723913,8
2,871,11861,3578723905,3578723915,10
2,871,11862,3578723905,3578723915,10
2,871,11863,3578723905,3578723918,13
2,871,11864,3578723905,3578723918,13
2,871,11865,3578723905,3578723918,13
2,871,11866,3578723905,3578723919,14
2,871,11867,3578723905,3578723922,17
2,871,11868,3578723905,3578723922,17
2,871,11869,3578723905,3578723925,20
2,871,11870,3578723905,3578723927,22
2,871,11871,3578723905,3578723930,25
2,871,11872,3578723905,3578723931,26
2,871,11873,3578723905,3578723933,28
2,871,11874,3578723905,3578723933,28
2,871,11875,3578723905,3578723934,29
2,871,11876,3578723905,3578723935,30
2,871,11877,3578723905,3578723936,31
2,871,11878,3578723905,3578723937,32
2,871,11879,3578723905,3578723938,33
2,871,11880,3578723905,3578723945,40
2,871,11881,3578723905,3578723950,45
2,871,11882,3578723905,3578723950,45
2,871,11883,3578723905,3578723952,47
2,871,11884,3578723905,3578723952,47
2,871,11885,3578723905,3578723953,48
2,871,11886,3578723905,3578723954,49
2,871,11887,3578723905,3578723955,50
2,872,11888,3578723961,3578723961,0
2,872,11889,3578723961,3578723961,0
2,872,11890,3578723961,3578723963,2
2,872,11891,3578723961,3578723964,3
2,872,11892,3578723961,3578723964,3
2,872,11893,3578723961,3578723966,5
2,872,11894,3578723961,3578723966,5
2,872,11895,3578723961,3578723968,7
2,872,11896,3578723961,3578723968,7
2,872,11897,3578723961,3578723971,10
2,872,11898,3578723961,3578723974,13
2,872,11899,3578723961,3578723976,15
2,872,11900,3578723961,3578723976,15
2,872,11901,3578723961,3578723977,16
2,872,11902,3578723961,3578723978,17
2,872,11903,3578723961,3578723980,19
2,872,11904,3578723961,3578723980,19
2,872,11905,3578723961,3578723988,27
2,872,11906,3578723961,3578723989,28
2,872,11907,3578723961,3578723990,29
2,872,11908,3578723961,3578723991,30
2,872,11909,3578723961,3578723993,32
2,872,11910,3578723961,3578723994,33
2,872,11911,3578723961,3578723997,36
2,872,11912,3578723961,3578723999,38
2,872,11913,3578723961,3578724000,39
2,872,11914,3578723961,3578724001,40
2,872,11915,3578723961,3578724003,42
2,872,11916,3578723961,3578724007,46
2,872,11917,3578723961,3578724008,47
2,872,11918,3578723961,3578724008,47
2,872,11919,3578723961,3578724009,48
2,873,11920,3578724017,3578724017,0
2,873,11921,3578724017,3578724017,0
2,873,11922,3578724017,3578724017,0
2,873,11923,3578724017,3578724017,0
2,873,11924,3578724017,3578724017,0
2,873,11925,3578724017,3578724018,1
2,873,11926,3578724017,3578724018,1
2,873,11927,3578724017,3578724020,3
2,873,11928,3578724017,3578724021,4
2,873,11929,3578724017,3578724022,5
2,873,11930,3578724017,3578724022,5
2,873,11931,3578724017,3578724026,9
2,873,11932,3578724017,3578724026,9
2,873,11933,3578724017,3578724026,9
2,873,11934,3578724017,3578724027,10
2,873,11935,3578724017,3578724028,11
2,873,11936,3578724017,3578724029,12
2,873,11937,3578724017,3578724030,13
2,873,11938,3578724017,3578724032,15
2,873,11939,3578724017,3578724033,16
2,873,11940,3578724017,3578724033,16
2,873,11941,3578724017,3578724035,18
2,873,11942,3578724017,3578724036,19
2,873,11943,3578724017,3578724036,19
2,873,11944,3578724017,3578724037,20
2,873,11945,3578724017,3578724038,21
2,873,11946,3578724017,3578724040,23
2,873,11947,3578724017,3578724041,24
2,873,11948,3578724017,3578724042,25
2,873,11949,3578724017,3578724042,25
2,873,11950,3578724017,3578724043,26
2,873,11951,3578724017,3578724046,29
2,873,11952,3578724017,3578724046,29
2,873,11953,3578724017,3578724047,30
2,873,11954,3578724017,3578724050,33
2,873,11955,3578724017,3578724050,33
2,873,11956,3578724017,3578724051,34
2,873,11957,3578724017,3578724053,36
2,873,11958,3578724017,3578724054,37
2,873,11959,3578724017,3578724057,40
2,873,11960,3578724017,3578724058,41
2,873,11961,3578724017,3578724060,43
2,873,11962,3578724017,3578724061,44
2,873,11963,3578724017,3578724065,48
2,873,11964,3578724017,3578724065,48
2,873,11965,3578724017,3578724066,49
2,874,11966,3578724073,3578724073,0
2,874,11967,3578724073,3578724073,0
2,874,11968,3578724073,3578724073,0
2,874,11969,3578724073,3578724077,4
2,874,11970,3578724073,3578724078,5
2,874,11971,3578724073,3578724079,6
2,874,11972,3578724073,3578724081,8
2,874,11973,3578724073,3578724082,9
2,874,11974,3578724073,3578724084,11
2,874,11975,3578724073,3578724084,11
2,874,11976,3578724073,3578724086,13
2,874,11977,3578724073,3578724086,13
2,874,11978,3578724073,3578724087,14
2,874,11979,3578724073,3578724088,15
2,874,11980,3578724073,3578724088,15
2,874,11981,3578724073,3578724093,20
2,874,11982,3578724073,3578724094,21
2,874,11983,3578724073,3578724097,24
2,874,11984,3578724073,3578724097,24
2,874,11985,3578724073,3578724097,24
2,874,11986,3578724073,3578724098,25
2,874,11987,3578724073,3578724098,25
2,874,11988,3578724073,3578724099,26
2,874,11989,3578724073,3578724099,26
2,874,11990,3578724073,3578724100,27
2,874,11991,3578724073,3578724100,27
2,874,11992,3578724073,3578724100,27
2,874,11993,3578724073,3578724101,28
2,874,11994,3578724073,3578724101,28
2,874,11995,3578724073,3578724101,28
2,874,11996,3578724073,3578724105,32
2,874,11997,3578724073,3578724106,33
2,874,11998,3578724073,3578724107,34
2,874,11999,3578724073,3578724107,34
2,874,12000,3578724073,3578724108,35
2,874,12001,3578724073,3578724110,37
2,874,12002,3578724073,3578724110,37
2,874,12003,3578724073,3578724110,37
2,874,12004,3578724073,3578724111,38
2,874,12005,3578724073,3578724112,39
2,874,12006,3578724073,3578724113,40
2,874,12007,3578724073,3578724113,40
2,874,12008,3578724073,3578724113,40
2,874,12009,3578724073,3578724113,40
2,874,12010,3578724073,3578724115,42
2,874,12011,3578724073,3578724116,43
2,874,12012,3578724073,3578724118,45
2,874,12013,3578724073,3578724118,45
2,874,12014,3578724073,3578724119,46
2,874,12015,3578724073,3578724119,46
2,874,12016,3578724073,3578724122,49
2,874,12017,3578724073,3578724122,49
2,875,12018,3578724129,3578724129,0
2,875,12019,3578724129,3578724129,0
2,875,12020,3578724129,3578724130,1
2,875,12021,3578724129,3578724131,2
2,875,12022,3578724129,3578724133,4
2,875,12023,3578724129,3578724134,5
2,875,12024,3578724129,3578724134,5
2,875,12025,3578724129,3578724135,6
2,875,12026,3578724129,3578724137,8
2,875,12027,3578724129,3578724137,8
2,875,12028,3578724129,3578724138,9
2,875,12029,3578724129,3578724138,9
2,875,12030,3578724129,3578724145,16
2,875,12031,3578724129,3578724151,22
2,875,12032,3578724129,3578724153,24
2,875,12033,3578724129,3578724153,24
2,875,12034,3578724129,3578724153,24
2,875,12035,3578724129,3578724154,25
2,875,12036,3578724129,3578724155,26
2,875,12037,3578724129,3578724156,27
2,875,12038,3578724129,3578724156,27
2,875,12039,3578724129,3578724160,31
2,875,12040,3578724129,3578724163,34
2,875,12041,3578724129,3578724164,35
2,875,12042,3578724129,3578724165,36
2,875,12043,3578724129,3578724165,36
2,875,12044,3578724129,3578724166,37
2,875,12045,3578724129,3578724166,37
2,875,12046,3578724129,3578724167,38
2,875,12047,3578724129,3578724167,38
2,875,12048,3578724129,3578724172,43
2,875,12049,3578724129,3578724172,43
2,875,12050,3578724129,3578724174,45
2,875,12051,3578724129,3578724175,46
2,875,12052,3578724129,3578724176,47
2,875,12053,3578724129,3578724176,47
2,875,12054,3578724129,3578724179,50
2,876,12055,3578724186,3578724186,0
2,876,12056,3578724186,3578724186,0
2,876,12057,3578724186,3578724186,0
2,876,12058,3578724186,3578724186,0
2,876,12059,3578724186,3578724188,2
2,876,12060,3578724186,3578724189,3
2,876,12061,3578724186,3578724189,3
2,876,12062,3578724186,3578724190,4
2,876,12063,3578724186,3578724193,7
2,876,12064,3578724186,3578724194,8
2,876,12065,3578724186,3578724195,9
2,876,12066,3578724186,3578724198,12
2,876,12067,3578724186,3578724200,14
2,876,12068,3578724186,3578724200,14
2,876,12069,3578724186,3578724200,14
2,876,12070,3578724186,3578724203,17
2,876,12071,3578724186,3578724207,21
2,876,12072,3578724186,3578724208,22
2,876,12073,3578724186,3578724209,23
2,876,12074,3578724186,3578724209,23
2,876,12075,3578724186,3578724211,25
2,876,12076,3578724186,3578724212,26
2,876,12077,3578724186,3578724212,26
2,876,12078,3578724186,3578724214,28
2,876,12079,3578724186,3578724216,30
2,876,12080,3578724186,3578724217,31
2,876,12081,3578724186,3578724218,32
2,876,12082,3578724186,3578724220,34
2,876,12083,3578724186,3578724222,36
2,876,12084,3578724186,3578724222,36
2,876,12085,3578724186,3578724222,36
2,876,12086,3578724186,3578724225,39
2,876,12087,3578724186,3578724226,40
2,876,12088,3578724186,3578724227,41
2,876,12089,3578724186,3578724227,41
2,876,12090,3578724186,3578724228,42
2,876,12091,3578724186,3578724229,43
2,876,12092,3578724186,3578724230,44
2,876,12093,3578724186,3578724232,46
2,876,12094,3578724186,3578724232,46
2,876,12095,3578724186,3578724234,48
2,876,12096,3578724186,3578724235,49
2,877,12097,3578724243,3578724243,0
2,877,12098,3578724243,3578724243,0
2,877,12099,3578724243,3578724243,0
2,877,12100,3578724243,3578724243,0
2,877,12101,3578724243,3578724243,0
2,877,12102,3578724243,3578724243,0
2,877,12103,3578724243,3578724243,0
2,877,12104,3578724243,3578724243,0
2,877,12105,3578724243,3578724243,0
2,877,12106,3578724243,3578724246,3
2,877,12107,3578724243,3578724247,4
2,877,12108,3578724243,3578724247,4
2,877,12109,3578724243,3578724249,6
2,877,12110,3578724243,3578724251,8
2,877,12111,3578724243,3578724252,9
2,877,12112,3578724243,3578724253,10
2,877,12113,3578724243,3578724255,12
2,877,12114,3578724243,3578724258,15
2,877,12115,3578724243,3578724258,15
2,877,12116,3578724243,3578724261,18
2,877,12117,3578724243,3578724261,18
2,877,12118,3578724243,3578724265,22
2,877,12119,3578724243,3578724265,22
2,877,12120,3578724243,3578724267,24
2,877,12121,3578724243,3578724269,26
2,877,12122,3578724243,3578724270,27
2,877,12123,3578724243,3578724270,27
2,877,12124,3578724243,3578724277,34
2,877,12125,3578724243,3578724279,36
2,877,12126,3578724243,3578724279,36
2,877,12127,3578724243,3578724281,38
2,877,12128,3578724243,3578724282,39
2,877,12129,3578724243,3578724284,41
2,877,12130,3578724243,3578724284,41
2,877,12131,3578724243,3578724285,42
2,877,12132,3578724243,3578724286,43
2,877,12133,3578724243,3578724286,43
2,877,12134,3578724243,3578724288,45
2,877,12135,3578724243,3578724289,46
2,877,12136,3578724243,3578724293,50
2,878,12137,3578724299,3578724299,0
2,878,12138,3578724299,3578724299,0
2,878,12139,3578724299,3578724299,0
2,878,12140,3578724299,3578724299,0
2,878,12141,3578724299,3578724299,0
2,878,12142,3578724299,3578724299,0
2,878,12143,3578724299,3578724299,0
2,878,12144,3578724299,3578724300,1
2,878,12145,3578724299,3578724300,1
2,878,12146,3578724299,3578724301,2
2,878,12147,3578724299,3578724301,2
2,878,12148,3578724299,3578724302,3
2,878,12149,3578724299,3578724305,6
2,878,12150,3578724299,3578724306,7
2,878,12151,3578724299,3578724307,8
2,878,12152,3578724299,3578724308,9
2,878,12153,3578724299,3578724309,10
2,878,12154,3578724299,3578724309,10
2,878,12155,3578724299,3578724311,12
2,878,12156,3578724299,3578724312,13
2,878,12157,3578724299,3578724312,13
2,878,12158,3578724299,3578724313,14
2,878,12159,3578724299,3578724313,14
2,878,12160,3578724299,3578724314,15
2,878,12161,3578724299,3578724314,15
2,878,12162,3578724299,3578724315,16
2,878,12163,3578724299,3578724317,18
2,878,12164,3578724299,3578724318,19
2,878,12165,3578724299,3578724318,19
2,878,12166,3578724299,3578724318,19
2,878,12167,3578724299,3578724319,20
2,878,12168,3578724299,3578724322,23
2,878,12169,3578724299,3578724323,24
2,878,12170,3578724299,3578724326,27
2,878,12171,3578724299,3578724327,28
2,878,12172,3578724299,3578724331,32
2,878,12173,3578724299,3578724331,32
2,878,12174,3578724299,3578724333,34
2,878,12175,3578724299,3578724334,35
2,878,12176,3578724299,3578724334,35
2,878,12177,3578724299,3578724335,36
2,878,12178,3578724299,3578724337,38
2,878,12179,3578724299,3578724337,38
2,878,12180,3578724299,3578724337,38
2,878,12181,3578724299,3578724338,39
2,878,12182,3578724299,3578724338,39
2,878,12183,3578724299,3578724345,46
2,879,12184,3578724356,3578724356,0
2,879,12185,3578724356,3578724356,0
2,879,12186,3578724356,3578724356,0
2,879,12187,3578724356,3578724356,0
2,879,12188,3578724356,3578724356,0
2,879,12189,3578724356,3578724356,0
2,879,12190,3578724356,3578724356,0
2,879,12191,3578724356,3578724356,0
2,879,12192,3578724356,3578724356,0
2,879,12193,3578724356,3578724360,4
2,879,12194,3578724356,3578724363,7
2,879,12195,3578724356,3578724363,7
2,879,12196,3578724356,3578724365,9
2,879,12197,3578724356,3578724366,10
2,879,12198,3578724356,3578724367,11
2,879,12199,3578724356,3578724367,11
2,879,12200,3578724356,3578724368,12
2,879,12201,3578724356,3578724369,13
2,879,12202,3578724356,3578724372,16
2,879,12203,3578724356,3578724373,17
2,879,12204,3578724356,3578724374,18
2,879,12205,3578724356,3578724375,19
2,879,12206,3578724356,3578724376,20
2,879,12207,3578724356,3578724377,21
2,879,12208,3578724356,3578724379,23
2,879,12209,3578724356,3578724380,24
2,879,12210,3578724356,3578724382,26
2,879,12211,3578724356,3578724384,28
2,879,12212,3578724356,3578724386,30
2,879,12213,3578724356,3578724389,33
2,879,12214,3578724356,3578724389,33
2,879,12215,3578724356,3578724391,35
2,879,12216,3578724356,3578724392,36
2,879,12217,3578724356,3578724393,37
2,879,12218,3578724356,3578724395,39
2,879,12219,3578724356,3578724395,39
2,879,12220,3578724356,3578724398,42
2,879,12221,3578724356,3578724399,43
2,879,12222,3578724356,3578724400,44
2,879,12223,3578724356,3578724401,45
2,879,12224,3578724356,3578724403,47
2,880,12225,3578724413,3578724413,0
2,880,12226,3578724413,3578724413,0
2,880,12227,3578724413,3578724413,0
2,880,12228,3578724413,3578724413,0
2,880,12229,3578724413,3578724413,0
2,880,12230,3578724413,3578724413,0
2,880,12231,3578724413,3578724413,0
2,880,12232,3578724413,3578724415,2
2,880,12233,3578724413,3578724416,3
2,880,12234,3578724413,3578724419,6
2,880,12235,3578724413,3578724421,8
2,880,12236,3578724413,3578724422,9
2,880,12237,3578724413,3578724422,9
2,880,12238,3578724413,3578724422,9
2,880,12239,3578724413,3578724426,13
2,880,12240,3578724413,3578724426,13
2,880,12241,3578724413,3578724426,13
2,880,12242,3578724413,3578724428,15
2,880,12243,3578724413,3578724429,16
2,880,12244,3578724413,3578724429,16
2,880,12245,3578724413,3578724430,17
2,880,12246,3578724413,3578724432,19
2,880,12247,3578724413,3578724433,20
2,880,12248,3578724413,3578724434,21
2,880,12249,3578724413,3578724435,22
2,880,12250,3578724413,3578724436,23
2,880,12251,3578724413,3578724437,24
2,880,12252,3578724413,3578724439,26
2,880,12253,3578724413,3578724439,26
2,880,12254,3578724413,3578724440,27
2,880,12255,3578724413,3578724442,29
2,880,12256,3578724413,3578724442,29
2,880,12257,3578724413,3578724442,29
2,880,12258,3578724413,3578724443,30
2,880,12259,3578724413,3578724443,30
2,880,12260,3578724413,3578724444,31
2,880,12261,3578724413,3578724446,33
2,880,12262,3578724413,3578724447,34
2,880,12263,3578724413,3578724448,35
2,880,12264,3578724413,3578724450,37
2,880,12265,3578724413,3578724450,37
2,880,12266,3578724413,3578724453,40
2,880,12267,3578724413,3578724453,40
2,880,12268,3578724413,3578724455,42
2,880,12269,3578724413,3578724456,43
2,880,12270,3578724413,3578724458,45
2,880,12271,3578724413,3578724458,45
2,880,12272,3578724413,3578724460,47
2,880,12273,3578724413,3578724461,48
2,880,12274,3578724413,3578724461,48
2,881,12275,3578724470,3578724470,0
2,881,12276,3578724470,3578724470,0
2,881,12277,3578724470,3578724470,0
2,881,12278,3578724470,3578724470,0
2,881,12279,3578724470,3578724470,0
2,881,12280,3578724470,3578724470,0
2,881,12281,3578724470,3578724476,6
2,881,12282,3578724470,3578724479,9
2,881,12283,3578724470,3578724480,10
2,881,12284,3578724470,3578724481,11
2,881,12285,3578724470,3578724482,12
2,881,12286,3578724470,3578724484,14
2,881,12287,3578724470,3578724484,14
2,881,12288,3578724470,3578724486,16
2,881,12289,3578724470,3578724486,16
2,881,12290,3578724470,3578724486,16
2,881,12291,3578724470,3578724488,18
2,881,12292,3578724470,3578724488,18
2,881,12293,3578724470,3578724491,21
2,881,12294,3578724470,3578724494,24
2,881,12295,3578724470,3578724494,24
2,881,12296,3578724470,3578724497,27
2,881,12297,3578724470,3578724497,27
2,881,12298,3578724470,3578724497,27
2,881,12299,3578724470,3578724498,28
2,881,12300,3578724470,3578724499,29
2,881,12301,3578724470,3578724500,30
2,881,12302,3578724470,3578724500,30
2,881,12303,3578724470,3578724500,30
2,881,12304,3578724470,3578724501,31
2,881,12305,3578724470,3578724501,31
2,881,12306,3578724470,3578724502,32
2,881,12307,3578724470,3578724506,36
2,881,12308,3578724470,3578724507,37
2,881,12309,3578724470,3578724507,37
2,881,12310,3578724470,3578724507,37
2,881,12311,3578724470,3578724508,38
2,881,12312,3578724470,3578724509,39
2,881,12313,3578724470,3578724510,40
2,881,12314,3578724470,3578724512,42
2,881,12315,3578724470,3578724512,42
2,881,12316,3578724470,3578724512,42
2,881,12317,3578724470,3578724514,44
2,881,12318,3578724470,3578724514,44
2,881,12319,3578724470,3578724514,44
2,881,12320,3578724470,3578724515,45
2,881,12321,3578724470,3578724517,47
2,881,12322,3578724470,3578724518,48
2,881,12323,3578724470,3578724519,49
2,881,12324,3578724470,3578724519,49
2,881,12325,3578724470,3578724520,50
2,882,12326,3578724526,3578724526,0
2,882,12327,3578724526,3578724526,0
2,882,12328,3578724526,3578724526,0
2,882,12329,3578724526,3578724526,0
2,882,12330,3578724526,3578724530,4
2,882,12331,3578724526,3578724531,5
2,882,12332,3578724526,3578724532,6
2,882,12333,3578724526,3578724533,7
2,882,12334,3578724526,3578724534,8
2,882,12335,3578724526,3578724534,8
2,882,12336,3578724526,3578724536,10
2,882,12337,3578724526,3578724536,10
2,882,12338,3578724526,3578724536,10
2,882,12339,3578724526,3578724537,11
2,882,12340,3578724526,3578724538,12
2,882,12341,3578724526,3578724541,15
2,882,12342,3578724526,3578724545,19
2,882,12343,3578724526,3578724550,24
2,882,12344,3578724526,3578724552,26
2,882,12345,3578724526,3578724552,26
2,882,12346,3578724526,3578724552,26
2,882,12347,3578724526,3578724553,27
2,882,12348,3578724526,3578724554,28
2,882,12349,3578724526,3578724554,28
2,882,12350,3578724526,3578724555,29
2,882,12351,3578724526,3578724556,30
2,882,12352,3578724526,3578724559,33
2,882,12353,3578724526,3578724562,36
2,882,12354,3578724526,3578724563,37
2,882,12355,3578724526,3578724563,37
2,882,12356,3578724526,3578724565,39
2,882,12357,3578724526,3578724566,40
2,882,12358,3578724526,3578724568,42
2,882,12359,3578724526,3578724568,42
2,882,12360,3578724526,3578724572,46
2,882,12361,3578724526,3578724572,46
2,882,12362,3578724526,3578724572,46
2,882,12363,3578724526,3578724575,49
2,882,12364,3578724526,3578724575,49
2,882,12365,3578724526,3578724575,49
2,883,12366,3578724582,3578724582,0
2,883,12367,3578724582,3578724582,0
2,883,12368,3578724582,3578724582,0
2,883,12369,3578724582,3578724584,2
2,883,12370,3578724582,3578724585,3
2,883,12371,3578724582,3578724587,5
2,883,12372,3578724582,3578724588,6
2,883,12373,3578724582,3578724590,8
2,883,12374,3578724582,3578724591,9
2,883,12375,3578724582,3578724594,12
2,883,12376,3578724582,3578724594,12
2,883,12377,3578724582,3578724597,15
2,883,12378,3578724582,3578724598,16
2,883,12379,3578724582,3578724599,17
2,883,12380,3578724582,3578724600,18
2,883,12381,3578724582,3578724602,20
2,883,12382,3578724582,3578724607,25
2,883,12383,3578724582,3578724608,26
2,883,12384,3578724582,3578724609,27
2,883,12385,3578724582,3578724609,27
2,883,12386,3578724582,3578724610,28
2,883,12387,3578724582,3578724611,29
2,883,12388,3578724582,3578724612,30
2,883,12389,3578724582,3578724615,33
2,883,12390,3578724582,3578724615,33
2,883,12391,3578724582,3578724618,36
2,883,12392,3578724582,3578724620,38
2,883,12393,3578724582,3578724621,39
2,883,12394,3578724582,3578724621,39
2,883,12395,3578724582,3578724625,43
2,883,12396,3578724582,3578724625,43
2,883,12397,3578724582,3578724626,44
2,883,12398,3578724582,3578724627,45
2,883,12399,3578724582,3578724628,46
2,883,12400,3578724582,3578724628,46
2,883,12401,3578724582,3578724629,47
2,883,12402,3578724582,3578724631,49
2,883,12403,3578724582,3578724631,49
2,883,12404,3578724582,3578724632,50
2,884,12405,3578724638,3578724638,0
2,884,12406,3578724638,3578724638,0
2,884,12407,3578724638,3578724638,0
2,884,12408,3578724638,3578724638,0
2,884,12409,3578724638,3578724638,0
2,884,12410,3578724638,3578724641,3
2,884,12411,3578724638,3578724641,3
2,884,12412,3578724638,3578724642,4
2,884,12413,3578724638,3578724642,4
2,884,12414,3578724638,3578724644,6
2,884,12415,3578724638,3578724645,7
2,884,12416,3578724638,3578724646,8
2,884,12417,3578724638,3578724646,8
2,884,12418,3578724638,3578724646,8
2,884,12419,3578724638,3578724648,10
2,884,12420,3578724638,3578724649,11
2,884,12421,3578724638,3578724652,14
2,884,12422,3578724638,3578724652,14
2,884,12423,3578724638,3578724654,16
2,884,12424,3578724638,3578724656,18
2,884,12425,3578724638,3578724657,19
2,884,12426,3578724638,3578724658,20
2,884,12427,3578724638,3578724659,21
2,884,12428,3578724638,3578724660,22
2,884,12429,3578724638,3578724661,23
2,884,12430,3578724638,3578724664,26
2,884,12431,3578724638,3578724665,27
2,884,12432,3578724638,3578724666,28
2,884,12433,3578724638,3578724668,30
2,884,12434,3578724638,3578724668,30
2,884,12435,3578724638,3578724668,30
2,884,12436,3578724638,3578724669,31
2,884,12437,3578724638,3578724677,39
2,884,12438,3578724638,3578724680,42
2,884,12439,3578724638,3578724680,42
2,884,12440,3578724638,3578724682,44
2,884,12441,3578724638,3578724683,45
2,884,12442,3578724638,3578724686,48
2,884,12443,3578724638,3578724686,48
2,884,12444,3578724638,3578724687,49
2,885,12445,3578724693,3578724693,0
2,885,12446,3578724693,3578724693,0
2,885,12447,3578724693,3578724693,0
2,885,12448,3578724693,3578724693,0
2,885,12449,3578724693,3578724693,0
2,885,12450,3578724693,3578724694,1
2,885,12451,3578724693,3578724697,4
2,885,12452,3578724693,3578724697,4
2,885,12453,3578724693,3578724697,4
2,885,12454,3578724693,3578724697,4
2,885,12455,3578724693,3578724699,6
2,885,12456,3578724693,3578724700,7
2,885,12457,3578724693,3578724700,7
2,885,12458,3578724693,3578724702,9
2,885,12459,3578724693,3578724702,9
2,885,12460,3578724693,3578724705,12
2,885,12461,3578724693,3578724707,14
2,885,12462,3578724693,3578724707,14
2,885,12463,3578724693,3578724707,14
2,885,12464,3578724693,3578724708,15
2,885,12465,3578724693,3578724709,16
2,885,12466,3578724693,3578724709,16
2,885,12467,3578724693,3578724711,18
2,885,12468,3578724693,3578724713,20
2,885,12469,3578724693,3578724713,20
2,885,12470,3578724693,3578724713,20
2,885,12471,3578724693,3578724714,21
2,885,12472,3578724693,3578724714,21
2,885,12473,3578724693,3578724715,22
2,885,12474,3578724693,3578724717,24
2,885,12475,3578724693,3578724719,26
2,885,12476,3578724693,3578724719,26
2,885,12477,3578724693,3578724719,26
2,885,12478,3578724693,3578724720,27
2,885,12479,3578724693,3578724721,28
2,885,12480,3578724693,3578724722,29
2,885,12481,3578724693,3578724725,32
2,885,12482,3578724693,3578724727,34
2,885,12483,3578724693,3578724729,36
2,885,12484,3578724693,3578724732,39
2,885,12485,3578724693,3578724732,39
2,885,12486,3578724693,3578724732,39
2,885,12487,3578724693,3578724733,40
2,885,12488,3578724693,3578724735,42
2,885,12489,3578724693,3578724736,43
2,885,12490,3578724693,3578724737,44
2,885,12491,3578724693,3578724737,44
2,885,12492,3578724693,3578724737,44
2,885,12493,3578724693,3578724738,45
2,885,12494,3578724693,3578724741,48
2,886,12495,3578724749,3578724749,0
2,886,12496,3578724749,3578724749,0
2,886,12497,3578724749,3578724752,3
2,886,12498,3578724749,3578724752,3
2,886,12499,3578724749,3578724753,4
2,886,12500,3578724749,3578724754,5
2,886,12501,3578724749,3578724755,6
2,886,12502,3578724749,3578724756,7
2,886,12503,3578724749,3578724756,7
2,886,12504,3578724749,3578724758,9
2,886,12505,3578724749,3578724762,13
2,886,12506,3578724749,3578724764,15
2,886,12507,3578724749,3578724766,17
2,886,12508,3578724749,3578724766,17
2,886,12509,3578724749,3578724767,18
2,886,12510,3578724749,3578724767,18
2,886,12511,3578724749,3578724768,19
2,886,12512,3578724749,3578724772,23
2,886,12513,3578724749,3578724773,24
2,886,12514,3578724749,3578724774,25
2,886,12515,3578724749,3578724774,25
2,886,12516,3578724749,3578724774,25
2,886,12517,3578724749,3578724780,31
2,886,12518,3578724749,3578724781,32
2,886,12519,3578724749,3578724781,32
2,886,12520,3578724749,3578724785,36
2,886,12521,3578724749,3578724785,36
2,886,12522,3578724749,3578724787,38
2,886,12523,3578724749,3578724788,39
2,886,12524,3578724749,3578724790,41
2,886,12525,3578724749,3578724791,42
2,886,12526,3578724749,3578724794,45
2,886,12527,3578724749,3578724797,48
2,886,12528,3578724749,3578724799,50
2,887,12529,3578724805,3578724805,0
2,887,12530,3578724805,3578724805,0
2,887,12531,3578724805,3578724807,2
2,887,12532,3578724805,3578724808,3
2,887,12533,3578724805,3578724809,4
2,887,12534,3578724805,3578724809,4
2,887,12535,3578724805,3578724811,6
2,887,12536,3578724805,3578724811,6
2,887,12537,3578724805,3578724813,8
2,887,12538,3578724805,3578724816,11
2,887,12539,3578724805,3578724816,11
2,887,12540,3578724805,3578724819,14
2,887,12541,3578724805,3578724821,16
2,887,12542,3578724805,3578724821,16
2,887,12543,3578724805,3578724821,16
2,887,12544,3578724805,3578724825,20
2,887,12545,3578724805,3578724827,22
2,887,12546,3578724805,3578724827,22
2,887,12547,3578724805,3578724827,22
2,887,12548,3578724805,3578724829,24
2,887,12549,3578724805,3578724829,24
2,887,12550,3578724805,3578724829,24
2,887,12551,3578724805,3578724832,27
2,887,12552,3578724805,3578724833,28
2,887,12553,3578724805,3578724833,28
2,887,12554,3578724805,3578724835,30
2,887,12555,3578724805,3578724835,30
2,887,12556,3578724805,3578724835,30
2,887,12557,3578724805,3578724837,32
2,887,12558,3578724805,3578724838,33
2,887,12559,3578724805,3578724839,34
2,887,12560,3578724805,3578724840,35
2,887,12561,3578724805,3578724841,36
2,887,12562,3578724805,3578724841,36
2,887,12563,3578724805,3578724842,37
2,887,12564,3578724805,3578724843,38
2,887,12565,3578724805,3578724843,38
2,887,12566,3578724805,3578724844,39
2,887,12567,3578724805,3578724846,41
2,887,12568,3578724805,3578724847,42
2,887,12569,3578724805,3578724847,42
2,887,12570,3578724805,3578724849,44
2,887,12571,3578724805,3578724850,45
2,887,12572,3578724805,3578724853,48
2,887,12573,3578724805,3578724853,48
2,887,12574,3578724805,3578724854,49
2,888,12575,3578724862,3578724862,0
2,888,12576,3578724862,3578724862,0
2,888,12577,3578724862,3578724862,0
2,888,12578,3578724862,3578724862,0
2,888,12579,3578724862,3578724862,0
2,888,12580,3578724862,3578724862,0
2,888,12581,3578724862,3578724865,3
2,888,12582,3578724862,3578724865,3
2,888,12583,3578724862,3578724866,4
2,888,12584,3578724862,3578724867,5
2,888,12585,3578724862,3578724868,6
2,888,12586,3578724862,3578724869,7
2,888,12587,3578724862,3578724870,8
2,888,12588,3578724862,3578724877,15
2,888,12589,3578724862,3578724880,18
2,888,12590,3578724862,3578724881,19
2,888,12591,3578724862,3578724882,20
2,888,12592,3578724862,3578724883,21
2,888,12593,3578724862,3578724883,21
2,888,12594,3578724862,3578724884,22
2,888,12595,3578724862,3578724886,24
2,888,12596,3578724862,3578724886,24
2,888,12597,3578724862,3578724887,25
2,888,12598,3578724862,3578724889,27
2,888,12599,3578724862,3578724889,27
2,888,12600,3578724862,3578724891,29
2,888,12601,3578724862,3578724893,31
2,888,12602,3578724862,3578724895,33
2,888,12603,3578724862,3578724897,35
2,888,12604,3578724862,3578724897,35
2,888,12605,3578724862,3578724898,36
2,888,12606,3578724862,3578724898,36
2,888,12607,3578724862,3578724898,36
2,888,12608,3578724862,3578724899,37
2,888,12609,3578724862,3578724900,38
2,888,12610,3578724862,3578724900,38
2,888,12611,3578724862,3578724900,38
2,888,12612,3578724862,3578724901,39
2,888,12613,3578724862,3578724901,39
2,888,12614,3578724862,3578724902,40
2,888,12615,3578724862,3578724905,43
2,888,12616,3578724862,3578724907,45
2,888,12617,3578724862,3578724907,45
2,888,12618,3578724862,3578724908,46
2,888,12619,3578724862,3578724908,46
2,888,12620,3578724862,3578724909,47
2,888,12621,3578724862,3578724910,48
2,888,12622,3578724862,3578724912,50
2,889,12623,3578724919,3578724919,0
2,889,12624,3578724919,3578724919,0
2,889,12625,3578724919,3578724919,0
2,889,12626,3578724919,3578724919,0
2,889,12627,3578724919,3578724919,0
2,889,12628,3578724919,3578724919,0
2,889,12629,3578724919,3578724919,0
2,889,12630,3578724919,3578724919,0
2,889,12631,3578724919,3578724920,1
2,889,12632,3578724919,3578724921,2
2,889,12633,3578724919,3578724921,2
2,889,12634,3578724919,3578724922,3
2,889,12635,3578724919,3578724926,7
2,889,12636,3578724919,3578724927,8
2,889,12637,3578724919,3578724929,10
2,889,12638,3578724919,3578724931,12
2,889,12639,3578724919,3578724933,14
2,889,12640,3578724919,3578724933,14
2,889,12641,3578724919,3578724934,15
2,889,12642,3578724919,3578724934,15
2,889,12643,3578724919,3578724936,17
2,889,12644,3578724919,3578724936,17
2,889,12645,3578724919,3578724937,18
2,889,12646,3578724919,3578724937,18
2,889,12647,3578724919,3578724938,19
2,889,12648,3578724919,3578724941,22
2,889,12649,3578724919,3578724945,26
2,889,12650,3578724919,3578724950,31
2,889,12651,3578724919,3578724952,33
2,889,12652,3578724919,3578724952,33
2,889,12653,3578724919,3578724953,34
2,889,12654,3578724919,3578724955,36
2,889,12655,3578724919,3578724955,36
2,889,12656,3578724919,3578724955,36
2,889,12657,3578724919,3578724956,37
2,889,12658,3578724919,3578724959,40
2,889,12659,3578724919,3578724965,46
2,889,12660,3578724919,3578724966,47
2,889,12661,3578724919,3578724966,47
2,889,12662,3578724919,3578724967,48
2,889,12663,3578724919,3578724967,48
2,889,12664,3578724919,3578724969,50
2,890,12665,3578724976,3578724976,0
2,890,12666,3578724976,3578724976,0
2,890,12667,3578724976,3578724976,0
2,890,12668,3578724976,3578724977,1
2,890,12669,3578724976,3578724980,4
2,890,12670,3578724976,3578724981,5
2,890,12671,3578724976,3578724981,5
2,890,12672,3578724976,3578724985,9
2,890,12673,3578724976,3578724986,10
2,890,12674,3578724976,3578724987,11
2,890,12675,3578724976,3578724988,12
2,890,12676,3578724976,3578724990,14
2,890,12677,3578724976,3578724991,15
2,890,12678,3578724976,3578724994,18
2,890,12679,3578724976,3578724994,18
2,890,12680,3578724976,3578724998,22
2,890,12681,3578724976,3578724998,22
2,890,12682,3578724976,3578725000,24
2,890,12683,3578724976,3578725002,26
2,890,12684,3578724976,3578725003,27
2,890,12685,3578724976,3578725007,31
2,890,12686,3578724976,3578725008,32
2,890,12687,3578724976,3578725009,33
2,890,12688,3578724976,3578725009,33
2,890,12689,3578724976,3578725011,35
2,890,12690,3578724976,3578725011,35
2,890,12691,3578724976,3578725013,37
2,890,12692,3578724976,3578725016,40
2,890,12693,3578724976,3578725017,41
2,890,12694,3578724976,3578725019,43
2,890,12695,3578724976,3578725021,45
2,890,12696,3578724976,3578725022,46
2,890,12697,3578724976,3578725022,46
2,890,12698,3578724976,3578725025,49
2,891,12699,3578725033,3578725033,0
2,891,12700,3578725033,3578725033,0
2,891,12701,3578725033,3578725033,0
2,891,12702,3578725033,3578725033,0
2,891,12703,3578725033,3578725033,0
2,891,12704,3578725033,3578725033,0
2,891,12705,3578725033,3578725033,0
2,891,12706,3578725033,3578725033,0
2,891,12707,3578725033,3578725033,0
2,891,12708,3578725033,3578725035,2
2,891,12709,3578725033,3578725035,2
2,891,12710,3578725033,3578725036,3
2,891,12711,3578725033,3578725037,4
2,891,12712,3578725033,3578725038,5
2,891,12713,3578725033,3578725039,6
2,891,12714,3578725033,3578725041,8
2,891,12715,3578725033,3578725041,8
2,891,12716,3578725033,3578725042,9
2,891,12717,3578725033,3578725042,9
2,891,12718,3578725033,3578725042,9
2,891,12719,3578725033,3578725043,10
2,891,12720,3578725033,3578725044,11
2,891,12721,3578725033,3578725045,12
2,891,12722,3578725033,3578725047,14
2,891,12723,3578725033,3578725047,14
2,891,12724,3578725033,3578725047,14
2,891,12725,3578725033,3578725050,17
2,891,12726,3578725033,3578725051,18
2,891,12727,3578725033,3578725052,19
2,891,12728,3578725033,3578725053,20
2,891,12729,3578725033,3578725056,23
2,891,12730,3578725033,3578725058,25
2,891,12731,3578725033,3578725059,26
2,891,12732,3578725033,3578725061,28
2,891,12733,3578725033,3578725061,28
2,891,12734,3578725033,3578725061,28
2,891,12735,3578725033,3578725061,28
2,891,12736,3578725033,3578725065,32
2,891,12737,3578725033,3578725066,33
2,891,12738,3578725033,3578725066,33
2,891,12739,3578725033,3578725068,35
2,891,12740,3578725033,3578725068,35
2,891,12741,3578725033,3578725069,36
2,891,12742,3578725033,3578725077,44
2,891,12743,3578725033,3578725080,47
2,891,12744,3578725033,3578725082,49
2,891,12745,3578725033,3578725082,49
2,891,12746,3578725033,3578725083,50
2,892,12747,3578725089,3578725089,0
2,892,12748,3578725089,3578725089,0
2,892,12749,3578725089,3578725089,0
2,892,12750,3578725089,3578725089,0
2,892,12751,3578725089,3578725089,0
2,892,12752,3578725089,3578725090,1
2,892,12753,3578725089,3578725091,2
2,892,12754,3578725089,3578725093,4
2,892,12755,3578725089,3578725093,4
2,892,12756,3578725089,3578725095,6
2,892,12757,3578725089,3578725097,8
2,892,12758,3578725089,3578725097,8
2,892,12759,3578725089,3578725098,9
2,892,12760,3578725089,3578725099,10
2,892,12761,3578725089,3578725100,11
2,892,12762,3578725089,3578725100,11
2,892,12763,3578725089,3578725100,11
2,892,12764,3578725089,3578725100,11
2,892,12765,3578725089,3578725101,12
2,892,12766,3578725089,3578725101,12
2,892,12767,3578725089,3578725102,13
2,892,12768,3578725089,3578725102,13
2,892,12769,3578725089,3578725106,17
2,892,12770,3578725089,3578725107,18
2,892,12771,3578725089,3578725107,18
2,892,12772,3578725089,3578725107,18
2,892,12773,3578725089,3578725108,19
2,892,12774,3578725089,3578725110,21
2,892,12775,3578725089,3578725112,23
2,892,12776,3578725089,3578725112,23
2,892,12777,3578725089,3578725112,23
2,892,12778,3578725089,3578725114,25
2,892,12779,3578725089,3578725114,25
2,892,12780,3578725089,3578725114,25
2,892,12781,3578725089,3578725115,26
2,892,12782,3578725089,3578725116,27
2,892,12783,3578725089,3578725118,29
2,892,12784,3578725089,3578725120,31
2,892,12785,3578725089,3578725120,31
2,892,12786,3578725089,3578725120,31
2,892,12787,3578725089,3578725121,32
2,892,12788,3578725089,3578725122,33
2,892,12789,3578725089,3578725126,37
2,892,12790,3578725089,3578725127,38
2,892,12791,3578725089,3578725129,40
2,892,12792,3578725089,3578725131,42
2,892,12793,3578725089,3578725133,44
2,892,12794,3578725089,3578725133,44
2,892,12795,3578725089,3578725134,45
2,892,12796,3578725089,3578725134,45
2,892,12797,3578725089,3578725136,47
2,892,12798,3578725089,3578725137,48
2,892,12799,3578725089,3578725138,49
2,892,12800,3578725089,3578725138,49
2,892,12801,3578725089,3578725138,49
2,893,12802,3578725145,3578725145,0
2,893,12803,3578725145,3578725145,0
2,893,12804,3578725145,3578725150,5
2,893,12805,3578725145,3578725151,6
2,893,12806,3578725145,3578725153,8
2,893,12807,3578725145,3578725153,8
2,893,12808,3578725145,3578725155,10
2,893,12809,3578725145,3578725156,11
2,893,12810,3578725145,3578725157,12
2,893,12811,3578725145,3578725164,19
2,893,12812,3578725145,3578725165,20
2,893,12813,3578725145,3578725165,20
2,893,12814,3578725145,3578725166,21
2,893,12815,3578725145,3578725166,21
2,893,12816,3578725145,3578725167,22
2,893,12817,3578725145,3578725167,22
2,893,12818,3578725145,3578725168,23
2,893,12819,3578725145,3578725172,27
2,893,12820,3578725145,3578725172,27
2,893,12821,3578725145,3578725174,29
2,893,12822,3578725145,3578725175,30
2,893,12823,3578725145,3578725176,31
2,893,12824,3578725145,3578725177,32
2,893,12825,3578725145,3578725181,36
2,893,12826,3578725145,3578725181,36
2,893,12827,3578725145,3578725182,37
2,893,12828,3578725145,3578725185,40
2,893,12829,3578725145,3578725186,41
2,893,12830,3578725145,3578725188,43
2,893,12831,3578725145,3578725189,44
2,893,12832,3578725145,3578725190,45
2,893,12833,3578725145,3578725191,46
2,893,12834,3578725145,3578725193,48
2,893,12835,3578725145,3578725194,49
2,893,12836,3578725145,3578725195,50
2,894,12837,3578725201,3578725201,0
2,894,12838,3578725201,3578725201,0
2,894,12839,3578725201,3578725201,0
2,894,12840,3578725201,3578725203,2
2,894,12841,3578725201,3578725203,2
2,894,12842,3578725201,3578725207,6
2,894,12843,3578725201,3578725209,8
2,894,12844,3578725201,3578725209,8
2,894,12845,3578725201,3578725210,9
2,894,12846,3578725201,3578725211,10
2,894,12847,3578725201,3578725212,11
2,894,12848,3578725201,3578725213,12
2,894,12849,3578725201,3578725217,16
2,894,12850,3578725201,3578725217,16
2,894,12851,3578725201,3578725220,19
2,894,12852,3578725201,3578725221,20
2,894,12853,3578725201,3578725221,20
2,894,12854,3578725201,3578725222,21
2,894,12855,3578725201,3578725222,21
2,894,12856,3578725201,3578725226,25
2,894,12857,3578725201,3578725226,25
2,894,12858,3578725201,3578725228,27
2,894,12859,3578725201,3578725229,28
2,894,12860,3578725201,3578725230,29
2,894,12861,3578725201,3578725231,30
2,894,12862,3578725201,3578725231,30
2,894,12863,3578725201,3578725232,31
2,894,12864,3578725201,3578725233,32
2,894,12865,3578725201,3578725234,33
2,894,12866,3578725201,3578725235,34
2,894,12867,3578725201,3578725237,36
2,894,12868,3578725201,3578725237,36
2,894,12869,3578725201,3578725238,37
2,894,12870,3578725201,3578725240,39
2,894,12871,3578725201,3578725242,41
2,894,12872,3578725201,3578725242,41
2,894,12873,3578725201,3578725243,42
2,894,12874,3578725201,3578725243,42
2,894,12875,3578725201,3578725243,42
2,894,12876,3578725201,3578725243,42
2,894,12877,3578725201,3578725245,44
2,894,12878,3578725201,3578725247,46
2,894,12879,3578725201,3578725247,46
2,894,12880,3578725201,3578725247,46
2,894,12881,3578725201,3578725250,49
2,894,12882,3578725201,3578725251,50
2,895,12883,3578725258,3578725258,0
2,895,12884,3578725258,3578725258,0
2,895,12885,3578725258,3578725258,0
2,895,12886,3578725258,3578725258,0
2,895,12887,3578725258,3578725258,0
2,895,12888,3578725258,3578725258,0
2,895,12889,3578725258,3578725260,2
2,895,12890,3578725258,3578725260,2
2,895,12891,3578725258,3578725261,3
2,895,12892,3578725258,3578725261,3
2,895,12893,3578725258,3578725265,7
2,895,12894,3578725258,3578725266,8
2,895,12895,3578725258,3578725267,9
2,895,12896,3578725258,3578725267,9
2,895,12897,3578725258,3578725269,11
2,895,12898,3578725258,3578725269,11
2,895,12899,3578725258,3578725277,19
2,895,12900,3578725258,3578725279,21
2,895,12901,3578725258,3578725281,23
2,895,12902,3578725258,3578725282,24
2,895,12903,3578725258,3578725282,24
2,895,12904,3578725258,3578725283,25
2,895,12905,3578725258,3578725283,25
2,895,12906,3578725258,3578725286,28
2,895,12907,3578725258,3578725287,29
2,895,12908,3578725258,3578725287,29
2,895,12909,3578725258,3578725287,29
2,895,12910,3578725258,3578725289,31
2,895,12911,3578725258,3578725290,32
2,895,12912,3578725258,3578725291,33
2,895,12913,3578725258,3578725293,35
2,895,12914,3578725258,3578725295,37
2,895,12915,3578725258,3578725297,39
2,895,12916,3578725258,3578725297,39
2,895,12917,3578725258,3578725299,41
2,895,12918,3578725258,3578725300,42
2,895,12919,3578725258,3578725300,42
2,895,12920,3578725258,3578725300,42
2,895,12921,3578725258,3578725300,42
2,895,12922,3578725258,3578725300,42
2,895,12923,3578725258,3578725300,42
2,895,12924,3578725258,3578725300,42
2,895,12925,3578725258,3578725302,44
2,895,12926,3578725258,3578725305,47
2,895,12927,3578725258,3578725307,49
2,895,12928,3578725258,3578725307,49
2,895,12929,3578725258,3578725307,49
2,895,12930,3578725258,3578725308,50
2,896,12931,3578725314,3578725314,0
2,896,12932,3578725314,3578725314,0
2,896,12933,3578725314,3578725314,0
2,896,12934,3578725314,3578725314,0
2,896,12935,3578725314,3578725314,0
2,896,12936,3578725314,3578725314,0
2,896,12937,3578725314,3578725315,1
2,896,12938,3578725314,3578725316,2
2,896,12939,3578725314,3578725316,2
2,896,12940,3578725314,3578725319,5
2,896,12941,3578725314,3578725320,6
2,896,12942,3578725314,3578725320,6
2,896,12943,3578725314,3578725321,7
2,896,12944,3578725314,3578725321,7
2,896,12945,3578725314,3578725321,7
2,896,12946,3578725314,3578725322,8
2,896,12947,3578725314,3578725326,12
2,896,12948,3578725314,3578725327,13
2,896,12949,3578725314,3578725329,15
2,896,12950,3578725314,3578725331,17
2,896,12951,3578725314,3578725333,19
2,896,12952,3578725314,3578725333,19
2,896,12953,3578725314,3578725334,20
2,896,12954,3578725314,3578725335,21
2,896,12955,3578725314,3578725336,22
2,896,12956,3578725314,3578725337,23
2,896,12957,3578725314,3578725337,23
2,896,12958,3578725314,3578725337,23
2,896,12959,3578725314,3578725338,24
2,896,12960,3578725314,3578725341,27
2,896,12961,3578725314,3578725350,36
2,896,12962,3578725314,3578725352,38
2,896,12963,3578725314,3578725352,38
2,896,12964,3578725314,3578725353,39
2,896,12965,3578725314,3578725354,40
2,896,12966,3578725314,3578725355,41
2,896,12967,3578725314,3578725355,41
2,896,12968,3578725314,3578725356,42
2,896,12969,3578725314,3578725356,42
2,896,12970,3578725314,3578725360,46
2,897,12971,3578725371,3578725371,0
2,897,12972,3578725371,3578725371,0
2,897,12973,3578725371,3578725371,0
2,897,12974,3578725371,3578725371,0
2,897,12975,3578725371,3578725371,0
2,897,12976,3578725371,3578725371,0
2,897,12977,3578725371,3578725371,0
2,897,12978,3578725371,3578725371,0
2,897,12979,3578725371,3578725373,2
2,897,12980,3578725371,3578725373,2
2,897,12981,3578725371,3578725374,3
2,897,12982,3578725371,3578725376,5
2,897,12983,3578725371,3578725376,5
2,897,12984,3578725371,3578725378,7
2,897,12985,3578725371,3578725381,10
2,897,12986,3578725371,3578725382,11
2,897,12987,3578725371,3578725382,11
2,897,12988,3578725371,3578725385,14
2,897,12989,3578725371,3578725386,15
2,897,12990,3578725371,3578725388,17
2,897,12991,3578725371,3578725389,18
2,897,12992,3578725371,3578725391,20
2,897,12993,3578725371,3578725392,21
2,897,12994,3578725371,3578725394,23
2,897,12995,3578725371,3578725395,24
2,897,12996,3578725371,3578725398,27
2,897,12997,3578725371,3578725399,28
2,897,12998,3578725371,3578725400,29
2,897,12999,3578725371,3578725403,32
2,897,13000,3578725371,3578725404,33
2,897,13001,3578725371,3578725408,37
2,897,13002,3578725371,3578725408,37
2,897,13003,3578725371,3578725409,38
2,897,13004,3578725371,3578725410,39
2,897,13005,3578725371,3578725411,40
2,897,13006,3578725371,3578725412,41
2,897,13007,3578725371,3578725414,43
2,897,13008,3578725371,3578725416,45
2,897,13009,3578725371,3578725417,46
2,897,13010,3578725371,3578725420,49
2,898,13011,3578725429,3578725429,0
2,898,13012,3578725429,3578725429,0
2,898,13013,3578725429,3578725429,0
2,898,13014,3578725429,3578725429,0
2,898,13015,3578725429,3578725429,0
2,898,13016,3578725429,3578725429,0
2,898,13017,3578725429,3578725429,0
2,898,13018,3578725429,3578725429,0
2,898,13019,3578725429,3578725430,1
2,898,13020,3578725429,3578725430,1
2,898,13021,3578725429,3578725431,2
2,898,13022,3578725429,3578725432,3
2,898,13023,3578725429,3578725432,3
2,898,13024,3578725429,3578725433,4
2,898,13025,3578725429,3578725433,4
2,898,13026,3578725429,3578725435,6
2,898,13027,3578725429,3578725436,7
2,898,13028,3578725429,3578725437,8
2,898,13029,3578725429,3578725438,9
2,898,13030,3578725429,3578725438,9
2,898,13031,3578725429,3578725440,11
2,898,13032,3578725429,3578725442,13
2,898,13033,3578725429,3578725442,13
2,898,13034,3578725429,3578725443,14
2,898,13035,3578725429,3578725443,14
2,898,13036,3578725429,3578725443,14
2,898,13037,3578725429,3578725445,16
2,898,13038,3578725429,3578725447,18
2,898,13039,3578725429,3578725447,18
2,898,13040,3578725429,3578725447,18
2,898,13041,3578725429,3578725450,21
2,898,13042,3578725429,3578725451,22
2,898,13043,3578725429,3578725453,24
2,898,13044,3578725429,3578725455,26
2,898,13045,3578725429,3578725458,29
2,898,13046,3578725429,3578725458,29
2,898,13047,3578725429,3578725459,30
2,898,13048,3578725429,3578725460,31
2,898,13049,3578725429,3578725461,32
2,898,13050,3578725429,3578725461,32
2,898,13051,3578725429,3578725465,36
2,898,13052,3578725429,3578725466,37
2,898,13053,3578725429,3578725468,39
2,898,13054,3578725429,3578725468,39
2,898,13055,3578725429,3578725469,40
2,898,13056,3578725429,3578725470,41
2,898,13057,3578725429,3578725477,48
2,899,13058,3578725485,3578725485,0
2,899,13059,3578725485,3578725485,0
2,899,13060,3578725485,3578725485,0
2,899,13061,3578725485,3578725485,0
2,899,13062,3578725485,3578725485,0
2,899,13063,3578725485,3578725485,0
2,899,13064,3578725485,3578725485,0
2,899,13065,3578725485,3578725486,1
2,899,13066,3578725485,3578725487,2
2,899,13067,3578725485,3578725488,3
2,899,13068,3578725485,3578725489,4
2,899,13069,3578725485,3578725490,5
2,899,13070,3578725485,3578725491,6
2,899,13071,3578725485,3578725492,7
2,899,13072,3578725485,3578725492,7
2,899,13073,3578725485,3578725494,9
2,899,13074,3578725485,3578725496,11
2,899,13075,3578725485,3578725496,11
2,899,13076,3578725485,3578725498,13
2,899,13077,3578725485,3578725499,14
2,899,13078,3578725485,3578725499,14
2,899,13079,3578725485,3578725499,14
2,899,13080,3578725485,3578725500,15
2,899,13081,3578725485,3578725500,15
2,899,13082,3578725485,3578725500,15
2,899,13083,3578725485,3578725501,16
2,899,13084,3578725485,3578725505,20
2,899,13085,3578725485,3578725506,21
2,899,13086,3578725485,3578725506,21
2,899,13087,3578725485,3578725507,22
2,899,13088,3578725485,3578725507,22
2,899,13089,3578725485,3578725510,25
2,899,13090,3578725485,3578725511,26
2,899,13091,3578725485,3578725511,26
2,899,13092,3578725485,3578725511,26
2,899,13093,3578725485,3578725512,27
2,899,13094,3578725485,3578725513,28
2,899,13095,3578725485,3578725514,29
2,899,13096,3578725485,3578725515,30
2,899,13097,3578725485,3578725516,31
2,899,13098,3578725485,3578725518,33
2,899,13099,3578725485,3578725519,34
2,899,13100,3578725485,3578725519,34
2,899,13101,3578725485,3578725519,34
2,899,13102,3578725485,3578725520,35
2,899,13103,3578725485,3578725521,36
2,899,13104,3578725485,3578725521,36
2,899,13105,3578725485,3578725521,36
2,899,13106,3578725485,3578725525,40
2,899,13107,3578725485,3578725526,41
2,899,13108,3578725485,3578725528,43
2,899,13109,3578725485,3578725531,46
2,899,13110,3578725485,3578725532,47
2,899,13111,3578725485,3578725533,48
2,899,13112,3578725485,3578725534,49
2,899,13113,3578725485,3578725535,50
2,900,13114,3578725542,3578725542,0
2,900,13115,3578725542,3578725542,0
2,900,13116,3578725542,3578725542,0
2,900,13117,3578725542,3578725542,0
2,900,13118,3578725542,3578725542,0
2,900,13119,3578725542,3578725542,0
2,900,13120,3578725542,3578725544,2
2,900,13121,3578725542,3578725551,9
2,900,13122,3578725542,3578725552,10
2,900,13123,3578725542,3578725553,11
2,900,13124,3578725542,3578725554,12
2,900,13125,3578725542,3578725555,13
2,900,13126,3578725542,3578725556,14
2,900,13127,3578725542,3578725556,14
2,900,13128,3578725542,3578725559,17
2,900,13129,3578725542,3578725563,21
2,900,13130,3578725542,3578725563,21
2,900,13131,3578725542,3578725564,22
2,900,13132,3578725542,3578725566,24
2,900,13133,3578725542,3578725567,25
2,900,13134,3578725542,3578725568,26
2,900,13135,3578725542,3578725568,26
2,900,13136,3578725542,3578725572,30
2,900,13137,3578725542,3578725572,30
2,900,13138,3578725542,3578725573,31
2,900,13139,3578725542,3578725575,33
2,900,13140,3578725542,3578725576,34
2,900,13141,3578725542,3578725577,35
2,900,13142,3578725542,3578725580,38
2,900,13143,3578725542,3578725581,39
2,900,13144,3578725542,3578725582,40
2,900,13145,3578725542,3578725584,42
2,900,13146,3578725542,3578725584,42
2,900,13147,3578725542,3578725588,46
2,900,13148,3578725542,3578725588,46
2,900,13149,3578725542,3578725591,49
2,900,13150,3578725542,3578725591,49
2,901,13151,3578725599,3578725599,0
2,901,13152,3578725599,3578725599,0
2,901,13153,3578725599,3578725599,0
2,901,13154,3578725599,3578725599,0
2,901,13155,3578725599,3578725599,0
2,901,13156,3578725599,3578725602,3
2,901,13157,3578725599,3578725603,4
2,901,13158,3578725599,3578725608,9
2,901,13159,3578725599,3578725608,9
2,901,13160,3578725599,3578725609,10
2,901,13161,3578725599,3578725610,11
2,901,13162,3578725599,3578725610,11
2,901,13163,3578725599,3578725612,13
2,901,13164,3578725599,3578725612,13
2,901,13165,3578725599,3578725615,16
2,901,13166,3578725599,3578725616,17
2,901,13167,3578725599,3578725617,18
2,901,13168,3578725599,3578725619,20
2,901,13169,3578725599,3578725620,21
2,901,13170,3578725599,3578725621,22
2,901,13171,3578725599,3578725622,23
2,901,13172,3578725599,3578725622,23
2,901,13173,3578725599,3578725625,26
2,901,13174,3578725599,3578725628,29
2,901,13175,3578725599,3578725628,29
2,901,13176,3578725599,3578725628,29
2,901,13177,3578725599,3578725628,29
2,901,13178,3578725599,3578725629,30
2,901,13179,3578725599,3578725631,32
2,901,13180,3578725599,3578725632,33
2,901,13181,3578725599,3578725632,33
2,901,13182,3578725599,3578725632,33
2,901,13183,3578725599,3578725634,35
2,901,13184,3578725599,3578725635,36
2,901,13185,3578725599,3578725635,36
2,901,13186,3578725599,3578725636,37
2,901,13187,3578725599,3578725637,38
2,901,13188,3578725599,3578725637,38
2,901,13189,3578725599,3578725641,42
2,901,13190,3578725599,3578725641,42
2,901,13191,3578725599,3578725641,42
2,901,13192,3578725599,3578725642,43
2,901,13193,3578725599,3578725642,43
2,901,13194,3578725599,3578725643,44
2,901,13195,3578725599,3578725644,45
2,901,13196,3578725599,3578725644,45
2,901,13197,3578725599,3578725646,47
2,901,13198,3578725599,3578725646,47
2,901,13199,3578725599,3578725647,48
2,902,13200,3578725655,3578725655,0
2,902,13201,3578725655,3578725655,0
2,902,13202,3578725655,3578725655,0
2,902,13203,3578725655,3578725655,0
2,902,13204,3578725655,3578725657,2
2,902,13205,3578725655,3578725658,3
2,902,13206,3578725655,3578725658,3
2,902,13207,3578725655,3578725659,4
2,902,13208,3578725655,3578725659,4
2,902,13209,3578725655,3578725660,5
2,902,13210,3578725655,3578725660,5
2,902,13211,3578725655,3578725663,8
2,902,13212,3578725655,3578725665,10
2,902,13213,3578725655,3578725665,10
2,902,13214,3578725655,3578725666,11
2,902,13215,3578725655,3578725668,13
2,902,13216,3578725655,3578725668,13
2,902,13217,3578725655,3578725670,15
2,902,13218,3578725655,3578725677,22
2,902,13219,3578725655,3578725680,25
2,902,13220,3578725655,3578725680,25
2,902,13221,3578725655,3578725681,26
2,902,13222,3578725655,3578725681,26
2,902,13223,3578725655,3578725682,27
2,902,13224,3578725655,3578725682,27
2,902,13225,3578725655,3578725685,30
2,902,13226,3578725655,3578725686,31
2,902,13227,3578725655,3578725686,31
2,902,13228,3578725655,3578725687,32
2,902,13229,3578725655,3578725688,33
2,902,13230,3578725655,3578725689,34
2,902,13231,3578725655,3578725690,35
2,902,13232,3578725655,3578725690,35
2,902,13233,3578725655,3578725692,37
2,902,13234,3578725655,3578725693,38
2,902,13235,3578725655,3578725694,39
2,902,13236,3578725655,3578725696,41
2,902,13237,3578725655,3578725696,41
2,902,13238,3578725655,3578725698,43
2,902,13239,3578725655,3578725698,43
2,902,13240,3578725655,3578725699,44
2,902,13241,3578725655,3578725699,44
2,902,13242,3578725655,3578725700,45
2,902,13243,3578725655,3578725700,45
2,902,13244,3578725655,3578725700,45
2,902,13245,3578725655,3578725700,45
2,902,13246,3578725655,3578725701,46
2,902,13247,3578725655,3578725705,50
2,903,13248,3578725712,3578725712,0
2,903,13249,3578725712,3578725712,0
2,903,13250,3578725712,3578725712,0
2,903,13251,3578725712,3578725712,0
2,903,13252,3578725712,3578725712,0
2,903,13253,3578725712,3578725712,0
2,903,13254,3578725712,3578725712,0
2,903,13255,3578725712,3578725713,1
2,903,13256,3578725712,3578725714,2
2,903,13257,3578725712,3578725714,2
2,903,13258,3578725712,3578725715,3
2,903,13259,3578725712,3578725715,3
2,903,13260,3578725712,3578725718,6
2,903,13261,3578725712,3578725719,7
2,903,13262,3578725712,3578725719,7
2,903,13263,3578725712,3578725720,8
2,903,13264,3578725712,3578725721,9
2,903,13265,3578725712,3578725721,9
2,903,13266,3578725712,3578725722,10
2,903,13267,3578725712,3578725723,11
2,903,13268,3578725712,3578725724,12
2,903,13269,3578725712,3578725727,15
2,903,13270,3578725712,3578725729,17
2,903,13271,3578725712,3578725732,20
2,903,13272,3578725712,3578725732,20
2,903,13273,3578725712,3578725733,21
2,903,13274,3578725712,3578725735,23
2,903,13275,3578725712,3578725735,23
2,903,13276,3578725712,3578725736,24
2,903,13277,3578725712,3578725736,24
2,903,13278,3578725712,3578725737,25
2,903,13279,3578725712,3578725737,25
2,903,13280,3578725712,3578725741,29
2,903,13281,3578725712,3578725745,33
2,903,13282,3578725712,3578725750,38
2,903,13283,3578725712,3578725751,39
2,903,13284,3578725712,3578725751,39
2,903,13285,3578725712,3578725753,41
2,903,13286,3578725712,3578725753,41
2,903,13287,3578725712,3578725754,42
2,903,13288,3578725712,3578725755,43
2,903,13289,3578725712,3578725756,44
2,903,13290,3578725712,3578725756,44
2,903,13291,3578725712,3578725758,46
2,904,13292,3578725769,3578725769,0
2,904,13293,3578725769,3578725769,0
2,904,13294,3578725769,3578725769,0
2,904,13295,3578725769,3578725769,0
2,904,13296,3578725769,3578725769,0
2,904,13297,3578725769,3578725769,0
2,904,13298,3578725769,3578725769,0
2,904,13299,3578725769,3578725771,2
2,904,13300,3578725769,3578725772,3
2,904,13301,3578725769,3578725774,5
2,904,13302,3578725769,3578725775,6
2,904,13303,3578725769,3578725776,7
2,904,13304,3578725769,3578725776,7
2,904,13305,3578725769,3578725780,11
2,904,13306,3578725769,3578725781,12
2,904,13307,3578725769,3578725783,14
2,904,13308,3578725769,3578725785,16
2,904,13309,3578725769,3578725785,16
2,904,13310,3578725769,3578725787,18
2,904,13311,3578725769,3578725788,19
2,904,13312,3578725769,3578725791,22
2,904,13313,3578725769,3578725794,25
2,904,13314,3578725769,3578725795,26
2,904,13315,3578725769,3578725798,29
2,904,13316,3578725769,3578725798,29
2,904,13317,3578725769,3578725799,30
2,904,13318,3578725769,3578725802,33
2,904,13319,3578725769,3578725804,35
2,904,13320,3578725769,3578725808,39
2,904,13321,3578725769,3578725808,39
2,904,13322,3578725769,3578725808,39
2,904,13323,3578725769,3578725809,40
2,904,13324,3578725769,3578725811,42
2,904,13325,3578725769,3578725811,42
2,904,13326,3578725769,3578725813,44
2,904,13327,3578725769,3578725816,47
2,904,13328,3578725769,3578725816,47
2,904,13329,3578725769,3578725817,48
2,904,13330,3578725769,3578725818,49
2,905,13331,3578725825,3578725825,0
2,905,13332,3578725825,3578725825,0
2,905,13333,3578725825,3578725825,0
2,905,13334,3578725825,3578725825,0
2,905,13335,3578725825,3578725826,1
2,905,13336,3578725825,3578725827,2
2,905,13337,3578725825,3578725828,3
2,905,13338,3578725825,3578725828,3
2,905,13339,3578725825,3578725829,4
2,905,13340,3578725825,3578725830,5
2,905,13341,3578725825,3578725830,5
2,905,13342,3578725825,3578725832,7
2,905,13343,3578725825,3578725833,8
2,905,13344,3578725825,3578725834,9
2,905,13345,3578725825,3578725835,10
2,905,13346,3578725825,3578725837,12
2,905,13347,3578725825,3578725837,12
2,905,13348,3578725825,3578725840,15
2,905,13349,3578725825,3578725841,16
2,905,13350,3578725825,3578725841,16
2,905,13351,3578725825,3578725842,17
2,905,13352,3578725825,3578725842,17
2,905,13353,3578725825,3578725843,18
2,905,13354,3578725825,3578725843,18
2,905,13355,3578725825,3578725844,19
2,905,13356,3578725825,3578725846,21
2,905,13357,3578725825,3578725847,22
2,905,13358,3578725825,3578725848,23
2,905,13359,3578725825,3578725850,25
2,905,13360,3578725825,3578725851,26
2,905,13361,3578725825,3578725851,26
2,905,13362,3578725825,3578725854,29
2,905,13363,3578725825,3578725856,31
2,905,13364,3578725825,3578725858,33
2,905,13365,3578725825,3578725858,33
2,905,13366,3578725825,3578725859,34
2,905,13367,3578725825,3578725860,35
2,905,13368,3578725825,3578725860,35
2,905,13369,3578725825,3578725861,36
2,905,13370,3578725825,3578725863,38
2,905,13371,3578725825,3578725865,40
2,905,13372,3578725825,3578725867,42
2,905,13373,3578725825,3578725869,44
2,906,13374,3578725882,3578725882,0
2,906,13375,3578725882,3578725882,0
2,906,13376,3578725882,3578725882,0
2,906,13377,3578725882,3578725882,0
2,906,13378,3578725882,3578725882,0
2,906,13379,3578725882,3578725882,0
2,906,13380,3578725882,3578725884,2
2,906,13381,3578725882,3578725886,4
2,906,13382,3578725882,3578725886,4
2,906,13383,3578725882,3578725887,5
2,906,13384,3578725882,3578725889,7
2,906,13385,3578725882,3578725889,7
2,906,13386,3578725882,3578725890,8
2,906,13387,3578725882,3578725890,8
2,906,13388,3578725882,3578725892,10
2,906,13389,3578725882,3578725892,10
2,906,13390,3578725882,3578725895,13
2,906,13391,3578725882,3578725897,15
2,906,13392,3578725882,3578725898,16
2,906,13393,3578725882,3578725899,17
2,906,13394,3578725882,3578725899,17
2,906,13395,3578725882,3578725900,18
2,906,13396,3578725882,3578725900,18
2,906,13397,3578725882,3578725900,18
2,906,13398,3578725882,3578725900,18
2,906,13399,3578725882,3578725900,18
2,906,13400,3578725882,3578725901,19
2,906,13401,3578725882,3578725901,19
2,906,13402,3578725882,3578725904,22
2,906,13403,3578725882,3578725906,24
2,906,13404,3578725882,3578725907,25
2,906,13405,3578725882,3578725907,25
2,906,13406,3578725882,3578725909,27
2,906,13407,3578725882,3578725910,28
2,906,13408,3578725882,3578725912,30
2,906,13409,3578725882,3578725912,30
2,906,13410,3578725882,3578725912,30
2,906,13411,3578725882,3578725913,31
2,906,13412,3578725882,3578725914,32
2,906,13413,3578725882,3578725914,32
2,906,13414,3578725882,3578725915,33
2,906,13415,3578725882,3578725915,33
2,906,13416,3578725882,3578725918,36
2,906,13417,3578725882,3578725919,37
2,906,13418,3578725882,3578725920,38
2,906,13419,3578725882,3578725920,38
2,906,13420,3578725882,3578725921,39
2,906,13421,3578725882,3578725921,39
2,906,13422,3578725882,3578725921,39
2,906,13423,3578725882,3578725922,40
2,906,13424,3578725882,3578725922,40
2,906,13425,3578725882,3578725925,43
2,906,13426,3578725882,3578725927,45
2,906,13427,3578725882,3578725929,47
2,906,13428,3578725882,3578725932,50
2,907,13429,3578725940,3578725940,0
2,907,13430,3578725940,3578725940,0
2,907,13431,3578725940,3578725940,0
2,907,13432,3578725940,3578725940,0
2,907,13433,3578725940,3578725940,0
2,907,13434,3578725940,3578725940,0
2,907,13435,3578725940,3578725940,0
2,907,13436,3578725940,3578725940,0
2,907,13437,3578725940,3578725940,0
2,907,13438,3578725940,3578725941,1
2,907,13439,3578725940,3578725945,5
2,907,13440,3578725940,3578725950,10
2,907,13441,3578725940,3578725951,11
2,907,13442,3578725940,3578725953,13
2,907,13443,3578725940,3578725953,13
2,907,13444,3578725940,3578725955,15
2,907,13445,3578725940,3578725955,15
2,907,13446,3578725940,3578725956,16
2,907,13447,3578725940,3578725956,16
2,907,13448,3578725940,3578725958,18
2,907,13449,3578725940,3578725962,22
2,907,13450,3578725940,3578725964,24
2,907,13451,3578725940,3578725965,25
2,907,13452,3578725940,3578725966,26
2,907,13453,3578725940,3578725967,27
2,907,13454,3578725940,3578725967,27
2,907,13455,3578725940,3578725968,28
2,907,13456,3578725940,3578725973,33
2,907,13457,3578725940,3578725974,34
2,907,13458,3578725940,3578725976,36
2,907,13459,3578725940,3578725976,36
2,907,13460,3578725940,3578725977,37
2,907,13461,3578725940,3578725980,40
2,907,13462,3578725940,3578725981,41
2,907,13463,3578725940,3578725984,44
2,907,13464,3578725940,3578725984,44
2,907,13465,3578725940,3578725984,44
2,907,13466,3578725940,3578725988,48
2,907,13467,3578725940,3578725988,48
2,907,13468,3578725940,3578725990,50
2,908,13469,3578725996,3578725996,0
2,908,13470,3578725996,3578725996,0
2,908,13471,3578725996,3578725997,1
2,908,13472,3578725996,3578725997,1
2,908,13473,3578725996,3578725998,2
2,908,13474,3578725996,3578725999,3
2,908,13475,3578725996,3578726000,4
2,908,13476,3578725996,3578726002,6
2,908,13477,3578725996,3578726004,8
2,908,13478,3578725996,3578726008,12
2,908,13479,3578725996,3578726008,12
2,908,13480,3578725996,3578726009,13
2,908,13481,3578725996,3578726009,13
2,908,13482,3578725996,3578726011,15
2,908,13483,3578725996,3578726012,16
2,908,13484,3578725996,3578726013,17
2,908,13485,3578725996,3578726016,20
2,908,13486,3578725996,3578726017,21
2,908,13487,3578725996,3578726018,22
2,908,13488,3578725996,3578726020,24
2,908,13489,3578725996,3578726022,26
2,908,13490,3578725996,3578726022,26
2,908,13491,3578725996,3578726023,27
2,908,13492,3578725996,3578726026,30
2,908,13493,3578725996,3578726026,30
2,908,13494,3578725996,3578726028,32
2,908,13495,3578725996,3578726028,32
2,908,13496,3578725996,3578726029,33
2,908,13497,3578725996,3578726029,33
2,908,13498,3578725996,3578726030,34
2,908,13499,3578725996,3578726030,34
2,908,13500,3578725996,3578726030,34
2,908,13501,3578725996,3578726032,36
2,908,13502,3578725996,3578726032,36
2,908,13503,3578725996,3578726033,37
2,908,13504,3578725996,3578726035,39
2,908,13505,3578725996,3578726035,39
2,908,13506,3578725996,3578726037,41
2,908,13507,3578725996,3578726037,41
2,908,13508,3578725996,3578726038,42
2,908,13509,3578725996,3578726040,44
2,908,13510,3578725996,3578726041,45
2,908,13511,3578725996,3578726041,45
2,908,13512,3578725996,3578726042,46
2,908,13513,3578725996,3578726042,46
2,908,13514,3578725996,3578726043,47
2,908,13515,3578725996,3578726043,47
2,908,13516,3578725996,3578726044,48
2,909,13517,3578726053,3578726054,1
2,909,13518,3578726053,3578726054,1
2,909,13519,3578726053,3578726054,1
2,909,13520,3578726053,3578726054,1
2,909,13521,3578726053,3578726054,1
2,909,13522,3578726053,3578726054,1
2,909,13523,3578726053,3578726054,1
2,909,13524,3578726053,3578726054,1
2,909,13525,3578726053,3578726057,4
2,909,13526,3578726053,3578726058,5
2,909,13527,3578726053,3578726058,5
2,909,13528,3578726053,3578726059,6
2,909,13529,3578726053,3578726060,7
2,909,13530,3578726053,3578726060,7
2,909,13531,3578726053,3578726061,8
2,909,13532,3578726053,3578726064,11
2,909,13533,3578726053,3578726065,12
2,909,13534,3578726053,3578726067,14
2,909,13535,3578726053,3578726068,15
2,909,13536,3578726053,3578726069,16
2,909,13537,3578726053,3578726077,24
2,909,13538,3578726053,3578726078,25
2,909,13539,3578726053,3578726080,27
2,909,13540,3578726053,3578726081,28
2,909,13541,3578726053,3578726081,28
2,909,13542,3578726053,3578726082,29
2,909,13543,3578726053,3578726083,30
2,909,13544,3578726053,3578726085,32
2,909,13545,3578726053,3578726086,33
2,909,13546,3578726053,3578726086,33
2,909,13547,3578726053,3578726086,33
2,909,13548,3578726053,3578726089,36
2,909,13549,3578726053,3578726089,36
2,909,13550,3578726053,3578726090,37
2,909,13551,3578726053,3578726091,38
2,909,13552,3578726053,3578726092,39
2,909,13553,3578726053,3578726092,39
2,909,13554,3578726053,3578726095,42
2,909,13555,3578726053,3578726097,44
2,909,13556,3578726053,3578726098,45
2,909,13557,3578726053,3578726099,46
2,909,13558,3578726053,3578726100,47
2,909,13559,3578726053,3578726100,47
2,909,13560,3578726053,3578726100,47
2,909,13561,3578726053,3578726100,47
2,909,13562,3578726053,3578726100,47
2,909,13563,3578726053,3578726101,48
2,909,13564,3578726053,3578726101,48
2,910,13565,3578726111,3578726111,0
2,910,13566,3578726111,3578726111,0
2,910,13567,3578726111,3578726111,0
2,910,13568,3578726111,3578726111,0
2,910,13569,3578726111,3578726111,0
2,910,13570,3578726111,3578726111,0
2,910,13571,3578726111,3578726112,1
2,910,13572,3578726111,3578726113,2
2,910,13573,3578726111,3578726113,2
2,910,13574,3578726111,3578726114,3
2,910,13575,3578726111,3578726115,4
2,910,13576,3578726111,3578726115,4
2,910,13577,3578726111,3578726115,4
2,910,13578,3578726111,3578726119,8
2,910,13579,3578726111,3578726120,9
2,910,13580,3578726111,3578726121,10
2,910,13581,3578726111,3578726121,10
2,910,13582,3578726111,3578726121,10
2,910,13583,3578726111,3578726122,11
2,910,13584,3578726111,3578726123,12
2,910,13585,3578726111,3578726126,15
2,910,13586,3578726111,3578726127,16
2,910,13587,3578726111,3578726129,18
2,910,13588,3578726111,3578726132,21
2,910,13589,3578726111,3578726132,21
2,910,13590,3578726111,3578726133,22
2,910,13591,3578726111,3578726135,24
2,910,13592,3578726111,3578726136,25
2,910,13593,3578726111,3578726137,26
2,910,13594,3578726111,3578726137,26
2,910,13595,3578726111,3578726138,27
2,910,13596,3578726111,3578726138,27
2,910,13597,3578726111,3578726141,30
2,910,13598,3578726111,3578726145,34
2,910,13599,3578726111,3578726150,39
2,910,13600,3578726111,3578726151,40
2,910,13601,3578726111,3578726151,40
2,910,13602,3578726111,3578726153,42
2,910,13603,3578726111,3578726153,42
2,910,13604,3578726111,3578726154,43
2,910,13605,3578726111,3578726155,44
2,910,13606,3578726111,3578726156,45
2,910,13607,3578726111,3578726156,45
2,910,13608,3578726111,3578726159,48
2,911,13609,3578726168,3578726168,0
2,911,13610,3578726168,3578726168,0
2,911,13611,3578726168,3578726168,0
2,911,13612,3578726168,3578726168,0
2,911,13613,3578726168,3578726168,0
2,911,13614,3578726168,3578726168,0
2,911,13615,3578726168,3578726168,0
2,911,13616,3578726168,3578726173,5
2,911,13617,3578726168,3578726173,5
2,911,13618,3578726168,3578726174,6
2,911,13619,3578726168,3578726176,8
2,911,13620,3578726168,3578726176,8
2,911,13621,3578726168,3578726177,9
2,911,13622,3578726168,3578726181,13
2,911,13623,3578726168,3578726181,13
2,911,13624,3578726168,3578726184,16
2,911,13625,3578726168,3578726184,16
2,911,13626,3578726168,3578726184,16
2,911,13627,3578726168,3578726186,18
2,911,13628,3578726168,3578726189,21
2,911,13629,3578726168,3578726191,23
2,911,13630,3578726168,3578726191,23
2,911,13631,3578726168,3578726194,26
2,911,13632,3578726168,3578726195,27
2,911,13633,3578726168,3578726198,30
2,911,13634,3578726168,3578726199,31
2,911,13635,3578726168,3578726200,32
2,911,13636,3578726168,3578726202,34
2,911,13637,3578726168,3578726204,36
2,911,13638,3578726168,3578726208,40
2,911,13639,3578726168,3578726209,41
2,911,13640,3578726168,3578726210,42
2,911,13641,3578726168,3578726211,43
2,911,13642,3578726168,3578726212,44
2,911,13643,3578726168,3578726213,45
2,911,13644,3578726168,3578726217,49
2,911,13645,3578726168,3578726217,49
2,912,13646,3578726225,3578726225,0
2,912,13647,3578726225,3578726225,0
2,912,13648,3578726225,3578726225,0
2,912,13649,3578726225,3578726225,0
2,912,13650,3578726225,3578726225,0
2,912,13651,3578726225,3578726227,2
2,912,13652,3578726225,3578726228,3
2,912,13653,3578726225,3578726228,3
2,912,13654,3578726225,3578726229,4
2,912,13655,3578726225,3578726229,4
2,912,13656,3578726225,3578726229,4
2,912,13657,3578726225,3578726230,5
2,912,13658,3578726225,3578726230,5
2,912,13659,3578726225,3578726232,7
2,912,13660,3578726225,3578726232,7
2,912,13661,3578726225,3578726235,10
2,912,13662,3578726225,3578726236,11
2,912,13663,3578726225,3578726236,11
2,912,13664,3578726225,3578726237,12
2,912,13665,3578726225,3578726237,12
2,912,13666,3578726225,3578726238,13
2,912,13667,3578726225,3578726241,16
2,912,13668,3578726225,3578726242,17
2,912,13669,3578726225,3578726242,17
2,912,13670,3578726225,3578726243,18
2,912,13671,3578726225,3578726244,19
2,912,13672,3578726225,3578726244,19
2,912,13673,3578726225,3578726246,21
2,912,13674,3578726225,3578726248,23
2,912,13675,3578726225,3578726248,23
2,912,13676,3578726225,3578726250,25
2,912,13677,3578726225,3578726252,27
2,912,13678,3578726225,3578726252,27
2,912,13679,3578726225,3578726253,28
2,912,13680,3578726225,3578726254,29
2,912,13681,3578726225,3578726258,33
2,912,13682,3578726225,3578726258,33
2,912,13683,3578726225,3578726259,34
2,912,13684,3578726225,3578726260,35
2,912,13685,3578726225,3578726260,35
2,912,13686,3578726225,3578726261,36
2,912,13687,3578726225,3578726261,36
2,912,13688,3578726225,3578726264,39
2,912,13689,3578726225,3578726265,40
2,912,13690,3578726225,3578726265,40
2,912,13691,3578726225,3578726267,42
2,912,13692,3578726225,3578726268,43
2,912,13693,3578726225,3578726269,44
2,912,13694,3578726225,3578726270,45
2,913,13695,3578726281,3578726281,0
2,913,13696,3578726281,3578726281,0
2,913,13697,3578726281,3578726281,0
2,913,13698,3578726281,3578726281,0
2,913,13699,3578726281,3578726281,0
2,913,13700,3578726281,3578726283,2
2,913,13701,3578726281,3578726283,2
2,913,13702,3578726281,3578726285,4
2,913,13703,3578726281,3578726286,5
2,913,13704,3578726281,3578726287,6
2,913,13705,3578726281,3578726287,6
2,913,13706,3578726281,3578726289,8
2,913,13707,3578726281,3578726290,9
2,913,13708,3578726281,3578726290,9
2,913,13709,3578726281,3578726292,11
2,913,13710,3578726281,3578726293,12
2,913,13711,3578726281,3578726295,14
2,913,13712,3578726281,3578726298,17
2,913,13713,3578726281,3578726298,17
2,913,13714,3578726281,3578726299,18
2,913,13715,3578726281,3578726299,18
2,913,13716,3578726281,3578726299,18
2,913,13717,3578726281,3578726300,19
2,913,13718,3578726281,3578726300,19
2,913,13719,3578726281,3578726301,20
2,913,13720,3578726281,3578726301,20
2,913,13721,3578726281,3578726302,21
2,913,13722,3578726281,3578726304,23
2,913,13723,3578726281,3578726306,25
2,913,13724,3578726281,3578726307,26
2,913,13725,3578726281,3578726307,26
2,913,13726,3578726281,3578726310,29
2,913,13727,3578726281,3578726311,30
2,913,13728,3578726281,3578726312,31
2,913,13729,3578726281,3578726312,31
2,913,13730,3578726281,3578726313,32
2,913,13731,3578726281,3578726313,32
2,913,13732,3578726281,3578726314,33
2,913,13733,3578726281,3578726315,34
2,913,13734,3578726281,3578726315,34
2,913,13735,3578726281,3578726315,34
2,913,13736,3578726281,3578726319,38
2,913,13737,3578726281,3578726321,40
2,913,13738,3578726281,3578726321,40
2,913,13739,3578726281,3578726321,40
2,913,13740,3578726281,3578726322,41
2,913,13741,3578726281,3578726323,42
2,913,13742,3578726281,3578726323,42
2,913,13743,3578726281,3578726327,46
2,913,13744,3578726281,3578726327,46
2,913,13745,3578726281,3578726329,48
2,914,13746,3578726337,3578726337,0
2,914,13747,3578726337,3578726337,0
2,914,13748,3578726337,3578726337,0
2,914,13749,3578726337,3578726338,1
2,914,13750,3578726337,3578726338,1
2,914,13751,3578726337,3578726338,1
2,914,13752,3578726337,3578726338,1
2,914,13753,3578726337,3578726338,1
2,914,13754,3578726337,3578726338,1
2,914,13755,3578726337,3578726338,1
2,914,13756,3578726337,3578726341,4
2,914,13757,3578726337,3578726344,7
2,914,13758,3578726337,3578726345,8
2,914,13759,3578726337,3578726350,13
2,914,13760,3578726337,3578726352,15
2,914,13761,3578726337,3578726353,16
2,914,13762,3578726337,3578726354,17
2,914,13763,3578726337,3578726355,18
2,914,13764,3578726337,3578726355,18
2,914,13765,3578726337,3578726356,19
2,914,13766,3578726337,3578726357,20
2,914,13767,3578726337,3578726360,23
2,914,13768,3578726337,3578726365,28
2,914,13769,3578726337,3578726366,29
2,914,13770,3578726337,3578726367,30
2,914,13771,3578726337,3578726367,30
2,914,13772,3578726337,3578726367,30
2,914,13773,3578726337,3578726367,30
2,914,13774,3578726337,3578726369,32
2,914,13775,3578726337,3578726369,32
2,914,13776,3578726337,3578726373,36
2,914,13777,3578726337,3578726373,36
2,914,13778,3578726337,3578726377,40
2,914,13779,3578726337,3578726377,40
2,914,13780,3578726337,3578726380,43
2,914,13781,3578726337,3578726381,44
2,914,13782,3578726337,3578726384,47
2,914,13783,3578726337,3578726384,47
2,914,13784,3578726337,3578726384,47
2,914,13785,3578726337,3578726386,49
2,915,13786,3578726394,3578726394,0
2,915,13787,3578726394,3578726394,0
2,915,13788,3578726394,3578726394,0
2,915,13789,3578726394,3578726394,0
2,915,13790,3578726394,3578726396,2
2,915,13791,3578726394,3578726398,4
2,915,13792,3578726394,3578726399,5
2,915,13793,3578726394,3578726400,6
2,915,13794,3578726394,3578726402,8
2,915,13795,3578726394,3578726404,10
2,915,13796,3578726394,3578726408,14
2,915,13797,3578726394,3578726409,15
2,915,13798,3578726394,3578726409,15
2,915,13799,3578726394,3578726410,16
2,915,13800,3578726394,3578726411,17
2,915,13801,3578726394,3578726412,18
2,915,13802,3578726394,3578726413,19
2,915,13803,3578726394,3578726416,22
2,915,13804,3578726394,3578726417,23
2,915,13805,3578726394,3578726417,23
2,915,13806,3578726394,3578726419,25
2,915,13807,3578726394,3578726422,28
2,915,13808,3578726394,3578726422,28
2,915,13809,3578726394,3578726423,29
2,915,13810,3578726394,3578726424,30
2,915,13811,3578726394,3578726427,33
2,915,13812,3578726394,3578726428,34
2,915,13813,3578726394,3578726428,34
2,915,13814,3578726394,3578726429,35
2,915,13815,3578726394,3578726430,36
2,915,13816,3578726394,3578726430,36
2,915,13817,3578726394,3578726430,36
2,915,13818,3578726394,3578726431,37
2,915,13819,3578726394,3578726432,38
2,915,13820,3578726394,3578726432,38
2,915,13821,3578726394,3578726433,39
2,915,13822,3578726394,3578726435,41
2,915,13823,3578726394,3578726436,42
2,915,13824,3578726394,3578726437,43
2,915,13825,3578726394,3578726438,44
2,915,13826,3578726394,3578726438,44
2,915,13827,3578726394,3578726441,47
2,915,13828,3578726394,3578726442,48
2,915,13829,3578726394,3578726442,48
2,915,13830,3578726394,3578726442,48
2,915,13831,3578726394,3578726442,48
2,915,13832,3578726394,3578726444,50
2,916,13833,3578726453,3578726453,0
2,916,13834,3578726453,3578726453,0
2,916,13835,3578726453,3578726453,0
2,916,13836,3578726453,3578726453,0
2,916,13837,3578726453,3578726453,0
2,916,13838,3578726453,3578726453,0
2,916,13839,3578726453,3578726453,0
2,916,13840,3578726453,3578726454,1
2,916,13841,3578726453,3578726455,2
2,916,13842,3578726453,3578726458,5
2,916,13843,3578726453,3578726458,5
2,916,13844,3578726453,3578726459,6
2,916,13845,3578726453,3578726459,6
2,916,13846,3578726453,3578726460,7
2,916,13847,3578726453,3578726464,11
2,916,13848,3578726453,3578726465,12
2,916,13849,3578726453,3578726465,12
2,916,13850,3578726453,3578726468,15
2,916,13851,3578726453,3578726468,15
2,916,13852,3578726453,3578726468,15
2,916,13853,3578726453,3578726469,16
2,916,13854,3578726453,3578726470,17
2,916,13855,3578726453,3578726477,24
2,916,13856,3578726453,3578726481,28
2,916,13857,3578726453,3578726481,28
2,916,13858,3578726453,3578726482,29
2,916,13859,3578726453,3578726482,29
2,916,13860,3578726453,3578726484,31
2,916,13861,3578726453,3578726484,31
2,916,13862,3578726453,3578726485,32
2,916,13863,3578726453,3578726485,32
2,916,13864,3578726453,3578726486,33
2,916,13865,3578726453,3578726487,34
2,916,13866,3578726453,3578726487,34
2,916,13867,3578726453,3578726489,36
2,916,13868,3578726453,3578726490,37
2,916,13869,3578726453,3578726490,37
2,916,13870,3578726453,3578726490,37
2,916,13871,3578726453,3578726492,39
2,916,13872,3578726453,3578726492,39
2,916,13873,3578726453,3578726493,40
2,916,13874,3578726453,3578726494,41
2,916,13875,3578726453,3578726496,43
2,916,13876,3578726453,3578726498,45
2,916,13877,3578726453,3578726498,45
2,916,13878,3578726453,3578726499,46
2,916,13879,3578726453,3578726500,47
2,916,13880,3578726453,3578726500,47
2,916,13881,3578726453,3578726500,47
2,916,13882,3578726453,3578726501,48
2,916,13883,3578726453,3578726501,48
2,916,13884,3578726453,3578726501,48
2,916,13885,3578726453,3578726503,50
2,917,13886,3578726511,3578726511,0
2,917,13887,3578726511,3578726511,0
2,917,13888,3578726511,3578726511,0
2,917,13889,3578726511,3578726511,0
2,917,13890,3578726511,3578726511,0
2,917,13891,3578726511,3578726511,0
2,917,13892,3578726511,3578726512,1
2,917,13893,3578726511,3578726512,1
2,917,13894,3578726511,3578726512,1
2,917,13895,3578726511,3578726514,3
2,917,13896,3578726511,3578726514,3
2,917,13897,3578726511,3578726515,4
2,917,13898,3578726511,3578726515,4
2,917,13899,3578726511,3578726520,9
2,917,13900,3578726511,3578726521,10
2,917,13901,3578726511,3578726521,10
2,917,13902,3578726511,3578726521,10
2,917,13903,3578726511,3578726521,10
2,917,13904,3578726511,3578726522,11
2,917,13905,3578726511,3578726526,15
2,917,13906,3578726511,3578726526,15
2,917,13907,3578726511,3578726529,18
2,917,13908,3578726511,3578726532,21
2,917,13909,3578726511,3578726532,21
2,917,13910,3578726511,3578726532,21
2,917,13911,3578726511,3578726535,24
2,917,13912,3578726511,3578726535,24
2,917,13913,3578726511,3578726536,25
2,917,13914,3578726511,3578726536,25
2,917,13915,3578726511,3578726537,26
2,917,13916,3578726511,3578726540,29
2,917,13917,3578726511,3578726542,31
2,917,13918,3578726511,3578726542,31
2,917,13919,3578726511,3578726544,33
2,917,13920,3578726511,3578726549,38
2,917,13921,3578726511,3578726550,39
2,917,13922,3578726511,3578726551,40
2,917,13923,3578726511,3578726553,42
2,917,13924,3578726511,3578726553,42
2,917,13925,3578726511,3578726555,44
2,917,13926,3578726511,3578726555,44
2,917,13927,3578726511,3578726555,44
2,917,13928,3578726511,3578726556,45
2,917,13929,3578726511,3578726559,48
2,918,13930,3578726568,3578726568,0
2,918,13931,3578726568,3578726568,0
2,918,13932,3578726568,3578726568,0
2,918,13933,3578726568,3578726568,0
2,918,13934,3578726568,3578726568,0
2,918,13935,3578726568,3578726568,0
2,918,13936,3578726568,3578726569,1
2,918,13937,3578726568,3578726569,1
2,918,13938,3578726568,3578726572,4
2,918,13939,3578726568,3578726573,5
2,918,13940,3578726568,3578726573,5
2,918,13941,3578726568,3578726576,8
2,918,13942,3578726568,3578726577,9
2,918,13943,3578726568,3578726580,12
2,918,13944,3578726568,3578726581,13
2,918,13945,3578726568,3578726583,15
2,918,13946,3578726568,3578726583,15
2,918,13947,3578726568,3578726583,15
2,918,13948,3578726568,3578726586,18
2,918,13949,3578726568,3578726587,19
2,918,13950,3578726568,3578726588,20
2,918,13951,3578726568,3578726590,22
2,918,13952,3578726568,3578726590,22
2,918,13953,3578726568,3578726593,25
2,918,13954,3578726568,3578726595,27
2,918,13955,3578726568,3578726597,29
2,918,13956,3578726568,3578726598,30
2,918,13957,3578726568,3578726599,31
2,918,13958,3578726568,3578726601,33
2,918,13959,3578726568,3578726604,36
2,918,13960,3578726568,3578726607,39
2,918,13961,3578726568,3578726608,40
2,918,13962,3578726568,3578726609,41
2,918,13963,3578726568,3578726610,42
2,918,13964,3578726568,3578726611,43
2,918,13965,3578726568,3578726611,43
2,918,13966,3578726568,3578726612,44
2,918,13967,3578726568,3578726616,48
2,918,13968,3578726568,3578726616,48
2,918,13969,3578726568,3578726617,49
2,919,13970,3578726626,3578726626,0
2,919,13971,3578726626,3578726626,0
2,919,13972,3578726626,3578726626,0
2,919,13973,3578726626,3578726626,0
2,919,13974,3578726626,3578726627,1
2,919,13975,3578726626,3578726627,1
2,919,13976,3578726626,3578726628,2
2,919,13977,3578726626,3578726630,4
2,919,13978,3578726626,3578726630,4
2,919,13979,3578726626,3578726630,4
2,919,13980,3578726626,3578726631,5
2,919,13981,3578726626,3578726632,6
2,919,13982,3578726626,3578726632,6
2,919,13983,3578726626,3578726633,7
2,919,13984,3578726626,3578726636,10
2,919,13985,3578726626,3578726637,11
2,919,13986,3578726626,3578726637,11
2,919,13987,3578726626,3578726640,14
2,919,13988,3578726626,3578726641,15
2,919,13989,3578726626,3578726641,15
2,919,13990,3578726626,3578726641,15
2,919,13991,3578726626,3578726642,16
2,919,13992,3578726626,3578726642,16
2,919,13993,3578726626,3578726643,17
2,919,13994,3578726626,3578726644,18
2,919,13995,3578726626,3578726646,20
2,919,13996,3578726626,3578726647,21
2,919,13997,3578726626,3578726648,22
2,919,13998,3578726626,3578726649,23
2,919,13999,3578726626,3578726651,25
2,919,14000,3578726626,3578726652,26
2,919,14001,3578726626,3578726654,28
2,919,14002,3578726626,3578726657,31
2,919,14003,3578726626,3578726658,32
2,919,14004,3578726626,3578726658,32
2,919,14005,3578726626,3578726658,32
2,919,14006,3578726626,3578726659,33
2,919,14007,3578726626,3578726661,35
2,919,14008,3578726626,3578726662,36
2,919,14009,3578726626,3578726664,38
2,919,14010,3578726626,3578726665,39
2,919,14011,3578726626,3578726666,40
2,919,14012,3578726626,3578726667,41
2,919,14013,3578726626,3578726667,41
2,919,14014,3578726626,3578726668,42
2,920,14015,3578726683,3578726683,0
2,920,14016,3578726683,3578726683,0
2,920,14017,3578726683,3578726683,0
2,920,14018,3578726683,3578726683,0
2,920,14019,3578726683,3578726683,0
2,920,14020,3578726683,3578726683,0
2,920,14021,3578726683,3578726684,1
2,920,14022,3578726683,3578726685,2
2,920,14023,3578726683,3578726686,3
2,920,14024,3578726683,3578726687,4
2,920,14025,3578726683,3578726690,7
2,920,14026,3578726683,3578726690,7
2,920,14027,3578726683,3578726690,7
2,920,14028,3578726683,3578726691,8
2,920,14029,3578726683,3578726692,9
2,920,14030,3578726683,3578726692,9
2,920,14031,3578726683,3578726693,10
2,920,14032,3578726683,3578726695,12
2,920,14033,3578726683,3578726695,12
2,920,14034,3578726683,3578726696,13
2,920,14035,3578726683,3578726698,15
2,920,14036,3578726683,3578726699,16
2,920,14037,3578726683,3578726699,16
2,920,14038,3578726683,3578726700,17
2,920,14039,3578726683,3578726700,17
2,920,14040,3578726683,3578726701,18
2,920,14041,3578726683,3578726701,18
2,920,14042,3578726683,3578726701,18
2,920,14043,3578726683,3578726702,19
2,920,14044,3578726683,3578726704,21
2,920,14045,3578726683,3578726704,21
2,920,14046,3578726683,3578726706,23
2,920,14047,3578726683,3578726708,25
2,920,14048,3578726683,3578726709,26
2,920,14049,3578726683,3578726709,26
2,920,14050,3578726683,3578726711,28
2,920,14051,3578726683,3578726712,29
2,920,14052,3578726683,3578726713,30
2,920,14053,3578726683,3578726714,31
2,920,14054,3578726683,3578726714,31
2,920,14055,3578726683,3578726715,32
2,920,14056,3578726683,3578726716,33
2,920,14057,3578726683,3578726717,34
2,920,14058,3578726683,3578726721,38
2,920,14059,3578726683,3578726721,38
2,920,14060,3578726683,3578726721,38
2,920,14061,3578726683,3578726721,38
2,920,14062,3578726683,3578726721,38
2,920,14063,3578726683,3578726721,38
2,920,14064,3578726683,3578726722,39
2,920,14065,3578726683,3578726726,43
2,920,14066,3578726683,3578726727,44
2,920,14067,3578726683,3578726729,46
2,920,14068,3578726683,3578726731,48
2,920,14069,3578726683,3578726732,49
2,920,14070,3578726683,3578726732,49
2,921,14071,3578726739,3578726739,0
2,921,14072,3578726739,3578726739,0
2,921,14073,3578726739,3578726739,0
2,921,14074,3578726739,3578726739,0
2,921,14075,3578726739,3578726740,1
2,921,14076,3578726739,3578726740,1
2,921,14077,3578726739,3578726740,1
2,921,14078,3578726739,3578726740,1
2,921,14079,3578726739,3578726742,3
2,921,14080,3578726739,3578726744,5
2,921,14081,3578726739,3578726749,10
2,921,14082,3578726739,3578726751,12
2,921,14083,3578726739,3578726753,14
2,921,14084,3578726739,3578726753,14
2,921,14085,3578726739,3578726755,16
2,921,14086,3578726739,3578726755,16
2,921,14087,3578726739,3578726756,17
2,921,14088,3578726739,3578726764,25
2,921,14089,3578726739,3578726766,27
2,921,14090,3578726739,3578726766,27
2,921,14091,3578726739,3578726766,27
2,921,14092,3578726739,3578726767,28
2,921,14093,3578726739,3578726768,29
2,921,14094,3578726739,3578726768,29
2,921,14095,3578726739,3578726769,30
2,921,14096,3578726739,3578726771,32
2,921,14097,3578726739,3578726773,34
2,921,14098,3578726739,3578726773,34
2,921,14099,3578726739,3578726775,36
2,921,14100,3578726739,3578726776,37
2,921,14101,3578726739,3578726776,37
2,921,14102,3578726739,3578726779,40
2,921,14103,3578726739,3578726780,41
2,921,14104,3578726739,3578726783,44
2,921,14105,3578726739,3578726783,44
2,921,14106,3578726739,3578726784,45
2,922,14107,3578726796,3578726796,0
2,922,14108,3578726796,3578726796,0
2,922,14109,3578726796,3578726796,0
2,922,14110,3578726796,3578726796,0
2,922,14111,3578726796,3578726796,0
2,922,14112,3578726796,3578726798,2
2,922,14113,3578726796,3578726798,2
2,922,14114,3578726796,3578726799,3
2,922,14115,3578726796,3578726800,4
2,922,14116,3578726796,3578726803,7
2,922,14117,3578726796,3578726809,13
2,922,14118,3578726796,3578726809,13
2,922,14119,3578726796,3578726810,14
2,922,14120,3578726796,3578726811,15
2,922,14121,3578726796,3578726812,16
2,922,14122,3578726796,3578726813,17
2,922,14123,3578726796,3578726815,19
2,922,14124,3578726796,3578726817,21
2,922,14125,3578726796,3578726818,22
2,922,14126,3578726796,3578726822,26
2,922,14127,3578726796,3578726822,26
2,922,14128,3578726796,3578726823,27
2,922,14129,3578726796,3578726827,31
2,922,14130,3578726796,3578726827,31
2,922,14131,3578726796,3578726827,31
2,922,14132,3578726796,3578726827,31
2,922,14133,3578726796,3578726830,34
2,922,14134,3578726796,3578726830,34
2,922,14135,3578726796,3578726830,34
2,922,14136,3578726796,3578726831,35
2,922,14137,3578726796,3578726832,36
2,922,14138,3578726796,3578726833,37
2,922,14139,3578726796,3578726834,38
2,922,14140,3578726796,3578726836,40
2,922,14141,3578726796,3578726837,41
2,922,14142,3578726796,3578726838,42
2,922,14143,3578726796,3578726840,44
2,922,14144,3578726796,3578726841,45
2,922,14145,3578726796,3578726841,45
2,922,14146,3578726796,3578726841,45
2,922,14147,3578726796,3578726843,47
2,922,14148,3578726796,3578726843,47
2,922,14149,3578726796,3578726844,48
2,922,14150,3578726796,3578726846,50
2,923,14151,3578726853,3578726853,0
2,923,14152,3578726853,3578726853,0
2,923,14153,3578726853,3578726853,0
2,923,14154,3578726853,3578726853,0
2,923,14155,3578726853,3578726853,0
2,923,14156,3578726853,3578726854,1
2,923,14157,3578726853,3578726854,1
2,923,14158,3578726853,3578726858,5
2,923,14159,3578726853,3578726859,6
2,923,14160,3578726853,3578726860,7
2,923,14161,3578726853,3578726860,7
2,923,14162,3578726853,3578726863,10
2,923,14163,3578726853,3578726864,11
2,923,14164,3578726853,3578726865,12
2,923,14165,3578726853,3578726866,13
2,923,14166,3578726853,3578726869,16
2,923,14167,3578726853,3578726869,16
2,923,14168,3578726853,3578726877,24
2,923,14169,3578726853,3578726882,29
2,923,14170,3578726853,3578726883,30
2,923,14171,3578726853,3578726883,30
2,923,14172,3578726853,3578726884,31
2,923,14173,3578726853,3578726885,32
2,923,14174,3578726853,3578726886,33
2,923,14175,3578726853,3578726886,33
2,923,14176,3578726853,3578726886,33
2,923,14177,3578726853,3578726887,34
2,923,14178,3578726853,3578726887,34
2,923,14179,3578726853,3578726889,36
2,923,14180,3578726853,3578726890,37
2,923,14181,3578726853,3578726890,37
2,923,14182,3578726853,3578726891,38
2,923,14183,3578726853,3578726892,39
2,923,14184,3578726853,3578726892,39
2,923,14185,3578726853,3578726893,40
2,923,14186,3578726853,3578726895,42
2,923,14187,3578726853,3578726895,42
2,923,14188,3578726853,3578726896,43
2,923,14189,3578726853,3578726899,46
2,923,14190,3578726853,3578726899,46
2,923,14191,3578726853,3578726900,47
2,923,14192,3578726853,3578726901,48
2,923,14193,3578726853,3578726901,48
2,923,14194,3578726853,3578726902,49
2,923,14195,3578726853,3578726902,49
2,924,14196,3578726909,3578726909,0
2,924,14197,3578726909,3578726909,0
2,924,14198,3578726909,3578726909,0
2,924,14199,3578726909,3578726909,0
2,924,14200,3578726909,3578726909,0
2,924,14201,3578726909,3578726909,0
2,924,14202,3578726909,3578726911,2
2,924,14203,3578726909,3578726911,2
2,924,14204,3578726909,3578726912,3
2,924,14205,3578726909,3578726913,4
2,924,14206,3578726909,3578726914,5
2,924,14207,3578726909,3578726915,6
2,924,14208,3578726909,3578726916,7
2,924,14209,3578726909,3578726916,7
2,924,14210,3578726909,3578726917,8
2,924,14211,3578726909,3578726921,12
2,924,14212,3578726909,3578726921,12
2,924,14213,3578726909,3578726921,12
2,924,14214,3578726909,3578726922,13
2,924,14215,3578726909,3578726922,13
2,924,14216,3578726909,3578726922,13
2,924,14217,3578726909,3578726926,17
2,924,14218,3578726909,3578726927,18
2,924,14219,3578726909,3578726929,20
2,924,14220,3578726909,3578726932,23
2,924,14221,3578726909,3578726932,23
2,924,14222,3578726909,3578726933,24
2,924,14223,3578726909,3578726936,27
2,924,14224,3578726909,3578726936,27
2,924,14225,3578726909,3578726936,27
2,924,14226,3578726909,3578726936,27
2,924,14227,3578726909,3578726936,27
2,924,14228,3578726909,3578726937,28
2,924,14229,3578726909,3578726940,31
2,924,14230,3578726909,3578726943,34
2,924,14231,3578726909,3578726943,34
2,924,14232,3578726909,3578726944,35
2,924,14233,3578726909,3578726949,40
2,924,14234,3578726909,3578726951,42
2,924,14235,3578726909,3578726953,44
2,924,14236,3578726909,3578726955,46
2,924,14237,3578726909,3578726955,46
2,924,14238,3578726909,3578726956,47
2,924,14239,3578726909,3578726956,47
2,924,14240,3578726909,3578726959,50
2,925,14241,3578726967,3578726967,0
2,925,14242,3578726967,3578726967,0
2,925,14243,3578726967,3578726967,0
2,925,14244,3578726967,3578726967,0
2,925,14245,3578726967,3578726968,1
2,925,14246,3578726967,3578726969,2
2,925,14247,3578726967,3578726971,4
2,925,14248,3578726967,3578726973,6
2,925,14249,3578726967,3578726974,7
2,925,14250,3578726967,3578726976,9
2,925,14251,3578726967,3578726976,9
2,925,14252,3578726967,3578726977,10
2,925,14253,3578726967,3578726980,13
2,925,14254,3578726967,3578726980,13
2,925,14255,3578726967,3578726983,16
2,925,14256,3578726967,3578726984,17
2,925,14257,3578726967,3578726987,20
2,925,14258,3578726967,3578726989,22
2,925,14259,3578726967,3578726990,23
2,925,14260,3578726967,3578726991,24
2,925,14261,3578726967,3578726994,27
2,925,14262,3578726967,3578726998,31
2,925,14263,3578726967,3578726998,31
2,925,14264,3578726967,3578727000,33
2,925,14265,3578726967,3578727001,34
2,925,14266,3578726967,3578727003,36
2,925,14267,3578726967,3578727007,40
2,925,14268,3578726967,3578727009,42
2,925,14269,3578726967,3578727009,42
2,925,14270,3578726967,3578727011,44
2,925,14271,3578726967,3578727011,44
2,925,14272,3578726967,3578727012,45
2,925,14273,3578726967,3578727012,45
2,925,14274,3578726967,3578727017,50
2,926,14275,3578727024,3578727024,0
2,926,14276,3578727024,3578727024,0
2,926,14277,3578727024,3578727024,0
2,926,14278,3578727024,3578727027,3
2,926,14279,3578727024,3578727027,3
2,926,14280,3578727024,3578727027,3
2,926,14281,3578727024,3578727027,3
2,926,14282,3578727024,3578727029,5
2,926,14283,3578727024,3578727030,6
2,926,14284,3578727024,3578727030,6
2,926,14285,3578727024,3578727032,8
2,926,14286,3578727024,3578727032,8
2,926,14287,3578727024,3578727032,8
2,926,14288,3578727024,3578727032,8
2,926,14289,3578727024,3578727035,11
2,926,14290,3578727024,3578727036,12
2,926,14291,3578727024,3578727036,12
2,926,14292,3578727024,3578727037,13
2,926,14293,3578727024,3578727041,17
2,926,14294,3578727024,3578727041,17
2,926,14295,3578727024,3578727042,18
2,926,14296,3578727024,3578727042,18
2,926,14297,3578727024,3578727042,18
2,926,14298,3578727024,3578727043,19
2,926,14299,3578727024,3578727044,20
2,926,14300,3578727024,3578727044,20
2,926,14301,3578727024,3578727046,22
2,926,14302,3578727024,3578727048,24
2,926,14303,3578727024,3578727049,25
2,926,14304,3578727024,3578727050,26
2,926,14305,3578727024,3578727051,27
2,926,14306,3578727024,3578727052,28
2,926,14307,3578727024,3578727054,30
2,926,14308,3578727024,3578727055,31
2,926,14309,3578727024,3578727059,35
2,926,14310,3578727024,3578727059,35
2,926,14311,3578727024,3578727060,36
2,926,14312,3578727024,3578727060,36
2,926,14313,3578727024,3578727061,37
2,926,14314,3578727024,3578727061,37
2,926,14315,3578727024,3578727064,40
2,926,14316,3578727024,3578727065,41
2,926,14317,3578727024,3578727067,43
2,926,14318,3578727024,3578727069,45
2,926,14319,3578727024,3578727069,45
2,927,14320,3578727080,3578727080,0
2,927,14321,3578727080,3578727080,0
2,927,14322,3578727080,3578727081,1
2,927,14323,3578727080,3578727082,2
2,927,14324,3578727080,3578727083,3
2,927,14325,3578727080,3578727084,4
2,927,14326,3578727080,3578727085,5
2,927,14327,3578727080,3578727086,6
2,927,14328,3578727080,3578727086,6
2,927,14329,3578727080,3578727087,7
2,927,14330,3578727080,3578727087,7
2,927,14331,3578727080,3578727090,10
2,927,14332,3578727080,3578727090,10
2,927,14333,3578727080,3578727090,10
2,927,14334,3578727080,3578727091,11
2,927,14335,3578727080,3578727092,12
2,927,14336,3578727080,3578727092,12
2,927,14337,3578727080,3578727093,13
2,927,14338,3578727080,3578727095,15
2,927,14339,3578727080,3578727096,16
2,927,14340,3578727080,3578727099,19
2,927,14341,3578727080,3578727099,19
2,927,14342,3578727080,3578727101,21
2,927,14343,3578727080,3578727101,21
2,927,14344,3578727080,3578727103,23
2,927,14345,3578727080,3578727103,23
2,927,14346,3578727080,3578727103,23
2,927,14347,3578727080,3578727105,25
2,927,14348,3578727080,3578727106,26
2,927,14349,3578727080,3578727107,27
2,927,14350,3578727080,3578727108,28
2,927,14351,3578727080,3578727111,31
2,927,14352,3578727080,3578727112,32
2,927,14353,3578727080,3578727113,33
2,927,14354,3578727080,3578727115,35
2,927,14355,3578727080,3578727115,35
2,927,14356,3578727080,3578727116,36
2,927,14357,3578727080,3578727117,37
2,927,14358,3578727080,3578727118,38
2,927,14359,3578727080,3578727118,38
2,927,14360,3578727080,3578727121,41
2,927,14361,3578727080,3578727121,41
2,927,14362,3578727080,3578727121,41
2,927,14363,3578727080,3578727121,41
2,927,14364,3578727080,3578727122,42
2,927,14365,3578727080,3578727122,42
2,927,14366,3578727080,3578727123,43
2,927,14367,3578727080,3578727126,46
2,927,14368,3578727080,3578727127,47
2,928,14369,3578727138,3578727138,0
2,928,14370,3578727138,3578727138,0
2,928,14371,3578727138,3578727138,0
2,928,14372,3578727138,3578727138,0
2,928,14373,3578727138,3578727138,0
2,928,14374,3578727138,3578727138,0
2,928,14375,3578727138,3578727138,0
2,928,14376,3578727138,3578727138,0
2,928,14377,3578727138,3578727138,0
2,928,14378,3578727138,3578727138,0
2,928,14379,3578727138,3578727138,0
2,928,14380,3578727138,3578727140,2
2,928,14381,3578727138,3578727143,5
2,928,14382,3578727138,3578727150,12
2,928,14383,3578727138,3578727151,13
2,928,14384,3578727138,3578727153,15
2,928,14385,3578727138,3578727155,17
2,928,14386,3578727138,3578727155,17
2,928,14387,3578727138,3578727156,18
2,928,14388,3578727138,3578727156,18
2,928,14389,3578727138,3578727156,18
2,928,14390,3578727138,3578727159,21
2,928,14391,3578727138,3578727164,26
2,928,14392,3578727138,3578727165,27
2,928,14393,3578727138,3578727166,28
2,928,14394,3578727138,3578727168,30
2,928,14395,3578727138,3578727168,30
2,928,14396,3578727138,3578727168,30
2,928,14397,3578727138,3578727172,34
2,928,14398,3578727138,3578727174,36
2,928,14399,3578727138,3578727174,36
2,928,14400,3578727138,3578727176,38
2,928,14401,3578727138,3578727176,38
2,928,14402,3578727138,3578727177,39
2,928,14403,3578727138,3578727180,42
2,928,14404,3578727138,3578727180,42
2,928,14405,3578727138,3578727184,46
2,928,14406,3578727138,3578727187,49
2,928,14407,3578727138,3578727188,50
2,929,14408,3578727194,3578727194,0
2,929,14409,3578727194,3578727194,0
2,929,14410,3578727194,3578727194,0
2,929,14411,3578727194,3578727194,0
2,929,14412,3578727194,3578727195,1
2,929,14413,3578727194,3578727198,4
2,929,14414,3578727194,3578727199,5
2,929,14415,3578727194,3578727200,6
2,929,14416,3578727194,3578727201,7
2,929,14417,3578727194,3578727203,9
2,929,14418,3578727194,3578727209,15
2,929,14419,3578727194,3578727211,17
2,929,14420,3578727194,3578727212,18
2,929,14421,3578727194,3578727212,18
2,929,14422,3578727194,3578727212,18
2,929,14423,3578727194,3578727217,23
2,929,14424,3578727194,3578727217,23
2,929,14425,3578727194,3578727217,23
2,929,14426,3578727194,3578727219,25
2,929,14427,3578727194,3578727222,28
2,929,14428,3578727194,3578727222,28
2,929,14429,3578727194,3578727223,29
2,929,14430,3578727194,3578727227,33
2,929,14431,3578727194,3578727227,33
2,929,14432,3578727194,3578727228,34
2,929,14433,3578727194,3578727228,34
2,929,14434,3578727194,3578727230,36
2,929,14435,3578727194,3578727230,36
2,929,14436,3578727194,3578727230,36
2,929,14437,3578727194,3578727233,39
2,929,14438,3578727194,3578727233,39
2,929,14439,3578727194,3578727235,41
2,929,14440,3578727194,3578727236,42
2,929,14441,3578727194,3578727237,43
2,929,14442,3578727194,3578727237,43
2,929,14443,3578727194,3578727241,47
2,929,14444,3578727194,3578727242,48
2,929,14445,3578727194,3578727242,48
2,929,14446,3578727194,3578727242,48
2,929,14447,3578727194,3578727242,48
2,929,14448,3578727194,3578727244,50
2,930,14449,3578727251,3578727251,0
2,930,14450,3578727251,3578727251,0
2,930,14451,3578727251,3578727251,0
2,930,14452,3578727251,3578727251,0
2,930,14453,3578727251,3578727251,0
2,930,14454,3578727251,3578727252,1
2,930,14455,3578727251,3578727253,2
2,930,14456,3578727251,3578727255,4
2,930,14457,3578727251,3578727255,4
2,930,14458,3578727251,3578727258,7
2,930,14459,3578727251,3578727259,8
2,930,14460,3578727251,3578727260,9
2,930,14461,3578727251,3578727260,9
2,930,14462,3578727251,3578727260,9
2,930,14463,3578727251,3578727261,10
2,930,14464,3578727251,3578727261,10
2,930,14465,3578727251,3578727261,10
2,930,14466,3578727251,3578727265,14
2,930,14467,3578727251,3578727267,16
2,930,14468,3578727251,3578727268,17
2,930,14469,3578727251,3578727269,18
2,930,14470,3578727251,3578727269,18
2,930,14471,3578727251,3578727270,19
2,930,14472,3578727251,3578727277,26
2,930,14473,3578727251,3578727282,31
2,930,14474,3578727251,3578727282,31
2,930,14475,3578727251,3578727283,32
2,930,14476,3578727251,3578727283,32
2,930,14477,3578727251,3578727284,33
2,930,14478,3578727251,3578727285,34
2,930,14479,3578727251,3578727285,34
2,930,14480,3578727251,3578727286,35
2,930,14481,3578727251,3578727287,36
2,930,14482,3578727251,3578727287,36
2,930,14483,3578727251,3578727288,37
2,930,14484,3578727251,3578727290,39
2,930,14485,3578727251,3578727290,39
2,930,14486,3578727251,3578727291,40
2,930,14487,3578727251,3578727291,40
2,930,14488,3578727251,3578727292,41
2,930,14489,3578727251,3578727293,42
2,930,14490,3578727251,3578727293,42
2,930,14491,3578727251,3578727295,44
2,930,14492,3578727251,3578727296,45
2,930,14493,3578727251,3578727296,45
2,930,14494,3578727251,3578727298,47
2,930,14495,3578727251,3578727299,48
2,930,14496,3578727251,3578727299,48
2,930,14497,3578727251,3578727300,49
2,931,14498,3578727308,3578727308,0
2,931,14499,3578727308,3578727308,0
2,931,14500,3578727308,3578727308,0
2,931,14501,3578727308,3578727308,0
2,931,14502,3578727308,3578727308,0
2,931,14503,3578727308,3578727308,0
2,931,14504,3578727308,3578727308,0
2,931,14505,3578727308,3578727308,0
2,931,14506,3578727308,3578727308,0
2,931,14507,3578727308,3578727309,1
2,931,14508,3578727308,3578727311,3
2,931,14509,3578727308,3578727312,4
2,931,14510,3578727308,3578727313,5
2,931,14511,3578727308,3578727313,5
2,931,14512,3578727308,3578727315,7
2,931,14513,3578727308,3578727316,8
2,931,14514,3578727308,3578727316,8
2,931,14515,3578727308,3578727318,10
2,931,14516,3578727308,3578727319,11
2,931,14517,3578727308,3578727321,13
2,931,14518,3578727308,3578727322,14
2,931,14519,3578727308,3578727322,14
2,931,14520,3578727308,3578727322,14
2,931,14521,3578727308,3578727323,15
2,931,14522,3578727308,3578727327,19
2,931,14523,3578727308,3578727331,23
2,931,14524,3578727308,3578727333,25
2,931,14525,3578727308,3578727333,25
2,931,14526,3578727308,3578727333,25
2,931,14527,3578727308,3578727336,28
2,931,14528,3578727308,3578727336,28
2,931,14529,3578727308,3578727337,29
2,931,14530,3578727308,3578727337,29
2,931,14531,3578727308,3578727337,29
2,931,14532,3578727308,3578727338,30
2,931,14533,3578727308,3578727341,33
2,931,14534,3578727308,3578727342,34
2,931,14535,3578727308,3578727343,35
2,931,14536,3578727308,3578727351,43
2,931,14537,3578727308,3578727351,43
2,931,14538,3578727308,3578727351,43
2,931,14539,3578727308,3578727353,45
2,931,14540,3578727308,3578727354,46
2,931,14541,3578727308,3578727355,47
2,931,14542,3578727308,3578727356,48
2,931,14543,3578727308,3578727356,48
2,931,14544,3578727308,3578727357,49
2,932,14545,3578727364,3578727364,0
2,932,14546,3578727364,3578727366,2
2,932,14547,3578727364,3578727366,2
2,932,14548,3578727364,3578727366,2
2,932,14549,3578727364,3578727368,4
2,932,14550,3578727364,3578727368,4
2,932,14551,3578727364,3578727369,5
2,932,14552,3578727364,3578727369,5
2,932,14553,3578727364,3578727373,9
2,932,14554,3578727364,3578727374,10
2,932,14555,3578727364,3578727374,10
2,932,14556,3578727364,3578727376,12
2,932,14557,3578727364,3578727376,12
2,932,14558,3578727364,3578727380,16
2,932,14559,3578727364,3578727380,16
2,932,14560,3578727364,3578727385,21
2,932,14561,3578727364,3578727389,25
2,932,14562,3578727364,3578727389,25
2,932,14563,3578727364,3578727391,27
2,932,14564,3578727364,3578727391,27
2,932,14565,3578727364,3578727394,30
2,932,14566,3578727364,3578727394,30
2,932,14567,3578727364,3578727399,35
2,932,14568,3578727364,3578727399,35
2,932,14569,3578727364,3578727400,36
2,932,14570,3578727364,3578727401,37
2,932,14571,3578727364,3578727403,39
2,932,14572,3578727364,3578727407,43
2,932,14573,3578727364,3578727409,45
2,932,14574,3578727364,3578727412,48
2,932,14575,3578727364,3578727413,49
2,932,14576,3578727364,3578727413,49
2,932,14577,3578727364,3578727413,49
2,933,14578,3578727422,3578727422,0
2,933,14579,3578727422,3578727422,0
2,933,14580,3578727422,3578727422,0
2,933,14581,3578727422,3578727422,0
2,933,14582,3578727422,3578727422,0
2,933,14583,3578727422,3578727423,1
2,933,14584,3578727422,3578727427,5
2,933,14585,3578727422,3578727428,6
2,933,14586,3578727422,3578727428,6
2,933,14587,3578727422,3578727428,6
2,933,14588,3578727422,3578727428,6
2,933,14589,3578727422,3578727430,8
2,933,14590,3578727422,3578727430,8
2,933,14591,3578727422,3578727430,8
2,933,14592,3578727422,3578727432,10
2,933,14593,3578727422,3578727433,11
2,933,14594,3578727422,3578727433,11
2,933,14595,3578727422,3578727433,11
2,933,14596,3578727422,3578727434,12
2,933,14597,3578727422,3578727436,14
2,933,14598,3578727422,3578727438,16
2,933,14599,3578727422,3578727438,16
2,933,14600,3578727422,3578727442,20
2,933,14601,3578727422,3578727442,20
2,933,14602,3578727422,3578727443,21
2,933,14603,3578727422,3578727443,21
2,933,14604,3578727422,3578727444,22
2,933,14605,3578727422,3578727445,23
2,933,14606,3578727422,3578727448,26
2,933,14607,3578727422,3578727449,27
2,933,14608,3578727422,3578727450,28
2,933,14609,3578727422,3578727452,30
2,933,14610,3578727422,3578727453,31
2,933,14611,3578727422,3578727454,32
2,933,14612,3578727422,3578727455,33
2,933,14613,3578727422,3578727458,36
2,933,14614,3578727422,3578727459,37
2,933,14615,3578727422,3578727460,38
2,933,14616,3578727422,3578727460,38
2,933,14617,3578727422,3578727461,39
2,933,14618,3578727422,3578727461,39
2,933,14619,3578727422,3578727461,39
2,933,14620,3578727422,3578727462,40
2,933,14621,3578727422,3578727465,43
2,933,14622,3578727422,3578727468,46
2,933,14623,3578727422,3578727469,47
2,933,14624,3578727422,3578727469,47
2,933,14625,3578727422,3578727471,49
2,934,14626,3578727480,3578727480,0
2,934,14627,3578727480,3578727480,0
2,934,14628,3578727480,3578727481,1
2,934,14629,3578727480,3578727481,1
2,934,14630,3578727480,3578727481,1
2,934,14631,3578727480,3578727482,2
2,934,14632,3578727480,3578727484,4
2,934,14633,3578727480,3578727485,5
2,934,14634,3578727480,3578727487,7
2,934,14635,3578727480,3578727487,7
2,934,14636,3578727480,3578727489,9
2,934,14637,3578727480,3578727489,9
2,934,14638,3578727480,3578727489,9
2,934,14639,3578727480,3578727490,10
2,934,14640,3578727480,3578727492,12
2,934,14641,3578727480,3578727492,12
2,934,14642,3578727480,3578727493,13
2,934,14643,3578727480,3578727494,14
2,934,14644,3578727480,3578727495,15
2,934,14645,3578727480,3578727497,17
2,934,14646,3578727480,3578727498,18
2,934,14647,3578727480,3578727498,18
2,934,14648,3578727480,3578727498,18
2,934,14649,3578727480,3578727501,21
2,934,14650,3578727480,3578727501,21
2,934,14651,3578727480,3578727502,22
2,934,14652,3578727480,3578727502,22
2,934,14653,3578727480,3578727503,23
2,934,14654,3578727480,3578727503,23
2,934,14655,3578727480,3578727506,26
2,934,14656,3578727480,3578727506,26
2,934,14657,3578727480,3578727507,27
2,934,14658,3578727480,3578727508,28
2,934,14659,3578727480,3578727510,30
2,934,14660,3578727480,3578727510,30
2,934,14661,3578727480,3578727511,31
2,934,14662,3578727480,3578727512,32
2,934,14663,3578727480,3578727513,33
2,934,14664,3578727480,3578727514,34
2,934,14665,3578727480,3578727515,35
2,934,14666,3578727480,3578727516,36
2,934,14667,3578727480,3578727517,37
2,934,14668,3578727480,3578727520,40
2,934,14669,3578727480,3578727521,41
2,934,14670,3578727480,3578727521,41
2,934,14671,3578727480,3578727521,41
2,934,14672,3578727480,3578727522,42
2,934,14673,3578727480,3578727522,42
2,934,14674,3578727480,3578727525,45
2,934,14675,3578727480,3578727525,45
2,935,14676,3578727537,3578727537,0
2,935,14677,3578727537,3578727537,0
2,935,14678,3578727537,3578727537,0
2,935,14679,3578727537,3578727537,0
2,935,14680,3578727537,3578727537,0
2,935,14681,3578727537,3578727537,0
2,935,14682,3578727537,3578727537,0
2,935,14683,3578727537,3578727537,0
2,935,14684,3578727537,3578727537,0
2,935,14685,3578727537,3578727537,0
2,935,14686,3578727537,3578727537,0
2,935,14687,3578727537,3578727540,3
2,935,14688,3578727537,3578727542,5
2,935,14689,3578727537,3578727544,7
2,935,14690,3578727537,3578727550,13
2,935,14691,3578727537,3578727551,14
2,935,14692,3578727537,3578727552,15
2,935,14693,3578727537,3578727554,17
2,935,14694,3578727537,3578727555,18
2,935,14695,3578727537,3578727556,19
2,935,14696,3578727537,3578727556,19
2,935,14697,3578727537,3578727559,22
2,935,14698,3578727537,3578727562,25
2,935,14699,3578727537,3578727564,27
2,935,14700,3578727537,3578727565,28
2,935,14701,3578727537,3578727565,28
2,935,14702,3578727537,3578727567,30
2,935,14703,3578727537,3578727567,30
2,935,14704,3578727537,3578727568,31
2,935,14705,3578727537,3578727568,31
2,935,14706,3578727537,3578727569,32
2,935,14707,3578727537,3578727571,34
2,935,14708,3578727537,3578727572,35
2,935,14709,3578727537,3578727573,36
2,935,14710,3578727537,3578727573,36
2,935,14711,3578727537,3578727575,38
2,935,14712,3578727537,3578727577,40
2,935,14713,3578727537,3578727580,43
2,935,14714,3578727537,3578727580,43
2,936,14715,3578727595,3578727595,0
2,936,14716,3578727595,3578727595,0
2,936,14717,3578727595,3578727595,0
2,936,14718,3578727595,3578727595,0
2,936,14719,3578727595,3578727595,0
2,936,14720,3578727595,3578727595,0
2,936,14721,3578727595,3578727597,2
2,936,14722,3578727595,3578727599,4
2,936,14723,3578727595,3578727600,5
2,936,14724,3578727595,3578727606,11
2,936,14725,3578727595,3578727608,13
2,936,14726,3578727595,3578727609,14
2,936,14727,3578727595,3578727611,16
2,936,14728,3578727595,3578727611,16
2,936,14729,3578727595,3578727613,18
2,936,14730,3578727595,3578727616,21
2,936,14731,3578727595,3578727616,21
2,936,14732,3578727595,3578727619,24
2,936,14733,3578727595,3578727620,25
2,936,14734,3578727595,3578727621,26
2,936,14735,3578727595,3578727621,26
2,936,14736,3578727595,3578727621,26
2,936,14737,3578727595,3578727626,31
2,936,14738,3578727595,3578727626,31
2,936,14739,3578727595,3578727626,31
2,936,14740,3578727595,3578727627,32
2,936,14741,3578727595,3578727628,33
2,936,14742,3578727595,3578727629,34
2,936,14743,3578727595,3578727629,34
2,936,14744,3578727595,3578727630,35
2,936,14745,3578727595,3578727632,37
2,936,14746,3578727595,3578727632,37
2,936,14747,3578727595,3578727632,37
2,936,14748,3578727595,3578727633,38
2,936,14749,3578727595,3578727636,41
2,936,14750,3578727595,3578727637,42
2,936,14751,3578727595,3578727641,46
2,936,14752,3578727595,3578727641,46
2,936,14753,3578727595,3578727641,46
2,936,14754,3578727595,3578727641,46
2,936,14755,3578727595,3578727641,46
2,936,14756,3578727595,3578727642,47
2,936,14757,3578727595,3578727643,48
2,936,14758,3578727595,3578727644,49
2,937,14759,3578727651,3578727651,0
2,937,14760,3578727651,3578727651,0
2,937,14761,3578727651,3578727651,0
2,937,14762,3578727651,3578727651,0
2,937,14763,3578727651,3578727651,0
2,937,14764,3578727651,3578727652,1
2,937,14765,3578727651,3578727653,2
2,937,14766,3578727651,3578727654,3
2,937,14767,3578727651,3578727654,3
2,937,14768,3578727651,3578727657,6
2,937,14769,3578727651,3578727658,7
2,937,14770,3578727651,3578727659,8
2,937,14771,3578727651,3578727659,8
2,937,14772,3578727651,3578727659,8
2,937,14773,3578727651,3578727659,8
2,937,14774,3578727651,3578727660,9
2,937,14775,3578727651,3578727664,13
2,937,14776,3578727651,3578727665,14
2,937,14777,3578727651,3578727666,15
2,937,14778,3578727651,3578727668,17
2,937,14779,3578727651,3578727668,17
2,937,14780,3578727651,3578727670,19
2,937,14781,3578727651,3578727678,27
2,937,14782,3578727651,3578727681,30
2,937,14783,3578727651,3578727682,31
2,937,14784,3578727651,3578727682,31
2,937,14785,3578727651,3578727682,31
2,937,14786,3578727651,3578727684,33
2,937,14787,3578727651,3578727685,34
2,937,14788,3578727651,3578727685,34
2,937,14789,3578727651,3578727687,36
2,937,14790,3578727651,3578727687,36
2,937,14791,3578727651,3578727687,36
2,937,14792,3578727651,3578727689,38
2,937,14793,3578727651,3578727689,38
2,937,14794,3578727651,3578727690,39
2,937,14795,3578727651,3578727690,39
2,937,14796,3578727651,3578727692,41
2,937,14797,3578727651,3578727693,42
2,937,14798,3578727651,3578727693,42
2,937,14799,3578727651,3578727694,43
2,937,14800,3578727651,3578727695,44
2,937,14801,3578727651,3578727697,46
2,937,14802,3578727651,3578727698,47
2,937,14803,3578727651,3578727698,47
2,937,14804,3578727651,3578727699,48
2,937,14805,3578727651,3578727699,48
2,937,14806,3578727651,3578727701,50
2,938,14807,3578727709,3578727709,0
2,938,14808,3578727709,3578727709,0
2,938,14809,3578727709,3578727709,0
2,938,14810,3578727709,3578727709,0
2,938,14811,3578727709,3578727709,0
2,938,14812,3578727709,3578727709,0
2,938,14813,3578727709,3578727709,0
2,938,14814,3578727709,3578727710,1
2,938,14815,3578727709,3578727710,1
2,938,14816,3578727709,3578727711,2
2,938,14817,3578727709,3578727711,2
2,938,14818,3578727709,3578727713,4
2,938,14819,3578727709,3578727714,5
2,938,14820,3578727709,3578727714,5
2,938,14821,3578727709,3578727716,7
2,938,14822,3578727709,3578727716,7
2,938,14823,3578727709,3578727717,8
2,938,14824,3578727709,3578727719,10
2,938,14825,3578727709,3578727721,12
2,938,14826,3578727709,3578727722,13
2,938,14827,3578727709,3578727722,13
2,938,14828,3578727709,3578727723,14
2,938,14829,3578727709,3578727726,17
2,938,14830,3578727709,3578727727,18
2,938,14831,3578727709,3578727731,22
2,938,14832,3578727709,3578727733,24
2,938,14833,3578727709,3578727733,24
2,938,14834,3578727709,3578727734,25
2,938,14835,3578727709,3578727735,26
2,938,14836,3578727709,3578727735,26
2,938,14837,3578727709,3578727736,27
2,938,14838,3578727709,3578727736,27
2,938,14839,3578727709,3578727737,28
2,938,14840,3578727709,3578727737,28
2,938,14841,3578727709,3578727740,31
2,938,14842,3578727709,3578727743,34
2,938,14843,3578727709,3578727743,34
2,938,14844,3578727709,3578727743,34
2,938,14845,3578727709,3578727750,41
2,938,14846,3578727709,3578727751,42
2,938,14847,3578727709,3578727751,42
2,938,14848,3578727709,3578727753,44
2,938,14849,3578727709,3578727755,46
2,938,14850,3578727709,3578727755,46
2,938,14851,3578727709,3578727755,46
2,938,14852,3578727709,3578727756,47
2,938,14853,3578727709,3578727759,50
2,939,14854,3578727766,3578727766,0
2,939,14855,3578727766,3578727766,0
2,939,14856,3578727766,3578727766,0
2,939,14857,3578727766,3578727766,0
2,939,14858,3578727766,3578727767,1
2,939,14859,3578727766,3578727767,1
2,939,14860,3578727766,3578727768,2
2,939,14861,3578727766,3578727769,3
2,939,14862,3578727766,3578727772,6
2,939,14863,3578727766,3578727773,7
2,939,14864,3578727766,3578727774,8
2,939,14865,3578727766,3578727775,9
2,939,14866,3578727766,3578727775,9
2,939,14867,3578727766,3578727777,11
2,939,14868,3578727766,3578727780,14
2,939,14869,3578727766,3578727780,14
2,939,14870,3578727766,3578727783,17
2,939,14871,3578727766,3578727785,19
2,939,14872,3578727766,3578727786,20
2,939,14873,3578727766,3578727788,22
2,939,14874,3578727766,3578727791,25
2,939,14875,3578727766,3578727792,26
2,939,14876,3578727766,3578727794,28
2,939,14877,3578727766,3578727794,28
2,939,14878,3578727766,3578727794,28
2,939,14879,3578727766,3578727797,31
2,939,14880,3578727766,3578727799,33
2,939,14881,3578727766,3578727801,35
2,939,14882,3578727766,3578727802,36
2,939,14883,3578727766,3578727806,40
2,939,14884,3578727766,3578727808,42
2,939,14885,3578727766,3578727811,45
2,939,14886,3578727766,3578727812,46
2,939,14887,3578727766,3578727814,48
2,939,14888,3578727766,3578727816,50
2,939,14889,3578727766,3578727816,50
2,940,14890,3578727823,3578727823,0
2,940,14891,3578727823,3578727823,0
2,940,14892,3578727823,3578727823,0
2,940,14893,3578727823,3578727823,0
2,940,14894,3578727823,3578727823,0
2,940,14895,3578727823,3578727826,3
2,940,14896,3578727823,3578727826,3
2,940,14897,3578727823,3578727827,4
2,940,14898,3578727823,3578727827,4
2,940,14899,3578727823,3578727829,6
2,940,14900,3578727823,3578727830,7
2,940,14901,3578727823,3578727830,7
2,940,14902,3578727823,3578727832,9
2,940,14903,3578727823,3578727832,9
2,940,14904,3578727823,3578727832,9
2,940,14905,3578727823,3578727834,11
2,940,14906,3578727823,3578727836,13
2,940,14907,3578727823,3578727837,14
2,940,14908,3578727823,3578727841,18
2,940,14909,3578727823,3578727841,18
2,940,14910,3578727823,3578727841,18
2,940,14911,3578727823,3578727841,18
2,940,14912,3578727823,3578727842,19
2,940,14913,3578727823,3578727842,19
2,940,14914,3578727823,3578727843,20
2,940,14915,3578727823,3578727844,21
2,940,14916,3578727823,3578727846,23
2,940,14917,3578727823,3578727847,24
2,940,14918,3578727823,3578727849,26
2,940,14919,3578727823,3578727849,26
2,940,14920,3578727823,3578727850,27
2,940,14921,3578727823,3578727851,28
2,940,14922,3578727823,3578727851,28
2,940,14923,3578727823,3578727854,31
2,940,14924,3578727823,3578727854,31
2,940,14925,3578727823,3578727854,31
2,940,14926,3578727823,3578727857,34
2,940,14927,3578727823,3578727859,36
2,940,14928,3578727823,3578727859,36
2,940,14929,3578727823,3578727860,37
2,940,14930,3578727823,3578727860,37
2,940,14931,3578727823,3578727861,38
2,940,14932,3578727823,3578727861,38
2,940,14933,3578727823,3578727864,41
2,940,14934,3578727823,3578727865,42
2,940,14935,3578727823,3578727867,44
2,940,14936,3578727823,3578727868,45
2,940,14937,3578727823,3578727869,46
2,940,14938,3578727823,3578727870,47
2,941,14939,3578727881,3578727881,0
2,941,14940,3578727881,3578727881,0
2,941,14941,3578727881,3578727882,1
2,941,14942,3578727881,3578727882,1
2,941,14943,3578727881,3578727883,2
2,941,14944,3578727881,3578727884,3
2,941,14945,3578727881,3578727885,4
2,941,14946,3578727881,3578727886,5
2,941,14947,3578727881,3578727887,6
2,941,14948,3578727881,3578727887,6
2,941,14949,3578727881,3578727889,8
2,941,14950,3578727881,3578727889,8
2,941,14951,3578727881,3578727891,10
2,941,14952,3578727881,3578727892,11
2,941,14953,3578727881,3578727892,11
2,941,14954,3578727881,3578727893,12
2,941,14955,3578727881,3578727894,13
2,941,14956,3578727881,3578727895,14
2,941,14957,3578727881,3578727895,14
2,941,14958,3578727881,3578727898,17
2,941,14959,3578727881,3578727899,18
2,941,14960,3578727881,3578727899,18
2,941,14961,3578727881,3578727900,19
2,941,14962,3578727881,3578727901,20
2,941,14963,3578727881,3578727903,22
2,941,14964,3578727881,3578727903,22
2,941,14965,3578727881,3578727903,22
2,941,14966,3578727881,3578727904,23
2,941,14967,3578727881,3578727905,24
2,941,14968,3578727881,3578727907,26
2,941,14969,3578727881,3578727907,26
2,941,14970,3578727881,3578727910,29
2,941,14971,3578727881,3578727910,29
2,941,14972,3578727881,3578727912,31
2,941,14973,3578727881,3578727914,33
2,941,14974,3578727881,3578727914,33
2,941,14975,3578727881,3578727915,34
2,941,14976,3578727881,3578727916,35
2,941,14977,3578727881,3578727917,36
2,941,14978,3578727881,3578727918,37
2,941,14979,3578727881,3578727919,38
2,941,14980,3578727881,3578727921,40
2,941,14981,3578727881,3578727921,40
2,941,14982,3578727881,3578727921,40
2,941,14983,3578727881,3578727922,41
2,941,14984,3578727881,3578727922,41
2,941,14985,3578727881,3578727923,42
2,941,14986,3578727881,3578727925,44
2,941,14987,3578727881,3578727927,46
2,941,14988,3578727881,3578727927,46
2,942,14989,3578727939,3578727939,0
2,942,14990,3578727939,3578727939,0
2,942,14991,3578727939,3578727939,0
2,942,14992,3578727939,3578727939,0
2,942,14993,3578727939,3578727939,0
2,942,14994,3578727939,3578727939,0
2,942,14995,3578727939,3578727939,0
2,942,14996,3578727939,3578727939,0
2,942,14997,3578727939,3578727939,0
2,942,14998,3578727939,3578727939,0
2,942,14999,3578727939,3578727939,0
2,942,15000,3578727939,3578727940,1
2,942,15001,3578727939,3578727943,4
2,942,15002,3578727939,3578727943,4
2,942,15003,3578727939,3578727952,13
2,942,15004,3578727939,3578727952,13
2,942,15005,3578727939,3578727953,14
2,942,15006,3578727939,3578727954,15
2,942,15007,3578727939,3578727955,16
2,942,15008,3578727939,3578727956,17
2,942,15009,3578727939,3578727956,17
2,942,15010,3578727939,3578727959,20
2,942,15011,3578727939,3578727966,27
2,942,15012,3578727939,3578727968,29
2,942,15013,3578727939,3578727968,29
2,942,15014,3578727939,3578727969,30
2,942,15015,3578727939,3578727969,30
2,942,15016,3578727939,3578727972,33
2,942,15017,3578727939,3578727973,34
2,942,15018,3578727939,3578727974,35
2,942,15019,3578727939,3578727976,37
2,942,15020,3578727939,3578727976,37
2,942,15021,3578727939,3578727977,38
2,942,15022,3578727939,3578727980,41
2,942,15023,3578727939,3578727980,41
2,942,15024,3578727939,3578727982,43
2,942,15025,3578727939,3578727985,46
2,942,15026,3578727939,3578727987,48
2,942,15027,3578727939,3578727988,49
2,943,15028,3578727996,3578727996,0
2,943,15029,3578727996,3578727996,0
2,943,15030,3578727996,3578727996,0
2,943,15031,3578727996,3578727996,0
2,943,15032,3578727996,3578727996,0
2,943,15033,3578727996,3578727998,2
2,943,15034,3578727996,3578728000,4
2,943,15035,3578727996,3578728001,5
2,943,15036,3578727996,3578728003,7
2,943,15037,3578727996,3578728006,10
2,943,15038,3578727996,3578728008,12
2,943,15039,3578727996,3578728011,15
2,943,15040,3578727996,3578728012,16
2,943,15041,3578727996,3578728013,17
2,943,15042,3578727996,3578728014,18
2,943,15043,3578727996,3578728016,20
2,943,15044,3578727996,3578728017,21
2,943,15045,3578727996,3578728019,23
2,943,15046,3578727996,3578728020,24
2,943,15047,3578727996,3578728022,26
2,943,15048,3578727996,3578728022,26
2,943,15049,3578727996,3578728023,27
2,943,15050,3578727996,3578728026,30
2,943,15051,3578727996,3578728027,31
2,943,15052,3578727996,3578728027,31
2,943,15053,3578727996,3578728027,31
2,943,15054,3578727996,3578728028,32
2,943,15055,3578727996,3578728029,33
2,943,15056,3578727996,3578728030,34
2,943,15057,3578727996,3578728030,34
2,943,15058,3578727996,3578728032,36
2,943,15059,3578727996,3578728035,39
2,943,15060,3578727996,3578728036,40
2,943,15061,3578727996,3578728037,41
2,943,15062,3578727996,3578728041,45
2,943,15063,3578727996,3578728041,45
2,943,15064,3578727996,3578728042,46
2,943,15065,3578727996,3578728042,46
2,943,15066,3578727996,3578728042,46
2,943,15067,3578727996,3578728043,47
2,943,15068,3578727996,3578728043,47
2,943,15069,3578727996,3578728044,48
2,944,15070,3578728056,3578728056,0
2,944,15071,3578728056,3578728056,0
2,944,15072,3578728056,3578728056,0
2,944,15073,3578728056,3578728056,0
2,944,15074,3578728056,3578728056,0
2,944,15075,3578728056,3578728056,0
2,944,15076,3578728056,3578728056,0
2,944,15077,3578728056,3578728056,0
2,944,15078,3578728056,3578728058,2
2,944,15079,3578728056,3578728059,3
2,944,15080,3578728056,3578728059,3
2,944,15081,3578728056,3578728060,4
2,944,15082,3578728056,3578728060,4
2,944,15083,3578728056,3578728060,4
2,944,15084,3578728056,3578728061,5
2,944,15085,3578728056,3578728061,5
2,944,15086,3578728056,3578728064,8
2,944,15087,3578728056,3578728065,9
2,944,15088,3578728056,3578728066,10
2,944,15089,3578728056,3578728067,11
2,944,15090,3578728056,3578728068,12
2,944,15091,3578728056,3578728069,13
2,944,15092,3578728056,3578728077,21
2,944,15093,3578728056,3578728081,25
2,944,15094,3578728056,3578728082,26
2,944,15095,3578728056,3578728082,26
2,944,15096,3578728056,3578728083,27
2,944,15097,3578728056,3578728084,28
2,944,15098,3578728056,3578728085,29
2,944,15099,3578728056,3578728086,30
2,944,15100,3578728056,3578728086,30
2,944,15101,3578728056,3578728087,31
2,944,15102,3578728056,3578728087,31
2,944,15103,3578728056,3578728089,33
2,944,15104,3578728056,3578728090,34
2,944,15105,3578728056,3578728090,34
2,944,15106,3578728056,3578728091,35
2,944,15107,3578728056,3578728093,37
2,944,15108,3578728056,3578728093,37
2,944,15109,3578728056,3578728094,38
2,944,15110,3578728056,3578728095,39
2,944,15111,3578728056,3578728095,39
2,944,15112,3578728056,3578728097,41
2,944,15113,3578728056,3578728099,43
2,944,15114,3578728056,3578728100,44
2,944,15115,3578728056,3578728100,44
2,944,15116,3578728056,3578728101,45
2,944,15117,3578728056,3578728103,47
2,944,15118,3578728056,3578728103,47
2,944,15119,3578728056,3578728104,48
2,944,15120,3578728056,3578728105,49
2,945,15121,3578728114,3578728114,0
2,945,15122,3578728114,3578728114,0
2,945,15123,3578728114,3578728114,0
2,945,15124,3578728114,3578728114,0
2,945,15125,3578728114,3578728114,0
2,945,15126,3578728114,3578728114,0
2,945,15127,3578728114,3578728114,0
2,945,15128,3578728114,3578728114,0
2,945,15129,3578728114,3578728114,0
2,945,15130,3578728114,3578728115,1
2,945,15131,3578728114,3578728117,3
2,945,15132,3578728114,3578728117,3
2,945,15133,3578728114,3578728117,3
2,945,15134,3578728114,3578728119,5
2,945,15135,3578728114,3578728121,7
2,945,15136,3578728114,3578728121,7
2,945,15137,3578728114,3578728122,8
2,945,15138,3578728114,3578728122,8
2,945,15139,3578728114,3578728122,8
2,945,15140,3578728114,3578728122,8
2,945,15141,3578728114,3578728123,9
2,945,15142,3578728114,3578728125,11
2,945,15143,3578728114,3578728127,13
2,945,15144,3578728114,3578728127,13
2,945,15145,3578728114,3578728132,18
2,945,15146,3578728114,3578728133,19
2,945,15147,3578728114,3578728135,21
2,945,15148,3578728114,3578728135,21
2,945,15149,3578728114,3578728136,22
2,945,15150,3578728114,3578728137,23
2,945,15151,3578728114,3578728137,23
2,945,15152,3578728114,3578728137,23
2,945,15153,3578728114,3578728138,24
2,945,15154,3578728114,3578728138,24
2,945,15155,3578728114,3578728140,26
2,945,15156,3578728114,3578728142,28
2,945,15157,3578728114,3578728143,29
2,945,15158,3578728114,3578728143,29
2,945,15159,3578728114,3578728151,37
2,945,15160,3578728114,3578728152,38
2,945,15161,3578728114,3578728152,38
2,945,15162,3578728114,3578728153,39
2,945,15163,3578728114,3578728155,41
2,945,15164,3578728114,3578728155,41
2,945,15165,3578728114,3578728155,41
2,945,15166,3578728114,3578728155,41
2,945,15167,3578728114,3578728157,43
2,946,15168,3578728170,3578728170,0
2,946,15169,3578728170,3578728170,0
2,946,15170,3578728170,3578728170,0
2,946,15171,3578728170,3578728170,0
2,946,15172,3578728170,3578728170,0
2,946,15173,3578728170,3578728170,0
2,946,15174,3578728170,3578728170,0
2,946,15175,3578728170,3578728170,0
2,946,15176,3578728170,3578728171,1
2,946,15177,3578728170,3578728172,2
2,946,15178,3578728170,3578728174,4
2,946,15179,3578728170,3578728174,4
2,946,15180,3578728170,3578728175,5
2,946,15181,3578728170,3578728176,6
2,946,15182,3578728170,3578728177,7
2,946,15183,3578728170,3578728180,10
2,946,15184,3578728170,3578728181,11
2,946,15185,3578728170,3578728181,11
2,946,15186,3578728170,3578728182,12
2,946,15187,3578728170,3578728185,15
2,946,15188,3578728170,3578728188,18
2,946,15189,3578728170,3578728189,19
2,946,15190,3578728170,3578728192,22
2,946,15191,3578728170,3578728193,23
2,946,15192,3578728170,3578728194,24
2,946,15193,3578728170,3578728194,24
2,946,15194,3578728170,3578728195,25
2,946,15195,3578728170,3578728197,27
2,946,15196,3578728170,3578728198,28
2,946,15197,3578728170,3578728200,30
2,946,15198,3578728170,3578728202,32
2,946,15199,3578728170,3578728204,34
2,946,15200,3578728170,3578728206,36
2,946,15201,3578728170,3578728209,39
2,946,15202,3578728170,3578728211,41
2,946,15203,3578728170,3578728212,42
2,946,15204,3578728170,3578728213,43
2,946,15205,3578728170,3578728214,44
2,946,15206,3578728170,3578728216,46
2,946,15207,3578728170,3578728218,48
2,946,15208,3578728170,3578728219,49
2,947,15209,3578728227,3578728227,0
2,947,15210,3578728227,3578728227,0
2,947,15211,3578728227,3578728227,0
2,947,15212,3578728227,3578728227,0
2,947,15213,3578728227,3578728227,0
2,947,15214,3578728227,3578728227,0
2,947,15215,3578728227,3578728227,0
2,947,15216,3578728227,3578728227,0
2,947,15217,3578728227,3578728229,2
2,947,15218,3578728227,3578728230,3
2,947,15219,3578728227,3578728230,3
2,947,15220,3578728227,3578728231,4
2,947,15221,3578728227,3578728232,5
2,947,15222,3578728227,3578728233,6
2,947,15223,3578728227,3578728233,6
2,947,15224,3578728227,3578728235,8
2,947,15225,3578728227,3578728237,10
2,947,15226,3578728227,3578728238,11
2,947,15227,3578728227,3578728241,14
2,947,15228,3578728227,3578728241,14
2,947,15229,3578728227,3578728242,15
2,947,15230,3578728227,3578728242,15
2,947,15231,3578728227,3578728242,15
2,947,15232,3578728227,3578728243,16
2,947,15233,3578728227,3578728243,16
2,947,15234,3578728227,3578728244,17
2,947,15235,3578728227,3578728247,20
2,947,15236,3578728227,3578728249,22
2,947,15237,3578728227,3578728250,23
2,947,15238,3578728227,3578728251,24
2,947,15239,3578728227,3578728252,25
2,947,15240,3578728227,3578728253,26
2,947,15241,3578728227,3578728253,26
2,947,15242,3578728227,3578728254,27
2,947,15243,3578728227,3578728255,28
2,947,15244,3578728227,3578728258,31
2,947,15245,3578728227,3578728258,31
2,947,15246,3578728227,3578728259,32
2,947,15247,3578728227,3578728260,33
2,947,15248,3578728227,3578728260,33
2,947,15249,3578728227,3578728260,33
2,947,15250,3578728227,3578728261,34
2,947,15251,3578728227,3578728262,35
2,947,15252,3578728227,3578728265,38
2,947,15253,3578728227,3578728267,40
2,947,15254,3578728227,3578728267,40
2,947,15255,3578728227,3578728269,42
2,947,15256,3578728227,3578728269,42
2,947,15257,3578728227,3578728277,50
2,948,15258,3578728284,3578728284,0
2,948,15259,3578728284,3578728284,0
2,948,15260,3578728284,3578728284,0
2,948,15261,3578728284,3578728284,0
2,948,15262,3578728284,3578728285,1
2,948,15263,3578728284,3578728286,2
2,948,15264,3578728284,3578728287,3
2,948,15265,3578728284,3578728288,4
2,948,15266,3578728284,3578728289,5
2,948,15267,3578728284,3578728289,5
2,948,15268,3578728284,3578728290,6
2,948,15269,3578728284,3578728290,6
2,948,15270,3578728284,3578728291,7
2,948,15271,3578728284,3578728293,9
2,948,15272,3578728284,3578728293,9
2,948,15273,3578728284,3578728294,10
2,948,15274,3578728284,3578728295,11
2,948,15275,3578728284,3578728295,11
2,948,15276,3578728284,3578728298,14
2,948,15277,3578728284,3578728300,16
2,948,15278,3578728284,3578728300,16
2,948,15279,3578728284,3578728301,17
2,948,15280,3578728284,3578728301,17
2,948,15281,3578728284,3578728304,20
2,948,15282,3578728284,3578728305,21
2,948,15283,3578728284,3578728305,21
2,948,15284,3578728284,3578728305,21
2,948,15285,3578728284,3578728306,22
2,948,15286,3578728284,3578728307,23
2,948,15287,3578728284,3578728310,26
2,948,15288,3578728284,3578728312,28
2,948,15289,3578728284,3578728312,28
2,948,15290,3578728284,3578728313,29
2,948,15291,3578728284,3578728314,30
2,948,15292,3578728284,3578728314,30
2,948,15293,3578728284,3578728315,31
2,948,15294,3578728284,3578728317,33
2,948,15295,3578728284,3578728317,33
2,948,15296,3578728284,3578728318,34
2,948,15297,3578728284,3578728318,34
2,948,15298,3578728284,3578728321,37
2,948,15299,3578728284,3578728322,38
2,948,15300,3578728284,3578728322,38
2,948,15301,3578728284,3578728322,38
2,948,15302,3578728284,3578728322,38
2,948,15303,3578728284,3578728322,38
2,948,15304,3578728284,3578728323,39
2,948,15305,3578728284,3578728326,42
2,948,15306,3578728284,3578728327,43
2,948,15307,3578728284,3578728334,50
2,949,15308,3578728343,3578728343,0
2,949,15309,3578728343,3578728343,0
2,949,15310,3578728343,3578728343,0
2,949,15311,3578728343,3578728343,0
2,949,15312,3578728343,3578728343,0
2,949,15313,3578728343,3578728343,0
2,949,15314,3578728343,3578728343,0
2,949,15315,3578728343,3578728343,0
2,949,15316,3578728343,3578728343,0
2,949,15317,3578728343,3578728343,0
2,949,15318,3578728343,3578728352,9
2,949,15319,3578728343,3578728352,9
2,949,15320,3578728343,3578728354,11
2,949,15321,3578728343,3578728354,11
2,949,15322,3578728343,3578728356,13
2,949,15323,3578728343,3578728357,14
2,949,15324,3578728343,3578728360,17
2,949,15325,3578728343,3578728364,21
2,949,15326,3578728343,3578728366,23
2,949,15327,3578728343,3578728366,23
2,949,15328,3578728343,3578728366,23
2,949,15329,3578728343,3578728369,26
2,949,15330,3578728343,3578728369,26
2,949,15331,3578728343,3578728369,26
2,949,15332,3578728343,3578728369,26
2,949,15333,3578728343,3578728374,31
2,949,15334,3578728343,3578728374,31
2,949,15335,3578728343,3578728375,32
2,949,15336,3578728343,3578728376,33
2,949,15337,3578728343,3578728380,37
2,949,15338,3578728343,3578728380,37
2,949,15339,3578728343,3578728381,38
2,949,15340,3578728343,3578728385,42
2,949,15341,3578728343,3578728386,43
2,949,15342,3578728343,3578728389,46
2,949,15343,3578728343,3578728389,46
2,949,15344,3578728343,3578728392,49
2,950,15345,3578728401,3578728401,0
2,950,15346,3578728401,3578728401,0
2,950,15347,3578728401,3578728401,0
2,950,15348,3578728401,3578728401,0
2,950,15349,3578728401,3578728401,0
2,950,15350,3578728401,3578728401,0
2,950,15351,3578728401,3578728402,1
2,950,15352,3578728401,3578728403,2
2,950,15353,3578728401,3578728407,6
2,950,15354,3578728401,3578728409,8
2,950,15355,3578728401,3578728410,9
2,950,15356,3578728401,3578728411,10
2,950,15357,3578728401,3578728413,12
2,950,15358,3578728401,3578728413,12
2,950,15359,3578728401,3578728414,13
2,950,15360,3578728401,3578728416,15
2,950,15361,3578728401,3578728417,16
2,950,15362,3578728401,3578728422,21
2,950,15363,3578728401,3578728424,23
2,950,15364,3578728401,3578728424,23
2,950,15365,3578728401,3578728427,26
2,950,15366,3578728401,3578728427,26
2,950,15367,3578728401,3578728428,27
2,950,15368,3578728401,3578728430,29
2,950,15369,3578728401,3578728430,29
2,950,15370,3578728401,3578728431,30
2,950,15371,3578728401,3578728432,31
2,950,15372,3578728401,3578728432,31
2,950,15373,3578728401,3578728433,32
2,950,15374,3578728401,3578728435,34
2,950,15375,3578728401,3578728437,36
2,950,15376,3578728401,3578728439,38
2,950,15377,3578728401,3578728442,41
2,950,15378,3578728401,3578728442,41
2,950,15379,3578728401,3578728442,41
2,950,15380,3578728401,3578728442,41
2,950,15381,3578728401,3578728443,42
2,950,15382,3578728401,3578728444,43
2,950,15383,3578728401,3578728445,44
2,950,15384,3578728401,3578728447,46
2,950,15385,3578728401,3578728450,49
2,950,15386,3578728401,3578728450,49
2,950,15387,3578728401,3578728451,50
2,951,15388,3578728461,3578728461,0
2,951,15389,3578728461,3578728461,0
2,951,15390,3578728461,3578728461,0
2,951,15391,3578728461,3578728461,0
2,951,15392,3578728461,3578728461,0
2,951,15393,3578728461,3578728461,0
2,951,15394,3578728461,3578728461,0
2,951,15395,3578728461,3578728461,0
2,951,15396,3578728461,3578728461,0
2,951,15397,3578728461,3578728461,0
2,951,15398,3578728461,3578728461,0
2,951,15399,3578728461,3578728462,1
2,951,15400,3578728461,3578728464,3
2,951,15401,3578728461,3578728465,4
2,951,15402,3578728461,3578728467,6
2,951,15403,3578728461,3578728467,6
2,951,15404,3578728461,3578728469,8
2,951,15405,3578728461,3578728469,8
2,951,15406,3578728461,3578728477,16
2,951,15407,3578728461,3578728478,17
2,951,15408,3578728461,3578728482,21
2,951,15409,3578728461,3578728483,22
2,951,15410,3578728461,3578728483,22
2,951,15411,3578728461,3578728485,24
2,951,15412,3578728461,3578728486,25
2,951,15413,3578728461,3578728487,26
2,951,15414,3578728461,3578728487,26
2,951,15415,3578728461,3578728488,27
2,951,15416,3578728461,3578728489,28
2,951,15417,3578728461,3578728490,29
2,951,15418,3578728461,3578728490,29
2,951,15419,3578728461,3578728491,30
2,951,15420,3578728461,3578728492,31
2,951,15421,3578728461,3578728494,33
2,951,15422,3578728461,3578728495,34
2,951,15423,3578728461,3578728495,34
2,951,15424,3578728461,3578728495,34
2,951,15425,3578728461,3578728497,36
2,951,15426,3578728461,3578728500,39
2,951,15427,3578728461,3578728500,39
2,951,15428,3578728461,3578728501,40
2,951,15429,3578728461,3578728501,40
2,951,15430,3578728461,3578728503,42
2,951,15431,3578728461,3578728505,44
2,951,15432,3578728461,3578728505,44
2,951,15433,3578728461,3578728506,45
2,951,15434,3578728461,3578728507,46
2,951,15435,3578728461,3578728507,46
2,951,15436,3578728461,3578728511,50
2,952,15437,3578728516,3578728516,0
2,952,15438,3578728516,3578728516,0
2,952,15439,3578728516,3578728516,0
2,952,15440,3578728516,3578728516,0
2,952,15441,3578728516,3578728516,0
2,952,15442,3578728516,3578728516,0
2,952,15443,3578728516,3578728516,0
2,952,15444,3578728516,3578728517,1
2,952,15445,3578728516,3578728517,1
2,952,15446,3578728516,3578728521,5
2,952,15447,3578728516,3578728521,5
2,952,15448,3578728516,3578728521,5
2,952,15449,3578728516,3578728521,5
2,952,15450,3578728516,3578728521,5
2,952,15451,3578728516,3578728522,6
2,952,15452,3578728516,3578728522,6
2,952,15453,3578728516,3578728524,8
2,952,15454,3578728516,3578728526,10
2,952,15455,3578728516,3578728526,10
2,952,15456,3578728516,3578728533,17
2,952,15457,3578728516,3578728535,19
2,952,15458,3578728516,3578728535,19
2,952,15459,3578728516,3578728536,20
2,952,15460,3578728516,3578728537,21
2,952,15461,3578728516,3578728539,23
2,952,15462,3578728516,3578728539,23
2,952,15463,3578728516,3578728540,24
2,952,15464,3578728516,3578728541,25
2,952,15465,3578728516,3578728542,26
2,952,15466,3578728516,3578728542,26
2,952,15467,3578728516,3578728550,34
2,952,15468,3578728516,3578728551,35
2,952,15469,3578728516,3578728552,36
2,952,15470,3578728516,3578728553,37
2,952,15471,3578728516,3578728554,38
2,952,15472,3578728516,3578728555,39
2,952,15473,3578728516,3578728556,40
2,952,15474,3578728516,3578728559,43
2,952,15475,3578728516,3578728563,47
2,952,15476,3578728516,3578728565,49
2,952,15477,3578728516,3578728565,49
2,953,15478,3578728573,3578728573,0
2,953,15479,3578728573,3578728573,0
2,953,15480,3578728573,3578728573,0
2,953,15481,3578728573,3578728573,0
2,953,15482,3578728573,3578728573,0
2,953,15483,3578728573,3578728573,0
2,953,15484,3578728573,3578728573,0
2,953,15485,3578728573,3578728575,2
2,953,15486,3578728573,3578728576,3
2,953,15487,3578728573,3578728579,6
2,953,15488,3578728573,3578728580,7
2,953,15489,3578728573,3578728582,9
2,953,15490,3578728573,3578728584,11
2,953,15491,3578728573,3578728587,14
2,953,15492,3578728573,3578728588,15
2,953,15493,3578728573,3578728590,17
2,953,15494,3578728573,3578728591,18
2,953,15495,3578728573,3578728593,20
2,953,15496,3578728573,3578728594,21
2,953,15497,3578728573,3578728594,21
2,953,15498,3578728573,3578728597,24
2,953,15499,3578728573,3578728597,24
2,953,15500,3578728573,3578728599,26
2,953,15501,3578728573,3578728601,28
2,953,15502,3578728573,3578728602,29
2,953,15503,3578728573,3578728606,33
2,953,15504,3578728573,3578728608,35
2,953,15505,3578728573,3578728609,36
2,953,15506,3578728573,3578728611,38
2,953,15507,3578728573,3578728612,39
2,953,15508,3578728573,3578728613,40
2,953,15509,3578728573,3578728614,41
2,953,15510,3578728573,3578728615,42
2,953,15511,3578728573,3578728616,43
2,953,15512,3578728573,3578728618,45
2,953,15513,3578728573,3578728620,47
2,953,15514,3578728573,3578728622,49
2,953,15515,3578728573,3578728623,50
2,954,15516,3578728631,3578728631,0
2,954,15517,3578728631,3578728631,0
2,954,15518,3578728631,3578728631,0
2,954,15519,3578728631,3578728631,0
2,954,15520,3578728631,3578728631,0
2,954,15521,3578728631,3578728631,0
2,954,15522,3578728631,3578728631,0
2,954,15523,3578728631,3578728631,0
2,954,15524,3578728631,3578728631,0
2,954,15525,3578728631,3578728632,1
2,954,15526,3578728631,3578728633,2
2,954,15527,3578728631,3578728634,3
2,954,15528,3578728631,3578728637,6
2,954,15529,3578728631,3578728638,7
2,954,15530,3578728631,3578728640,9
2,954,15531,3578728631,3578728641,10
2,954,15532,3578728631,3578728641,10
2,954,15533,3578728631,3578728641,10
2,954,15534,3578728631,3578728642,11
2,954,15535,3578728631,3578728643,12
2,954,15536,3578728631,3578728644,13
2,954,15537,3578728631,3578728646,15
2,954,15538,3578728631,3578728646,15
2,954,15539,3578728631,3578728648,17
2,954,15540,3578728631,3578728649,18
2,954,15541,3578728631,3578728649,18
2,954,15542,3578728631,3578728651,20
2,954,15543,3578728631,3578728652,21
2,954,15544,3578728631,3578728652,21
2,954,15545,3578728631,3578728653,22
2,954,15546,3578728631,3578728653,22
2,954,15547,3578728631,3578728656,25
2,954,15548,3578728631,3578728658,27
2,954,15549,3578728631,3578728658,27
2,954,15550,3578728631,3578728659,28
2,954,15551,3578728631,3578728660,29
2,954,15552,3578728631,3578728660,29
2,954,15553,3578728631,3578728660,29
2,954,15554,3578728631,3578728661,30
2,954,15555,3578728631,3578728664,33
2,954,15556,3578728631,3578728665,34
2,954,15557,3578728631,3578728667,36
2,954,15558,3578728631,3578728667,36
2,954,15559,3578728631,3578728668,37
2,954,15560,3578728631,3578728668,37
2,954,15561,3578728631,3578728669,38
2,954,15562,3578728631,3578728677,46
2,954,15563,3578728631,3578728678,47
2,954,15564,3578728631,3578728681,50
2,955,15565,3578728688,3578728688,0
2,955,15566,3578728688,3578728688,0
2,955,15567,3578728688,3578728688,0
2,955,15568,3578728688,3578728688,0
2,955,15569,3578728688,3578728688,0
2,955,15570,3578728688,3578728688,0
2,955,15571,3578728688,3578728688,0
2,955,15572,3578728688,3578728688,0
2,955,15573,3578728688,3578728689,1
2,955,15574,3578728688,3578728690,2
2,955,15575,3578728688,3578728691,3
2,955,15576,3578728688,3578728692,4
2,955,15577,3578728688,3578728693,5
2,955,15578,3578728688,3578728694,6
2,955,15579,3578728688,3578728695,7
2,955,15580,3578728688,3578728695,7
2,955,15581,3578728688,3578728698,10
2,955,15582,3578728688,3578728699,11
2,955,15583,3578728688,3578728701,13
2,955,15584,3578728688,3578728701,13
2,955,15585,3578728688,3578728701,13
2,955,15586,3578728688,3578728703,15
2,955,15587,3578728688,3578728705,17
2,955,15588,3578728688,3578728705,17
2,955,15589,3578728688,3578728707,19
2,955,15590,3578728688,3578728707,19
2,955,15591,3578728688,3578728707,19
2,955,15592,3578728688,3578728708,20
2,955,15593,3578728688,3578728711,23
2,955,15594,3578728688,3578728711,23
2,955,15595,3578728688,3578728713,25
2,955,15596,3578728688,3578728714,26
2,955,15597,3578728688,3578728714,26
2,955,15598,3578728688,3578728715,27
2,955,15599,3578728688,3578728715,27
2,955,15600,3578728688,3578728716,28
2,955,15601,3578728688,3578728716,28
2,955,15602,3578728688,3578728717,29
2,955,15603,3578728688,3578728718,30
2,955,15604,3578728688,3578728720,32
2,955,15605,3578728688,3578728721,33
2,955,15606,3578728688,3578728721,33
2,955,15607,3578728688,3578728721,33
2,955,15608,3578728688,3578728722,34
2,955,15609,3578728688,3578728722,34
2,955,15610,3578728688,3578728722,34
2,955,15611,3578728688,3578728724,36
2,955,15612,3578728688,3578728726,38
2,955,15613,3578728688,3578728727,39
2,955,15614,3578728688,3578728733,45
2,955,15615,3578728688,3578728735,47
2,955,15616,3578728688,3578728735,47
2,955,15617,3578728688,3578728735,47
2,955,15618,3578728688,3578728735,47
2,955,15619,3578728688,3578728738,50
2,956,15620,3578728745,3578728745,0
2,956,15621,3578728745,3578728745,0
2,956,15622,3578728745,3578728745,0
2,956,15623,3578728745,3578728745,0
2,956,15624,3578728745,3578728745,0
2,956,15625,3578728745,3578728745,0
2,956,15626,3578728745,3578728746,1
2,956,15627,3578728745,3578728749,4
2,956,15628,3578728745,3578728751,6
2,956,15629,3578728745,3578728754,9
2,956,15630,3578728745,3578728754,9
2,956,15631,3578728745,3578728755,10
2,956,15632,3578728745,3578728755,10
2,956,15633,3578728745,3578728755,10
2,956,15634,3578728745,3578728757,12
2,956,15635,3578728745,3578728759,14
2,956,15636,3578728745,3578728764,19
2,956,15637,3578728745,3578728765,20
2,956,15638,3578728745,3578728768,23
2,956,15639,3578728745,3578728768,23
2,956,15640,3578728745,3578728770,25
2,956,15641,3578728745,3578728771,26
2,956,15642,3578728745,3578728773,28
2,956,15643,3578728745,3578728774,29
2,956,15644,3578728745,3578728774,29
2,956,15645,3578728745,3578728775,30
2,956,15646,3578728745,3578728777,32
2,956,15647,3578728745,3578728780,35
2,956,15648,3578728745,3578728780,35
2,956,15649,3578728745,3578728782,37
2,956,15650,3578728745,3578728787,42
2,956,15651,3578728745,3578728788,43
2,956,15652,3578728745,3578728789,44
2,956,15653,3578728745,3578728792,47
2,956,15654,3578728745,3578728793,48
2,956,15655,3578728745,3578728794,49
2,956,15656,3578728745,3578728794,49
2,957,15657,3578728802,3578728802,0
2,957,15658,3578728802,3578728802,0
2,957,15659,3578728802,3578728802,0
2,957,15660,3578728802,3578728806,4
2,957,15661,3578728802,3578728808,6
2,957,15662,3578728802,3578728809,7
2,957,15663,3578728802,3578728811,9
2,957,15664,3578728802,3578728812,10
2,957,15665,3578728802,3578728814,12
2,957,15666,3578728802,3578728815,13
2,957,15667,3578728802,3578728816,14
2,957,15668,3578728802,3578728820,18
2,957,15669,3578728802,3578728820,18
2,957,15670,3578728802,3578728824,22
2,957,15671,3578728802,3578728824,22
2,957,15672,3578728802,3578728824,22
2,957,15673,3578728802,3578728826,24
2,957,15674,3578728802,3578728826,24
2,957,15675,3578728802,3578728826,24
2,957,15676,3578728802,3578728827,25
2,957,15677,3578728802,3578728827,25
2,957,15678,3578728802,3578728828,26
2,957,15679,3578728802,3578728829,27
2,957,15680,3578728802,3578728829,27
2,957,15681,3578728802,3578728831,29
2,957,15682,3578728802,3578728831,29
2,957,15683,3578728802,3578728833,31
2,957,15684,3578728802,3578728833,31
2,957,15685,3578728802,3578728834,32
2,957,15686,3578728802,3578728837,35
2,957,15687,3578728802,3578728839,37
2,957,15688,3578728802,3578728840,38
2,957,15689,3578728802,3578728841,39
2,957,15690,3578728802,3578728842,40
2,957,15691,3578728802,3578728842,40
2,957,15692,3578728802,3578728843,41
2,957,15693,3578728802,3578728844,42
2,957,15694,3578728802,3578728846,44
2,957,15695,3578728802,3578728847,45
2,957,15696,3578728802,3578728848,46
2,957,15697,3578728802,3578728849,47
2,957,15698,3578728802,3578728850,48
2,957,15699,3578728802,3578728851,49
2,957,15700,3578728802,3578728852,50
2,958,15701,3578728862,3578728862,0
2,958,15702,3578728862,3578728862,0
2,958,15703,3578728862,3578728862,0
2,958,15704,3578728862,3578728862,0
2,958,15705,3578728862,3578728862,0
2,958,15706,3578728862,3578728862,0
2,958,15707,3578728862,3578728862,0
2,958,15708,3578728862,3578728862,0
2,958,15709,3578728862,3578728862,0
2,958,15710,3578728862,3578728862,0
2,958,15711,3578728862,3578728862,0
2,958,15712,3578728862,3578728864,2
2,958,15713,3578728862,3578728865,3
2,958,15714,3578728862,3578728867,5
2,958,15715,3578728862,3578728868,6
2,958,15716,3578728862,3578728869,7
2,958,15717,3578728862,3578728869,7
2,958,15718,3578728862,3578728882,20
2,958,15719,3578728862,3578728884,22
2,958,15720,3578728862,3578728884,22
2,958,15721,3578728862,3578728885,23
2,958,15722,3578728862,3578728885,23
2,958,15723,3578728862,3578728885,23
2,958,15724,3578728862,3578728886,24
2,958,15725,3578728862,3578728887,25
2,958,15726,3578728862,3578728889,27
2,958,15727,3578728862,3578728889,27
2,958,15728,3578728862,3578728889,27
2,958,15729,3578728862,3578728891,29
2,958,15730,3578728862,3578728892,30
2,958,15731,3578728862,3578728893,31
2,958,15732,3578728862,3578728894,32
2,958,15733,3578728862,3578728895,33
2,958,15734,3578728862,3578728895,33
2,958,15735,3578728862,3578728896,34
2,958,15736,3578728862,3578728897,35
2,958,15737,3578728862,3578728897,35
2,958,15738,3578728862,3578728898,36
2,958,15739,3578728862,3578728900,38
2,958,15740,3578728862,3578728901,39
2,958,15741,3578728862,3578728901,39
2,958,15742,3578728862,3578728902,40
2,958,15743,3578728862,3578728902,40
2,958,15744,3578728862,3578728903,41
2,958,15745,3578728862,3578728905,43
2,958,15746,3578728862,3578728905,43
2,958,15747,3578728862,3578728907,45
2,958,15748,3578728862,3578728907,45
2,958,15749,3578728862,3578728907,45
2,958,15750,3578728862,3578728908,46
2,958,15751,3578728862,3578728911,49
2,958,15752,3578728862,3578728912,50
2,959,15753,3578728919,3578728919,0
2,959,15754,3578728919,3578728919,0
2,959,15755,3578728919,3578728919,0
2,959,15756,3578728919,3578728919,0
2,959,15757,3578728919,3578728919,0
2,959,15758,3578728919,3578728919,0
2,959,15759,3578728919,3578728919,0
2,959,15760,3578728919,3578728919,0
2,959,15761,3578728919,3578728919,0
2,959,15762,3578728919,3578728919,0
2,959,15763,3578728919,3578728921,2
2,959,15764,3578728919,3578728921,2
2,959,15765,3578728919,3578728921,2
2,959,15766,3578728919,3578728921,2
2,959,15767,3578728919,3578728921,2
2,959,15768,3578728919,3578728922,3
2,959,15769,3578728919,3578728923,4
2,959,15770,3578728919,3578728926,7
2,959,15771,3578728919,3578728926,7
2,959,15772,3578728919,3578728928,9
2,959,15773,3578728919,3578728933,14
2,959,15774,3578728919,3578728936,17
2,959,15775,3578728919,3578728936,17
2,959,15776,3578728919,3578728936,17
2,959,15777,3578728919,3578728938,19
2,959,15778,3578728919,3578728939,20
2,959,15779,3578728919,3578728940,21
2,959,15780,3578728919,3578728940,21
2,959,15781,3578728919,3578728940,21
2,959,15782,3578728919,3578728941,22
2,959,15783,3578728919,3578728941,22
2,959,15784,3578728919,3578728942,23
2,959,15785,3578728919,3578728946,27
2,959,15786,3578728919,3578728950,31
2,959,15787,3578728919,3578728952,33
2,959,15788,3578728919,3578728954,35
2,959,15789,3578728919,3578728955,36
2,959,15790,3578728919,3578728955,36
2,959,15791,3578728919,3578728955,36
2,959,15792,3578728919,3578728955,36
2,959,15793,3578728919,3578728958,39
2,959,15794,3578728919,3578728959,40
2,959,15795,3578728919,3578728963,44
2,959,15796,3578728919,3578728965,46
2,959,15797,3578728919,3578728965,46
2,959,15798,3578728919,3578728967,48
2,959,15799,3578728919,3578728968,49
2,959,15800,3578728919,3578728969,50
2,960,15801,3578728976,3578728976,0
2,960,15802,3578728976,3578728976,0
2,960,15803,3578728976,3578728976,0
2,960,15804,3578728976,3578728976,0
2,960,15805,3578728976,3578728976,0
2,960,15806,3578728976,3578728976,0
2,960,15807,3578728976,3578728979,3
2,960,15808,3578728976,3578728980,4
2,960,15809,3578728976,3578728981,5
2,960,15810,3578728976,3578728985,9
2,960,15811,3578728976,3578728985,9
2,960,15812,3578728976,3578728987,11
2,960,15813,3578728976,3578728989,13
2,960,15814,3578728976,3578728991,15
2,960,15815,3578728976,3578728993,17
2,960,15816,3578728976,3578728993,17
2,960,15817,3578728976,3578728994,18
2,960,15818,3578728976,3578728994,18
2,960,15819,3578728976,3578728996,20
2,960,15820,3578728976,3578728998,22
2,960,15821,3578728976,3578729000,24
2,960,15822,3578728976,3578729003,27
2,960,15823,3578728976,3578729003,27
2,960,15824,3578728976,3578729007,31
2,960,15825,3578728976,3578729008,32
2,960,15826,3578728976,3578729010,34
2,960,15827,3578728976,3578729011,35
2,960,15828,3578728976,3578729013,37
2,960,15829,3578728976,3578729014,38
2,960,15830,3578728976,3578729016,40
2,960,15831,3578728976,3578729017,41
2,960,15832,3578728976,3578729017,41
2,960,15833,3578728976,3578729019,43
2,960,15834,3578728976,3578729020,44
2,960,15835,3578728976,3578729021,45
2,960,15836,3578728976,3578729024,48
2,960,15837,3578728976,3578729024,48
2,960,15838,3578728976,3578729024,48
2,960,15839,3578728976,3578729025,49
2,960,15840,3578728976,3578729026,50
2,961,15841,3578729035,3578729035,0
2,961,15842,3578729035,3578729035,0
2,961,15843,3578729035,3578729035,0
2,961,15844,3578729035,3578729035,0
2,961,15845,3578729035,3578729035,0
2,961,15846,3578729035,3578729035,0
2,961,15847,3578729035,3578729035,0
2,961,15848,3578729035,3578729035,0
2,961,15849,3578729035,3578729035,0
2,961,15850,3578729035,3578729035,0
2,961,15851,3578729035,3578729038,3
2,961,15852,3578729035,3578729039,4
2,961,15853,3578729035,3578729041,6
2,961,15854,3578729035,3578729041,6
2,961,15855,3578729035,3578729042,7
2,961,15856,3578729035,3578729042,7
2,961,15857,3578729035,3578729042,7
2,961,15858,3578729035,3578729043,8
2,961,15859,3578729035,3578729043,8
2,961,15860,3578729035,3578729044,9
2,961,15861,3578729035,3578729046,11
2,961,15862,3578729035,3578729047,12
2,961,15863,3578729035,3578729049,14
2,961,15864,3578729035,3578729049,14
2,961,15865,3578729035,3578729051,16
2,961,15866,3578729035,3578729051,16
2,961,15867,3578729035,3578729052,17
2,961,15868,3578729035,3578729052,17
2,961,15869,3578729035,3578729053,18
2,961,15870,3578729035,3578729058,23
2,961,15871,3578729035,3578729058,23
2,961,15872,3578729035,3578729059,24
2,961,15873,3578729035,3578729061,26
2,961,15874,3578729035,3578729061,26
2,961,15875,3578729035,3578729061,26
2,961,15876,3578729035,3578729062,27
2,961,15877,3578729035,3578729063,28
2,961,15878,3578729035,3578729065,30
2,961,15879,3578729035,3578729065,30
2,961,15880,3578729035,3578729067,32
2,961,15881,3578729035,3578729068,33
2,961,15882,3578729035,3578729069,34
2,961,15883,3578729035,3578729070,35
2,961,15884,3578729035,3578729077,42
2,961,15885,3578729035,3578729082,47
2,961,15886,3578729035,3578729083,48
2,961,15887,3578729035,3578729084,49
2,961,15888,3578729035,3578729084,49
2,961,15889,3578729035,3578729085,50
2,962,15890,3578729092,3578729092,0
2,962,15891,3578729092,3578729092,0
2,962,15892,3578729092,3578729092,0
2,962,15893,3578729092,3578729092,0
2,962,15894,3578729092,3578729092,0
2,962,15895,3578729092,3578729092,0
2,962,15896,3578729092,3578729092,0
2,962,15897,3578729092,3578729092,0
2,962,15898,3578729092,3578729092,0
2,962,15899,3578729092,3578729092,0
2,962,15900,3578729092,3578729093,1
2,962,15901,3578729092,3578729093,1
2,962,15902,3578729092,3578729095,3
2,962,15903,3578729092,3578729095,3
2,962,15904,3578729092,3578729096,4
2,962,15905,3578729092,3578729097,5
2,962,15906,3578729092,3578729098,6
2,962,15907,3578729092,3578729099,7
2,962,15908,3578729092,3578729099,7
2,962,15909,3578729092,3578729100,8
2,962,15910,3578729092,3578729104,12
2,962,15911,3578729092,3578729105,13
2,962,15912,3578729092,3578729107,15
2,962,15913,3578729092,3578729107,15
2,962,15914,3578729092,3578729108,16
2,962,15915,3578729092,3578729108,16
2,962,15916,3578729092,3578729108,16
2,962,15917,3578729092,3578729111,19
2,962,15918,3578729092,3578729112,20
2,962,15919,3578729092,3578729113,21
2,962,15920,3578729092,3578729114,22
2,962,15921,3578729092,3578729114,22
2,962,15922,3578729092,3578729116,24
2,962,15923,3578729092,3578729116,24
2,962,15924,3578729092,3578729117,25
2,962,15925,3578729092,3578729117,25
2,962,15926,3578729092,3578729118,26
2,962,15927,3578729092,3578729118,26
2,962,15928,3578729092,3578729119,27
2,962,15929,3578729092,3578729121,29
2,962,15930,3578729092,3578729122,30
2,962,15931,3578729092,3578729122,30
2,962,15932,3578729092,3578729122,30
2,962,15933,3578729092,3578729122,30
2,962,15934,3578729092,3578729123,31
2,962,15935,3578729092,3578729123,31
2,962,15936,3578729092,3578729125,33
2,962,15937,3578729092,3578729126,34
2,962,15938,3578729092,3578729128,36
2,962,15939,3578729092,3578729135,43
2,962,15940,3578729092,3578729136,44
2,962,15941,3578729092,3578729136,44
2,962,15942,3578729092,3578729136,44
2,962,15943,3578729092,3578729138,46
2,962,15944,3578729092,3578729139,47
2,962,15945,3578729092,3578729140,48
2,962,15946,3578729092,3578729140,48
2,962,15947,3578729092,3578729141,49
2,963,15948,3578729150,3578729150,0
2,963,15949,3578729150,3578729150,0
2,963,15950,3578729150,3578729150,0
2,963,15951,3578729150,3578729150,0
2,963,15952,3578729150,3578729151,1
2,963,15953,3578729150,3578729151,1
2,963,15954,3578729150,3578729152,2
2,963,15955,3578729150,3578729154,4
2,963,15956,3578729150,3578729155,5
2,963,15957,3578729150,3578729156,6
2,963,15958,3578729150,3578729158,8
2,963,15959,3578729150,3578729159,9
2,963,15960,3578729150,3578729164,14
2,963,15961,3578729150,3578729165,15
2,963,15962,3578729150,3578729165,15
2,963,15963,3578729150,3578729166,16
2,963,15964,3578729150,3578729168,18
2,963,15965,3578729150,3578729169,19
2,963,15966,3578729150,3578729169,19
2,963,15967,3578729150,3578729169,19
2,963,15968,3578729150,3578729173,23
2,963,15969,3578729150,3578729175,25
2,963,15970,3578729150,3578729175,25
2,963,15971,3578729150,3578729176,26
2,963,15972,3578729150,3578729177,27
2,963,15973,3578729150,3578729178,28
2,963,15974,3578729150,3578729180,30
2,963,15975,3578729150,3578729180,30
2,963,15976,3578729150,3578729182,32
2,963,15977,3578729150,3578729185,35
2,963,15978,3578729150,3578729189,39
2,963,15979,3578729150,3578729189,39
2,963,15980,3578729150,3578729192,42
2,963,15981,3578729150,3578729193,43
2,963,15982,3578729150,3578729194,44
2,963,15983,3578729150,3578729194,44
2,963,15984,3578729150,3578729196,46
2,963,15985,3578729150,3578729200,50
2,964,15986,3578729208,3578729208,0
2,964,15987,3578729208,3578729208,0
2,964,15988,3578729208,3578729208,0
2,964,15989,3578729208,3578729208,0
2,964,15990,3578729208,3578729211,3
2,964,15991,3578729208,3578729212,4
2,964,15992,3578729208,3578729215,7
2,964,15993,3578729208,3578729216,8
2,964,15994,3578729208,3578729217,9
2,964,15995,3578729208,3578729217,9
2,964,15996,3578729208,3578729218,10
2,964,15997,3578729208,3578729219,11
2,964,15998,3578729208,3578729221,13
2,964,15999,3578729208,3578729224,16
2,964,16000,3578729208,3578729224,16
2,964,16001,3578729208,3578729225,17
2,964,16002,3578729208,3578729226,18
2,964,16003,3578729208,3578729226,18
2,964,16004,3578729208,3578729227,19
2,964,16005,3578729208,3578729227,19
2,964,16006,3578729208,3578729228,20
2,964,16007,3578729208,3578729228,20
2,964,16008,3578729208,3578729230,22
2,964,16009,3578729208,3578729230,22
2,964,16010,3578729208,3578729231,23
2,964,16011,3578729208,3578729232,24
2,964,16012,3578729208,3578729233,25
2,964,16013,3578729208,3578729234,26
2,964,16014,3578729208,3578729235,27
2,964,16015,3578729208,3578729239,31
2,964,16016,3578729208,3578729241,33
2,964,16017,3578729208,3578729242,34
2,964,16018,3578729208,3578729242,34
2,964,16019,3578729208,3578729242,34
2,964,16020,3578729208,3578729243,35
2,964,16021,3578729208,3578729243,35
2,964,16022,3578729208,3578729244,36
2,964,16023,3578729208,3578729244,36
2,964,16024,3578729208,3578729246,38
2,964,16025,3578729208,3578729247,39
2,964,16026,3578729208,3578729249,41
2,964,16027,3578729208,3578729250,42
2,964,16028,3578729208,3578729251,43
2,964,16029,3578729208,3578729251,43
2,964,16030,3578729208,3578729252,44
2,964,16031,3578729208,3578729253,45
2,964,16032,3578729208,3578729255,47
2,965,16033,3578729267,3578729267,0
2,965,16034,3578729267,3578729267,0
2,965,16035,3578729267,3578729267,0
2,965,16036,3578729267,3578729267,0
2,965,16037,3578729267,3578729267,0
2,965,16038,3578729267,3578729267,0
2,965,16039,3578729267,3578729267,0
2,965,16040,3578729267,3578729267,0
2,965,16041,3578729267,3578729268,1
2,965,16042,3578729267,3578729269,2
2,965,16043,3578729267,3578729269,2
2,965,16044,3578729267,3578729277,10
2,965,16045,3578729267,3578729279,12
2,965,16046,3578729267,3578729281,14
2,965,16047,3578729267,3578729283,16
2,965,16048,3578729267,3578729285,18
2,965,16049,3578729267,3578729285,18
2,965,16050,3578729267,3578729285,18
2,965,16051,3578729267,3578729285,18
2,965,16052,3578729267,3578729286,19
2,965,16053,3578729267,3578729286,19
2,965,16054,3578729267,3578729288,21
2,965,16055,3578729267,3578729289,22
2,965,16056,3578729267,3578729289,22
2,965,16057,3578729267,3578729290,23
2,965,16058,3578729267,3578729290,23
2,965,16059,3578729267,3578729292,25
2,965,16060,3578729267,3578729293,26
2,965,16061,3578729267,3578729293,26
2,965,16062,3578729267,3578729294,27
2,965,16063,3578729267,3578729295,28
2,965,16064,3578729267,3578729296,29
2,965,16065,3578729267,3578729297,30
2,965,16066,3578729267,3578729297,30
2,965,16067,3578729267,3578729298,31
2,965,16068,3578729267,3578729298,31
2,965,16069,3578729267,3578729299,32
2,965,16070,3578729267,3578729301,34
2,965,16071,3578729267,3578729302,35
2,965,16072,3578729267,3578729302,35
2,965,16073,3578729267,3578729303,36
2,965,16074,3578729267,3578729305,38
2,965,16075,3578729267,3578729307,40
2,965,16076,3578729267,3578729308,41
2,965,16077,3578729267,3578729308,41
2,965,16078,3578729267,3578729308,41
2,965,16079,3578729267,3578729311,44
2,965,16080,3578729267,3578729311,44
2,965,16081,3578729267,3578729312,45
2,965,16082,3578729267,3578729312,45
2,965,16083,3578729267,3578729313,46
2,965,16084,3578729267,3578729314,47
2,965,16085,3578729267,3578729316,49
2,965,16086,3578729267,3578729316,49
2,966,16087,3578729325,3578729325,0
2,966,16088,3578729325,3578729325,0
2,966,16089,3578729325,3578729325,0
2,966,16090,3578729325,3578729325,0
2,966,16091,3578729325,3578729325,0
2,966,16092,3578729325,3578729325,0
2,966,16093,3578729325,3578729325,0
2,966,16094,3578729325,3578729325,0
2,966,16095,3578729325,3578729325,0
2,966,16096,3578729325,3578729325,0
2,966,16097,3578729325,3578729325,0
2,966,16098,3578729325,3578729325,0
2,966,16099,3578729325,3578729325,0
2,966,16100,3578729325,3578729325,0
2,966,16101,3578729325,3578729328,3
2,966,16102,3578729325,3578729333,8
2,966,16103,3578729325,3578729335,10
2,966,16104,3578729325,3578729335,10
2,966,16105,3578729325,3578729336,11
2,966,16106,3578729325,3578729336,11
2,966,16107,3578729325,3578729337,12
2,966,16108,3578729325,3578729338,13
2,966,16109,3578729325,3578729338,13
2,966,16110,3578729325,3578729340,15
2,966,16111,3578729325,3578729340,15
2,966,16112,3578729325,3578729341,16
2,966,16113,3578729325,3578729342,17
2,966,16114,3578729325,3578729343,18
2,966,16115,3578729325,3578729347,22
2,966,16116,3578729325,3578729351,26
2,966,16117,3578729325,3578729352,27
2,966,16118,3578729325,3578729352,27
2,966,16119,3578729325,3578729354,29
2,966,16120,3578729325,3578729355,30
2,966,16121,3578729325,3578729356,31
2,966,16122,3578729325,3578729359,34
2,966,16123,3578729325,3578729360,35
2,966,16124,3578729325,3578729364,39
2,966,16125,3578729325,3578729364,39
2,966,16126,3578729325,3578729365,40
2,966,16127,3578729325,3578729365,40
2,966,16128,3578729325,3578729365,40
2,966,16129,3578729325,3578729368,43
2,966,16130,3578729325,3578729369,44
2,966,16131,3578729325,3578729370,45
2,966,16132,3578729325,3578729370,45
2,966,16133,3578729325,3578729373,48
2,967,16134,3578729383,3578729383,0
2,967,16135,3578729383,3578729383,0
2,967,16136,3578729383,3578729383,0
2,967,16137,3578729383,3578729383,0
2,967,16138,3578729383,3578729383,0
2,967,16139,3578729383,3578729383,0
2,967,16140,3578729383,3578729383,0
2,967,16141,3578729383,3578729386,3
2,967,16142,3578729383,3578729389,6
2,967,16143,3578729383,3578729389,6
2,967,16144,3578729383,3578729391,8
2,967,16145,3578729383,3578729394,11
2,967,16146,3578729383,3578729394,11
2,967,16147,3578729383,3578729395,12
2,967,16148,3578729383,3578729397,14
2,967,16149,3578729383,3578729398,15
2,967,16150,3578729383,3578729400,17
2,967,16151,3578729383,3578729403,20
2,967,16152,3578729383,3578729404,21
2,967,16153,3578729383,3578729407,24
2,967,16154,3578729383,3578729409,26
2,967,16155,3578729383,3578729411,28
2,967,16156,3578729383,3578729413,30
2,967,16157,3578729383,3578729415,32
2,967,16158,3578729383,3578729415,32
2,967,16159,3578729383,3578729417,34
2,967,16160,3578729383,3578729418,35
2,967,16161,3578729383,3578729420,37
2,967,16162,3578729383,3578729420,37
2,967,16163,3578729383,3578729424,41
2,967,16164,3578729383,3578729424,41
2,967,16165,3578729383,3578729425,42
2,967,16166,3578729383,3578729426,43
2,967,16167,3578729383,3578729427,44
2,967,16168,3578729383,3578729427,44
2,967,16169,3578729383,3578729427,44
2,967,16170,3578729383,3578729427,44
2,967,16171,3578729383,3578729428,45
2,967,16172,3578729383,3578729430,47
2,967,16173,3578729383,3578729431,48
2,967,16174,3578729383,3578729432,49
2,967,16175,3578729383,3578729432,49
2,968,16176,3578729442,3578729442,0
2,968,16177,3578729442,3578729442,0
2,968,16178,3578729442,3578729442,0
2,968,16179,3578729442,3578729442,0
2,968,16180,3578729442,3578729442,0
2,968,16181,3578729442,3578729442,0
2,968,16182,3578729442,3578729442,0
2,968,16183,3578729442,3578729443,1
2,968,16184,3578729442,3578729443,1
2,968,16185,3578729442,3578729443,1
2,968,16186,3578729442,3578729445,3
2,968,16187,3578729442,3578729446,4
2,968,16188,3578729442,3578729449,7
2,968,16189,3578729442,3578729450,8
2,968,16190,3578729442,3578729451,9
2,968,16191,3578729442,3578729451,9
2,968,16192,3578729442,3578729452,10
2,968,16193,3578729442,3578729452,10
2,968,16194,3578729442,3578729454,12
2,968,16195,3578729442,3578729454,12
2,968,16196,3578729442,3578729458,16
2,968,16197,3578729442,3578729461,19
2,968,16198,3578729442,3578729462,20
2,968,16199,3578729442,3578729462,20
2,968,16200,3578729442,3578729464,22
2,968,16201,3578729442,3578729464,22
2,968,16202,3578729442,3578729465,23
2,968,16203,3578729442,3578729468,26
2,968,16204,3578729442,3578729468,26
2,968,16205,3578729442,3578729469,27
2,968,16206,3578729442,3578729470,28
2,968,16207,3578729442,3578729476,34
2,968,16208,3578729442,3578729482,40
2,968,16209,3578729442,3578729484,42
2,968,16210,3578729442,3578729484,42
2,968,16211,3578729442,3578729484,42
2,968,16212,3578729442,3578729485,43
2,968,16213,3578729442,3578729486,44
2,968,16214,3578729442,3578729486,44
2,968,16215,3578729442,3578729488,46
2,968,16216,3578729442,3578729489,47
2,968,16217,3578729442,3578729490,48
2,968,16218,3578729442,3578729491,49
2,969,16219,3578729499,3578729499,0
2,969,16220,3578729499,3578729499,0
2,969,16221,3578729499,3578729499,0
2,969,16222,3578729499,3578729499,0
2,969,16223,3578729499,3578729499,0
2,969,16224,3578729499,3578729499,0
2,969,16225,3578729499,3578729499,0
2,969,16226,3578729499,3578729499,0
2,969,16227,3578729499,3578729499,0
2,969,16228,3578729499,3578729500,1
2,969,16229,3578729499,3578729502,3
2,969,16230,3578729499,3578729504,5
2,969,16231,3578729499,3578729506,7
2,969,16232,3578729499,3578729507,8
2,969,16233,3578729499,3578729507,8
2,969,16234,3578729499,3578729507,8
2,969,16235,3578729499,3578729510,11
2,969,16236,3578729499,3578729511,12
2,969,16237,3578729499,3578729512,13
2,969,16238,3578729499,3578729515,16
2,969,16239,3578729499,3578729516,17
2,969,16240,3578729499,3578729517,18
2,969,16241,3578729499,3578729520,21
2,969,16242,3578729499,3578729520,21
2,969,16243,3578729499,3578729520,21
2,969,16244,3578729499,3578729521,22
2,969,16245,3578729499,3578729521,22
2,969,16246,3578729499,3578729521,22
2,969,16247,3578729499,3578729522,23
2,969,16248,3578729499,3578729523,24
2,969,16249,3578729499,3578729523,24
2,969,16250,3578729499,3578729524,25
2,969,16251,3578729499,3578729525,26
2,969,16252,3578729499,3578729527,28
2,969,16253,3578729499,3578729532,33
2,969,16254,3578729499,3578729534,35
2,969,16255,3578729499,3578729534,35
2,969,16256,3578729499,3578729535,36
2,969,16257,3578729499,3578729535,36
2,969,16258,3578729499,3578729535,36
2,969,16259,3578729499,3578729538,39
2,969,16260,3578729499,3578729538,39
2,969,16261,3578729499,3578729538,39
2,969,16262,3578729499,3578729540,41
2,969,16263,3578729499,3578729540,41
2,969,16264,3578729499,3578729541,42
2,969,16265,3578729499,3578729542,43
2,969,16266,3578729499,3578729545,46
2,970,16267,3578729556,3578729556,0
2,970,16268,3578729556,3578729556,0
2,970,16269,3578729556,3578729556,0
2,970,16270,3578729556,3578729556,0
2,970,16271,3578729556,3578729556,0
2,970,16272,3578729556,3578729556,0
2,970,16273,3578729556,3578729558,2
2,970,16274,3578729556,3578729560,4
2,970,16275,3578729556,3578729563,7
2,970,16276,3578729556,3578729563,7
2,970,16277,3578729556,3578729564,8
2,970,16278,3578729556,3578729565,9
2,970,16279,3578729556,3578729565,9
2,970,16280,3578729556,3578729567,11
2,970,16281,3578729556,3578729568,12
2,970,16282,3578729556,3578729569,13
2,970,16283,3578729556,3578729572,16
2,970,16284,3578729556,3578729572,16
2,970,16285,3578729556,3578729574,18
2,970,16286,3578729556,3578729575,19
2,970,16287,3578729556,3578729576,20
2,970,16288,3578729556,3578729577,21
2,970,16289,3578729556,3578729578,22
2,970,16290,3578729556,3578729579,23
2,970,16291,3578729556,3578729580,24
2,970,16292,3578729556,3578729583,27
2,970,16293,3578729556,3578729584,28
2,970,16294,3578729556,3578729588,32
2,970,16295,3578729556,3578729588,32
2,970,16296,3578729556,3578729591,35
2,970,16297,3578729556,3578729593,37
2,970,16298,3578729556,3578729594,38
2,970,16299,3578729556,3578729594,38
2,970,16300,3578729556,3578729596,40
2,970,16301,3578729556,3578729599,43
2,970,16302,3578729556,3578729603,47
2,970,16303,3578729556,3578729603,47
2,971,16304,3578729613,3578729613,0
2,971,16305,3578729613,3578729613,0
2,971,16306,3578729613,3578729613,0
2,971,16307,3578729613,3578729614,1
2,971,16308,3578729613,3578729615,2
2,971,16309,3578729613,3578729617,4
2,971,16310,3578729613,3578729618,5
2,971,16311,3578729613,3578729619,6
2,971,16312,3578729613,3578729620,7
2,971,16313,3578729613,3578729623,10
2,971,16314,3578729613,3578729623,10
2,971,16315,3578729613,3578729625,12
2,971,16316,3578729613,3578729625,12
2,971,16317,3578729613,3578729626,13
2,971,16318,3578729613,3578729626,13
2,971,16319,3578729613,3578729627,14
2,971,16320,3578729613,3578729627,14
2,971,16321,3578729613,3578729627,14
2,971,16322,3578729613,3578729629,16
2,971,16323,3578729613,3578729630,17
2,971,16324,3578729613,3578729631,18
2,971,16325,3578729613,3578729631,18
2,971,16326,3578729613,3578729631,18
2,971,16327,3578729613,3578729632,19
2,971,16328,3578729613,3578729635,22
2,971,16329,3578729613,3578729639,26
2,971,16330,3578729613,3578729641,28
2,971,16331,3578729613,3578729641,28
2,971,16332,3578729613,3578729642,29
2,971,16333,3578729613,3578729642,29
2,971,16334,3578729613,3578729643,30
2,971,16335,3578729613,3578729644,31
2,971,16336,3578729613,3578729646,33
2,971,16337,3578729613,3578729646,33
2,971,16338,3578729613,3578729649,36
2,971,16339,3578729613,3578729649,36
2,971,16340,3578729613,3578729650,37
2,971,16341,3578729613,3578729651,38
2,971,16342,3578729613,3578729651,38
2,971,16343,3578729613,3578729652,39
2,971,16344,3578729613,3578729652,39
2,971,16345,3578729613,3578729654,41
2,971,16346,3578729613,3578729656,43
2,971,16347,3578729613,3578729658,45
2,971,16348,3578729613,3578729660,47
2,971,16349,3578729613,3578729660,47
2,971,16350,3578729613,3578729661,48
2,971,16351,3578729613,3578729662,49
2,971,16352,3578729613,3578729663,50
2,972,16353,3578729670,3578729670,0
2,972,16354,3578729670,3578729670,0
2,972,16355,3578729670,3578729670,0
2,972,16356,3578729670,3578729670,0
2,972,16357,3578729670,3578729670,0
2,972,16358,3578729670,3578729670,0
2,972,16359,3578729670,3578729676,6
2,972,16360,3578729670,3578729681,11
2,972,16361,3578729670,3578729683,13
2,972,16362,3578729670,3578729684,14
2,972,16363,3578729670,3578729684,14
2,972,16364,3578729670,3578729684,14
2,972,16365,3578729670,3578729684,14
2,972,16366,3578729670,3578729686,16
2,972,16367,3578729670,3578729686,16
2,972,16368,3578729670,3578729688,18
2,972,16369,3578729670,3578729689,19
2,972,16370,3578729670,3578729690,20
2,972,16371,3578729670,3578729690,20
2,972,16372,3578729670,3578729691,21
2,972,16373,3578729670,3578729693,23
2,972,16374,3578729670,3578729694,24
2,972,16375,3578729670,3578729694,24
2,972,16376,3578729670,3578729694,24
2,972,16377,3578729670,3578729694,24
2,972,16378,3578729670,3578729695,25
2,972,16379,3578729670,3578729696,26
2,972,16380,3578729670,3578729696,26
2,972,16381,3578729670,3578729697,27
2,972,16382,3578729670,3578729697,27
2,972,16383,3578729670,3578729700,30
2,972,16384,3578729670,3578729701,31
2,972,16385,3578729670,3578729701,31
2,972,16386,3578729670,3578729701,31
2,972,16387,3578729670,3578729703,33
2,972,16388,3578729670,3578729704,34
2,972,16389,3578729670,3578729706,36
2,972,16390,3578729670,3578729706,36
2,972,16391,3578729670,3578729707,37
2,972,16392,3578729670,3578729707,37
2,972,16393,3578729670,3578729708,38
2,972,16394,3578729670,3578729709,39
2,972,16395,3578729670,3578729711,41
2,972,16396,3578729670,3578729711,41
2,972,16397,3578729670,3578729712,42
2,972,16398,3578729670,3578729713,43
2,972,16399,3578729670,3578729715,45
2,972,16400,3578729670,3578729717,47
2,972,16401,3578729670,3578729718,48
2,972,16402,3578729670,3578729719,49
2,972,16403,3578729670,3578729720,50
2,973,16404,3578729730,3578729730,0
2,973,16405,3578729730,3578729730,0
2,973,16406,3578729730,3578729730,0
2,973,16407,3578729730,3578729730,0
2,973,16408,3578729730,3578729730,0
2,973,16409,3578729730,3578729730,0
2,973,16410,3578729730,3578729730,0
2,973,16411,3578729730,3578729730,0
2,973,16412,3578729730,3578729730,0
2,973,16413,3578729730,3578729732,2
2,973,16414,3578729730,3578729734,4
2,973,16415,3578729730,3578729735,5
2,973,16416,3578729730,3578729735,5
2,973,16417,3578729730,3578729735,5
2,973,16418,3578729730,3578729736,6
2,973,16419,3578729730,3578729738,8
2,973,16420,3578729730,3578729738,8
2,973,16421,3578729730,3578729739,9
2,973,16422,3578729730,3578729740,10
2,973,16423,3578729730,3578729740,10
2,973,16424,3578729730,3578729741,11
2,973,16425,3578729730,3578729742,12
2,973,16426,3578729730,3578729745,15
2,973,16427,3578729730,3578729750,20
2,973,16428,3578729730,3578729750,20
2,973,16429,3578729730,3578729753,23
2,973,16430,3578729730,3578729755,25
2,973,16431,3578729730,3578729755,25
2,973,16432,3578729730,3578729758,28
2,973,16433,3578729730,3578729760,30
2,973,16434,3578729730,3578729763,33
2,973,16435,3578729730,3578729764,34
2,973,16436,3578729730,3578729764,34
2,973,16437,3578729730,3578729766,36
2,973,16438,3578729730,3578729768,38
2,973,16439,3578729730,3578729769,39
2,973,16440,3578729730,3578729769,39
2,973,16441,3578729730,3578729770,40
2,973,16442,3578729730,3578729773,43
2,973,16443,3578729730,3578729774,44
2,973,16444,3578729730,3578729774,44
2,973,16445,3578729730,3578729776,46
2,973,16446,3578729730,3578729777,47
2,973,16447,3578729730,3578729778,48
2,973,16448,3578729730,3578729779,49
2,974,16449,3578729792,3578729792,0
2,974,16450,3578729792,3578729792,0
2,974,16451,3578729792,3578729792,0
2,974,16452,3578729792,3578729792,0
2,974,16453,3578729792,3578729792,0
2,974,16454,3578729792,3578729792,0
2,974,16455,3578729792,3578729792,0
2,974,16456,3578729792,3578729793,1
2,974,16457,3578729792,3578729794,2
2,974,16458,3578729792,3578729794,2
2,974,16459,3578729792,3578729797,5
2,974,16460,3578729792,3578729798,6
2,974,16461,3578729792,3578729799,7
2,974,16462,3578729792,3578729802,10
2,974,16463,3578729792,3578729806,14
2,974,16464,3578729792,3578729808,16
2,974,16465,3578729792,3578729809,17
2,974,16466,3578729792,3578729811,19
2,974,16467,3578729792,3578729812,20
2,974,16468,3578729792,3578729814,22
2,974,16469,3578729792,3578729814,22
2,974,16470,3578729792,3578729816,24
2,974,16471,3578729792,3578729817,25
2,974,16472,3578729792,3578729818,26
2,974,16473,3578729792,3578729818,26
2,974,16474,3578729792,3578729819,27
2,974,16475,3578729792,3578729824,32
2,974,16476,3578729792,3578729824,32
2,974,16477,3578729792,3578729826,34
2,974,16478,3578729792,3578729826,34
2,974,16479,3578729792,3578729827,35
2,974,16480,3578729792,3578729827,35
2,974,16481,3578729792,3578729828,36
2,974,16482,3578729792,3578729828,36
2,974,16483,3578729792,3578729829,37
2,974,16484,3578729792,3578729829,37
2,974,16485,3578729792,3578729831,39
2,974,16486,3578729792,3578729831,39
2,974,16487,3578729792,3578729833,41
2,974,16488,3578729792,3578729833,41
2,974,16489,3578729792,3578729835,43
2,974,16490,3578729792,3578729838,46
2,974,16491,3578729792,3578729840,48
2,974,16492,3578729792,3578729840,48
2,974,16493,3578729792,3578729841,49
2,974,16494,3578729792,3578729841,49
2,974,16495,3578729792,3578729842,50
2,975,16496,3578729852,3578729852,0
2,975,16497,3578729852,3578729852,0
2,975,16498,3578729852,3578729852,0
2,975,16499,3578729852,3578729852,0
2,975,16500,3578729852,3578729852,0
2,975,16501,3578729852,3578729852,0
2,975,16502,3578729852,3578729852,0
2,975,16503,3578729852,3578729852,0
2,975,16504,3578729852,3578729852,0
2,975,16505,3578729852,3578729853,1
2,975,16506,3578729852,3578729854,2
2,975,16507,3578729852,3578729857,5
2,975,16508,3578729852,3578729858,6
2,975,16509,3578729852,3578729859,7
2,975,16510,3578729852,3578729861,9
2,975,16511,3578729852,3578729861,9
2,975,16512,3578729852,3578729863,11
2,975,16513,3578729852,3578729863,11
2,975,16514,3578729852,3578729864,12
2,975,16515,3578729852,3578729865,13
2,975,16516,3578729852,3578729867,15
2,975,16517,3578729852,3578729868,16
2,975,16518,3578729852,3578729868,16
2,975,16519,3578729852,3578729869,17
2,975,16520,3578729852,3578729870,18
2,975,16521,3578729852,3578729877,25
2,975,16522,3578729852,3578729881,29
2,975,16523,3578729852,3578729884,32
2,975,16524,3578729852,3578729885,33
2,975,16525,3578729852,3578729885,33
2,975,16526,3578729852,3578729885,33
2,975,16527,3578729852,3578729886,34
2,975,16528,3578729852,3578729887,35
2,975,16529,3578729852,3578729888,36
2,975,16530,3578729852,3578729889,37
2,975,16531,3578729852,3578729890,38
2,975,16532,3578729852,3578729890,38
2,975,16533,3578729852,3578729890,38
2,975,16534,3578729852,3578729892,40
2,975,16535,3578729852,3578729893,41
2,975,16536,3578729852,3578729894,42
2,975,16537,3578729852,3578729894,42
2,975,16538,3578729852,3578729895,43
2,975,16539,3578729852,3578729895,43
2,975,16540,3578729852,3578729896,44
2,975,16541,3578729852,3578729896,44
2,975,16542,3578729852,3578729898,46
2,975,16543,3578729852,3578729898,46
2,975,16544,3578729852,3578729900,48
2,975,16545,3578729852,3578729900,48
2,975,16546,3578729852,3578729901,49
2,975,16547,3578729852,3578729902,50
2,976,16548,3578729909,3578729909,0
2,976,16549,3578729909,3578729909,0
2,976,16550,3578729909,3578729909,0
2,976,16551,3578729909,3578729909,0
2,976,16552,3578729909,3578729909,0
2,976,16553,3578729909,3578729909,0
2,976,16554,3578729909,3578729909,0
2,976,16555,3578729909,3578729909,0
2,976,16556,3578729909,3578729909,0
2,976,16557,3578729909,3578729911,2
2,976,16558,3578729909,3578729912,3
2,976,16559,3578729909,3578729912,3
2,976,16560,3578729909,3578729913,4
2,976,16561,3578729909,3578729916,7
2,976,16562,3578729909,3578729917,8
2,976,16563,3578729909,3578729917,8
2,976,16564,3578729909,3578729918,9
2,976,16565,3578729909,3578729918,9
2,976,16566,3578729909,3578729920,11
2,976,16567,3578729909,3578729921,12
2,976,16568,3578729909,3578729921,12
2,976,16569,3578729909,3578729921,12
2,976,16570,3578729909,3578729921,12
2,976,16571,3578729909,3578729922,13
2,976,16572,3578729909,3578729923,14
2,976,16573,3578729909,3578729924,15
2,976,16574,3578729909,3578729924,15
2,976,16575,3578729909,3578729925,16
2,976,16576,3578729909,3578729927,18
2,976,16577,3578729909,3578729933,24
2,976,16578,3578729909,3578729934,25
2,976,16579,3578729909,3578729935,26
2,976,16580,3578729909,3578729936,27
2,976,16581,3578729909,3578729936,27
2,976,16582,3578729909,3578729936,27
2,976,16583,3578729909,3578729937,28
2,976,16584,3578729909,3578729938,29
2,976,16585,3578729909,3578729939,30
2,976,16586,3578729909,3578729940,31
2,976,16587,3578729909,3578729940,31
2,976,16588,3578729909,3578729941,32
2,976,16589,3578729909,3578729942,33
2,976,16590,3578729909,3578729942,33
2,976,16591,3578729909,3578729945,36
2,976,16592,3578729909,3578729950,41
2,976,16593,3578729909,3578729951,42
2,976,16594,3578729909,3578729953,44
2,976,16595,3578729909,3578729955,46
2,976,16596,3578729909,3578729956,47
2,976,16597,3578729909,3578729958,49
2,977,16598,3578729968,3578729968,0
2,977,16599,3578729968,3578729968,0
2,977,16600,3578729968,3578729968,0
2,977,16601,3578729968,3578729968,0
2,977,16602,3578729968,3578729969,1
2,977,16603,3578729968,3578729969,1
2,977,16604,3578729968,3578729971,3
2,977,16605,3578729968,3578729973,5
2,977,16606,3578729968,3578729974,6
2,977,16607,3578729968,3578729976,8
2,977,16608,3578729968,3578729977,9
2,977,16609,3578729968,3578729978,10
2,977,16610,3578729968,3578729980,12
2,977,16611,3578729968,3578729980,12
2,977,16612,3578729968,3578729984,16
2,977,16613,3578729968,3578729984,16
2,977,16614,3578729968,3578729989,21
2,977,16615,3578729968,3578729990,22
2,977,16616,3578729968,3578729992,24
2,977,16617,3578729968,3578729993,25
2,977,16618,3578729968,3578729994,26
2,977,16619,3578729968,3578729995,27
2,977,16620,3578729968,3578729997,29
2,977,16621,3578729968,3578730000,32
2,977,16622,3578729968,3578730002,34
2,977,16623,3578729968,3578730008,40
2,977,16624,3578729968,3578730008,40
2,977,16625,3578729968,3578730011,43
2,977,16626,3578729968,3578730013,45
2,977,16627,3578729968,3578730014,46
2,977,16628,3578729968,3578730015,47
2,977,16629,3578729968,3578730016,48
2,977,16630,3578729968,3578730017,49
2,977,16631,3578729968,3578730017,49
2,978,16632,3578730024,3578730024,0
2,978,16633,3578730024,3578730024,0
2,978,16634,3578730024,3578730025,1
2,978,16635,3578730024,3578730025,1
2,978,16636,3578730024,3578730026,2
2,978,16637,3578730024,3578730026,2
2,978,16638,3578730024,3578730026,2
2,978,16639,3578730024,3578730027,3
2,978,16640,3578730024,3578730027,3
2,978,16641,3578730024,3578730028,4
2,978,16642,3578730024,3578730029,5
2,978,16643,3578730024,3578730031,7
2,978,16644,3578730024,3578730031,7
2,978,16645,3578730024,3578730031,7
2,978,16646,3578730024,3578730032,8
2,978,16647,3578730024,3578730032,8
2,978,16648,3578730024,3578730033,9
2,978,16649,3578730024,3578730035,11
2,978,16650,3578730024,3578730038,14
2,978,16651,3578730024,3578730040,16
2,978,16652,3578730024,3578730040,16
2,978,16653,3578730024,3578730041,17
2,978,16654,3578730024,3578730042,18
2,978,16655,3578730024,3578730042,18
2,978,16656,3578730024,3578730042,18
2,978,16657,3578730024,3578730042,18
2,978,16658,3578730024,3578730044,20
2,978,16659,3578730024,3578730046,22
2,978,16660,3578730024,3578730047,23
2,978,16661,3578730024,3578730047,23
2,978,16662,3578730024,3578730050,26
2,978,16663,3578730024,3578730050,26
2,978,16664,3578730024,3578730050,26
2,978,16665,3578730024,3578730051,27
2,978,16666,3578730024,3578730051,27
2,978,16667,3578730024,3578730052,28
2,978,16668,3578730024,3578730053,29
2,978,16669,3578730024,3578730054,30
2,978,16670,3578730024,3578730057,33
2,978,16671,3578730024,3578730058,34
2,978,16672,3578730024,3578730061,37
2,978,16673,3578730024,3578730061,37
2,978,16674,3578730024,3578730063,39
2,978,16675,3578730024,3578730064,40
2,978,16676,3578730024,3578730064,40
2,978,16677,3578730024,3578730067,43
2,978,16678,3578730024,3578730068,44
2,978,16679,3578730024,3578730068,44
2,978,16680,3578730024,3578730069,45
2,978,16681,3578730024,3578730070,46
2,979,16682,3578730081,3578730081,0
2,979,16683,3578730081,3578730081,0
2,979,16684,3578730081,3578730081,0
2,979,16685,3578730081,3578730084,3
2,979,16686,3578730081,3578730085,4
2,979,16687,3578730081,3578730086,5
2,979,16688,3578730081,3578730086,5
2,979,16689,3578730081,3578730086,5
2,979,16690,3578730081,3578730086,5
2,979,16691,3578730081,3578730086,5
2,979,16692,3578730081,3578730088,7
2,979,16693,3578730081,3578730089,8
2,979,16694,3578730081,3578730091,10
2,979,16695,3578730081,3578730091,10
2,979,16696,3578730081,3578730092,11
2,979,16697,3578730081,3578730093,12
2,979,16698,3578730081,3578730094,13
2,979,16699,3578730081,3578730095,14
2,979,16700,3578730081,3578730095,14
2,979,16701,3578730081,3578730096,15
2,979,16702,3578730081,3578730096,15
2,979,16703,3578730081,3578730097,16
2,979,16704,3578730081,3578730098,17
2,979,16705,3578730081,3578730098,17
2,979,16706,3578730081,3578730100,19
2,979,16707,3578730081,3578730100,19
2,979,16708,3578730081,3578730101,20
2,979,16709,3578730081,3578730101,20
2,979,16710,3578730081,3578730104,23
2,979,16711,3578730081,3578730105,24
2,979,16712,3578730081,3578730107,26
2,979,16713,3578730081,3578730107,26
2,979,16714,3578730081,3578730107,26
2,979,16715,3578730081,3578730108,27
2,979,16716,3578730081,3578730109,28
2,979,16717,3578730081,3578730110,29
2,979,16718,3578730081,3578730112,31
2,979,16719,3578730081,3578730112,31
2,979,16720,3578730081,3578730112,31
2,979,16721,3578730081,3578730112,31
2,979,16722,3578730081,3578730113,32
2,979,16723,3578730081,3578730115,34
2,979,16724,3578730081,3578730117,36
2,979,16725,3578730081,3578730118,37
2,979,16726,3578730081,3578730118,37
2,979,16727,3578730081,3578730119,38
2,979,16728,3578730081,3578730120,39
2,979,16729,3578730081,3578730121,40
2,979,16730,3578730081,3578730121,40
2,979,16731,3578730081,3578730122,41
2,979,16732,3578730081,3578730122,41
2,979,16733,3578730081,3578730122,41
2,979,16734,3578730081,3578730123,42
2,979,16735,3578730081,3578730124,43
2,979,16736,3578730081,3578730124,43
2,979,16737,3578730081,3578730125,44
2,979,16738,3578730081,3578730127,46
2,980,16739,3578730139,3578730139,0
2,980,16740,3578730139,3578730139,0
2,980,16741,3578730139,3578730139,0
2,980,16742,3578730139,3578730139,0
2,980,16743,3578730139,3578730139,0
2,980,16744,3578730139,3578730139,0
2,980,16745,3578730139,3578730139,0
2,980,16746,3578730139,3578730139,0
2,980,16747,3578730139,3578730139,0
2,980,16748,3578730139,3578730139,0
2,980,16749,3578730139,3578730139,0
2,980,16750,3578730139,3578730140,1
2,980,16751,3578730139,3578730141,2
2,980,16752,3578730139,3578730143,4
2,980,16753,3578730139,3578730146,7
2,980,16754,3578730139,3578730150,11
2,980,16755,3578730139,3578730151,12
2,980,16756,3578730139,3578730153,14
2,980,16757,3578730139,3578730154,15
2,980,16758,3578730139,3578730156,17
2,980,16759,3578730139,3578730156,17
2,980,16760,3578730139,3578730156,17
2,980,16761,3578730139,3578730159,20
2,980,16762,3578730139,3578730160,21
2,980,16763,3578730139,3578730163,24
2,980,16764,3578730139,3578730164,25
2,980,16765,3578730139,3578730165,26
2,980,16766,3578730139,3578730166,27
2,980,16767,3578730139,3578730168,29
2,980,16768,3578730139,3578730169,30
2,980,16769,3578730139,3578730171,32
2,980,16770,3578730139,3578730173,34
2,980,16771,3578730139,3578730175,36
2,980,16772,3578730139,3578730175,36
2,980,16773,3578730139,3578730176,37
2,980,16774,3578730139,3578730178,39
2,980,16775,3578730139,3578730179,40
2,980,16776,3578730139,3578730179,40
2,980,16777,3578730139,3578730181,42
2,980,16778,3578730139,3578730183,44
2,980,16779,3578730139,3578730183,44
2,980,16780,3578730139,3578730184,45
2,980,16781,3578730139,3578730185,46
2,980,16782,3578730139,3578730188,49
2,980,16783,3578730139,3578730189,50
2,981,16784,3578730196,3578730196,0
2,981,16785,3578730196,3578730197,1
2,981,16786,3578730196,3578730197,1
2,981,16787,3578730196,3578730197,1
2,981,16788,3578730196,3578730197,1
2,981,16789,3578730196,3578730197,1
2,981,16790,3578730196,3578730198,2
2,981,16791,3578730196,3578730200,4
2,981,16792,3578730196,3578730204,8
2,981,16793,3578730196,3578730204,8
2,981,16794,3578730196,3578730206,10
2,981,16795,3578730196,3578730208,12
2,981,16796,3578730196,3578730209,13
2,981,16797,3578730196,3578730212,16
2,981,16798,3578730196,3578730213,17
2,981,16799,3578730196,3578730214,18
2,981,16800,3578730196,3578730215,19
2,981,16801,3578730196,3578730217,21
2,981,16802,3578730196,3578730217,21
2,981,16803,3578730196,3578730223,27
2,981,16804,3578730196,3578730224,28
2,981,16805,3578730196,3578730225,29
2,981,16806,3578730196,3578730225,29
2,981,16807,3578730196,3578730226,30
2,981,16808,3578730196,3578730227,31
2,981,16809,3578730196,3578730227,31
2,981,16810,3578730196,3578730227,31
2,981,16811,3578730196,3578730228,32
2,981,16812,3578730196,3578730231,35
2,981,16813,3578730196,3578730231,35
2,981,16814,3578730196,3578730231,35
2,981,16815,3578730196,3578730232,36
2,981,16816,3578730196,3578730232,36
2,981,16817,3578730196,3578730235,39
2,981,16818,3578730196,3578730239,43
2,981,16819,3578730196,3578730240,44
2,981,16820,3578730196,3578730241,45
2,981,16821,3578730196,3578730242,46
2,981,16822,3578730196,3578730242,46
2,981,16823,3578730196,3578730242,46
2,981,16824,3578730196,3578730242,46
2,981,16825,3578730196,3578730244,48
2,981,16826,3578730196,3578730246,50
2,982,16827,3578730254,3578730254,0
2,982,16828,3578730254,3578730254,0
2,982,16829,3578730254,3578730254,0
2,982,16830,3578730254,3578730254,0
2,982,16831,3578730254,3578730254,0
2,982,16832,3578730254,3578730254,0
2,982,16833,3578730254,3578730254,0
2,982,16834,3578730254,3578730254,0
2,982,16835,3578730254,3578730254,0
2,982,16836,3578730254,3578730255,1
2,982,16837,3578730254,3578730257,3
2,982,16838,3578730254,3578730258,4
2,982,16839,3578730254,3578730261,7
2,982,16840,3578730254,3578730261,7
2,982,16841,3578730254,3578730263,9
2,982,16842,3578730254,3578730264,10
2,982,16843,3578730254,3578730265,11
2,982,16844,3578730254,3578730266,12
2,982,16845,3578730254,3578730268,14
2,982,16846,3578730254,3578730269,15
2,982,16847,3578730254,3578730269,15
2,982,16848,3578730254,3578730270,16
2,982,16849,3578730254,3578730281,27
2,982,16850,3578730254,3578730284,30
2,982,16851,3578730254,3578730285,31
2,982,16852,3578730254,3578730285,31
2,982,16853,3578730254,3578730285,31
2,982,16854,3578730254,3578730286,32
2,982,16855,3578730254,3578730286,32
2,982,16856,3578730254,3578730287,33
2,982,16857,3578730254,3578730288,34
2,982,16858,3578730254,3578730290,36
2,982,16859,3578730254,3578730290,36
2,982,16860,3578730254,3578730291,37
2,982,16861,3578730254,3578730292,38
2,982,16862,3578730254,3578730292,38
2,982,16863,3578730254,3578730293,39
2,982,16864,3578730254,3578730294,40
2,982,16865,3578730254,3578730295,41
2,982,16866,3578730254,3578730295,41
2,982,16867,3578730254,3578730295,41
2,982,16868,3578730254,3578730296,42
2,982,16869,3578730254,3578730296,42
2,982,16870,3578730254,3578730298,44
2,982,16871,3578730254,3578730299,45
2,982,16872,3578730254,3578730300,46
2,982,16873,3578730254,3578730301,47
2,982,16874,3578730254,3578730302,48
2,982,16875,3578730254,3578730304,50
2,983,16876,3578730314,3578730314,0
2,983,16877,3578730314,3578730314,0
2,983,16878,3578730314,3578730314,0
2,983,16879,3578730314,3578730314,0
2,983,16880,3578730314,3578730314,0
2,983,16881,3578730314,3578730314,0
2,983,16882,3578730314,3578730314,0
2,983,16883,3578730314,3578730314,0
2,983,16884,3578730314,3578730314,0
2,983,16885,3578730314,3578730314,0
2,983,16886,3578730314,3578730314,0
2,983,16887,3578730314,3578730314,0
2,983,16888,3578730314,3578730314,0
2,983,16889,3578730314,3578730315,1
2,983,16890,3578730314,3578730318,4
2,983,16891,3578730314,3578730318,4
2,983,16892,3578730314,3578730318,4
2,983,16893,3578730314,3578730319,5
2,983,16894,3578730314,3578730320,6
2,983,16895,3578730314,3578730321,7
2,983,16896,3578730314,3578730321,7
2,983,16897,3578730314,3578730322,8
2,983,16898,3578730314,3578730322,8
2,983,16899,3578730314,3578730323,9
2,983,16900,3578730314,3578730324,10
2,983,16901,3578730314,3578730324,10
2,983,16902,3578730314,3578730325,11
2,983,16903,3578730314,3578730325,11
2,983,16904,3578730314,3578730327,13
2,983,16905,3578730314,3578730333,19
2,983,16906,3578730314,3578730334,20
2,983,16907,3578730314,3578730335,21
2,983,16908,3578730314,3578730336,22
2,983,16909,3578730314,3578730337,23
2,983,16910,3578730314,3578730338,24
2,983,16911,3578730314,3578730338,24
2,983,16912,3578730314,3578730338,24
2,983,16913,3578730314,3578730340,26
2,983,16914,3578730314,3578730340,26
2,983,16915,3578730314,3578730341,27
2,983,16916,3578730314,3578730341,27
2,983,16917,3578730314,3578730342,28
2,983,16918,3578730314,3578730343,29
2,983,16919,3578730314,3578730345,31
2,983,16920,3578730314,3578730351,37
2,983,16921,3578730314,3578730351,37
2,983,16922,3578730314,3578730354,40
2,983,16923,3578730314,3578730354,40
2,983,16924,3578730314,3578730355,41
2,983,16925,3578730314,3578730356,42
2,983,16926,3578730314,3578730357,43
2,983,16927,3578730314,3578730359,45
2,983,16928,3578730314,3578730360,46
2,984,16929,3578730372,3578730372,0
2,984,16930,3578730372,3578730372,0
2,984,16931,3578730372,3578730372,0
2,984,16932,3578730372,3578730372,0
2,984,16933,3578730372,3578730372,0
2,984,16934,3578730372,3578730372,0
2,984,16935,3578730372,3578730372,0
2,984,16936,3578730372,3578730372,0
2,984,16937,3578730372,3578730372,0
2,984,16938,3578730372,3578730372,0
2,984,16939,3578730372,3578730373,1
2,984,16940,3578730372,3578730375,3
2,984,16941,3578730372,3578730376,4
2,984,16942,3578730372,3578730377,5
2,984,16943,3578730372,3578730378,6
2,984,16944,3578730372,3578730379,7
2,984,16945,3578730372,3578730380,8
2,984,16946,3578730372,3578730381,9
2,984,16947,3578730372,3578730383,11
2,984,16948,3578730372,3578730384,12
2,984,16949,3578730372,3578730384,12
2,984,16950,3578730372,3578730389,17
2,984,16951,3578730372,3578730390,18
2,984,16952,3578730372,3578730392,20
2,984,16953,3578730372,3578730394,22
2,984,16954,3578730372,3578730394,22
2,984,16955,3578730372,3578730394,22
2,984,16956,3578730372,3578730396,24
2,984,16957,3578730372,3578730397,25
2,984,16958,3578730372,3578730400,28
2,984,16959,3578730372,3578730403,31
2,984,16960,3578730372,3578730404,32
2,984,16961,3578730372,3578730409,37
2,984,16962,3578730372,3578730409,37
2,984,16963,3578730372,3578730413,41
2,984,16964,3578730372,3578730413,41
2,984,16965,3578730372,3578730414,42
2,984,16966,3578730372,3578730416,44
2,984,16967,3578730372,3578730417,45
2,984,16968,3578730372,3578730417,45
2,984,16969,3578730372,3578730418,46
2,985,16970,3578730431,3578730431,0
2,985,16971,3578730431,3578730431,0
2,985,16972,3578730431,3578730431,0
2,985,16973,3578730431,3578730431,0
2,985,16974,3578730431,3578730431,0
2,985,16975,3578730431,3578730431,0
2,985,16976,3578730431,3578730431,0
2,985,16977,3578730431,3578730431,0
2,985,16978,3578730431,3578730431,0
2,985,16979,3578730431,3578730431,0
2,985,16980,3578730431,3578730431,0
2,985,16981,3578730431,3578730431,0
2,985,16982,3578730431,3578730431,0
2,985,16983,3578730431,3578730432,1
2,985,16984,3578730431,3578730433,2
2,985,16985,3578730431,3578730434,3
2,985,16986,3578730431,3578730435,4
2,985,16987,3578730431,3578730440,9
2,985,16988,3578730431,3578730441,10
2,985,16989,3578730431,3578730441,10
2,985,16990,3578730431,3578730441,10
2,985,16991,3578730431,3578730442,11
2,985,16992,3578730431,3578730442,11
2,985,16993,3578730431,3578730442,11
2,985,16994,3578730431,3578730444,13
2,985,16995,3578730431,3578730446,15
2,985,16996,3578730431,3578730446,15
2,985,16997,3578730431,3578730447,16
2,985,16998,3578730431,3578730449,18
2,985,16999,3578730431,3578730450,19
2,985,17000,3578730431,3578730451,20
2,985,17001,3578730431,3578730451,20
2,985,17002,3578730431,3578730453,22
2,985,17003,3578730431,3578730455,24
2,985,17004,3578730431,3578730458,27
2,985,17005,3578730431,3578730460,29
2,985,17006,3578730431,3578730460,29
2,985,17007,3578730431,3578730462,31
2,985,17008,3578730431,3578730463,32
2,985,17009,3578730431,3578730466,35
2,985,17010,3578730431,3578730466,35
2,985,17011,3578730431,3578730466,35
2,985,17012,3578730431,3578730468,37
2,985,17013,3578730431,3578730468,37
2,985,17014,3578730431,3578730469,38
2,985,17015,3578730431,3578730470,39
2,985,17016,3578730431,3578730471,40
2,985,17017,3578730431,3578730477,46
2,986,17018,3578730489,3578730489,0
2,986,17019,3578730489,3578730489,0
2,986,17020,3578730489,3578730489,0
2,986,17021,3578730489,3578730489,0
2,986,17022,3578730489,3578730489,0
2,986,17023,3578730489,3578730489,0
2,986,17024,3578730489,3578730489,0
2,986,17025,3578730489,3578730489,0
2,986,17026,3578730489,3578730489,0
2,986,17027,3578730489,3578730489,0
2,986,17028,3578730489,3578730489,0
2,986,17029,3578730489,3578730489,0
2,986,17030,3578730489,3578730491,2
2,986,17031,3578730489,3578730491,2
2,986,17032,3578730489,3578730492,3
2,986,17033,3578730489,3578730493,4
2,986,17034,3578730489,3578730494,5
2,986,17035,3578730489,3578730494,5
2,986,17036,3578730489,3578730494,5
2,986,17037,3578730489,3578730494,5
2,986,17038,3578730489,3578730496,7
2,986,17039,3578730489,3578730497,8
2,986,17040,3578730489,3578730499,10
2,986,17041,3578730489,3578730500,11
2,986,17042,3578730489,3578730500,11
2,986,17043,3578730489,3578730503,14
2,986,17044,3578730489,3578730505,16
2,986,17045,3578730489,3578730506,17
2,986,17046,3578730489,3578730506,17
2,986,17047,3578730489,3578730507,18
2,986,17048,3578730489,3578730507,18
2,986,17049,3578730489,3578730507,18
2,986,17050,3578730489,3578730510,21
2,986,17051,3578730489,3578730510,21
2,986,17052,3578730489,3578730511,22
2,986,17053,3578730489,3578730511,22
2,986,17054,3578730489,3578730512,23
2,986,17055,3578730489,3578730513,24
2,986,17056,3578730489,3578730514,25
2,986,17057,3578730489,3578730517,28
2,986,17058,3578730489,3578730517,28
2,986,17059,3578730489,3578730517,28
2,986,17060,3578730489,3578730518,29
2,986,17061,3578730489,3578730519,30
2,986,17062,3578730489,3578730520,31
2,986,17063,3578730489,3578730520,31
2,986,17064,3578730489,3578730521,32
2,986,17065,3578730489,3578730522,33
2,986,17066,3578730489,3578730523,34
2,986,17067,3578730489,3578730524,35
2,986,17068,3578730489,3578730524,35
2,986,17069,3578730489,3578730524,35
2,986,17070,3578730489,3578730525,36
2,986,17071,3578730489,3578730526,37
2,986,17072,3578730489,3578730532,43
2,986,17073,3578730489,3578730534,45
2,986,17074,3578730489,3578730535,46
2,986,17075,3578730489,3578730535,46
2,986,17076,3578730489,3578730536,47
2,986,17077,3578730489,3578730536,47
2,986,17078,3578730489,3578730537,48
2,986,17079,3578730489,3578730538,49
2,986,17080,3578730489,3578730538,49
2,986,17081,3578730489,3578730539,50
2,987,17082,3578730546,3578730546,0
2,987,17083,3578730546,3578730546,0
2,987,17084,3578730546,3578730546,0
2,987,17085,3578730546,3578730546,0
2,987,17086,3578730546,3578730550,4
2,987,17087,3578730546,3578730551,5
2,987,17088,3578730546,3578730553,7
2,987,17089,3578730546,3578730554,8
2,987,17090,3578730546,3578730555,9
2,987,17091,3578730546,3578730555,9
2,987,17092,3578730546,3578730558,12
2,987,17093,3578730546,3578730559,13
2,987,17094,3578730546,3578730563,17
2,987,17095,3578730546,3578730564,18
2,987,17096,3578730546,3578730564,18
2,987,17097,3578730546,3578730564,18
2,987,17098,3578730546,3578730565,19
2,987,17099,3578730546,3578730568,22
2,987,17100,3578730546,3578730568,22
2,987,17101,3578730546,3578730568,22
2,987,17102,3578730546,3578730571,25
2,987,17103,3578730546,3578730573,27
2,987,17104,3578730546,3578730574,28
2,987,17105,3578730546,3578730574,28
2,987,17106,3578730546,3578730575,29
2,987,17107,3578730546,3578730577,31
2,987,17108,3578730546,3578730578,32
2,987,17109,3578730546,3578730578,32
2,987,17110,3578730546,3578730580,34
2,987,17111,3578730546,3578730583,37
2,987,17112,3578730546,3578730583,37
2,987,17113,3578730546,3578730584,38
2,987,17114,3578730546,3578730588,42
2,987,17115,3578730546,3578730588,42
2,987,17116,3578730546,3578730591,45
2,987,17117,3578730546,3578730592,46
2,987,17118,3578730546,3578730593,47
2,987,17119,3578730546,3578730593,47
2,987,17120,3578730546,3578730594,48
2,987,17121,3578730546,3578730596,50
2,988,17122,3578730605,3578730605,0
2,988,17123,3578730605,3578730605,0
2,988,17124,3578730605,3578730605,0
2,988,17125,3578730605,3578730605,0
2,988,17126,3578730605,3578730605,0
2,988,17127,3578730605,3578730608,3
2,988,17128,3578730605,3578730608,3
2,988,17129,3578730605,3578730612,7
2,988,17130,3578730605,3578730612,7
2,988,17131,3578730605,3578730614,9
2,988,17132,3578730605,3578730615,10
2,988,17133,3578730605,3578730617,12
2,988,17134,3578730605,3578730617,12
2,988,17135,3578730605,3578730621,16
2,988,17136,3578730605,3578730624,19
2,988,17137,3578730605,3578730624,19
2,988,17138,3578730605,3578730625,20
2,988,17139,3578730605,3578730626,21
2,988,17140,3578730605,3578730626,21
2,988,17141,3578730605,3578730626,21
2,988,17142,3578730605,3578730628,23
2,988,17143,3578730605,3578730630,25
2,988,17144,3578730605,3578730630,25
2,988,17145,3578730605,3578730631,26
2,988,17146,3578730605,3578730631,26
2,988,17147,3578730605,3578730631,26
2,988,17148,3578730605,3578730634,29
2,988,17149,3578730605,3578730634,29
2,988,17150,3578730605,3578730638,33
2,988,17151,3578730605,3578730639,34
2,988,17152,3578730605,3578730639,34
2,988,17153,3578730605,3578730640,35
2,988,17154,3578730605,3578730641,36
2,988,17155,3578730605,3578730641,36
2,988,17156,3578730605,3578730641,36
2,988,17157,3578730605,3578730641,36
2,988,17158,3578730605,3578730644,39
2,988,17159,3578730605,3578730646,41
2,988,17160,3578730605,3578730646,41
2,988,17161,3578730605,3578730648,43
2,988,17162,3578730605,3578730650,45
2,988,17163,3578730605,3578730650,45
2,988,17164,3578730605,3578730651,46
2,988,17165,3578730605,3578730651,46
2,988,17166,3578730605,3578730652,47
2,988,17167,3578730605,3578730652,47
2,988,17168,3578730605,3578730654,49
2,989,17169,3578730664,3578730665,1
2,989,17170,3578730664,3578730665,1
2,989,17171,3578730664,3578730665,1
2,989,17172,3578730664,3578730665,1
2,989,17173,3578730664,3578730665,1
2,989,17174,3578730664,3578730665,1
2,989,17175,3578730664,3578730665,1
2,989,17176,3578730664,3578730666,2
2,989,17177,3578730664,3578730668,4
2,989,17178,3578730664,3578730669,5
2,989,17179,3578730664,3578730676,12
2,989,17180,3578730664,3578730681,17
2,989,17181,3578730664,3578730683,19
2,989,17182,3578730664,3578730684,20
2,989,17183,3578730664,3578730684,20
2,989,17184,3578730664,3578730684,20
2,989,17185,3578730664,3578730685,21
2,989,17186,3578730664,3578730685,21
2,989,17187,3578730664,3578730686,22
2,989,17188,3578730664,3578730687,23
2,989,17189,3578730664,3578730689,25
2,989,17190,3578730664,3578730690,26
2,989,17191,3578730664,3578730691,27
2,989,17192,3578730664,3578730692,28
2,989,17193,3578730664,3578730693,29
2,989,17194,3578730664,3578730693,29
2,989,17195,3578730664,3578730693,29
2,989,17196,3578730664,3578730694,30
2,989,17197,3578730664,3578730695,31
2,989,17198,3578730664,3578730695,31
2,989,17199,3578730664,3578730696,32
2,989,17200,3578730664,3578730697,33
2,989,17201,3578730664,3578730700,36
2,989,17202,3578730664,3578730700,36
2,989,17203,3578730664,3578730700,36
2,989,17204,3578730664,3578730701,37
2,989,17205,3578730664,3578730704,40
2,989,17206,3578730664,3578730706,42
2,989,17207,3578730664,3578730706,42
2,989,17208,3578730664,3578730707,43
2,989,17209,3578730664,3578730707,43
2,989,17210,3578730664,3578730707,43
2,989,17211,3578730664,3578730708,44
2,989,17212,3578730664,3578730709,45
2,989,17213,3578730664,3578730711,47
2,989,17214,3578730664,3578730711,47
2,989,17215,3578730664,3578730711,47
2,989,17216,3578730664,3578730712,48
2,989,17217,3578730664,3578730712,48
2,989,17218,3578730664,3578730714,50
2,990,17219,3578730723,3578730723,0
2,990,17220,3578730723,3578730723,0
2,990,17221,3578730723,3578730723,0
2,990,17222,3578730723,3578730723,0
2,990,17223,3578730723,3578730723,0
2,990,17224,3578730723,3578730723,0
2,990,17225,3578730723,3578730723,0
2,990,17226,3578730723,3578730723,0
2,990,17227,3578730723,3578730723,0
2,990,17228,3578730723,3578730723,0
2,990,17229,3578730723,3578730724,1
2,990,17230,3578730723,3578730724,1
2,990,17231,3578730723,3578730725,2
2,990,17232,3578730723,3578730726,3
2,990,17233,3578730723,3578730727,4
2,990,17234,3578730723,3578730732,9
2,990,17235,3578730723,3578730733,10
2,990,17236,3578730723,3578730735,12
2,990,17237,3578730723,3578730735,12
2,990,17238,3578730723,3578730735,12
2,990,17239,3578730723,3578730735,12
2,990,17240,3578730723,3578730736,13
2,990,17241,3578730723,3578730736,13
2,990,17242,3578730723,3578730737,14
2,990,17243,3578730723,3578730739,16
2,990,17244,3578730723,3578730739,16
2,990,17245,3578730723,3578730739,16
2,990,17246,3578730723,3578730742,19
2,990,17247,3578730723,3578730742,19
2,990,17248,3578730723,3578730743,20
2,990,17249,3578730723,3578730743,20
2,990,17250,3578730723,3578730745,22
2,990,17251,3578730723,3578730750,27
2,990,17252,3578730723,3578730751,28
2,990,17253,3578730723,3578730753,30
2,990,17254,3578730723,3578730754,31
2,990,17255,3578730723,3578730754,31
2,990,17256,3578730723,3578730755,32
2,990,17257,3578730723,3578730755,32
2,990,17258,3578730723,3578730759,36
2,990,17259,3578730723,3578730759,36
2,990,17260,3578730723,3578730763,40
2,990,17261,3578730723,3578730763,40
2,990,17262,3578730723,3578730764,41
2,990,17263,3578730723,3578730764,41
2,990,17264,3578730723,3578730765,42
2,990,17265,3578730723,3578730768,45
2,990,17266,3578730723,3578730768,45
2,990,17267,3578730723,3578730772,49
2,991,17268,3578730781,3578730781,0
2,991,17269,3578730781,3578730781,0
2,991,17270,3578730781,3578730781,0
2,991,17271,3578730781,3578730781,0
2,991,17272,3578730781,3578730781,0
2,991,17273,3578730781,3578730781,0
2,991,17274,3578730781,3578730783,2
2,991,17275,3578730781,3578730783,2
2,991,17276,3578730781,3578730785,4
2,991,17277,3578730781,3578730785,4
2,991,17278,3578730781,3578730788,7
2,991,17279,3578730781,3578730788,7
2,991,17280,3578730781,3578730790,9
2,991,17281,3578730781,3578730793,12
2,991,17282,3578730781,3578730793,12
2,991,17283,3578730781,3578730793,12
2,991,17284,3578730781,3578730795,14
2,991,17285,3578730781,3578730797,16
2,991,17286,3578730781,3578730798,17
2,991,17287,3578730781,3578730799,18
2,991,17288,3578730781,3578730802,21
2,991,17289,3578730781,3578730803,22
2,991,17290,3578730781,3578730807,26
2,991,17291,3578730781,3578730808,27
2,991,17292,3578730781,3578730812,31
2,991,17293,3578730781,3578730814,33
2,991,17294,3578730781,3578730815,34
2,991,17295,3578730781,3578730815,34
2,991,17296,3578730781,3578730818,37
2,991,17297,3578730781,3578730818,37
2,991,17298,3578730781,3578730821,40
2,991,17299,3578730781,3578730824,43
2,991,17300,3578730781,3578730825,44
2,991,17301,3578730781,3578730826,45
2,991,17302,3578730781,3578730826,45
2,991,17303,3578730781,3578730826,45
2,991,17304,3578730781,3578730826,45
2,991,17305,3578730781,3578730826,45
2,991,17306,3578730781,3578730828,47
2,991,17307,3578730781,3578730828,47
2,991,17308,3578730781,3578730830,49
2,992,17309,3578730839,3578730839,0
2,992,17310,3578730839,3578730839,0
2,992,17311,3578730839,3578730839,0
2,992,17312,3578730839,3578730839,0
2,992,17313,3578730839,3578730839,0
2,992,17314,3578730839,3578730839,0
2,992,17315,3578730839,3578730839,0
2,992,17316,3578730839,3578730839,0
2,992,17317,3578730839,3578730840,1
2,992,17318,3578730839,3578730840,1
2,992,17319,3578730839,3578730841,2
2,992,17320,3578730839,3578730841,2
2,992,17321,3578730839,3578730841,2
2,992,17322,3578730839,3578730842,3
2,992,17323,3578730839,3578730845,6
2,992,17324,3578730839,3578730846,7
2,992,17325,3578730839,3578730846,7
2,992,17326,3578730839,3578730847,8
2,992,17327,3578730839,3578730849,10
2,992,17328,3578730839,3578730851,12
2,992,17329,3578730839,3578730851,12
2,992,17330,3578730839,3578730851,12
2,992,17331,3578730839,3578730851,12
2,992,17332,3578730839,3578730852,13
2,992,17333,3578730839,3578730853,14
2,992,17334,3578730839,3578730853,14
2,992,17335,3578730839,3578730854,15
2,992,17336,3578730839,3578730858,19
2,992,17337,3578730839,3578730860,21
2,992,17338,3578730839,3578730861,22
2,992,17339,3578730839,3578730864,25
2,992,17340,3578730839,3578730865,26
2,992,17341,3578730839,3578730866,27
2,992,17342,3578730839,3578730866,27
2,992,17343,3578730839,3578730868,29
2,992,17344,3578730839,3578730869,30
2,992,17345,3578730839,3578730876,37
2,992,17346,3578730839,3578730881,42
2,992,17347,3578730839,3578730882,43
2,992,17348,3578730839,3578730883,44
2,992,17349,3578730839,3578730884,45
2,992,17350,3578730839,3578730884,45
2,992,17351,3578730839,3578730884,45
2,992,17352,3578730839,3578730885,46
2,992,17353,3578730839,3578730885,46
2,992,17354,3578730839,3578730886,47
2,992,17355,3578730839,3578730887,48
2,993,17356,3578730896,3578730896,0
2,993,17357,3578730896,3578730897,1
2,993,17358,3578730896,3578730897,1
2,993,17359,3578730896,3578730897,1
2,993,17360,3578730896,3578730897,1
2,993,17361,3578730896,3578730897,1
2,993,17362,3578730896,3578730897,1
2,993,17363,3578730896,3578730897,1
2,993,17364,3578730896,3578730897,1
2,993,17365,3578730896,3578730897,1
2,993,17366,3578730896,3578730897,1
2,993,17367,3578730896,3578730898,2
2,993,17368,3578730896,3578730898,2
2,993,17369,3578730896,3578730900,4
2,993,17370,3578730896,3578730900,4
2,993,17371,3578730896,3578730901,5
2,993,17372,3578730896,3578730904,8
2,993,17373,3578730896,3578730907,11
2,993,17374,3578730896,3578730907,11
2,993,17375,3578730896,3578730907,11
2,993,17376,3578730896,3578730907,11
2,993,17377,3578730896,3578730908,12
2,993,17378,3578730896,3578730909,13
2,993,17379,3578730896,3578730910,14
2,993,17380,3578730896,3578730911,15
2,993,17381,3578730896,3578730911,15
2,993,17382,3578730896,3578730912,16
2,993,17383,3578730896,3578730913,17
2,993,17384,3578730896,3578730913,17
2,993,17385,3578730896,3578730914,18
2,993,17386,3578730896,3578730917,21
2,993,17387,3578730896,3578730917,21
2,993,17388,3578730896,3578730917,21
2,993,17389,3578730896,3578730918,22
2,993,17390,3578730896,3578730919,23
2,993,17391,3578730896,3578730921,25
2,993,17392,3578730896,3578730921,25
2,993,17393,3578730896,3578730921,25
2,993,17394,3578730896,3578730922,26
2,993,17395,3578730896,3578730922,26
2,993,17396,3578730896,3578730923,27
2,993,17397,3578730896,3578730924,28
2,993,17398,3578730896,3578730925,29
2,993,17399,3578730896,3578730926,30
2,993,17400,3578730896,3578730926,30
2,993,17401,3578730896,3578730926,30
2,993,17402,3578730896,3578730933,37
2,993,17403,3578730896,3578730933,37
2,993,17404,3578730896,3578730934,38
2,993,17405,3578730896,3578730935,39
2,993,17406,3578730896,3578730935,39
2,993,17407,3578730896,3578730935,39
2,993,17408,3578730896,3578730936,40
2,993,17409,3578730896,3578730936,40
2,993,17410,3578730896,3578730936,40
2,993,17411,3578730896,3578730937,41
2,993,17412,3578730896,3578730939,43
2,993,17413,3578730896,3578730939,43
2,993,17414,3578730896,3578730939,43
2,993,17415,3578730896,3578730942,46
2,993,17416,3578730896,3578730943,47
2,993,17417,3578730896,3578730944,48
2,994,17418,3578730953,3578730953,0
2,994,17419,3578730953,3578730953,0
2,994,17420,3578730953,3578730953,0
2,994,17421,3578730953,3578730954,1
2,994,17422,3578730953,3578730955,2
2,994,17423,3578730953,3578730955,2
2,994,17424,3578730953,3578730955,2
2,994,17425,3578730953,3578730956,3
2,994,17426,3578730953,3578730959,6
2,994,17427,3578730953,3578730960,7
2,994,17428,3578730953,3578730963,10
2,994,17429,3578730953,3578730964,11
2,994,17430,3578730953,3578730965,12
2,994,17431,3578730953,3578730968,15
2,994,17432,3578730953,3578730968,15
2,994,17433,3578730953,3578730968,15
2,994,17434,3578730953,3578730972,19
2,994,17435,3578730953,3578730974,21
2,994,17436,3578730953,3578730974,21
2,994,17437,3578730953,3578730975,22
2,994,17438,3578730953,3578730976,23
2,994,17439,3578730953,3578730977,24
2,994,17440,3578730953,3578730978,25
2,994,17441,3578730953,3578730979,26
2,994,17442,3578730953,3578730980,27
2,994,17443,3578730953,3578730981,28
2,994,17444,3578730953,3578730983,30
2,994,17445,3578730953,3578730983,30
2,994,17446,3578730953,3578730985,32
2,994,17447,3578730953,3578730987,34
2,994,17448,3578730953,3578730988,35
2,994,17449,3578730953,3578730990,37
2,994,17450,3578730953,3578730993,40
2,994,17451,3578730953,3578730993,40
2,994,17452,3578730953,3578730994,41
2,994,17453,3578730953,3578730996,43
2,994,17454,3578730953,3578731000,47
2,994,17455,3578730953,3578731003,50
2,995,17456,3578731011,3578731011,0
2,995,17457,3578731011,3578731011,0
2,995,17458,3578731011,3578731011,0
2,995,17459,3578731011,3578731011,0
2,995,17460,3578731011,3578731012,1
2,995,17461,3578731011,3578731012,1
2,995,17462,3578731011,3578731014,3
2,995,17463,3578731011,3578731016,5
2,995,17464,3578731011,3578731017,6
2,995,17465,3578731011,3578731017,6
2,995,17466,3578731011,3578731025,14
2,995,17467,3578731011,3578731025,14
2,995,17468,3578731011,3578731026,15
2,995,17469,3578731011,3578731026,15
2,995,17470,3578731011,3578731026,15
2,995,17471,3578731011,3578731026,15
2,995,17472,3578731011,3578731027,16
2,995,17473,3578731011,3578731028,17
2,995,17474,3578731011,3578731028,17
2,995,17475,3578731011,3578731030,19
2,995,17476,3578731011,3578731030,19
2,995,17477,3578731011,3578731032,21
2,995,17478,3578731011,3578731034,23
2,995,17479,3578731011,3578731035,24
2,995,17480,3578731011,3578731035,24
2,995,17481,3578731011,3578731036,25
2,995,17482,3578731011,3578731038,27
2,995,17483,3578731011,3578731038,27
2,995,17484,3578731011,3578731039,28
2,995,17485,3578731011,3578731040,29
2,995,17486,3578731011,3578731040,29
2,995,17487,3578731011,3578731041,30
2,995,17488,3578731011,3578731041,30
2,995,17489,3578731011,3578731041,30
2,995,17490,3578731011,3578731042,31
2,995,17491,3578731011,3578731046,35
2,995,17492,3578731011,3578731046,35
2,995,17493,3578731011,3578731046,35
2,995,17494,3578731011,3578731047,36
2,995,17495,3578731011,3578731049,38
2,995,17496,3578731011,3578731051,40
2,995,17497,3578731011,3578731051,40
2,995,17498,3578731011,3578731051,40
2,995,17499,3578731011,3578731052,41
2,995,17500,3578731011,3578731053,42
2,995,17501,3578731011,3578731053,42
2,995,17502,3578731011,3578731055,44
2,995,17503,3578731011,3578731057,46
2,995,17504,3578731011,3578731059,48
2,995,17505,3578731011,3578731060,49
2,995,17506,3578731011,3578731061,50
2,996,17507,3578731069,3578731069,0
2,996,17508,3578731069,3578731069,0
2,996,17509,3578731069,3578731069,0
2,996,17510,3578731069,3578731069,0
2,996,17511,3578731069,3578731069,0
2,996,17512,3578731069,3578731070,1
2,996,17513,3578731069,3578731077,8
2,996,17514,3578731069,3578731082,13
2,996,17515,3578731069,3578731084,15
2,996,17516,3578731069,3578731084,15
2,996,17517,3578731069,3578731084,15
2,996,17518,3578731069,3578731085,16
2,996,17519,3578731069,3578731086,17
2,996,17520,3578731069,3578731087,18
2,996,17521,3578731069,3578731089,20
2,996,17522,3578731069,3578731089,20
2,996,17523,3578731069,3578731092,23
2,996,17524,3578731069,3578731093,24
2,996,17525,3578731069,3578731094,25
2,996,17526,3578731069,3578731094,25
2,996,17527,3578731069,3578731094,25
2,996,17528,3578731069,3578731095,26
2,996,17529,3578731069,3578731095,26
2,996,17530,3578731069,3578731095,26
2,996,17531,3578731069,3578731096,27
2,996,17532,3578731069,3578731096,27
2,996,17533,3578731069,3578731097,28
2,996,17534,3578731069,3578731099,30
2,996,17535,3578731069,3578731100,31
2,996,17536,3578731069,3578731100,31
2,996,17537,3578731069,3578731102,33
2,996,17538,3578731069,3578731104,35
2,996,17539,3578731069,3578731106,37
2,996,17540,3578731069,3578731107,38
2,996,17541,3578731069,3578731107,38
2,996,17542,3578731069,3578731107,38
2,996,17543,3578731069,3578731107,38
2,996,17544,3578731069,3578731108,39
2,996,17545,3578731069,3578731111,42
2,996,17546,3578731069,3578731111,42
2,996,17547,3578731069,3578731111,42
2,996,17548,3578731069,3578731112,43
2,996,17549,3578731069,3578731113,44
2,996,17550,3578731069,3578731117,48
2,996,17551,3578731069,3578731117,48
2,996,17552,3578731069,3578731118,49
2,997,17553,3578731129,3578731129,0
2,997,17554,3578731129,3578731129,0
2,997,17555,3578731129,3578731129,0
2,997,17556,3578731129,3578731129,0
2,997,17557,3578731129,3578731129,0
2,997,17558,3578731129,3578731129,0
2,997,17559,3578731129,3578731129,0
2,997,17560,3578731129,3578731129,0
2,997,17561,3578731129,3578731129,0
2,997,17562,3578731129,3578731129,0
2,997,17563,3578731129,3578731129,0
2,997,17564,3578731129,3578731129,0
2,997,17565,3578731129,3578731129,0
2,997,17566,3578731129,3578731133,4
2,997,17567,3578731129,3578731133,4
2,997,17568,3578731129,3578731135,6
2,997,17569,3578731129,3578731135,6
2,997,17570,3578731129,3578731135,6
2,997,17571,3578731129,3578731136,7
2,997,17572,3578731129,3578731137,8
2,997,17573,3578731129,3578731137,8
2,997,17574,3578731129,3578731138,9
2,997,17575,3578731129,3578731138,9
2,997,17576,3578731129,3578731139,10
2,997,17577,3578731129,3578731140,11
2,997,17578,3578731129,3578731142,13
2,997,17579,3578731129,3578731143,14
2,997,17580,3578731129,3578731143,14
2,997,17581,3578731129,3578731143,14
2,997,17582,3578731129,3578731144,15
2,997,17583,3578731129,3578731151,22
2,997,17584,3578731129,3578731151,22
2,997,17585,3578731129,3578731154,25
2,997,17586,3578731129,3578731155,26
2,997,17587,3578731129,3578731155,26
2,997,17588,3578731129,3578731155,26
2,997,17589,3578731129,3578731156,27
2,997,17590,3578731129,3578731159,30
2,997,17591,3578731129,3578731159,30
2,997,17592,3578731129,3578731164,35
2,997,17593,3578731129,3578731165,36
2,997,17594,3578731129,3578731165,36
2,997,17595,3578731129,3578731166,37
2,997,17596,3578731129,3578731167,38
2,997,17597,3578731129,3578731168,39
2,997,17598,3578731129,3578731171,42
2,997,17599,3578731129,3578731172,43
2,997,17600,3578731129,3578731174,45
2,997,17601,3578731129,3578731174,45
2,997,17602,3578731129,3578731176,47
2,997,17603,3578731129,3578731177,48
2,997,17604,3578731129,3578731178,49
2,998,17605,3578731189,3578731189,0
2,998,17606,3578731189,3578731189,0
2,998,17607,3578731189,3578731189,0
2,998,17608,3578731189,3578731189,0
2,998,17609,3578731189,3578731189,0
2,998,17610,3578731189,3578731189,0
2,998,17611,3578731189,3578731190,1
2,998,17612,3578731189,3578731193,4
2,998,17613,3578731189,3578731193,4
2,998,17614,3578731189,3578731193,4
2,998,17615,3578731189,3578731194,5
2,998,17616,3578731189,3578731195,6
2,998,17617,3578731189,3578731196,7
2,998,17618,3578731189,3578731200,11
2,998,17619,3578731189,3578731203,14
2,998,17620,3578731189,3578731203,14
2,998,17621,3578731189,3578731207,18
2,998,17622,3578731189,3578731208,19
2,998,17623,3578731189,3578731209,20
2,998,17624,3578731189,3578731212,23
2,998,17625,3578731189,3578731212,23
2,998,17626,3578731189,3578731215,26
2,998,17627,3578731189,3578731217,28
2,998,17628,3578731189,3578731217,28
2,998,17629,3578731189,3578731217,28
2,998,17630,3578731189,3578731218,29
2,998,17631,3578731189,3578731225,36
2,998,17632,3578731189,3578731225,36
2,998,17633,3578731189,3578731226,37
2,998,17634,3578731189,3578731226,37
2,998,17635,3578731189,3578731226,37
2,998,17636,3578731189,3578731227,38
2,998,17637,3578731189,3578731227,38
2,998,17638,3578731189,3578731228,39
2,998,17639,3578731189,3578731230,41
2,998,17640,3578731189,3578731231,42
2,998,17641,3578731189,3578731232,43
2,998,17642,3578731189,3578731234,45
2,998,17643,3578731189,3578731235,46
2,998,17644,3578731189,3578731235,46
2,998,17645,3578731189,3578731236,47
2,998,17646,3578731189,3578731238,49
2,998,17647,3578731189,3578731239,50
2,999,17648,3578731247,3578731247,0
2,999,17649,3578731247,3578731247,0
2,999,17650,3578731247,3578731247,0
2,999,17651,3578731247,3578731247,0
2,999,17652,3578731247,3578731247,0
2,999,17653,3578731247,3578731247,0
2,999,17654,3578731247,3578731247,0
2,999,17655,3578731247,3578731247,0
2,999,17656,3578731247,3578731247,0
2,999,17657,3578731247,3578731247,0
2,999,17658,3578731247,3578731248,1
2,999,17659,3578731247,3578731249,2
2,999,17660,3578731247,3578731251,4
2,999,17661,3578731247,3578731252,5
2,999,17662,3578731247,3578731252,5
2,999,17663,3578731247,3578731252,5
2,999,17664,3578731247,3578731252,5
2,999,17665,3578731247,3578731252,5
2,999,17666,3578731247,3578731253,6
2,999,17667,3578731247,3578731255,8
2,999,17668,3578731247,3578731257,10
2,999,17669,3578731247,3578731257,10
2,999,17670,3578731247,3578731260,13
2,999,17671,3578731247,3578731261,14
2,999,17672,3578731247,3578731261,14
2,999,17673,3578731247,3578731262,15
2,999,17674,3578731247,3578731265,18
2,999,17675,3578731247,3578731265,18
2,999,17676,3578731247,3578731265,18
2,999,17677,3578731247,3578731267,20
2,999,17678,3578731247,3578731268,21
2,999,17679,3578731247,3578731268,21
2,999,17680,3578731247,3578731269,22
2,999,17681,3578731247,3578731269,22
2,999,17682,3578731247,3578731276,29
2,999,17683,3578731247,3578731282,35
2,999,17684,3578731247,3578731284,37
2,999,17685,3578731247,3578731284,37
2,999,17686,3578731247,3578731284,37
2,999,17687,3578731247,3578731286,39
2,999,17688,3578731247,3578731286,39
2,999,17689,3578731247,3578731290,43
2,999,17690,3578731247,3578731290,43
2,999,17691,3578731247,3578731291,44
2,999,17692,3578731247,3578731293,46
2,999,17693,3578731247,3578731293,46
2,999,17694,3578731247,3578731294,47
2,999,17695,3578731247,3578731294,47
2,999,17696,3578731247,3578731294,47
2,999,17697,3578731247,3578731295,48
2,999,17698,3578731247,3578731295,48
2,999,17699,3578731247,3578731295,48
2,999,17700,3578731247,3578731296,49
2,1000,17701,3578731305,3578731305,0
2,1000,17702,3578731305,3578731305,0
2,1000,17703,3578731305,3578731305,0
2,1000,17704,3578731305,3578731305,0
2,1000,17705,3578731305,3578731305,0
2,1000,17706,3578731305,3578731305,0
2,1000,17707,3578731305,3578731305,0
2,1000,17708,3578731305,3578731305,0
2,1000,17709,3578731305,3578731306,1
2,1000,17710,3578731305,3578731306,1
2,1000,17711,3578731305,3578731307,2
2,1000,17712,3578731305,3578731307,2
2,1000,17713,3578731305,3578731307,2
2,1000,17714,3578731305,3578731308,3
2,1000,17715,3578731305,3578731310,5
2,1000,17716,3578731305,3578731311,6
2,1000,17717,3578731305,3578731311,6
2,1000,17718,3578731305,3578731312,7
2,1000,17719,3578731305,3578731312,7
2,1000,17720,3578731305,3578731312,7
2,1000,17721,3578731305,3578731312,7
2,1000,17722,3578731305,3578731313,8
2,1000,17723,3578731305,3578731318,13
2,1000,17724,3578731305,3578731318,13
2,1000,17725,3578731305,3578731319,14
2,1000,17726,3578731305,3578731319,14
2,1000,17727,3578731305,3578731320,15
2,1000,17728,3578731305,3578731321,16
2,1000,17729,3578731305,3578731322,17
2,1000,17730,3578731305,3578731322,17
2,1000,17731,3578731305,3578731323,18
2,1000,17732,3578731305,3578731324,19
2,1000,17733,3578731305,3578731324,19
2,1000,17734,3578731305,3578731325,20
2,1000,17735,3578731305,3578731327,22
2,1000,17736,3578731305,3578731327,22
2,1000,17737,3578731305,3578731328,23
2,1000,17738,3578731305,3578731333,28
2,1000,17739,3578731305,3578731333,28
2,1000,17740,3578731305,3578731335,30
2,1000,17741,3578731305,3578731335,30
2,1000,17742,3578731305,3578731336,31
2,1000,17743,3578731305,3578731336,31
2,1000,17744,3578731305,3578731336,31
2,1000,17745,3578731305,3578731337,32
2,1000,17746,3578731305,3578731338,33
2,1000,17747,3578731305,3578731339,34
2,1000,17748,3578731305,3578731340,35
2,1000,17749,3578731305,3578731343,38
2,1000,17750,3578731305,3578731343,38
2,1000,17751,3578731305,3578731344,39
2,1000,17752,3578731305,3578731344,39
2,1000,17753,3578731305,3578731350,45
2,1000,17754,3578731305,3578731352,47
2,1000,17755,3578731305,3578731353,48
2,1000,17756,3578731305,3578731354,49
2,1001,17757,3578731364,3578731364,0
2,1001,17758,3578731364,3578731364,0
2,1001,17759,3578731364,3578731364,0
2,1001,17760,3578731364,3578731364,0
2,1001,17761,3578731364,3578731364,0
2,1001,17762,3578731364,3578731364,0
2,1001,17763,3578731364,3578731364,0
2,1001,17764,3578731364,3578731364,0
2,1001,17765,3578731364,3578731364,0
2,1001,17766,3578731364,3578731365,1
2,1001,17767,3578731364,3578731365,1
2,1001,17768,3578731364,3578731369,5
2,1001,17769,3578731364,3578731369,5
2,1001,17770,3578731364,3578731371,7
2,1001,17771,3578731364,3578731374,10
2,1001,17772,3578731364,3578731374,10
2,1001,17773,3578731364,3578731375,11
2,1001,17774,3578731364,3578731376,12
2,1001,17775,3578731364,3578731377,13
2,1001,17776,3578731364,3578731379,15
2,1001,17777,3578731364,3578731380,16
2,1001,17778,3578731364,3578731381,17
2,1001,17779,3578731364,3578731383,19
2,1001,17780,3578731364,3578731385,21
2,1001,17781,3578731364,3578731386,22
2,1001,17782,3578731364,3578731389,25
2,1001,17783,3578731364,3578731389,25
2,1001,17784,3578731364,3578731392,28
2,1001,17785,3578731364,3578731393,29
2,1001,17786,3578731364,3578731393,29
2,1001,17787,3578731364,3578731393,29
2,1001,17788,3578731364,3578731394,30
2,1001,17789,3578731364,3578731394,30
2,1001,17790,3578731364,3578731397,33
2,1001,17791,3578731364,3578731398,34
2,1001,17792,3578731364,3578731401,37
2,1001,17793,3578731364,3578731403,39
2,1001,17794,3578731364,3578731403,39
2,1001,17795,3578731364,3578731408,44
2,1001,17796,3578731364,3578731409,45
2,1001,17797,3578731364,3578731413,49
2,1002,17798,3578731423,3578731423,0
2,1002,17799,3578731423,3578731424,1
2,1002,17800,3578731423,3578731424,1
2,1002,17801,3578731423,3578731424,1
2,1002,17802,3578731423,3578731424,1
2,1002,17803,3578731423,3578731426,3
2,1002,17804,3578731423,3578731426,3
2,1002,17805,3578731423,3578731427,4
2,1002,17806,3578731423,3578731427,4
2,1002,17807,3578731423,3578731427,4
2,1002,17808,3578731423,3578731427,4
2,1002,17809,3578731423,3578731428,5
2,1002,17810,3578731423,3578731430,7
2,1002,17811,3578731423,3578731430,7
2,1002,17812,3578731423,3578731432,9
2,1002,17813,3578731423,3578731434,11
2,1002,17814,3578731423,3578731435,12
2,1002,17815,3578731423,3578731436,13
2,1002,17816,3578731423,3578731437,14
2,1002,17817,3578731423,3578731439,16
2,1002,17818,3578731423,3578731439,16
2,1002,17819,3578731423,3578731441,18
2,1002,17820,3578731423,3578731442,19
2,1002,17821,3578731423,3578731442,19
2,1002,17822,3578731423,3578731443,20
2,1002,17823,3578731423,3578731444,21
2,1002,17824,3578731423,3578731446,23
2,1002,17825,3578731423,3578731446,23
2,1002,17826,3578731423,3578731447,24
2,1002,17827,3578731423,3578731447,24
2,1002,17828,3578731423,3578731448,25
2,1002,17829,3578731423,3578731450,27
2,1002,17830,3578731423,3578731451,28
2,1002,17831,3578731423,3578731452,29
2,1002,17832,3578731423,3578731452,29
2,1002,17833,3578731423,3578731452,29
2,1002,17834,3578731423,3578731453,30
2,1002,17835,3578731423,3578731453,30
2,1002,17836,3578731423,3578731453,30
2,1002,17837,3578731423,3578731455,32
2,1002,17838,3578731423,3578731456,33
2,1002,17839,3578731423,3578731457,34
2,1002,17840,3578731423,3578731459,36
2,1002,17841,3578731423,3578731461,38
2,1002,17842,3578731423,3578731461,38
2,1002,17843,3578731423,3578731461,38
2,1002,17844,3578731423,3578731461,38
2,1002,17845,3578731423,3578731465,42
2,1002,17846,3578731423,3578731465,42
2,1002,17847,3578731423,3578731468,45
2,1002,17848,3578731423,3578731468,45
2,1002,17849,3578731423,3578731469,46
2,1002,17850,3578731423,3578731469,46
2,1002,17851,3578731423,3578731470,47
2,1002,17852,3578731423,3578731471,48
2,1003,17853,3578731485,3578731485,0
2,1003,17854,3578731485,3578731485,0
2,1003,17855,3578731485,3578731485,0
2,1003,17856,3578731485,3578731485,0
2,1003,17857,3578731485,3578731485,0
2,1003,17858,3578731485,3578731485,0
2,1003,17859,3578731485,3578731485,0
2,1003,17860,3578731485,3578731486,1
2,1003,17861,3578731485,3578731488,3
2,1003,17862,3578731485,3578731489,4
2,1003,17863,3578731485,3578731491,6
2,1003,17864,3578731485,3578731492,7
2,1003,17865,3578731485,3578731493,8
2,1003,17866,3578731485,3578731493,8
2,1003,17867,3578731485,3578731493,8
2,1003,17868,3578731485,3578731493,8
2,1003,17869,3578731485,3578731494,9
2,1003,17870,3578731485,3578731495,10
2,1003,17871,3578731485,3578731495,10
2,1003,17872,3578731485,3578731495,10
2,1003,17873,3578731485,3578731497,12
2,1003,17874,3578731485,3578731499,14
2,1003,17875,3578731485,3578731500,15
2,1003,17876,3578731485,3578731500,15
2,1003,17877,3578731485,3578731500,15
2,1003,17878,3578731485,3578731504,19
2,1003,17879,3578731485,3578731505,20
2,1003,17880,3578731485,3578731506,21
2,1003,17881,3578731485,3578731506,21
2,1003,17882,3578731485,3578731507,22
2,1003,17883,3578731485,3578731508,23
2,1003,17884,3578731485,3578731510,25
2,1003,17885,3578731485,3578731510,25
2,1003,17886,3578731485,3578731510,25
2,1003,17887,3578731485,3578731511,26
2,1003,17888,3578731485,3578731511,26
2,1003,17889,3578731485,3578731512,27
2,1003,17890,3578731485,3578731513,28
2,1003,17891,3578731485,3578731514,29
2,1003,17892,3578731485,3578731516,31
2,1003,17893,3578731485,3578731517,32
2,1003,17894,3578731485,3578731517,32
2,1003,17895,3578731485,3578731518,33
2,1003,17896,3578731485,3578731519,34
2,1003,17897,3578731485,3578731520,35
2,1003,17898,3578731485,3578731521,36
2,1003,17899,3578731485,3578731521,36
2,1003,17900,3578731485,3578731521,36
2,1003,17901,3578731485,3578731522,37
2,1003,17902,3578731485,3578731524,39
2,1003,17903,3578731485,3578731524,39
2,1003,17904,3578731485,3578731524,39
2,1003,17905,3578731485,3578731526,41
2,1003,17906,3578731485,3578731527,42
2,1003,17907,3578731485,3578731527,42
2,1003,17908,3578731485,3578731532,47
2,1003,17909,3578731485,3578731532,47
2,1003,17910,3578731485,3578731534,49
2,1003,17911,3578731485,3578731535,50
2,1004,17912,3578731543,3578731543,0
2,1004,17913,3578731543,3578731543,0
2,1004,17914,3578731543,3578731543,0
2,1004,17915,3578731543,3578731543,0
2,1004,17916,3578731543,3578731543,0
2,1004,17917,3578731543,3578731543,0
2,1004,17918,3578731543,3578731543,0
2,1004,17919,3578731543,3578731543,0
2,1004,17920,3578731543,3578731543,0
2,1004,17921,3578731543,3578731543,0
2,1004,17922,3578731543,3578731543,0
2,1004,17923,3578731543,3578731543,0
2,1004,17924,3578731543,3578731550,7
2,1004,17925,3578731543,3578731551,8
2,1004,17926,3578731543,3578731552,9
2,1004,17927,3578731543,3578731553,10
2,1004,17928,3578731543,3578731554,11
2,1004,17929,3578731543,3578731555,12
2,1004,17930,3578731543,3578731556,13
2,1004,17931,3578731543,3578731559,16
2,1004,17932,3578731543,3578731559,16
2,1004,17933,3578731543,3578731561,18
2,1004,17934,3578731543,3578731562,19
2,1004,17935,3578731543,3578731562,19
2,1004,17936,3578731543,3578731564,21
2,1004,17937,3578731543,3578731564,21
2,1004,17938,3578731543,3578731565,22
2,1004,17939,3578731543,3578731567,24
2,1004,17940,3578731543,3578731567,24
2,1004,17941,3578731543,3578731567,24
2,1004,17942,3578731543,3578731571,28
2,1004,17943,3578731543,3578731573,30
2,1004,17944,3578731543,3578731573,30
2,1004,17945,3578731543,3578731575,32
2,1004,17946,3578731543,3578731577,34
2,1004,17947,3578731543,3578731578,35
2,1004,17948,3578731543,3578731580,37
2,1004,17949,3578731543,3578731580,37
2,1004,17950,3578731543,3578731582,39
2,1004,17951,3578731543,3578731582,39
2,1004,17952,3578731543,3578731584,41
2,1004,17953,3578731543,3578731588,45
2,1004,17954,3578731543,3578731589,46
2,1004,17955,3578731543,3578731590,47
2,1004,17956,3578731543,3578731591,48
2,1004,17957,3578731543,3578731592,49
2,1004,17958,3578731543,3578731592,49
2,1005,17959,3578731602,3578731602,0
2,1005,17960,3578731602,3578731602,0
2,1005,17961,3578731602,3578731602,0
2,1005,17962,3578731602,3578731602,0
2,1005,17963,3578731602,3578731602,0
2,1005,17964,3578731602,3578731602,0
2,1005,17965,3578731602,3578731608,6
2,1005,17966,3578731602,3578731608,6
2,1005,17967,3578731602,3578731612,10
2,1005,17968,3578731602,3578731612,10
2,1005,17969,3578731602,3578731613,11
2,1005,17970,3578731602,3578731615,13
2,1005,17971,3578731602,3578731615,13
2,1005,17972,3578731602,3578731616,14
2,1005,17973,3578731602,3578731616,14
2,1005,17974,3578731602,3578731617,15
2,1005,17975,3578731602,3578731618,16
2,1005,17976,3578731602,3578731620,18
2,1005,17977,3578731602,3578731625,23
2,1005,17978,3578731602,3578731625,23
2,1005,17979,3578731602,3578731627,25
2,1005,17980,3578731602,3578731627,25
2,1005,17981,3578731602,3578731627,25
2,1005,17982,3578731602,3578731628,26
2,1005,17983,3578731602,3578731629,27
2,1005,17984,3578731602,3578731630,28
2,1005,17985,3578731602,3578731632,30
2,1005,17986,3578731602,3578731633,31
2,1005,17987,3578731602,3578731634,32
2,1005,17988,3578731602,3578731635,33
2,1005,17989,3578731602,3578731636,34
2,1005,17990,3578731602,3578731637,35
2,1005,17991,3578731602,3578731638,36
2,1005,17992,3578731602,3578731638,36
2,1005,17993,3578731602,3578731640,38
2,1005,17994,3578731602,3578731641,39
2,1005,17995,3578731602,3578731641,39
2,1005,17996,3578731602,3578731642,40
2,1005,17997,3578731602,3578731643,41
2,1005,17998,3578731602,3578731643,41
2,1005,17999,3578731602,3578731645,43
2,1005,18000,3578731602,3578731646,44
2,1005,18001,3578731602,3578731646,44
2,1005,18002,3578731602,3578731648,46
2,1005,18003,3578731602,3578731649,47
2,1005,18004,3578731602,3578731650,48
2,1005,18005,3578731602,3578731651,49
2,1005,18006,3578731602,3578731651,49
2,1005,18007,3578731602,3578731652,50
2,1005,18008,3578731602,3578731652,50
2,1005,18009,3578731602,3578731652,50
2,1005,18010,3578731602,3578731652,50
2,1006,18011,3578731660,3578731660,0
2,1006,18012,3578731660,3578731660,0
2,1006,18013,3578731660,3578731660,0
2,1006,18014,3578731660,3578731660,0
2,1006,18015,3578731660,3578731660,0
2,1006,18016,3578731660,3578731660,0
2,1006,18017,3578731660,3578731660,0
2,1006,18018,3578731660,3578731660,0
2,1006,18019,3578731660,3578731664,4
2,1006,18020,3578731660,3578731665,5
2,1006,18021,3578731660,3578731667,7
2,1006,18022,3578731660,3578731667,7
2,1006,18023,3578731660,3578731669,9
2,1006,18024,3578731660,3578731669,9
2,1006,18025,3578731660,3578731670,10
2,1006,18026,3578731660,3578731676,16
2,1006,18027,3578731660,3578731681,21
2,1006,18028,3578731660,3578731681,21
2,1006,18029,3578731660,3578731682,22
2,1006,18030,3578731660,3578731683,23
2,1006,18031,3578731660,3578731683,23
2,1006,18032,3578731660,3578731684,24
2,1006,18033,3578731660,3578731685,25
2,1006,18034,3578731660,3578731685,25
2,1006,18035,3578731660,3578731685,25
2,1006,18036,3578731660,3578731686,26
2,1006,18037,3578731660,3578731689,29
2,1006,18038,3578731660,3578731689,29
2,1006,18039,3578731660,3578731690,30
2,1006,18040,3578731660,3578731692,32
2,1006,18041,3578731660,3578731693,33
2,1006,18042,3578731660,3578731693,33
2,1006,18043,3578731660,3578731693,33
2,1006,18044,3578731660,3578731694,34
2,1006,18045,3578731660,3578731694,34
2,1006,18046,3578731660,3578731695,35
2,1006,18047,3578731660,3578731695,35
2,1006,18048,3578731660,3578731698,38
2,1006,18049,3578731660,3578731698,38
2,1006,18050,3578731660,3578731699,39
2,1006,18051,3578731660,3578731699,39
2,1006,18052,3578731660,3578731700,40
2,1006,18053,3578731660,3578731701,41
2,1006,18054,3578731660,3578731701,41
2,1006,18055,3578731660,3578731701,41
2,1006,18056,3578731660,3578731704,44
2,1006,18057,3578731660,3578731706,46
2,1006,18058,3578731660,3578731706,46
2,1006,18059,3578731660,3578731707,47
2,1006,18060,3578731660,3578731707,47
2,1006,18061,3578731660,3578731709,49
2,1006,18062,3578731660,3578731709,49
2,1006,18063,3578731660,3578731710,50
2,1007,18064,3578731718,3578731718,0
2,1007,18065,3578731718,3578731718,0
2,1007,18066,3578731718,3578731718,0
2,1007,18067,3578731718,3578731718,0
2,1007,18068,3578731718,3578731718,0
2,1007,18069,3578731718,3578731718,0
2,1007,18070,3578731718,3578731718,0
2,1007,18071,3578731718,3578731718,0
2,1007,18072,3578731718,3578731718,0
2,1007,18073,3578731718,3578731718,0
2,1007,18074,3578731718,3578731720,2
2,1007,18075,3578731718,3578731721,3
2,1007,18076,3578731718,3578731721,3
2,1007,18077,3578731718,3578731721,3
2,1007,18078,3578731718,3578731723,5
2,1007,18079,3578731718,3578731723,5
2,1007,18080,3578731718,3578731725,7
2,1007,18081,3578731718,3578731725,7
2,1007,18082,3578731718,3578731727,9
2,1007,18083,3578731718,3578731728,10
2,1007,18084,3578731718,3578731729,11
2,1007,18085,3578731718,3578731732,14
2,1007,18086,3578731718,3578731733,15
2,1007,18087,3578731718,3578731733,15
2,1007,18088,3578731718,3578731734,16
2,1007,18089,3578731718,3578731734,16
2,1007,18090,3578731718,3578731735,17
2,1007,18091,3578731718,3578731735,17
2,1007,18092,3578731718,3578731736,18
2,1007,18093,3578731718,3578731736,18
2,1007,18094,3578731718,3578731737,19
2,1007,18095,3578731718,3578731739,21
2,1007,18096,3578731718,3578731740,22
2,1007,18097,3578731718,3578731742,24
2,1007,18098,3578731718,3578731743,25
2,1007,18099,3578731718,3578731743,25
2,1007,18100,3578731718,3578731744,26
2,1007,18101,3578731718,3578731750,32
2,1007,18102,3578731718,3578731752,34
2,1007,18103,3578731718,3578731752,34
2,1007,18104,3578731718,3578731754,36
2,1007,18105,3578731718,3578731754,36
2,1007,18106,3578731718,3578731755,37
2,1007,18107,3578731718,3578731756,38
2,1007,18108,3578731718,3578731759,41
2,1007,18109,3578731718,3578731759,41
2,1007,18110,3578731718,3578731762,44
2,1007,18111,3578731718,3578731763,45
2,1007,18112,3578731718,3578731763,45
2,1007,18113,3578731718,3578731764,46
2,1007,18114,3578731718,3578731765,47
2,1007,18115,3578731718,3578731767,49
2,1007,18116,3578731718,3578731768,50
2,1008,18117,3578731776,3578731776,0
2,1008,18118,3578731776,3578731776,0
2,1008,18119,3578731776,3578731776,0
2,1008,18120,3578731776,3578731776,0
2,1008,18121,3578731776,3578731776,0
2,1008,18122,3578731776,3578731776,0
2,1008,18123,3578731776,3578731778,2
2,1008,18124,3578731776,3578731780,4
2,1008,18125,3578731776,3578731780,4
2,1008,18126,3578731776,3578731780,4
2,1008,18127,3578731776,3578731782,6
2,1008,18128,3578731776,3578731785,9
2,1008,18129,3578731776,3578731788,12
2,1008,18130,3578731776,3578731788,12
2,1008,18131,3578731776,3578731791,15
2,1008,18132,3578731776,3578731792,16
2,1008,18133,3578731776,3578731792,16
2,1008,18134,3578731776,3578731793,17
2,1008,18135,3578731776,3578731794,18
2,1008,18136,3578731776,3578731795,19
2,1008,18137,3578731776,3578731796,20
2,1008,18138,3578731776,3578731800,24
2,1008,18139,3578731776,3578731802,26
2,1008,18140,3578731776,3578731808,32
2,1008,18141,3578731776,3578731808,32
2,1008,18142,3578731776,3578731808,32
2,1008,18143,3578731776,3578731812,36
2,1008,18144,3578731776,3578731812,36
2,1008,18145,3578731776,3578731813,37
2,1008,18146,3578731776,3578731815,39
2,1008,18147,3578731776,3578731816,40
2,1008,18148,3578731776,3578731817,41
2,1008,18149,3578731776,3578731817,41
2,1008,18150,3578731776,3578731819,43
2,1008,18151,3578731776,3578731821,45
2,1008,18152,3578731776,3578731825,49
2,1008,18153,3578731776,3578731825,49
2,1009,18154,3578731836,3578731836,0
2,1009,18155,3578731836,3578731836,0
2,1009,18156,3578731836,3578731836,0
2,1009,18157,3578731836,3578731836,0
2,1009,18158,3578731836,3578731836,0
2,1009,18159,3578731836,3578731836,0
2,1009,18160,3578731836,3578731836,0
2,1009,18161,3578731836,3578731836,0
2,1009,18162,3578731836,3578731836,0
2,1009,18163,3578731836,3578731836,0
2,1009,18164,3578731836,3578731836,0
2,1009,18165,3578731836,3578731836,0
2,1009,18166,3578731836,3578731837,1
2,1009,18167,3578731836,3578731838,2
2,1009,18168,3578731836,3578731839,3
2,1009,18169,3578731836,3578731840,4
2,1009,18170,3578731836,3578731841,5
2,1009,18171,3578731836,3578731842,6
2,1009,18172,3578731836,3578731842,6
2,1009,18173,3578731836,3578731842,6
2,1009,18174,3578731836,3578731843,7
2,1009,18175,3578731836,3578731846,10
2,1009,18176,3578731836,3578731847,11
2,1009,18177,3578731836,3578731847,11
2,1009,18178,3578731836,3578731847,11
2,1009,18179,3578731836,3578731849,13
2,1009,18180,3578731836,3578731851,15
2,1009,18181,3578731836,3578731852,16
2,1009,18182,3578731836,3578731852,16
2,1009,18183,3578731836,3578731853,17
2,1009,18184,3578731836,3578731853,17
2,1009,18185,3578731836,3578731853,17
2,1009,18186,3578731836,3578731855,19
2,1009,18187,3578731836,3578731856,20
2,1009,18188,3578731836,3578731860,24
2,1009,18189,3578731836,3578731860,24
2,1009,18190,3578731836,3578731860,24
2,1009,18191,3578731836,3578731861,25
2,1009,18192,3578731836,3578731864,28
2,1009,18193,3578731836,3578731865,29
2,1009,18194,3578731836,3578731867,31
2,1009,18195,3578731836,3578731867,31
2,1009,18196,3578731836,3578731868,32
2,1009,18197,3578731836,3578731868,32
2,1009,18198,3578731836,3578731870,34
2,1009,18199,3578731836,3578731870,34
2,1009,18200,3578731836,3578731876,40
2,1009,18201,3578731836,3578731881,45
2,1009,18202,3578731836,3578731882,46
2,1009,18203,3578731836,3578731883,47
2,1009,18204,3578731836,3578731884,48
2,1009,18205,3578731836,3578731884,48
2,1009,18206,3578731836,3578731886,50
2,1010,18207,3578731894,3578731894,0
2,1010,18208,3578731894,3578731894,0
2,1010,18209,3578731894,3578731894,0
2,1010,18210,3578731894,3578731894,0
2,1010,18211,3578731894,3578731894,0
2,1010,18212,3578731894,3578731894,0
2,1010,18213,3578731894,3578731894,0
2,1010,18214,3578731894,3578731894,0
2,1010,18215,3578731894,3578731894,0
2,1010,18216,3578731894,3578731894,0
2,1010,18217,3578731894,3578731895,1
2,1010,18218,3578731894,3578731896,2
2,1010,18219,3578731894,3578731899,5
2,1010,18220,3578731894,3578731899,5
2,1010,18221,3578731894,3578731900,6
2,1010,18222,3578731894,3578731901,7
2,1010,18223,3578731894,3578731901,7
2,1010,18224,3578731894,3578731905,11
2,1010,18225,3578731894,3578731906,12
2,1010,18226,3578731894,3578731907,13
2,1010,18227,3578731894,3578731907,13
2,1010,18228,3578731894,3578731908,14
2,1010,18229,3578731894,3578731910,16
2,1010,18230,3578731894,3578731911,17
2,1010,18231,3578731894,3578731911,17
2,1010,18232,3578731894,3578731912,18
2,1010,18233,3578731894,3578731912,18
2,1010,18234,3578731894,3578731915,21
2,1010,18235,3578731894,3578731915,21
2,1010,18236,3578731894,3578731917,23
2,1010,18237,3578731894,3578731917,23
2,1010,18238,3578731894,3578731918,24
2,1010,18239,3578731894,3578731918,24
2,1010,18240,3578731894,3578731919,25
2,1010,18241,3578731894,3578731921,27
2,1010,18242,3578731894,3578731922,28
2,1010,18243,3578731894,3578731922,28
2,1010,18244,3578731894,3578731922,28
2,1010,18245,3578731894,3578731924,30
2,1010,18246,3578731894,3578731925,31
2,1010,18247,3578731894,3578731925,31
2,1010,18248,3578731894,3578731927,33
2,1010,18249,3578731894,3578731928,34
2,1010,18250,3578731894,3578731929,35
2,1010,18251,3578731894,3578731930,36
2,1010,18252,3578731894,3578731932,38
2,1010,18253,3578731894,3578731933,39
2,1010,18254,3578731894,3578731934,40
2,1010,18255,3578731894,3578731935,41
2,1010,18256,3578731894,3578731936,42
2,1010,18257,3578731894,3578731936,42
2,1010,18258,3578731894,3578731936,42
2,1010,18259,3578731894,3578731937,43
2,1010,18260,3578731894,3578731938,44
2,1010,18261,3578731894,3578731938,44
2,1010,18262,3578731894,3578731939,45
2,1010,18263,3578731894,3578731940,46
2,1010,18264,3578731894,3578731942,48
2,1010,18265,3578731894,3578731942,48
2,1010,18266,3578731894,3578731943,49
2,1010,18267,3578731894,3578731943,49
2,1011,18268,3578731954,3578731954,0
2,1011,18269,3578731954,3578731954,0
2,1011,18270,3578731954,3578731954,0
2,1011,18271,3578731954,3578731954,0
2,1011,18272,3578731954,3578731955,1
2,1011,18273,3578731954,3578731959,5
2,1011,18274,3578731954,3578731959,5
2,1011,18275,3578731954,3578731962,8
2,1011,18276,3578731954,3578731963,9
2,1011,18277,3578731954,3578731965,11
2,1011,18278,3578731954,3578731968,14
2,1011,18279,3578731954,3578731968,14
2,1011,18280,3578731954,3578731970,16
2,1011,18281,3578731954,3578731973,19
2,1011,18282,3578731954,3578731974,20
2,1011,18283,3578731954,3578731975,21
2,1011,18284,3578731954,3578731976,22
2,1011,18285,3578731954,3578731978,24
2,1011,18286,3578731954,3578731979,25
2,1011,18287,3578731954,3578731979,25
2,1011,18288,3578731954,3578731980,26
2,1011,18289,3578731954,3578731982,28
2,1011,18290,3578731954,3578731983,29
2,1011,18291,3578731954,3578731985,31
2,1011,18292,3578731954,3578731986,32
2,1011,18293,3578731954,3578731988,34
2,1011,18294,3578731954,3578731988,34
2,1011,18295,3578731954,3578731991,37
2,1011,18296,3578731954,3578731992,38
2,1011,18297,3578731954,3578731992,38
2,1011,18298,3578731954,3578731993,39
2,1011,18299,3578731954,3578731994,40
2,1011,18300,3578731954,3578731995,41
2,1011,18301,3578731954,3578731996,42
2,1011,18302,3578731954,3578731999,45
2,1011,18303,3578731954,3578732001,47
2,1011,18304,3578731954,3578732002,48
2,1011,18305,3578731954,3578732002,48
2,1012,18306,3578732013,3578732013,0
2,1012,18307,3578732013,3578732013,0
2,1012,18308,3578732013,3578732013,0
2,1012,18309,3578732013,3578732013,0
2,1012,18310,3578732013,3578732013,0
2,1012,18311,3578732013,3578732014,1
2,1012,18312,3578732013,3578732015,2
2,1012,18313,3578732013,3578732016,3
2,1012,18314,3578732013,3578732016,3
2,1012,18315,3578732013,3578732016,3
2,1012,18316,3578732013,3578732017,4
2,1012,18317,3578732013,3578732020,7
2,1012,18318,3578732013,3578732025,12
2,1012,18319,3578732013,3578732026,13
2,1012,18320,3578732013,3578732026,13
2,1012,18321,3578732013,3578732028,15
2,1012,18322,3578732013,3578732028,15
2,1012,18323,3578732013,3578732028,15
2,1012,18324,3578732013,3578732028,15
2,1012,18325,3578732013,3578732030,17
2,1012,18326,3578732013,3578732032,19
2,1012,18327,3578732013,3578732033,20
2,1012,18328,3578732013,3578732035,22
2,1012,18329,3578732013,3578732035,22
2,1012,18330,3578732013,3578732037,24
2,1012,18331,3578732013,3578732038,25
2,1012,18332,3578732013,3578732040,27
2,1012,18333,3578732013,3578732041,28
2,1012,18334,3578732013,3578732041,28
2,1012,18335,3578732013,3578732041,28
2,1012,18336,3578732013,3578732043,30
2,1012,18337,3578732013,3578732043,30
2,1012,18338,3578732013,3578732043,30
2,1012,18339,3578732013,3578732046,33
2,1012,18340,3578732013,3578732047,34
2,1012,18341,3578732013,3578732047,34
2,1012,18342,3578732013,3578732048,35
2,1012,18343,3578732013,3578732049,36
2,1012,18344,3578732013,3578732051,38
2,1012,18345,3578732013,3578732053,40
2,1012,18346,3578732013,3578732053,40
2,1012,18347,3578732013,3578732053,40
2,1012,18348,3578732013,3578732053,40
2,1012,18349,3578732013,3578732053,40
2,1012,18350,3578732013,3578732055,42
2,1012,18351,3578732013,3578732056,43
2,1012,18352,3578732013,3578732056,43
2,1012,18353,3578732013,3578732060,47
2,1012,18354,3578732013,3578732060,47
2,1012,18355,3578732013,3578732061,48
2,1013,18356,3578732072,3578732072,0
2,1013,18357,3578732072,3578732072,0
2,1013,18358,3578732072,3578732072,0
2,1013,18359,3578732072,3578732072,0
2,1013,18360,3578732072,3578732072,0
2,1013,18361,3578732072,3578732081,9
2,1013,18362,3578732072,3578732083,11
2,1013,18363,3578732072,3578732085,13
2,1013,18364,3578732072,3578732085,13
2,1013,18365,3578732072,3578732085,13
2,1013,18366,3578732072,3578732085,13
2,1013,18367,3578732072,3578732086,14
2,1013,18368,3578732072,3578732089,17
2,1013,18369,3578732072,3578732089,17
2,1013,18370,3578732072,3578732089,17
2,1013,18371,3578732072,3578732092,20
2,1013,18372,3578732072,3578732092,20
2,1013,18373,3578732072,3578732094,22
2,1013,18374,3578732072,3578732094,22
2,1013,18375,3578732072,3578732094,22
2,1013,18376,3578732072,3578732095,23
2,1013,18377,3578732072,3578732095,23
2,1013,18378,3578732072,3578732096,24
2,1013,18379,3578732072,3578732099,27
2,1013,18380,3578732072,3578732099,27
2,1013,18381,3578732072,3578732100,28
2,1013,18382,3578732072,3578732100,28
2,1013,18383,3578732072,3578732101,29
2,1013,18384,3578732072,3578732101,29
2,1013,18385,3578732072,3578732102,30
2,1013,18386,3578732072,3578732105,33
2,1013,18387,3578732072,3578732106,34
2,1013,18388,3578732072,3578732107,35
2,1013,18389,3578732072,3578732107,35
2,1013,18390,3578732072,3578732107,35
2,1013,18391,3578732072,3578732108,36
2,1013,18392,3578732072,3578732111,39
2,1013,18393,3578732072,3578732111,39
2,1013,18394,3578732072,3578732112,40
2,1013,18395,3578732072,3578732112,40
2,1013,18396,3578732072,3578732112,40
2,1013,18397,3578732072,3578732113,41
2,1013,18398,3578732072,3578732115,43
2,1013,18399,3578732072,3578732115,43
2,1013,18400,3578732072,3578732117,45
2,1013,18401,3578732072,3578732117,45
2,1013,18402,3578732072,3578732118,46
2,1013,18403,3578732072,3578732119,47
2,1013,18404,3578732072,3578732120,48
2,1013,18405,3578732072,3578732120,48
2,1013,18406,3578732072,3578732121,49
2,1014,18407,3578732129,3578732129,0
2,1014,18408,3578732129,3578732129,0
2,1014,18409,3578732129,3578732129,0
2,1014,18410,3578732129,3578732129,0
2,1014,18411,3578732129,3578732129,0
2,1014,18412,3578732129,3578732129,0
2,1014,18413,3578732129,3578732129,0
2,1014,18414,3578732129,3578732129,0
2,1014,18415,3578732129,3578732129,0
2,1014,18416,3578732129,3578732130,1
2,1014,18417,3578732129,3578732133,4
2,1014,18418,3578732129,3578732133,4
2,1014,18419,3578732129,3578732133,4
2,1014,18420,3578732129,3578732134,5
2,1014,18421,3578732129,3578732135,6
2,1014,18422,3578732129,3578732136,7
2,1014,18423,3578732129,3578732136,7
2,1014,18424,3578732129,3578732136,7
2,1014,18425,3578732129,3578732137,8
2,1014,18426,3578732129,3578732137,8
2,1014,18427,3578732129,3578732138,9
2,1014,18428,3578732129,3578732138,9
2,1014,18429,3578732129,3578732141,12
2,1014,18430,3578732129,3578732143,14
2,1014,18431,3578732129,3578732143,14
2,1014,18432,3578732129,3578732151,22
2,1014,18433,3578732129,3578732151,22
2,1014,18434,3578732129,3578732152,23
2,1014,18435,3578732129,3578732154,25
2,1014,18436,3578732129,3578732154,25
2,1014,18437,3578732129,3578732155,26
2,1014,18438,3578732129,3578732156,27
2,1014,18439,3578732129,3578732159,30
2,1014,18440,3578732129,3578732160,31
2,1014,18441,3578732129,3578732162,33
2,1014,18442,3578732129,3578732163,34
2,1014,18443,3578732129,3578732163,34
2,1014,18444,3578732129,3578732165,36
2,1014,18445,3578732129,3578732165,36
2,1014,18446,3578732129,3578732168,39
2,1014,18447,3578732129,3578732168,39
2,1014,18448,3578732129,3578732168,39
2,1014,18449,3578732129,3578732174,45
2,1014,18450,3578732129,3578732174,45
2,1014,18451,3578732129,3578732174,45
2,1014,18452,3578732129,3578732175,46
2,1014,18453,3578732129,3578732175,46
2,1014,18454,3578732129,3578732177,48
2,1014,18455,3578732129,3578732179,50
2,1015,18456,3578732186,3578732186,0
2,1015,18457,3578732186,3578732186,0
2,1015,18458,3578732186,3578732186,0
2,1015,18459,3578732186,3578732186,0
2,1015,18460,3578732186,3578732188,2
2,1015,18461,3578732186,3578732189,3
2,1015,18462,3578732186,3578732190,4
2,1015,18463,3578732186,3578732192,6
2,1015,18464,3578732186,3578732192,6
2,1015,18465,3578732186,3578732197,11
2,1015,18466,3578732186,3578732199,13
2,1015,18467,3578732186,3578732201,15
2,1015,18468,3578732186,3578732203,17
2,1015,18469,3578732186,3578732206,20
2,1015,18470,3578732186,3578732208,22
2,1015,18471,3578732186,3578732209,23
2,1015,18472,3578732186,3578732210,24
2,1015,18473,3578732186,3578732212,26
2,1015,18474,3578732186,3578732213,27
2,1015,18475,3578732186,3578732215,29
2,1015,18476,3578732186,3578732217,31
2,1015,18477,3578732186,3578732217,31
2,1015,18478,3578732186,3578732218,32
2,1015,18479,3578732186,3578732220,34
2,1015,18480,3578732186,3578732226,40
2,1015,18481,3578732186,3578732226,40
2,1015,18482,3578732186,3578732227,41
2,1015,18483,3578732186,3578732228,42
2,1015,18484,3578732186,3578732228,42
2,1015,18485,3578732186,3578732228,42
2,1015,18486,3578732186,3578732229,43
2,1015,18487,3578732186,3578732229,43
2,1015,18488,3578732186,3578732232,46
2,1015,18489,3578732186,3578732233,47
2,1015,18490,3578732186,3578732235,49
2,1015,18491,3578732186,3578732235,49
2,1016,18492,3578732244,3578732244,0
2,1016,18493,3578732244,3578732244,0
2,1016,18494,3578732244,3578732244,0
2,1016,18495,3578732244,3578732244,0
2,1016,18496,3578732244,3578732244,0
2,1016,18497,3578732244,3578732244,0
2,1016,18498,3578732244,3578732244,0
2,1016,18499,3578732244,3578732244,0
2,1016,18500,3578732244,3578732244,0
2,1016,18501,3578732244,3578732246,2
2,1016,18502,3578732244,3578732247,3
2,1016,18503,3578732244,3578732247,3
2,1016,18504,3578732244,3578732248,4
2,1016,18505,3578732244,3578732250,6
2,1016,18506,3578732244,3578732252,8
2,1016,18507,3578732244,3578732253,9
2,1016,18508,3578732244,3578732253,9
2,1016,18509,3578732244,3578732253,9
2,1016,18510,3578732244,3578732254,10
2,1016,18511,3578732244,3578732255,11
2,1016,18512,3578732244,3578732257,13
2,1016,18513,3578732244,3578732259,15
2,1016,18514,3578732244,3578732260,16
2,1016,18515,3578732244,3578732260,16
2,1016,18516,3578732244,3578732260,16
2,1016,18517,3578732244,3578732262,18
2,1016,18518,3578732244,3578732265,21
2,1016,18519,3578732244,3578732266,22
2,1016,18520,3578732244,3578732267,23
2,1016,18521,3578732244,3578732267,23
2,1016,18522,3578732244,3578732267,23
2,1016,18523,3578732244,3578732269,25
2,1016,18524,3578732244,3578732269,25
2,1016,18525,3578732244,3578732270,26
2,1016,18526,3578732244,3578732276,32
2,1016,18527,3578732244,3578732282,38
2,1016,18528,3578732244,3578732283,39
2,1016,18529,3578732244,3578732284,40
2,1016,18530,3578732244,3578732284,40
2,1016,18531,3578732244,3578732286,42
2,1016,18532,3578732244,3578732286,42
2,1016,18533,3578732244,3578732289,45
2,1016,18534,3578732244,3578732290,46
2,1016,18535,3578732244,3578732290,46
2,1016,18536,3578732244,3578732292,48
2,1016,18537,3578732244,3578732293,49
2,1017,18538,3578732303,3578732303,0
2,1017,18539,3578732303,3578732303,0
2,1017,18540,3578732303,3578732303,0
2,1017,18541,3578732303,3578732303,0
2,1017,18542,3578732303,3578732303,0
2,1017,18543,3578732303,3578732303,0
2,1017,18544,3578732303,3578732303,0
2,1017,18545,3578732303,3578732303,0
2,1017,18546,3578732303,3578732303,0
2,1017,18547,3578732303,3578732306,3
2,1017,18548,3578732303,3578732306,3
2,1017,18549,3578732303,3578732307,4
2,1017,18550,3578732303,3578732307,4
2,1017,18551,3578732303,3578732308,5
2,1017,18552,3578732303,3578732309,6
2,1017,18553,3578732303,3578732310,7
2,1017,18554,3578732303,3578732312,9
2,1017,18555,3578732303,3578732312,9
2,1017,18556,3578732303,3578732312,9
2,1017,18557,3578732303,3578732313,10
2,1017,18558,3578732303,3578732315,12
2,1017,18559,3578732303,3578732316,13
2,1017,18560,3578732303,3578732317,14
2,1017,18561,3578732303,3578732317,14
2,1017,18562,3578732303,3578732318,15
2,1017,18563,3578732303,3578732319,16
2,1017,18564,3578732303,3578732320,17
2,1017,18565,3578732303,3578732321,18
2,1017,18566,3578732303,3578732323,20
2,1017,18567,3578732303,3578732323,20
2,1017,18568,3578732303,3578732324,21
2,1017,18569,3578732303,3578732325,22
2,1017,18570,3578732303,3578732325,22
2,1017,18571,3578732303,3578732326,23
2,1017,18572,3578732303,3578732328,25
2,1017,18573,3578732303,3578732329,26
2,1017,18574,3578732303,3578732329,26
2,1017,18575,3578732303,3578732330,27
2,1017,18576,3578732303,3578732332,29
2,1017,18577,3578732303,3578732333,30
2,1017,18578,3578732303,3578732334,31
2,1017,18579,3578732303,3578732335,32
2,1017,18580,3578732303,3578732337,34
2,1017,18581,3578732303,3578732337,34
2,1017,18582,3578732303,3578732337,34
2,1017,18583,3578732303,3578732337,34
2,1017,18584,3578732303,3578732338,35
2,1017,18585,3578732303,3578732339,36
2,1017,18586,3578732303,3578732342,39
2,1017,18587,3578732303,3578732343,40
2,1017,18588,3578732303,3578732343,40
2,1017,18589,3578732303,3578732343,40
2,1017,18590,3578732303,3578732351,48
2,1017,18591,3578732303,3578732352,49
2,1018,18592,3578732362,3578732362,0
2,1018,18593,3578732362,3578732362,0
2,1018,18594,3578732362,3578732362,0
2,1018,18595,3578732362,3578732362,0
2,1018,18596,3578732362,3578732362,0
2,1018,18597,3578732362,3578732362,0
2,1018,18598,3578732362,3578732364,2
2,1018,18599,3578732362,3578732364,2
2,1018,18600,3578732362,3578732366,4
2,1018,18601,3578732362,3578732369,7
2,1018,18602,3578732362,3578732369,7
2,1018,18603,3578732362,3578732374,12
2,1018,18604,3578732362,3578732375,13
2,1018,18605,3578732362,3578732376,14
2,1018,18606,3578732362,3578732376,14
2,1018,18607,3578732362,3578732378,16
2,1018,18608,3578732362,3578732378,16
2,1018,18609,3578732362,3578732380,18
2,1018,18610,3578732362,3578732383,21
2,1018,18611,3578732362,3578732383,21
2,1018,18612,3578732362,3578732383,21
2,1018,18613,3578732362,3578732386,24
2,1018,18614,3578732362,3578732389,27
2,1018,18615,3578732362,3578732391,29
2,1018,18616,3578732362,3578732391,29
2,1018,18617,3578732362,3578732392,30
2,1018,18618,3578732362,3578732394,32
2,1018,18619,3578732362,3578732394,32
2,1018,18620,3578732362,3578732396,34
2,1018,18621,3578732362,3578732401,39
2,1018,18622,3578732362,3578732402,40
2,1018,18623,3578732362,3578732403,41
2,1018,18624,3578732362,3578732408,46
2,1018,18625,3578732362,3578732409,47
2,1018,18626,3578732362,3578732409,47
2,1019,18627,3578732421,3578732421,0
2,1019,18628,3578732421,3578732421,0
2,1019,18629,3578732421,3578732421,0
2,1019,18630,3578732421,3578732421,0
2,1019,18631,3578732421,3578732421,0
2,1019,18632,3578732421,3578732421,0
2,1019,18633,3578732421,3578732421,0
2,1019,18634,3578732421,3578732426,5
2,1019,18635,3578732421,3578732426,5
2,1019,18636,3578732421,3578732428,7
2,1019,18637,3578732421,3578732428,7
2,1019,18638,3578732421,3578732429,8
2,1019,18639,3578732421,3578732429,8
2,1019,18640,3578732421,3578732429,8
2,1019,18641,3578732421,3578732431,10
2,1019,18642,3578732421,3578732432,11
2,1019,18643,3578732421,3578732433,12
2,1019,18644,3578732421,3578732435,14
2,1019,18645,3578732421,3578732435,14
2,1019,18646,3578732421,3578732438,17
2,1019,18647,3578732421,3578732438,17
2,1019,18648,3578732421,3578732441,20
2,1019,18649,3578732421,3578732441,20
2,1019,18650,3578732421,3578732442,21
2,1019,18651,3578732421,3578732442,21
2,1019,18652,3578732421,3578732443,22
2,1019,18653,3578732421,3578732446,25
2,1019,18654,3578732421,3578732447,26
2,1019,18655,3578732421,3578732447,26
2,1019,18656,3578732421,3578732448,27
2,1019,18657,3578732421,3578732450,29
2,1019,18658,3578732421,3578732451,30
2,1019,18659,3578732421,3578732452,31
2,1019,18660,3578732421,3578732452,31
2,1019,18661,3578732421,3578732453,32
2,1019,18662,3578732421,3578732453,32
2,1019,18663,3578732421,3578732454,33
2,1019,18664,3578732421,3578732454,33
2,1019,18665,3578732421,3578732455,34
2,1019,18666,3578732421,3578732457,36
2,1019,18667,3578732421,3578732457,36
2,1019,18668,3578732421,3578732459,38
2,1019,18669,3578732421,3578732460,39
2,1019,18670,3578732421,3578732460,39
2,1019,18671,3578732421,3578732460,39
2,1019,18672,3578732421,3578732462,41
2,1019,18673,3578732421,3578732465,44
2,1019,18674,3578732421,3578732465,44
2,1019,18675,3578732421,3578732467,46
2,1019,18676,3578732421,3578732467,46
2,1019,18677,3578732421,3578732468,47
2,1019,18678,3578732421,3578732468,47
2,1019,18679,3578732421,3578732469,48
2,1019,18680,3578732421,3578732469,48
2,1019,18681,3578732421,3578732469,48
2,1019,18682,3578732421,3578732470,49
2,1020,18683,3578732479,3578732479,0
2,1020,18684,3578732479,3578732480,1
2,1020,18685,3578732479,3578732480,1
2,1020,18686,3578732479,3578732483,4
2,1020,18687,3578732479,3578732483,4
2,1020,18688,3578732479,3578732483,4
2,1020,18689,3578732479,3578732484,5
2,1020,18690,3578732479,3578732485,6
2,1020,18691,3578732479,3578732485,6
2,1020,18692,3578732479,3578732487,8
2,1020,18693,3578732479,3578732488,9
2,1020,18694,3578732479,3578732489,10
2,1020,18695,3578732479,3578732490,11
2,1020,18696,3578732479,3578732490,11
2,1020,18697,3578732479,3578732491,12
2,1020,18698,3578732479,3578732493,14
2,1020,18699,3578732479,3578732494,15
2,1020,18700,3578732479,3578732494,15
2,1020,18701,3578732479,3578732494,15
2,1020,18702,3578732479,3578732494,15
2,1020,18703,3578732479,3578732498,19
2,1020,18704,3578732479,3578732498,19
2,1020,18705,3578732479,3578732498,19
2,1020,18706,3578732479,3578732499,20
2,1020,18707,3578732479,3578732500,21
2,1020,18708,3578732479,3578732500,21
2,1020,18709,3578732479,3578732500,21
2,1020,18710,3578732479,3578732501,22
2,1020,18711,3578732479,3578732505,26
2,1020,18712,3578732479,3578732505,26
2,1020,18713,3578732479,3578732505,26
2,1020,18714,3578732479,3578732506,27
2,1020,18715,3578732479,3578732507,28
2,1020,18716,3578732479,3578732507,28
2,1020,18717,3578732479,3578732510,31
2,1020,18718,3578732479,3578732511,32
2,1020,18719,3578732479,3578732511,32
2,1020,18720,3578732479,3578732512,33
2,1020,18721,3578732479,3578732514,35
2,1020,18722,3578732479,3578732515,36
2,1020,18723,3578732479,3578732516,37
2,1020,18724,3578732479,3578732516,37
2,1020,18725,3578732479,3578732517,38
2,1020,18726,3578732479,3578732518,39
2,1020,18727,3578732479,3578732518,39
2,1020,18728,3578732479,3578732519,40
2,1020,18729,3578732479,3578732521,42
2,1020,18730,3578732479,3578732522,43
2,1020,18731,3578732479,3578732522,43
2,1020,18732,3578732479,3578732523,44
2,1020,18733,3578732479,3578732524,45
2,1020,18734,3578732479,3578732524,45
2,1020,18735,3578732479,3578732527,48
2,1020,18736,3578732479,3578732527,48
2,1020,18737,3578732479,3578732528,49
2,1020,18738,3578732479,3578732528,49
2,1021,18739,3578732537,3578732537,0
2,1021,18740,3578732537,3578732537,0
2,1021,18741,3578732537,3578732537,0
2,1021,18742,3578732537,3578732537,0
2,1021,18743,3578732537,3578732537,0
2,1021,18744,3578732537,3578732537,0
2,1021,18745,3578732537,3578732537,0
2,1021,18746,3578732537,3578732537,0
2,1021,18747,3578732537,3578732537,0
2,1021,18748,3578732537,3578732537,0
2,1021,18749,3578732537,3578732538,1
2,1021,18750,3578732537,3578732542,5
2,1021,18751,3578732537,3578732542,5
2,1021,18752,3578732537,3578732543,6
2,1021,18753,3578732537,3578732551,14
2,1021,18754,3578732537,3578732551,14
2,1021,18755,3578732537,3578732551,14
2,1021,18756,3578732537,3578732553,16
2,1021,18757,3578732537,3578732554,17
2,1021,18758,3578732537,3578732555,18
2,1021,18759,3578732537,3578732556,19
2,1021,18760,3578732537,3578732556,19
2,1021,18761,3578732537,3578732558,21
2,1021,18762,3578732537,3578732560,23
2,1021,18763,3578732537,3578732561,24
2,1021,18764,3578732537,3578732563,26
2,1021,18765,3578732537,3578732564,27
2,1021,18766,3578732537,3578732565,28
2,1021,18767,3578732537,3578732565,28
2,1021,18768,3578732537,3578732568,31
2,1021,18769,3578732537,3578732568,31
2,1021,18770,3578732537,3578732568,31
2,1021,18771,3578732537,3578732574,37
2,1021,18772,3578732537,3578732574,37
2,1021,18773,3578732537,3578732574,37
2,1021,18774,3578732537,3578732575,38
2,1021,18775,3578732537,3578732575,38
2,1021,18776,3578732537,3578732577,40
2,1021,18777,3578732537,3578732578,41
2,1021,18778,3578732537,3578732579,42
2,1021,18779,3578732537,3578732579,42
2,1021,18780,3578732537,3578732581,44
2,1021,18781,3578732537,3578732582,45
2,1021,18782,3578732537,3578732583,46
2,1021,18783,3578732537,3578732584,47
2,1021,18784,3578732537,3578732584,47
2,1022,18785,3578732596,3578732596,0
2,1022,18786,3578732596,3578732596,0
2,1022,18787,3578732596,3578732596,0
2,1022,18788,3578732596,3578732596,0
2,1022,18789,3578732596,3578732596,0
2,1022,18790,3578732596,3578732596,0
2,1022,18791,3578732596,3578732596,0
2,1022,18792,3578732596,3578732596,0
2,1022,18793,3578732596,3578732596,0
2,1022,18794,3578732596,3578732600,4
2,1022,18795,3578732596,3578732602,6
2,1022,18796,3578732596,3578732606,10
2,1022,18797,3578732596,3578732608,12
2,1022,18798,3578732596,3578732608,12
2,1022,18799,3578732596,3578732609,13
2,1022,18800,3578732596,3578732612,16
2,1022,18801,3578732596,3578732612,16
2,1022,18802,3578732596,3578732615,19
2,1022,18803,3578732596,3578732616,20
2,1022,18804,3578732596,3578732616,20
2,1022,18805,3578732596,3578732617,21
2,1022,18806,3578732596,3578732620,24
2,1022,18807,3578732596,3578732621,25
2,1022,18808,3578732596,3578732624,28
2,1022,18809,3578732596,3578732625,29
2,1022,18810,3578732596,3578732626,30
2,1022,18811,3578732596,3578732626,30
2,1022,18812,3578732596,3578732627,31
2,1022,18813,3578732596,3578732627,31
2,1022,18814,3578732596,3578732627,31
2,1022,18815,3578732596,3578732628,32
2,1022,18816,3578732596,3578732628,32
2,1022,18817,3578732596,3578732629,33
2,1022,18818,3578732596,3578732631,35
2,1022,18819,3578732596,3578732631,35
2,1022,18820,3578732596,3578732632,36
2,1022,18821,3578732596,3578732634,38
2,1022,18822,3578732596,3578732634,38
2,1022,18823,3578732596,3578732637,41
2,1022,18824,3578732596,3578732638,42
2,1022,18825,3578732596,3578732638,42
2,1022,18826,3578732596,3578732639,43
2,1022,18827,3578732596,3578732640,44
2,1022,18828,3578732596,3578732640,44
2,1022,18829,3578732596,3578732641,45
2,1022,18830,3578732596,3578732642,46
2,1022,18831,3578732596,3578732642,46
2,1022,18832,3578732596,3578732642,46
2,1022,18833,3578732596,3578732645,49
2,1022,18834,3578732596,3578732646,50
2,1023,18835,3578732656,3578732656,0
2,1023,18836,3578732656,3578732656,0
2,1023,18837,3578732656,3578732656,0
2,1023,18838,3578732656,3578732656,0
2,1023,18839,3578732656,3578732656,0
2,1023,18840,3578732656,3578732656,0
2,1023,18841,3578732656,3578732656,0
2,1023,18842,3578732656,3578732656,0
2,1023,18843,3578732656,3578732656,0
2,1023,18844,3578732656,3578732656,0
2,1023,18845,3578732656,3578732656,0
2,1023,18846,3578732656,3578732659,3
2,1023,18847,3578732656,3578732659,3
2,1023,18848,3578732656,3578732660,4
2,1023,18849,3578732656,3578732660,4
2,1023,18850,3578732656,3578732661,5
2,1023,18851,3578732656,3578732664,8
2,1023,18852,3578732656,3578732666,10
2,1023,18853,3578732656,3578732667,11
2,1023,18854,3578732656,3578732667,11
2,1023,18855,3578732656,3578732667,11
2,1023,18856,3578732656,3578732668,12
2,1023,18857,3578732656,3578732669,13
2,1023,18858,3578732656,3578732670,14
2,1023,18859,3578732656,3578732678,22
2,1023,18860,3578732656,3578732682,26
2,1023,18861,3578732656,3578732682,26
2,1023,18862,3578732656,3578732683,27
2,1023,18863,3578732656,3578732684,28
2,1023,18864,3578732656,3578732685,29
2,1023,18865,3578732656,3578732685,29
2,1023,18866,3578732656,3578732687,31
2,1023,18867,3578732656,3578732689,33
2,1023,18868,3578732656,3578732689,33
2,1023,18869,3578732656,3578732689,33
2,1023,18870,3578732656,3578732690,34
2,1023,18871,3578732656,3578732692,36
2,1023,18872,3578732656,3578732692,36
2,1023,18873,3578732656,3578732693,37
2,1023,18874,3578732656,3578732693,37
2,1023,18875,3578732656,3578732694,38
2,1023,18876,3578732656,3578732694,38
2,1023,18877,3578732656,3578732695,39
2,1023,18878,3578732656,3578732698,42
2,1023,18879,3578732656,3578732698,42
2,1023,18880,3578732656,3578732699,43
2,1023,18881,3578732656,3578732700,44
2,1023,18882,3578732656,3578732701,45
2,1023,18883,3578732656,3578732702,46
2,1023,18884,3578732656,3578732705,49
2,1023,18885,3578732656,3578732705,49
2,1023,18886,3578732656,3578732706,50
2,1024,18887,3578732718,3578732718,0
2,1024,18888,3578732718,3578732718,0
2,1024,18889,3578732718,3578732718,0
2,1024,18890,3578732718,3578732718,0
2,1024,18891,3578732718,3578732718,0
2,1024,18892,3578732718,3578732718,0
2,1024,18893,3578732718,3578732718,0
2,1024,18894,3578732718,3578732718,0
2,1024,18895,3578732718,3578732718,0
2,1024,18896,3578732718,3578732718,0
2,1024,18897,3578732718,3578732718,0
2,1024,18898,3578732718,3578732718,0
2,1024,18899,3578732718,3578732718,0
2,1024,18900,3578732718,3578732718,0
2,1024,18901,3578732718,3578732718,0
2,1024,18902,3578732718,3578732720,2
2,1024,18903,3578732718,3578732721,3
2,1024,18904,3578732718,3578732721,3
2,1024,18905,3578732718,3578732722,4
2,1024,18906,3578732718,3578732723,5
2,1024,18907,3578732718,3578732723,5
2,1024,18908,3578732718,3578732724,6
2,1024,18909,3578732718,3578732724,6
2,1024,18910,3578732718,3578732726,8
2,1024,18911,3578732718,3578732727,9
2,1024,18912,3578732718,3578732728,10
2,1024,18913,3578732718,3578732729,11
2,1024,18914,3578732718,3578732732,14
2,1024,18915,3578732718,3578732733,15
2,1024,18916,3578732718,3578732733,15
2,1024,18917,3578732718,3578732733,15
2,1024,18918,3578732718,3578732734,16
2,1024,18919,3578732718,3578732735,17
2,1024,18920,3578732718,3578732735,17
2,1024,18921,3578732718,3578732736,18
2,1024,18922,3578732718,3578732736,18
2,1024,18923,3578732718,3578732737,19
2,1024,18924,3578732718,3578732737,19
2,1024,18925,3578732718,3578732738,20
2,1024,18926,3578732718,3578732741,23
2,1024,18927,3578732718,3578732741,23
2,1024,18928,3578732718,3578732742,24
2,1024,18929,3578732718,3578732742,24
2,1024,18930,3578732718,3578732743,25
2,1024,18931,3578732718,3578732750,32
2,1024,18932,3578732718,3578732752,34
2,1024,18933,3578732718,3578732752,34
2,1024,18934,3578732718,3578732754,36
2,1024,18935,3578732718,3578732755,37
2,1024,18936,3578732718,3578732756,38
2,1024,18937,3578732718,3578732759,41
2,1024,18938,3578732718,3578732760,42
2,1024,18939,3578732718,3578732761,43
2,1024,18940,3578732718,3578732763,45
2,1024,18941,3578732718,3578732764,46
2,1024,18942,3578732718,3578732765,47
2,1024,18943,3578732718,3578732767,49
2,1024,18944,3578732718,3578732768,50
2,1025,18945,3578732780,3578732780,0
2,1025,18946,3578732780,3578732780,0
2,1025,18947,3578732780,3578732780,0
2,1025,18948,3578732780,3578732780,0
2,1025,18949,3578732780,3578732780,0
2,1025,18950,3578732780,3578732780,0
2,1025,18951,3578732780,3578732780,0
2,1025,18952,3578732780,3578732782,2
2,1025,18953,3578732780,3578732782,2
2,1025,18954,3578732780,3578732783,3
2,1025,18955,3578732780,3578732789,9
2,1025,18956,3578732780,3578732789,9
2,1025,18957,3578732780,3578732790,10
2,1025,18958,3578732780,3578732791,11
2,1025,18959,3578732780,3578732791,11
2,1025,18960,3578732780,3578732795,15
2,1025,18961,3578732780,3578732795,15
2,1025,18962,3578732780,3578732796,16
2,1025,18963,3578732780,3578732796,16
2,1025,18964,3578732780,3578732800,20
2,1025,18965,3578732780,3578732804,24
2,1025,18966,3578732780,3578732808,28
2,1025,18967,3578732780,3578732808,28
2,1025,18968,3578732780,3578732809,29
2,1025,18969,3578732780,3578732812,32
2,1025,18970,3578732780,3578732812,32
2,1025,18971,3578732780,3578732815,35
2,1025,18972,3578732780,3578732815,35
2,1025,18973,3578732780,3578732816,36
2,1025,18974,3578732780,3578732817,37
2,1025,18975,3578732780,3578732817,37
2,1025,18976,3578732780,3578732820,40
2,1025,18977,3578732780,3578732821,41
2,1025,18978,3578732780,3578732825,45
2,1025,18979,3578732780,3578732827,47
2,1025,18980,3578732780,3578732828,48
2,1025,18981,3578732780,3578732828,48
2,1025,18982,3578732780,3578732828,48
2,1025,18983,3578732780,3578732829,49
2,1025,18984,3578732780,3578732829,49
2,1026,18985,3578732838,3578732838,0
2,1026,18986,3578732838,3578732838,0
2,1026,18987,3578732838,3578732838,0
2,1026,18988,3578732838,3578732838,0
2,1026,18989,3578732838,3578732838,0
2,1026,18990,3578732838,3578732838,0
2,1026,18991,3578732838,3578732839,1
2,1026,18992,3578732838,3578732840,2
2,1026,18993,3578732838,3578732841,3
2,1026,18994,3578732838,3578732841,3
2,1026,18995,3578732838,3578732841,3
2,1026,18996,3578732838,3578732842,4
2,1026,18997,3578732838,3578732842,4
2,1026,18998,3578732838,3578732842,4
2,1026,18999,3578732838,3578732845,7
2,1026,19000,3578732838,3578732846,8
2,1026,19001,3578732838,3578732846,8
2,1026,19002,3578732838,3578732847,9
2,1026,19003,3578732838,3578732847,9
2,1026,19004,3578732838,3578732849,11
2,1026,19005,3578732838,3578732851,13
2,1026,19006,3578732838,3578732853,15
2,1026,19007,3578732838,3578732853,15
2,1026,19008,3578732838,3578732853,15
2,1026,19009,3578732838,3578732853,15
2,1026,19010,3578732838,3578732853,15
2,1026,19011,3578732838,3578732854,16
2,1026,19012,3578732838,3578732857,19
2,1026,19013,3578732838,3578732857,19
2,1026,19014,3578732838,3578732859,21
2,1026,19015,3578732838,3578732859,21
2,1026,19016,3578732838,3578732859,21
2,1026,19017,3578732838,3578732861,23
2,1026,19018,3578732838,3578732865,27
2,1026,19019,3578732838,3578732865,27
2,1026,19020,3578732838,3578732866,28
2,1026,19021,3578732838,3578732866,28
2,1026,19022,3578732838,3578732867,29
2,1026,19023,3578732838,3578732867,29
2,1026,19024,3578732838,3578732867,29
2,1026,19025,3578732838,3578732868,30
2,1026,19026,3578732838,3578732869,31
2,1026,19027,3578732838,3578732869,31
2,1026,19028,3578732838,3578732878,40
2,1026,19029,3578732838,3578732881,43
2,1026,19030,3578732838,3578732882,44
2,1026,19031,3578732838,3578732883,45
2,1026,19032,3578732838,3578732884,46
2,1026,19033,3578732838,3578732884,46
2,1026,19034,3578732838,3578732885,47
2,1026,19035,3578732838,3578732887,49
2,1027,19036,3578732897,3578732897,0
2,1027,19037,3578732897,3578732897,0
2,1027,19038,3578732897,3578732897,0
2,1027,19039,3578732897,3578732897,0
2,1027,19040,3578732897,3578732897,0
2,1027,19041,3578732897,3578732897,0
2,1027,19042,3578732897,3578732897,0
2,1027,19043,3578732897,3578732897,0
2,1027,19044,3578732897,3578732897,0
2,1027,19045,3578732897,3578732897,0
2,1027,19046,3578732897,3578732898,1
2,1027,19047,3578732897,3578732898,1
2,1027,19048,3578732897,3578732898,1
2,1027,19049,3578732897,3578732900,3
2,1027,19050,3578732897,3578732901,4
2,1027,19051,3578732897,3578732902,5
2,1027,19052,3578732897,3578732902,5
2,1027,19053,3578732897,3578732905,8
2,1027,19054,3578732897,3578732905,8
2,1027,19055,3578732897,3578732906,9
2,1027,19056,3578732897,3578732906,9
2,1027,19057,3578732897,3578732907,10
2,1027,19058,3578732897,3578732907,10
2,1027,19059,3578732897,3578732911,14
2,1027,19060,3578732897,3578732911,14
2,1027,19061,3578732897,3578732912,15
2,1027,19062,3578732897,3578732912,15
2,1027,19063,3578732897,3578732912,15
2,1027,19064,3578732897,3578732915,18
2,1027,19065,3578732897,3578732916,19
2,1027,19066,3578732897,3578732917,20
2,1027,19067,3578732897,3578732917,20
2,1027,19068,3578732897,3578732917,20
2,1027,19069,3578732897,3578732918,21
2,1027,19070,3578732897,3578732920,23
2,1027,19071,3578732897,3578732921,24
2,1027,19072,3578732897,3578732921,24
2,1027,19073,3578732897,3578732923,26
2,1027,19074,3578732897,3578732924,27
2,1027,19075,3578732897,3578732924,27
2,1027,19076,3578732897,3578732925,28
2,1027,19077,3578732897,3578732925,28
2,1027,19078,3578732897,3578732927,30
2,1027,19079,3578732897,3578732927,30
2,1027,19080,3578732897,3578732928,31
2,1027,19081,3578732897,3578732930,33
2,1027,19082,3578732897,3578732932,35
2,1027,19083,3578732897,3578732933,36
2,1027,19084,3578732897,3578732933,36
2,1027,19085,3578732897,3578732933,36
2,1027,19086,3578732897,3578732935,38
2,1027,19087,3578732897,3578732935,38
2,1027,19088,3578732897,3578732936,39
2,1027,19089,3578732897,3578732936,39
2,1027,19090,3578732897,3578732936,39
2,1027,19091,3578732897,3578732937,40
2,1027,19092,3578732897,3578732938,41
2,1027,19093,3578732897,3578732941,44
2,1027,19094,3578732897,3578732942,45
2,1027,19095,3578732897,3578732942,45
2,1027,19096,3578732897,3578732943,46
2,1028,19097,3578732955,3578732955,0
2,1028,19098,3578732955,3578732955,0
2,1028,19099,3578732955,3578732955,0
2,1028,19100,3578732955,3578732955,0
2,1028,19101,3578732955,3578732955,0
2,1028,19102,3578732955,3578732955,0
2,1028,19103,3578732955,3578732955,0
2,1028,19104,3578732955,3578732959,4
2,1028,19105,3578732955,3578732960,5
2,1028,19106,3578732955,3578732961,6
2,1028,19107,3578732955,3578732964,9
2,1028,19108,3578732955,3578732965,10
2,1028,19109,3578732955,3578732965,10
2,1028,19110,3578732955,3578732967,12
2,1028,19111,3578732955,3578732968,13
2,1028,19112,3578732955,3578732968,13
2,1028,19113,3578732955,3578732974,19
2,1028,19114,3578732955,3578732974,19
2,1028,19115,3578732955,3578732975,20
2,1028,19116,3578732955,3578732975,20
2,1028,19117,3578732955,3578732976,21
2,1028,19118,3578732955,3578732978,23
2,1028,19119,3578732955,3578732980,25
2,1028,19120,3578732955,3578732980,25
2,1028,19121,3578732955,3578732983,28
2,1028,19122,3578732955,3578732985,30
2,1028,19123,3578732955,3578732989,34
2,1028,19124,3578732955,3578732989,34
2,1028,19125,3578732955,3578732991,36
2,1028,19126,3578732955,3578732991,36
2,1028,19127,3578732955,3578732992,37
2,1028,19128,3578732955,3578732993,38
2,1028,19129,3578732955,3578732995,40
2,1028,19130,3578732955,3578732996,41
2,1028,19131,3578732955,3578732999,44
2,1028,19132,3578732955,3578733002,47
2,1028,19133,3578732955,3578733002,47
2,1028,19134,3578732955,3578733003,48
2,1029,19135,3578733015,3578733015,0
2,1029,19136,3578733015,3578733015,0
2,1029,19137,3578733015,3578733015,0
2,1029,19138,3578733015,3578733015,0
2,1029,19139,3578733015,3578733015,0
2,1029,19140,3578733015,3578733016,1
2,1029,19141,3578733015,3578733016,1
2,1029,19142,3578733015,3578733016,1
2,1029,19143,3578733015,3578733018,3
2,1029,19144,3578733015,3578733020,5
2,1029,19145,3578733015,3578733024,9
2,1029,19146,3578733015,3578733025,10
2,1029,19147,3578733015,3578733026,11
2,1029,19148,3578733015,3578733027,12
2,1029,19149,3578733015,3578733028,13
2,1029,19150,3578733015,3578733028,13
2,1029,19151,3578733015,3578733028,13
2,1029,19152,3578733015,3578733028,13
2,1029,19153,3578733015,3578733029,14
2,1029,19154,3578733015,3578733030,15
2,1029,19155,3578733015,3578733030,15
2,1029,19156,3578733015,3578733032,17
2,1029,19157,3578733015,3578733034,19
2,1029,19158,3578733015,3578733034,19
2,1029,19159,3578733015,3578733035,20
2,1029,19160,3578733015,3578733038,23
2,1029,19161,3578733015,3578733039,24
2,1029,19162,3578733015,3578733040,25
2,1029,19163,3578733015,3578733041,26
2,1029,19164,3578733015,3578733041,26
2,1029,19165,3578733015,3578733041,26
2,1029,19166,3578733015,3578733042,27
2,1029,19167,3578733015,3578733042,27
2,1029,19168,3578733015,3578733042,27
2,1029,19169,3578733015,3578733045,30
2,1029,19170,3578733015,3578733046,31
2,1029,19171,3578733015,3578733047,32
2,1029,19172,3578733015,3578733048,33
2,1029,19173,3578733015,3578733049,34
2,1029,19174,3578733015,3578733053,38
2,1029,19175,3578733015,3578733053,38
2,1029,19176,3578733015,3578733053,38
2,1029,19177,3578733015,3578733054,39
2,1029,19178,3578733015,3578733054,39
2,1029,19179,3578733015,3578733054,39
2,1029,19180,3578733015,3578733057,42
2,1029,19181,3578733015,3578733057,42
2,1029,19182,3578733015,3578733059,44
2,1029,19183,3578733015,3578733060,45
2,1029,19184,3578733015,3578733060,45
2,1029,19185,3578733015,3578733060,45
2,1029,19186,3578733015,3578733061,46
2,1030,19187,3578733075,3578733075,0
2,1030,19188,3578733075,3578733075,0
2,1030,19189,3578733075,3578733075,0
2,1030,19190,3578733075,3578733075,0
2,1030,19191,3578733075,3578733075,0
2,1030,19192,3578733075,3578733075,0
2,1030,19193,3578733075,3578733075,0
2,1030,19194,3578733075,3578733079,4
2,1030,19195,3578733075,3578733080,5
2,1030,19196,3578733075,3578733082,7
2,1030,19197,3578733075,3578733082,7
2,1030,19198,3578733075,3578733085,10
2,1030,19199,3578733075,3578733085,10
2,1030,19200,3578733075,3578733086,11
2,1030,19201,3578733075,3578733090,15
2,1030,19202,3578733075,3578733090,15
2,1030,19203,3578733075,3578733091,16
2,1030,19204,3578733075,3578733092,17
2,1030,19205,3578733075,3578733093,18
2,1030,19206,3578733075,3578733093,18
2,1030,19207,3578733075,3578733094,19
2,1030,19208,3578733075,3578733094,19
2,1030,19209,3578733075,3578733095,20
2,1030,19210,3578733075,3578733096,21
2,1030,19211,3578733075,3578733098,23
2,1030,19212,3578733075,3578733099,24
2,1030,19213,3578733075,3578733100,25
2,1030,19214,3578733075,3578733101,26
2,1030,19215,3578733075,3578733102,27
2,1030,19216,3578733075,3578733106,31
2,1030,19217,3578733075,3578733106,31
2,1030,19218,3578733075,3578733107,32
2,1030,19219,3578733075,3578733107,32
2,1030,19220,3578733075,3578733107,32
2,1030,19221,3578733075,3578733108,33
2,1030,19222,3578733075,3578733111,36
2,1030,19223,3578733075,3578733111,36
2,1030,19224,3578733075,3578733111,36
2,1030,19225,3578733075,3578733112,37
2,1030,19226,3578733075,3578733112,37
2,1030,19227,3578733075,3578733113,38
2,1030,19228,3578733075,3578733115,40
2,1030,19229,3578733075,3578733116,41
2,1030,19230,3578733075,3578733118,43
2,1030,19231,3578733075,3578733118,43
2,1030,19232,3578733075,3578733118,43
2,1030,19233,3578733075,3578733118,43
2,1030,19234,3578733075,3578733118,43
2,1030,19235,3578733075,3578733120,45
2,1030,19236,3578733075,3578733120,45
2,1030,19237,3578733075,3578733121,46
2,1030,19238,3578733075,3578733122,47
2,1030,19239,3578733075,3578733123,48
2,1030,19240,3578733075,3578733125,50
2,1031,19241,3578733136,3578733136,0
2,1031,19242,3578733136,3578733136,0
2,1031,19243,3578733136,3578733136,0
2,1031,19244,3578733136,3578733136,0
2,1031,19245,3578733136,3578733136,0
2,1031,19246,3578733136,3578733136,0
2,1031,19247,3578733136,3578733136,0
2,1031,19248,3578733136,3578733136,0
2,1031,19249,3578733136,3578733136,0
2,1031,19250,3578733136,3578733136,0
2,1031,19251,3578733136,3578733136,0
2,1031,19252,3578733136,3578733136,0
2,1031,19253,3578733136,3578733137,1
2,1031,19254,3578733136,3578733137,1
2,1031,19255,3578733136,3578733137,1
2,1031,19256,3578733136,3578733137,1
2,1031,19257,3578733136,3578733137,1
2,1031,19258,3578733136,3578733139,3
2,1031,19259,3578733136,3578733142,6
2,1031,19260,3578733136,3578733143,7
2,1031,19261,3578733136,3578733143,7
2,1031,19262,3578733136,3578733143,7
2,1031,19263,3578733136,3578733150,14
2,1031,19264,3578733136,3578733151,15
2,1031,19265,3578733136,3578733152,16
2,1031,19266,3578733136,3578733155,19
2,1031,19267,3578733136,3578733156,20
2,1031,19268,3578733136,3578733160,24
2,1031,19269,3578733136,3578733161,25
2,1031,19270,3578733136,3578733162,26
2,1031,19271,3578733136,3578733164,28
2,1031,19272,3578733136,3578733165,29
2,1031,19273,3578733136,3578733165,29
2,1031,19274,3578733136,3578733167,31
2,1031,19275,3578733136,3578733168,32
2,1031,19276,3578733136,3578733168,32
2,1031,19277,3578733136,3578733175,39
2,1031,19278,3578733136,3578733175,39
2,1031,19279,3578733136,3578733176,40
2,1031,19280,3578733136,3578733176,40
2,1031,19281,3578733136,3578733180,44
2,1031,19282,3578733136,3578733181,45
2,1031,19283,3578733136,3578733182,46
2,1031,19284,3578733136,3578733183,47
2,1031,19285,3578733136,3578733185,49
2,1031,19286,3578733136,3578733185,49
2,1032,19287,3578733195,3578733195,0
2,1032,19288,3578733195,3578733195,0
2,1032,19289,3578733195,3578733195,0
2,1032,19290,3578733195,3578733195,0
2,1032,19291,3578733195,3578733195,0
2,1032,19292,3578733195,3578733195,0
2,1032,19293,3578733195,3578733195,0
2,1032,19294,3578733195,3578733196,1
2,1032,19295,3578733195,3578733199,4
2,1032,19296,3578733195,3578733202,7
2,1032,19297,3578733195,3578733203,8
2,1032,19298,3578733195,3578733208,13
2,1032,19299,3578733195,3578733209,14
2,1032,19300,3578733195,3578733212,17
2,1032,19301,3578733195,3578733214,19
2,1032,19302,3578733195,3578733215,20
2,1032,19303,3578733195,3578733216,21
2,1032,19304,3578733195,3578733217,22
2,1032,19305,3578733195,3578733218,23
2,1032,19306,3578733195,3578733221,26
2,1032,19307,3578733195,3578733224,29
2,1032,19308,3578733195,3578733225,30
2,1032,19309,3578733195,3578733227,32
2,1032,19310,3578733195,3578733228,33
2,1032,19311,3578733195,3578733228,33
2,1032,19312,3578733195,3578733229,34
2,1032,19313,3578733195,3578733229,34
2,1032,19314,3578733195,3578733229,34
2,1032,19315,3578733195,3578733231,36
2,1032,19316,3578733195,3578733231,36
2,1032,19317,3578733195,3578733232,37
2,1032,19318,3578733195,3578733234,39
2,1032,19319,3578733195,3578733234,39
2,1032,19320,3578733195,3578733235,40
2,1032,19321,3578733195,3578733237,42
2,1032,19322,3578733195,3578733239,44
2,1032,19323,3578733195,3578733240,45
2,1032,19324,3578733195,3578733241,46
2,1032,19325,3578733195,3578733241,46
2,1032,19326,3578733195,3578733242,47
2,1032,19327,3578733195,3578733242,47
2,1033,19328,3578733252,3578733252,0
2,1033,19329,3578733252,3578733252,0
2,1033,19330,3578733252,3578733252,0
2,1033,19331,3578733252,3578733252,0
2,1033,19332,3578733252,3578733252,0
2,1033,19333,3578733252,3578733252,0
2,1033,19334,3578733252,3578733253,1
2,1033,19335,3578733252,3578733253,1
2,1033,19336,3578733252,3578733253,1
2,1033,19337,3578733252,3578733254,2
2,1033,19338,3578733252,3578733254,2
2,1033,19339,3578733252,3578733255,3
2,1033,19340,3578733252,3578733255,3
2,1033,19341,3578733252,3578733257,5
2,1033,19342,3578733252,3578733259,7
2,1033,19343,3578733252,3578733259,7
2,1033,19344,3578733252,3578733260,8
2,1033,19345,3578733252,3578733260,8
2,1033,19346,3578733252,3578733261,9
2,1033,19347,3578733252,3578733265,13
2,1033,19348,3578733252,3578733266,14
2,1033,19349,3578733252,3578733266,14
2,1033,19350,3578733252,3578733268,16
2,1033,19351,3578733252,3578733268,16
2,1033,19352,3578733252,3578733269,17
2,1033,19353,3578733252,3578733269,17
2,1033,19354,3578733252,3578733269,17
2,1033,19355,3578733252,3578733269,17
2,1033,19356,3578733252,3578733269,17
2,1033,19357,3578733252,3578733279,27
2,1033,19358,3578733252,3578733280,28
2,1033,19359,3578733252,3578733281,29
2,1033,19360,3578733252,3578733283,31
2,1033,19361,3578733252,3578733283,31
2,1033,19362,3578733252,3578733284,32
2,1033,19363,3578733252,3578733285,33
2,1033,19364,3578733252,3578733285,33
2,1033,19365,3578733252,3578733287,35
2,1033,19366,3578733252,3578733290,38
2,1033,19367,3578733252,3578733290,38
2,1033,19368,3578733252,3578733291,39
2,1033,19369,3578733252,3578733292,40
2,1033,19370,3578733252,3578733292,40
2,1033,19371,3578733252,3578733293,41
2,1033,19372,3578733252,3578733293,41
2,1033,19373,3578733252,3578733294,42
2,1033,19374,3578733252,3578733294,42
2,1033,19375,3578733252,3578733295,43
2,1033,19376,3578733252,3578733295,43
2,1033,19377,3578733252,3578733298,46
2,1033,19378,3578733252,3578733300,48
2,1033,19379,3578733252,3578733300,48
2,1033,19380,3578733252,3578733301,49
2,1033,19381,3578733252,3578733301,49
2,1033,19382,3578733252,3578733302,50
2,1034,19383,3578733311,3578733311,0
2,1034,19384,3578733311,3578733311,0
2,1034,19385,3578733311,3578733311,0
2,1034,19386,3578733311,3578733311,0
2,1034,19387,3578733311,3578733311,0
2,1034,19388,3578733311,3578733311,0
2,1034,19389,3578733311,3578733311,0
2,1034,19390,3578733311,3578733311,0
2,1034,19391,3578733311,3578733311,0
2,1034,19392,3578733311,3578733312,1
2,1034,19393,3578733311,3578733312,1
2,1034,19394,3578733311,3578733312,1
2,1034,19395,3578733311,3578733312,1
2,1034,19396,3578733311,3578733313,2
2,1034,19397,3578733311,3578733315,4
2,1034,19398,3578733311,3578733316,5
2,1034,19399,3578733311,3578733318,7
2,1034,19400,3578733311,3578733318,7
2,1034,19401,3578733311,3578733318,7
2,1034,19402,3578733311,3578733319,8
2,1034,19403,3578733311,3578733319,8
2,1034,19404,3578733311,3578733321,10
2,1034,19405,3578733311,3578733322,11
2,1034,19406,3578733311,3578733324,13
2,1034,19407,3578733311,3578733325,14
2,1034,19408,3578733311,3578733326,15
2,1034,19409,3578733311,3578733328,17
2,1034,19410,3578733311,3578733328,17
2,1034,19411,3578733311,3578733329,18
2,1034,19412,3578733311,3578733330,19
2,1034,19413,3578733311,3578733330,19
2,1034,19414,3578733311,3578733333,22
2,1034,19415,3578733311,3578733333,22
2,1034,19416,3578733311,3578733334,23
2,1034,19417,3578733311,3578733335,24
2,1034,19418,3578733311,3578733335,24
2,1034,19419,3578733311,3578733336,25
2,1034,19420,3578733311,3578733337,26
2,1034,19421,3578733311,3578733337,26
2,1034,19422,3578733311,3578733338,27
2,1034,19423,3578733311,3578733338,27
2,1034,19424,3578733311,3578733341,30
2,1034,19425,3578733311,3578733343,32
2,1034,19426,3578733311,3578733343,32
2,1034,19427,3578733311,3578733343,32
2,1034,19428,3578733311,3578733350,39
2,1034,19429,3578733311,3578733351,40
2,1034,19430,3578733311,3578733351,40
2,1034,19431,3578733311,3578733355,44
2,1034,19432,3578733311,3578733355,44
2,1034,19433,3578733311,3578733355,44
2,1034,19434,3578733311,3578733356,45
2,1034,19435,3578733311,3578733357,46
2,1034,19436,3578733311,3578733360,49
2,1035,19437,3578733371,3578733371,0
2,1035,19438,3578733371,3578733371,0
2,1035,19439,3578733371,3578733371,0
2,1035,19440,3578733371,3578733371,0
2,1035,19441,3578733371,3578733371,0
2,1035,19442,3578733371,3578733371,0
2,1035,19443,3578733371,3578733371,0
2,1035,19444,3578733371,3578733371,0
2,1035,19445,3578733371,3578733375,4
2,1035,19446,3578733371,3578733375,4
2,1035,19447,3578733371,3578733376,5
2,1035,19448,3578733371,3578733376,5
2,1035,19449,3578733371,3578733376,5
2,1035,19450,3578733371,3578733379,8
2,1035,19451,3578733371,3578733380,9
2,1035,19452,3578733371,3578733381,10
2,1035,19453,3578733371,3578733381,10
2,1035,19454,3578733371,3578733383,12
2,1035,19455,3578733371,3578733386,15
2,1035,19456,3578733371,3578733390,19
2,1035,19457,3578733371,3578733390,19
2,1035,19458,3578733371,3578733391,20
2,1035,19459,3578733371,3578733392,21
2,1035,19460,3578733371,3578733394,23
2,1035,19461,3578733371,3578733394,23
2,1035,19462,3578733371,3578733395,24
2,1035,19463,3578733371,3578733397,26
2,1035,19464,3578733371,3578733399,28
2,1035,19465,3578733371,3578733402,31
2,1035,19466,3578733371,3578733402,31
2,1035,19467,3578733371,3578733403,32
2,1035,19468,3578733371,3578733406,35
2,1035,19469,3578733371,3578733408,37
2,1035,19470,3578733371,3578733410,39
2,1035,19471,3578733371,3578733412,41
2,1035,19472,3578733371,3578733413,42
2,1035,19473,3578733371,3578733416,45
2,1035,19474,3578733371,3578733417,46
2,1035,19475,3578733371,3578733417,46
2,1035,19476,3578733371,3578733418,47
2,1035,19477,3578733371,3578733421,50
2,1036,19478,3578733431,3578733431,0
2,1036,19479,3578733431,3578733431,0
2,1036,19480,3578733431,3578733431,0
2,1036,19481,3578733431,3578733431,0
2,1036,19482,3578733431,3578733431,0
2,1036,19483,3578733431,3578733431,0
2,1036,19484,3578733431,3578733431,0
2,1036,19485,3578733431,3578733431,0
2,1036,19486,3578733431,3578733432,1
2,1036,19487,3578733431,3578733433,2
2,1036,19488,3578733431,3578733434,3
2,1036,19489,3578733431,3578733434,3
2,1036,19490,3578733431,3578733435,4
2,1036,19491,3578733431,3578733437,6
2,1036,19492,3578733431,3578733439,8
2,1036,19493,3578733431,3578733440,9
2,1036,19494,3578733431,3578733441,10
2,1036,19495,3578733431,3578733441,10
2,1036,19496,3578733431,3578733442,11
2,1036,19497,3578733431,3578733442,11
2,1036,19498,3578733431,3578733442,11
2,1036,19499,3578733431,3578733442,11
2,1036,19500,3578733431,3578733447,16
2,1036,19501,3578733431,3578733449,18
2,1036,19502,3578733431,3578733449,18
2,1036,19503,3578733431,3578733450,19
2,1036,19504,3578733431,3578733453,22
2,1036,19505,3578733431,3578733453,22
2,1036,19506,3578733431,3578733453,22
2,1036,19507,3578733431,3578733455,24
2,1036,19508,3578733431,3578733455,24
2,1036,19509,3578733431,3578733456,25
2,1036,19510,3578733431,3578733457,26
2,1036,19511,3578733431,3578733458,27
2,1036,19512,3578733431,3578733459,28
2,1036,19513,3578733431,3578733459,28
2,1036,19514,3578733431,3578733459,28
2,1036,19515,3578733431,3578733461,30
2,1036,19516,3578733431,3578733461,30
2,1036,19517,3578733431,3578733465,34
2,1036,19518,3578733431,3578733466,35
2,1036,19519,3578733431,3578733467,36
2,1036,19520,3578733431,3578733468,37
2,1036,19521,3578733431,3578733469,38
2,1036,19522,3578733431,3578733469,38
2,1036,19523,3578733431,3578733470,39
2,1036,19524,3578733431,3578733480,49
2,1036,19525,3578733431,3578733480,49
2,1036,19526,3578733431,3578733480,49
2,1037,19527,3578733492,3578733492,0
2,1037,19528,3578733492,3578733492,0
2,1037,19529,3578733492,3578733492,0
2,1037,19530,3578733492,3578733492,0
2,1037,19531,3578733492,3578733492,0
2,1037,19532,3578733492,3578733492,0
2,1037,19533,3578733492,3578733492,0
2,1037,19534,3578733492,3578733492,0
2,1037,19535,3578733492,3578733492,0
2,1037,19536,3578733492,3578733492,0
2,1037,19537,3578733492,3578733492,0
2,1037,19538,3578733492,3578733493,1
2,1037,19539,3578733492,3578733494,2
2,1037,19540,3578733492,3578733495,3
2,1037,19541,3578733492,3578733495,3
2,1037,19542,3578733492,3578733497,5
2,1037,19543,3578733492,3578733499,7
2,1037,19544,3578733492,3578733500,8
2,1037,19545,3578733492,3578733500,8
2,1037,19546,3578733492,3578733500,8
2,1037,19547,3578733492,3578733501,9
2,1037,19548,3578733492,3578733502,10
2,1037,19549,3578733492,3578733505,13
2,1037,19550,3578733492,3578733505,13
2,1037,19551,3578733492,3578733506,14
2,1037,19552,3578733492,3578733507,15
2,1037,19553,3578733492,3578733507,15
2,1037,19554,3578733492,3578733508,16
2,1037,19555,3578733492,3578733508,16
2,1037,19556,3578733492,3578733510,18
2,1037,19557,3578733492,3578733511,19
2,1037,19558,3578733492,3578733511,19
2,1037,19559,3578733492,3578733511,19
2,1037,19560,3578733492,3578733512,20
2,1037,19561,3578733492,3578733514,22
2,1037,19562,3578733492,3578733515,23
2,1037,19563,3578733492,3578733517,25
2,1037,19564,3578733492,3578733517,25
2,1037,19565,3578733492,3578733518,26
2,1037,19566,3578733492,3578733518,26
2,1037,19567,3578733492,3578733518,26
2,1037,19568,3578733492,3578733519,27
2,1037,19569,3578733492,3578733520,28
2,1037,19570,3578733492,3578733520,28
2,1037,19571,3578733492,3578733520,28
2,1037,19572,3578733492,3578733521,29
2,1037,19573,3578733492,3578733521,29
2,1037,19574,3578733492,3578733522,30
2,1037,19575,3578733492,3578733524,32
2,1037,19576,3578733492,3578733524,32
2,1037,19577,3578733492,3578733525,33
2,1037,19578,3578733492,3578733527,35
2,1037,19579,3578733492,3578733529,37
2,1037,19580,3578733492,3578733529,37
2,1037,19581,3578733492,3578733530,38
2,1037,19582,3578733492,3578733532,40
2,1037,19583,3578733492,3578733532,40
2,1037,19584,3578733492,3578733533,41
2,1037,19585,3578733492,3578733533,41
2,1037,19586,3578733492,3578733533,41
2,1037,19587,3578733492,3578733534,42
2,1037,19588,3578733492,3578733536,44
2,1037,19589,3578733492,3578733537,45
2,1037,19590,3578733492,3578733537,45
2,1037,19591,3578733492,3578733537,45
2,1037,19592,3578733492,3578733540,48
2,1038,19593,3578733551,3578733551,0
2,1038,19594,3578733551,3578733551,0
2,1038,19595,3578733551,3578733551,0
2,1038,19596,3578733551,3578733551,0
2,1038,19597,3578733551,3578733551,0
2,1038,19598,3578733551,3578733551,0
2,1038,19599,3578733551,3578733551,0
2,1038,19600,3578733551,3578733551,0
2,1038,19601,3578733551,3578733553,2
2,1038,19602,3578733551,3578733554,3
2,1038,19603,3578733551,3578733554,3
2,1038,19604,3578733551,3578733556,5
2,1038,19605,3578733551,3578733559,8
2,1038,19606,3578733551,3578733560,9
2,1038,19607,3578733551,3578733561,10
2,1038,19608,3578733551,3578733562,11
2,1038,19609,3578733551,3578733562,11
2,1038,19610,3578733551,3578733563,12
2,1038,19611,3578733551,3578733565,14
2,1038,19612,3578733551,3578733565,14
2,1038,19613,3578733551,3578733568,17
2,1038,19614,3578733551,3578733568,17
2,1038,19615,3578733551,3578733570,19
2,1038,19616,3578733551,3578733570,19
2,1038,19617,3578733551,3578733574,23
2,1038,19618,3578733551,3578733575,24
2,1038,19619,3578733551,3578733575,24
2,1038,19620,3578733551,3578733575,24
2,1038,19621,3578733551,3578733575,24
2,1038,19622,3578733551,3578733580,29
2,1038,19623,3578733551,3578733581,30
2,1038,19624,3578733551,3578733583,32
2,1038,19625,3578733551,3578733585,34
2,1038,19626,3578733551,3578733588,37
2,1038,19627,3578733551,3578733589,38
2,1038,19628,3578733551,3578733589,38
2,1038,19629,3578733551,3578733591,40
2,1038,19630,3578733551,3578733593,42
2,1038,19631,3578733551,3578733594,43
2,1038,19632,3578733551,3578733594,43
2,1038,19633,3578733551,3578733594,43
2,1038,19634,3578733551,3578733596,45
2,1038,19635,3578733551,3578733598,47
2,1038,19636,3578733551,3578733600,49
2,1038,19637,3578733551,3578733601,50
2,1039,19638,3578733610,3578733610,0
2,1039,19639,3578733610,3578733610,0
2,1039,19640,3578733610,3578733612,2
2,1039,19641,3578733610,3578733613,3
2,1039,19642,3578733610,3578733615,5
2,1039,19643,3578733610,3578733617,7
2,1039,19644,3578733610,3578733618,8
2,1039,19645,3578733610,3578733621,11
2,1039,19646,3578733610,3578733621,11
2,1039,19647,3578733610,3578733624,14
2,1039,19648,3578733610,3578733626,16
2,1039,19649,3578733610,3578733628,18
2,1039,19650,3578733610,3578733628,18
2,1039,19651,3578733610,3578733628,18
2,1039,19652,3578733610,3578733628,18
2,1039,19653,3578733610,3578733628,18
2,1039,19654,3578733610,3578733629,19
2,1039,19655,3578733610,3578733632,22
2,1039,19656,3578733610,3578733632,22
2,1039,19657,3578733610,3578733632,22
2,1039,19658,3578733610,3578733634,24
2,1039,19659,3578733610,3578733637,27
2,1039,19660,3578733610,3578733638,28
2,1039,19661,3578733610,3578733639,29
2,1039,19662,3578733610,3578733640,30
2,1039,19663,3578733610,3578733641,31
2,1039,19664,3578733610,3578733641,31
2,1039,19665,3578733610,3578733642,32
2,1039,19666,3578733610,3578733646,36
2,1039,19667,3578733610,3578733647,37
2,1039,19668,3578733610,3578733648,38
2,1039,19669,3578733610,3578733648,38
2,1039,19670,3578733610,3578733651,41
2,1039,19671,3578733610,3578733652,42
2,1039,19672,3578733610,3578733652,42
2,1039,19673,3578733610,3578733653,43
2,1039,19674,3578733610,3578733654,44
2,1039,19675,3578733610,3578733654,44
2,1039,19676,3578733610,3578733655,45
2,1039,19677,3578733610,3578733656,46
2,1039,19678,3578733610,3578733658,48
2,1039,19679,3578733610,3578733658,48
2,1039,19680,3578733610,3578733659,49
2,1040,19681,3578733669,3578733669,0
2,1040,19682,3578733669,3578733669,0
2,1040,19683,3578733669,3578733669,0
2,1040,19684,3578733669,3578733669,0
2,1040,19685,3578733669,3578733669,0
2,1040,19686,3578733669,3578733669,0
2,1040,19687,3578733669,3578733669,0
2,1040,19688,3578733669,3578733669,0
2,1040,19689,3578733669,3578733669,0
2,1040,19690,3578733669,3578733669,0
2,1040,19691,3578733669,3578733669,0
2,1040,19692,3578733669,3578733680,11
2,1040,19693,3578733669,3578733680,11
2,1040,19694,3578733669,3578733682,13
2,1040,19695,3578733669,3578733683,14
2,1040,19696,3578733669,3578733683,14
2,1040,19697,3578733669,3578733684,15
2,1040,19698,3578733669,3578733684,15
2,1040,19699,3578733669,3578733685,16
2,1040,19700,3578733669,3578733686,17
2,1040,19701,3578733669,3578733689,20
2,1040,19702,3578733669,3578733689,20
2,1040,19703,3578733669,3578733690,21
2,1040,19704,3578733669,3578733690,21
2,1040,19705,3578733669,3578733691,22
2,1040,19706,3578733669,3578733692,23
2,1040,19707,3578733669,3578733693,24
2,1040,19708,3578733669,3578733693,24
2,1040,19709,3578733669,3578733694,25
2,1040,19710,3578733669,3578733694,25
2,1040,19711,3578733669,3578733696,27
2,1040,19712,3578733669,3578733697,28
2,1040,19713,3578733669,3578733698,29
2,1040,19714,3578733669,3578733700,31
2,1040,19715,3578733669,3578733700,31
2,1040,19716,3578733669,3578733700,31
2,1040,19717,3578733669,3578733700,31
2,1040,19718,3578733669,3578733701,32
2,1040,19719,3578733669,3578733702,33
2,1040,19720,3578733669,3578733705,36
2,1040,19721,3578733669,3578733705,36
2,1040,19722,3578733669,3578733706,37
2,1040,19723,3578733669,3578733708,39
2,1040,19724,3578733669,3578733709,40
2,1040,19725,3578733669,3578733709,40
2,1040,19726,3578733669,3578733710,41
2,1040,19727,3578733669,3578733711,42
2,1040,19728,3578733669,3578733711,42
2,1040,19729,3578733669,3578733713,44
2,1040,19730,3578733669,3578733714,45
2,1040,19731,3578733669,3578733715,46
2,1040,19732,3578733669,3578733717,48
2,1040,19733,3578733669,3578733717,48
2,1040,19734,3578733669,3578733717,48
2,1040,19735,3578733669,3578733718,49
2,1040,19736,3578733669,3578733718,49
2,1040,19737,3578733669,3578733719,50
2,1041,19738,3578733727,3578733727,0
2,1041,19739,3578733727,3578733727,0
2,1041,19740,3578733727,3578733727,0
2,1041,19741,3578733727,3578733727,0
2,1041,19742,3578733727,3578733727,0
2,1041,19743,3578733727,3578733727,0
2,1041,19744,3578733727,3578733727,0
2,1041,19745,3578733727,3578733727,0
2,1041,19746,3578733727,3578733728,1
2,1041,19747,3578733727,3578733728,1
2,1041,19748,3578733727,3578733728,1
2,1041,19749,3578733727,3578733730,3
2,1041,19750,3578733727,3578733730,3
2,1041,19751,3578733727,3578733731,4
2,1041,19752,3578733727,3578733732,5
2,1041,19753,3578733727,3578733733,6
2,1041,19754,3578733727,3578733733,6
2,1041,19755,3578733727,3578733734,7
2,1041,19756,3578733727,3578733735,8
2,1041,19757,3578733727,3578733735,8
2,1041,19758,3578733727,3578733737,10
2,1041,19759,3578733727,3578733737,10
2,1041,19760,3578733727,3578733737,10
2,1041,19761,3578733727,3578733737,10
2,1041,19762,3578733727,3578733739,12
2,1041,19763,3578733727,3578733740,13
2,1041,19764,3578733727,3578733742,15
2,1041,19765,3578733727,3578733743,16
2,1041,19766,3578733727,3578733743,16
2,1041,19767,3578733727,3578733749,22
2,1041,19768,3578733727,3578733751,24
2,1041,19769,3578733727,3578733751,24
2,1041,19770,3578733727,3578733753,26
2,1041,19771,3578733727,3578733754,27
2,1041,19772,3578733727,3578733754,27
2,1041,19773,3578733727,3578733756,29
2,1041,19774,3578733727,3578733758,31
2,1041,19775,3578733727,3578733760,33
2,1041,19776,3578733727,3578733761,34
2,1041,19777,3578733727,3578733762,35
2,1041,19778,3578733727,3578733763,36
2,1041,19779,3578733727,3578733764,37
2,1041,19780,3578733727,3578733766,39
2,1041,19781,3578733727,3578733768,41
2,1041,19782,3578733727,3578733769,42
2,1041,19783,3578733727,3578733769,42
2,1041,19784,3578733727,3578733771,44
2,1041,19785,3578733727,3578733774,47
2,1041,19786,3578733727,3578733774,47
2,1041,19787,3578733727,3578733775,48
2,1041,19788,3578733727,3578733775,48
2,1041,19789,3578733727,3578733775,48
2,1042,19790,3578733790,3578733790,0
2,1042,19791,3578733790,3578733790,0
2,1042,19792,3578733790,3578733790,0
2,1042,19793,3578733790,3578733790,0
2,1042,19794,3578733790,3578733790,0
2,1042,19795,3578733790,3578733790,0
2,1042,19796,3578733790,3578733790,0
2,1042,19797,3578733790,3578733790,0
2,1042,19798,3578733790,3578733790,0
2,1042,19799,3578733790,3578733790,0
2,1042,19800,3578733790,3578733790,0
2,1042,19801,3578733790,3578733791,1
2,1042,19802,3578733790,3578733793,3
2,1042,19803,3578733790,3578733793,3
2,1042,19804,3578733790,3578733794,4
2,1042,19805,3578733790,3578733795,5
2,1042,19806,3578733790,3578733795,5
2,1042,19807,3578733790,3578733796,6
2,1042,19808,3578733790,3578733801,11
2,1042,19809,3578733790,3578733801,11
2,1042,19810,3578733790,3578733804,14
2,1042,19811,3578733790,3578733806,16
2,1042,19812,3578733790,3578733809,19
2,1042,19813,3578733790,3578733809,19
2,1042,19814,3578733790,3578733813,23
2,1042,19815,3578733790,3578733814,24
2,1042,19816,3578733790,3578733816,26
2,1042,19817,3578733790,3578733816,26
2,1042,19818,3578733790,3578733817,27
2,1042,19819,3578733790,3578733817,27
2,1042,19820,3578733790,3578733821,31
2,1042,19821,3578733790,3578733826,36
2,1042,19822,3578733790,3578733827,37
2,1042,19823,3578733790,3578733827,37
2,1042,19824,3578733790,3578733828,38
2,1042,19825,3578733790,3578733828,38
2,1042,19826,3578733790,3578733828,38
2,1042,19827,3578733790,3578733830,40
2,1042,19828,3578733790,3578733830,40
2,1042,19829,3578733790,3578733832,42
2,1042,19830,3578733790,3578733833,43
2,1042,19831,3578733790,3578733833,43
2,1042,19832,3578733790,3578733834,44
2,1042,19833,3578733790,3578733838,48
2,1042,19834,3578733790,3578733839,49
2,1042,19835,3578733790,3578733839,49
2,1043,19836,3578733853,3578733853,0
2,1043,19837,3578733853,3578733853,0
2,1043,19838,3578733853,3578733853,0
2,1043,19839,3578733853,3578733853,0
2,1043,19840,3578733853,3578733853,0
2,1043,19841,3578733853,3578733853,0
2,1043,19842,3578733853,3578733853,0
2,1043,19843,3578733853,3578733853,0
2,1043,19844,3578733853,3578733853,0
2,1043,19845,3578733853,3578733853,0
2,1043,19846,3578733853,3578733853,0
2,1043,19847,3578733853,3578733853,0
2,1043,19848,3578733853,3578733853,0
2,1043,19849,3578733853,3578733854,1
2,1043,19850,3578733853,3578733854,1
2,1043,19851,3578733853,3578733857,4
2,1043,19852,3578733853,3578733857,4
2,1043,19853,3578733853,3578733857,4
2,1043,19854,3578733853,3578733858,5
2,1043,19855,3578733853,3578733858,5
2,1043,19856,3578733853,3578733859,6
2,1043,19857,3578733853,3578733860,7
2,1043,19858,3578733853,3578733861,8
2,1043,19859,3578733853,3578733864,11
2,1043,19860,3578733853,3578733866,13
2,1043,19861,3578733853,3578733866,13
2,1043,19862,3578733853,3578733868,15
2,1043,19863,3578733853,3578733868,15
2,1043,19864,3578733853,3578733869,16
2,1043,19865,3578733853,3578733870,17
2,1043,19866,3578733853,3578733870,17
2,1043,19867,3578733853,3578733880,27
2,1043,19868,3578733853,3578733881,28
2,1043,19869,3578733853,3578733882,29
2,1043,19870,3578733853,3578733882,29
2,1043,19871,3578733853,3578733883,30
2,1043,19872,3578733853,3578733884,31
2,1043,19873,3578733853,3578733884,31
2,1043,19874,3578733853,3578733886,33
2,1043,19875,3578733853,3578733889,36
2,1043,19876,3578733853,3578733889,36
2,1043,19877,3578733853,3578733891,38
2,1043,19878,3578733853,3578733891,38
2,1043,19879,3578733853,3578733891,38
2,1043,19880,3578733853,3578733892,39
2,1043,19881,3578733853,3578733892,39
2,1043,19882,3578733853,3578733893,40
2,1043,19883,3578733853,3578733894,41
2,1043,19884,3578733853,3578733894,41
2,1043,19885,3578733853,3578733895,42
2,1043,19886,3578733853,3578733897,44
2,1043,19887,3578733853,3578733897,44
2,1043,19888,3578733853,3578733900,47
2,1043,19889,3578733853,3578733900,47
2,1043,19890,3578733853,3578733900,47
2,1043,19891,3578733853,3578733901,48
2,1043,19892,3578733853,3578733902,49
2,1044,19893,3578734010,3578734010,0
2,1044,19894,3578734010,3578734010,0
2,1044,19895,3578734010,3578734010,0
2,1044,19896,3578734010,3578734010,0
2,1044,19897,3578734010,3578734010,0
2,1044,19898,3578734010,3578734010,0
2,1044,19899,3578734010,3578734010,0
2,1044,19900,3578734010,3578734010,0
2,1044,19901,3578734010,3578734010,0
2,1044,19902,3578734010,3578734010,0
2,1044,19903,3578734010,3578734010,0
2,1044,19904,3578734010,3578734010,0
2,1044,19905,3578734010,3578734010,0
2,1044,19906,3578734010,3578734010,0
2,1044,19907,3578734010,3578734010,0
2,1044,19908,3578734010,3578734010,0
2,1044,19909,3578734010,3578734010,0
2,1044,19910,3578734010,3578734010,0
2,1044,19911,3578734010,3578734010,0
2,1044,19912,3578734010,3578734011,1
2,1044,19913,3578734010,3578734011,1
2,1044,19914,3578734010,3578734011,1
2,1044,19915,3578734010,3578734011,1
2,1044,19916,3578734010,3578734011,1
2,1044,19917,3578734010,3578734011,1
2,1044,19918,3578734010,3578734011,1
2,1044,19919,3578734010,3578734011,1
2,1044,19920,3578734010,3578734011,1
2,1044,19921,3578734010,3578734011,1
2,1044,19922,3578734010,3578734011,1
2,1044,19923,3578734010,3578734011,1
2,1044,19924,3578734010,3578734011,1
2,1044,19925,3578734010,3578734011,1
2,1044,19926,3578734010,3578734011,1
2,1044,19927,3578734010,3578734011,1
2,1044,19928,3578734010,3578734011,1
2,1044,19929,3578734010,3578734011,1
2,1044,19930,3578734010,3578734011,1
2,1044,19931,3578734010,3578734011,1
2,1044,19932,3578734010,3578734011,1
2,1044,19933,3578734010,3578734011,1
2,1044,19934,3578734010,3578734011,1
2,1044,19935,3578734010,3578734011,1
2,1044,19936,3578734010,3578734011,1
2,1044,19937,3578734010,3578734011,1
2,1044,19938,3578734010,3578734011,1
2,1044,19939,3578734010,3578734011,1
2,1044,19940,3578734010,3578734011,1
2,1044,19941,3578734010,3578734011,1
2,1044,19942,3578734010,3578734011,1
2,1044,19943,3578734010,3578734011,1
2,1044,19944,3578734010,3578734011,1
2,1044,19945,3578734010,3578734011,1
2,1044,19946,3578734010,3578734011,1
2,1044,19947,3578734010,3578734011,1
2,1044,19948,3578734010,3578734011,1
2,1044,19949,3578734010,3578734011,1
2,1044,19950,3578734010,3578734011,1
2,1044,19951,3578734010,3578734011,1
2,1044,19952,3578734010,3578734011,1
2,1044,19953,3578734010,3578734011,1
2,1044,19954,3578734010,3578734011,1
2,1044,19955,3578734010,3578734011,1
2,1044,19956,3578734010,3578734011,1
2,1044,19957,3578734010,3578734011,1
2,1044,19958,3578734010,3578734011,1
2,1044,19959,3578734010,3578734011,1
2,1044,19960,3578734010,3578734011,1
2,1044,19961,3578734010,3578734011,1
2,1044,19962,3578734010,3578734011,1
2,1044,19963,3578734010,3578734011,1
2,1044,19964,3578734010,3578734011,1
2,1044,19965,3578734010,3578734011,1
2,1044,19966,3578734010,3578734011,1
2,1044,19967,3578734010,3578734011,1
2,1044,19968,3578734010,3578734011,1
2,1044,19969,3578734010,3578734011,1
2,1044,19970,3578734010,3578734011,1
2,1044,19971,3578734010,3578734011,1
2,1044,19972,3578734010,3578734011,1
2,1044,19973,3578734010,3578734011,1
2,1044,19974,3578734010,3578734011,1
2,1044,19975,3578734010,3578734011,1
2,1044,19976,3578734010,3578734011,1
2,1044,19977,3578734010,3578734011,1
2,1044,19978,3578734010,3578734011,1
2,1044,19979,3578734010,3578734011,1
2,1044,19980,3578734010,3578734011,1
2,1044,19981,3578734010,3578734011,1
2,1044,19982,3578734010,3578734011,1
2,1044,19983,3578734010,3578734011,1
2,1044,19984,3578734010,3578734011,1
2,1044,19985,3578734010,3578734011,1
2,1044,19986,3578734010,3578734011,1
2,1044,19987,3578734010,3578734013,3
2,1044,19988,3578734010,3578734014,4
2,1044,19989,3578734010,3578734015,5
2,1044,19990,3578734010,3578734016,6
2,1044,19991,3578734010,3578734017,7
2,1044,19992,3578734010,3578734017,7
2,1044,19993,3578734010,3578734022,12
2,1044,19994,3578734010,3578734024,14
2,1044,19995,3578734010,3578734026,16
2,1044,19996,3578734010,3578734027,17
2,1044,19997,3578734010,3578734027,17
2,1044,19998,3578734010,3578734028,18
2,1044,19999,3578734010,3578734028,18
2,1044,20000,3578734010,3578734029,19
2,1044,20001,3578734010,3578734029,19
2,1044,20002,3578734010,3578734031,21
2,1044,20003,3578734010,3578734032,22
2,1044,20004,3578734010,3578734033,23
2,1044,20005,3578734010,3578734033,23
2,1044,20006,3578734010,3578734033,23
2,1044,20007,3578734010,3578734035,25
2,1044,20008,3578734010,3578734037,27
2,1044,20009,3578734010,3578734039,29
2,1044,20010,3578734010,3578734039,29
2,1044,20011,3578734010,3578734041,31
2,1044,20012,3578734010,3578734041,31
2,1044,20013,3578734010,3578734042,32
2,1044,20014,3578734010,3578734042,32
2,1044,20015,3578734010,3578734042,32
2,1044,20016,3578734010,3578734042,32
2,1044,20017,3578734010,3578734046,36
2,1044,20018,3578734010,3578734046,36
2,1044,20019,3578734010,3578734049,39
2,1044,20020,3578734010,3578734049,39
2,1044,20021,3578734010,3578734049,39
2,1044,20022,3578734010,3578734052,42
2,1044,20023,3578734010,3578734053,43
2,1044,20024,3578734010,3578734053,43
2,1044,20025,3578734010,3578734054,44
2,1044,20026,3578734010,3578734054,44
2,1044,20027,3578734010,3578734054,44
2,1044,20028,3578734010,3578734057,47
2,1044,20029,3578734010,3578734057,47
2,1044,20030,3578734010,3578734057,47
2,1044,20031,3578734010,3578734058,48
2,1044,20032,3578734010,3578734059,49
2,1044,20033,3578734010,3578734059,49
2,1044,20034,3578734010,3578734060,50
2,1045,20035,3578734070,3578734070,0
2,1045,20036,3578734070,3578734070,0
2,1045,20037,3578734070,3578734070,0
2,1045,20038,3578734070,3578734070,0
2,1045,20039,3578734070,3578734070,0
2,1045,20040,3578734070,3578734070,0
2,1045,20041,3578734070,3578734070,0
2,1045,20042,3578734070,3578734070,0
2,1045,20043,3578734070,3578734070,0
2,1045,20044,3578734070,3578734080,10
2,1045,20045,3578734070,3578734080,10
2,1045,20046,3578734070,3578734082,12
2,1045,20047,3578734070,3578734082,12
2,1045,20048,3578734070,3578734082,12
2,1045,20049,3578734070,3578734083,13
2,1045,20050,3578734070,3578734084,14
2,1045,20051,3578734070,3578734085,15
2,1045,20052,3578734070,3578734085,15
2,1045,20053,3578734070,3578734085,15
2,1045,20054,3578734070,3578734086,16
2,1045,20055,3578734070,3578734086,16
2,1045,20056,3578734070,3578734089,19
2,1045,20057,3578734070,3578734089,19
2,1045,20058,3578734070,3578734091,21
2,1045,20059,3578734070,3578734091,21
2,1045,20060,3578734070,3578734092,22
2,1045,20061,3578734070,3578734092,22
2,1045,20062,3578734070,3578734092,22
2,1045,20063,3578734070,3578734093,23
2,1045,20064,3578734070,3578734094,24
2,1045,20065,3578734070,3578734094,24
2,1045,20066,3578734070,3578734095,25
2,1045,20067,3578734070,3578734096,26
2,1045,20068,3578734070,3578734097,27
2,1045,20069,3578734070,3578734098,28
2,1045,20070,3578734070,3578734099,29
2,1045,20071,3578734070,3578734100,30
2,1045,20072,3578734070,3578734100,30
2,1045,20073,3578734070,3578734100,30
2,1045,20074,3578734070,3578734101,31
2,1045,20075,3578734070,3578734105,35
2,1045,20076,3578734070,3578734106,36
2,1045,20077,3578734070,3578734107,37
2,1045,20078,3578734070,3578734107,37
2,1045,20079,3578734070,3578734108,38
2,1045,20080,3578734070,3578734109,39
2,1045,20081,3578734070,3578734111,41
2,1045,20082,3578734070,3578734112,42
2,1045,20083,3578734070,3578734112,42
2,1045,20084,3578734070,3578734112,42
2,1045,20085,3578734070,3578734113,43
2,1045,20086,3578734070,3578734114,44
2,1045,20087,3578734070,3578734115,45
2,1045,20088,3578734070,3578734116,46
2,1045,20089,3578734070,3578734118,48
2,1045,20090,3578734070,3578734118,48
2,1045,20091,3578734070,3578734119,49
2,1045,20092,3578734070,3578734119,49
2,1045,20093,3578734070,3578734120,50
2,1046,20094,3578734129,3578734129,0
2,1046,20095,3578734129,3578734129,0
2,1046,20096,3578734129,3578734129,0
2,1046,20097,3578734129,3578734129,0
2,1046,20098,3578734129,3578734129,0
2,1046,20099,3578734129,3578734129,0
2,1046,20100,3578734129,3578734129,0
2,1046,20101,3578734129,3578734129,0
2,1046,20102,3578734129,3578734129,0
2,1046,20103,3578734129,3578734129,0
2,1046,20104,3578734129,3578734129,0
2,1046,20105,3578734129,3578734131,2
2,1046,20106,3578734129,3578734132,3
2,1046,20107,3578734129,3578734133,4
2,1046,20108,3578734129,3578734134,5
2,1046,20109,3578734129,3578734135,6
2,1046,20110,3578734129,3578734135,6
2,1046,20111,3578734129,3578734137,8
2,1046,20112,3578734129,3578734137,8
2,1046,20113,3578734129,3578734137,8
2,1046,20114,3578734129,3578734138,9
2,1046,20115,3578734129,3578734139,10
2,1046,20116,3578734129,3578734139,10
2,1046,20117,3578734129,3578734139,10
2,1046,20118,3578734129,3578734143,14
2,1046,20119,3578734129,3578734144,15
2,1046,20120,3578734129,3578734144,15
2,1046,20121,3578734129,3578734149,20
2,1046,20122,3578734129,3578734151,22
2,1046,20123,3578734129,3578734151,22
2,1046,20124,3578734129,3578734155,26
2,1046,20125,3578734129,3578734155,26
2,1046,20126,3578734129,3578734155,26
2,1046,20127,3578734129,3578734155,26
2,1046,20128,3578734129,3578734158,29
2,1046,20129,3578734129,3578734161,32
2,1046,20130,3578734129,3578734162,33
2,1046,20131,3578734129,3578734163,34
2,1046,20132,3578734129,3578734164,35
2,1046,20133,3578734129,3578734165,36
2,1046,20134,3578734129,3578734165,36
2,1046,20135,3578734129,3578734165,36
2,1046,20136,3578734129,3578734167,38
2,1046,20137,3578734129,3578734168,39
2,1046,20138,3578734129,3578734169,40
2,1046,20139,3578734129,3578734171,42
2,1046,20140,3578734129,3578734174,45
2,1046,20141,3578734129,3578734174,45
2,1046,20142,3578734129,3578734175,46
2,1046,20143,3578734129,3578734176,47
2,1046,20144,3578734129,3578734177,48
2,1047,20145,3578734187,3578734187,0
2,1047,20146,3578734187,3578734187,0
2,1047,20147,3578734187,3578734187,0
2,1047,20148,3578734187,3578734187,0
2,1047,20149,3578734187,3578734187,0
2,1047,20150,3578734187,3578734188,1
2,1047,20151,3578734187,3578734190,3
2,1047,20152,3578734187,3578734190,3
2,1047,20153,3578734187,3578734190,3
2,1047,20154,3578734187,3578734194,7
2,1047,20155,3578734187,3578734194,7
2,1047,20156,3578734187,3578734195,8
2,1047,20157,3578734187,3578734195,8
2,1047,20158,3578734187,3578734195,8
2,1047,20159,3578734187,3578734198,11
2,1047,20160,3578734187,3578734201,14
2,1047,20161,3578734187,3578734204,17
2,1047,20162,3578734187,3578734204,17
2,1047,20163,3578734187,3578734206,19
2,1047,20164,3578734187,3578734208,21
2,1047,20165,3578734187,3578734210,23
2,1047,20166,3578734187,3578734213,26
2,1047,20167,3578734187,3578734214,27
2,1047,20168,3578734187,3578734216,29
2,1047,20169,3578734187,3578734216,29
2,1047,20170,3578734187,3578734217,30
2,1047,20171,3578734187,3578734221,34
2,1047,20172,3578734187,3578734225,38
2,1047,20173,3578734187,3578734227,40
2,1047,20174,3578734187,3578734227,40
2,1047,20175,3578734187,3578734227,40
2,1047,20176,3578734187,3578734229,42
2,1047,20177,3578734187,3578734229,42
2,1047,20178,3578734187,3578734231,44
2,1047,20179,3578734187,3578734232,45
2,1047,20180,3578734187,3578734233,46
2,1047,20181,3578734187,3578734233,46
2,1047,20182,3578734187,3578734234,47
2,1047,20183,3578734187,3578734236,49
2,1048,20184,3578734245,3578734245,0
2,1048,20185,3578734245,3578734245,0
2,1048,20186,3578734245,3578734245,0
2,1048,20187,3578734245,3578734245,0
2,1048,20188,3578734245,3578734245,0
2,1048,20189,3578734245,3578734245,0
2,1048,20190,3578734245,3578734245,0
2,1048,20191,3578734245,3578734245,0
2,1048,20192,3578734245,3578734245,0
2,1048,20193,3578734245,3578734246,1
2,1048,20194,3578734245,3578734246,1
2,1048,20195,3578734245,3578734250,5
2,1048,20196,3578734245,3578734250,5
2,1048,20197,3578734245,3578734250,5
2,1048,20198,3578734245,3578734252,7
2,1048,20199,3578734245,3578734252,7
2,1048,20200,3578734245,3578734253,8
2,1048,20201,3578734245,3578734254,9
2,1048,20202,3578734245,3578734254,9
2,1048,20203,3578734245,3578734255,10
2,1048,20204,3578734245,3578734257,12
2,1048,20205,3578734245,3578734257,12
2,1048,20206,3578734245,3578734257,12
2,1048,20207,3578734245,3578734257,12
2,1048,20208,3578734245,3578734259,14
2,1048,20209,3578734245,3578734259,14
2,1048,20210,3578734245,3578734260,15
2,1048,20211,3578734245,3578734265,20
2,1048,20212,3578734245,3578734266,21
2,1048,20213,3578734245,3578734267,22
2,1048,20214,3578734245,3578734267,22
2,1048,20215,3578734245,3578734269,24
2,1048,20216,3578734245,3578734269,24
2,1048,20217,3578734245,3578734269,24
2,1048,20218,3578734245,3578734280,35
2,1048,20219,3578734245,3578734280,35
2,1048,20220,3578734245,3578734282,37
2,1048,20221,3578734245,3578734283,38
2,1048,20222,3578734245,3578734283,38
2,1048,20223,3578734245,3578734283,38
2,1048,20224,3578734245,3578734285,40
2,1048,20225,3578734245,3578734286,41
2,1048,20226,3578734245,3578734287,42
2,1048,20227,3578734245,3578734289,44
2,1048,20228,3578734245,3578734290,45
2,1048,20229,3578734245,3578734291,46
2,1048,20230,3578734245,3578734291,46
2,1048,20231,3578734245,3578734291,46
2,1048,20232,3578734245,3578734292,47
2,1048,20233,3578734245,3578734293,48
2,1048,20234,3578734245,3578734294,49
2,1048,20235,3578734245,3578734294,49
2,1048,20236,3578734245,3578734294,49
2,1049,20237,3578734305,3578734305,0
2,1049,20238,3578734305,3578734305,0
2,1049,20239,3578734305,3578734305,0
2,1049,20240,3578734305,3578734305,0
2,1049,20241,3578734305,3578734305,0
2,1049,20242,3578734305,3578734305,0
2,1049,20243,3578734305,3578734305,0
2,1049,20244,3578734305,3578734305,0
2,1049,20245,3578734305,3578734305,0
2,1049,20246,3578734305,3578734305,0
2,1049,20247,3578734305,3578734305,0
2,1049,20248,3578734305,3578734306,1
2,1049,20249,3578734305,3578734307,2
2,1049,20250,3578734305,3578734307,2
2,1049,20251,3578734305,3578734309,4
2,1049,20252,3578734305,3578734310,5
2,1049,20253,3578734305,3578734310,5
2,1049,20254,3578734305,3578734311,6
2,1049,20255,3578734305,3578734311,6
2,1049,20256,3578734305,3578734312,7
2,1049,20257,3578734305,3578734313,8
2,1049,20258,3578734305,3578734314,9
2,1049,20259,3578734305,3578734315,10
2,1049,20260,3578734305,3578734317,12
2,1049,20261,3578734305,3578734318,13
2,1049,20262,3578734305,3578734318,13
2,1049,20263,3578734305,3578734319,14
2,1049,20264,3578734305,3578734319,14
2,1049,20265,3578734305,3578734320,15
2,1049,20266,3578734305,3578734320,15
2,1049,20267,3578734305,3578734320,15
2,1049,20268,3578734305,3578734322,17
2,1049,20269,3578734305,3578734325,20
2,1049,20270,3578734305,3578734325,20
2,1049,20271,3578734305,3578734326,21
2,1049,20272,3578734305,3578734326,21
2,1049,20273,3578734305,3578734327,22
2,1049,20274,3578734305,3578734329,24
2,1049,20275,3578734305,3578734329,24
2,1049,20276,3578734305,3578734331,26
2,1049,20277,3578734305,3578734332,27
2,1049,20278,3578734305,3578734333,28
2,1049,20279,3578734305,3578734333,28
2,1049,20280,3578734305,3578734334,29
2,1049,20281,3578734305,3578734335,30
2,1049,20282,3578734305,3578734337,32
2,1049,20283,3578734305,3578734337,32
2,1049,20284,3578734305,3578734337,32
2,1049,20285,3578734305,3578734337,32
2,1049,20286,3578734305,3578734339,34
2,1049,20287,3578734305,3578734340,35
2,1049,20288,3578734305,3578734341,36
2,1049,20289,3578734305,3578734343,38
2,1049,20290,3578734305,3578734343,38
2,1049,20291,3578734305,3578734343,38
2,1049,20292,3578734305,3578734344,39
2,1049,20293,3578734305,3578734345,40
2,1049,20294,3578734305,3578734349,44
2,1049,20295,3578734305,3578734351,46
2,1049,20296,3578734305,3578734351,46
2,1049,20297,3578734305,3578734352,47
2,1050,20298,3578734363,3578734363,0
2,1050,20299,3578734363,3578734363,0
2,1050,20300,3578734363,3578734363,0
2,1050,20301,3578734363,3578734363,0
2,1050,20302,3578734363,3578734363,0
2,1050,20303,3578734363,3578734363,0
2,1050,20304,3578734363,3578734363,0
2,1050,20305,3578734363,3578734363,0
2,1050,20306,3578734363,3578734363,0
2,1050,20307,3578734363,3578734364,1
2,1050,20308,3578734363,3578734365,2
2,1050,20309,3578734363,3578734365,2
2,1050,20310,3578734363,3578734366,3
2,1050,20311,3578734363,3578734368,5
2,1050,20312,3578734363,3578734369,6
2,1050,20313,3578734363,3578734369,6
2,1050,20314,3578734363,3578734371,8
2,1050,20315,3578734363,3578734374,11
2,1050,20316,3578734363,3578734375,12
2,1050,20317,3578734363,3578734375,12
2,1050,20318,3578734363,3578734376,13
2,1050,20319,3578734363,3578734377,14
2,1050,20320,3578734363,3578734381,18
2,1050,20321,3578734363,3578734381,18
2,1050,20322,3578734363,3578734383,20
2,1050,20323,3578734363,3578734385,22
2,1050,20324,3578734363,3578734385,22
2,1050,20325,3578734363,3578734386,23
2,1050,20326,3578734363,3578734387,24
2,1050,20327,3578734363,3578734390,27
2,1050,20328,3578734363,3578734391,28
2,1050,20329,3578734363,3578734391,28
2,1050,20330,3578734363,3578734393,30
2,1050,20331,3578734363,3578734394,31
2,1050,20332,3578734363,3578734395,32
2,1050,20333,3578734363,3578734395,32
2,1050,20334,3578734363,3578734395,32
2,1050,20335,3578734363,3578734401,38
2,1050,20336,3578734363,3578734402,39
2,1050,20337,3578734363,3578734404,41
2,1050,20338,3578734363,3578734405,42
2,1050,20339,3578734363,3578734410,47
2,1051,20340,3578734425,3578734425,0
2,1051,20341,3578734425,3578734425,0
2,1051,20342,3578734425,3578734425,0
2,1051,20343,3578734425,3578734425,0
2,1051,20344,3578734425,3578734425,0
2,1051,20345,3578734425,3578734425,0
2,1051,20346,3578734425,3578734425,0
2,1051,20347,3578734425,3578734425,0
2,1051,20348,3578734425,3578734427,2
2,1051,20349,3578734425,3578734428,3
2,1051,20350,3578734425,3578734428,3
2,1051,20351,3578734425,3578734428,3
2,1051,20352,3578734425,3578734429,4
2,1051,20353,3578734425,3578734430,5
2,1051,20354,3578734425,3578734432,7
2,1051,20355,3578734425,3578734433,8
2,1051,20356,3578734425,3578734433,8
2,1051,20357,3578734425,3578734435,10
2,1051,20358,3578734425,3578734436,11
2,1051,20359,3578734425,3578734437,12
2,1051,20360,3578734425,3578734439,14
2,1051,20361,3578734425,3578734441,16
2,1051,20362,3578734425,3578734441,16
2,1051,20363,3578734425,3578734442,17
2,1051,20364,3578734425,3578734442,17
2,1051,20365,3578734425,3578734444,19
2,1051,20366,3578734425,3578734444,19
2,1051,20367,3578734425,3578734446,21
2,1051,20368,3578734425,3578734447,22
2,1051,20369,3578734425,3578734448,23
2,1051,20370,3578734425,3578734450,25
2,1051,20371,3578734425,3578734451,26
2,1051,20372,3578734425,3578734452,27
2,1051,20373,3578734425,3578734452,27
2,1051,20374,3578734425,3578734453,28
2,1051,20375,3578734425,3578734454,29
2,1051,20376,3578734425,3578734455,30
2,1051,20377,3578734425,3578734457,32
2,1051,20378,3578734425,3578734457,32
2,1051,20379,3578734425,3578734457,32
2,1051,20380,3578734425,3578734458,33
2,1051,20381,3578734425,3578734459,34
2,1051,20382,3578734425,3578734459,34
2,1051,20383,3578734425,3578734460,35
2,1051,20384,3578734425,3578734462,37
2,1051,20385,3578734425,3578734464,39
2,1051,20386,3578734425,3578734466,41
2,1051,20387,3578734425,3578734466,41
2,1051,20388,3578734425,3578734466,41
2,1051,20389,3578734425,3578734467,42
2,1051,20390,3578734425,3578734468,43
2,1051,20391,3578734425,3578734469,44
2,1051,20392,3578734425,3578734469,44
2,1051,20393,3578734425,3578734470,45
2,1051,20394,3578734425,3578734470,45
2,1052,20395,3578734484,3578734484,0
2,1052,20396,3578734484,3578734484,0
2,1052,20397,3578734484,3578734484,0
2,1052,20398,3578734484,3578734484,0
2,1052,20399,3578734484,3578734484,0
2,1052,20400,3578734484,3578734484,0
2,1052,20401,3578734484,3578734484,0
2,1052,20402,3578734484,3578734484,0
2,1052,20403,3578734484,3578734485,1
2,1052,20404,3578734484,3578734486,2
2,1052,20405,3578734484,3578734487,3
2,1052,20406,3578734484,3578734489,5
2,1052,20407,3578734484,3578734489,5
2,1052,20408,3578734484,3578734489,5
2,1052,20409,3578734484,3578734491,7
2,1052,20410,3578734484,3578734491,7
2,1052,20411,3578734484,3578734491,7
2,1052,20412,3578734484,3578734492,8
2,1052,20413,3578734484,3578734493,9
2,1052,20414,3578734484,3578734494,10
2,1052,20415,3578734484,3578734494,10
2,1052,20416,3578734484,3578734495,11
2,1052,20417,3578734484,3578734497,13
2,1052,20418,3578734484,3578734498,14
2,1052,20419,3578734484,3578734499,15
2,1052,20420,3578734484,3578734499,15
2,1052,20421,3578734484,3578734499,15
2,1052,20422,3578734484,3578734500,16
2,1052,20423,3578734484,3578734500,16
2,1052,20424,3578734484,3578734500,16
2,1052,20425,3578734484,3578734501,17
2,1052,20426,3578734484,3578734505,21
2,1052,20427,3578734484,3578734505,21
2,1052,20428,3578734484,3578734505,21
2,1052,20429,3578734484,3578734507,23
2,1052,20430,3578734484,3578734508,24
2,1052,20431,3578734484,3578734509,25
2,1052,20432,3578734484,3578734509,25
2,1052,20433,3578734484,3578734511,27
2,1052,20434,3578734484,3578734511,27
2,1052,20435,3578734484,3578734513,29
2,1052,20436,3578734484,3578734514,30
2,1052,20437,3578734484,3578734516,32
2,1052,20438,3578734484,3578734517,33
2,1052,20439,3578734484,3578734518,34
2,1052,20440,3578734484,3578734518,34
2,1052,20441,3578734484,3578734519,35
2,1052,20442,3578734484,3578734519,35
2,1052,20443,3578734484,3578734519,35
2,1052,20444,3578734484,3578734520,36
2,1052,20445,3578734484,3578734520,36
2,1052,20446,3578734484,3578734520,36
2,1052,20447,3578734484,3578734521,37
2,1052,20448,3578734484,3578734524,40
2,1052,20449,3578734484,3578734524,40
2,1052,20450,3578734484,3578734525,41
2,1052,20451,3578734484,3578734525,41
2,1052,20452,3578734484,3578734526,42
2,1052,20453,3578734484,3578734526,42
2,1052,20454,3578734484,3578734527,43
2,1052,20455,3578734484,3578734527,43
2,1052,20456,3578734484,3578734528,44
2,1052,20457,3578734484,3578734530,46
2,1052,20458,3578734484,3578734532,48
2,1052,20459,3578734484,3578734532,48
2,1052,20460,3578734484,3578734532,48
2,1052,20461,3578734484,3578734534,50
2,1053,20462,3578734543,3578734543,0
2,1053,20463,3578734543,3578734543,0
2,1053,20464,3578734543,3578734543,0
2,1053,20465,3578734543,3578734543,0
2,1053,20466,3578734543,3578734543,0
2,1053,20467,3578734543,3578734543,0
2,1053,20468,3578734543,3578734543,0
2,1053,20469,3578734543,3578734543,0
2,1053,20470,3578734543,3578734543,0
2,1053,20471,3578734543,3578734543,0
2,1053,20472,3578734543,3578734543,0
2,1053,20473,3578734543,3578734544,1
2,1053,20474,3578734543,3578734548,5
2,1053,20475,3578734543,3578734550,7
2,1053,20476,3578734543,3578734551,8
2,1053,20477,3578734543,3578734554,11
2,1053,20478,3578734543,3578734555,12
2,1053,20479,3578734543,3578734555,12
2,1053,20480,3578734543,3578734556,13
2,1053,20481,3578734543,3578734559,16
2,1053,20482,3578734543,3578734561,18
2,1053,20483,3578734543,3578734561,18
2,1053,20484,3578734543,3578734562,19
2,1053,20485,3578734543,3578734563,20
2,1053,20486,3578734543,3578734564,21
2,1053,20487,3578734543,3578734565,22
2,1053,20488,3578734543,3578734568,25
2,1053,20489,3578734543,3578734568,25
2,1053,20490,3578734543,3578734568,25
2,1053,20491,3578734543,3578734570,27
2,1053,20492,3578734543,3578734573,30
2,1053,20493,3578734543,3578734574,31
2,1053,20494,3578734543,3578734575,32
2,1053,20495,3578734543,3578734575,32
2,1053,20496,3578734543,3578734577,34
2,1053,20497,3578734543,3578734577,34
2,1053,20498,3578734543,3578734580,37
2,1053,20499,3578734543,3578734580,37
2,1053,20500,3578734543,3578734583,40
2,1053,20501,3578734543,3578734584,41
2,1053,20502,3578734543,3578734584,41
2,1053,20503,3578734543,3578734585,42
2,1053,20504,3578734543,3578734585,42
2,1053,20505,3578734543,3578734589,46
2,1053,20506,3578734543,3578734590,47
2,1053,20507,3578734543,3578734591,48
2,1053,20508,3578734543,3578734593,50
2,1054,20509,3578734602,3578734602,0
2,1054,20510,3578734602,3578734602,0
2,1054,20511,3578734602,3578734602,0
2,1054,20512,3578734602,3578734602,0
2,1054,20513,3578734602,3578734602,0
2,1054,20514,3578734602,3578734602,0
2,1054,20515,3578734602,3578734602,0
2,1054,20516,3578734602,3578734603,1
2,1054,20517,3578734602,3578734604,2
2,1054,20518,3578734602,3578734606,4
2,1054,20519,3578734602,3578734608,6
2,1054,20520,3578734602,3578734609,7
2,1054,20521,3578734602,3578734612,10
2,1054,20522,3578734602,3578734613,11
2,1054,20523,3578734602,3578734615,13
2,1054,20524,3578734602,3578734617,15
2,1054,20525,3578734602,3578734617,15
2,1054,20526,3578734602,3578734620,18
2,1054,20527,3578734602,3578734622,20
2,1054,20528,3578734602,3578734624,22
2,1054,20529,3578734602,3578734626,24
2,1054,20530,3578734602,3578734627,25
2,1054,20531,3578734602,3578734627,25
2,1054,20532,3578734602,3578734627,25
2,1054,20533,3578734602,3578734628,26
2,1054,20534,3578734602,3578734628,26
2,1054,20535,3578734602,3578734629,27
2,1054,20536,3578734602,3578734631,29
2,1054,20537,3578734602,3578734632,30
2,1054,20538,3578734602,3578734633,31
2,1054,20539,3578734602,3578734635,33
2,1054,20540,3578734602,3578734635,33
2,1054,20541,3578734602,3578734636,34
2,1054,20542,3578734602,3578734638,36
2,1054,20543,3578734602,3578734640,38
2,1054,20544,3578734602,3578734640,38
2,1054,20545,3578734602,3578734640,38
2,1054,20546,3578734602,3578734642,40
2,1054,20547,3578734602,3578734643,41
2,1054,20548,3578734602,3578734643,41
2,1054,20549,3578734602,3578734646,44
2,1054,20550,3578734602,3578734646,44
2,1054,20551,3578734602,3578734647,45
2,1054,20552,3578734602,3578734650,48
2,1054,20553,3578734602,3578734650,48
2,1054,20554,3578734602,3578734650,48
2,1054,20555,3578734602,3578734651,49
2,1054,20556,3578734602,3578734652,50
2,1055,20557,3578734663,3578734663,0
2,1055,20558,3578734663,3578734663,0
2,1055,20559,3578734663,3578734663,0
2,1055,20560,3578734663,3578734663,0
2,1055,20561,3578734663,3578734663,0
2,1055,20562,3578734663,3578734663,0
2,1055,20563,3578734663,3578734663,0
2,1055,20564,3578734663,3578734663,0
2,1055,20565,3578734663,3578734663,0
2,1055,20566,3578734663,3578734663,0
2,1055,20567,3578734663,3578734663,0
2,1055,20568,3578734663,3578734663,0
2,1055,20569,3578734663,3578734663,0
2,1055,20570,3578734663,3578734665,2
2,1055,20571,3578734663,3578734665,2
2,1055,20572,3578734663,3578734667,4
2,1055,20573,3578734663,3578734668,5
2,1055,20574,3578734663,3578734668,5
2,1055,20575,3578734663,3578734669,6
2,1055,20576,3578734663,3578734680,17
2,1055,20577,3578734663,3578734681,18
2,1055,20578,3578734663,3578734681,18
2,1055,20579,3578734663,3578734681,18
2,1055,20580,3578734663,3578734682,19
2,1055,20581,3578734663,3578734683,20
2,1055,20582,3578734663,3578734683,20
2,1055,20583,3578734663,3578734684,21
2,1055,20584,3578734663,3578734684,21
2,1055,20585,3578734663,3578734684,21
2,1055,20586,3578734663,3578734684,21
2,1055,20587,3578734663,3578734686,23
2,1055,20588,3578734663,3578734688,25
2,1055,20589,3578734663,3578734689,26
2,1055,20590,3578734663,3578734690,27
2,1055,20591,3578734663,3578734690,27
2,1055,20592,3578734663,3578734691,28
2,1055,20593,3578734663,3578734692,29
2,1055,20594,3578734663,3578734692,29
2,1055,20595,3578734663,3578734693,30
2,1055,20596,3578734663,3578734694,31
2,1055,20597,3578734663,3578734694,31
2,1055,20598,3578734663,3578734696,33
2,1055,20599,3578734663,3578734696,33
2,1055,20600,3578734663,3578734698,35
2,1055,20601,3578734663,3578734699,36
2,1055,20602,3578734663,3578734699,36
2,1055,20603,3578734663,3578734699,36
2,1055,20604,3578734663,3578734699,36
2,1055,20605,3578734663,3578734700,37
2,1055,20606,3578734663,3578734700,37
2,1055,20607,3578734663,3578734700,37
2,1055,20608,3578734663,3578734705,42
2,1055,20609,3578734663,3578734706,43
2,1055,20610,3578734663,3578734706,43
2,1055,20611,3578734663,3578734708,45
2,1055,20612,3578734663,3578734708,45
2,1055,20613,3578734663,3578734708,45
2,1055,20614,3578734663,3578734708,45
2,1055,20615,3578734663,3578734710,47
2,1055,20616,3578734663,3578734710,47
2,1055,20617,3578734663,3578734712,49
2,1055,20618,3578734663,3578734712,49
2,1056,20619,3578734724,3578734724,0
2,1056,20620,3578734724,3578734724,0
2,1056,20621,3578734724,3578734724,0
2,1056,20622,3578734724,3578734724,0
2,1056,20623,3578734724,3578734724,0
2,1056,20624,3578734724,3578734724,0
2,1056,20625,3578734724,3578734724,0
2,1056,20626,3578734724,3578734724,0
2,1056,20627,3578734724,3578734724,0
2,1056,20628,3578734724,3578734724,0
2,1056,20629,3578734724,3578734724,0
2,1056,20630,3578734724,3578734724,0
2,1056,20631,3578734724,3578734724,0
2,1056,20632,3578734724,3578734726,2
2,1056,20633,3578734724,3578734726,2
2,1056,20634,3578734724,3578734727,3
2,1056,20635,3578734724,3578734728,4
2,1056,20636,3578734724,3578734729,5
2,1056,20637,3578734724,3578734732,8
2,1056,20638,3578734724,3578734733,9
2,1056,20639,3578734724,3578734733,9
2,1056,20640,3578734724,3578734733,9
2,1056,20641,3578734724,3578734733,9
2,1056,20642,3578734724,3578734734,10
2,1056,20643,3578734724,3578734734,10
2,1056,20644,3578734724,3578734735,11
2,1056,20645,3578734724,3578734736,12
2,1056,20646,3578734724,3578734736,12
2,1056,20647,3578734724,3578734737,13
2,1056,20648,3578734724,3578734737,13
2,1056,20649,3578734724,3578734738,14
2,1056,20650,3578734724,3578734740,16
2,1056,20651,3578734724,3578734742,18
2,1056,20652,3578734724,3578734743,19
2,1056,20653,3578734724,3578734743,19
2,1056,20654,3578734724,3578734744,20
2,1056,20655,3578734724,3578734748,24
2,1056,20656,3578734724,3578734751,27
2,1056,20657,3578734724,3578734755,31
2,1056,20658,3578734724,3578734755,31
2,1056,20659,3578734724,3578734756,32
2,1056,20660,3578734724,3578734756,32
2,1056,20661,3578734724,3578734759,35
2,1056,20662,3578734724,3578734761,37
2,1056,20663,3578734724,3578734761,37
2,1056,20664,3578734724,3578734762,38
2,1056,20665,3578734724,3578734763,39
2,1056,20666,3578734724,3578734764,40
2,1056,20667,3578734724,3578734764,40
2,1056,20668,3578734724,3578734765,41
2,1056,20669,3578734724,3578734768,44
2,1056,20670,3578734724,3578734768,44
2,1056,20671,3578734724,3578734768,44
2,1056,20672,3578734724,3578734771,47
2,1056,20673,3578734724,3578734774,50
2,1057,20674,3578734786,3578734786,0
2,1057,20675,3578734786,3578734786,0
2,1057,20676,3578734786,3578734786,0
2,1057,20677,3578734786,3578734786,0
2,1057,20678,3578734786,3578734786,0
2,1057,20679,3578734786,3578734786,0
2,1057,20680,3578734786,3578734786,0
2,1057,20681,3578734786,3578734786,0
2,1057,20682,3578734786,3578734786,0
2,1057,20683,3578734786,3578734786,0
2,1057,20684,3578734786,3578734786,0
2,1057,20685,3578734786,3578734787,1
2,1057,20686,3578734786,3578734789,3
2,1057,20687,3578734786,3578734790,4
2,1057,20688,3578734786,3578734790,4
2,1057,20689,3578734786,3578734794,8
2,1057,20690,3578734786,3578734794,8
2,1057,20691,3578734786,3578734795,9
2,1057,20692,3578734786,3578734796,10
2,1057,20693,3578734786,3578734796,10
2,1057,20694,3578734786,3578734800,14
2,1057,20695,3578734786,3578734801,15
2,1057,20696,3578734786,3578734803,17
2,1057,20697,3578734786,3578734804,18
2,1057,20698,3578734786,3578734806,20
2,1057,20699,3578734786,3578734809,23
2,1057,20700,3578734786,3578734810,24
2,1057,20701,3578734786,3578734813,27
2,1057,20702,3578734786,3578734813,27
2,1057,20703,3578734786,3578734814,28
2,1057,20704,3578734786,3578734815,29
2,1057,20705,3578734786,3578734817,31
2,1057,20706,3578734786,3578734817,31
2,1057,20707,3578734786,3578734818,32
2,1057,20708,3578734786,3578734820,34
2,1057,20709,3578734786,3578734822,36
2,1057,20710,3578734786,3578734825,39
2,1057,20711,3578734786,3578734826,40
2,1057,20712,3578734786,3578734827,41
2,1057,20713,3578734786,3578734828,42
2,1057,20714,3578734786,3578734828,42
2,1057,20715,3578734786,3578734828,42
2,1057,20716,3578734786,3578734828,42
2,1057,20717,3578734786,3578734830,44
2,1057,20718,3578734786,3578734830,44
2,1057,20719,3578734786,3578734831,45
2,1057,20720,3578734786,3578734833,47
2,1057,20721,3578734786,3578734833,47
2,1057,20722,3578734786,3578734835,49
2,1057,20723,3578734786,3578734835,49
2,1058,20724,3578734844,3578734844,0
2,1058,20725,3578734844,3578734844,0
2,1058,20726,3578734844,3578734844,0
2,1058,20727,3578734844,3578734844,0
2,1058,20728,3578734844,3578734844,0
2,1058,20729,3578734844,3578734844,0
2,1058,20730,3578734844,3578734844,0
2,1058,20731,3578734844,3578734844,0
2,1058,20732,3578734844,3578734846,2
2,1058,20733,3578734844,3578734846,2
2,1058,20734,3578734844,3578734847,3
2,1058,20735,3578734844,3578734850,6
2,1058,20736,3578734844,3578734850,6
2,1058,20737,3578734844,3578734850,6
2,1058,20738,3578734844,3578734851,7
2,1058,20739,3578734844,3578734854,10
2,1058,20740,3578734844,3578734854,10
2,1058,20741,3578734844,3578734854,10
2,1058,20742,3578734844,3578734855,11
2,1058,20743,3578734844,3578734857,13
2,1058,20744,3578734844,3578734857,13
2,1058,20745,3578734844,3578734857,13
2,1058,20746,3578734844,3578734858,14
2,1058,20747,3578734844,3578734859,15
2,1058,20748,3578734844,3578734859,15
2,1058,20749,3578734844,3578734860,16
2,1058,20750,3578734844,3578734861,17
2,1058,20751,3578734844,3578734865,21
2,1058,20752,3578734844,3578734865,21
2,1058,20753,3578734844,3578734865,21
2,1058,20754,3578734844,3578734866,22
2,1058,20755,3578734844,3578734868,24
2,1058,20756,3578734844,3578734869,25
2,1058,20757,3578734844,3578734869,25
2,1058,20758,3578734844,3578734880,36
2,1058,20759,3578734844,3578734881,37
2,1058,20760,3578734844,3578734881,37
2,1058,20761,3578734844,3578734883,39
2,1058,20762,3578734844,3578734883,39
2,1058,20763,3578734844,3578734884,40
2,1058,20764,3578734844,3578734884,40
2,1058,20765,3578734844,3578734885,41
2,1058,20766,3578734844,3578734885,41
2,1058,20767,3578734844,3578734885,41
2,1058,20768,3578734844,3578734887,43
2,1058,20769,3578734844,3578734887,43
2,1058,20770,3578734844,3578734889,45
2,1058,20771,3578734844,3578734891,47
2,1058,20772,3578734844,3578734891,47
2,1058,20773,3578734844,3578734891,47
2,1058,20774,3578734844,3578734891,47
2,1058,20775,3578734844,3578734892,48
2,1058,20776,3578734844,3578734892,48
2,1058,20777,3578734844,3578734894,50
2,1059,20778,3578734902,3578734902,0
2,1059,20779,3578734902,3578734902,0
2,1059,20780,3578734902,3578734902,0
2,1059,20781,3578734902,3578734902,0
2,1059,20782,3578734902,3578734902,0
2,1059,20783,3578734902,3578734902,0
2,1059,20784,3578734902,3578734902,0
2,1059,20785,3578734902,3578734902,0
2,1059,20786,3578734902,3578734902,0
2,1059,20787,3578734902,3578734902,0
2,1059,20788,3578734902,3578734902,0
2,1059,20789,3578734902,3578734905,3
2,1059,20790,3578734902,3578734905,3
2,1059,20791,3578734902,3578734905,3
2,1059,20792,3578734902,3578734906,4
2,1059,20793,3578734902,3578734908,6
2,1059,20794,3578734902,3578734908,6
2,1059,20795,3578734902,3578734909,7
2,1059,20796,3578734902,3578734909,7
2,1059,20797,3578734902,3578734910,8
2,1059,20798,3578734902,3578734912,10
2,1059,20799,3578734902,3578734912,10
2,1059,20800,3578734902,3578734913,11
2,1059,20801,3578734902,3578734914,12
2,1059,20802,3578734902,3578734914,12
2,1059,20803,3578734902,3578734917,15
2,1059,20804,3578734902,3578734917,15
2,1059,20805,3578734902,3578734918,16
2,1059,20806,3578734902,3578734918,16
2,1059,20807,3578734902,3578734919,17
2,1059,20808,3578734902,3578734920,18
2,1059,20809,3578734902,3578734920,18
2,1059,20810,3578734902,3578734921,19
2,1059,20811,3578734902,3578734921,19
2,1059,20812,3578734902,3578734925,23
2,1059,20813,3578734902,3578734925,23
2,1059,20814,3578734902,3578734925,23
2,1059,20815,3578734902,3578734926,24
2,1059,20816,3578734902,3578734927,25
2,1059,20817,3578734902,3578734927,25
2,1059,20818,3578734902,3578734929,27
2,1059,20819,3578734902,3578734929,27
2,1059,20820,3578734902,3578734932,30
2,1059,20821,3578734902,3578734933,31
2,1059,20822,3578734902,3578734933,31
2,1059,20823,3578734902,3578734933,31
2,1059,20824,3578734902,3578734934,32
2,1059,20825,3578734902,3578734934,32
2,1059,20826,3578734902,3578734934,32
2,1059,20827,3578734902,3578734935,33
2,1059,20828,3578734902,3578734936,34
2,1059,20829,3578734902,3578734936,34
2,1059,20830,3578734902,3578734937,35
2,1059,20831,3578734902,3578734938,36
2,1059,20832,3578734902,3578734938,36
2,1059,20833,3578734902,3578734940,38
2,1059,20834,3578734902,3578734942,40
2,1059,20835,3578734902,3578734943,41
2,1059,20836,3578734902,3578734943,41
2,1059,20837,3578734902,3578734945,43
2,1059,20838,3578734902,3578734945,43
2,1059,20839,3578734902,3578734948,46
2,1059,20840,3578734902,3578734951,49
2,1060,20841,3578734961,3578734961,0
2,1060,20842,3578734961,3578734961,0
2,1060,20843,3578734961,3578734961,0
2,1060,20844,3578734961,3578734961,0
2,1060,20845,3578734961,3578734961,0
2,1060,20846,3578734961,3578734961,0
2,1060,20847,3578734961,3578734961,0
2,1060,20848,3578734961,3578734962,1
2,1060,20849,3578734961,3578734963,2
2,1060,20850,3578734961,3578734963,2
2,1060,20851,3578734961,3578734965,4
2,1060,20852,3578734961,3578734965,4
2,1060,20853,3578734961,3578734965,4
2,1060,20854,3578734961,3578734968,7
2,1060,20855,3578734961,3578734969,8
2,1060,20856,3578734961,3578734969,8
2,1060,20857,3578734961,3578734970,9
2,1060,20858,3578734961,3578734974,13
2,1060,20859,3578734961,3578734975,14
2,1060,20860,3578734961,3578734975,14
2,1060,20861,3578734961,3578734976,15
2,1060,20862,3578734961,3578734978,17
2,1060,20863,3578734961,3578734981,20
2,1060,20864,3578734961,3578734982,21
2,1060,20865,3578734961,3578734982,21
2,1060,20866,3578734961,3578734984,23
2,1060,20867,3578734961,3578734985,24
2,1060,20868,3578734961,3578734986,25
2,1060,20869,3578734961,3578734987,26
2,1060,20870,3578734961,3578734989,28
2,1060,20871,3578734961,3578734991,30
2,1060,20872,3578734961,3578734991,30
2,1060,20873,3578734961,3578734993,32
2,1060,20874,3578734961,3578734994,33
2,1060,20875,3578734961,3578734996,35
2,1060,20876,3578734961,3578734996,35
2,1060,20877,3578734961,3578734997,36
2,1060,20878,3578734961,3578734998,37
2,1060,20879,3578734961,3578735000,39
2,1060,20880,3578734961,3578735001,40
2,1060,20881,3578734961,3578735004,43
2,1060,20882,3578734961,3578735004,43
2,1060,20883,3578734961,3578735006,45
2,1060,20884,3578734961,3578735009,48
2,1060,20885,3578734961,3578735010,49
2,1061,20886,3578735022,3578735022,0
2,1061,20887,3578735022,3578735022,0
2,1061,20888,3578735022,3578735022,0
2,1061,20889,3578735022,3578735022,0
2,1061,20890,3578735022,3578735022,0
2,1061,20891,3578735022,3578735022,0
2,1061,20892,3578735022,3578735022,0
2,1061,20893,3578735022,3578735023,1
2,1061,20894,3578735022,3578735024,2
2,1061,20895,3578735022,3578735024,2
2,1061,20896,3578735022,3578735026,4
2,1061,20897,3578735022,3578735027,5
2,1061,20898,3578735022,3578735027,5
2,1061,20899,3578735022,3578735028,6
2,1061,20900,3578735022,3578735028,6
2,1061,20901,3578735022,3578735030,8
2,1061,20902,3578735022,3578735030,8
2,1061,20903,3578735022,3578735032,10
2,1061,20904,3578735022,3578735033,11
2,1061,20905,3578735022,3578735035,13
2,1061,20906,3578735022,3578735035,13
2,1061,20907,3578735022,3578735035,13
2,1061,20908,3578735022,3578735037,15
2,1061,20909,3578735022,3578735037,15
2,1061,20910,3578735022,3578735039,17
2,1061,20911,3578735022,3578735040,18
2,1061,20912,3578735022,3578735040,18
2,1061,20913,3578735022,3578735041,19
2,1061,20914,3578735022,3578735042,20
2,1061,20915,3578735022,3578735043,21
2,1061,20916,3578735022,3578735043,21
2,1061,20917,3578735022,3578735046,24
2,1061,20918,3578735022,3578735047,25
2,1061,20919,3578735022,3578735049,27
2,1061,20920,3578735022,3578735050,28
2,1061,20921,3578735022,3578735050,28
2,1061,20922,3578735022,3578735051,29
2,1061,20923,3578735022,3578735051,29
2,1061,20924,3578735022,3578735054,32
2,1061,20925,3578735022,3578735054,32
2,1061,20926,3578735022,3578735054,32
2,1061,20927,3578735022,3578735056,34
2,1061,20928,3578735022,3578735057,35
2,1061,20929,3578735022,3578735057,35
2,1061,20930,3578735022,3578735058,36
2,1061,20931,3578735022,3578735059,37
2,1061,20932,3578735022,3578735060,38
2,1061,20933,3578735022,3578735060,38
2,1061,20934,3578735022,3578735061,39
2,1061,20935,3578735022,3578735065,43
2,1061,20936,3578735022,3578735065,43
2,1061,20937,3578735022,3578735066,44
2,1061,20938,3578735022,3578735067,45
2,1061,20939,3578735022,3578735068,46
2,1061,20940,3578735022,3578735068,46
2,1061,20941,3578735022,3578735068,46
2,1061,20942,3578735022,3578735069,47
2,1061,20943,3578735022,3578735069,47
2,1062,20944,3578735086,3578735086,0
2,1062,20945,3578735086,3578735086,0
2,1062,20946,3578735086,3578735086,0
2,1062,20947,3578735086,3578735086,0
2,1062,20948,3578735086,3578735086,0
2,1062,20949,3578735086,3578735086,0
2,1062,20950,3578735086,3578735087,1
2,1062,20951,3578735086,3578735087,1
2,1062,20952,3578735086,3578735087,1
2,1062,20953,3578735086,3578735088,2
2,1062,20954,3578735086,3578735089,3
2,1062,20955,3578735086,3578735091,5
2,1062,20956,3578735086,3578735091,5
2,1062,20957,3578735086,3578735091,5
2,1062,20958,3578735086,3578735092,6
2,1062,20959,3578735086,3578735092,6
2,1062,20960,3578735086,3578735093,7
2,1062,20961,3578735086,3578735096,10
2,1062,20962,3578735086,3578735097,11
2,1062,20963,3578735086,3578735098,12
2,1062,20964,3578735086,3578735098,12
2,1062,20965,3578735086,3578735100,14
2,1062,20966,3578735086,3578735100,14
2,1062,20967,3578735086,3578735100,14
2,1062,20968,3578735086,3578735100,14
2,1062,20969,3578735086,3578735101,15
2,1062,20970,3578735086,3578735101,15
2,1062,20971,3578735086,3578735105,19
2,1062,20972,3578735086,3578735106,20
2,1062,20973,3578735086,3578735107,21
2,1062,20974,3578735086,3578735108,22
2,1062,20975,3578735086,3578735108,22
2,1062,20976,3578735086,3578735109,23
2,1062,20977,3578735086,3578735109,23
2,1062,20978,3578735086,3578735111,25
2,1062,20979,3578735086,3578735111,25
2,1062,20980,3578735086,3578735113,27
2,1062,20981,3578735086,3578735113,27
2,1062,20982,3578735086,3578735113,27
2,1062,20983,3578735086,3578735114,28
2,1062,20984,3578735086,3578735115,29
2,1062,20985,3578735086,3578735117,31
2,1062,20986,3578735086,3578735117,31
2,1062,20987,3578735086,3578735119,33
2,1062,20988,3578735086,3578735119,33
2,1062,20989,3578735086,3578735119,33
2,1062,20990,3578735086,3578735119,33
2,1062,20991,3578735086,3578735121,35
2,1062,20992,3578735086,3578735122,36
2,1062,20993,3578735086,3578735125,39
2,1062,20994,3578735086,3578735125,39
2,1062,20995,3578735086,3578735125,39
2,1062,20996,3578735086,3578735126,40
2,1062,20997,3578735086,3578735127,41
2,1062,20998,3578735086,3578735127,41
2,1062,20999,3578735086,3578735127,41
2,1062,21000,3578735086,3578735129,43
2,1062,21001,3578735086,3578735133,47
2,1062,21002,3578735086,3578735134,48
2,1062,21003,3578735086,3578735134,48
2,1062,21004,3578735086,3578735134,48
2,1062,21005,3578735086,3578735135,49
2,1062,21006,3578735086,3578735135,49
2,1062,21007,3578735086,3578735135,49
2,1062,21008,3578735086,3578735135,49
2,1063,21009,3578735147,3578735147,0
2,1063,21010,3578735147,3578735147,0
2,1063,21011,3578735147,3578735147,0
2,1063,21012,3578735147,3578735147,0
2,1063,21013,3578735147,3578735147,0
2,1063,21014,3578735147,3578735147,0
2,1063,21015,3578735147,3578735147,0
2,1063,21016,3578735147,3578735147,0
2,1063,21017,3578735147,3578735147,0
2,1063,21018,3578735147,3578735148,1
2,1063,21019,3578735147,3578735151,4
2,1063,21020,3578735147,3578735152,5
2,1063,21021,3578735147,3578735155,8
2,1063,21022,3578735147,3578735155,8
2,1063,21023,3578735147,3578735157,10
2,1063,21024,3578735147,3578735159,12
2,1063,21025,3578735147,3578735162,15
2,1063,21026,3578735147,3578735163,16
2,1063,21027,3578735147,3578735163,16
2,1063,21028,3578735147,3578735164,17
2,1063,21029,3578735147,3578735165,18
2,1063,21030,3578735147,3578735165,18
2,1063,21031,3578735147,3578735166,19
2,1063,21032,3578735147,3578735168,21
2,1063,21033,3578735147,3578735169,22
2,1063,21034,3578735147,3578735169,22
2,1063,21035,3578735147,3578735171,24
2,1063,21036,3578735147,3578735174,27
2,1063,21037,3578735147,3578735174,27
2,1063,21038,3578735147,3578735176,29
2,1063,21039,3578735147,3578735176,29
2,1063,21040,3578735147,3578735178,31
2,1063,21041,3578735147,3578735180,33
2,1063,21042,3578735147,3578735182,35
2,1063,21043,3578735147,3578735183,36
2,1063,21044,3578735147,3578735184,37
2,1063,21045,3578735147,3578735185,38
2,1063,21046,3578735147,3578735186,39
2,1063,21047,3578735147,3578735189,42
2,1063,21048,3578735147,3578735190,43
2,1063,21049,3578735147,3578735191,44
2,1063,21050,3578735147,3578735194,47
2,1063,21051,3578735147,3578735194,47
2,1063,21052,3578735147,3578735195,48
2,1063,21053,3578735147,3578735196,49
2,1064,21054,3578735207,3578735207,0
2,1064,21055,3578735207,3578735207,0
2,1064,21056,3578735207,3578735207,0
2,1064,21057,3578735207,3578735207,0
2,1064,21058,3578735207,3578735207,0
2,1064,21059,3578735207,3578735207,0
2,1064,21060,3578735207,3578735207,0
2,1064,21061,3578735207,3578735209,2
2,1064,21062,3578735207,3578735210,3
2,1064,21063,3578735207,3578735212,5
2,1064,21064,3578735207,3578735214,7
2,1064,21065,3578735207,3578735215,8
2,1064,21066,3578735207,3578735216,9
2,1064,21067,3578735207,3578735217,10
2,1064,21068,3578735207,3578735219,12
2,1064,21069,3578735207,3578735221,14
2,1064,21070,3578735207,3578735224,17
2,1064,21071,3578735207,3578735225,18
2,1064,21072,3578735207,3578735227,20
2,1064,21073,3578735207,3578735227,20
2,1064,21074,3578735207,3578735228,21
2,1064,21075,3578735207,3578735228,21
2,1064,21076,3578735207,3578735229,22
2,1064,21077,3578735207,3578735230,23
2,1064,21078,3578735207,3578735231,24
2,1064,21079,3578735207,3578735232,25
2,1064,21080,3578735207,3578735233,26
2,1064,21081,3578735207,3578735234,27
2,1064,21082,3578735207,3578735235,28
2,1064,21083,3578735207,3578735235,28
2,1064,21084,3578735207,3578735237,30
2,1064,21085,3578735207,3578735238,31
2,1064,21086,3578735207,3578735239,32
2,1064,21087,3578735207,3578735240,33
2,1064,21088,3578735207,3578735240,33
2,1064,21089,3578735207,3578735241,34
2,1064,21090,3578735207,3578735242,35
2,1064,21091,3578735207,3578735243,36
2,1064,21092,3578735207,3578735243,36
2,1064,21093,3578735207,3578735246,39
2,1064,21094,3578735207,3578735246,39
2,1064,21095,3578735207,3578735247,40
2,1064,21096,3578735207,3578735251,44
2,1064,21097,3578735207,3578735251,44
2,1064,21098,3578735207,3578735252,45
2,1064,21099,3578735207,3578735253,46
2,1064,21100,3578735207,3578735255,48
2,1064,21101,3578735207,3578735256,49
2,1064,21102,3578735207,3578735257,50
2,1065,21103,3578735266,3578735266,0
2,1065,21104,3578735266,3578735266,0
2,1065,21105,3578735266,3578735266,0
2,1065,21106,3578735266,3578735266,0
2,1065,21107,3578735266,3578735266,0
2,1065,21108,3578735266,3578735266,0
2,1065,21109,3578735266,3578735266,0
2,1065,21110,3578735266,3578735267,1
2,1065,21111,3578735266,3578735267,1
2,1065,21112,3578735266,3578735268,2
2,1065,21113,3578735266,3578735269,3
2,1065,21114,3578735266,3578735269,3
2,1065,21115,3578735266,3578735270,4
2,1065,21116,3578735266,3578735280,14
2,1065,21117,3578735266,3578735281,15
2,1065,21118,3578735266,3578735281,15
2,1065,21119,3578735266,3578735282,16
2,1065,21120,3578735266,3578735283,17
2,1065,21121,3578735266,3578735284,18
2,1065,21122,3578735266,3578735284,18
2,1065,21123,3578735266,3578735284,18
2,1065,21124,3578735266,3578735284,18
2,1065,21125,3578735266,3578735284,18
2,1065,21126,3578735266,3578735285,19
2,1065,21127,3578735266,3578735289,23
2,1065,21128,3578735266,3578735290,24
2,1065,21129,3578735266,3578735290,24
2,1065,21130,3578735266,3578735291,25
2,1065,21131,3578735266,3578735291,25
2,1065,21132,3578735266,3578735291,25
2,1065,21133,3578735266,3578735292,26
2,1065,21134,3578735266,3578735293,27
2,1065,21135,3578735266,3578735293,27
2,1065,21136,3578735266,3578735293,27
2,1065,21137,3578735266,3578735295,29
2,1065,21138,3578735266,3578735296,30
2,1065,21139,3578735266,3578735297,31
2,1065,21140,3578735266,3578735298,32
2,1065,21141,3578735266,3578735299,33
2,1065,21142,3578735266,3578735299,33
2,1065,21143,3578735266,3578735300,34
2,1065,21144,3578735266,3578735300,34
2,1065,21145,3578735266,3578735301,35
2,1065,21146,3578735266,3578735301,35
2,1065,21147,3578735266,3578735301,35
2,1065,21148,3578735266,3578735306,40
2,1065,21149,3578735266,3578735306,40
2,1065,21150,3578735266,3578735307,41
2,1065,21151,3578735266,3578735308,42
2,1065,21152,3578735266,3578735309,43
2,1065,21153,3578735266,3578735309,43
2,1065,21154,3578735266,3578735310,44
2,1065,21155,3578735266,3578735310,44
2,1065,21156,3578735266,3578735312,46
2,1065,21157,3578735266,3578735313,47
2,1065,21158,3578735266,3578735313,47
2,1065,21159,3578735266,3578735313,47
2,1065,21160,3578735266,3578735315,49
2,1066,21161,3578735326,3578735326,0
2,1066,21162,3578735326,3578735326,0
2,1066,21163,3578735326,3578735326,0
2,1066,21164,3578735326,3578735326,0
2,1066,21165,3578735326,3578735326,0
2,1066,21166,3578735326,3578735326,0
2,1066,21167,3578735326,3578735326,0
2,1066,21168,3578735326,3578735326,0
2,1066,21169,3578735326,3578735326,0
2,1066,21170,3578735326,3578735326,0
2,1066,21171,3578735326,3578735326,0
2,1066,21172,3578735326,3578735326,0
2,1066,21173,3578735326,3578735326,0
2,1066,21174,3578735326,3578735326,0
2,1066,21175,3578735326,3578735326,0
2,1066,21176,3578735326,3578735326,0
2,1066,21177,3578735326,3578735327,1
2,1066,21178,3578735326,3578735327,1
2,1066,21179,3578735326,3578735330,4
2,1066,21180,3578735326,3578735330,4
2,1066,21181,3578735326,3578735332,6
2,1066,21182,3578735326,3578735333,7
2,1066,21183,3578735326,3578735334,8
2,1066,21184,3578735326,3578735334,8
2,1066,21185,3578735326,3578735334,8
2,1066,21186,3578735326,3578735334,8
2,1066,21187,3578735326,3578735335,9
2,1066,21188,3578735326,3578735336,10
2,1066,21189,3578735326,3578735336,10
2,1066,21190,3578735326,3578735336,10
2,1066,21191,3578735326,3578735338,12
2,1066,21192,3578735326,3578735340,14
2,1066,21193,3578735326,3578735341,15
2,1066,21194,3578735326,3578735341,15
2,1066,21195,3578735326,3578735343,17
2,1066,21196,3578735326,3578735343,17
2,1066,21197,3578735326,3578735346,20
2,1066,21198,3578735326,3578735348,22
2,1066,21199,3578735326,3578735350,24
2,1066,21200,3578735326,3578735352,26
2,1066,21201,3578735326,3578735355,29
2,1066,21202,3578735326,3578735355,29
2,1066,21203,3578735326,3578735356,30
2,1066,21204,3578735326,3578735357,31
2,1066,21205,3578735326,3578735360,34
2,1066,21206,3578735326,3578735362,36
2,1066,21207,3578735326,3578735363,37
2,1066,21208,3578735326,3578735363,37
2,1066,21209,3578735326,3578735363,37
2,1066,21210,3578735326,3578735364,38
2,1066,21211,3578735326,3578735365,39
2,1066,21212,3578735326,3578735365,39
2,1066,21213,3578735326,3578735369,43
2,1066,21214,3578735326,3578735369,43
2,1066,21215,3578735326,3578735369,43
2,1066,21216,3578735326,3578735370,44
2,1066,21217,3578735326,3578735375,49
2,1066,21218,3578735326,3578735375,49
2,1066,21219,3578735326,3578735376,50
2,1067,21220,3578735386,3578735386,0
2,1067,21221,3578735386,3578735386,0
2,1067,21222,3578735386,3578735386,0
2,1067,21223,3578735386,3578735386,0
2,1067,21224,3578735386,3578735386,0
2,1067,21225,3578735386,3578735386,0
2,1067,21226,3578735386,3578735386,0
2,1067,21227,3578735386,3578735386,0
2,1067,21228,3578735386,3578735387,1
2,1067,21229,3578735386,3578735389,3
2,1067,21230,3578735386,3578735390,4
2,1067,21231,3578735386,3578735390,4
2,1067,21232,3578735386,3578735392,6
2,1067,21233,3578735386,3578735393,7
2,1067,21234,3578735386,3578735394,8
2,1067,21235,3578735386,3578735395,9
2,1067,21236,3578735386,3578735397,11
2,1067,21237,3578735386,3578735397,11
2,1067,21238,3578735386,3578735398,12
2,1067,21239,3578735386,3578735401,15
2,1067,21240,3578735386,3578735401,15
2,1067,21241,3578735386,3578735403,17
2,1067,21242,3578735386,3578735404,18
2,1067,21243,3578735386,3578735406,20
2,1067,21244,3578735386,3578735409,23
2,1067,21245,3578735386,3578735411,25
2,1067,21246,3578735386,3578735411,25
2,1067,21247,3578735386,3578735413,27
2,1067,21248,3578735386,3578735414,28
2,1067,21249,3578735386,3578735415,29
2,1067,21250,3578735386,3578735416,30
2,1067,21251,3578735386,3578735417,31
2,1067,21252,3578735386,3578735420,34
2,1067,21253,3578735386,3578735420,34
2,1067,21254,3578735386,3578735424,38
2,1067,21255,3578735386,3578735425,39
2,1067,21256,3578735386,3578735425,39
2,1067,21257,3578735386,3578735427,41
2,1067,21258,3578735386,3578735427,41
2,1067,21259,3578735386,3578735428,42
2,1067,21260,3578735386,3578735429,43
2,1067,21261,3578735386,3578735430,44
2,1067,21262,3578735386,3578735431,45
2,1067,21263,3578735386,3578735432,46
2,1067,21264,3578735386,3578735433,47
2,1067,21265,3578735386,3578735435,49
2,1067,21266,3578735386,3578735435,49
2,1067,21267,3578735386,3578735435,49
2,1068,21268,3578735449,3578735449,0
2,1068,21269,3578735449,3578735449,0
2,1068,21270,3578735449,3578735449,0
2,1068,21271,3578735449,3578735449,0
2,1068,21272,3578735449,3578735449,0
2,1068,21273,3578735449,3578735449,0
2,1068,21274,3578735449,3578735449,0
2,1068,21275,3578735449,3578735449,0
2,1068,21276,3578735449,3578735449,0
2,1068,21277,3578735449,3578735449,0
2,1068,21278,3578735449,3578735449,0
2,1068,21279,3578735449,3578735451,2
2,1068,21280,3578735449,3578735451,2
2,1068,21281,3578735449,3578735452,3
2,1068,21282,3578735449,3578735453,4
2,1068,21283,3578735449,3578735453,4
2,1068,21284,3578735449,3578735454,5
2,1068,21285,3578735449,3578735455,6
2,1068,21286,3578735449,3578735456,7
2,1068,21287,3578735449,3578735457,8
2,1068,21288,3578735449,3578735458,9
2,1068,21289,3578735449,3578735458,9
2,1068,21290,3578735449,3578735459,10
2,1068,21291,3578735449,3578735460,11
2,1068,21292,3578735449,3578735460,11
2,1068,21293,3578735449,3578735461,12
2,1068,21294,3578735449,3578735465,16
2,1068,21295,3578735449,3578735466,17
2,1068,21296,3578735449,3578735467,18
2,1068,21297,3578735449,3578735467,18
2,1068,21298,3578735449,3578735469,20
2,1068,21299,3578735449,3578735469,20
2,1068,21300,3578735449,3578735470,21
2,1068,21301,3578735449,3578735480,31
2,1068,21302,3578735449,3578735481,32
2,1068,21303,3578735449,3578735482,33
2,1068,21304,3578735449,3578735482,33
2,1068,21305,3578735449,3578735483,34
2,1068,21306,3578735449,3578735484,35
2,1068,21307,3578735449,3578735484,35
2,1068,21308,3578735449,3578735485,36
2,1068,21309,3578735449,3578735485,36
2,1068,21310,3578735449,3578735488,39
2,1068,21311,3578735449,3578735489,40
2,1068,21312,3578735449,3578735490,41
2,1068,21313,3578735449,3578735491,42
2,1068,21314,3578735449,3578735491,42
2,1068,21315,3578735449,3578735491,42
2,1068,21316,3578735449,3578735492,43
2,1068,21317,3578735449,3578735492,43
2,1068,21318,3578735449,3578735492,43
2,1068,21319,3578735449,3578735493,44
2,1068,21320,3578735449,3578735494,45
2,1068,21321,3578735449,3578735495,46
2,1068,21322,3578735449,3578735497,48
2,1068,21323,3578735449,3578735498,49
2,1069,21324,3578735511,3578735511,0
2,1069,21325,3578735511,3578735511,0
2,1069,21326,3578735511,3578735511,0
2,1069,21327,3578735511,3578735511,0
2,1069,21328,3578735511,3578735511,0
2,1069,21329,3578735511,3578735511,0
2,1069,21330,3578735511,3578735511,0
2,1069,21331,3578735511,3578735511,0
2,1069,21332,3578735511,3578735511,0
2,1069,21333,3578735511,3578735511,0
2,1069,21334,3578735511,3578735511,0
2,1069,21335,3578735511,3578735511,0
2,1069,21336,3578735511,3578735511,0
2,1069,21337,3578735511,3578735511,0
2,1069,21338,3578735511,3578735511,0
2,1069,21339,3578735511,3578735511,0
2,1069,21340,3578735511,3578735511,0
2,1069,21341,3578735511,3578735511,0
2,1069,21342,3578735511,3578735512,1
2,1069,21343,3578735511,3578735513,2
2,1069,21344,3578735511,3578735513,2
2,1069,21345,3578735511,3578735513,2
2,1069,21346,3578735511,3578735514,3
2,1069,21347,3578735511,3578735516,5
2,1069,21348,3578735511,3578735518,7
2,1069,21349,3578735511,3578735518,7
2,1069,21350,3578735511,3578735519,8
2,1069,21351,3578735511,3578735520,9
2,1069,21352,3578735511,3578735520,9
2,1069,21353,3578735511,3578735520,9
2,1069,21354,3578735511,3578735520,9
2,1069,21355,3578735511,3578735521,10
2,1069,21356,3578735511,3578735521,10
2,1069,21357,3578735511,3578735522,11
2,1069,21358,3578735511,3578735524,13
2,1069,21359,3578735511,3578735524,13
2,1069,21360,3578735511,3578735525,14
2,1069,21361,3578735511,3578735525,14
2,1069,21362,3578735511,3578735526,15
2,1069,21363,3578735511,3578735526,15
2,1069,21364,3578735511,3578735527,16
2,1069,21365,3578735511,3578735529,18
2,1069,21366,3578735511,3578735529,18
2,1069,21367,3578735511,3578735532,21
2,1069,21368,3578735511,3578735532,21
2,1069,21369,3578735511,3578735532,21
2,1069,21370,3578735511,3578735533,22
2,1069,21371,3578735511,3578735534,23
2,1069,21372,3578735511,3578735534,23
2,1069,21373,3578735511,3578735535,24
2,1069,21374,3578735511,3578735535,24
2,1069,21375,3578735511,3578735536,25
2,1069,21376,3578735511,3578735536,25
2,1069,21377,3578735511,3578735537,26
2,1069,21378,3578735511,3578735538,27
2,1069,21379,3578735511,3578735539,28
2,1069,21380,3578735511,3578735540,29
2,1069,21381,3578735511,3578735542,31
2,1069,21382,3578735511,3578735542,31
2,1069,21383,3578735511,3578735542,31
2,1069,21384,3578735511,3578735546,35
2,1069,21385,3578735511,3578735548,37
2,1069,21386,3578735511,3578735549,38
2,1069,21387,3578735511,3578735551,40
2,1069,21388,3578735511,3578735554,43
2,1069,21389,3578735511,3578735555,44
2,1069,21390,3578735511,3578735558,47
2,1069,21391,3578735511,3578735559,48
2,1069,21392,3578735511,3578735561,50
2,1070,21393,3578735571,3578735571,0
2,1070,21394,3578735571,3578735571,0
2,1070,21395,3578735571,3578735571,0
2,1070,21396,3578735571,3578735571,0
2,1070,21397,3578735571,3578735571,0
2,1070,21398,3578735571,3578735571,0
2,1070,21399,3578735571,3578735571,0
2,1070,21400,3578735571,3578735571,0
2,1070,21401,3578735571,3578735571,0
2,1070,21402,3578735571,3578735571,0
2,1070,21403,3578735571,3578735574,3
2,1070,21404,3578735571,3578735575,4
2,1070,21405,3578735571,3578735575,4
2,1070,21406,3578735571,3578735575,4
2,1070,21407,3578735571,3578735580,9
2,1070,21408,3578735571,3578735580,9
2,1070,21409,3578735571,3578735580,9
2,1070,21410,3578735571,3578735581,10
2,1070,21411,3578735571,3578735583,12
2,1070,21412,3578735571,3578735583,12
2,1070,21413,3578735571,3578735584,13
2,1070,21414,3578735571,3578735585,14
2,1070,21415,3578735571,3578735585,14
2,1070,21416,3578735571,3578735585,14
2,1070,21417,3578735571,3578735589,18
2,1070,21418,3578735571,3578735589,18
2,1070,21419,3578735571,3578735589,18
2,1070,21420,3578735571,3578735591,20
2,1070,21421,3578735571,3578735593,22
2,1070,21422,3578735571,3578735593,22
2,1070,21423,3578735571,3578735594,23
2,1070,21424,3578735571,3578735595,24
2,1070,21425,3578735571,3578735596,25
2,1070,21426,3578735571,3578735598,27
2,1070,21427,3578735571,3578735599,28
2,1070,21428,3578735571,3578735600,29
2,1070,21429,3578735571,3578735602,31
2,1070,21430,3578735571,3578735603,32
2,1070,21431,3578735571,3578735606,35
2,1070,21432,3578735571,3578735610,39
2,1070,21433,3578735571,3578735612,41
2,1070,21434,3578735571,3578735612,41
2,1070,21435,3578735571,3578735614,43
2,1070,21436,3578735571,3578735615,44
2,1070,21437,3578735571,3578735616,45
2,1070,21438,3578735571,3578735616,45
2,1070,21439,3578735571,3578735619,48
2,1070,21440,3578735571,3578735620,49
2,1070,21441,3578735571,3578735620,49
2,1071,21442,3578735630,3578735630,0
2,1071,21443,3578735630,3578735630,0
2,1071,21444,3578735630,3578735630,0
2,1071,21445,3578735630,3578735630,0
2,1071,21446,3578735630,3578735630,0
2,1071,21447,3578735630,3578735630,0
2,1071,21448,3578735630,3578735630,0
2,1071,21449,3578735630,3578735630,0
2,1071,21450,3578735630,3578735630,0
2,1071,21451,3578735630,3578735630,0
2,1071,21452,3578735630,3578735632,2
2,1071,21453,3578735630,3578735634,4
2,1071,21454,3578735630,3578735634,4
2,1071,21455,3578735630,3578735634,4
2,1071,21456,3578735630,3578735637,7
2,1071,21457,3578735630,3578735638,8
2,1071,21458,3578735630,3578735638,8
2,1071,21459,3578735630,3578735639,9
2,1071,21460,3578735630,3578735639,9
2,1071,21461,3578735630,3578735639,9
2,1071,21462,3578735630,3578735641,11
2,1071,21463,3578735630,3578735642,12
2,1071,21464,3578735630,3578735642,12
2,1071,21465,3578735630,3578735646,16
2,1071,21466,3578735630,3578735647,17
2,1071,21467,3578735630,3578735647,17
2,1071,21468,3578735630,3578735650,20
2,1071,21469,3578735630,3578735651,21
2,1071,21470,3578735630,3578735651,21
2,1071,21471,3578735630,3578735652,22
2,1071,21472,3578735630,3578735653,23
2,1071,21473,3578735630,3578735654,24
2,1071,21474,3578735630,3578735655,25
2,1071,21475,3578735630,3578735656,26
2,1071,21476,3578735630,3578735657,27
2,1071,21477,3578735630,3578735658,28
2,1071,21478,3578735630,3578735659,29
2,1071,21479,3578735630,3578735659,29
2,1071,21480,3578735630,3578735659,29
2,1071,21481,3578735630,3578735659,29
2,1071,21482,3578735630,3578735660,30
2,1071,21483,3578735630,3578735665,35
2,1071,21484,3578735630,3578735665,35
2,1071,21485,3578735630,3578735666,36
2,1071,21486,3578735630,3578735667,37
2,1071,21487,3578735630,3578735667,37
2,1071,21488,3578735630,3578735668,38
2,1071,21489,3578735630,3578735669,39
2,1071,21490,3578735630,3578735670,40
2,1072,21491,3578735688,3578735688,0
2,1072,21492,3578735688,3578735688,0
2,1072,21493,3578735688,3578735688,0
2,1072,21494,3578735688,3578735688,0
2,1072,21495,3578735688,3578735688,0
2,1072,21496,3578735688,3578735688,0
2,1072,21497,3578735688,3578735688,0
2,1072,21498,3578735688,3578735688,0
2,1072,21499,3578735688,3578735688,0
2,1072,21500,3578735688,3578735688,0
2,1072,21501,3578735688,3578735688,0
2,1072,21502,3578735688,3578735688,0
2,1072,21503,3578735688,3578735688,0
2,1072,21504,3578735688,3578735690,2
2,1072,21505,3578735688,3578735690,2
2,1072,21506,3578735688,3578735691,3
2,1072,21507,3578735688,3578735692,4
2,1072,21508,3578735688,3578735692,4
2,1072,21509,3578735688,3578735692,4
2,1072,21510,3578735688,3578735693,5
2,1072,21511,3578735688,3578735693,5
2,1072,21512,3578735688,3578735695,7
2,1072,21513,3578735688,3578735696,8
2,1072,21514,3578735688,3578735697,9
2,1072,21515,3578735688,3578735699,11
2,1072,21516,3578735688,3578735699,11
2,1072,21517,3578735688,3578735699,11
2,1072,21518,3578735688,3578735700,12
2,1072,21519,3578735688,3578735700,12
2,1072,21520,3578735688,3578735701,13
2,1072,21521,3578735688,3578735701,13
2,1072,21522,3578735688,3578735703,15
2,1072,21523,3578735688,3578735705,17
2,1072,21524,3578735688,3578735706,18
2,1072,21525,3578735688,3578735706,18
2,1072,21526,3578735688,3578735706,18
2,1072,21527,3578735688,3578735708,20
2,1072,21528,3578735688,3578735708,20
2,1072,21529,3578735688,3578735709,21
2,1072,21530,3578735688,3578735709,21
2,1072,21531,3578735688,3578735712,24
2,1072,21532,3578735688,3578735712,24
2,1072,21533,3578735688,3578735712,24
2,1072,21534,3578735688,3578735713,25
2,1072,21535,3578735688,3578735714,26
2,1072,21536,3578735688,3578735716,28
2,1072,21537,3578735688,3578735717,29
2,1072,21538,3578735688,3578735719,31
2,1072,21539,3578735688,3578735719,31
2,1072,21540,3578735688,3578735719,31
2,1072,21541,3578735688,3578735720,32
2,1072,21542,3578735688,3578735721,33
2,1072,21543,3578735688,3578735721,33
2,1072,21544,3578735688,3578735721,33
2,1072,21545,3578735688,3578735723,35
2,1072,21546,3578735688,3578735724,36
2,1072,21547,3578735688,3578735725,37
2,1072,21548,3578735688,3578735725,37
2,1072,21549,3578735688,3578735725,37
2,1072,21550,3578735688,3578735726,38
2,1072,21551,3578735688,3578735727,39
2,1072,21552,3578735688,3578735727,39
2,1072,21553,3578735688,3578735729,41
2,1072,21554,3578735688,3578735729,41
2,1072,21555,3578735688,3578735732,44
2,1072,21556,3578735688,3578735732,44
2,1072,21557,3578735688,3578735732,44
2,1072,21558,3578735688,3578735733,45
2,1072,21559,3578735688,3578735734,46
2,1072,21560,3578735688,3578735734,46
2,1072,21561,3578735688,3578735734,46
2,1072,21562,3578735688,3578735735,47
2,1072,21563,3578735688,3578735736,48
2,1072,21564,3578735688,3578735736,48
2,1072,21565,3578735688,3578735736,48
2,1072,21566,3578735688,3578735738,50
2,1073,21567,3578735748,3578735749,1
2,1073,21568,3578735748,3578735749,1
2,1073,21569,3578735748,3578735749,1
2,1073,21570,3578735748,3578735749,1
2,1073,21571,3578735748,3578735749,1
2,1073,21572,3578735748,3578735749,1
2,1073,21573,3578735748,3578735749,1
2,1073,21574,3578735748,3578735749,1
2,1073,21575,3578735748,3578735749,1
2,1073,21576,3578735748,3578735752,4
2,1073,21577,3578735748,3578735753,5
2,1073,21578,3578735748,3578735754,6
2,1073,21579,3578735748,3578735755,7
2,1073,21580,3578735748,3578735758,10
2,1073,21581,3578735748,3578735759,11
2,1073,21582,3578735748,3578735761,13
2,1073,21583,3578735748,3578735762,14
2,1073,21584,3578735748,3578735763,15
2,1073,21585,3578735748,3578735763,15
2,1073,21586,3578735748,3578735764,16
2,1073,21587,3578735748,3578735765,17
2,1073,21588,3578735748,3578735768,20
2,1073,21589,3578735748,3578735768,20
2,1073,21590,3578735748,3578735768,20
2,1073,21591,3578735748,3578735770,22
2,1073,21592,3578735748,3578735774,26
2,1073,21593,3578735748,3578735775,27
2,1073,21594,3578735748,3578735775,27
2,1073,21595,3578735748,3578735775,27
2,1073,21596,3578735748,3578735779,31
2,1073,21597,3578735748,3578735780,32
2,1073,21598,3578735748,3578735780,32
2,1073,21599,3578735748,3578735781,33
2,1073,21600,3578735748,3578735783,35
2,1073,21601,3578735748,3578735784,36
2,1073,21602,3578735748,3578735785,37
2,1073,21603,3578735748,3578735785,37
2,1073,21604,3578735748,3578735786,38
2,1073,21605,3578735748,3578735788,40
2,1073,21606,3578735748,3578735790,42
2,1073,21607,3578735748,3578735790,42
2,1073,21608,3578735748,3578735790,42
2,1073,21609,3578735748,3578735793,45
2,1073,21610,3578735748,3578735794,46
2,1073,21611,3578735748,3578735794,46
2,1073,21612,3578735748,3578735796,48
2,1073,21613,3578735748,3578735797,49
2,1074,21614,3578735807,3578735807,0
2,1074,21615,3578735807,3578735807,0
2,1074,21616,3578735807,3578735807,0
2,1074,21617,3578735807,3578735807,0
2,1074,21618,3578735807,3578735807,0
2,1074,21619,3578735807,3578735811,4
2,1074,21620,3578735807,3578735811,4
2,1074,21621,3578735807,3578735813,6
2,1074,21622,3578735807,3578735813,6
2,1074,21623,3578735807,3578735816,9
2,1074,21624,3578735807,3578735816,9
2,1074,21625,3578735807,3578735816,9
2,1074,21626,3578735807,3578735818,11
2,1074,21627,3578735807,3578735820,13
2,1074,21628,3578735807,3578735820,13
2,1074,21629,3578735807,3578735823,16
2,1074,21630,3578735807,3578735824,17
2,1074,21631,3578735807,3578735826,19
2,1074,21632,3578735807,3578735826,19
2,1074,21633,3578735807,3578735826,19
2,1074,21634,3578735807,3578735828,21
2,1074,21635,3578735807,3578735828,21
2,1074,21636,3578735807,3578735829,22
2,1074,21637,3578735807,3578735830,23
2,1074,21638,3578735807,3578735831,24
2,1074,21639,3578735807,3578735831,24
2,1074,21640,3578735807,3578735832,25
2,1074,21641,3578735807,3578735834,27
2,1074,21642,3578735807,3578735834,27
2,1074,21643,3578735807,3578735834,27
2,1074,21644,3578735807,3578735838,31
2,1074,21645,3578735807,3578735838,31
2,1074,21646,3578735807,3578735838,31
2,1074,21647,3578735807,3578735839,32
2,1074,21648,3578735807,3578735839,32
2,1074,21649,3578735807,3578735839,32
2,1074,21650,3578735807,3578735841,34
2,1074,21651,3578735807,3578735842,35
2,1074,21652,3578735807,3578735842,35
2,1074,21653,3578735807,3578735846,39
2,1074,21654,3578735807,3578735846,39
2,1074,21655,3578735807,3578735847,40
2,1074,21656,3578735807,3578735849,42
2,1074,21657,3578735807,3578735850,43
2,1074,21658,3578735807,3578735852,45
2,1074,21659,3578735807,3578735854,47
2,1074,21660,3578735807,3578735854,47
2,1074,21661,3578735807,3578735855,48
2,1075,21662,3578735870,3578735870,0
2,1075,21663,3578735870,3578735870,0
2,1075,21664,3578735870,3578735870,0
2,1075,21665,3578735870,3578735870,0
2,1075,21666,3578735870,3578735870,0
2,1075,21667,3578735870,3578735870,0
2,1075,21668,3578735870,3578735870,0
2,1075,21669,3578735870,3578735870,0
2,1075,21670,3578735870,3578735870,0
2,1075,21671,3578735870,3578735870,0
2,1075,21672,3578735870,3578735870,0
2,1075,21673,3578735870,3578735870,0
2,1075,21674,3578735870,3578735870,0
2,1075,21675,3578735870,3578735870,0
2,1075,21676,3578735870,3578735880,10
2,1075,21677,3578735870,3578735880,10
2,1075,21678,3578735870,3578735881,11
2,1075,21679,3578735870,3578735882,12
2,1075,21680,3578735870,3578735883,13
2,1075,21681,3578735870,3578735883,13
2,1075,21682,3578735870,3578735885,15
2,1075,21683,3578735870,3578735885,15
2,1075,21684,3578735870,3578735885,15
2,1075,21685,3578735870,3578735886,16
2,1075,21686,3578735870,3578735888,18
2,1075,21687,3578735870,3578735889,19
2,1075,21688,3578735870,3578735890,20
2,1075,21689,3578735870,3578735891,21
2,1075,21690,3578735870,3578735892,22
2,1075,21691,3578735870,3578735892,22
2,1075,21692,3578735870,3578735893,23
2,1075,21693,3578735870,3578735894,24
2,1075,21694,3578735870,3578735894,24
2,1075,21695,3578735870,3578735894,24
2,1075,21696,3578735870,3578735896,26
2,1075,21697,3578735870,3578735896,26
2,1075,21698,3578735870,3578735897,27
2,1075,21699,3578735870,3578735899,29
2,1075,21700,3578735870,3578735899,29
2,1075,21701,3578735870,3578735899,29
2,1075,21702,3578735870,3578735900,30
2,1075,21703,3578735870,3578735901,31
2,1075,21704,3578735870,3578735901,31
2,1075,21705,3578735870,3578735901,31
2,1075,21706,3578735870,3578735903,33
2,1075,21707,3578735870,3578735905,35
2,1075,21708,3578735870,3578735905,35
2,1075,21709,3578735870,3578735906,36
2,1075,21710,3578735870,3578735906,36
2,1075,21711,3578735870,3578735907,37
2,1075,21712,3578735870,3578735909,39
2,1075,21713,3578735870,3578735909,39
2,1075,21714,3578735870,3578735909,39
2,1075,21715,3578735870,3578735909,39
2,1075,21716,3578735870,3578735912,42
2,1075,21717,3578735870,3578735912,42
2,1075,21718,3578735870,3578735913,43
2,1075,21719,3578735870,3578735914,44
2,1075,21720,3578735870,3578735916,46
2,1075,21721,3578735870,3578735918,48
2,1075,21722,3578735870,3578735919,49
2,1075,21723,3578735870,3578735919,49
2,1075,21724,3578735870,3578735920,50
2,1076,21725,3578735928,3578735928,0
2,1076,21726,3578735928,3578735928,0
2,1076,21727,3578735928,3578735929,1
2,1076,21728,3578735928,3578735929,1
2,1076,21729,3578735928,3578735929,1
2,1076,21730,3578735928,3578735929,1
2,1076,21731,3578735928,3578735929,1
2,1076,21732,3578735928,3578735929,1
2,1076,21733,3578735928,3578735929,1
2,1076,21734,3578735928,3578735929,1
2,1076,21735,3578735928,3578735929,1
2,1076,21736,3578735928,3578735929,1
2,1076,21737,3578735928,3578735933,5
2,1076,21738,3578735928,3578735933,5
2,1076,21739,3578735928,3578735933,5
2,1076,21740,3578735928,3578735934,6
2,1076,21741,3578735928,3578735934,6
2,1076,21742,3578735928,3578735935,7
2,1076,21743,3578735928,3578735936,8
2,1076,21744,3578735928,3578735936,8
2,1076,21745,3578735928,3578735936,8
2,1076,21746,3578735928,3578735936,8
2,1076,21747,3578735928,3578735938,10
2,1076,21748,3578735928,3578735939,11
2,1076,21749,3578735928,3578735940,12
2,1076,21750,3578735928,3578735942,14
2,1076,21751,3578735928,3578735942,14
2,1076,21752,3578735928,3578735942,14
2,1076,21753,3578735928,3578735942,14
2,1076,21754,3578735928,3578735946,18
2,1076,21755,3578735928,3578735948,20
2,1076,21756,3578735928,3578735950,22
2,1076,21757,3578735928,3578735951,23
2,1076,21758,3578735928,3578735954,26
2,1076,21759,3578735928,3578735955,27
2,1076,21760,3578735928,3578735958,30
2,1076,21761,3578735928,3578735959,31
2,1076,21762,3578735928,3578735961,33
2,1076,21763,3578735928,3578735962,34
2,1076,21764,3578735928,3578735963,35
2,1076,21765,3578735928,3578735963,35
2,1076,21766,3578735928,3578735964,36
2,1076,21767,3578735928,3578735965,37
2,1076,21768,3578735928,3578735968,40
2,1076,21769,3578735928,3578735968,40
2,1076,21770,3578735928,3578735969,41
2,1076,21771,3578735928,3578735970,42
2,1076,21772,3578735928,3578735974,46
2,1076,21773,3578735928,3578735975,47
2,1076,21774,3578735928,3578735975,47
2,1076,21775,3578735928,3578735976,48
2,1076,21776,3578735928,3578735978,50
2,1077,21777,3578735990,3578735990,0
2,1077,21778,3578735990,3578735990,0
2,1077,21779,3578735990,3578735990,0
2,1077,21780,3578735990,3578735990,0
2,1077,21781,3578735990,3578735990,0
2,1077,21782,3578735990,3578735990,0
2,1077,21783,3578735990,3578735990,0
2,1077,21784,3578735990,3578735990,0
2,1077,21785,3578735990,3578735990,0
2,1077,21786,3578735990,3578735990,0
2,1077,21787,3578735990,3578735990,0
2,1077,21788,3578735990,3578735990,0
2,1077,21789,3578735990,3578735991,1
2,1077,21790,3578735990,3578735993,3
2,1077,21791,3578735990,3578735994,4
2,1077,21792,3578735990,3578735994,4
2,1077,21793,3578735990,3578735996,6
2,1077,21794,3578735990,3578735996,6
2,1077,21795,3578735990,3578735998,8
2,1077,21796,3578735990,3578736000,10
2,1077,21797,3578735990,3578736000,10
2,1077,21798,3578735990,3578736003,13
2,1077,21799,3578735990,3578736006,16
2,1077,21800,3578735990,3578736011,21
2,1077,21801,3578735990,3578736011,21
2,1077,21802,3578735990,3578736012,22
2,1077,21803,3578735990,3578736014,24
2,1077,21804,3578735990,3578736016,26
2,1077,21805,3578735990,3578736016,26
2,1077,21806,3578735990,3578736016,26
2,1077,21807,3578735990,3578736018,28
2,1077,21808,3578735990,3578736021,31
2,1077,21809,3578735990,3578736025,35
2,1077,21810,3578735990,3578736026,36
2,1077,21811,3578735990,3578736027,37
2,1077,21812,3578735990,3578736027,37
2,1077,21813,3578735990,3578736028,38
2,1077,21814,3578735990,3578736029,39
2,1077,21815,3578735990,3578736030,40
2,1077,21816,3578735990,3578736032,42
2,1077,21817,3578735990,3578736032,42
2,1077,21818,3578735990,3578736034,44
2,1077,21819,3578735990,3578736034,44
2,1077,21820,3578735990,3578736035,45
2,1077,21821,3578735990,3578736038,48
2,1077,21822,3578735990,3578736038,48
2,1077,21823,3578735990,3578736039,49
2,1077,21824,3578735990,3578736039,49
2,1077,21825,3578735990,3578736039,49
2,1077,21826,3578735990,3578736039,49
2,1078,21827,3578736051,3578736051,0
2,1078,21828,3578736051,3578736051,0
2,1078,21829,3578736051,3578736051,0
2,1078,21830,3578736051,3578736051,0
2,1078,21831,3578736051,3578736051,0
2,1078,21832,3578736051,3578736051,0
2,1078,21833,3578736051,3578736051,0
2,1078,21834,3578736051,3578736052,1
2,1078,21835,3578736051,3578736052,1
2,1078,21836,3578736051,3578736054,3
2,1078,21837,3578736051,3578736054,3
2,1078,21838,3578736051,3578736055,4
2,1078,21839,3578736051,3578736055,4
2,1078,21840,3578736051,3578736056,5
2,1078,21841,3578736051,3578736057,6
2,1078,21842,3578736051,3578736059,8
2,1078,21843,3578736051,3578736059,8
2,1078,21844,3578736051,3578736060,9
2,1078,21845,3578736051,3578736060,9
2,1078,21846,3578736051,3578736060,9
2,1078,21847,3578736051,3578736061,10
2,1078,21848,3578736051,3578736065,14
2,1078,21849,3578736051,3578736065,14
2,1078,21850,3578736051,3578736066,15
2,1078,21851,3578736051,3578736067,16
2,1078,21852,3578736051,3578736068,17
2,1078,21853,3578736051,3578736069,18
2,1078,21854,3578736051,3578736070,19
2,1078,21855,3578736051,3578736071,20
2,1078,21856,3578736051,3578736081,30
2,1078,21857,3578736051,3578736083,32
2,1078,21858,3578736051,3578736083,32
2,1078,21859,3578736051,3578736084,33
2,1078,21860,3578736051,3578736084,33
2,1078,21861,3578736051,3578736085,34
2,1078,21862,3578736051,3578736085,34
2,1078,21863,3578736051,3578736086,35
2,1078,21864,3578736051,3578736088,37
2,1078,21865,3578736051,3578736090,39
2,1078,21866,3578736051,3578736090,39
2,1078,21867,3578736051,3578736092,41
2,1078,21868,3578736051,3578736093,42
2,1078,21869,3578736051,3578736093,42
2,1078,21870,3578736051,3578736094,43
2,1078,21871,3578736051,3578736095,44
2,1078,21872,3578736051,3578736096,45
2,1078,21873,3578736051,3578736096,45
2,1078,21874,3578736051,3578736097,46
2,1078,21875,3578736051,3578736099,48
2,1078,21876,3578736051,3578736099,48
2,1078,21877,3578736051,3578736099,48
2,1078,21878,3578736051,3578736100,49
2,1079,21879,3578736111,3578736111,0
2,1079,21880,3578736111,3578736111,0
2,1079,21881,3578736111,3578736111,0
2,1079,21882,3578736111,3578736111,0
2,1079,21883,3578736111,3578736111,0
2,1079,21884,3578736111,3578736111,0
2,1079,21885,3578736111,3578736111,0
2,1079,21886,3578736111,3578736111,0
2,1079,21887,3578736111,3578736111,0
2,1079,21888,3578736111,3578736111,0
2,1079,21889,3578736111,3578736111,0
2,1079,21890,3578736111,3578736113,2
2,1079,21891,3578736111,3578736113,2
2,1079,21892,3578736111,3578736115,4
2,1079,21893,3578736111,3578736117,6
2,1079,21894,3578736111,3578736119,8
2,1079,21895,3578736111,3578736120,9
2,1079,21896,3578736111,3578736120,9
2,1079,21897,3578736111,3578736121,10
2,1079,21898,3578736111,3578736121,10
2,1079,21899,3578736111,3578736123,12
2,1079,21900,3578736111,3578736124,13
2,1079,21901,3578736111,3578736124,13
2,1079,21902,3578736111,3578736125,14
2,1079,21903,3578736111,3578736125,14
2,1079,21904,3578736111,3578736126,15
2,1079,21905,3578736111,3578736126,15
2,1079,21906,3578736111,3578736128,17
2,1079,21907,3578736111,3578736129,18
2,1079,21908,3578736111,3578736129,18
2,1079,21909,3578736111,3578736133,22
2,1079,21910,3578736111,3578736133,22
2,1079,21911,3578736111,3578736133,22
2,1079,21912,3578736111,3578736134,23
2,1079,21913,3578736111,3578736134,23
2,1079,21914,3578736111,3578736134,23
2,1079,21915,3578736111,3578736135,24
2,1079,21916,3578736111,3578736136,25
2,1079,21917,3578736111,3578736137,26
2,1079,21918,3578736111,3578736137,26
2,1079,21919,3578736111,3578736138,27
2,1079,21920,3578736111,3578736138,27
2,1079,21921,3578736111,3578736139,28
2,1079,21922,3578736111,3578736140,29
2,1079,21923,3578736111,3578736142,31
2,1079,21924,3578736111,3578736143,32
2,1079,21925,3578736111,3578736143,32
2,1079,21926,3578736111,3578736143,32
2,1079,21927,3578736111,3578736145,34
2,1079,21928,3578736111,3578736150,39
2,1079,21929,3578736111,3578736154,43
2,1079,21930,3578736111,3578736155,44
2,1079,21931,3578736111,3578736158,47
2,1079,21932,3578736111,3578736158,47
2,1080,21933,3578736172,3578736172,0
2,1080,21934,3578736172,3578736172,0
2,1080,21935,3578736172,3578736172,0
2,1080,21936,3578736172,3578736172,0
2,1080,21937,3578736172,3578736172,0
2,1080,21938,3578736172,3578736172,0
2,1080,21939,3578736172,3578736172,0
2,1080,21940,3578736172,3578736172,0
2,1080,21941,3578736172,3578736172,0
2,1080,21942,3578736172,3578736172,0
2,1080,21943,3578736172,3578736172,0
2,1080,21944,3578736172,3578736175,3
2,1080,21945,3578736172,3578736175,3
2,1080,21946,3578736172,3578736175,3
2,1080,21947,3578736172,3578736176,4
2,1080,21948,3578736172,3578736179,7
2,1080,21949,3578736172,3578736180,8
2,1080,21950,3578736172,3578736180,8
2,1080,21951,3578736172,3578736181,9
2,1080,21952,3578736172,3578736182,10
2,1080,21953,3578736172,3578736183,11
2,1080,21954,3578736172,3578736184,12
2,1080,21955,3578736172,3578736185,13
2,1080,21956,3578736172,3578736186,14
2,1080,21957,3578736172,3578736189,17
2,1080,21958,3578736172,3578736189,17
2,1080,21959,3578736172,3578736190,18
2,1080,21960,3578736172,3578736190,18
2,1080,21961,3578736172,3578736190,18
2,1080,21962,3578736172,3578736194,22
2,1080,21963,3578736172,3578736194,22
2,1080,21964,3578736172,3578736194,22
2,1080,21965,3578736172,3578736194,22
2,1080,21966,3578736172,3578736196,24
2,1080,21967,3578736172,3578736198,26
2,1080,21968,3578736172,3578736200,28
2,1080,21969,3578736172,3578736200,28
2,1080,21970,3578736172,3578736203,31
2,1080,21971,3578736172,3578736206,34
2,1080,21972,3578736172,3578736211,39
2,1080,21973,3578736172,3578736212,40
2,1080,21974,3578736172,3578736213,41
2,1080,21975,3578736172,3578736213,41
2,1080,21976,3578736172,3578736215,43
2,1080,21977,3578736172,3578736216,44
2,1080,21978,3578736172,3578736218,46
2,1080,21979,3578736172,3578736219,47
2,1080,21980,3578736172,3578736220,48
2,1081,21981,3578736233,3578736233,0
2,1081,21982,3578736233,3578736233,0
2,1081,21983,3578736233,3578736233,0
2,1081,21984,3578736233,3578736233,0
2,1081,21985,3578736233,3578736233,0
2,1081,21986,3578736233,3578736233,0
2,1081,21987,3578736233,3578736233,0
2,1081,21988,3578736233,3578736233,0
2,1081,21989,3578736233,3578736233,0
2,1081,21990,3578736233,3578736233,0
2,1081,21991,3578736233,3578736233,0
2,1081,21992,3578736233,3578736234,1
2,1081,21993,3578736233,3578736235,2
2,1081,21994,3578736233,3578736237,4
2,1081,21995,3578736233,3578736239,6
2,1081,21996,3578736233,3578736239,6
2,1081,21997,3578736233,3578736239,6
2,1081,21998,3578736233,3578736239,6
2,1081,21999,3578736233,3578736240,7
2,1081,22000,3578736233,3578736241,8
2,1081,22001,3578736233,3578736242,9
2,1081,22002,3578736233,3578736242,9
2,1081,22003,3578736233,3578736242,9
2,1081,22004,3578736233,3578736246,13
2,1081,22005,3578736233,3578736246,13
2,1081,22006,3578736233,3578736247,14
2,1081,22007,3578736233,3578736249,16
2,1081,22008,3578736233,3578736251,18
2,1081,22009,3578736233,3578736252,19
2,1081,22010,3578736233,3578736252,19
2,1081,22011,3578736233,3578736254,21
2,1081,22012,3578736233,3578736255,22
2,1081,22013,3578736233,3578736255,22
2,1081,22014,3578736233,3578736256,23
2,1081,22015,3578736233,3578736257,24
2,1081,22016,3578736233,3578736259,26
2,1081,22017,3578736233,3578736259,26
2,1081,22018,3578736233,3578736260,27
2,1081,22019,3578736233,3578736260,27
2,1081,22020,3578736233,3578736261,28
2,1081,22021,3578736233,3578736261,28
2,1081,22022,3578736233,3578736265,32
2,1081,22023,3578736233,3578736265,32
2,1081,22024,3578736233,3578736267,34
2,1081,22025,3578736233,3578736268,35
2,1081,22026,3578736233,3578736269,36
2,1081,22027,3578736233,3578736269,36
2,1081,22028,3578736233,3578736270,37
2,1081,22029,3578736233,3578736272,39
2,1081,22030,3578736233,3578736281,48
2,1081,22031,3578736233,3578736281,48
2,1082,22032,3578736292,3578736292,0
2,1082,22033,3578736292,3578736292,0
2,1082,22034,3578736292,3578736292,0
2,1082,22035,3578736292,3578736292,0
2,1082,22036,3578736292,3578736292,0
2,1082,22037,3578736292,3578736292,0
2,1082,22038,3578736292,3578736292,0
2,1082,22039,3578736292,3578736292,0
2,1082,22040,3578736292,3578736292,0
2,1082,22041,3578736292,3578736292,0
2,1082,22042,3578736292,3578736292,0
2,1082,22043,3578736292,3578736292,0
2,1082,22044,3578736292,3578736293,1
2,1082,22045,3578736292,3578736293,1
2,1082,22046,3578736292,3578736294,2
2,1082,22047,3578736292,3578736294,2
2,1082,22048,3578736292,3578736294,2
2,1082,22049,3578736292,3578736296,4
2,1082,22050,3578736292,3578736296,4
2,1082,22051,3578736292,3578736297,5
2,1082,22052,3578736292,3578736298,6
2,1082,22053,3578736292,3578736299,7
2,1082,22054,3578736292,3578736299,7
2,1082,22055,3578736292,3578736300,8
2,1082,22056,3578736292,3578736301,9
2,1082,22057,3578736292,3578736303,11
2,1082,22058,3578736292,3578736305,13
2,1082,22059,3578736292,3578736306,14
2,1082,22060,3578736292,3578736306,14
2,1082,22061,3578736292,3578736306,14
2,1082,22062,3578736292,3578736307,15
2,1082,22063,3578736292,3578736308,16
2,1082,22064,3578736292,3578736309,17
2,1082,22065,3578736292,3578736310,18
2,1082,22066,3578736292,3578736310,18
2,1082,22067,3578736292,3578736311,19
2,1082,22068,3578736292,3578736312,20
2,1082,22069,3578736292,3578736312,20
2,1082,22070,3578736292,3578736313,21
2,1082,22071,3578736292,3578736313,21
2,1082,22072,3578736292,3578736314,22
2,1082,22073,3578736292,3578736316,24
2,1082,22074,3578736292,3578736317,25
2,1082,22075,3578736292,3578736317,25
2,1082,22076,3578736292,3578736319,27
2,1082,22077,3578736292,3578736320,28
2,1082,22078,3578736292,3578736320,28
2,1082,22079,3578736292,3578736320,28
2,1082,22080,3578736292,3578736322,30
2,1082,22081,3578736292,3578736322,30
2,1082,22082,3578736292,3578736323,31
2,1082,22083,3578736292,3578736324,32
2,1082,22084,3578736292,3578736325,33
2,1082,22085,3578736292,3578736325,33
2,1082,22086,3578736292,3578736325,33
2,1082,22087,3578736292,3578736325,33
2,1082,22088,3578736292,3578736326,34
2,1082,22089,3578736292,3578736327,35
2,1082,22090,3578736292,3578736329,37
2,1082,22091,3578736292,3578736329,37
2,1082,22092,3578736292,3578736332,40
2,1082,22093,3578736292,3578736332,40
2,1082,22094,3578736292,3578736333,41
2,1082,22095,3578736292,3578736334,42
2,1082,22096,3578736292,3578736334,42
2,1082,22097,3578736292,3578736334,42
2,1082,22098,3578736292,3578736334,42
2,1082,22099,3578736292,3578736336,44
2,1082,22100,3578736292,3578736336,44
2,1082,22101,3578736292,3578736337,45
2,1082,22102,3578736292,3578736338,46
2,1082,22103,3578736292,3578736338,46
2,1082,22104,3578736292,3578736340,48
2,1082,22105,3578736292,3578736341,49
2,1082,22106,3578736292,3578736342,50
2,1083,22107,3578736352,3578736352,0
2,1083,22108,3578736352,3578736352,0
2,1083,22109,3578736352,3578736352,0
2,1083,22110,3578736352,3578736352,0
2,1083,22111,3578736352,3578736352,0
2,1083,22112,3578736352,3578736352,0
2,1083,22113,3578736352,3578736352,0
2,1083,22114,3578736352,3578736355,3
2,1083,22115,3578736352,3578736355,3
2,1083,22116,3578736352,3578736358,6
2,1083,22117,3578736352,3578736360,8
2,1083,22118,3578736352,3578736362,10
2,1083,22119,3578736352,3578736362,10
2,1083,22120,3578736352,3578736363,11
2,1083,22121,3578736352,3578736363,11
2,1083,22122,3578736352,3578736364,12
2,1083,22123,3578736352,3578736365,13
2,1083,22124,3578736352,3578736368,16
2,1083,22125,3578736352,3578736368,16
2,1083,22126,3578736352,3578736369,17
2,1083,22127,3578736352,3578736370,18
2,1083,22128,3578736352,3578736375,23
2,1083,22129,3578736352,3578736375,23
2,1083,22130,3578736352,3578736375,23
2,1083,22131,3578736352,3578736377,25
2,1083,22132,3578736352,3578736379,27
2,1083,22133,3578736352,3578736380,28
2,1083,22134,3578736352,3578736381,29
2,1083,22135,3578736352,3578736382,30
2,1083,22136,3578736352,3578736384,32
2,1083,22137,3578736352,3578736384,32
2,1083,22138,3578736352,3578736385,33
2,1083,22139,3578736352,3578736386,34
2,1083,22140,3578736352,3578736387,35
2,1083,22141,3578736352,3578736389,37
2,1083,22142,3578736352,3578736389,37
2,1083,22143,3578736352,3578736391,39
2,1083,22144,3578736352,3578736391,39
2,1083,22145,3578736352,3578736391,39
2,1083,22146,3578736352,3578736394,42
2,1083,22147,3578736352,3578736394,42
2,1083,22148,3578736352,3578736394,42
2,1083,22149,3578736352,3578736394,42
2,1083,22150,3578736352,3578736398,46
2,1083,22151,3578736352,3578736400,48
2,1083,22152,3578736352,3578736400,48
2,1084,22153,3578736414,3578736414,0
2,1084,22154,3578736414,3578736414,0
2,1084,22155,3578736414,3578736414,0
2,1084,22156,3578736414,3578736414,0
2,1084,22157,3578736414,3578736414,0
2,1084,22158,3578736414,3578736414,0
2,1084,22159,3578736414,3578736415,1
2,1084,22160,3578736414,3578736417,3
2,1084,22161,3578736414,3578736418,4
2,1084,22162,3578736414,3578736420,6
2,1084,22163,3578736414,3578736424,10
2,1084,22164,3578736414,3578736427,13
2,1084,22165,3578736414,3578736427,13
2,1084,22166,3578736414,3578736428,14
2,1084,22167,3578736414,3578736428,14
2,1084,22168,3578736414,3578736428,14
2,1084,22169,3578736414,3578736430,16
2,1084,22170,3578736414,3578736430,16
2,1084,22171,3578736414,3578736431,17
2,1084,22172,3578736414,3578736432,18
2,1084,22173,3578736414,3578736432,18
2,1084,22174,3578736414,3578736433,19
2,1084,22175,3578736414,3578736434,20
2,1084,22176,3578736414,3578736435,21
2,1084,22177,3578736414,3578736438,24
2,1084,22178,3578736414,3578736439,25
2,1084,22179,3578736414,3578736439,25
2,1084,22180,3578736414,3578736439,25
2,1084,22181,3578736414,3578736440,26
2,1084,22182,3578736414,3578736441,27
2,1084,22183,3578736414,3578736442,28
2,1084,22184,3578736414,3578736442,28
2,1084,22185,3578736414,3578736442,28
2,1084,22186,3578736414,3578736446,32
2,1084,22187,3578736414,3578736452,38
2,1084,22188,3578736414,3578736452,38
2,1084,22189,3578736414,3578736452,38
2,1084,22190,3578736414,3578736454,40
2,1084,22191,3578736414,3578736455,41
2,1084,22192,3578736414,3578736455,41
2,1084,22193,3578736414,3578736455,41
2,1084,22194,3578736414,3578736456,42
2,1084,22195,3578736414,3578736457,43
2,1084,22196,3578736414,3578736457,43
2,1084,22197,3578736414,3578736459,45
2,1084,22198,3578736414,3578736459,45
2,1084,22199,3578736414,3578736460,46
2,1084,22200,3578736414,3578736461,47
2,1084,22201,3578736414,3578736461,47
2,1084,22202,3578736414,3578736462,48
2,1085,22203,3578736476,3578736476,0
2,1085,22204,3578736476,3578736476,0
2,1085,22205,3578736476,3578736476,0
2,1085,22206,3578736476,3578736476,0
2,1085,22207,3578736476,3578736476,0
2,1085,22208,3578736476,3578736476,0
2,1085,22209,3578736476,3578736476,0
2,1085,22210,3578736476,3578736476,0
2,1085,22211,3578736476,3578736476,0
2,1085,22212,3578736476,3578736480,4
2,1085,22213,3578736476,3578736480,4
2,1085,22214,3578736476,3578736482,6
2,1085,22215,3578736476,3578736483,7
2,1085,22216,3578736476,3578736483,7
2,1085,22217,3578736476,3578736483,7
2,1085,22218,3578736476,3578736485,9
2,1085,22219,3578736476,3578736485,9
2,1085,22220,3578736476,3578736486,10
2,1085,22221,3578736476,3578736489,13
2,1085,22222,3578736476,3578736491,15
2,1085,22223,3578736476,3578736491,15
2,1085,22224,3578736476,3578736493,17
2,1085,22225,3578736476,3578736493,17
2,1085,22226,3578736476,3578736494,18
2,1085,22227,3578736476,3578736494,18
2,1085,22228,3578736476,3578736495,19
2,1085,22229,3578736476,3578736496,20
2,1085,22230,3578736476,3578736496,20
2,1085,22231,3578736476,3578736498,22
2,1085,22232,3578736476,3578736498,22
2,1085,22233,3578736476,3578736498,22
2,1085,22234,3578736476,3578736499,23
2,1085,22235,3578736476,3578736500,24
2,1085,22236,3578736476,3578736500,24
2,1085,22237,3578736476,3578736500,24
2,1085,22238,3578736476,3578736503,27
2,1085,22239,3578736476,3578736504,28
2,1085,22240,3578736476,3578736506,30
2,1085,22241,3578736476,3578736506,30
2,1085,22242,3578736476,3578736506,30
2,1085,22243,3578736476,3578736508,32
2,1085,22244,3578736476,3578736508,32
2,1085,22245,3578736476,3578736508,32
2,1085,22246,3578736476,3578736511,35
2,1085,22247,3578736476,3578736511,35
2,1085,22248,3578736476,3578736511,35
2,1085,22249,3578736476,3578736511,35
2,1085,22250,3578736476,3578736514,38
2,1085,22251,3578736476,3578736515,39
2,1085,22252,3578736476,3578736515,39
2,1085,22253,3578736476,3578736517,41
2,1085,22254,3578736476,3578736518,42
2,1085,22255,3578736476,3578736518,42
2,1085,22256,3578736476,3578736519,43
2,1085,22257,3578736476,3578736520,44
2,1085,22258,3578736476,3578736520,44
2,1085,22259,3578736476,3578736521,45
2,1085,22260,3578736476,3578736522,46
2,1085,22261,3578736476,3578736523,47
2,1085,22262,3578736476,3578736524,48
2,1085,22263,3578736476,3578736524,48
2,1085,22264,3578736476,3578736524,48
2,1085,22265,3578736476,3578736525,49
2,1085,22266,3578736476,3578736525,49
2,1085,22267,3578736476,3578736525,49
2,1085,22268,3578736476,3578736526,50
2,1086,22269,3578736537,3578736537,0
2,1086,22270,3578736537,3578736537,0
2,1086,22271,3578736537,3578736537,0
2,1086,22272,3578736537,3578736537,0
2,1086,22273,3578736537,3578736537,0
2,1086,22274,3578736537,3578736537,0
2,1086,22275,3578736537,3578736537,0
2,1086,22276,3578736537,3578736538,1
2,1086,22277,3578736537,3578736538,1
2,1086,22278,3578736537,3578736538,1
2,1086,22279,3578736537,3578736538,1
2,1086,22280,3578736537,3578736538,1
2,1086,22281,3578736537,3578736538,1
2,1086,22282,3578736537,3578736538,1
2,1086,22283,3578736537,3578736538,1
2,1086,22284,3578736537,3578736538,1
2,1086,22285,3578736537,3578736539,2
2,1086,22286,3578736537,3578736541,4
2,1086,22287,3578736537,3578736542,5
2,1086,22288,3578736537,3578736542,5
2,1086,22289,3578736537,3578736543,6
2,1086,22290,3578736537,3578736548,11
2,1086,22291,3578736537,3578736549,12
2,1086,22292,3578736537,3578736550,13
2,1086,22293,3578736537,3578736552,15
2,1086,22294,3578736537,3578736554,17
2,1086,22295,3578736537,3578736554,17
2,1086,22296,3578736537,3578736556,19
2,1086,22297,3578736537,3578736559,22
2,1086,22298,3578736537,3578736559,22
2,1086,22299,3578736537,3578736562,25
2,1086,22300,3578736537,3578736562,25
2,1086,22301,3578736537,3578736562,25
2,1086,22302,3578736537,3578736563,26
2,1086,22303,3578736537,3578736564,27
2,1086,22304,3578736537,3578736565,28
2,1086,22305,3578736537,3578736567,30
2,1086,22306,3578736537,3578736568,31
2,1086,22307,3578736537,3578736568,31
2,1086,22308,3578736537,3578736569,32
2,1086,22309,3578736537,3578736574,37
2,1086,22310,3578736537,3578736574,37
2,1086,22311,3578736537,3578736575,38
2,1086,22312,3578736537,3578736576,39
2,1086,22313,3578736537,3578736578,41
2,1086,22314,3578736537,3578736578,41
2,1086,22315,3578736537,3578736579,42
2,1086,22316,3578736537,3578736579,42
2,1086,22317,3578736537,3578736581,44
2,1086,22318,3578736537,3578736581,44
2,1086,22319,3578736537,3578736583,46
2,1086,22320,3578736537,3578736584,47
2,1086,22321,3578736537,3578736584,47
2,1086,22322,3578736537,3578736585,48
2,1086,22323,3578736537,3578736586,49
2,1087,22324,3578736597,3578736597,0
2,1087,22325,3578736597,3578736597,0
2,1087,22326,3578736597,3578736597,0
2,1087,22327,3578736597,3578736597,0
2,1087,22328,3578736597,3578736597,0
2,1087,22329,3578736597,3578736597,0
2,1087,22330,3578736597,3578736597,0
2,1087,22331,3578736597,3578736597,0
2,1087,22332,3578736597,3578736597,0
2,1087,22333,3578736597,3578736597,0
2,1087,22334,3578736597,3578736599,2
2,1087,22335,3578736597,3578736603,6
2,1087,22336,3578736597,3578736606,9
2,1087,22337,3578736597,3578736606,9
2,1087,22338,3578736597,3578736607,10
2,1087,22339,3578736597,3578736610,13
2,1087,22340,3578736597,3578736611,14
2,1087,22341,3578736597,3578736612,15
2,1087,22342,3578736597,3578736612,15
2,1087,22343,3578736597,3578736613,16
2,1087,22344,3578736597,3578736616,19
2,1087,22345,3578736597,3578736617,20
2,1087,22346,3578736597,3578736619,22
2,1087,22347,3578736597,3578736620,23
2,1087,22348,3578736597,3578736620,23
2,1087,22349,3578736597,3578736623,26
2,1087,22350,3578736597,3578736624,27
2,1087,22351,3578736597,3578736625,28
2,1087,22352,3578736597,3578736626,29
2,1087,22353,3578736597,3578736627,30
2,1087,22354,3578736597,3578736627,30
2,1087,22355,3578736597,3578736628,31
2,1087,22356,3578736597,3578736629,32
2,1087,22357,3578736597,3578736630,33
2,1087,22358,3578736597,3578736631,34
2,1087,22359,3578736597,3578736631,34
2,1087,22360,3578736597,3578736633,36
2,1087,22361,3578736597,3578736633,36
2,1087,22362,3578736597,3578736634,37
2,1087,22363,3578736597,3578736636,39
2,1087,22364,3578736597,3578736638,41
2,1087,22365,3578736597,3578736638,41
2,1087,22366,3578736597,3578736638,41
2,1087,22367,3578736597,3578736639,42
2,1087,22368,3578736597,3578736640,43
2,1087,22369,3578736597,3578736641,44
2,1087,22370,3578736597,3578736641,44
2,1087,22371,3578736597,3578736641,44
2,1087,22372,3578736597,3578736646,49
2,1087,22373,3578736597,3578736646,49
2,1088,22374,3578736658,3578736658,0
2,1088,22375,3578736658,3578736658,0
2,1088,22376,3578736658,3578736658,0
2,1088,22377,3578736658,3578736658,0
2,1088,22378,3578736658,3578736658,0
2,1088,22379,3578736658,3578736658,0
2,1088,22380,3578736658,3578736658,0
2,1088,22381,3578736658,3578736658,0
2,1088,22382,3578736658,3578736658,0
2,1088,22383,3578736658,3578736659,1
2,1088,22384,3578736658,3578736659,1
2,1088,22385,3578736658,3578736659,1
2,1088,22386,3578736658,3578736660,2
2,1088,22387,3578736658,3578736661,3
2,1088,22388,3578736658,3578736664,6
2,1088,22389,3578736658,3578736665,7
2,1088,22390,3578736658,3578736666,8
2,1088,22391,3578736658,3578736667,9
2,1088,22392,3578736658,3578736669,11
2,1088,22393,3578736658,3578736669,11
2,1088,22394,3578736658,3578736671,13
2,1088,22395,3578736658,3578736672,14
2,1088,22396,3578736658,3578736680,22
2,1088,22397,3578736658,3578736680,22
2,1088,22398,3578736658,3578736681,23
2,1088,22399,3578736658,3578736682,24
2,1088,22400,3578736658,3578736683,25
2,1088,22401,3578736658,3578736683,25
2,1088,22402,3578736658,3578736683,25
2,1088,22403,3578736658,3578736684,26
2,1088,22404,3578736658,3578736686,28
2,1088,22405,3578736658,3578736686,28
2,1088,22406,3578736658,3578736687,29
2,1088,22407,3578736658,3578736689,31
2,1088,22408,3578736658,3578736690,32
2,1088,22409,3578736658,3578736691,33
2,1088,22410,3578736658,3578736692,34
2,1088,22411,3578736658,3578736693,35
2,1088,22412,3578736658,3578736693,35
2,1088,22413,3578736658,3578736694,36
2,1088,22414,3578736658,3578736694,36
2,1088,22415,3578736658,3578736694,36
2,1088,22416,3578736658,3578736696,38
2,1088,22417,3578736658,3578736696,38
2,1088,22418,3578736658,3578736698,40
2,1088,22419,3578736658,3578736698,40
2,1088,22420,3578736658,3578736699,41
2,1088,22421,3578736658,3578736699,41
2,1088,22422,3578736658,3578736701,43
2,1088,22423,3578736658,3578736701,43
2,1088,22424,3578736658,3578736701,43
2,1088,22425,3578736658,3578736703,45
2,1088,22426,3578736658,3578736704,46
2,1088,22427,3578736658,3578736706,48
2,1088,22428,3578736658,3578736706,48
2,1088,22429,3578736658,3578736707,49
2,1088,22430,3578736658,3578736707,49
2,1088,22431,3578736658,3578736707,49
2,1089,22432,3578736720,3578736720,0
2,1089,22433,3578736720,3578736720,0
2,1089,22434,3578736720,3578736720,0
2,1089,22435,3578736720,3578736720,0
2,1089,22436,3578736720,3578736720,0
2,1089,22437,3578736720,3578736720,0
2,1089,22438,3578736720,3578736720,0
2,1089,22439,3578736720,3578736720,0
2,1089,22440,3578736720,3578736720,0
2,1089,22441,3578736720,3578736720,0
2,1089,22442,3578736720,3578736720,0
2,1089,22443,3578736720,3578736720,0
2,1089,22444,3578736720,3578736720,0
2,1089,22445,3578736720,3578736720,0
2,1089,22446,3578736720,3578736720,0
2,1089,22447,3578736720,3578736722,2
2,1089,22448,3578736720,3578736722,2
2,1089,22449,3578736720,3578736722,2
2,1089,22450,3578736720,3578736724,4
2,1089,22451,3578736720,3578736724,4
2,1089,22452,3578736720,3578736724,4
2,1089,22453,3578736720,3578736725,5
2,1089,22454,3578736720,3578736725,5
2,1089,22455,3578736720,3578736725,5
2,1089,22456,3578736720,3578736725,5
2,1089,22457,3578736720,3578736727,7
2,1089,22458,3578736720,3578736728,8
2,1089,22459,3578736720,3578736729,9
2,1089,22460,3578736720,3578736730,10
2,1089,22461,3578736720,3578736731,11
2,1089,22462,3578736720,3578736732,12
2,1089,22463,3578736720,3578736732,12
2,1089,22464,3578736720,3578736733,13
2,1089,22465,3578736720,3578736733,13
2,1089,22466,3578736720,3578736734,14
2,1089,22467,3578736720,3578736735,15
2,1089,22468,3578736720,3578736736,16
2,1089,22469,3578736720,3578736736,16
2,1089,22470,3578736720,3578736737,17
2,1089,22471,3578736720,3578736737,17
2,1089,22472,3578736720,3578736737,17
2,1089,22473,3578736720,3578736740,20
2,1089,22474,3578736720,3578736741,21
2,1089,22475,3578736720,3578736743,23
2,1089,22476,3578736720,3578736743,23
2,1089,22477,3578736720,3578736745,25
2,1089,22478,3578736720,3578736748,28
2,1089,22479,3578736720,3578736749,29
2,1089,22480,3578736720,3578736750,30
2,1089,22481,3578736720,3578736750,30
2,1089,22482,3578736720,3578736752,32
2,1089,22483,3578736720,3578736754,34
2,1089,22484,3578736720,3578736754,34
2,1089,22485,3578736720,3578736755,35
2,1089,22486,3578736720,3578736759,39
2,1089,22487,3578736720,3578736759,39
2,1089,22488,3578736720,3578736761,41
2,1089,22489,3578736720,3578736762,42
2,1089,22490,3578736720,3578736763,43
2,1089,22491,3578736720,3578736763,43
2,1089,22492,3578736720,3578736763,43
2,1089,22493,3578736720,3578736765,45
2,1089,22494,3578736720,3578736767,47
2,1089,22495,3578736720,3578736768,48
2,1089,22496,3578736720,3578736768,48
2,1089,22497,3578736720,3578736769,49
2,1090,22498,3578736783,3578736783,0
2,1090,22499,3578736783,3578736783,0
2,1090,22500,3578736783,3578736783,0
2,1090,22501,3578736783,3578736783,0
2,1090,22502,3578736783,3578736783,0
2,1090,22503,3578736783,3578736783,0
2,1090,22504,3578736783,3578736783,0
2,1090,22505,3578736783,3578736783,0
2,1090,22506,3578736783,3578736783,0
2,1090,22507,3578736783,3578736783,0
2,1090,22508,3578736783,3578736783,0
2,1090,22509,3578736783,3578736784,1
2,1090,22510,3578736783,3578736785,2
2,1090,22511,3578736783,3578736787,4
2,1090,22512,3578736783,3578736787,4
2,1090,22513,3578736783,3578736790,7
2,1090,22514,3578736783,3578736790,7
2,1090,22515,3578736783,3578736790,7
2,1090,22516,3578736783,3578736791,8
2,1090,22517,3578736783,3578736792,9
2,1090,22518,3578736783,3578736793,10
2,1090,22519,3578736783,3578736794,11
2,1090,22520,3578736783,3578736796,13
2,1090,22521,3578736783,3578736796,13
2,1090,22522,3578736783,3578736799,16
2,1090,22523,3578736783,3578736799,16
2,1090,22524,3578736783,3578736806,23
2,1090,22525,3578736783,3578736806,23
2,1090,22526,3578736783,3578736807,24
2,1090,22527,3578736783,3578736811,28
2,1090,22528,3578736783,3578736813,30
2,1090,22529,3578736783,3578736813,30
2,1090,22530,3578736783,3578736814,31
2,1090,22531,3578736783,3578736816,33
2,1090,22532,3578736783,3578736816,33
2,1090,22533,3578736783,3578736817,34
2,1090,22534,3578736783,3578736819,36
2,1090,22535,3578736783,3578736819,36
2,1090,22536,3578736783,3578736820,37
2,1090,22537,3578736783,3578736824,41
2,1090,22538,3578736783,3578736826,43
2,1090,22539,3578736783,3578736827,44
2,1090,22540,3578736783,3578736827,44
2,1090,22541,3578736783,3578736828,45
2,1090,22542,3578736783,3578736828,45
2,1090,22543,3578736783,3578736829,46
2,1090,22544,3578736783,3578736829,46
2,1090,22545,3578736783,3578736830,47
2,1090,22546,3578736783,3578736831,48
2,1090,22547,3578736783,3578736832,49
2,1090,22548,3578736783,3578736833,50
2,1091,22549,3578736845,3578736845,0
2,1091,22550,3578736845,3578736845,0
2,1091,22551,3578736845,3578736845,0
2,1091,22552,3578736845,3578736845,0
2,1091,22553,3578736845,3578736845,0
2,1091,22554,3578736845,3578736845,0
2,1091,22555,3578736845,3578736845,0
2,1091,22556,3578736845,3578736845,0
2,1091,22557,3578736845,3578736845,0
2,1091,22558,3578736845,3578736845,0
2,1091,22559,3578736845,3578736846,1
2,1091,22560,3578736845,3578736850,5
2,1091,22561,3578736845,3578736850,5
2,1091,22562,3578736845,3578736851,6
2,1091,22563,3578736845,3578736853,8
2,1091,22564,3578736845,3578736854,9
2,1091,22565,3578736845,3578736854,9
2,1091,22566,3578736845,3578736854,9
2,1091,22567,3578736845,3578736855,10
2,1091,22568,3578736845,3578736857,12
2,1091,22569,3578736845,3578736857,12
2,1091,22570,3578736845,3578736858,13
2,1091,22571,3578736845,3578736859,14
2,1091,22572,3578736845,3578736859,14
2,1091,22573,3578736845,3578736861,16
2,1091,22574,3578736845,3578736862,17
2,1091,22575,3578736845,3578736864,19
2,1091,22576,3578736845,3578736865,20
2,1091,22577,3578736845,3578736866,21
2,1091,22578,3578736845,3578736867,22
2,1091,22579,3578736845,3578736868,23
2,1091,22580,3578736845,3578736871,26
2,1091,22581,3578736845,3578736872,27
2,1091,22582,3578736845,3578736880,35
2,1091,22583,3578736845,3578736880,35
2,1091,22584,3578736845,3578736881,36
2,1091,22585,3578736845,3578736882,37
2,1091,22586,3578736845,3578736883,38
2,1091,22587,3578736845,3578736883,38
2,1091,22588,3578736845,3578736884,39
2,1091,22589,3578736845,3578736885,40
2,1091,22590,3578736845,3578736886,41
2,1091,22591,3578736845,3578736887,42
2,1091,22592,3578736845,3578736889,44
2,1091,22593,3578736845,3578736890,45
2,1091,22594,3578736845,3578736890,45
2,1091,22595,3578736845,3578736892,47
2,1091,22596,3578736845,3578736892,47
2,1091,22597,3578736845,3578736893,48
2,1091,22598,3578736845,3578736893,48
2,1091,22599,3578736845,3578736894,49
2,1091,22600,3578736845,3578736894,49
2,1091,22601,3578736845,3578736895,50
2,1092,22602,3578736905,3578736905,0
2,1092,22603,3578736905,3578736905,0
2,1092,22604,3578736905,3578736905,0
2,1092,22605,3578736905,3578736905,0
2,1092,22606,3578736905,3578736905,0
2,1092,22607,3578736905,3578736905,0
2,1092,22608,3578736905,3578736905,0
2,1092,22609,3578736905,3578736905,0
2,1092,22610,3578736905,3578736905,0
2,1092,22611,3578736905,3578736905,0
2,1092,22612,3578736905,3578736905,0
2,1092,22613,3578736905,3578736906,1
2,1092,22614,3578736905,3578736907,2
2,1092,22615,3578736905,3578736907,2
2,1092,22616,3578736905,3578736907,2
2,1092,22617,3578736905,3578736908,3
2,1092,22618,3578736905,3578736908,3
2,1092,22619,3578736905,3578736910,5
2,1092,22620,3578736905,3578736911,6
2,1092,22621,3578736905,3578736912,7
2,1092,22622,3578736905,3578736912,7
2,1092,22623,3578736905,3578736912,7
2,1092,22624,3578736905,3578736913,8
2,1092,22625,3578736905,3578736913,8
2,1092,22626,3578736905,3578736915,10
2,1092,22627,3578736905,3578736916,11
2,1092,22628,3578736905,3578736917,12
2,1092,22629,3578736905,3578736917,12
2,1092,22630,3578736905,3578736919,14
2,1092,22631,3578736905,3578736919,14
2,1092,22632,3578736905,3578736920,15
2,1092,22633,3578736905,3578736920,15
2,1092,22634,3578736905,3578736922,17
2,1092,22635,3578736905,3578736922,17
2,1092,22636,3578736905,3578736922,17
2,1092,22637,3578736905,3578736924,19
2,1092,22638,3578736905,3578736925,20
2,1092,22639,3578736905,3578736925,20
2,1092,22640,3578736905,3578736925,20
2,1092,22641,3578736905,3578736925,20
2,1092,22642,3578736905,3578736925,20
2,1092,22643,3578736905,3578736926,21
2,1092,22644,3578736905,3578736928,23
2,1092,22645,3578736905,3578736930,25
2,1092,22646,3578736905,3578736930,25
2,1092,22647,3578736905,3578736931,26
2,1092,22648,3578736905,3578736933,28
2,1092,22649,3578736905,3578736934,29
2,1092,22650,3578736905,3578736935,30
2,1092,22651,3578736905,3578736935,30
2,1092,22652,3578736905,3578736937,32
2,1092,22653,3578736905,3578736937,32
2,1092,22654,3578736905,3578736937,32
2,1092,22655,3578736905,3578736937,32
2,1092,22656,3578736905,3578736938,33
2,1092,22657,3578736905,3578736941,36
2,1092,22658,3578736905,3578736941,36
2,1092,22659,3578736905,3578736941,36
2,1092,22660,3578736905,3578736942,37
2,1092,22661,3578736905,3578736943,38
2,1092,22662,3578736905,3578736943,38
2,1092,22663,3578736905,3578736945,40
2,1092,22664,3578736905,3578736947,42
2,1092,22665,3578736905,3578736949,44
2,1092,22666,3578736905,3578736950,45
2,1092,22667,3578736905,3578736952,47
2,1092,22668,3578736905,3578736954,49
2,1092,22669,3578736905,3578736955,50
2,1093,22670,3578736966,3578736966,0
2,1093,22671,3578736966,3578736966,0
2,1093,22672,3578736966,3578736966,0
2,1093,22673,3578736966,3578736966,0
2,1093,22674,3578736966,3578736966,0
2,1093,22675,3578736966,3578736966,0
2,1093,22676,3578736966,3578736966,0
2,1093,22677,3578736966,3578736966,0
2,1093,22678,3578736966,3578736967,1
2,1093,22679,3578736966,3578736968,2
2,1093,22680,3578736966,3578736968,2
2,1093,22681,3578736966,3578736969,3
2,1093,22682,3578736966,3578736974,8
2,1093,22683,3578736966,3578736975,9
2,1093,22684,3578736966,3578736976,10
2,1093,22685,3578736966,3578736977,11
2,1093,22686,3578736966,3578736978,12
2,1093,22687,3578736966,3578736978,12
2,1093,22688,3578736966,3578736979,13
2,1093,22689,3578736966,3578736981,15
2,1093,22690,3578736966,3578736981,15
2,1093,22691,3578736966,3578736983,17
2,1093,22692,3578736966,3578736984,18
2,1093,22693,3578736966,3578736986,20
2,1093,22694,3578736966,3578736988,22
2,1093,22695,3578736966,3578736988,22
2,1093,22696,3578736966,3578736989,23
2,1093,22697,3578736966,3578736989,23
2,1093,22698,3578736966,3578736990,24
2,1093,22699,3578736966,3578736991,25
2,1093,22700,3578736966,3578736992,26
2,1093,22701,3578736966,3578736993,27
2,1093,22702,3578736966,3578736993,27
2,1093,22703,3578736966,3578736994,28
2,1093,22704,3578736966,3578736995,29
2,1093,22705,3578736966,3578736996,30
2,1093,22706,3578736966,3578736998,32
2,1093,22707,3578736966,3578737000,34
2,1093,22708,3578736966,3578737000,34
2,1093,22709,3578736966,3578737002,36
2,1093,22710,3578736966,3578737006,40
2,1093,22711,3578736966,3578737006,40
2,1093,22712,3578736966,3578737008,42
2,1093,22713,3578736966,3578737011,45
2,1093,22714,3578736966,3578737013,47
2,1093,22715,3578736966,3578737014,48
2,1093,22716,3578736966,3578737014,48
2,1093,22717,3578736966,3578737016,50
2,1094,22718,3578737028,3578737028,0
2,1094,22719,3578737028,3578737028,0
2,1094,22720,3578737028,3578737028,0
2,1094,22721,3578737028,3578737028,0
2,1094,22722,3578737028,3578737028,0
2,1094,22723,3578737028,3578737028,0
2,1094,22724,3578737028,3578737028,0
2,1094,22725,3578737028,3578737028,0
2,1094,22726,3578737028,3578737028,0
2,1094,22727,3578737028,3578737029,1
2,1094,22728,3578737028,3578737029,1
2,1094,22729,3578737028,3578737029,1
2,1094,22730,3578737028,3578737032,4
2,1094,22731,3578737028,3578737032,4
2,1094,22732,3578737028,3578737033,5
2,1094,22733,3578737028,3578737034,6
2,1094,22734,3578737028,3578737034,6
2,1094,22735,3578737028,3578737037,9
2,1094,22736,3578737028,3578737038,10
2,1094,22737,3578737028,3578737038,10
2,1094,22738,3578737028,3578737038,10
2,1094,22739,3578737028,3578737039,11
2,1094,22740,3578737028,3578737041,13
2,1094,22741,3578737028,3578737041,13
2,1094,22742,3578737028,3578737042,14
2,1094,22743,3578737028,3578737042,14
2,1094,22744,3578737028,3578737042,14
2,1094,22745,3578737028,3578737046,18
2,1094,22746,3578737028,3578737046,18
2,1094,22747,3578737028,3578737047,19
2,1094,22748,3578737028,3578737050,22
2,1094,22749,3578737028,3578737051,23
2,1094,22750,3578737028,3578737051,23
2,1094,22751,3578737028,3578737053,25
2,1094,22752,3578737028,3578737054,26
2,1094,22753,3578737028,3578737054,26
2,1094,22754,3578737028,3578737055,27
2,1094,22755,3578737028,3578737055,27
2,1094,22756,3578737028,3578737057,29
2,1094,22757,3578737028,3578737057,29
2,1094,22758,3578737028,3578737059,31
2,1094,22759,3578737028,3578737060,32
2,1094,22760,3578737028,3578737060,32
2,1094,22761,3578737028,3578737061,33
2,1094,22762,3578737028,3578737063,35
2,1094,22763,3578737028,3578737065,37
2,1094,22764,3578737028,3578737066,38
2,1094,22765,3578737028,3578737067,39
2,1094,22766,3578737028,3578737069,41
2,1094,22767,3578737028,3578737069,41
2,1094,22768,3578737028,3578737072,44
2,1094,22769,3578737028,3578737073,45
2,1095,22770,3578737089,3578737089,0
2,1095,22771,3578737089,3578737089,0
2,1095,22772,3578737089,3578737089,0
2,1095,22773,3578737089,3578737089,0
2,1095,22774,3578737089,3578737089,0
2,1095,22775,3578737089,3578737089,0
2,1095,22776,3578737089,3578737089,0
2,1095,22777,3578737089,3578737089,0
2,1095,22778,3578737089,3578737089,0
2,1095,22779,3578737089,3578737089,0
2,1095,22780,3578737089,3578737089,0
2,1095,22781,3578737089,3578737089,0
2,1095,22782,3578737089,3578737089,0
2,1095,22783,3578737089,3578737089,0
2,1095,22784,3578737089,3578737092,3
2,1095,22785,3578737089,3578737092,3
2,1095,22786,3578737089,3578737093,4
2,1095,22787,3578737089,3578737094,5
2,1095,22788,3578737089,3578737094,5
2,1095,22789,3578737089,3578737094,5
2,1095,22790,3578737089,3578737095,6
2,1095,22791,3578737089,3578737096,7
2,1095,22792,3578737089,3578737096,7
2,1095,22793,3578737089,3578737098,9
2,1095,22794,3578737089,3578737098,9
2,1095,22795,3578737089,3578737098,9
2,1095,22796,3578737089,3578737099,10
2,1095,22797,3578737089,3578737101,12
2,1095,22798,3578737089,3578737101,12
2,1095,22799,3578737089,3578737102,13
2,1095,22800,3578737089,3578737103,14
2,1095,22801,3578737089,3578737104,15
2,1095,22802,3578737089,3578737107,18
2,1095,22803,3578737089,3578737107,18
2,1095,22804,3578737089,3578737107,18
2,1095,22805,3578737089,3578737107,18
2,1095,22806,3578737089,3578737107,18
2,1095,22807,3578737089,3578737108,19
2,1095,22808,3578737089,3578737110,21
2,1095,22809,3578737089,3578737111,22
2,1095,22810,3578737089,3578737112,23
2,1095,22811,3578737089,3578737112,23
2,1095,22812,3578737089,3578737113,24
2,1095,22813,3578737089,3578737113,24
2,1095,22814,3578737089,3578737114,25
2,1095,22815,3578737089,3578737114,25
2,1095,22816,3578737089,3578737115,26
2,1095,22817,3578737089,3578737116,27
2,1095,22818,3578737089,3578737118,29
2,1095,22819,3578737089,3578737118,29
2,1095,22820,3578737089,3578737119,30
2,1095,22821,3578737089,3578737119,30
2,1095,22822,3578737089,3578737120,31
2,1095,22823,3578737089,3578737120,31
2,1095,22824,3578737089,3578737121,32
2,1095,22825,3578737089,3578737122,33
2,1095,22826,3578737089,3578737122,33
2,1095,22827,3578737089,3578737123,34
2,1095,22828,3578737089,3578737124,35
2,1095,22829,3578737089,3578737125,36
2,1095,22830,3578737089,3578737125,36
2,1095,22831,3578737089,3578737125,36
2,1095,22832,3578737089,3578737126,37
2,1095,22833,3578737089,3578737128,39
2,1095,22834,3578737089,3578737130,41
2,1095,22835,3578737089,3578737131,42
2,1095,22836,3578737089,3578737132,43
2,1095,22837,3578737089,3578737133,44
2,1095,22838,3578737089,3578737133,44
2,1095,22839,3578737089,3578737133,44
2,1095,22840,3578737089,3578737134,45
2,1095,22841,3578737089,3578737135,46
2,1095,22842,3578737089,3578737136,47
2,1095,22843,3578737089,3578737137,48
2,1095,22844,3578737089,3578737137,48
2,1095,22845,3578737089,3578737138,49
2,1095,22846,3578737089,3578737138,49
2,1095,22847,3578737089,3578737138,49
2,1096,22848,3578737152,3578737152,0
2,1096,22849,3578737152,3578737152,0
2,1096,22850,3578737152,3578737152,0
2,1096,22851,3578737152,3578737152,0
2,1096,22852,3578737152,3578737152,0
2,1096,22853,3578737152,3578737152,0
2,1096,22854,3578737152,3578737152,0
2,1096,22855,3578737152,3578737152,0
2,1096,22856,3578737152,3578737152,0
2,1096,22857,3578737152,3578737152,0
2,1096,22858,3578737152,3578737154,2
2,1096,22859,3578737152,3578737155,3
2,1096,22860,3578737152,3578737159,7
2,1096,22861,3578737152,3578737160,8
2,1096,22862,3578737152,3578737163,11
2,1096,22863,3578737152,3578737164,12
2,1096,22864,3578737152,3578737164,12
2,1096,22865,3578737152,3578737164,12
2,1096,22866,3578737152,3578737165,13
2,1096,22867,3578737152,3578737166,14
2,1096,22868,3578737152,3578737168,16
2,1096,22869,3578737152,3578737168,16
2,1096,22870,3578737152,3578737168,16
2,1096,22871,3578737152,3578737169,17
2,1096,22872,3578737152,3578737174,22
2,1096,22873,3578737152,3578737174,22
2,1096,22874,3578737152,3578737175,23
2,1096,22875,3578737152,3578737176,24
2,1096,22876,3578737152,3578737178,26
2,1096,22877,3578737152,3578737178,26
2,1096,22878,3578737152,3578737179,27
2,1096,22879,3578737152,3578737180,28
2,1096,22880,3578737152,3578737180,28
2,1096,22881,3578737152,3578737181,29
2,1096,22882,3578737152,3578737181,29
2,1096,22883,3578737152,3578737183,31
2,1096,22884,3578737152,3578737184,32
2,1096,22885,3578737152,3578737185,33
2,1096,22886,3578737152,3578737187,35
2,1096,22887,3578737152,3578737188,36
2,1096,22888,3578737152,3578737189,37
2,1096,22889,3578737152,3578737189,37
2,1096,22890,3578737152,3578737190,38
2,1096,22891,3578737152,3578737190,38
2,1096,22892,3578737152,3578737193,41
2,1096,22893,3578737152,3578737194,42
2,1096,22894,3578737152,3578737194,42
2,1096,22895,3578737152,3578737194,42
2,1096,22896,3578737152,3578737196,44
2,1096,22897,3578737152,3578737199,47
2,1096,22898,3578737152,3578737200,48
2,1097,22899,3578737212,3578737212,0
2,1097,22900,3578737212,3578737212,0
2,1097,22901,3578737212,3578737212,0
2,1097,22902,3578737212,3578737212,0
2,1097,22903,3578737212,3578737212,0
2,1097,22904,3578737212,3578737213,1
2,1097,22905,3578737212,3578737214,2
2,1097,22906,3578737212,3578737214,2
2,1097,22907,3578737212,3578737216,4
2,1097,22908,3578737212,3578737219,7
2,1097,22909,3578737212,3578737220,8
2,1097,22910,3578737212,3578737220,8
2,1097,22911,3578737212,3578737221,9
2,1097,22912,3578737212,3578737224,12
2,1097,22913,3578737212,3578737227,15
2,1097,22914,3578737212,3578737227,15
2,1097,22915,3578737212,3578737228,16
2,1097,22916,3578737212,3578737228,16
2,1097,22917,3578737212,3578737228,16
2,1097,22918,3578737212,3578737229,17
2,1097,22919,3578737212,3578737229,17
2,1097,22920,3578737212,3578737229,17
2,1097,22921,3578737212,3578737230,18
2,1097,22922,3578737212,3578737232,20
2,1097,22923,3578737212,3578737232,20
2,1097,22924,3578737212,3578737233,21
2,1097,22925,3578737212,3578737233,21
2,1097,22926,3578737212,3578737234,22
2,1097,22927,3578737212,3578737238,26
2,1097,22928,3578737212,3578737238,26
2,1097,22929,3578737212,3578737239,27
2,1097,22930,3578737212,3578737239,27
2,1097,22931,3578737212,3578737239,27
2,1097,22932,3578737212,3578737240,28
2,1097,22933,3578737212,3578737241,29
2,1097,22934,3578737212,3578737241,29
2,1097,22935,3578737212,3578737242,30
2,1097,22936,3578737212,3578737245,33
2,1097,22937,3578737212,3578737246,34
2,1097,22938,3578737212,3578737246,34
2,1097,22939,3578737212,3578737247,35
2,1097,22940,3578737212,3578737250,38
2,1097,22941,3578737212,3578737250,38
2,1097,22942,3578737212,3578737252,40
2,1097,22943,3578737212,3578737253,41
2,1097,22944,3578737212,3578737254,42
2,1097,22945,3578737212,3578737254,42
2,1097,22946,3578737212,3578737255,43
2,1097,22947,3578737212,3578737255,43
2,1097,22948,3578737212,3578737256,44
2,1097,22949,3578737212,3578737257,45
2,1097,22950,3578737212,3578737259,47
2,1097,22951,3578737212,3578737260,48
2,1097,22952,3578737212,3578737261,49
2,1098,22953,3578737272,3578737272,0
2,1098,22954,3578737272,3578737272,0
2,1098,22955,3578737272,3578737272,0
2,1098,22956,3578737272,3578737272,0
2,1098,22957,3578737272,3578737272,0
2,1098,22958,3578737272,3578737272,0
2,1098,22959,3578737272,3578737272,0
2,1098,22960,3578737272,3578737272,0
2,1098,22961,3578737272,3578737272,0
2,1098,22962,3578737272,3578737273,1
2,1098,22963,3578737272,3578737273,1
2,1098,22964,3578737272,3578737275,3
2,1098,22965,3578737272,3578737281,9
2,1098,22966,3578737272,3578737281,9
2,1098,22967,3578737272,3578737282,10
2,1098,22968,3578737272,3578737282,10
2,1098,22969,3578737272,3578737283,11
2,1098,22970,3578737272,3578737283,11
2,1098,22971,3578737272,3578737283,11
2,1098,22972,3578737272,3578737285,13
2,1098,22973,3578737272,3578737286,14
2,1098,22974,3578737272,3578737287,15
2,1098,22975,3578737272,3578737287,15
2,1098,22976,3578737272,3578737289,17
2,1098,22977,3578737272,3578737292,20
2,1098,22978,3578737272,3578737293,21
2,1098,22979,3578737272,3578737293,21
2,1098,22980,3578737272,3578737294,22
2,1098,22981,3578737272,3578737294,22
2,1098,22982,3578737272,3578737295,23
2,1098,22983,3578737272,3578737295,23
2,1098,22984,3578737272,3578737296,24
2,1098,22985,3578737272,3578737296,24
2,1098,22986,3578737272,3578737298,26
2,1098,22987,3578737272,3578737298,26
2,1098,22988,3578737272,3578737299,27
2,1098,22989,3578737272,3578737299,27
2,1098,22990,3578737272,3578737301,29
2,1098,22991,3578737272,3578737301,29
2,1098,22992,3578737272,3578737301,29
2,1098,22993,3578737272,3578737303,31
2,1098,22994,3578737272,3578737304,32
2,1098,22995,3578737272,3578737306,34
2,1098,22996,3578737272,3578737307,35
2,1098,22997,3578737272,3578737307,35
2,1098,22998,3578737272,3578737307,35
2,1098,22999,3578737272,3578737307,35
2,1098,23000,3578737272,3578737310,38
2,1098,23001,3578737272,3578737310,38
2,1098,23002,3578737272,3578737311,39
2,1098,23003,3578737272,3578737313,41
2,1098,23004,3578737272,3578737314,42
2,1098,23005,3578737272,3578737315,43
2,1098,23006,3578737272,3578737316,44
2,1098,23007,3578737272,3578737317,45
2,1098,23008,3578737272,3578737318,46
2,1098,23009,3578737272,3578737319,47
2,1098,23010,3578737272,3578737320,48
2,1098,23011,3578737272,3578737320,48
2,1098,23012,3578737272,3578737321,49
2,1098,23013,3578737272,3578737321,49
2,1098,23014,3578737272,3578737322,50
2,1099,23015,3578737333,3578737333,0
2,1099,23016,3578737333,3578737333,0
2,1099,23017,3578737333,3578737333,0
2,1099,23018,3578737333,3578737333,0
2,1099,23019,3578737333,3578737333,0
2,1099,23020,3578737333,3578737333,0
2,1099,23021,3578737333,3578737333,0
2,1099,23022,3578737333,3578737333,0
2,1099,23023,3578737333,3578737333,0
2,1099,23024,3578737333,3578737333,0
2,1099,23025,3578737333,3578737333,0
2,1099,23026,3578737333,3578737333,0
2,1099,23027,3578737333,3578737333,0
2,1099,23028,3578737333,3578737333,0
2,1099,23029,3578737333,3578737333,0
2,1099,23030,3578737333,3578737333,0
2,1099,23031,3578737333,3578737334,1
2,1099,23032,3578737333,3578737335,2
2,1099,23033,3578737333,3578737335,2
2,1099,23034,3578737333,3578737337,4
2,1099,23035,3578737333,3578737338,5
2,1099,23036,3578737333,3578737338,5
2,1099,23037,3578737333,3578737338,5
2,1099,23038,3578737333,3578737338,5
2,1099,23039,3578737333,3578737341,8
2,1099,23040,3578737333,3578737341,8
2,1099,23041,3578737333,3578737342,9
2,1099,23042,3578737333,3578737343,10
2,1099,23043,3578737333,3578737343,10
2,1099,23044,3578737333,3578737343,10
2,1099,23045,3578737333,3578737344,11
2,1099,23046,3578737333,3578737345,12
2,1099,23047,3578737333,3578737348,15
2,1099,23048,3578737333,3578737348,15
2,1099,23049,3578737333,3578737349,16
2,1099,23050,3578737333,3578737350,17
2,1099,23051,3578737333,3578737352,19
2,1099,23052,3578737333,3578737354,21
2,1099,23053,3578737333,3578737355,22
2,1099,23054,3578737333,3578737356,23
2,1099,23055,3578737333,3578737360,27
2,1099,23056,3578737333,3578737360,27
2,1099,23057,3578737333,3578737362,29
2,1099,23058,3578737333,3578737364,31
2,1099,23059,3578737333,3578737364,31
2,1099,23060,3578737333,3578737364,31
2,1099,23061,3578737333,3578737364,31
2,1099,23062,3578737333,3578737365,32
2,1099,23063,3578737333,3578737366,33
2,1099,23064,3578737333,3578737369,36
2,1099,23065,3578737333,3578737369,36
2,1099,23066,3578737333,3578737369,36
2,1099,23067,3578737333,3578737370,37
2,1099,23068,3578737333,3578737374,41
2,1099,23069,3578737333,3578737375,42
2,1099,23070,3578737333,3578737375,42
2,1099,23071,3578737333,3578737376,43
2,1099,23072,3578737333,3578737378,45
2,1099,23073,3578737333,3578737378,45
2,1099,23074,3578737333,3578737379,46
2,1099,23075,3578737333,3578737380,47
2,1099,23076,3578737333,3578737380,47
2,1099,23077,3578737333,3578737382,49
2,1099,23078,3578737333,3578737382,49
2,1100,23079,3578737396,3578737396,0
2,1100,23080,3578737396,3578737396,0
2,1100,23081,3578737396,3578737396,0
2,1100,23082,3578737396,3578737396,0
2,1100,23083,3578737396,3578737396,0
2,1100,23084,3578737396,3578737396,0
2,1100,23085,3578737396,3578737396,0
2,1100,23086,3578737396,3578737396,0
2,1100,23087,3578737396,3578737396,0
2,1100,23088,3578737396,3578737396,0
2,1100,23089,3578737396,3578737396,0
2,1100,23090,3578737396,3578737396,0
2,1100,23091,3578737396,3578737396,0
2,1100,23092,3578737396,3578737397,1
2,1100,23093,3578737396,3578737400,4
2,1100,23094,3578737396,3578737400,4
2,1100,23095,3578737396,3578737404,8
2,1100,23096,3578737396,3578737406,10
2,1100,23097,3578737396,3578737406,10
2,1100,23098,3578737396,3578737408,12
2,1100,23099,3578737396,3578737412,16
2,1100,23100,3578737396,3578737412,16
2,1100,23101,3578737396,3578737414,18
2,1100,23102,3578737396,3578737415,19
2,1100,23103,3578737396,3578737419,23
2,1100,23104,3578737396,3578737420,24
2,1100,23105,3578737396,3578737421,25
2,1100,23106,3578737396,3578737421,25
2,1100,23107,3578737396,3578737425,29
2,1100,23108,3578737396,3578737425,29
2,1100,23109,3578737396,3578737427,31
2,1100,23110,3578737396,3578737427,31
2,1100,23111,3578737396,3578737427,31
2,1100,23112,3578737396,3578737428,32
2,1100,23113,3578737396,3578737429,33
2,1100,23114,3578737396,3578737429,33
2,1100,23115,3578737396,3578737430,34
2,1100,23116,3578737396,3578737432,36
2,1100,23117,3578737396,3578737432,36
2,1100,23118,3578737396,3578737433,37
2,1100,23119,3578737396,3578737434,38
2,1100,23120,3578737396,3578737435,39
2,1100,23121,3578737396,3578737437,41
2,1100,23122,3578737396,3578737438,42
2,1100,23123,3578737396,3578737438,42
2,1100,23124,3578737396,3578737439,43
2,1100,23125,3578737396,3578737439,43
2,1100,23126,3578737396,3578737440,44
2,1100,23127,3578737396,3578737442,46
2,1100,23128,3578737396,3578737442,46
2,1100,23129,3578737396,3578737443,47
2,1100,23130,3578737396,3578737444,48
2,1100,23131,3578737396,3578737446,50
2,1101,23132,3578737456,3578737456,0
2,1101,23133,3578737456,3578737456,0
2,1101,23134,3578737456,3578737456,0
2,1101,23135,3578737456,3578737456,0
2,1101,23136,3578737456,3578737456,0
2,1101,23137,3578737456,3578737456,0
2,1101,23138,3578737456,3578737456,0
2,1101,23139,3578737456,3578737456,0
2,1101,23140,3578737456,3578737456,0
2,1101,23141,3578737456,3578737456,0
2,1101,23142,3578737456,3578737456,0
2,1101,23143,3578737456,3578737457,1
2,1101,23144,3578737456,3578737459,3
2,1101,23145,3578737456,3578737460,4
2,1101,23146,3578737456,3578737460,4
2,1101,23147,3578737456,3578737461,5
2,1101,23148,3578737456,3578737462,6
2,1101,23149,3578737456,3578737464,8
2,1101,23150,3578737456,3578737465,9
2,1101,23151,3578737456,3578737466,10
2,1101,23152,3578737456,3578737468,12
2,1101,23153,3578737456,3578737468,12
2,1101,23154,3578737456,3578737470,14
2,1101,23155,3578737456,3578737470,14
2,1101,23156,3578737456,3578737473,17
2,1101,23157,3578737456,3578737474,18
2,1101,23158,3578737456,3578737476,20
2,1101,23159,3578737456,3578737480,24
2,1101,23160,3578737456,3578737481,25
2,1101,23161,3578737456,3578737481,25
2,1101,23162,3578737456,3578737482,26
2,1101,23163,3578737456,3578737483,27
2,1101,23164,3578737456,3578737483,27
2,1101,23165,3578737456,3578737484,28
2,1101,23166,3578737456,3578737486,30
2,1101,23167,3578737456,3578737486,30
2,1101,23168,3578737456,3578737487,31
2,1101,23169,3578737456,3578737490,34
2,1101,23170,3578737456,3578737490,34
2,1101,23171,3578737456,3578737492,36
2,1101,23172,3578737456,3578737493,37
2,1101,23173,3578737456,3578737494,38
2,1101,23174,3578737456,3578737494,38
2,1101,23175,3578737456,3578737494,38
2,1101,23176,3578737456,3578737495,39
2,1101,23177,3578737456,3578737496,40
2,1101,23178,3578737456,3578737496,40
2,1101,23179,3578737456,3578737496,40
2,1101,23180,3578737456,3578737497,41
2,1101,23181,3578737456,3578737498,42
2,1101,23182,3578737456,3578737499,43
2,1101,23183,3578737456,3578737499,43
2,1101,23184,3578737456,3578737500,44
2,1101,23185,3578737456,3578737500,44
2,1101,23186,3578737456,3578737502,46
2,1101,23187,3578737456,3578737503,47
2,1101,23188,3578737456,3578737504,48
2,1101,23189,3578737456,3578737506,50
2,1102,23190,3578737515,3578737515,0
2,1102,23191,3578737515,3578737515,0
2,1102,23192,3578737515,3578737515,0
2,1102,23193,3578737515,3578737515,0
2,1102,23194,3578737515,3578737515,0
2,1102,23195,3578737515,3578737515,0
2,1102,23196,3578737515,3578737515,0
2,1102,23197,3578737515,3578737515,0
2,1102,23198,3578737515,3578737515,0
2,1102,23199,3578737515,3578737515,0
2,1102,23200,3578737515,3578737515,0
2,1102,23201,3578737515,3578737515,0
2,1102,23202,3578737515,3578737516,1
2,1102,23203,3578737515,3578737518,3
2,1102,23204,3578737515,3578737518,3
2,1102,23205,3578737515,3578737519,4
2,1102,23206,3578737515,3578737519,4
2,1102,23207,3578737515,3578737519,4
2,1102,23208,3578737515,3578737521,6
2,1102,23209,3578737515,3578737522,7
2,1102,23210,3578737515,3578737522,7
2,1102,23211,3578737515,3578737522,7
2,1102,23212,3578737515,3578737523,8
2,1102,23213,3578737515,3578737524,9
2,1102,23214,3578737515,3578737525,10
2,1102,23215,3578737515,3578737525,10
2,1102,23216,3578737515,3578737525,10
2,1102,23217,3578737515,3578737526,11
2,1102,23218,3578737515,3578737527,12
2,1102,23219,3578737515,3578737531,16
2,1102,23220,3578737515,3578737531,16
2,1102,23221,3578737515,3578737532,17
2,1102,23222,3578737515,3578737532,17
2,1102,23223,3578737515,3578737532,17
2,1102,23224,3578737515,3578737533,18
2,1102,23225,3578737515,3578737534,19
2,1102,23226,3578737515,3578737535,20
2,1102,23227,3578737515,3578737536,21
2,1102,23228,3578737515,3578737536,21
2,1102,23229,3578737515,3578737537,22
2,1102,23230,3578737515,3578737538,23
2,1102,23231,3578737515,3578737538,23
2,1102,23232,3578737515,3578737540,25
2,1102,23233,3578737515,3578737541,26
2,1102,23234,3578737515,3578737542,27
2,1102,23235,3578737515,3578737542,27
2,1102,23236,3578737515,3578737543,28
2,1102,23237,3578737515,3578737543,28
2,1102,23238,3578737515,3578737544,29
2,1102,23239,3578737515,3578737548,33
2,1102,23240,3578737515,3578737548,33
2,1102,23241,3578737515,3578737548,33
2,1102,23242,3578737515,3578737549,34
2,1102,23243,3578737515,3578737550,35
2,1102,23244,3578737515,3578737553,38
2,1102,23245,3578737515,3578737555,40
2,1102,23246,3578737515,3578737556,41
2,1102,23247,3578737515,3578737557,42
2,1102,23248,3578737515,3578737559,44
2,1102,23249,3578737515,3578737560,45
2,1102,23250,3578737515,3578737561,46
2,1102,23251,3578737515,3578737563,48
2,1102,23252,3578737515,3578737563,48
2,1102,23253,3578737515,3578737563,48
2,1102,23254,3578737515,3578737564,49
2,1102,23255,3578737515,3578737564,49
2,1103,23256,3578737574,3578737574,0
2,1103,23257,3578737574,3578737574,0
2,1103,23258,3578737574,3578737574,0
2,1103,23259,3578737574,3578737574,0
2,1103,23260,3578737574,3578737574,0
2,1103,23261,3578737574,3578737574,0
2,1103,23262,3578737574,3578737574,0
2,1103,23263,3578737574,3578737575,1
2,1103,23264,3578737574,3578737575,1
2,1103,23265,3578737574,3578737577,3
2,1103,23266,3578737574,3578737578,4
2,1103,23267,3578737574,3578737579,5
2,1103,23268,3578737574,3578737579,5
2,1103,23269,3578737574,3578737580,6
2,1103,23270,3578737574,3578737581,7
2,1103,23271,3578737574,3578737583,9
2,1103,23272,3578737574,3578737584,10
2,1103,23273,3578737574,3578737586,12
2,1103,23274,3578737574,3578737588,14
2,1103,23275,3578737574,3578737588,14
2,1103,23276,3578737574,3578737589,15
2,1103,23277,3578737574,3578737589,15
2,1103,23278,3578737574,3578737590,16
2,1103,23279,3578737574,3578737592,18
2,1103,23280,3578737574,3578737592,18
2,1103,23281,3578737574,3578737593,19
2,1103,23282,3578737574,3578737594,20
2,1103,23283,3578737574,3578737595,21
2,1103,23284,3578737574,3578737596,22
2,1103,23285,3578737574,3578737599,25
2,1103,23286,3578737574,3578737599,25
2,1103,23287,3578737574,3578737603,29
2,1103,23288,3578737574,3578737606,32
2,1103,23289,3578737574,3578737606,32
2,1103,23290,3578737574,3578737607,33
2,1103,23291,3578737574,3578737611,37
2,1103,23292,3578737574,3578737611,37
2,1103,23293,3578737574,3578737612,38
2,1103,23294,3578737574,3578737614,40
2,1103,23295,3578737574,3578737614,40
2,1103,23296,3578737574,3578737618,44
2,1103,23297,3578737574,3578737619,45
2,1103,23298,3578737574,3578737619,45
2,1103,23299,3578737574,3578737620,46
2,1103,23300,3578737574,3578737621,47
2,1104,23301,3578737636,3578737636,0
2,1104,23302,3578737636,3578737636,0
2,1104,23303,3578737636,3578737636,0
2,1104,23304,3578737636,3578737636,0
2,1104,23305,3578737636,3578737636,0
2,1104,23306,3578737636,3578737636,0
2,1104,23307,3578737636,3578737636,0
2,1104,23308,3578737636,3578737636,0
2,1104,23309,3578737636,3578737636,0
2,1104,23310,3578737636,3578737636,0
2,1104,23311,3578737636,3578737636,0
2,1104,23312,3578737636,3578737636,0
2,1104,23313,3578737636,3578737636,0
2,1104,23314,3578737636,3578737636,0
2,1104,23315,3578737636,3578737636,0
2,1104,23316,3578737636,3578737638,2
2,1104,23317,3578737636,3578737638,2
2,1104,23318,3578737636,3578737638,2
2,1104,23319,3578737636,3578737639,3
2,1104,23320,3578737636,3578737641,5
2,1104,23321,3578737636,3578737641,5
2,1104,23322,3578737636,3578737642,6
2,1104,23323,3578737636,3578737644,8
2,1104,23324,3578737636,3578737645,9
2,1104,23325,3578737636,3578737646,10
2,1104,23326,3578737636,3578737648,12
2,1104,23327,3578737636,3578737649,13
2,1104,23328,3578737636,3578737649,13
2,1104,23329,3578737636,3578737650,14
2,1104,23330,3578737636,3578737651,15
2,1104,23331,3578737636,3578737653,17
2,1104,23332,3578737636,3578737653,17
2,1104,23333,3578737636,3578737654,18
2,1104,23334,3578737636,3578737654,18
2,1104,23335,3578737636,3578737656,20
2,1104,23336,3578737636,3578737657,21
2,1104,23337,3578737636,3578737657,21
2,1104,23338,3578737636,3578737658,22
2,1104,23339,3578737636,3578737658,22
2,1104,23340,3578737636,3578737659,23
2,1104,23341,3578737636,3578737660,24
2,1104,23342,3578737636,3578737660,24
2,1104,23343,3578737636,3578737663,27
2,1104,23344,3578737636,3578737663,27
2,1104,23345,3578737636,3578737665,29
2,1104,23346,3578737636,3578737666,30
2,1104,23347,3578737636,3578737667,31
2,1104,23348,3578737636,3578737668,32
2,1104,23349,3578737636,3578737669,33
2,1104,23350,3578737636,3578737674,38
2,1104,23351,3578737636,3578737675,39
2,1104,23352,3578737636,3578737676,40
2,1104,23353,3578737636,3578737680,44
2,1104,23354,3578737636,3578737681,45
2,1104,23355,3578737636,3578737682,46
2,1104,23356,3578737636,3578737682,46
2,1104,23357,3578737636,3578737683,47
2,1104,23358,3578737636,3578737684,48
2,1104,23359,3578737636,3578737684,48
2,1104,23360,3578737636,3578737684,48
2,1104,23361,3578737636,3578737686,50
2,1105,23362,3578737698,3578737698,0
2,1105,23363,3578737698,3578737698,0
2,1105,23364,3578737698,3578737698,0
2,1105,23365,3578737698,3578737698,0
2,1105,23366,3578737698,3578737698,0
2,1105,23367,3578737698,3578737698,0
2,1105,23368,3578737698,3578737698,0
2,1105,23369,3578737698,3578737698,0
2,1105,23370,3578737698,3578737698,0
2,1105,23371,3578737698,3578737698,0
2,1105,23372,3578737698,3578737698,0
2,1105,23373,3578737698,3578737698,0
2,1105,23374,3578737698,3578737698,0
2,1105,23375,3578737698,3578737698,0
2,1105,23376,3578737698,3578737698,0
2,1105,23377,3578737698,3578737698,0
2,1105,23378,3578737698,3578737699,1
2,1105,23379,3578737698,3578737699,1
2,1105,23380,3578737698,3578737700,2
2,1105,23381,3578737698,3578737700,2
2,1105,23382,3578737698,3578737701,3
2,1105,23383,3578737698,3578737702,4
2,1105,23384,3578737698,3578737703,5
2,1105,23385,3578737698,3578737705,7
2,1105,23386,3578737698,3578737706,8
2,1105,23387,3578737698,3578737708,10
2,1105,23388,3578737698,3578737709,11
2,1105,23389,3578737698,3578737709,11
2,1105,23390,3578737698,3578737711,13
2,1105,23391,3578737698,3578737711,13
2,1105,23392,3578737698,3578737712,14
2,1105,23393,3578737698,3578737712,14
2,1105,23394,3578737698,3578737712,14
2,1105,23395,3578737698,3578737713,15
2,1105,23396,3578737698,3578737714,16
2,1105,23397,3578737698,3578737714,16
2,1105,23398,3578737698,3578737714,16
2,1105,23399,3578737698,3578737715,17
2,1105,23400,3578737698,3578737717,19
2,1105,23401,3578737698,3578737718,20
2,1105,23402,3578737698,3578737718,20
2,1105,23403,3578737698,3578737719,21
2,1105,23404,3578737698,3578737719,21
2,1105,23405,3578737698,3578737721,23
2,1105,23406,3578737698,3578737722,24
2,1105,23407,3578737698,3578737722,24
2,1105,23408,3578737698,3578737723,25
2,1105,23409,3578737698,3578737723,25
2,1105,23410,3578737698,3578737724,26
2,1105,23411,3578737698,3578737724,26
2,1105,23412,3578737698,3578737724,26
2,1105,23413,3578737698,3578737725,27
2,1105,23414,3578737698,3578737726,28
2,1105,23415,3578737698,3578737727,29
2,1105,23416,3578737698,3578737727,29
2,1105,23417,3578737698,3578737730,32
2,1105,23418,3578737698,3578737730,32
2,1105,23419,3578737698,3578737730,32
2,1105,23420,3578737698,3578737731,33
2,1105,23421,3578737698,3578737732,34
2,1105,23422,3578737698,3578737732,34
2,1105,23423,3578737698,3578737734,36
2,1105,23424,3578737698,3578737734,36
2,1105,23425,3578737698,3578737736,38
2,1105,23426,3578737698,3578737736,38
2,1105,23427,3578737698,3578737736,38
2,1105,23428,3578737698,3578737737,39
2,1105,23429,3578737698,3578737738,40
2,1105,23430,3578737698,3578737738,40
2,1105,23431,3578737698,3578737740,42
2,1105,23432,3578737698,3578737741,43
2,1105,23433,3578737698,3578737741,43
2,1105,23434,3578737698,3578737743,45
2,1105,23435,3578737698,3578737743,45
2,1105,23436,3578737698,3578737743,45
2,1105,23437,3578737698,3578737744,46
2,1105,23438,3578737698,3578737747,49
2,1105,23439,3578737698,3578737748,50
2,1106,23440,3578737758,3578737759,1
2,1106,23441,3578737758,3578737759,1
2,1106,23442,3578737758,3578737759,1
2,1106,23443,3578737758,3578737759,1
2,1106,23444,3578737758,3578737759,1
2,1106,23445,3578737758,3578737759,1
2,1106,23446,3578737758,3578737760,2
2,1106,23447,3578737758,3578737760,2
2,1106,23448,3578737758,3578737762,4
2,1106,23449,3578737758,3578737763,5
2,1106,23450,3578737758,3578737763,5
2,1106,23451,3578737758,3578737764,6
2,1106,23452,3578737758,3578737764,6
2,1106,23453,3578737758,3578737765,7
2,1106,23454,3578737758,3578737767,9
2,1106,23455,3578737758,3578737769,11
2,1106,23456,3578737758,3578737769,11
2,1106,23457,3578737758,3578737772,14
2,1106,23458,3578737758,3578737773,15
2,1106,23459,3578737758,3578737774,16
2,1106,23460,3578737758,3578737774,16
2,1106,23461,3578737758,3578737775,17
2,1106,23462,3578737758,3578737778,20
2,1106,23463,3578737758,3578737778,20
2,1106,23464,3578737758,3578737779,21
2,1106,23465,3578737758,3578737779,21
2,1106,23466,3578737758,3578737780,22
2,1106,23467,3578737758,3578737781,23
2,1106,23468,3578737758,3578737784,26
2,1106,23469,3578737758,3578737784,26
2,1106,23470,3578737758,3578737787,29
2,1106,23471,3578737758,3578737787,29
2,1106,23472,3578737758,3578737788,30
2,1106,23473,3578737758,3578737790,32
2,1106,23474,3578737758,3578737790,32
2,1106,23475,3578737758,3578737790,32
2,1106,23476,3578737758,3578737792,34
2,1106,23477,3578737758,3578737793,35
2,1106,23478,3578737758,3578737793,35
2,1106,23479,3578737758,3578737794,36
2,1106,23480,3578737758,3578737796,38
2,1106,23481,3578737758,3578737798,40
2,1106,23482,3578737758,3578737798,40
2,1106,23483,3578737758,3578737799,41
2,1106,23484,3578737758,3578737802,44
2,1106,23485,3578737758,3578737805,47
2,1106,23486,3578737758,3578737806,48
2,1107,23487,3578737821,3578737821,0
2,1107,23488,3578737821,3578737821,0
2,1107,23489,3578737821,3578737821,0
2,1107,23490,3578737821,3578737821,0
2,1107,23491,3578737821,3578737821,0
2,1107,23492,3578737821,3578737821,0
2,1107,23493,3578737821,3578737821,0
2,1107,23494,3578737821,3578737821,0
2,1107,23495,3578737821,3578737821,0
2,1107,23496,3578737821,3578737821,0
2,1107,23497,3578737821,3578737824,3
2,1107,23498,3578737821,3578737824,3
2,1107,23499,3578737821,3578737827,6
2,1107,23500,3578737821,3578737828,7
2,1107,23501,3578737821,3578737828,7
2,1107,23502,3578737821,3578737829,8
2,1107,23503,3578737821,3578737829,8
2,1107,23504,3578737821,3578737829,8
2,1107,23505,3578737821,3578737830,9
2,1107,23506,3578737821,3578737832,11
2,1107,23507,3578737821,3578737832,11
2,1107,23508,3578737821,3578737832,11
2,1107,23509,3578737821,3578737833,12
2,1107,23510,3578737821,3578737835,14
2,1107,23511,3578737821,3578737837,16
2,1107,23512,3578737821,3578737837,16
2,1107,23513,3578737821,3578737838,17
2,1107,23514,3578737821,3578737838,17
2,1107,23515,3578737821,3578737839,18
2,1107,23516,3578737821,3578737840,19
2,1107,23517,3578737821,3578737841,20
2,1107,23518,3578737821,3578737841,20
2,1107,23519,3578737821,3578737842,21
2,1107,23520,3578737821,3578737844,23
2,1107,23521,3578737821,3578737845,24
2,1107,23522,3578737821,3578737846,25
2,1107,23523,3578737821,3578737848,27
2,1107,23524,3578737821,3578737849,28
2,1107,23525,3578737821,3578737849,28
2,1107,23526,3578737821,3578737851,30
2,1107,23527,3578737821,3578737851,30
2,1107,23528,3578737821,3578737853,32
2,1107,23529,3578737821,3578737853,32
2,1107,23530,3578737821,3578737854,33
2,1107,23531,3578737821,3578737857,36
2,1107,23532,3578737821,3578737857,36
2,1107,23533,3578737821,3578737857,36
2,1107,23534,3578737821,3578737860,39
2,1107,23535,3578737821,3578737860,39
2,1107,23536,3578737821,3578737860,39
2,1107,23537,3578737821,3578737861,40
2,1107,23538,3578737821,3578737864,43
2,1107,23539,3578737821,3578737864,43
2,1107,23540,3578737821,3578737865,44
2,1107,23541,3578737821,3578737867,46
2,1107,23542,3578737821,3578737868,47
2,1108,23543,3578737882,3578737882,0
2,1108,23544,3578737882,3578737882,0
2,1108,23545,3578737882,3578737882,0
2,1108,23546,3578737882,3578737882,0
2,1108,23547,3578737882,3578737882,0
2,1108,23548,3578737882,3578737882,0
2,1108,23549,3578737882,3578737882,0
2,1108,23550,3578737882,3578737883,1
2,1108,23551,3578737882,3578737883,1
2,1108,23552,3578737882,3578737883,1
2,1108,23553,3578737882,3578737884,2
2,1108,23554,3578737882,3578737884,2
2,1108,23555,3578737882,3578737884,2
2,1108,23556,3578737882,3578737885,3
2,1108,23557,3578737882,3578737887,5
2,1108,23558,3578737882,3578737887,5
2,1108,23559,3578737882,3578737888,6
2,1108,23560,3578737882,3578737888,6
2,1108,23561,3578737882,3578737890,8
2,1108,23562,3578737882,3578737893,11
2,1108,23563,3578737882,3578737894,12
2,1108,23564,3578737882,3578737894,12
2,1108,23565,3578737882,3578737894,12
2,1108,23566,3578737882,3578737894,12
2,1108,23567,3578737882,3578737895,13
2,1108,23568,3578737882,3578737895,13
2,1108,23569,3578737882,3578737896,14
2,1108,23570,3578737882,3578737896,14
2,1108,23571,3578737882,3578737897,15
2,1108,23572,3578737882,3578737898,16
2,1108,23573,3578737882,3578737898,16
2,1108,23574,3578737882,3578737899,17
2,1108,23575,3578737882,3578737901,19
2,1108,23576,3578737882,3578737901,19
2,1108,23577,3578737882,3578737901,19
2,1108,23578,3578737882,3578737901,19
2,1108,23579,3578737882,3578737904,22
2,1108,23580,3578737882,3578737906,24
2,1108,23581,3578737882,3578737906,24
2,1108,23582,3578737882,3578737907,25
2,1108,23583,3578737882,3578737909,27
2,1108,23584,3578737882,3578737910,28
2,1108,23585,3578737882,3578737910,28
2,1108,23586,3578737882,3578737913,31
2,1108,23587,3578737882,3578737913,31
2,1108,23588,3578737882,3578737914,32
2,1108,23589,3578737882,3578737914,32
2,1108,23590,3578737882,3578737915,33
2,1108,23591,3578737882,3578737915,33
2,1108,23592,3578737882,3578737917,35
2,1108,23593,3578737882,3578737918,36
2,1108,23594,3578737882,3578737919,37
2,1108,23595,3578737882,3578737919,37
2,1108,23596,3578737882,3578737920,38
2,1108,23597,3578737882,3578737920,38
2,1108,23598,3578737882,3578737922,40
2,1108,23599,3578737882,3578737923,41
2,1108,23600,3578737882,3578737923,41
2,1108,23601,3578737882,3578737923,41
2,1108,23602,3578737882,3578737924,42
2,1108,23603,3578737882,3578737925,43
2,1108,23604,3578737882,3578737926,44
2,1108,23605,3578737882,3578737926,44
2,1108,23606,3578737882,3578737927,45
2,1108,23607,3578737882,3578737927,45
2,1108,23608,3578737882,3578737930,48
2,1108,23609,3578737882,3578737930,48
2,1108,23610,3578737882,3578737931,49
2,1109,23611,3578737942,3578737942,0
2,1109,23612,3578737942,3578737942,0
2,1109,23613,3578737942,3578737942,0
2,1109,23614,3578737942,3578737942,0
2,1109,23615,3578737942,3578737942,0
2,1109,23616,3578737942,3578737942,0
2,1109,23617,3578737942,3578737942,0
2,1109,23618,3578737942,3578737942,0
2,1109,23619,3578737942,3578737942,0
2,1109,23620,3578737942,3578737942,0
2,1109,23621,3578737942,3578737942,0
2,1109,23622,3578737942,3578737942,0
2,1109,23623,3578737942,3578737942,0
2,1109,23624,3578737942,3578737943,1
2,1109,23625,3578737942,3578737943,1
2,1109,23626,3578737942,3578737944,2
2,1109,23627,3578737942,3578737945,3
2,1109,23628,3578737942,3578737948,6
2,1109,23629,3578737942,3578737949,7
2,1109,23630,3578737942,3578737949,7
2,1109,23631,3578737942,3578737951,9
2,1109,23632,3578737942,3578737951,9
2,1109,23633,3578737942,3578737953,11
2,1109,23634,3578737942,3578737955,13
2,1109,23635,3578737942,3578737960,18
2,1109,23636,3578737942,3578737961,19
2,1109,23637,3578737942,3578737961,19
2,1109,23638,3578737942,3578737962,20
2,1109,23639,3578737942,3578737963,21
2,1109,23640,3578737942,3578737963,21
2,1109,23641,3578737942,3578737964,22
2,1109,23642,3578737942,3578737965,23
2,1109,23643,3578737942,3578737968,26
2,1109,23644,3578737942,3578737969,27
2,1109,23645,3578737942,3578737972,30
2,1109,23646,3578737942,3578737973,31
2,1109,23647,3578737942,3578737974,32
2,1109,23648,3578737942,3578737974,32
2,1109,23649,3578737942,3578737976,34
2,1109,23650,3578737942,3578737977,35
2,1109,23651,3578737942,3578737978,36
2,1109,23652,3578737942,3578737978,36
2,1109,23653,3578737942,3578737979,37
2,1109,23654,3578737942,3578737980,38
2,1109,23655,3578737942,3578737980,38
2,1109,23656,3578737942,3578737981,39
2,1109,23657,3578737942,3578737984,42
2,1109,23658,3578737942,3578737984,42
2,1109,23659,3578737942,3578737984,42
2,1109,23660,3578737942,3578737987,45
2,1109,23661,3578737942,3578737987,45
2,1109,23662,3578737942,3578737988,46
2,1109,23663,3578737942,3578737990,48
2,1109,23664,3578737942,3578737990,48
2,1109,23665,3578737942,3578737991,49
2,1110,23666,3578738003,3578738003,0
2,1110,23667,3578738003,3578738003,0
2,1110,23668,3578738003,3578738003,0
2,1110,23669,3578738003,3578738003,0
2,1110,23670,3578738003,3578738003,0
2,1110,23671,3578738003,3578738003,0
2,1110,23672,3578738003,3578738003,0
2,1110,23673,3578738003,3578738003,0
2,1110,23674,3578738003,3578738003,0
2,1110,23675,3578738003,3578738005,2
2,1110,23676,3578738003,3578738009,6
2,1110,23677,3578738003,3578738012,9
2,1110,23678,3578738003,3578738013,10
2,1110,23679,3578738003,3578738013,10
2,1110,23680,3578738003,3578738014,11
2,1110,23681,3578738003,3578738014,11
2,1110,23682,3578738003,3578738015,12
2,1110,23683,3578738003,3578738020,17
2,1110,23684,3578738003,3578738020,17
2,1110,23685,3578738003,3578738020,17
2,1110,23686,3578738003,3578738024,21
2,1110,23687,3578738003,3578738026,23
2,1110,23688,3578738003,3578738027,24
2,1110,23689,3578738003,3578738028,25
2,1110,23690,3578738003,3578738028,25
2,1110,23691,3578738003,3578738028,25
2,1110,23692,3578738003,3578738029,26
2,1110,23693,3578738003,3578738029,26
2,1110,23694,3578738003,3578738030,27
2,1110,23695,3578738003,3578738031,28
2,1110,23696,3578738003,3578738031,28
2,1110,23697,3578738003,3578738032,29
2,1110,23698,3578738003,3578738032,29
2,1110,23699,3578738003,3578738032,29
2,1110,23700,3578738003,3578738033,30
2,1110,23701,3578738003,3578738035,32
2,1110,23702,3578738003,3578738038,35
2,1110,23703,3578738003,3578738038,35
2,1110,23704,3578738003,3578738038,35
2,1110,23705,3578738003,3578738038,35
2,1110,23706,3578738003,3578738039,36
2,1110,23707,3578738003,3578738039,36
2,1110,23708,3578738003,3578738041,38
2,1110,23709,3578738003,3578738041,38
2,1110,23710,3578738003,3578738042,39
2,1110,23711,3578738003,3578738044,41
2,1110,23712,3578738003,3578738046,43
2,1110,23713,3578738003,3578738049,46
2,1110,23714,3578738003,3578738049,46
2,1110,23715,3578738003,3578738051,48
2,1110,23716,3578738003,3578738052,49
2,1111,23717,3578738062,3578738062,0
2,1111,23718,3578738062,3578738062,0
2,1111,23719,3578738062,3578738062,0
2,1111,23720,3578738062,3578738062,0
2,1111,23721,3578738062,3578738062,0
2,1111,23722,3578738062,3578738062,0
2,1111,23723,3578738062,3578738062,0
2,1111,23724,3578738062,3578738063,1
2,1111,23725,3578738062,3578738063,1
2,1111,23726,3578738062,3578738063,1
2,1111,23727,3578738062,3578738065,3
2,1111,23728,3578738062,3578738065,3
2,1111,23729,3578738062,3578738067,5
2,1111,23730,3578738062,3578738067,5
2,1111,23731,3578738062,3578738067,5
2,1111,23732,3578738062,3578738067,5
2,1111,23733,3578738062,3578738067,5
2,1111,23734,3578738062,3578738069,7
2,1111,23735,3578738062,3578738069,7
2,1111,23736,3578738062,3578738076,14
2,1111,23737,3578738062,3578738077,15
2,1111,23738,3578738062,3578738077,15
2,1111,23739,3578738062,3578738080,18
2,1111,23740,3578738062,3578738080,18
2,1111,23741,3578738062,3578738081,19
2,1111,23742,3578738062,3578738082,20
2,1111,23743,3578738062,3578738084,22
2,1111,23744,3578738062,3578738084,22
2,1111,23745,3578738062,3578738084,22
2,1111,23746,3578738062,3578738085,23
2,1111,23747,3578738062,3578738085,23
2,1111,23748,3578738062,3578738086,24
2,1111,23749,3578738062,3578738088,26
2,1111,23750,3578738062,3578738089,27
2,1111,23751,3578738062,3578738089,27
2,1111,23752,3578738062,3578738091,29
2,1111,23753,3578738062,3578738094,32
2,1111,23754,3578738062,3578738094,32
2,1111,23755,3578738062,3578738094,32
2,1111,23756,3578738062,3578738095,33
2,1111,23757,3578738062,3578738095,33
2,1111,23758,3578738062,3578738095,33
2,1111,23759,3578738062,3578738095,33
2,1111,23760,3578738062,3578738096,34
2,1111,23761,3578738062,3578738097,35
2,1111,23762,3578738062,3578738097,35
2,1111,23763,3578738062,3578738097,35
2,1111,23764,3578738062,3578738099,37
2,1111,23765,3578738062,3578738099,37
2,1111,23766,3578738062,3578738099,37
2,1111,23767,3578738062,3578738101,39
2,1111,23768,3578738062,3578738102,40
2,1111,23769,3578738062,3578738102,40
2,1111,23770,3578738062,3578738104,42
2,1111,23771,3578738062,3578738106,44
2,1111,23772,3578738062,3578738106,44
2,1111,23773,3578738062,3578738108,46
2,1111,23774,3578738062,3578738109,47
2,1111,23775,3578738062,3578738110,48
2,1111,23776,3578738062,3578738110,48
2,1111,23777,3578738062,3578738111,49
2,1112,23778,3578738127,3578738127,0
2,1112,23779,3578738127,3578738127,0
2,1112,23780,3578738127,3578738127,0
2,1112,23781,3578738127,3578738127,0
2,1112,23782,3578738127,3578738127,0
2,1112,23783,3578738127,3578738127,0
2,1112,23784,3578738127,3578738127,0
2,1112,23785,3578738127,3578738127,0
2,1112,23786,3578738127,3578738127,0
2,1112,23787,3578738127,3578738127,0
2,1112,23788,3578738127,3578738127,0
2,1112,23789,3578738127,3578738127,0
2,1112,23790,3578738127,3578738127,0
2,1112,23791,3578738127,3578738127,0
2,1112,23792,3578738127,3578738127,0
2,1112,23793,3578738127,3578738127,0
2,1112,23794,3578738127,3578738127,0
2,1112,23795,3578738127,3578738127,0
2,1112,23796,3578738127,3578738127,0
2,1112,23797,3578738127,3578738127,0
2,1112,23798,3578738127,3578738127,0
2,1112,23799,3578738127,3578738127,0
2,1112,23800,3578738127,3578738128,1
2,1112,23801,3578738127,3578738130,3
2,1112,23802,3578738127,3578738130,3
2,1112,23803,3578738127,3578738131,4
2,1112,23804,3578738127,3578738133,6
2,1112,23805,3578738127,3578738133,6
2,1112,23806,3578738127,3578738133,6
2,1112,23807,3578738127,3578738134,7
2,1112,23808,3578738127,3578738136,9
2,1112,23809,3578738127,3578738136,9
2,1112,23810,3578738127,3578738136,9
2,1112,23811,3578738127,3578738137,10
2,1112,23812,3578738127,3578738138,11
2,1112,23813,3578738127,3578738138,11
2,1112,23814,3578738127,3578738139,12
2,1112,23815,3578738127,3578738140,13
2,1112,23816,3578738127,3578738141,14
2,1112,23817,3578738127,3578738143,16
2,1112,23818,3578738127,3578738143,16
2,1112,23819,3578738127,3578738143,16
2,1112,23820,3578738127,3578738143,16
2,1112,23821,3578738127,3578738144,17
2,1112,23822,3578738127,3578738146,19
2,1112,23823,3578738127,3578738147,20
2,1112,23824,3578738127,3578738149,22
2,1112,23825,3578738127,3578738150,23
2,1112,23826,3578738127,3578738151,24
2,1112,23827,3578738127,3578738152,25
2,1112,23828,3578738127,3578738155,28
2,1112,23829,3578738127,3578738156,29
2,1112,23830,3578738127,3578738160,33
2,1112,23831,3578738127,3578738161,34
2,1112,23832,3578738127,3578738161,34
2,1112,23833,3578738127,3578738162,35
2,1112,23834,3578738127,3578738164,37
2,1112,23835,3578738127,3578738164,37
2,1112,23836,3578738127,3578738164,37
2,1112,23837,3578738127,3578738165,38
2,1112,23838,3578738127,3578738169,42
2,1112,23839,3578738127,3578738169,42
2,1112,23840,3578738127,3578738171,44
2,1112,23841,3578738127,3578738173,46
2,1112,23842,3578738127,3578738174,47
2,1112,23843,3578738127,3578738175,48
2,1112,23844,3578738127,3578738176,49
2,1113,23845,3578738188,3578738188,0
2,1113,23846,3578738188,3578738188,0
2,1113,23847,3578738188,3578738188,0
2,1113,23848,3578738188,3578738188,0
2,1113,23849,3578738188,3578738188,0
2,1113,23850,3578738188,3578738188,0
2,1113,23851,3578738188,3578738188,0
2,1113,23852,3578738188,3578738188,0
2,1113,23853,3578738188,3578738188,0
2,1113,23854,3578738188,3578738188,0
2,1113,23855,3578738188,3578738188,0
2,1113,23856,3578738188,3578738189,1
2,1113,23857,3578738188,3578738190,2
2,1113,23858,3578738188,3578738190,2
2,1113,23859,3578738188,3578738191,3
2,1113,23860,3578738188,3578738192,4
2,1113,23861,3578738188,3578738193,5
2,1113,23862,3578738188,3578738194,6
2,1113,23863,3578738188,3578738196,8
2,1113,23864,3578738188,3578738196,8
2,1113,23865,3578738188,3578738197,9
2,1113,23866,3578738188,3578738198,10
2,1113,23867,3578738188,3578738200,12
2,1113,23868,3578738188,3578738203,15
2,1113,23869,3578738188,3578738205,17
2,1113,23870,3578738188,3578738207,19
2,1113,23871,3578738188,3578738209,21
2,1113,23872,3578738188,3578738213,25
2,1113,23873,3578738188,3578738213,25
2,1113,23874,3578738188,3578738213,25
2,1113,23875,3578738188,3578738215,27
2,1113,23876,3578738188,3578738215,27
2,1113,23877,3578738188,3578738219,31
2,1113,23878,3578738188,3578738221,33
2,1113,23879,3578738188,3578738221,33
2,1113,23880,3578738188,3578738221,33
2,1113,23881,3578738188,3578738221,33
2,1113,23882,3578738188,3578738224,36
2,1113,23883,3578738188,3578738225,37
2,1113,23884,3578738188,3578738227,39
2,1113,23885,3578738188,3578738227,39
2,1113,23886,3578738188,3578738228,40
2,1113,23887,3578738188,3578738228,40
2,1113,23888,3578738188,3578738229,41
2,1113,23889,3578738188,3578738229,41
2,1113,23890,3578738188,3578738230,42
2,1113,23891,3578738188,3578738232,44
2,1113,23892,3578738188,3578738232,44
2,1113,23893,3578738188,3578738232,44
2,1113,23894,3578738188,3578738232,44
2,1113,23895,3578738188,3578738233,45
2,1113,23896,3578738188,3578738233,45
2,1113,23897,3578738188,3578738236,48
2,1113,23898,3578738188,3578738237,49
2,1113,23899,3578738188,3578738238,50
2,1114,23900,3578738250,3578738250,0
2,1114,23901,3578738250,3578738250,0
2,1114,23902,3578738250,3578738250,0
2,1114,23903,3578738250,3578738250,0
2,1114,23904,3578738250,3578738250,0
2,1114,23905,3578738250,3578738250,0
2,1114,23906,3578738250,3578738250,0
2,1114,23907,3578738250,3578738250,0
2,1114,23908,3578738250,3578738250,0
2,1114,23909,3578738250,3578738250,0
2,1114,23910,3578738250,3578738252,2
2,1114,23911,3578738250,3578738253,3
2,1114,23912,3578738250,3578738253,3
2,1114,23913,3578738250,3578738256,6
2,1114,23914,3578738250,3578738257,7
2,1114,23915,3578738250,3578738257,7
2,1114,23916,3578738250,3578738258,8
2,1114,23917,3578738250,3578738260,10
2,1114,23918,3578738250,3578738260,10
2,1114,23919,3578738250,3578738260,10
2,1114,23920,3578738250,3578738261,11
2,1114,23921,3578738250,3578738265,15
2,1114,23922,3578738250,3578738268,18
2,1114,23923,3578738250,3578738268,18
2,1114,23924,3578738250,3578738269,19
2,1114,23925,3578738250,3578738271,21
2,1114,23926,3578738250,3578738276,26
2,1114,23927,3578738250,3578738277,27
2,1114,23928,3578738250,3578738278,28
2,1114,23929,3578738250,3578738280,30
2,1114,23930,3578738250,3578738281,31
2,1114,23931,3578738250,3578738281,31
2,1114,23932,3578738250,3578738282,32
2,1114,23933,3578738250,3578738283,33
2,1114,23934,3578738250,3578738284,34
2,1114,23935,3578738250,3578738284,34
2,1114,23936,3578738250,3578738285,35
2,1114,23937,3578738250,3578738285,35
2,1114,23938,3578738250,3578738285,35
2,1114,23939,3578738250,3578738287,37
2,1114,23940,3578738250,3578738288,38
2,1114,23941,3578738250,3578738288,38
2,1114,23942,3578738250,3578738288,38
2,1114,23943,3578738250,3578738289,39
2,1114,23944,3578738250,3578738291,41
2,1114,23945,3578738250,3578738293,43
2,1114,23946,3578738250,3578738294,44
2,1114,23947,3578738250,3578738294,44
2,1114,23948,3578738250,3578738294,44
2,1114,23949,3578738250,3578738295,45
2,1114,23950,3578738250,3578738295,45
2,1114,23951,3578738250,3578738295,45
2,1114,23952,3578738250,3578738297,47
2,1114,23953,3578738250,3578738297,47
2,1114,23954,3578738250,3578738297,47
2,1114,23955,3578738250,3578738299,49
2,1114,23956,3578738250,3578738299,49
2,1115,23957,3578738309,3578738309,0
2,1115,23958,3578738309,3578738309,0
2,1115,23959,3578738309,3578738309,0
2,1115,23960,3578738309,3578738309,0
2,1115,23961,3578738309,3578738309,0
2,1115,23962,3578738309,3578738309,0
2,1115,23963,3578738309,3578738310,1
2,1115,23964,3578738309,3578738310,1
2,1115,23965,3578738309,3578738310,1
2,1115,23966,3578738309,3578738311,2
2,1115,23967,3578738309,3578738311,2
2,1115,23968,3578738309,3578738312,3
2,1115,23969,3578738309,3578738312,3
2,1115,23970,3578738309,3578738313,4
2,1115,23971,3578738309,3578738314,5
2,1115,23972,3578738309,3578738315,6
2,1115,23973,3578738309,3578738316,7
2,1115,23974,3578738309,3578738317,8
2,1115,23975,3578738309,3578738318,9
2,1115,23976,3578738309,3578738318,9
2,1115,23977,3578738309,3578738319,10
2,1115,23978,3578738309,3578738319,10
2,1115,23979,3578738309,3578738320,11
2,1115,23980,3578738309,3578738321,12
2,1115,23981,3578738309,3578738321,12
2,1115,23982,3578738309,3578738322,13
2,1115,23983,3578738309,3578738322,13
2,1115,23984,3578738309,3578738323,14
2,1115,23985,3578738309,3578738323,14
2,1115,23986,3578738309,3578738323,14
2,1115,23987,3578738309,3578738324,15
2,1115,23988,3578738309,3578738325,16
2,1115,23989,3578738309,3578738326,17
2,1115,23990,3578738309,3578738326,17
2,1115,23991,3578738309,3578738327,18
2,1115,23992,3578738309,3578738328,19
2,1115,23993,3578738309,3578738329,20
2,1115,23994,3578738309,3578738330,21
2,1115,23995,3578738309,3578738330,21
2,1115,23996,3578738309,3578738332,23
2,1115,23997,3578738309,3578738333,24
2,1115,23998,3578738309,3578738333,24
2,1115,23999,3578738309,3578738333,24
2,1115,24000,3578738309,3578738334,25
2,1115,24001,3578738309,3578738336,27
2,1115,24002,3578738309,3578738336,27
2,1115,24003,3578738309,3578738337,28
2,1115,24004,3578738309,3578738337,28
2,1115,24005,3578738309,3578738338,29
2,1115,24006,3578738309,3578738338,29
2,1115,24007,3578738309,3578738339,30
2,1115,24008,3578738309,3578738341,32
2,1115,24009,3578738309,3578738341,32
2,1115,24010,3578738309,3578738342,33
2,1115,24011,3578738309,3578738343,34
2,1115,24012,3578738309,3578738343,34
2,1115,24013,3578738309,3578738345,36
2,1115,24014,3578738309,3578738346,37
2,1115,24015,3578738309,3578738348,39
2,1115,24016,3578738309,3578738349,40
2,1115,24017,3578738309,3578738351,42
2,1115,24018,3578738309,3578738351,42
2,1115,24019,3578738309,3578738352,43
2,1115,24020,3578738309,3578738353,44
2,1115,24021,3578738309,3578738354,45
2,1115,24022,3578738309,3578738355,46
2,1115,24023,3578738309,3578738355,46
2,1116,24024,3578738372,3578738372,0
2,1116,24025,3578738372,3578738372,0
2,1116,24026,3578738372,3578738372,0
2,1116,24027,3578738372,3578738372,0
2,1116,24028,3578738372,3578738372,0
2,1116,24029,3578738372,3578738372,0
2,1116,24030,3578738372,3578738372,0
2,1116,24031,3578738372,3578738372,0
2,1116,24032,3578738372,3578738372,0
2,1116,24033,3578738372,3578738372,0
2,1116,24034,3578738372,3578738372,0
2,1116,24035,3578738372,3578738372,0
2,1116,24036,3578738372,3578738373,1
2,1116,24037,3578738372,3578738375,3
2,1116,24038,3578738372,3578738375,3
2,1116,24039,3578738372,3578738376,4
2,1116,24040,3578738372,3578738378,6
2,1116,24041,3578738372,3578738378,6
2,1116,24042,3578738372,3578738380,8
2,1116,24043,3578738372,3578738380,8
2,1116,24044,3578738372,3578738381,9
2,1116,24045,3578738372,3578738383,11
2,1116,24046,3578738372,3578738384,12
2,1116,24047,3578738372,3578738385,13
2,1116,24048,3578738372,3578738386,14
2,1116,24049,3578738372,3578738389,17
2,1116,24050,3578738372,3578738390,18
2,1116,24051,3578738372,3578738391,19
2,1116,24052,3578738372,3578738392,20
2,1116,24053,3578738372,3578738392,20
2,1116,24054,3578738372,3578738393,21
2,1116,24055,3578738372,3578738394,22
2,1116,24056,3578738372,3578738394,22
2,1116,24057,3578738372,3578738396,24
2,1116,24058,3578738372,3578738396,24
2,1116,24059,3578738372,3578738397,25
2,1116,24060,3578738372,3578738398,26
2,1116,24061,3578738372,3578738399,27
2,1116,24062,3578738372,3578738400,28
2,1116,24063,3578738372,3578738403,31
2,1116,24064,3578738372,3578738405,33
2,1116,24065,3578738372,3578738407,35
2,1116,24066,3578738372,3578738410,38
2,1116,24067,3578738372,3578738413,41
2,1116,24068,3578738372,3578738413,41
2,1116,24069,3578738372,3578738413,41
2,1116,24070,3578738372,3578738414,42
2,1116,24071,3578738372,3578738415,43
2,1116,24072,3578738372,3578738415,43
2,1116,24073,3578738372,3578738421,49
2,1116,24074,3578738372,3578738421,49
2,1116,24075,3578738372,3578738421,49
2,1116,24076,3578738372,3578738421,49
2,1116,24077,3578738372,3578738422,50
2,1117,24078,3578738433,3578738433,0
2,1117,24079,3578738433,3578738433,0
2,1117,24080,3578738433,3578738433,0
2,1117,24081,3578738433,3578738433,0
2,1117,24082,3578738433,3578738433,0
2,1117,24083,3578738433,3578738433,0
2,1117,24084,3578738433,3578738433,0
2,1117,24085,3578738433,3578738433,0
2,1117,24086,3578738433,3578738433,0
2,1117,24087,3578738433,3578738433,0
2,1117,24088,3578738433,3578738433,0
2,1117,24089,3578738433,3578738433,0
2,1117,24090,3578738433,3578738433,0
2,1117,24091,3578738433,3578738437,4
2,1117,24092,3578738433,3578738437,4
2,1117,24093,3578738433,3578738437,4
2,1117,24094,3578738433,3578738439,6
2,1117,24095,3578738433,3578738439,6
2,1117,24096,3578738433,3578738441,8
2,1117,24097,3578738433,3578738441,8
2,1117,24098,3578738433,3578738442,9
2,1117,24099,3578738433,3578738442,9
2,1117,24100,3578738433,3578738443,10
2,1117,24101,3578738433,3578738445,12
2,1117,24102,3578738433,3578738445,12
2,1117,24103,3578738433,3578738446,13
2,1117,24104,3578738433,3578738450,17
2,1117,24105,3578738433,3578738450,17
2,1117,24106,3578738433,3578738451,18
2,1117,24107,3578738433,3578738453,20
2,1117,24108,3578738433,3578738453,20
2,1117,24109,3578738433,3578738454,21
2,1117,24110,3578738433,3578738454,21
2,1117,24111,3578738433,3578738456,23
2,1117,24112,3578738433,3578738457,24
2,1117,24113,3578738433,3578738458,25
2,1117,24114,3578738433,3578738459,26
2,1117,24115,3578738433,3578738459,26
2,1117,24116,3578738433,3578738460,27
2,1117,24117,3578738433,3578738460,27
2,1117,24118,3578738433,3578738461,28
2,1117,24119,3578738433,3578738465,32
2,1117,24120,3578738433,3578738465,32
2,1117,24121,3578738433,3578738467,34
2,1117,24122,3578738433,3578738468,35
2,1117,24123,3578738433,3578738469,36
2,1117,24124,3578738433,3578738470,37
2,1117,24125,3578738433,3578738477,44
2,1117,24126,3578738433,3578738478,45
2,1117,24127,3578738433,3578738480,47
2,1117,24128,3578738433,3578738481,48
2,1117,24129,3578738433,3578738481,48
2,1117,24130,3578738433,3578738482,49
2,1118,24131,3578738492,3578738492,0
2,1118,24132,3578738492,3578738492,0
2,1118,24133,3578738492,3578738492,0
2,1118,24134,3578738492,3578738492,0
2,1118,24135,3578738492,3578738492,0
2,1118,24136,3578738492,3578738492,0
2,1118,24137,3578738492,3578738492,0
2,1118,24138,3578738492,3578738492,0
2,1118,24139,3578738492,3578738492,0
2,1118,24140,3578738492,3578738492,0
2,1118,24141,3578738492,3578738492,0
2,1118,24142,3578738492,3578738493,1
2,1118,24143,3578738492,3578738493,1
2,1118,24144,3578738492,3578738494,2
2,1118,24145,3578738492,3578738494,2
2,1118,24146,3578738492,3578738494,2
2,1118,24147,3578738492,3578738495,3
2,1118,24148,3578738492,3578738495,3
2,1118,24149,3578738492,3578738496,4
2,1118,24150,3578738492,3578738497,5
2,1118,24151,3578738492,3578738497,5
2,1118,24152,3578738492,3578738498,6
2,1118,24153,3578738492,3578738498,6
2,1118,24154,3578738492,3578738499,7
2,1118,24155,3578738492,3578738499,7
2,1118,24156,3578738492,3578738501,9
2,1118,24157,3578738492,3578738501,9
2,1118,24158,3578738492,3578738504,12
2,1118,24159,3578738492,3578738505,13
2,1118,24160,3578738492,3578738506,14
2,1118,24161,3578738492,3578738508,16
2,1118,24162,3578738492,3578738509,17
2,1118,24163,3578738492,3578738509,17
2,1118,24164,3578738492,3578738510,18
2,1118,24165,3578738492,3578738510,18
2,1118,24166,3578738492,3578738511,19
2,1118,24167,3578738492,3578738512,20
2,1118,24168,3578738492,3578738513,21
2,1118,24169,3578738492,3578738513,21
2,1118,24170,3578738492,3578738515,23
2,1118,24171,3578738492,3578738515,23
2,1118,24172,3578738492,3578738515,23
2,1118,24173,3578738492,3578738517,25
2,1118,24174,3578738492,3578738518,26
2,1118,24175,3578738492,3578738518,26
2,1118,24176,3578738492,3578738519,27
2,1118,24177,3578738492,3578738519,27
2,1118,24178,3578738492,3578738519,27
2,1118,24179,3578738492,3578738521,29
2,1118,24180,3578738492,3578738521,29
2,1118,24181,3578738492,3578738521,29
2,1118,24182,3578738492,3578738522,30
2,1118,24183,3578738492,3578738522,30
2,1118,24184,3578738492,3578738523,31
2,1118,24185,3578738492,3578738524,32
2,1118,24186,3578738492,3578738525,33
2,1118,24187,3578738492,3578738525,33
2,1118,24188,3578738492,3578738525,33
2,1118,24189,3578738492,3578738526,34
2,1118,24190,3578738492,3578738528,36
2,1118,24191,3578738492,3578738529,37
2,1118,24192,3578738492,3578738529,37
2,1118,24193,3578738492,3578738530,38
2,1118,24194,3578738492,3578738532,40
2,1118,24195,3578738492,3578738532,40
2,1118,24196,3578738492,3578738533,41
2,1118,24197,3578738492,3578738534,42
2,1118,24198,3578738492,3578738535,43
2,1118,24199,3578738492,3578738536,44
2,1118,24200,3578738492,3578738536,44
2,1118,24201,3578738492,3578738536,44
2,1118,24202,3578738492,3578738537,45
2,1118,24203,3578738492,3578738538,46
2,1118,24204,3578738492,3578738538,46
2,1118,24205,3578738492,3578738540,48
2,1118,24206,3578738492,3578738540,48
2,1118,24207,3578738492,3578738542,50
2,1119,24208,3578738553,3578738553,0
2,1119,24209,3578738553,3578738553,0
2,1119,24210,3578738553,3578738553,0
2,1119,24211,3578738553,3578738553,0
2,1119,24212,3578738553,3578738553,0
2,1119,24213,3578738553,3578738553,0
2,1119,24214,3578738553,3578738553,0
2,1119,24215,3578738553,3578738553,0
2,1119,24216,3578738553,3578738553,0
2,1119,24217,3578738553,3578738553,0
2,1119,24218,3578738553,3578738556,3
2,1119,24219,3578738553,3578738557,4
2,1119,24220,3578738553,3578738559,6
2,1119,24221,3578738553,3578738561,8
2,1119,24222,3578738553,3578738561,8
2,1119,24223,3578738553,3578738562,9
2,1119,24224,3578738553,3578738562,9
2,1119,24225,3578738553,3578738563,10
2,1119,24226,3578738553,3578738563,10
2,1119,24227,3578738553,3578738564,11
2,1119,24228,3578738553,3578738564,11
2,1119,24229,3578738553,3578738567,14
2,1119,24230,3578738553,3578738568,15
2,1119,24231,3578738553,3578738569,16
2,1119,24232,3578738553,3578738571,18
2,1119,24233,3578738553,3578738573,20
2,1119,24234,3578738553,3578738574,21
2,1119,24235,3578738553,3578738575,22
2,1119,24236,3578738553,3578738575,22
2,1119,24237,3578738553,3578738577,24
2,1119,24238,3578738553,3578738578,25
2,1119,24239,3578738553,3578738579,26
2,1119,24240,3578738553,3578738579,26
2,1119,24241,3578738553,3578738580,27
2,1119,24242,3578738553,3578738583,30
2,1119,24243,3578738553,3578738584,31
2,1119,24244,3578738553,3578738584,31
2,1119,24245,3578738553,3578738586,33
2,1119,24246,3578738553,3578738588,35
2,1119,24247,3578738553,3578738589,36
2,1119,24248,3578738553,3578738591,38
2,1119,24249,3578738553,3578738591,38
2,1119,24250,3578738553,3578738592,39
2,1119,24251,3578738553,3578738593,40
2,1119,24252,3578738553,3578738594,41
2,1119,24253,3578738553,3578738595,42
2,1119,24254,3578738553,3578738595,42
2,1119,24255,3578738553,3578738595,42
2,1119,24256,3578738553,3578738596,43
2,1119,24257,3578738553,3578738597,44
2,1119,24258,3578738553,3578738599,46
2,1119,24259,3578738553,3578738599,46
2,1119,24260,3578738553,3578738602,49
2,1120,24261,3578738613,3578738613,0
2,1120,24262,3578738613,3578738613,0
2,1120,24263,3578738613,3578738613,0
2,1120,24264,3578738613,3578738613,0
2,1120,24265,3578738613,3578738613,0
2,1120,24266,3578738613,3578738613,0
2,1120,24267,3578738613,3578738614,1
2,1120,24268,3578738613,3578738615,2
2,1120,24269,3578738613,3578738620,7
2,1120,24270,3578738613,3578738621,8
2,1120,24271,3578738613,3578738621,8
2,1120,24272,3578738613,3578738621,8
2,1120,24273,3578738613,3578738622,9
2,1120,24274,3578738613,3578738623,10
2,1120,24275,3578738613,3578738627,14
2,1120,24276,3578738613,3578738628,15
2,1120,24277,3578738613,3578738628,15
2,1120,24278,3578738613,3578738628,15
2,1120,24279,3578738613,3578738628,15
2,1120,24280,3578738613,3578738629,16
2,1120,24281,3578738613,3578738630,17
2,1120,24282,3578738613,3578738630,17
2,1120,24283,3578738613,3578738631,18
2,1120,24284,3578738613,3578738631,18
2,1120,24285,3578738613,3578738631,18
2,1120,24286,3578738613,3578738631,18
2,1120,24287,3578738613,3578738632,19
2,1120,24288,3578738613,3578738636,23
2,1120,24289,3578738613,3578738637,24
2,1120,24290,3578738613,3578738637,24
2,1120,24291,3578738613,3578738638,25
2,1120,24292,3578738613,3578738639,26
2,1120,24293,3578738613,3578738641,28
2,1120,24294,3578738613,3578738641,28
2,1120,24295,3578738613,3578738641,28
2,1120,24296,3578738613,3578738641,28
2,1120,24297,3578738613,3578738642,29
2,1120,24298,3578738613,3578738644,31
2,1120,24299,3578738613,3578738644,31
2,1120,24300,3578738613,3578738646,33
2,1120,24301,3578738613,3578738649,36
2,1120,24302,3578738613,3578738649,36
2,1120,24303,3578738613,3578738651,38
2,1120,24304,3578738613,3578738651,38
2,1120,24305,3578738613,3578738652,39
2,1120,24306,3578738613,3578738652,39
2,1120,24307,3578738613,3578738653,40
2,1120,24308,3578738613,3578738656,43
2,1120,24309,3578738613,3578738657,44
2,1120,24310,3578738613,3578738657,44
2,1120,24311,3578738613,3578738658,45
2,1120,24312,3578738613,3578738658,45
2,1120,24313,3578738613,3578738659,46
2,1120,24314,3578738613,3578738659,46
2,1120,24315,3578738613,3578738660,47
2,1121,24316,3578738673,3578738673,0
2,1121,24317,3578738673,3578738673,0
2,1121,24318,3578738673,3578738673,0
2,1121,24319,3578738673,3578738673,0
2,1121,24320,3578738673,3578738673,0
2,1121,24321,3578738673,3578738674,1
2,1121,24322,3578738673,3578738674,1
2,1121,24323,3578738673,3578738676,3
2,1121,24324,3578738673,3578738678,5
2,1121,24325,3578738673,3578738679,6
2,1121,24326,3578738673,3578738681,8
2,1121,24327,3578738673,3578738683,10
2,1121,24328,3578738673,3578738685,12
2,1121,24329,3578738673,3578738685,12
2,1121,24330,3578738673,3578738687,14
2,1121,24331,3578738673,3578738687,14
2,1121,24332,3578738673,3578738687,14
2,1121,24333,3578738673,3578738688,15
2,1121,24334,3578738673,3578738688,15
2,1121,24335,3578738673,3578738688,15
2,1121,24336,3578738673,3578738688,15
2,1121,24337,3578738673,3578738688,15
2,1121,24338,3578738673,3578738689,16
2,1121,24339,3578738673,3578738689,16
2,1121,24340,3578738673,3578738693,20
2,1121,24341,3578738673,3578738693,20
2,1121,24342,3578738673,3578738693,20
2,1121,24343,3578738673,3578738694,21
2,1121,24344,3578738673,3578738694,21
2,1121,24345,3578738673,3578738694,21
2,1121,24346,3578738673,3578738695,22
2,1121,24347,3578738673,3578738695,22
2,1121,24348,3578738673,3578738695,22
2,1121,24349,3578738673,3578738697,24
2,1121,24350,3578738673,3578738697,24
2,1121,24351,3578738673,3578738698,25
2,1121,24352,3578738673,3578738699,26
2,1121,24353,3578738673,3578738699,26
2,1121,24354,3578738673,3578738700,27
2,1121,24355,3578738673,3578738700,27
2,1121,24356,3578738673,3578738701,28
2,1121,24357,3578738673,3578738703,30
2,1121,24358,3578738673,3578738704,31
2,1121,24359,3578738673,3578738706,33
2,1121,24360,3578738673,3578738706,33
2,1121,24361,3578738673,3578738709,36
2,1121,24362,3578738673,3578738709,36
2,1121,24363,3578738673,3578738710,37
2,1121,24364,3578738673,3578738710,37
2,1121,24365,3578738673,3578738711,38
2,1121,24366,3578738673,3578738712,39
2,1121,24367,3578738673,3578738712,39
2,1121,24368,3578738673,3578738712,39
2,1121,24369,3578738673,3578738715,42
2,1121,24370,3578738673,3578738715,42
2,1121,24371,3578738673,3578738715,42
2,1121,24372,3578738673,3578738716,43
2,1121,24373,3578738673,3578738718,45
2,1121,24374,3578738673,3578738719,46
2,1121,24375,3578738673,3578738719,46
2,1121,24376,3578738673,3578738720,47
2,1121,24377,3578738673,3578738720,47
2,1121,24378,3578738673,3578738721,48
2,1121,24379,3578738673,3578738721,48
2,1121,24380,3578738673,3578738721,48
2,1121,24381,3578738673,3578738722,49
2,1121,24382,3578738673,3578738722,49
2,1121,24383,3578738673,3578738723,50
2,1122,24384,3578738735,3578738735,0
2,1122,24385,3578738735,3578738735,0
2,1122,24386,3578738735,3578738735,0
2,1122,24387,3578738735,3578738735,0
2,1122,24388,3578738735,3578738735,0
2,1122,24389,3578738735,3578738735,0
2,1122,24390,3578738735,3578738735,0
2,1122,24391,3578738735,3578738735,0
2,1122,24392,3578738735,3578738735,0
2,1122,24393,3578738735,3578738735,0
2,1122,24394,3578738735,3578738735,0
2,1122,24395,3578738735,3578738735,0
2,1122,24396,3578738735,3578738735,0
2,1122,24397,3578738735,3578738735,0
2,1122,24398,3578738735,3578738735,0
2,1122,24399,3578738735,3578738736,1
2,1122,24400,3578738735,3578738736,1
2,1122,24401,3578738735,3578738737,2
2,1122,24402,3578738735,3578738738,3
2,1122,24403,3578738735,3578738739,4
2,1122,24404,3578738735,3578738739,4
2,1122,24405,3578738735,3578738740,5
2,1122,24406,3578738735,3578738741,6
2,1122,24407,3578738735,3578738742,7
2,1122,24408,3578738735,3578738742,7
2,1122,24409,3578738735,3578738742,7
2,1122,24410,3578738735,3578738745,10
2,1122,24411,3578738735,3578738748,13
2,1122,24412,3578738735,3578738750,15
2,1122,24413,3578738735,3578738752,17
2,1122,24414,3578738735,3578738752,17
2,1122,24415,3578738735,3578738753,18
2,1122,24416,3578738735,3578738754,19
2,1122,24417,3578738735,3578738755,20
2,1122,24418,3578738735,3578738757,22
2,1122,24419,3578738735,3578738759,24
2,1122,24420,3578738735,3578738761,26
2,1122,24421,3578738735,3578738762,27
2,1122,24422,3578738735,3578738763,28
2,1122,24423,3578738735,3578738763,28
2,1122,24424,3578738735,3578738763,28
2,1122,24425,3578738735,3578738764,29
2,1122,24426,3578738735,3578738764,29
2,1122,24427,3578738735,3578738765,30
2,1122,24428,3578738735,3578738767,32
2,1122,24429,3578738735,3578738768,33
2,1122,24430,3578738735,3578738769,34
2,1122,24431,3578738735,3578738772,37
2,1122,24432,3578738735,3578738773,38
2,1122,24433,3578738735,3578738774,39
2,1122,24434,3578738735,3578738775,40
2,1122,24435,3578738735,3578738776,41
2,1122,24436,3578738735,3578738778,43
2,1122,24437,3578738735,3578738778,43
2,1122,24438,3578738735,3578738779,44
2,1122,24439,3578738735,3578738779,44
2,1122,24440,3578738735,3578738779,44
2,1122,24441,3578738735,3578738779,44
2,1122,24442,3578738735,3578738780,45
2,1122,24443,3578738735,3578738784,49
2,1122,24444,3578738735,3578738785,50
2,1123,24445,3578738799,3578738799,0
2,1123,24446,3578738799,3578738799,0
2,1123,24447,3578738799,3578738799,0
2,1123,24448,3578738799,3578738799,0
2,1123,24449,3578738799,3578738799,0
2,1123,24450,3578738799,3578738799,0
2,1123,24451,3578738799,3578738799,0
2,1123,24452,3578738799,3578738799,0
2,1123,24453,3578738799,3578738799,0
2,1123,24454,3578738799,3578738799,0
2,1123,24455,3578738799,3578738799,0
2,1123,24456,3578738799,3578738799,0
2,1123,24457,3578738799,3578738799,0
2,1123,24458,3578738799,3578738799,0
2,1123,24459,3578738799,3578738799,0
2,1123,24460,3578738799,3578738802,3
2,1123,24461,3578738799,3578738803,4
2,1123,24462,3578738799,3578738806,7
2,1123,24463,3578738799,3578738809,10
2,1123,24464,3578738799,3578738812,13
2,1123,24465,3578738799,3578738813,14
2,1123,24466,3578738799,3578738813,14
2,1123,24467,3578738799,3578738813,14
2,1123,24468,3578738799,3578738814,15
2,1123,24469,3578738799,3578738816,17
2,1123,24470,3578738799,3578738816,17
2,1123,24471,3578738799,3578738819,20
2,1123,24472,3578738799,3578738820,21
2,1123,24473,3578738799,3578738820,21
2,1123,24474,3578738799,3578738821,22
2,1123,24475,3578738799,3578738822,23
2,1123,24476,3578738799,3578738822,23
2,1123,24477,3578738799,3578738826,27
2,1123,24478,3578738799,3578738826,27
2,1123,24479,3578738799,3578738827,28
2,1123,24480,3578738799,3578738828,29
2,1123,24481,3578738799,3578738829,30
2,1123,24482,3578738799,3578738829,30
2,1123,24483,3578738799,3578738830,31
2,1123,24484,3578738799,3578738830,31
2,1123,24485,3578738799,3578738830,31
2,1123,24486,3578738799,3578738830,31
2,1123,24487,3578738799,3578738831,32
2,1123,24488,3578738799,3578738831,32
2,1123,24489,3578738799,3578738832,33
2,1123,24490,3578738799,3578738833,34
2,1123,24491,3578738799,3578738833,34
2,1123,24492,3578738799,3578738834,35
2,1123,24493,3578738799,3578738836,37
2,1123,24494,3578738799,3578738837,38
2,1123,24495,3578738799,3578738838,39
2,1123,24496,3578738799,3578738838,39
2,1123,24497,3578738799,3578738839,40
2,1123,24498,3578738799,3578738841,42
2,1123,24499,3578738799,3578738841,42
2,1123,24500,3578738799,3578738841,42
2,1123,24501,3578738799,3578738842,43
2,1123,24502,3578738799,3578738842,43
2,1123,24503,3578738799,3578738842,43
2,1123,24504,3578738799,3578738844,45
2,1123,24505,3578738799,3578738844,45
2,1123,24506,3578738799,3578738846,47
2,1124,24507,3578738861,3578738861,0
2,1124,24508,3578738861,3578738861,0
2,1124,24509,3578738861,3578738861,0
2,1124,24510,3578738861,3578738861,0
2,1124,24511,3578738861,3578738861,0
2,1124,24512,3578738861,3578738861,0
2,1124,24513,3578738861,3578738861,0
2,1124,24514,3578738861,3578738861,0
2,1124,24515,3578738861,3578738861,0
2,1124,24516,3578738861,3578738861,0
2,1124,24517,3578738861,3578738861,0
2,1124,24518,3578738861,3578738861,0
2,1124,24519,3578738861,3578738861,0
2,1124,24520,3578738861,3578738861,0
2,1124,24521,3578738861,3578738861,0
2,1124,24522,3578738861,3578738865,4
2,1124,24523,3578738861,3578738866,5
2,1124,24524,3578738861,3578738866,5
2,1124,24525,3578738861,3578738866,5
2,1124,24526,3578738861,3578738867,6
2,1124,24527,3578738861,3578738867,6
2,1124,24528,3578738861,3578738868,7
2,1124,24529,3578738861,3578738868,7
2,1124,24530,3578738861,3578738869,8
2,1124,24531,3578738861,3578738877,16
2,1124,24532,3578738861,3578738878,17
2,1124,24533,3578738861,3578738879,18
2,1124,24534,3578738861,3578738880,19
2,1124,24535,3578738861,3578738881,20
2,1124,24536,3578738861,3578738883,22
2,1124,24537,3578738861,3578738884,23
2,1124,24538,3578738861,3578738885,24
2,1124,24539,3578738861,3578738886,25
2,1124,24540,3578738861,3578738887,26
2,1124,24541,3578738861,3578738887,26
2,1124,24542,3578738861,3578738887,26
2,1124,24543,3578738861,3578738888,27
2,1124,24544,3578738861,3578738888,27
2,1124,24545,3578738861,3578738888,27
2,1124,24546,3578738861,3578738889,28
2,1124,24547,3578738861,3578738889,28
2,1124,24548,3578738861,3578738893,32
2,1124,24549,3578738861,3578738893,32
2,1124,24550,3578738861,3578738893,32
2,1124,24551,3578738861,3578738894,33
2,1124,24552,3578738861,3578738894,33
2,1124,24553,3578738861,3578738895,34
2,1124,24554,3578738861,3578738895,34
2,1124,24555,3578738861,3578738895,34
2,1124,24556,3578738861,3578738897,36
2,1124,24557,3578738861,3578738898,37
2,1124,24558,3578738861,3578738898,37
2,1124,24559,3578738861,3578738898,37
2,1124,24560,3578738861,3578738899,38
2,1124,24561,3578738861,3578738899,38
2,1124,24562,3578738861,3578738899,38
2,1124,24563,3578738861,3578738904,43
2,1124,24564,3578738861,3578738904,43
2,1124,24565,3578738861,3578738906,45
2,1124,24566,3578738861,3578738906,45
2,1124,24567,3578738861,3578738906,45
2,1124,24568,3578738861,3578738909,48
2,1124,24569,3578738861,3578738909,48
2,1124,24570,3578738861,3578738910,49
2,1124,24571,3578738861,3578738910,49
2,1124,24572,3578738861,3578738911,50
2,1125,24573,3578738923,3578738923,0
2,1125,24574,3578738923,3578738923,0
2,1125,24575,3578738923,3578738923,0
2,1125,24576,3578738923,3578738923,0
2,1125,24577,3578738923,3578738923,0
2,1125,24578,3578738923,3578738923,0
2,1125,24579,3578738923,3578738923,0
2,1125,24580,3578738923,3578738923,0
2,1125,24581,3578738923,3578738923,0
2,1125,24582,3578738923,3578738923,0
2,1125,24583,3578738923,3578738923,0
2,1125,24584,3578738923,3578738923,0
2,1125,24585,3578738923,3578738923,0
2,1125,24586,3578738923,3578738923,0
2,1125,24587,3578738923,3578738923,0
2,1125,24588,3578738923,3578738923,0
2,1125,24589,3578738923,3578738923,0
2,1125,24590,3578738923,3578738923,0
2,1125,24591,3578738923,3578738924,1
2,1125,24592,3578738923,3578738925,2
2,1125,24593,3578738923,3578738926,3
2,1125,24594,3578738923,3578738926,3
2,1125,24595,3578738923,3578738928,5
2,1125,24596,3578738923,3578738929,6
2,1125,24597,3578738923,3578738930,7
2,1125,24598,3578738923,3578738931,8
2,1125,24599,3578738923,3578738932,9
2,1125,24600,3578738923,3578738933,10
2,1125,24601,3578738923,3578738934,11
2,1125,24602,3578738923,3578738934,11
2,1125,24603,3578738923,3578738936,13
2,1125,24604,3578738923,3578738937,14
2,1125,24605,3578738923,3578738937,14
2,1125,24606,3578738923,3578738937,14
2,1125,24607,3578738923,3578738939,16
2,1125,24608,3578738923,3578738939,16
2,1125,24609,3578738923,3578738940,17
2,1125,24610,3578738923,3578738941,18
2,1125,24611,3578738923,3578738941,18
2,1125,24612,3578738923,3578738942,19
2,1125,24613,3578738923,3578738942,19
2,1125,24614,3578738923,3578738942,19
2,1125,24615,3578738923,3578738948,25
2,1125,24616,3578738923,3578738948,25
2,1125,24617,3578738923,3578738952,29
2,1125,24618,3578738923,3578738952,29
2,1125,24619,3578738923,3578738955,32
2,1125,24620,3578738923,3578738956,33
2,1125,24621,3578738923,3578738957,34
2,1125,24622,3578738923,3578738959,36
2,1125,24623,3578738923,3578738961,38
2,1125,24624,3578738923,3578738962,39
2,1125,24625,3578738923,3578738962,39
2,1125,24626,3578738923,3578738963,40
2,1125,24627,3578738923,3578738963,40
2,1125,24628,3578738923,3578738964,41
2,1125,24629,3578738923,3578738965,42
2,1125,24630,3578738923,3578738968,45
2,1125,24631,3578738923,3578738968,45
2,1125,24632,3578738923,3578738968,45
2,1125,24633,3578738923,3578738971,48
2,1125,24634,3578738923,3578738973,50
2,1126,24635,3578738986,3578738986,0
2,1126,24636,3578738986,3578738986,0
2,1126,24637,3578738986,3578738986,0
2,1126,24638,3578738986,3578738986,0
2,1126,24639,3578738986,3578738986,0
2,1126,24640,3578738986,3578738986,0
2,1126,24641,3578738986,3578738986,0
2,1126,24642,3578738986,3578738986,0
2,1126,24643,3578738986,3578738986,0
2,1126,24644,3578738986,3578738986,0
2,1126,24645,3578738986,3578738986,0
2,1126,24646,3578738986,3578738986,0
2,1126,24647,3578738986,3578738986,0
2,1126,24648,3578738986,3578738986,0
2,1126,24649,3578738986,3578738986,0
2,1126,24650,3578738986,3578738987,1
2,1126,24651,3578738986,3578738989,3
2,1126,24652,3578738986,3578738990,4
2,1126,24653,3578738986,3578738991,5
2,1126,24654,3578738986,3578738992,6
2,1126,24655,3578738986,3578738992,6
2,1126,24656,3578738986,3578738994,8
2,1126,24657,3578738986,3578738995,9
2,1126,24658,3578738986,3578738995,9
2,1126,24659,3578738986,3578738996,10
2,1126,24660,3578738986,3578738996,10
2,1126,24661,3578738986,3578738997,11
2,1126,24662,3578738986,3578738998,12
2,1126,24663,3578738986,3578738998,12
2,1126,24664,3578738986,3578739000,14
2,1126,24665,3578738986,3578739002,16
2,1126,24666,3578738986,3578739006,20
2,1126,24667,3578738986,3578739008,22
2,1126,24668,3578738986,3578739013,27
2,1126,24669,3578738986,3578739013,27
2,1126,24670,3578738986,3578739013,27
2,1126,24671,3578738986,3578739014,28
2,1126,24672,3578738986,3578739015,29
2,1126,24673,3578738986,3578739016,30
2,1126,24674,3578738986,3578739019,33
2,1126,24675,3578738986,3578739020,34
2,1126,24676,3578738986,3578739021,35
2,1126,24677,3578738986,3578739021,35
2,1126,24678,3578738986,3578739023,37
2,1126,24679,3578738986,3578739023,37
2,1126,24680,3578738986,3578739026,40
2,1126,24681,3578738986,3578739027,41
2,1126,24682,3578738986,3578739028,42
2,1126,24683,3578738986,3578739029,43
2,1126,24684,3578738986,3578739029,43
2,1126,24685,3578738986,3578739030,44
2,1126,24686,3578738986,3578739031,45
2,1126,24687,3578738986,3578739031,45
2,1126,24688,3578738986,3578739031,45
2,1126,24689,3578738986,3578739032,46
2,1126,24690,3578738986,3578739032,46
2,1126,24691,3578738986,3578739033,47
2,1126,24692,3578738986,3578739035,49
2,1127,24693,3578739048,3578739048,0
2,1127,24694,3578739048,3578739048,0
2,1127,24695,3578739048,3578739048,0
2,1127,24696,3578739048,3578739048,0
2,1127,24697,3578739048,3578739048,0
2,1127,24698,3578739048,3578739048,0
2,1127,24699,3578739048,3578739048,0
2,1127,24700,3578739048,3578739048,0
2,1127,24701,3578739048,3578739048,0
2,1127,24702,3578739048,3578739048,0
2,1127,24703,3578739048,3578739048,0
2,1127,24704,3578739048,3578739048,0
2,1127,24705,3578739048,3578739048,0
2,1127,24706,3578739048,3578739048,0
2,1127,24707,3578739048,3578739048,0
2,1127,24708,3578739048,3578739051,3
2,1127,24709,3578739048,3578739051,3
2,1127,24710,3578739048,3578739053,5
2,1127,24711,3578739048,3578739053,5
2,1127,24712,3578739048,3578739053,5
2,1127,24713,3578739048,3578739054,6
2,1127,24714,3578739048,3578739054,6
2,1127,24715,3578739048,3578739055,7
2,1127,24716,3578739048,3578739056,8
2,1127,24717,3578739048,3578739057,9
2,1127,24718,3578739048,3578739058,10
2,1127,24719,3578739048,3578739058,10
2,1127,24720,3578739048,3578739059,11
2,1127,24721,3578739048,3578739059,11
2,1127,24722,3578739048,3578739060,12
2,1127,24723,3578739048,3578739060,12
2,1127,24724,3578739048,3578739065,17
2,1127,24725,3578739048,3578739066,18
2,1127,24726,3578739048,3578739066,18
2,1127,24727,3578739048,3578739067,19
2,1127,24728,3578739048,3578739067,19
2,1127,24729,3578739048,3578739067,19
2,1127,24730,3578739048,3578739068,20
2,1127,24731,3578739048,3578739069,21
2,1127,24732,3578739048,3578739077,29
2,1127,24733,3578739048,3578739078,30
2,1127,24734,3578739048,3578739079,31
2,1127,24735,3578739048,3578739081,33
2,1127,24736,3578739048,3578739081,33
2,1127,24737,3578739048,3578739083,35
2,1127,24738,3578739048,3578739084,36
2,1127,24739,3578739048,3578739086,38
2,1127,24740,3578739048,3578739087,39
2,1127,24741,3578739048,3578739087,39
2,1127,24742,3578739048,3578739088,40
2,1127,24743,3578739048,3578739088,40
2,1127,24744,3578739048,3578739088,40
2,1127,24745,3578739048,3578739088,40
2,1127,24746,3578739048,3578739088,40
2,1127,24747,3578739048,3578739088,40
2,1127,24748,3578739048,3578739089,41
2,1127,24749,3578739048,3578739089,41
2,1127,24750,3578739048,3578739090,42
2,1127,24751,3578739048,3578739093,45
2,1127,24752,3578739048,3578739093,45
2,1127,24753,3578739048,3578739094,46
2,1127,24754,3578739048,3578739094,46
2,1127,24755,3578739048,3578739094,46
2,1127,24756,3578739048,3578739095,47
2,1127,24757,3578739048,3578739096,48
2,1127,24758,3578739048,3578739096,48
2,1127,24759,3578739048,3578739096,48
2,1127,24760,3578739048,3578739097,49
2,1127,24761,3578739048,3578739097,49
2,1127,24762,3578739048,3578739098,50
2,1128,24763,3578739114,3578739114,0
2,1128,24764,3578739114,3578739114,0
2,1128,24765,3578739114,3578739114,0
2,1128,24766,3578739114,3578739114,0
2,1128,24767,3578739114,3578739114,0
2,1128,24768,3578739114,3578739114,0
2,1128,24769,3578739114,3578739114,0
2,1128,24770,3578739114,3578739114,0
2,1128,24771,3578739114,3578739114,0
2,1128,24772,3578739114,3578739114,0
2,1128,24773,3578739114,3578739114,0
2,1128,24774,3578739114,3578739114,0
2,1128,24775,3578739114,3578739114,0
2,1128,24776,3578739114,3578739114,0
2,1128,24777,3578739114,3578739114,0
2,1128,24778,3578739114,3578739114,0
2,1128,24779,3578739114,3578739114,0
2,1128,24780,3578739114,3578739115,1
2,1128,24781,3578739114,3578739116,2
2,1128,24782,3578739114,3578739116,2
2,1128,24783,3578739114,3578739118,4
2,1128,24784,3578739114,3578739118,4
2,1128,24785,3578739114,3578739119,5
2,1128,24786,3578739114,3578739119,5
2,1128,24787,3578739114,3578739120,6
2,1128,24788,3578739114,3578739120,6
2,1128,24789,3578739114,3578739122,8
2,1128,24790,3578739114,3578739122,8
2,1128,24791,3578739114,3578739123,9
2,1128,24792,3578739114,3578739123,9
2,1128,24793,3578739114,3578739123,9
2,1128,24794,3578739114,3578739124,10
2,1128,24795,3578739114,3578739124,10
2,1128,24796,3578739114,3578739125,11
2,1128,24797,3578739114,3578739125,11
2,1128,24798,3578739114,3578739126,12
2,1128,24799,3578739114,3578739128,14
2,1128,24800,3578739114,3578739129,15
2,1128,24801,3578739114,3578739130,16
2,1128,24802,3578739114,3578739130,16
2,1128,24803,3578739114,3578739132,18
2,1128,24804,3578739114,3578739133,19
2,1128,24805,3578739114,3578739133,19
2,1128,24806,3578739114,3578739135,21
2,1128,24807,3578739114,3578739135,21
2,1128,24808,3578739114,3578739136,22
2,1128,24809,3578739114,3578739137,23
2,1128,24810,3578739114,3578739137,23
2,1128,24811,3578739114,3578739138,24
2,1128,24812,3578739114,3578739139,25
2,1128,24813,3578739114,3578739139,25
2,1128,24814,3578739114,3578739140,26
2,1128,24815,3578739114,3578739141,27
2,1128,24816,3578739114,3578739141,27
2,1128,24817,3578739114,3578739141,27
2,1128,24818,3578739114,3578739143,29
2,1128,24819,3578739114,3578739145,31
2,1128,24820,3578739114,3578739147,33
2,1128,24821,3578739114,3578739148,34
2,1128,24822,3578739114,3578739148,34
2,1128,24823,3578739114,3578739152,38
2,1128,24824,3578739114,3578739152,38
2,1128,24825,3578739114,3578739153,39
2,1128,24826,3578739114,3578739156,42
2,1128,24827,3578739114,3578739157,43
2,1128,24828,3578739114,3578739159,45
2,1128,24829,3578739114,3578739162,48
2,1128,24830,3578739114,3578739162,48
2,1128,24831,3578739114,3578739163,49
2,1128,24832,3578739114,3578739163,49
2,1128,24833,3578739114,3578739163,49
2,1128,24834,3578739114,3578739163,49
2,1128,24835,3578739114,3578739164,50
2,1129,24836,3578739178,3578739178,0
2,1129,24837,3578739178,3578739178,0
2,1129,24838,3578739178,3578739178,0
2,1129,24839,3578739178,3578739178,0
2,1129,24840,3578739178,3578739178,0
2,1129,24841,3578739178,3578739178,0
2,1129,24842,3578739178,3578739178,0
2,1129,24843,3578739178,3578739178,0
2,1129,24844,3578739178,3578739178,0
2,1129,24845,3578739178,3578739178,0
2,1129,24846,3578739178,3578739178,0
2,1129,24847,3578739178,3578739180,2
2,1129,24848,3578739178,3578739180,2
2,1129,24849,3578739178,3578739180,2
2,1129,24850,3578739178,3578739181,3
2,1129,24851,3578739178,3578739184,6
2,1129,24852,3578739178,3578739185,7
2,1129,24853,3578739178,3578739185,7
2,1129,24854,3578739178,3578739186,8
2,1129,24855,3578739178,3578739188,10
2,1129,24856,3578739178,3578739189,11
2,1129,24857,3578739178,3578739190,12
2,1129,24858,3578739178,3578739190,12
2,1129,24859,3578739178,3578739194,16
2,1129,24860,3578739178,3578739194,16
2,1129,24861,3578739178,3578739195,17
2,1129,24862,3578739178,3578739196,18
2,1129,24863,3578739178,3578739196,18
2,1129,24864,3578739178,3578739196,18
2,1129,24865,3578739178,3578739199,21
2,1129,24866,3578739178,3578739200,22
2,1129,24867,3578739178,3578739201,23
2,1129,24868,3578739178,3578739204,26
2,1129,24869,3578739178,3578739204,26
2,1129,24870,3578739178,3578739204,26
2,1129,24871,3578739178,3578739205,27
2,1129,24872,3578739178,3578739206,28
2,1129,24873,3578739178,3578739209,31
2,1129,24874,3578739178,3578739213,35
2,1129,24875,3578739178,3578739213,35
2,1129,24876,3578739178,3578739213,35
2,1129,24877,3578739178,3578739214,36
2,1129,24878,3578739178,3578739214,36
2,1129,24879,3578739178,3578739216,38
2,1129,24880,3578739178,3578739217,39
2,1129,24881,3578739178,3578739219,41
2,1129,24882,3578739178,3578739221,43
2,1129,24883,3578739178,3578739221,43
2,1129,24884,3578739178,3578739224,46
2,1129,24885,3578739178,3578739226,48
2,1129,24886,3578739178,3578739228,50
2,1130,24887,3578739238,3578739238,0
2,1130,24888,3578739238,3578739238,0
2,1130,24889,3578739238,3578739238,0
2,1130,24890,3578739238,3578739238,0
2,1130,24891,3578739238,3578739238,0
2,1130,24892,3578739238,3578739238,0
2,1130,24893,3578739238,3578739238,0
2,1130,24894,3578739238,3578739238,0
2,1130,24895,3578739238,3578739238,0
2,1130,24896,3578739238,3578739238,0
2,1130,24897,3578739238,3578739238,0
2,1130,24898,3578739238,3578739238,0
2,1130,24899,3578739238,3578739239,1
2,1130,24900,3578739238,3578739239,1
2,1130,24901,3578739238,3578739239,1
2,1130,24902,3578739238,3578739239,1
2,1130,24903,3578739238,3578739241,3
2,1130,24904,3578739238,3578739241,3
2,1130,24905,3578739238,3578739242,4
2,1130,24906,3578739238,3578739242,4
2,1130,24907,3578739238,3578739242,4
2,1130,24908,3578739238,3578739244,6
2,1130,24909,3578739238,3578739244,6
2,1130,24910,3578739238,3578739246,8
2,1130,24911,3578739238,3578739249,11
2,1130,24912,3578739238,3578739249,11
2,1130,24913,3578739238,3578739250,12
2,1130,24914,3578739238,3578739252,14
2,1130,24915,3578739238,3578739253,15
2,1130,24916,3578739238,3578739253,15
2,1130,24917,3578739238,3578739253,15
2,1130,24918,3578739238,3578739254,16
2,1130,24919,3578739238,3578739255,17
2,1130,24920,3578739238,3578739255,17
2,1130,24921,3578739238,3578739256,18
2,1130,24922,3578739238,3578739258,20
2,1130,24923,3578739238,3578739259,21
2,1130,24924,3578739238,3578739259,21
2,1130,24925,3578739238,3578739260,22
2,1130,24926,3578739238,3578739260,22
2,1130,24927,3578739238,3578739260,22
2,1130,24928,3578739238,3578739260,22
2,1130,24929,3578739238,3578739261,23
2,1130,24930,3578739238,3578739265,27
2,1130,24931,3578739238,3578739266,28
2,1130,24932,3578739238,3578739267,29
2,1130,24933,3578739238,3578739268,30
2,1130,24934,3578739238,3578739268,30
2,1130,24935,3578739238,3578739269,31
2,1130,24936,3578739238,3578739276,38
2,1130,24937,3578739238,3578739278,40
2,1130,24938,3578739238,3578739279,41
2,1130,24939,3578739238,3578739280,42
2,1130,24940,3578739238,3578739281,43
2,1130,24941,3578739238,3578739281,43
2,1130,24942,3578739238,3578739283,45
2,1130,24943,3578739238,3578739284,46
2,1130,24944,3578739238,3578739284,46
2,1130,24945,3578739238,3578739286,48
2,1130,24946,3578739238,3578739286,48
2,1130,24947,3578739238,3578739287,49
2,1130,24948,3578739238,3578739288,50
2,1131,24949,3578739298,3578739298,0
2,1131,24950,3578739298,3578739298,0
2,1131,24951,3578739298,3578739298,0
2,1131,24952,3578739298,3578739298,0
2,1131,24953,3578739298,3578739298,0
2,1131,24954,3578739298,3578739298,0
2,1131,24955,3578739298,3578739298,0
2,1131,24956,3578739298,3578739298,0
2,1131,24957,3578739298,3578739298,0
2,1131,24958,3578739298,3578739298,0
2,1131,24959,3578739298,3578739298,0
2,1131,24960,3578739298,3578739298,0
2,1131,24961,3578739298,3578739298,0
2,1131,24962,3578739298,3578739298,0
2,1131,24963,3578739298,3578739298,0
2,1131,24964,3578739298,3578739298,0
2,1131,24965,3578739298,3578739298,0
2,1131,24966,3578739298,3578739298,0
2,1131,24967,3578739298,3578739299,1
2,1131,24968,3578739298,3578739299,1
2,1131,24969,3578739298,3578739300,2
2,1131,24970,3578739298,3578739303,5
2,1131,24971,3578739298,3578739304,6
2,1131,24972,3578739298,3578739306,8
2,1131,24973,3578739298,3578739307,9
2,1131,24974,3578739298,3578739309,11
2,1131,24975,3578739298,3578739310,12
2,1131,24976,3578739298,3578739311,13
2,1131,24977,3578739298,3578739312,14
2,1131,24978,3578739298,3578739312,14
2,1131,24979,3578739298,3578739313,15
2,1131,24980,3578739298,3578739315,17
2,1131,24981,3578739298,3578739317,19
2,1131,24982,3578739298,3578739317,19
2,1131,24983,3578739298,3578739318,20
2,1131,24984,3578739298,3578739318,20
2,1131,24985,3578739298,3578739319,21
2,1131,24986,3578739298,3578739319,21
2,1131,24987,3578739298,3578739321,23
2,1131,24988,3578739298,3578739321,23
2,1131,24989,3578739298,3578739322,24
2,1131,24990,3578739298,3578739322,24
2,1131,24991,3578739298,3578739322,24
2,1131,24992,3578739298,3578739322,24
2,1131,24993,3578739298,3578739323,25
2,1131,24994,3578739298,3578739323,25
2,1131,24995,3578739298,3578739324,26
2,1131,24996,3578739298,3578739325,27
2,1131,24997,3578739298,3578739326,28
2,1131,24998,3578739298,3578739326,28
2,1131,24999,3578739298,3578739328,30
2,1131,25000,3578739298,3578739329,31
2,1131,25001,3578739298,3578739329,31
2,1131,25002,3578739298,3578739330,32
2,1131,25003,3578739298,3578739330,32
2,1131,25004,3578739298,3578739333,35
2,1131,25005,3578739298,3578739333,35
2,1131,25006,3578739298,3578739333,35
2,1131,25007,3578739298,3578739334,36
2,1131,25008,3578739298,3578739334,36
2,1131,25009,3578739298,3578739335,37
2,1131,25010,3578739298,3578739336,38
2,1131,25011,3578739298,3578739337,39
2,1131,25012,3578739298,3578739337,39
2,1131,25013,3578739298,3578739337,39
2,1131,25014,3578739298,3578739338,40
2,1131,25015,3578739298,3578739339,41
2,1131,25016,3578739298,3578739341,43
2,1131,25017,3578739298,3578739341,43
2,1131,25018,3578739298,3578739341,43
2,1131,25019,3578739298,3578739342,44
2,1131,25020,3578739298,3578739343,45
2,1131,25021,3578739298,3578739345,47
2,1131,25022,3578739298,3578739347,49
2,1131,25023,3578739298,3578739348,50
2,1132,25024,3578739360,3578739360,0
2,1132,25025,3578739360,3578739360,0
2,1132,25026,3578739360,3578739360,0
2,1132,25027,3578739360,3578739360,0
2,1132,25028,3578739360,3578739360,0
2,1132,25029,3578739360,3578739360,0
2,1132,25030,3578739360,3578739360,0
2,1132,25031,3578739360,3578739360,0
2,1132,25032,3578739360,3578739361,1
2,1132,25033,3578739360,3578739363,3
2,1132,25034,3578739360,3578739364,4
2,1132,25035,3578739360,3578739364,4
2,1132,25036,3578739360,3578739364,4
2,1132,25037,3578739360,3578739365,5
2,1132,25038,3578739360,3578739367,7
2,1132,25039,3578739360,3578739367,7
2,1132,25040,3578739360,3578739368,8
2,1132,25041,3578739360,3578739369,9
2,1132,25042,3578739360,3578739370,10
2,1132,25043,3578739360,3578739373,13
2,1132,25044,3578739360,3578739373,13
2,1132,25045,3578739360,3578739374,14
2,1132,25046,3578739360,3578739376,16
2,1132,25047,3578739360,3578739376,16
2,1132,25048,3578739360,3578739377,17
2,1132,25049,3578739360,3578739380,20
2,1132,25050,3578739360,3578739380,20
2,1132,25051,3578739360,3578739380,20
2,1132,25052,3578739360,3578739380,20
2,1132,25053,3578739360,3578739382,22
2,1132,25054,3578739360,3578739385,25
2,1132,25055,3578739360,3578739385,25
2,1132,25056,3578739360,3578739385,25
2,1132,25057,3578739360,3578739386,26
2,1132,25058,3578739360,3578739386,26
2,1132,25059,3578739360,3578739389,29
2,1132,25060,3578739360,3578739389,29
2,1132,25061,3578739360,3578739390,30
2,1132,25062,3578739360,3578739391,31
2,1132,25063,3578739360,3578739392,32
2,1132,25064,3578739360,3578739394,34
2,1132,25065,3578739360,3578739394,34
2,1132,25066,3578739360,3578739395,35
2,1132,25067,3578739360,3578739396,36
2,1132,25068,3578739360,3578739396,36
2,1132,25069,3578739360,3578739396,36
2,1132,25070,3578739360,3578739396,36
2,1132,25071,3578739360,3578739399,39
2,1132,25072,3578739360,3578739399,39
2,1132,25073,3578739360,3578739400,40
2,1132,25074,3578739360,3578739401,41
2,1132,25075,3578739360,3578739403,43
2,1132,25076,3578739360,3578739404,44
2,1132,25077,3578739360,3578739404,44
2,1132,25078,3578739360,3578739406,46
2,1132,25079,3578739360,3578739406,46
2,1132,25080,3578739360,3578739409,49
2,1133,25081,3578739427,3578739427,0
2,1133,25082,3578739427,3578739427,0
2,1133,25083,3578739427,3578739427,0
2,1133,25084,3578739427,3578739427,0
2,1133,25085,3578739427,3578739427,0
2,1133,25086,3578739427,3578739427,0
2,1133,25087,3578739427,3578739427,0
2,1133,25088,3578739427,3578739427,0
2,1133,25089,3578739427,3578739427,0
2,1133,25090,3578739427,3578739427,0
2,1133,25091,3578739427,3578739427,0
2,1133,25092,3578739427,3578739428,1
2,1133,25093,3578739427,3578739429,2
2,1133,25094,3578739427,3578739429,2
2,1133,25095,3578739427,3578739429,2
2,1133,25096,3578739427,3578739429,2
2,1133,25097,3578739427,3578739431,4
2,1133,25098,3578739427,3578739431,4
2,1133,25099,3578739427,3578739432,5
2,1133,25100,3578739427,3578739433,6
2,1133,25101,3578739427,3578739433,6
2,1133,25102,3578739427,3578739433,6
2,1133,25103,3578739427,3578739435,8
2,1133,25104,3578739427,3578739437,10
2,1133,25105,3578739427,3578739438,11
2,1133,25106,3578739427,3578739439,12
2,1133,25107,3578739427,3578739439,12
2,1133,25108,3578739427,3578739439,12
2,1133,25109,3578739427,3578739441,14
2,1133,25110,3578739427,3578739442,15
2,1133,25111,3578739427,3578739442,15
2,1133,25112,3578739427,3578739444,17
2,1133,25113,3578739427,3578739445,18
2,1133,25114,3578739427,3578739446,19
2,1133,25115,3578739427,3578739446,19
2,1133,25116,3578739427,3578739449,22
2,1133,25117,3578739427,3578739449,22
2,1133,25118,3578739427,3578739450,23
2,1133,25119,3578739427,3578739451,24
2,1133,25120,3578739427,3578739452,25
2,1133,25121,3578739427,3578739452,25
2,1133,25122,3578739427,3578739452,25
2,1133,25123,3578739427,3578739453,26
2,1133,25124,3578739427,3578739453,26
2,1133,25125,3578739427,3578739454,27
2,1133,25126,3578739427,3578739454,27
2,1133,25127,3578739427,3578739454,27
2,1133,25128,3578739427,3578739456,29
2,1133,25129,3578739427,3578739458,31
2,1133,25130,3578739427,3578739459,32
2,1133,25131,3578739427,3578739459,32
2,1133,25132,3578739427,3578739459,32
2,1133,25133,3578739427,3578739460,33
2,1133,25134,3578739427,3578739460,33
2,1133,25135,3578739427,3578739460,33
2,1133,25136,3578739427,3578739462,35
2,1133,25137,3578739427,3578739465,38
2,1133,25138,3578739427,3578739467,40
2,1133,25139,3578739427,3578739467,40
2,1133,25140,3578739427,3578739468,41
2,1133,25141,3578739427,3578739469,42
2,1133,25142,3578739427,3578739469,42
2,1133,25143,3578739427,3578739470,43
2,1133,25144,3578739427,3578739477,50
2,1134,25145,3578739490,3578739490,0
2,1134,25146,3578739490,3578739490,0
2,1134,25147,3578739490,3578739490,0
2,1134,25148,3578739490,3578739490,0
2,1134,25149,3578739490,3578739490,0
2,1134,25150,3578739490,3578739490,0
2,1134,25151,3578739490,3578739490,0
2,1134,25152,3578739490,3578739490,0
2,1134,25153,3578739490,3578739490,0
2,1134,25154,3578739490,3578739490,0
2,1134,25155,3578739490,3578739490,0
2,1134,25156,3578739490,3578739490,0
2,1134,25157,3578739490,3578739490,0
2,1134,25158,3578739490,3578739490,0
2,1134,25159,3578739490,3578739490,0
2,1134,25160,3578739490,3578739491,1
2,1134,25161,3578739490,3578739492,2
2,1134,25162,3578739490,3578739492,2
2,1134,25163,3578739490,3578739493,3
2,1134,25164,3578739490,3578739493,3
2,1134,25165,3578739490,3578739493,3
2,1134,25166,3578739490,3578739494,4
2,1134,25167,3578739490,3578739494,4
2,1134,25168,3578739490,3578739495,5
2,1134,25169,3578739490,3578739496,6
2,1134,25170,3578739490,3578739497,7
2,1134,25171,3578739490,3578739497,7
2,1134,25172,3578739490,3578739498,8
2,1134,25173,3578739490,3578739498,8
2,1134,25174,3578739490,3578739499,9
2,1134,25175,3578739490,3578739499,9
2,1134,25176,3578739490,3578739499,9
2,1134,25177,3578739490,3578739502,12
2,1134,25178,3578739490,3578739503,13
2,1134,25179,3578739490,3578739506,16
2,1134,25180,3578739490,3578739506,16
2,1134,25181,3578739490,3578739506,16
2,1134,25182,3578739490,3578739508,18
2,1134,25183,3578739490,3578739508,18
2,1134,25184,3578739490,3578739509,19
2,1134,25185,3578739490,3578739510,20
2,1134,25186,3578739490,3578739510,20
2,1134,25187,3578739490,3578739511,21
2,1134,25188,3578739490,3578739513,23
2,1134,25189,3578739490,3578739513,23
2,1134,25190,3578739490,3578739514,24
2,1134,25191,3578739490,3578739515,25
2,1134,25192,3578739490,3578739515,25
2,1134,25193,3578739490,3578739517,27
2,1134,25194,3578739490,3578739518,28
2,1134,25195,3578739490,3578739518,28
2,1134,25196,3578739490,3578739518,28
2,1134,25197,3578739490,3578739519,29
2,1134,25198,3578739490,3578739521,31
2,1134,25199,3578739490,3578739521,31
2,1134,25200,3578739490,3578739521,31
2,1134,25201,3578739490,3578739522,32
2,1134,25202,3578739490,3578739522,32
2,1134,25203,3578739490,3578739522,32
2,1134,25204,3578739490,3578739522,32
2,1134,25205,3578739490,3578739523,33
2,1134,25206,3578739490,3578739524,34
2,1134,25207,3578739490,3578739525,35
2,1134,25208,3578739490,3578739525,35
2,1134,25209,3578739490,3578739526,36
2,1134,25210,3578739490,3578739528,38
2,1134,25211,3578739490,3578739528,38
2,1134,25212,3578739490,3578739529,39
2,1134,25213,3578739490,3578739530,40
2,1134,25214,3578739490,3578739532,42
2,1134,25215,3578739490,3578739532,42
2,1134,25216,3578739490,3578739533,43
2,1134,25217,3578739490,3578739534,44
2,1134,25218,3578739490,3578739534,44
2,1134,25219,3578739490,3578739536,46
2,1134,25220,3578739490,3578739537,47
2,1134,25221,3578739490,3578739537,47
2,1134,25222,3578739490,3578739538,48
2,1134,25223,3578739490,3578739538,48
2,1134,25224,3578739490,3578739538,48
2,1134,25225,3578739490,3578739540,50
2,1135,25226,3578739551,3578739551,0
2,1135,25227,3578739551,3578739551,0
2,1135,25228,3578739551,3578739551,0
2,1135,25229,3578739551,3578739551,0
2,1135,25230,3578739551,3578739551,0
2,1135,25231,3578739551,3578739551,0
2,1135,25232,3578739551,3578739551,0
2,1135,25233,3578739551,3578739551,0
2,1135,25234,3578739551,3578739551,0
2,1135,25235,3578739551,3578739551,0
2,1135,25236,3578739551,3578739553,2
2,1135,25237,3578739551,3578739553,2
2,1135,25238,3578739551,3578739553,2
2,1135,25239,3578739551,3578739555,4
2,1135,25240,3578739551,3578739555,4
2,1135,25241,3578739551,3578739558,7
2,1135,25242,3578739551,3578739560,9
2,1135,25243,3578739551,3578739561,10
2,1135,25244,3578739551,3578739563,12
2,1135,25245,3578739551,3578739563,12
2,1135,25246,3578739551,3578739564,13
2,1135,25247,3578739551,3578739564,13
2,1135,25248,3578739551,3578739564,13
2,1135,25249,3578739551,3578739565,14
2,1135,25250,3578739551,3578739567,16
2,1135,25251,3578739551,3578739567,16
2,1135,25252,3578739551,3578739567,16
2,1135,25253,3578739551,3578739568,17
2,1135,25254,3578739551,3578739569,18
2,1135,25255,3578739551,3578739572,21
2,1135,25256,3578739551,3578739573,22
2,1135,25257,3578739551,3578739573,22
2,1135,25258,3578739551,3578739575,24
2,1135,25259,3578739551,3578739575,24
2,1135,25260,3578739551,3578739577,26
2,1135,25261,3578739551,3578739579,28
2,1135,25262,3578739551,3578739579,28
2,1135,25263,3578739551,3578739579,28
2,1135,25264,3578739551,3578739579,28
2,1135,25265,3578739551,3578739580,29
2,1135,25266,3578739551,3578739583,32
2,1135,25267,3578739551,3578739584,33
2,1135,25268,3578739551,3578739585,34
2,1135,25269,3578739551,3578739585,34
2,1135,25270,3578739551,3578739587,36
2,1135,25271,3578739551,3578739589,38
2,1135,25272,3578739551,3578739589,38
2,1135,25273,3578739551,3578739589,38
2,1135,25274,3578739551,3578739591,40
2,1135,25275,3578739551,3578739591,40
2,1135,25276,3578739551,3578739593,42
2,1135,25277,3578739551,3578739594,43
2,1135,25278,3578739551,3578739594,43
2,1135,25279,3578739551,3578739595,44
2,1135,25280,3578739551,3578739595,44
2,1135,25281,3578739551,3578739596,45
2,1135,25282,3578739551,3578739597,46
2,1135,25283,3578739551,3578739599,48
2,1135,25284,3578739551,3578739599,48
2,1136,25285,3578739613,3578739613,0
2,1136,25286,3578739613,3578739613,0
2,1136,25287,3578739613,3578739613,0
2,1136,25288,3578739613,3578739613,0
2,1136,25289,3578739613,3578739613,0
2,1136,25290,3578739613,3578739613,0
2,1136,25291,3578739613,3578739614,1
2,1136,25292,3578739613,3578739614,1
2,1136,25293,3578739613,3578739615,2
2,1136,25294,3578739613,3578739615,2
2,1136,25295,3578739613,3578739619,6
2,1136,25296,3578739613,3578739620,7
2,1136,25297,3578739613,3578739621,8
2,1136,25298,3578739613,3578739621,8
2,1136,25299,3578739613,3578739624,11
2,1136,25300,3578739613,3578739625,12
2,1136,25301,3578739613,3578739626,13
2,1136,25302,3578739613,3578739626,13
2,1136,25303,3578739613,3578739626,13
2,1136,25304,3578739613,3578739628,15
2,1136,25305,3578739613,3578739628,15
2,1136,25306,3578739613,3578739628,15
2,1136,25307,3578739613,3578739629,16
2,1136,25308,3578739613,3578739629,16
2,1136,25309,3578739613,3578739630,17
2,1136,25310,3578739613,3578739631,18
2,1136,25311,3578739613,3578739631,18
2,1136,25312,3578739613,3578739632,19
2,1136,25313,3578739613,3578739632,19
2,1136,25314,3578739613,3578739634,21
2,1136,25315,3578739613,3578739636,23
2,1136,25316,3578739613,3578739637,24
2,1136,25317,3578739613,3578739638,25
2,1136,25318,3578739613,3578739638,25
2,1136,25319,3578739613,3578739640,27
2,1136,25320,3578739613,3578739640,27
2,1136,25321,3578739613,3578739641,28
2,1136,25322,3578739613,3578739641,28
2,1136,25323,3578739613,3578739641,28
2,1136,25324,3578739613,3578739641,28
2,1136,25325,3578739613,3578739643,30
2,1136,25326,3578739613,3578739645,32
2,1136,25327,3578739613,3578739646,33
2,1136,25328,3578739613,3578739646,33
2,1136,25329,3578739613,3578739647,34
2,1136,25330,3578739613,3578739648,35
2,1136,25331,3578739613,3578739648,35
2,1136,25332,3578739613,3578739650,37
2,1136,25333,3578739613,3578739651,38
2,1136,25334,3578739613,3578739651,38
2,1136,25335,3578739613,3578739652,39
2,1136,25336,3578739613,3578739652,39
2,1136,25337,3578739613,3578739653,40
2,1136,25338,3578739613,3578739653,40
2,1136,25339,3578739613,3578739654,41
2,1136,25340,3578739613,3578739655,42
2,1136,25341,3578739613,3578739658,45
2,1136,25342,3578739613,3578739658,45
2,1136,25343,3578739613,3578739658,45
2,1136,25344,3578739613,3578739658,45
2,1136,25345,3578739613,3578739659,46
2,1136,25346,3578739613,3578739659,46
2,1136,25347,3578739613,3578739659,46
2,1136,25348,3578739613,3578739660,47
2,1136,25349,3578739613,3578739661,48
2,1137,25350,3578739674,3578739675,1
2,1137,25351,3578739674,3578739675,1
2,1137,25352,3578739674,3578739675,1
2,1137,25353,3578739674,3578739675,1
2,1137,25354,3578739674,3578739675,1
2,1137,25355,3578739674,3578739675,1
2,1137,25356,3578739674,3578739675,1
2,1137,25357,3578739674,3578739675,1
2,1137,25358,3578739674,3578739675,1
2,1137,25359,3578739674,3578739676,2
2,1137,25360,3578739674,3578739678,4
2,1137,25361,3578739674,3578739680,6
2,1137,25362,3578739674,3578739680,6
2,1137,25363,3578739674,3578739681,7
2,1137,25364,3578739674,3578739683,9
2,1137,25365,3578739674,3578739683,9
2,1137,25366,3578739674,3578739685,11
2,1137,25367,3578739674,3578739686,12
2,1137,25368,3578739674,3578739686,12
2,1137,25369,3578739674,3578739686,12
2,1137,25370,3578739674,3578739687,13
2,1137,25371,3578739674,3578739687,13
2,1137,25372,3578739674,3578739687,13
2,1137,25373,3578739674,3578739688,14
2,1137,25374,3578739674,3578739688,14
2,1137,25375,3578739674,3578739690,16
2,1137,25376,3578739674,3578739692,18
2,1137,25377,3578739674,3578739693,19
2,1137,25378,3578739674,3578739693,19
2,1137,25379,3578739674,3578739693,19
2,1137,25380,3578739674,3578739693,19
2,1137,25381,3578739674,3578739694,20
2,1137,25382,3578739674,3578739694,20
2,1137,25383,3578739674,3578739694,20
2,1137,25384,3578739674,3578739696,22
2,1137,25385,3578739674,3578739696,22
2,1137,25386,3578739674,3578739696,22
2,1137,25387,3578739674,3578739697,23
2,1137,25388,3578739674,3578739698,24
2,1137,25389,3578739674,3578739698,24
2,1137,25390,3578739674,3578739698,24
2,1137,25391,3578739674,3578739698,24
2,1137,25392,3578739674,3578739700,26
2,1137,25393,3578739674,3578739703,29
2,1137,25394,3578739674,3578739703,29
2,1137,25395,3578739674,3578739705,31
2,1137,25396,3578739674,3578739705,31
2,1137,25397,3578739674,3578739707,33
2,1137,25398,3578739674,3578739709,35
2,1137,25399,3578739674,3578739709,35
2,1137,25400,3578739674,3578739710,36
2,1137,25401,3578739674,3578739710,36
2,1137,25402,3578739674,3578739711,37
2,1137,25403,3578739674,3578739711,37
2,1137,25404,3578739674,3578739711,37
2,1137,25405,3578739674,3578739713,39
2,1137,25406,3578739674,3578739714,40
2,1137,25407,3578739674,3578739714,40
2,1137,25408,3578739674,3578739715,41
2,1137,25409,3578739674,3578739716,42
2,1137,25410,3578739674,3578739717,43
2,1137,25411,3578739674,3578739717,43
2,1137,25412,3578739674,3578739718,44
2,1137,25413,3578739674,3578739718,44
2,1137,25414,3578739674,3578739719,45
2,1137,25415,3578739674,3578739720,46
2,1137,25416,3578739674,3578739721,47
2,1137,25417,3578739674,3578739721,47
2,1137,25418,3578739674,3578739722,48
2,1137,25419,3578739674,3578739722,48
2,1137,25420,3578739674,3578739722,48
2,1137,25421,3578739674,3578739722,48
2,1137,25422,3578739674,3578739722,48
2,1137,25423,3578739674,3578739723,49
2,1138,25424,3578739737,3578739737,0
2,1138,25425,3578739737,3578739737,0
2,1138,25426,3578739737,3578739737,0
2,1138,25427,3578739737,3578739737,0
2,1138,25428,3578739737,3578739737,0
2,1138,25429,3578739737,3578739737,0
2,1138,25430,3578739737,3578739737,0
2,1138,25431,3578739737,3578739737,0
2,1138,25432,3578739737,3578739737,0
2,1138,25433,3578739737,3578739737,0
2,1138,25434,3578739737,3578739737,0
2,1138,25435,3578739737,3578739737,0
2,1138,25436,3578739737,3578739737,0
2,1138,25437,3578739737,3578739737,0
2,1138,25438,3578739737,3578739737,0
2,1138,25439,3578739737,3578739737,0
2,1138,25440,3578739737,3578739738,1
2,1138,25441,3578739737,3578739738,1
2,1138,25442,3578739737,3578739739,2
2,1138,25443,3578739737,3578739740,3
2,1138,25444,3578739737,3578739740,3
2,1138,25445,3578739737,3578739740,3
2,1138,25446,3578739737,3578739741,4
2,1138,25447,3578739737,3578739742,5
2,1138,25448,3578739737,3578739742,5
2,1138,25449,3578739737,3578739743,6
2,1138,25450,3578739737,3578739744,7
2,1138,25451,3578739737,3578739746,9
2,1138,25452,3578739737,3578739747,10
2,1138,25453,3578739737,3578739748,11
2,1138,25454,3578739737,3578739749,12
2,1138,25455,3578739737,3578739750,13
2,1138,25456,3578739737,3578739753,16
2,1138,25457,3578739737,3578739753,16
2,1138,25458,3578739737,3578739754,17
2,1138,25459,3578739737,3578739754,17
2,1138,25460,3578739737,3578739755,18
2,1138,25461,3578739737,3578739756,19
2,1138,25462,3578739737,3578739758,21
2,1138,25463,3578739737,3578739759,22
2,1138,25464,3578739737,3578739761,24
2,1138,25465,3578739737,3578739761,24
2,1138,25466,3578739737,3578739763,26
2,1138,25467,3578739737,3578739763,26
2,1138,25468,3578739737,3578739763,26
2,1138,25469,3578739737,3578739764,27
2,1138,25470,3578739737,3578739764,27
2,1138,25471,3578739737,3578739767,30
2,1138,25472,3578739737,3578739767,30
2,1138,25473,3578739737,3578739767,30
2,1138,25474,3578739737,3578739768,31
2,1138,25475,3578739737,3578739768,31
2,1138,25476,3578739737,3578739772,35
2,1138,25477,3578739737,3578739773,36
2,1138,25478,3578739737,3578739775,38
2,1138,25479,3578739737,3578739775,38
2,1138,25480,3578739737,3578739775,38
2,1138,25481,3578739737,3578739778,41
2,1138,25482,3578739737,3578739779,42
2,1138,25483,3578739737,3578739779,42
2,1138,25484,3578739737,3578739780,43
2,1138,25485,3578739737,3578739780,43
2,1138,25486,3578739737,3578739781,44
2,1138,25487,3578739737,3578739785,48
2,1138,25488,3578739737,3578739785,48
2,1138,25489,3578739737,3578739785,48
2,1138,25490,3578739737,3578739785,48
2,1139,25491,3578739799,3578739799,0
2,1139,25492,3578739799,3578739799,0
2,1139,25493,3578739799,3578739799,0
2,1139,25494,3578739799,3578739799,0
2,1139,25495,3578739799,3578739799,0
2,1139,25496,3578739799,3578739799,0
2,1139,25497,3578739799,3578739799,0
2,1139,25498,3578739799,3578739799,0
2,1139,25499,3578739799,3578739799,0
2,1139,25500,3578739799,3578739799,0
2,1139,25501,3578739799,3578739799,0
2,1139,25502,3578739799,3578739799,0
2,1139,25503,3578739799,3578739799,0
2,1139,25504,3578739799,3578739799,0
2,1139,25505,3578739799,3578739799,0
2,1139,25506,3578739799,3578739802,3
2,1139,25507,3578739799,3578739803,4
2,1139,25508,3578739799,3578739805,6
2,1139,25509,3578739799,3578739806,7
2,1139,25510,3578739799,3578739808,9
2,1139,25511,3578739799,3578739813,14
2,1139,25512,3578739799,3578739813,14
2,1139,25513,3578739799,3578739814,15
2,1139,25514,3578739799,3578739815,16
2,1139,25515,3578739799,3578739816,17
2,1139,25516,3578739799,3578739819,20
2,1139,25517,3578739799,3578739820,21
2,1139,25518,3578739799,3578739821,22
2,1139,25519,3578739799,3578739821,22
2,1139,25520,3578739799,3578739821,22
2,1139,25521,3578739799,3578739824,25
2,1139,25522,3578739799,3578739825,26
2,1139,25523,3578739799,3578739826,27
2,1139,25524,3578739799,3578739827,28
2,1139,25525,3578739799,3578739828,29
2,1139,25526,3578739799,3578739829,30
2,1139,25527,3578739799,3578739829,30
2,1139,25528,3578739799,3578739829,30
2,1139,25529,3578739799,3578739829,30
2,1139,25530,3578739799,3578739830,31
2,1139,25531,3578739799,3578739831,32
2,1139,25532,3578739799,3578739832,33
2,1139,25533,3578739799,3578739832,33
2,1139,25534,3578739799,3578739832,33
2,1139,25535,3578739799,3578739833,34
2,1139,25536,3578739799,3578739833,34
2,1139,25537,3578739799,3578739834,35
2,1139,25538,3578739799,3578739836,37
2,1139,25539,3578739799,3578739837,38
2,1139,25540,3578739799,3578739837,38
2,1139,25541,3578739799,3578739838,39
2,1139,25542,3578739799,3578739839,40
2,1139,25543,3578739799,3578739840,41
2,1139,25544,3578739799,3578739841,42
2,1139,25545,3578739799,3578739841,42
2,1139,25546,3578739799,3578739841,42
2,1139,25547,3578739799,3578739841,42
2,1139,25548,3578739799,3578739844,45
2,1139,25549,3578739799,3578739846,47
2,1139,25550,3578739799,3578739846,47
2,1139,25551,3578739799,3578739846,47
2,1139,25552,3578739799,3578739848,49
2,1139,25553,3578739799,3578739849,50
2,1140,25554,3578739861,3578739861,0
2,1140,25555,3578739861,3578739861,0
2,1140,25556,3578739861,3578739861,0
2,1140,25557,3578739861,3578739861,0
2,1140,25558,3578739861,3578739861,0
2,1140,25559,3578739861,3578739861,0
2,1140,25560,3578739861,3578739861,0
2,1140,25561,3578739861,3578739861,0
2,1140,25562,3578739861,3578739861,0
2,1140,25563,3578739861,3578739861,0
2,1140,25564,3578739861,3578739861,0
2,1140,25565,3578739861,3578739861,0
2,1140,25566,3578739861,3578739861,0
2,1140,25567,3578739861,3578739861,0
2,1140,25568,3578739861,3578739861,0
2,1140,25569,3578739861,3578739861,0
2,1140,25570,3578739861,3578739861,0
2,1140,25571,3578739861,3578739861,0
2,1140,25572,3578739861,3578739861,0
2,1140,25573,3578739861,3578739865,4
2,1140,25574,3578739861,3578739865,4
2,1140,25575,3578739861,3578739867,6
2,1140,25576,3578739861,3578739868,7
2,1140,25577,3578739861,3578739868,7
2,1140,25578,3578739861,3578739870,9
2,1140,25579,3578739861,3578739870,9
2,1140,25580,3578739861,3578739870,9
2,1140,25581,3578739861,3578739877,16
2,1140,25582,3578739861,3578739878,17
2,1140,25583,3578739861,3578739880,19
2,1140,25584,3578739861,3578739881,20
2,1140,25585,3578739861,3578739882,21
2,1140,25586,3578739861,3578739883,22
2,1140,25587,3578739861,3578739884,23
2,1140,25588,3578739861,3578739886,25
2,1140,25589,3578739861,3578739887,26
2,1140,25590,3578739861,3578739887,26
2,1140,25591,3578739861,3578739887,26
2,1140,25592,3578739861,3578739887,26
2,1140,25593,3578739861,3578739887,26
2,1140,25594,3578739861,3578739888,27
2,1140,25595,3578739861,3578739889,28
2,1140,25596,3578739861,3578739891,30
2,1140,25597,3578739861,3578739892,31
2,1140,25598,3578739861,3578739893,32
2,1140,25599,3578739861,3578739893,32
2,1140,25600,3578739861,3578739893,32
2,1140,25601,3578739861,3578739894,33
2,1140,25602,3578739861,3578739894,33
2,1140,25603,3578739861,3578739894,33
2,1140,25604,3578739861,3578739895,34
2,1140,25605,3578739861,3578739895,34
2,1140,25606,3578739861,3578739896,35
2,1140,25607,3578739861,3578739896,35
2,1140,25608,3578739861,3578739897,36
2,1140,25609,3578739861,3578739897,36
2,1140,25610,3578739861,3578739898,37
2,1140,25611,3578739861,3578739898,37
2,1140,25612,3578739861,3578739898,37
2,1140,25613,3578739861,3578739899,38
2,1140,25614,3578739861,3578739900,39
2,1140,25615,3578739861,3578739902,41
2,1140,25616,3578739861,3578739903,42
2,1140,25617,3578739861,3578739905,44
2,1140,25618,3578739861,3578739906,45
2,1140,25619,3578739861,3578739906,45
2,1140,25620,3578739861,3578739909,48
2,1140,25621,3578739861,3578739909,48
2,1140,25622,3578739861,3578739910,49
2,1140,25623,3578739861,3578739911,50
2,1141,25624,3578739922,3578739922,0
2,1141,25625,3578739922,3578739922,0
2,1141,25626,3578739922,3578739922,0
2,1141,25627,3578739922,3578739922,0
2,1141,25628,3578739922,3578739922,0
2,1141,25629,3578739922,3578739922,0
2,1141,25630,3578739922,3578739922,0
2,1141,25631,3578739922,3578739922,0
2,1141,25632,3578739922,3578739922,0
2,1141,25633,3578739922,3578739922,0
2,1141,25634,3578739922,3578739922,0
2,1141,25635,3578739922,3578739922,0
2,1141,25636,3578739922,3578739922,0
2,1141,25637,3578739922,3578739922,0
2,1141,25638,3578739922,3578739922,0
2,1141,25639,3578739922,3578739922,0
2,1141,25640,3578739922,3578739922,0
2,1141,25641,3578739922,3578739922,0
2,1141,25642,3578739922,3578739922,0
2,1141,25643,3578739922,3578739922,0
2,1141,25644,3578739922,3578739922,0
2,1141,25645,3578739922,3578739925,3
2,1141,25646,3578739922,3578739926,4
2,1141,25647,3578739922,3578739926,4
2,1141,25648,3578739922,3578739926,4
2,1141,25649,3578739922,3578739927,5
2,1141,25650,3578739922,3578739929,7
2,1141,25651,3578739922,3578739929,7
2,1141,25652,3578739922,3578739930,8
2,1141,25653,3578739922,3578739930,8
2,1141,25654,3578739922,3578739932,10
2,1141,25655,3578739922,3578739932,10
2,1141,25656,3578739922,3578739933,11
2,1141,25657,3578739922,3578739935,13
2,1141,25658,3578739922,3578739935,13
2,1141,25659,3578739922,3578739936,14
2,1141,25660,3578739922,3578739937,15
2,1141,25661,3578739922,3578739938,16
2,1141,25662,3578739922,3578739939,17
2,1141,25663,3578739922,3578739940,18
2,1141,25664,3578739922,3578739941,19
2,1141,25665,3578739922,3578739941,19
2,1141,25666,3578739922,3578739941,19
2,1141,25667,3578739922,3578739942,20
2,1141,25668,3578739922,3578739942,20
2,1141,25669,3578739922,3578739944,22
2,1141,25670,3578739922,3578739945,23
2,1141,25671,3578739922,3578739946,24
2,1141,25672,3578739922,3578739947,25
2,1141,25673,3578739922,3578739949,27
2,1141,25674,3578739922,3578739951,29
2,1141,25675,3578739922,3578739953,31
2,1141,25676,3578739922,3578739954,32
2,1141,25677,3578739922,3578739954,32
2,1141,25678,3578739922,3578739954,32
2,1141,25679,3578739922,3578739955,33
2,1141,25680,3578739922,3578739955,33
2,1141,25681,3578739922,3578739956,34
2,1141,25682,3578739922,3578739958,36
2,1141,25683,3578739922,3578739958,36
2,1141,25684,3578739922,3578739961,39
2,1141,25685,3578739922,3578739962,40
2,1141,25686,3578739922,3578739964,42
2,1141,25687,3578739922,3578739964,42
2,1141,25688,3578739922,3578739964,42
2,1141,25689,3578739922,3578739964,42
2,1141,25690,3578739922,3578739965,43
2,1141,25691,3578739922,3578739965,43
2,1141,25692,3578739922,3578739965,43
2,1141,25693,3578739922,3578739967,45
2,1141,25694,3578739922,3578739967,45
2,1141,25695,3578739922,3578739967,45
2,1141,25696,3578739922,3578739968,46
2,1141,25697,3578739922,3578739968,46
2,1141,25698,3578739922,3578739968,46
2,1141,25699,3578739922,3578739969,47
2,1142,25700,3578739984,3578739984,0
2,1142,25701,3578739984,3578739984,0
2,1142,25702,3578739984,3578739984,0
2,1142,25703,3578739984,3578739984,0
2,1142,25704,3578739984,3578739984,0
2,1142,25705,3578739984,3578739984,0
2,1142,25706,3578739984,3578739984,0
2,1142,25707,3578739984,3578739984,0
2,1142,25708,3578739984,3578739984,0
2,1142,25709,3578739984,3578739984,0
2,1142,25710,3578739984,3578739984,0
2,1142,25711,3578739984,3578739985,1
2,1142,25712,3578739984,3578739985,1
2,1142,25713,3578739984,3578739986,2
2,1142,25714,3578739984,3578739988,4
2,1142,25715,3578739984,3578739988,4
2,1142,25716,3578739984,3578739989,5
2,1142,25717,3578739984,3578739990,6
2,1142,25718,3578739984,3578739991,7
2,1142,25719,3578739984,3578739992,8
2,1142,25720,3578739984,3578739992,8
2,1142,25721,3578739984,3578739992,8
2,1142,25722,3578739984,3578739994,10
2,1142,25723,3578739984,3578739994,10
2,1142,25724,3578739984,3578739995,11
2,1142,25725,3578739984,3578739995,11
2,1142,25726,3578739984,3578739996,12
2,1142,25727,3578739984,3578739999,15
2,1142,25728,3578739984,3578740000,16
2,1142,25729,3578739984,3578740000,16
2,1142,25730,3578739984,3578740002,18
2,1142,25731,3578739984,3578740003,19
2,1142,25732,3578739984,3578740005,21
2,1142,25733,3578739984,3578740006,22
2,1142,25734,3578739984,3578740007,23
2,1142,25735,3578739984,3578740013,29
2,1142,25736,3578739984,3578740013,29
2,1142,25737,3578739984,3578740014,30
2,1142,25738,3578739984,3578740014,30
2,1142,25739,3578739984,3578740016,32
2,1142,25740,3578739984,3578740016,32
2,1142,25741,3578739984,3578740017,33
2,1142,25742,3578739984,3578740019,35
2,1142,25743,3578739984,3578740020,36
2,1142,25744,3578739984,3578740021,37
2,1142,25745,3578739984,3578740021,37
2,1142,25746,3578739984,3578740024,40
2,1142,25747,3578739984,3578740025,41
2,1142,25748,3578739984,3578740026,42
2,1142,25749,3578739984,3578740026,42
2,1142,25750,3578739984,3578740027,43
2,1142,25751,3578739984,3578740029,45
2,1142,25752,3578739984,3578740029,45
2,1142,25753,3578739984,3578740029,45
2,1142,25754,3578739984,3578740029,45
2,1142,25755,3578739984,3578740030,46
2,1142,25756,3578739984,3578740032,48
2,1142,25757,3578739984,3578740032,48
2,1142,25758,3578739984,3578740032,48
2,1142,25759,3578739984,3578740033,49
2,1143,25760,3578740048,3578740048,0
2,1143,25761,3578740048,3578740048,0
2,1143,25762,3578740048,3578740048,0
2,1143,25763,3578740048,3578740048,0
2,1143,25764,3578740048,3578740048,0
2,1143,25765,3578740048,3578740048,0
2,1143,25766,3578740048,3578740048,0
2,1143,25767,3578740048,3578740048,0
2,1143,25768,3578740048,3578740048,0
2,1143,25769,3578740048,3578740048,0
2,1143,25770,3578740048,3578740048,0
2,1143,25771,3578740048,3578740048,0
2,1143,25772,3578740048,3578740048,0
2,1143,25773,3578740048,3578740049,1
2,1143,25774,3578740048,3578740049,1
2,1143,25775,3578740048,3578740050,2
2,1143,25776,3578740048,3578740051,3
2,1143,25777,3578740048,3578740051,3
2,1143,25778,3578740048,3578740051,3
2,1143,25779,3578740048,3578740053,5
2,1143,25780,3578740048,3578740053,5
2,1143,25781,3578740048,3578740054,6
2,1143,25782,3578740048,3578740055,7
2,1143,25783,3578740048,3578740055,7
2,1143,25784,3578740048,3578740055,7
2,1143,25785,3578740048,3578740055,7
2,1143,25786,3578740048,3578740058,10
2,1143,25787,3578740048,3578740058,10
2,1143,25788,3578740048,3578740060,12
2,1143,25789,3578740048,3578740060,12
2,1143,25790,3578740048,3578740060,12
2,1143,25791,3578740048,3578740060,12
2,1143,25792,3578740048,3578740061,13
2,1143,25793,3578740048,3578740065,17
2,1143,25794,3578740048,3578740066,18
2,1143,25795,3578740048,3578740066,18
2,1143,25796,3578740048,3578740067,19
2,1143,25797,3578740048,3578740067,19
2,1143,25798,3578740048,3578740068,20
2,1143,25799,3578740048,3578740069,21
2,1143,25800,3578740048,3578740070,22
2,1143,25801,3578740048,3578740071,23
2,1143,25802,3578740048,3578740077,29
2,1143,25803,3578740048,3578740077,29
2,1143,25804,3578740048,3578740078,30
2,1143,25805,3578740048,3578740080,32
2,1143,25806,3578740048,3578740081,33
2,1143,25807,3578740048,3578740082,34
2,1143,25808,3578740048,3578740083,35
2,1143,25809,3578740048,3578740083,35
2,1143,25810,3578740048,3578740084,36
2,1143,25811,3578740048,3578740085,37
2,1143,25812,3578740048,3578740087,39
2,1143,25813,3578740048,3578740087,39
2,1143,25814,3578740048,3578740087,39
2,1143,25815,3578740048,3578740087,39
2,1143,25816,3578740048,3578740088,40
2,1143,25817,3578740048,3578740089,41
2,1143,25818,3578740048,3578740089,41
2,1143,25819,3578740048,3578740091,43
2,1143,25820,3578740048,3578740092,44
2,1143,25821,3578740048,3578740093,45
2,1143,25822,3578740048,3578740093,45
2,1143,25823,3578740048,3578740093,45
2,1143,25824,3578740048,3578740094,46
2,1143,25825,3578740048,3578740095,47
2,1143,25826,3578740048,3578740095,47
2,1143,25827,3578740048,3578740096,48
2,1143,25828,3578740048,3578740096,48
2,1143,25829,3578740048,3578740096,48
2,1143,25830,3578740048,3578740097,49
2,1143,25831,3578740048,3578740098,50
2,1144,25832,3578740111,3578740111,0
2,1144,25833,3578740111,3578740111,0
2,1144,25834,3578740111,3578740111,0
2,1144,25835,3578740111,3578740111,0
2,1144,25836,3578740111,3578740111,0
2,1144,25837,3578740111,3578740111,0
2,1144,25838,3578740111,3578740111,0
2,1144,25839,3578740111,3578740111,0
2,1144,25840,3578740111,3578740111,0
2,1144,25841,3578740111,3578740111,0
2,1144,25842,3578740111,3578740111,0
2,1144,25843,3578740111,3578740111,0
2,1144,25844,3578740111,3578740112,1
2,1144,25845,3578740111,3578740112,1
2,1144,25846,3578740111,3578740114,3
2,1144,25847,3578740111,3578740115,4
2,1144,25848,3578740111,3578740116,5
2,1144,25849,3578740111,3578740117,6
2,1144,25850,3578740111,3578740117,6
2,1144,25851,3578740111,3578740118,7
2,1144,25852,3578740111,3578740118,7
2,1144,25853,3578740111,3578740118,7
2,1144,25854,3578740111,3578740119,8
2,1144,25855,3578740111,3578740121,10
2,1144,25856,3578740111,3578740122,11
2,1144,25857,3578740111,3578740122,11
2,1144,25858,3578740111,3578740122,11
2,1144,25859,3578740111,3578740122,11
2,1144,25860,3578740111,3578740122,11
2,1144,25861,3578740111,3578740123,12
2,1144,25862,3578740111,3578740125,14
2,1144,25863,3578740111,3578740125,14
2,1144,25864,3578740111,3578740126,15
2,1144,25865,3578740111,3578740126,15
2,1144,25866,3578740111,3578740127,16
2,1144,25867,3578740111,3578740129,18
2,1144,25868,3578740111,3578740129,18
2,1144,25869,3578740111,3578740130,19
2,1144,25870,3578740111,3578740130,19
2,1144,25871,3578740111,3578740132,21
2,1144,25872,3578740111,3578740133,22
2,1144,25873,3578740111,3578740133,22
2,1144,25874,3578740111,3578740133,22
2,1144,25875,3578740111,3578740134,23
2,1144,25876,3578740111,3578740137,26
2,1144,25877,3578740111,3578740137,26
2,1144,25878,3578740111,3578740138,27
2,1144,25879,3578740111,3578740139,28
2,1144,25880,3578740111,3578740139,28
2,1144,25881,3578740111,3578740140,29
2,1144,25882,3578740111,3578740140,29
2,1144,25883,3578740111,3578740140,29
2,1144,25884,3578740111,3578740141,30
2,1144,25885,3578740111,3578740142,31
2,1144,25886,3578740111,3578740143,32
2,1144,25887,3578740111,3578740143,32
2,1144,25888,3578740111,3578740144,33
2,1144,25889,3578740111,3578740145,34
2,1144,25890,3578740111,3578740147,36
2,1144,25891,3578740111,3578740149,38
2,1144,25892,3578740111,3578740149,38
2,1144,25893,3578740111,3578740152,41
2,1144,25894,3578740111,3578740154,43
2,1144,25895,3578740111,3578740154,43
2,1144,25896,3578740111,3578740155,44
2,1144,25897,3578740111,3578740155,44
2,1144,25898,3578740111,3578740155,44
2,1144,25899,3578740111,3578740157,46
2,1144,25900,3578740111,3578740159,48
2,1145,25901,3578740172,3578740172,0
2,1145,25902,3578740172,3578740172,0
2,1145,25903,3578740172,3578740172,0
2,1145,25904,3578740172,3578740172,0
2,1145,25905,3578740172,3578740172,0
2,1145,25906,3578740172,3578740172,0
2,1145,25907,3578740172,3578740172,0
2,1145,25908,3578740172,3578740172,0
2,1145,25909,3578740172,3578740172,0
2,1145,25910,3578740172,3578740172,0
2,1145,25911,3578740172,3578740172,0
2,1145,25912,3578740172,3578740172,0
2,1145,25913,3578740172,3578740172,0
2,1145,25914,3578740172,3578740173,1
2,1145,25915,3578740172,3578740176,4
2,1145,25916,3578740172,3578740176,4
2,1145,25917,3578740172,3578740177,5
2,1145,25918,3578740172,3578740177,5
2,1145,25919,3578740172,3578740178,6
2,1145,25920,3578740172,3578740179,7
2,1145,25921,3578740172,3578740180,8
2,1145,25922,3578740172,3578740181,9
2,1145,25923,3578740172,3578740181,9
2,1145,25924,3578740172,3578740182,10
2,1145,25925,3578740172,3578740184,12
2,1145,25926,3578740172,3578740185,13
2,1145,25927,3578740172,3578740185,13
2,1145,25928,3578740172,3578740185,13
2,1145,25929,3578740172,3578740186,14
2,1145,25930,3578740172,3578740189,17
2,1145,25931,3578740172,3578740189,17
2,1145,25932,3578740172,3578740189,17
2,1145,25933,3578740172,3578740192,20
2,1145,25934,3578740172,3578740192,20
2,1145,25935,3578740172,3578740193,21
2,1145,25936,3578740172,3578740194,22
2,1145,25937,3578740172,3578740194,22
2,1145,25938,3578740172,3578740195,23
2,1145,25939,3578740172,3578740195,23
2,1145,25940,3578740172,3578740196,24
2,1145,25941,3578740172,3578740199,27
2,1145,25942,3578740172,3578740199,27
2,1145,25943,3578740172,3578740199,27
2,1145,25944,3578740172,3578740200,28
2,1145,25945,3578740172,3578740204,32
2,1145,25946,3578740172,3578740204,32
2,1145,25947,3578740172,3578740205,33
2,1145,25948,3578740172,3578740206,34
2,1145,25949,3578740172,3578740208,36
2,1145,25950,3578740172,3578740213,41
2,1145,25951,3578740172,3578740214,42
2,1145,25952,3578740172,3578740214,42
2,1145,25953,3578740172,3578740215,43
2,1145,25954,3578740172,3578740216,44
2,1145,25955,3578740172,3578740217,45
2,1145,25956,3578740172,3578740217,45
2,1145,25957,3578740172,3578740219,47
2,1145,25958,3578740172,3578740221,49
2,1145,25959,3578740172,3578740221,49
2,1146,25960,3578740235,3578740235,0
2,1146,25961,3578740235,3578740235,0
2,1146,25962,3578740235,3578740236,1
2,1146,25963,3578740235,3578740236,1
2,1146,25964,3578740235,3578740236,1
2,1146,25965,3578740235,3578740236,1
2,1146,25966,3578740235,3578740236,1
2,1146,25967,3578740235,3578740236,1
2,1146,25968,3578740235,3578740236,1
2,1146,25969,3578740235,3578740236,1
2,1146,25970,3578740235,3578740236,1
2,1146,25971,3578740235,3578740236,1
2,1146,25972,3578740235,3578740236,1
2,1146,25973,3578740235,3578740236,1
2,1146,25974,3578740235,3578740236,1
2,1146,25975,3578740235,3578740236,1
2,1146,25976,3578740235,3578740236,1
2,1146,25977,3578740235,3578740237,2
2,1146,25978,3578740235,3578740237,2
2,1146,25979,3578740235,3578740238,3
2,1146,25980,3578740235,3578740239,4
2,1146,25981,3578740235,3578740239,4
2,1146,25982,3578740235,3578740239,4
2,1146,25983,3578740235,3578740241,6
2,1146,25984,3578740235,3578740241,6
2,1146,25985,3578740235,3578740241,6
2,1146,25986,3578740235,3578740242,7
2,1146,25987,3578740235,3578740242,7
2,1146,25988,3578740235,3578740245,10
2,1146,25989,3578740235,3578740246,11
2,1146,25990,3578740235,3578740247,12
2,1146,25991,3578740235,3578740247,12
2,1146,25992,3578740235,3578740248,13
2,1146,25993,3578740235,3578740249,14
2,1146,25994,3578740235,3578740251,16
2,1146,25995,3578740235,3578740251,16
2,1146,25996,3578740235,3578740252,17
2,1146,25997,3578740235,3578740253,18
2,1146,25998,3578740235,3578740254,19
2,1146,25999,3578740235,3578740254,19
2,1146,26000,3578740235,3578740254,19
2,1146,26001,3578740235,3578740254,19
2,1146,26002,3578740235,3578740255,20
2,1146,26003,3578740235,3578740256,21
2,1146,26004,3578740235,3578740258,23
2,1146,26005,3578740235,3578740258,23
2,1146,26006,3578740235,3578740258,23
2,1146,26007,3578740235,3578740259,24
2,1146,26008,3578740235,3578740259,24
2,1146,26009,3578740235,3578740260,25
2,1146,26010,3578740235,3578740260,25
2,1146,26011,3578740235,3578740260,25
2,1146,26012,3578740235,3578740261,26
2,1146,26013,3578740235,3578740265,30
2,1146,26014,3578740235,3578740266,31
2,1146,26015,3578740235,3578740267,32
2,1146,26016,3578740235,3578740268,33
2,1146,26017,3578740235,3578740269,34
2,1146,26018,3578740235,3578740269,34
2,1146,26019,3578740235,3578740270,35
2,1146,26020,3578740235,3578740271,36
2,1146,26021,3578740235,3578740277,42
2,1146,26022,3578740235,3578740278,43
2,1146,26023,3578740235,3578740279,44
2,1146,26024,3578740235,3578740280,45
2,1146,26025,3578740235,3578740280,45
2,1146,26026,3578740235,3578740281,46
2,1146,26027,3578740235,3578740283,48
2,1146,26028,3578740235,3578740283,48
2,1146,26029,3578740235,3578740283,48
2,1146,26030,3578740235,3578740284,49
2,1147,26031,3578740298,3578740298,0
2,1147,26032,3578740298,3578740298,0
2,1147,26033,3578740298,3578740298,0
2,1147,26034,3578740298,3578740298,0
2,1147,26035,3578740298,3578740298,0
2,1147,26036,3578740298,3578740298,0
2,1147,26037,3578740298,3578740298,0
2,1147,26038,3578740298,3578740298,0
2,1147,26039,3578740298,3578740298,0
2,1147,26040,3578740298,3578740298,0
2,1147,26041,3578740298,3578740298,0
2,1147,26042,3578740298,3578740298,0
2,1147,26043,3578740298,3578740298,0
2,1147,26044,3578740298,3578740298,0
2,1147,26045,3578740298,3578740298,0
2,1147,26046,3578740298,3578740298,0
2,1147,26047,3578740298,3578740298,0
2,1147,26048,3578740298,3578740298,0
2,1147,26049,3578740298,3578740298,0
2,1147,26050,3578740298,3578740298,0
2,1147,26051,3578740298,3578740298,0
2,1147,26052,3578740298,3578740298,0
2,1147,26053,3578740298,3578740298,0
2,1147,26054,3578740298,3578740299,1
2,1147,26055,3578740298,3578740299,1
2,1147,26056,3578740298,3578740300,2
2,1147,26057,3578740298,3578740301,3
2,1147,26058,3578740298,3578740303,5
2,1147,26059,3578740298,3578740304,6
2,1147,26060,3578740298,3578740306,8
2,1147,26061,3578740298,3578740307,9
2,1147,26062,3578740298,3578740307,9
2,1147,26063,3578740298,3578740309,11
2,1147,26064,3578740298,3578740309,11
2,1147,26065,3578740298,3578740310,12
2,1147,26066,3578740298,3578740311,13
2,1147,26067,3578740298,3578740312,14
2,1147,26068,3578740298,3578740313,15
2,1147,26069,3578740298,3578740314,16
2,1147,26070,3578740298,3578740315,17
2,1147,26071,3578740298,3578740316,18
2,1147,26072,3578740298,3578740317,19
2,1147,26073,3578740298,3578740318,20
2,1147,26074,3578740298,3578740318,20
2,1147,26075,3578740298,3578740318,20
2,1147,26076,3578740298,3578740319,21
2,1147,26077,3578740298,3578740320,22
2,1147,26078,3578740298,3578740321,23
2,1147,26079,3578740298,3578740322,24
2,1147,26080,3578740298,3578740322,24
2,1147,26081,3578740298,3578740322,24
2,1147,26082,3578740298,3578740322,24
2,1147,26083,3578740298,3578740322,24
2,1147,26084,3578740298,3578740322,24
2,1147,26085,3578740298,3578740323,25
2,1147,26086,3578740298,3578740325,27
2,1147,26087,3578740298,3578740326,28
2,1147,26088,3578740298,3578740326,28
2,1147,26089,3578740298,3578740327,29
2,1147,26090,3578740298,3578740327,29
2,1147,26091,3578740298,3578740328,30
2,1147,26092,3578740298,3578740329,31
2,1147,26093,3578740298,3578740330,32
2,1147,26094,3578740298,3578740331,33
2,1147,26095,3578740298,3578740333,35
2,1147,26096,3578740298,3578740333,35
2,1147,26097,3578740298,3578740333,35
2,1147,26098,3578740298,3578740333,35
2,1147,26099,3578740298,3578740334,36
2,1147,26100,3578740298,3578740338,40
2,1147,26101,3578740298,3578740338,40
2,1147,26102,3578740298,3578740338,40
2,1147,26103,3578740298,3578740339,41
2,1147,26104,3578740298,3578740339,41
2,1147,26105,3578740298,3578740340,42
2,1147,26106,3578740298,3578740341,43
2,1147,26107,3578740298,3578740341,43
2,1147,26108,3578740298,3578740342,44
2,1147,26109,3578740298,3578740342,44
2,1147,26110,3578740298,3578740343,45
2,1147,26111,3578740298,3578740344,46
2,1147,26112,3578740298,3578740345,47
2,1147,26113,3578740298,3578740348,50
2,1148,26114,3578740363,3578740363,0
2,1148,26115,3578740363,3578740363,0
2,1148,26116,3578740363,3578740363,0
2,1148,26117,3578740363,3578740363,0
2,1148,26118,3578740363,3578740363,0
2,1148,26119,3578740363,3578740363,0
2,1148,26120,3578740363,3578740363,0
2,1148,26121,3578740363,3578740363,0
2,1148,26122,3578740363,3578740363,0
2,1148,26123,3578740363,3578740363,0
2,1148,26124,3578740363,3578740363,0
2,1148,26125,3578740363,3578740364,1
2,1148,26126,3578740363,3578740365,2
2,1148,26127,3578740363,3578740365,2
2,1148,26128,3578740363,3578740365,2
2,1148,26129,3578740363,3578740366,3
2,1148,26130,3578740363,3578740367,4
2,1148,26131,3578740363,3578740368,5
2,1148,26132,3578740363,3578740368,5
2,1148,26133,3578740363,3578740368,5
2,1148,26134,3578740363,3578740368,5
2,1148,26135,3578740363,3578740369,6
2,1148,26136,3578740363,3578740370,7
2,1148,26137,3578740363,3578740370,7
2,1148,26138,3578740363,3578740373,10
2,1148,26139,3578740363,3578740375,12
2,1148,26140,3578740363,3578740377,14
2,1148,26141,3578740363,3578740377,14
2,1148,26142,3578740363,3578740378,15
2,1148,26143,3578740363,3578740378,15
2,1148,26144,3578740363,3578740380,17
2,1148,26145,3578740363,3578740381,18
2,1148,26146,3578740363,3578740381,18
2,1148,26147,3578740363,3578740382,19
2,1148,26148,3578740363,3578740383,20
2,1148,26149,3578740363,3578740384,21
2,1148,26150,3578740363,3578740385,22
2,1148,26151,3578740363,3578740385,22
2,1148,26152,3578740363,3578740386,23
2,1148,26153,3578740363,3578740389,26
2,1148,26154,3578740363,3578740390,27
2,1148,26155,3578740363,3578740393,30
2,1148,26156,3578740363,3578740393,30
2,1148,26157,3578740363,3578740394,31
2,1148,26158,3578740363,3578740395,32
2,1148,26159,3578740363,3578740395,32
2,1148,26160,3578740363,3578740396,33
2,1148,26161,3578740363,3578740399,36
2,1148,26162,3578740363,3578740400,37
2,1148,26163,3578740363,3578740400,37
2,1148,26164,3578740363,3578740404,41
2,1148,26165,3578740363,3578740405,42
2,1148,26166,3578740363,3578740405,42
2,1148,26167,3578740363,3578740406,43
2,1148,26168,3578740363,3578740408,45
2,1149,26169,3578740426,3578740426,0
2,1149,26170,3578740426,3578740426,0
2,1149,26171,3578740426,3578740426,0
2,1149,26172,3578740426,3578740426,0
2,1149,26173,3578740426,3578740426,0
2,1149,26174,3578740426,3578740426,0
2,1149,26175,3578740426,3578740426,0
2,1149,26176,3578740426,3578740426,0
2,1149,26177,3578740426,3578740426,0
2,1149,26178,3578740426,3578740426,0
2,1149,26179,3578740426,3578740427,1
2,1149,26180,3578740426,3578740427,1
2,1149,26181,3578740426,3578740427,1
2,1149,26182,3578740426,3578740428,2
2,1149,26183,3578740426,3578740428,2
2,1149,26184,3578740426,3578740428,2
2,1149,26185,3578740426,3578740429,3
2,1149,26186,3578740426,3578740430,4
2,1149,26187,3578740426,3578740430,4
2,1149,26188,3578740426,3578740432,6
2,1149,26189,3578740426,3578740432,6
2,1149,26190,3578740426,3578740432,6
2,1149,26191,3578740426,3578740433,7
2,1149,26192,3578740426,3578740433,7
2,1149,26193,3578740426,3578740433,7
2,1149,26194,3578740426,3578740434,8
2,1149,26195,3578740426,3578740434,8
2,1149,26196,3578740426,3578740437,11
2,1149,26197,3578740426,3578740437,11
2,1149,26198,3578740426,3578740438,12
2,1149,26199,3578740426,3578740440,14
2,1149,26200,3578740426,3578740440,14
2,1149,26201,3578740426,3578740440,14
2,1149,26202,3578740426,3578740441,15
2,1149,26203,3578740426,3578740442,16
2,1149,26204,3578740426,3578740442,16
2,1149,26205,3578740426,3578740442,16
2,1149,26206,3578740426,3578740442,16
2,1149,26207,3578740426,3578740446,20
2,1149,26208,3578740426,3578740447,21
2,1149,26209,3578740426,3578740447,21
2,1149,26210,3578740426,3578740447,21
2,1149,26211,3578740426,3578740449,23
2,1149,26212,3578740426,3578740450,24
2,1149,26213,3578740426,3578740451,25
2,1149,26214,3578740426,3578740452,26
2,1149,26215,3578740426,3578740453,27
2,1149,26216,3578740426,3578740454,28
2,1149,26217,3578740426,3578740454,28
2,1149,26218,3578740426,3578740455,29
2,1149,26219,3578740426,3578740455,29
2,1149,26220,3578740426,3578740455,29
2,1149,26221,3578740426,3578740455,29
2,1149,26222,3578740426,3578740456,30
2,1149,26223,3578740426,3578740458,32
2,1149,26224,3578740426,3578740458,32
2,1149,26225,3578740426,3578740459,33
2,1149,26226,3578740426,3578740460,34
2,1149,26227,3578740426,3578740460,34
2,1149,26228,3578740426,3578740460,34
2,1149,26229,3578740426,3578740460,34
2,1149,26230,3578740426,3578740460,34
2,1149,26231,3578740426,3578740465,39
2,1149,26232,3578740426,3578740466,40
2,1149,26233,3578740426,3578740467,41
2,1149,26234,3578740426,3578740467,41
2,1149,26235,3578740426,3578740468,42
2,1149,26236,3578740426,3578740468,42
2,1149,26237,3578740426,3578740468,42
2,1149,26238,3578740426,3578740469,43
2,1149,26239,3578740426,3578740470,44
2,1149,26240,3578740426,3578740471,45
2,1150,26241,3578740489,3578740489,0
2,1150,26242,3578740489,3578740489,0
2,1150,26243,3578740489,3578740489,0
2,1150,26244,3578740489,3578740489,0
2,1150,26245,3578740489,3578740489,0
2,1150,26246,3578740489,3578740489,0
2,1150,26247,3578740489,3578740489,0
2,1150,26248,3578740489,3578740489,0
2,1150,26249,3578740489,3578740489,0
2,1150,26250,3578740489,3578740489,0
2,1150,26251,3578740489,3578740489,0
2,1150,26252,3578740489,3578740489,0
2,1150,26253,3578740489,3578740489,0
2,1150,26254,3578740489,3578740489,0
2,1150,26255,3578740489,3578740490,1
2,1150,26256,3578740489,3578740490,1
2,1150,26257,3578740489,3578740490,1
2,1150,26258,3578740489,3578740490,1
2,1150,26259,3578740489,3578740491,2
2,1150,26260,3578740489,3578740493,4
2,1150,26261,3578740489,3578740493,4
2,1150,26262,3578740489,3578740493,4
2,1150,26263,3578740489,3578740493,4
2,1150,26264,3578740489,3578740494,5
2,1150,26265,3578740489,3578740494,5
2,1150,26266,3578740489,3578740494,5
2,1150,26267,3578740489,3578740496,7
2,1150,26268,3578740489,3578740496,7
2,1150,26269,3578740489,3578740496,7
2,1150,26270,3578740489,3578740498,9
2,1150,26271,3578740489,3578740498,9
2,1150,26272,3578740489,3578740498,9
2,1150,26273,3578740489,3578740499,10
2,1150,26274,3578740489,3578740500,11
2,1150,26275,3578740489,3578740502,13
2,1150,26276,3578740489,3578740502,13
2,1150,26277,3578740489,3578740506,17
2,1150,26278,3578740489,3578740506,17
2,1150,26279,3578740489,3578740508,19
2,1150,26280,3578740489,3578740508,19
2,1150,26281,3578740489,3578740508,19
2,1150,26282,3578740489,3578740510,21
2,1150,26283,3578740489,3578740511,22
2,1150,26284,3578740489,3578740512,23
2,1150,26285,3578740489,3578740512,23
2,1150,26286,3578740489,3578740513,24
2,1150,26287,3578740489,3578740514,25
2,1150,26288,3578740489,3578740514,25
2,1150,26289,3578740489,3578740515,26
2,1150,26290,3578740489,3578740515,26
2,1150,26291,3578740489,3578740517,28
2,1150,26292,3578740489,3578740517,28
2,1150,26293,3578740489,3578740517,28
2,1150,26294,3578740489,3578740517,28
2,1150,26295,3578740489,3578740518,29
2,1150,26296,3578740489,3578740520,31
2,1150,26297,3578740489,3578740521,32
2,1150,26298,3578740489,3578740521,32
2,1150,26299,3578740489,3578740521,32
2,1150,26300,3578740489,3578740521,32
2,1150,26301,3578740489,3578740522,33
2,1150,26302,3578740489,3578740522,33
2,1150,26303,3578740489,3578740522,33
2,1150,26304,3578740489,3578740523,34
2,1150,26305,3578740489,3578740525,36
2,1150,26306,3578740489,3578740525,36
2,1150,26307,3578740489,3578740526,37
2,1150,26308,3578740489,3578740526,37
2,1150,26309,3578740489,3578740527,38
2,1150,26310,3578740489,3578740528,39
2,1150,26311,3578740489,3578740528,39
2,1150,26312,3578740489,3578740529,40
2,1150,26313,3578740489,3578740530,41
2,1150,26314,3578740489,3578740532,43
2,1150,26315,3578740489,3578740532,43
2,1150,26316,3578740489,3578740533,44
2,1150,26317,3578740489,3578740534,45
2,1150,26318,3578740489,3578740536,47
2,1150,26319,3578740489,3578740537,48
2,1150,26320,3578740489,3578740538,49
2,1150,26321,3578740489,3578740538,49
2,1151,26322,3578740554,3578740554,0
2,1151,26323,3578740554,3578740554,0
2,1151,26324,3578740554,3578740554,0
2,1151,26325,3578740554,3578740554,0
2,1151,26326,3578740554,3578740554,0
2,1151,26327,3578740554,3578740554,0
2,1151,26328,3578740554,3578740554,0
2,1151,26329,3578740554,3578740554,0
2,1151,26330,3578740554,3578740554,0
2,1151,26331,3578740554,3578740554,0
2,1151,26332,3578740554,3578740554,0
2,1151,26333,3578740554,3578740554,0
2,1151,26334,3578740554,3578740554,0
2,1151,26335,3578740554,3578740554,0
2,1151,26336,3578740554,3578740554,0
2,1151,26337,3578740554,3578740555,1
2,1151,26338,3578740554,3578740555,1
2,1151,26339,3578740554,3578740556,2
2,1151,26340,3578740554,3578740557,3
2,1151,26341,3578740554,3578740559,5
2,1151,26342,3578740554,3578740561,7
2,1151,26343,3578740554,3578740562,8
2,1151,26344,3578740554,3578740563,9
2,1151,26345,3578740554,3578740564,10
2,1151,26346,3578740554,3578740564,10
2,1151,26347,3578740554,3578740564,10
2,1151,26348,3578740554,3578740566,12
2,1151,26349,3578740554,3578740566,12
2,1151,26350,3578740554,3578740567,13
2,1151,26351,3578740554,3578740568,14
2,1151,26352,3578740554,3578740568,14
2,1151,26353,3578740554,3578740568,14
2,1151,26354,3578740554,3578740569,15
2,1151,26355,3578740554,3578740569,15
2,1151,26356,3578740554,3578740572,18
2,1151,26357,3578740554,3578740574,20
2,1151,26358,3578740554,3578740576,22
2,1151,26359,3578740554,3578740576,22
2,1151,26360,3578740554,3578740577,23
2,1151,26361,3578740554,3578740578,24
2,1151,26362,3578740554,3578740579,25
2,1151,26363,3578740554,3578740580,26
2,1151,26364,3578740554,3578740580,26
2,1151,26365,3578740554,3578740580,26
2,1151,26366,3578740554,3578740583,29
2,1151,26367,3578740554,3578740584,30
2,1151,26368,3578740554,3578740584,30
2,1151,26369,3578740554,3578740584,30
2,1151,26370,3578740554,3578740585,31
2,1151,26371,3578740554,3578740588,34
2,1151,26372,3578740554,3578740589,35
2,1151,26373,3578740554,3578740590,36
2,1151,26374,3578740554,3578740591,37
2,1151,26375,3578740554,3578740592,38
2,1151,26376,3578740554,3578740592,38
2,1151,26377,3578740554,3578740593,39
2,1151,26378,3578740554,3578740594,40
2,1151,26379,3578740554,3578740594,40
2,1151,26380,3578740554,3578740595,41
2,1151,26381,3578740554,3578740595,41
2,1151,26382,3578740554,3578740598,44
2,1151,26383,3578740554,3578740599,45
2,1151,26384,3578740554,3578740599,45
2,1151,26385,3578740554,3578740600,46
2,1151,26386,3578740554,3578740602,48
2,1151,26387,3578740554,3578740604,50
2,1152,26388,3578740615,3578740615,0
2,1152,26389,3578740615,3578740615,0
2,1152,26390,3578740615,3578740615,0
2,1152,26391,3578740615,3578740615,0
2,1152,26392,3578740615,3578740615,0
2,1152,26393,3578740615,3578740615,0
2,1152,26394,3578740615,3578740615,0
2,1152,26395,3578740615,3578740616,1
2,1152,26396,3578740615,3578740616,1
2,1152,26397,3578740615,3578740619,4
2,1152,26398,3578740615,3578740620,5
2,1152,26399,3578740615,3578740620,5
2,1152,26400,3578740615,3578740620,5
2,1152,26401,3578740615,3578740622,7
2,1152,26402,3578740615,3578740624,9
2,1152,26403,3578740615,3578740625,10
2,1152,26404,3578740615,3578740626,11
2,1152,26405,3578740615,3578740626,11
2,1152,26406,3578740615,3578740626,11
2,1152,26407,3578740615,3578740627,12
2,1152,26408,3578740615,3578740627,12
2,1152,26409,3578740615,3578740628,13
2,1152,26410,3578740615,3578740629,14
2,1152,26411,3578740615,3578740630,15
2,1152,26412,3578740615,3578740631,16
2,1152,26413,3578740615,3578740632,17
2,1152,26414,3578740615,3578740632,17
2,1152,26415,3578740615,3578740632,17
2,1152,26416,3578740615,3578740632,17
2,1152,26417,3578740615,3578740633,18
2,1152,26418,3578740615,3578740636,21
2,1152,26419,3578740615,3578740636,21
2,1152,26420,3578740615,3578740637,22
2,1152,26421,3578740615,3578740637,22
2,1152,26422,3578740615,3578740638,23
2,1152,26423,3578740615,3578740638,23
2,1152,26424,3578740615,3578740638,23
2,1152,26425,3578740615,3578740639,24
2,1152,26426,3578740615,3578740641,26
2,1152,26427,3578740615,3578740642,27
2,1152,26428,3578740615,3578740642,27
2,1152,26429,3578740615,3578740642,27
2,1152,26430,3578740615,3578740643,28
2,1152,26431,3578740615,3578740646,31
2,1152,26432,3578740615,3578740646,31
2,1152,26433,3578740615,3578740647,32
2,1152,26434,3578740615,3578740647,32
2,1152,26435,3578740615,3578740648,33
2,1152,26436,3578740615,3578740649,34
2,1152,26437,3578740615,3578740650,35
2,1152,26438,3578740615,3578740651,36
2,1152,26439,3578740615,3578740651,36
2,1152,26440,3578740615,3578740652,37
2,1152,26441,3578740615,3578740653,38
2,1152,26442,3578740615,3578740653,38
2,1152,26443,3578740615,3578740654,39
2,1152,26444,3578740615,3578740655,40
2,1152,26445,3578740615,3578740655,40
2,1152,26446,3578740615,3578740655,40
2,1152,26447,3578740615,3578740655,40
2,1152,26448,3578740615,3578740657,42
2,1152,26449,3578740615,3578740658,43
2,1152,26450,3578740615,3578740658,43
2,1152,26451,3578740615,3578740660,45
2,1152,26452,3578740615,3578740660,45
2,1152,26453,3578740615,3578740660,45
2,1152,26454,3578740615,3578740660,45
2,1152,26455,3578740615,3578740665,50
2,1153,26456,3578740677,3578740677,0
2,1153,26457,3578740677,3578740677,0
2,1153,26458,3578740677,3578740677,0
2,1153,26459,3578740677,3578740677,0
2,1153,26460,3578740677,3578740677,0
2,1153,26461,3578740677,3578740677,0
2,1153,26462,3578740677,3578740677,0
2,1153,26463,3578740677,3578740677,0
2,1153,26464,3578740677,3578740677,0
2,1153,26465,3578740677,3578740679,2
2,1153,26466,3578740677,3578740679,2
2,1153,26467,3578740677,3578740680,3
2,1153,26468,3578740677,3578740681,4
2,1153,26469,3578740677,3578740682,5
2,1153,26470,3578740677,3578740685,8
2,1153,26471,3578740677,3578740685,8
2,1153,26472,3578740677,3578740685,8
2,1153,26473,3578740677,3578740685,8
2,1153,26474,3578740677,3578740687,10
2,1153,26475,3578740677,3578740687,10
2,1153,26476,3578740677,3578740688,11
2,1153,26477,3578740677,3578740689,12
2,1153,26478,3578740677,3578740689,12
2,1153,26479,3578740677,3578740691,14
2,1153,26480,3578740677,3578740691,14
2,1153,26481,3578740677,3578740691,14
2,1153,26482,3578740677,3578740692,15
2,1153,26483,3578740677,3578740693,16
2,1153,26484,3578740677,3578740693,16
2,1153,26485,3578740677,3578740694,17
2,1153,26486,3578740677,3578740694,17
2,1153,26487,3578740677,3578740694,17
2,1153,26488,3578740677,3578740694,17
2,1153,26489,3578740677,3578740695,18
2,1153,26490,3578740677,3578740696,19
2,1153,26491,3578740677,3578740696,19
2,1153,26492,3578740677,3578740696,19
2,1153,26493,3578740677,3578740696,19
2,1153,26494,3578740677,3578740698,21
2,1153,26495,3578740677,3578740698,21
2,1153,26496,3578740677,3578740698,21
2,1153,26497,3578740677,3578740699,22
2,1153,26498,3578740677,3578740702,25
2,1153,26499,3578740677,3578740703,26
2,1153,26500,3578740677,3578740706,29
2,1153,26501,3578740677,3578740706,29
2,1153,26502,3578740677,3578740708,31
2,1153,26503,3578740677,3578740709,32
2,1153,26504,3578740677,3578740709,32
2,1153,26505,3578740677,3578740710,33
2,1153,26506,3578740677,3578740710,33
2,1153,26507,3578740677,3578740711,34
2,1153,26508,3578740677,3578740713,36
2,1153,26509,3578740677,3578740714,37
2,1153,26510,3578740677,3578740714,37
2,1153,26511,3578740677,3578740715,38
2,1153,26512,3578740677,3578740717,40
2,1153,26513,3578740677,3578740717,40
2,1153,26514,3578740677,3578740717,40
2,1153,26515,3578740677,3578740717,40
2,1153,26516,3578740677,3578740719,42
2,1153,26517,3578740677,3578740720,43
2,1153,26518,3578740677,3578740720,43
2,1153,26519,3578740677,3578740721,44
2,1153,26520,3578740677,3578740721,44
2,1153,26521,3578740677,3578740722,45
2,1153,26522,3578740677,3578740722,45
2,1153,26523,3578740677,3578740723,46
2,1153,26524,3578740677,3578740723,46
2,1153,26525,3578740677,3578740725,48
2,1153,26526,3578740677,3578740725,48
2,1153,26527,3578740677,3578740725,48
2,1153,26528,3578740677,3578740727,50
2,1154,26529,3578740744,3578740744,0
2,1154,26530,3578740744,3578740744,0
2,1154,26531,3578740744,3578740744,0
2,1154,26532,3578740744,3578740744,0
2,1154,26533,3578740744,3578740744,0
2,1154,26534,3578740744,3578740744,0
2,1154,26535,3578740744,3578740744,0
2,1154,26536,3578740744,3578740744,0
2,1154,26537,3578740744,3578740744,0
2,1154,26538,3578740744,3578740744,0
2,1154,26539,3578740744,3578740744,0
2,1154,26540,3578740744,3578740744,0
2,1154,26541,3578740744,3578740744,0
2,1154,26542,3578740744,3578740744,0
2,1154,26543,3578740744,3578740744,0
2,1154,26544,3578740744,3578740744,0
2,1154,26545,3578740744,3578740744,0
2,1154,26546,3578740744,3578740744,0
2,1154,26547,3578740744,3578740744,0
2,1154,26548,3578740744,3578740744,0
2,1154,26549,3578740744,3578740744,0
2,1154,26550,3578740744,3578740744,0
2,1154,26551,3578740744,3578740744,0
2,1154,26552,3578740744,3578740749,5
2,1154,26553,3578740744,3578740752,8
2,1154,26554,3578740744,3578740752,8
2,1154,26555,3578740744,3578740753,9
2,1154,26556,3578740744,3578740753,9
2,1154,26557,3578740744,3578740754,10
2,1154,26558,3578740744,3578740755,11
2,1154,26559,3578740744,3578740755,11
2,1154,26560,3578740744,3578740755,11
2,1154,26561,3578740744,3578740759,15
2,1154,26562,3578740744,3578740761,17
2,1154,26563,3578740744,3578740761,17
2,1154,26564,3578740744,3578740763,19
2,1154,26565,3578740744,3578740764,20
2,1154,26566,3578740744,3578740765,21
2,1154,26567,3578740744,3578740765,21
2,1154,26568,3578740744,3578740766,22
2,1154,26569,3578740744,3578740766,22
2,1154,26570,3578740744,3578740767,23
2,1154,26571,3578740744,3578740767,23
2,1154,26572,3578740744,3578740768,24
2,1154,26573,3578740744,3578740768,24
2,1154,26574,3578740744,3578740768,24
2,1154,26575,3578740744,3578740769,25
2,1154,26576,3578740744,3578740772,28
2,1154,26577,3578740744,3578740774,30
2,1154,26578,3578740744,3578740776,32
2,1154,26579,3578740744,3578740777,33
2,1154,26580,3578740744,3578740777,33
2,1154,26581,3578740744,3578740778,34
2,1154,26582,3578740744,3578740778,34
2,1154,26583,3578740744,3578740779,35
2,1154,26584,3578740744,3578740780,36
2,1154,26585,3578740744,3578740780,36
2,1154,26586,3578740744,3578740781,37
2,1154,26587,3578740744,3578740783,39
2,1154,26588,3578740744,3578740784,40
2,1154,26589,3578740744,3578740785,41
2,1154,26590,3578740744,3578740785,41
2,1154,26591,3578740744,3578740786,42
2,1154,26592,3578740744,3578740788,44
2,1154,26593,3578740744,3578740790,46
2,1154,26594,3578740744,3578740790,46
2,1154,26595,3578740744,3578740791,47
2,1154,26596,3578740744,3578740791,47
2,1154,26597,3578740744,3578740792,48
2,1154,26598,3578740744,3578740793,49
2,1154,26599,3578740744,3578740794,50
2,1155,26600,3578740805,3578740805,0
2,1155,26601,3578740805,3578740805,0
2,1155,26602,3578740805,3578740805,0
2,1155,26603,3578740805,3578740805,0
2,1155,26604,3578740805,3578740805,0
2,1155,26605,3578740805,3578740805,0
2,1155,26606,3578740805,3578740805,0
2,1155,26607,3578740805,3578740805,0
2,1155,26608,3578740805,3578740805,0
2,1155,26609,3578740805,3578740805,0
2,1155,26610,3578740805,3578740806,1
2,1155,26611,3578740805,3578740806,1
2,1155,26612,3578740805,3578740812,7
2,1155,26613,3578740805,3578740812,7
2,1155,26614,3578740805,3578740813,8
2,1155,26615,3578740805,3578740813,8
2,1155,26616,3578740805,3578740815,10
2,1155,26617,3578740805,3578740815,10
2,1155,26618,3578740805,3578740817,12
2,1155,26619,3578740805,3578740818,13
2,1155,26620,3578740805,3578740820,15
2,1155,26621,3578740805,3578740821,16
2,1155,26622,3578740805,3578740821,16
2,1155,26623,3578740805,3578740823,18
2,1155,26624,3578740805,3578740824,19
2,1155,26625,3578740805,3578740826,21
2,1155,26626,3578740805,3578740826,21
2,1155,26627,3578740805,3578740827,22
2,1155,26628,3578740805,3578740828,23
2,1155,26629,3578740805,3578740828,23
2,1155,26630,3578740805,3578740829,24
2,1155,26631,3578740805,3578740829,24
2,1155,26632,3578740805,3578740829,24
2,1155,26633,3578740805,3578740831,26
2,1155,26634,3578740805,3578740832,27
2,1155,26635,3578740805,3578740832,27
2,1155,26636,3578740805,3578740832,27
2,1155,26637,3578740805,3578740832,27
2,1155,26638,3578740805,3578740832,27
2,1155,26639,3578740805,3578740833,28
2,1155,26640,3578740805,3578740836,31
2,1155,26641,3578740805,3578740836,31
2,1155,26642,3578740805,3578740837,32
2,1155,26643,3578740805,3578740837,32
2,1155,26644,3578740805,3578740838,33
2,1155,26645,3578740805,3578740838,33
2,1155,26646,3578740805,3578740839,34
2,1155,26647,3578740805,3578740840,35
2,1155,26648,3578740805,3578740840,35
2,1155,26649,3578740805,3578740841,36
2,1155,26650,3578740805,3578740842,37
2,1155,26651,3578740805,3578740842,37
2,1155,26652,3578740805,3578740843,38
2,1155,26653,3578740805,3578740846,41
2,1155,26654,3578740805,3578740847,42
2,1155,26655,3578740805,3578740847,42
2,1155,26656,3578740805,3578740848,43
2,1155,26657,3578740805,3578740849,44
2,1155,26658,3578740805,3578740850,45
2,1155,26659,3578740805,3578740850,45
2,1155,26660,3578740805,3578740852,47
2,1155,26661,3578740805,3578740852,47
2,1155,26662,3578740805,3578740852,47
2,1155,26663,3578740805,3578740853,48
2,1155,26664,3578740805,3578740854,49
2,1155,26665,3578740805,3578740855,50
2,1156,26666,3578740870,3578740870,0
2,1156,26667,3578740870,3578740870,0
2,1156,26668,3578740870,3578740870,0
2,1156,26669,3578740870,3578740870,0
2,1156,26670,3578740870,3578740870,0
2,1156,26671,3578740870,3578740870,0
2,1156,26672,3578740870,3578740870,0
2,1156,26673,3578740870,3578740870,0
2,1156,26674,3578740870,3578740870,0
2,1156,26675,3578740870,3578740870,0
2,1156,26676,3578740870,3578740870,0
2,1156,26677,3578740870,3578740870,0
2,1156,26678,3578740870,3578740870,0
2,1156,26679,3578740870,3578740870,0
2,1156,26680,3578740870,3578740870,0
2,1156,26681,3578740870,3578740870,0
2,1156,26682,3578740870,3578740870,0
2,1156,26683,3578740870,3578740870,0
2,1156,26684,3578740870,3578740870,0
2,1156,26685,3578740870,3578740871,1
2,1156,26686,3578740870,3578740877,7
2,1156,26687,3578740870,3578740879,9
2,1156,26688,3578740870,3578740881,11
2,1156,26689,3578740870,3578740881,11
2,1156,26690,3578740870,3578740882,12
2,1156,26691,3578740870,3578740883,13
2,1156,26692,3578740870,3578740884,14
2,1156,26693,3578740870,3578740885,15
2,1156,26694,3578740870,3578740885,15
2,1156,26695,3578740870,3578740886,16
2,1156,26696,3578740870,3578740886,16
2,1156,26697,3578740870,3578740888,18
2,1156,26698,3578740870,3578740888,18
2,1156,26699,3578740870,3578740889,19
2,1156,26700,3578740870,3578740890,20
2,1156,26701,3578740870,3578740890,20
2,1156,26702,3578740870,3578740891,21
2,1156,26703,3578740870,3578740892,22
2,1156,26704,3578740870,3578740892,22
2,1156,26705,3578740870,3578740893,23
2,1156,26706,3578740870,3578740893,23
2,1156,26707,3578740870,3578740893,23
2,1156,26708,3578740870,3578740894,24
2,1156,26709,3578740870,3578740894,24
2,1156,26710,3578740870,3578740896,26
2,1156,26711,3578740870,3578740896,26
2,1156,26712,3578740870,3578740896,26
2,1156,26713,3578740870,3578740897,27
2,1156,26714,3578740870,3578740897,27
2,1156,26715,3578740870,3578740897,27
2,1156,26716,3578740870,3578740898,28
2,1156,26717,3578740870,3578740898,28
2,1156,26718,3578740870,3578740899,29
2,1156,26719,3578740870,3578740901,31
2,1156,26720,3578740870,3578740902,32
2,1156,26721,3578740870,3578740903,33
2,1156,26722,3578740870,3578740906,36
2,1156,26723,3578740870,3578740910,40
2,1156,26724,3578740870,3578740910,40
2,1156,26725,3578740870,3578740910,40
2,1156,26726,3578740870,3578740910,40
2,1156,26727,3578740870,3578740912,42
2,1156,26728,3578740870,3578740913,43
2,1156,26729,3578740870,3578740914,44
2,1156,26730,3578740870,3578740915,45
2,1156,26731,3578740870,3578740916,46
2,1156,26732,3578740870,3578740917,47
2,1156,26733,3578740870,3578740917,47
2,1156,26734,3578740870,3578740917,47
2,1156,26735,3578740870,3578740918,48
2,1156,26736,3578740870,3578740918,48
2,1156,26737,3578740870,3578740918,48
2,1157,26738,3578740931,3578740931,0
2,1157,26739,3578740931,3578740931,0
2,1157,26740,3578740931,3578740931,0
2,1157,26741,3578740931,3578740931,0
2,1157,26742,3578740931,3578740931,0
2,1157,26743,3578740931,3578740931,0
2,1157,26744,3578740931,3578740931,0
2,1157,26745,3578740931,3578740931,0
2,1157,26746,3578740931,3578740931,0
2,1157,26747,3578740931,3578740931,0
2,1157,26748,3578740931,3578740931,0
2,1157,26749,3578740931,3578740931,0
2,1157,26750,3578740931,3578740931,0
2,1157,26751,3578740931,3578740931,0
2,1157,26752,3578740931,3578740931,0
2,1157,26753,3578740931,3578740931,0
2,1157,26754,3578740931,3578740931,0
2,1157,26755,3578740931,3578740931,0
2,1157,26756,3578740931,3578740931,0
2,1157,26757,3578740931,3578740932,1
2,1157,26758,3578740931,3578740933,2
2,1157,26759,3578740931,3578740933,2
2,1157,26760,3578740931,3578740934,3
2,1157,26761,3578740931,3578740934,3
2,1157,26762,3578740931,3578740934,3
2,1157,26763,3578740931,3578740937,6
2,1157,26764,3578740931,3578740937,6
2,1157,26765,3578740931,3578740938,7
2,1157,26766,3578740931,3578740938,7
2,1157,26767,3578740931,3578740939,8
2,1157,26768,3578740931,3578740940,9
2,1157,26769,3578740931,3578740940,9
2,1157,26770,3578740931,3578740941,10
2,1157,26771,3578740931,3578740943,12
2,1157,26772,3578740931,3578740943,12
2,1157,26773,3578740931,3578740943,12
2,1157,26774,3578740931,3578740943,12
2,1157,26775,3578740931,3578740944,13
2,1157,26776,3578740931,3578740944,13
2,1157,26777,3578740931,3578740949,18
2,1157,26778,3578740931,3578740949,18
2,1157,26779,3578740931,3578740953,22
2,1157,26780,3578740931,3578740954,23
2,1157,26781,3578740931,3578740955,24
2,1157,26782,3578740931,3578740955,24
2,1157,26783,3578740931,3578740955,24
2,1157,26784,3578740931,3578740955,24
2,1157,26785,3578740931,3578740957,26
2,1157,26786,3578740931,3578740959,28
2,1157,26787,3578740931,3578740961,30
2,1157,26788,3578740931,3578740961,30
2,1157,26789,3578740931,3578740963,32
2,1157,26790,3578740931,3578740964,33
2,1157,26791,3578740931,3578740965,34
2,1157,26792,3578740931,3578740966,35
2,1157,26793,3578740931,3578740966,35
2,1157,26794,3578740931,3578740966,35
2,1157,26795,3578740931,3578740966,35
2,1157,26796,3578740931,3578740967,36
2,1157,26797,3578740931,3578740967,36
2,1157,26798,3578740931,3578740968,37
2,1157,26799,3578740931,3578740969,38
2,1157,26800,3578740931,3578740969,38
2,1157,26801,3578740931,3578740973,42
2,1157,26802,3578740931,3578740974,43
2,1157,26803,3578740931,3578740975,44
2,1157,26804,3578740931,3578740977,46
2,1157,26805,3578740931,3578740977,46
2,1157,26806,3578740931,3578740977,46
2,1157,26807,3578740931,3578740978,47
2,1157,26808,3578740931,3578740979,48
2,1157,26809,3578740931,3578740980,49
2,1157,26810,3578740931,3578740980,49
2,1157,26811,3578740931,3578740980,49
2,1157,26812,3578740931,3578740981,50
2,1158,26813,3578740992,3578740992,0
2,1158,26814,3578740992,3578740992,0
2,1158,26815,3578740992,3578740992,0
2,1158,26816,3578740992,3578740992,0
2,1158,26817,3578740992,3578740992,0
2,1158,26818,3578740992,3578740992,0
2,1158,26819,3578740992,3578740992,0
2,1158,26820,3578740992,3578740992,0
2,1158,26821,3578740992,3578740992,0
2,1158,26822,3578740992,3578740992,0
2,1158,26823,3578740992,3578740992,0
2,1158,26824,3578740992,3578740992,0
2,1158,26825,3578740992,3578740992,0
2,1158,26826,3578740992,3578740994,2
2,1158,26827,3578740992,3578740994,2
2,1158,26828,3578740992,3578740994,2
2,1158,26829,3578740992,3578740997,5
2,1158,26830,3578740992,3578740999,7
2,1158,26831,3578740992,3578740999,7
2,1158,26832,3578740992,3578741000,8
2,1158,26833,3578740992,3578741002,10
2,1158,26834,3578740992,3578741004,12
2,1158,26835,3578740992,3578741004,12
2,1158,26836,3578740992,3578741006,14
2,1158,26837,3578740992,3578741006,14
2,1158,26838,3578740992,3578741012,20
2,1158,26839,3578740992,3578741013,21
2,1158,26840,3578740992,3578741013,21
2,1158,26841,3578740992,3578741014,22
2,1158,26842,3578740992,3578741015,23
2,1158,26843,3578740992,3578741015,23
2,1158,26844,3578740992,3578741017,25
2,1158,26845,3578740992,3578741017,25
2,1158,26846,3578740992,3578741018,26
2,1158,26847,3578740992,3578741020,28
2,1158,26848,3578740992,3578741020,28
2,1158,26849,3578740992,3578741020,28
2,1158,26850,3578740992,3578741021,29
2,1158,26851,3578740992,3578741024,32
2,1158,26852,3578740992,3578741025,33
2,1158,26853,3578740992,3578741026,34
2,1158,26854,3578740992,3578741027,35
2,1158,26855,3578740992,3578741028,36
2,1158,26856,3578740992,3578741028,36
2,1158,26857,3578740992,3578741029,37
2,1158,26858,3578740992,3578741029,37
2,1158,26859,3578740992,3578741029,37
2,1158,26860,3578740992,3578741030,38
2,1158,26861,3578740992,3578741031,39
2,1158,26862,3578740992,3578741032,40
2,1158,26863,3578740992,3578741032,40
2,1158,26864,3578740992,3578741032,40
2,1158,26865,3578740992,3578741032,40
2,1158,26866,3578740992,3578741033,41
2,1158,26867,3578740992,3578741033,41
2,1158,26868,3578740992,3578741036,44
2,1158,26869,3578740992,3578741037,45
2,1158,26870,3578740992,3578741038,46
2,1158,26871,3578740992,3578741038,46
2,1158,26872,3578740992,3578741038,46
2,1158,26873,3578740992,3578741040,48
2,1158,26874,3578740992,3578741041,49
2,1158,26875,3578740992,3578741041,49
2,1158,26876,3578740992,3578741041,49
2,1158,26877,3578740992,3578741042,50
2,1159,26878,3578741054,3578741054,0
2,1159,26879,3578741054,3578741054,0
2,1159,26880,3578741054,3578741054,0
2,1159,26881,3578741054,3578741054,0
2,1159,26882,3578741054,3578741054,0
2,1159,26883,3578741054,3578741054,0
2,1159,26884,3578741054,3578741054,0
2,1159,26885,3578741054,3578741054,0
2,1159,26886,3578741054,3578741054,0
2,1159,26887,3578741054,3578741054,0
2,1159,26888,3578741054,3578741054,0
2,1159,26889,3578741054,3578741054,0
2,1159,26890,3578741054,3578741054,0
2,1159,26891,3578741054,3578741054,0
2,1159,26892,3578741054,3578741054,0
2,1159,26893,3578741054,3578741054,0
2,1159,26894,3578741054,3578741055,1
2,1159,26895,3578741054,3578741055,1
2,1159,26896,3578741054,3578741056,2
2,1159,26897,3578741054,3578741057,3
2,1159,26898,3578741054,3578741057,3
2,1159,26899,3578741054,3578741058,4
2,1159,26900,3578741054,3578741059,5
2,1159,26901,3578741054,3578741060,6
2,1159,26902,3578741054,3578741060,6
2,1159,26903,3578741054,3578741061,7
2,1159,26904,3578741054,3578741061,7
2,1159,26905,3578741054,3578741062,8
2,1159,26906,3578741054,3578741066,12
2,1159,26907,3578741054,3578741067,13
2,1159,26908,3578741054,3578741067,13
2,1159,26909,3578741054,3578741067,13
2,1159,26910,3578741054,3578741068,14
2,1159,26911,3578741054,3578741068,14
2,1159,26912,3578741054,3578741069,15
2,1159,26913,3578741054,3578741071,17
2,1159,26914,3578741054,3578741071,17
2,1159,26915,3578741054,3578741072,18
2,1159,26916,3578741054,3578741077,23
2,1159,26917,3578741054,3578741079,25
2,1159,26918,3578741054,3578741080,26
2,1159,26919,3578741054,3578741082,28
2,1159,26920,3578741054,3578741083,29
2,1159,26921,3578741054,3578741083,29
2,1159,26922,3578741054,3578741084,30
2,1159,26923,3578741054,3578741085,31
2,1159,26924,3578741054,3578741087,33
2,1159,26925,3578741054,3578741088,34
2,1159,26926,3578741054,3578741088,34
2,1159,26927,3578741054,3578741089,35
2,1159,26928,3578741054,3578741090,36
2,1159,26929,3578741054,3578741091,37
2,1159,26930,3578741054,3578741091,37
2,1159,26931,3578741054,3578741092,38
2,1159,26932,3578741054,3578741092,38
2,1159,26933,3578741054,3578741093,39
2,1159,26934,3578741054,3578741094,40
2,1159,26935,3578741054,3578741094,40
2,1159,26936,3578741054,3578741095,41
2,1159,26937,3578741054,3578741095,41
2,1159,26938,3578741054,3578741096,42
2,1159,26939,3578741054,3578741097,43
2,1159,26940,3578741054,3578741097,43
2,1159,26941,3578741054,3578741097,43
2,1159,26942,3578741054,3578741097,43
2,1159,26943,3578741054,3578741098,44
2,1159,26944,3578741054,3578741098,44
2,1159,26945,3578741054,3578741098,44
2,1159,26946,3578741054,3578741099,45
2,1159,26947,3578741054,3578741101,47
2,1159,26948,3578741054,3578741102,48
2,1159,26949,3578741054,3578741103,49
2,1160,26950,3578741117,3578741117,0
2,1160,26951,3578741117,3578741117,0
2,1160,26952,3578741117,3578741117,0
2,1160,26953,3578741117,3578741117,0
2,1160,26954,3578741117,3578741117,0
2,1160,26955,3578741117,3578741117,0
2,1160,26956,3578741117,3578741117,0
2,1160,26957,3578741117,3578741117,0
2,1160,26958,3578741117,3578741117,0
2,1160,26959,3578741117,3578741117,0
2,1160,26960,3578741117,3578741117,0
2,1160,26961,3578741117,3578741117,0
2,1160,26962,3578741117,3578741117,0
2,1160,26963,3578741117,3578741118,1
2,1160,26964,3578741117,3578741118,1
2,1160,26965,3578741117,3578741118,1
2,1160,26966,3578741117,3578741119,2
2,1160,26967,3578741117,3578741122,5
2,1160,26968,3578741117,3578741122,5
2,1160,26969,3578741117,3578741122,5
2,1160,26970,3578741117,3578741122,5
2,1160,26971,3578741117,3578741122,5
2,1160,26972,3578741117,3578741123,6
2,1160,26973,3578741117,3578741124,7
2,1160,26974,3578741117,3578741124,7
2,1160,26975,3578741117,3578741125,8
2,1160,26976,3578741117,3578741125,8
2,1160,26977,3578741117,3578741125,8
2,1160,26978,3578741117,3578741126,9
2,1160,26979,3578741117,3578741126,9
2,1160,26980,3578741117,3578741126,9
2,1160,26981,3578741117,3578741128,11
2,1160,26982,3578741117,3578741128,11
2,1160,26983,3578741117,3578741131,14
2,1160,26984,3578741117,3578741132,15
2,1160,26985,3578741117,3578741133,16
2,1160,26986,3578741117,3578741133,16
2,1160,26987,3578741117,3578741134,17
2,1160,26988,3578741117,3578741134,17
2,1160,26989,3578741117,3578741135,18
2,1160,26990,3578741117,3578741137,20
2,1160,26991,3578741117,3578741138,21
2,1160,26992,3578741117,3578741138,21
2,1160,26993,3578741117,3578741139,22
2,1160,26994,3578741117,3578741139,22
2,1160,26995,3578741117,3578741140,23
2,1160,26996,3578741117,3578741140,23
2,1160,26997,3578741117,3578741141,24
2,1160,26998,3578741117,3578741142,25
2,1160,26999,3578741117,3578741143,26
2,1160,27000,3578741117,3578741144,27
2,1160,27001,3578741117,3578741144,27
2,1160,27002,3578741117,3578741144,27
2,1160,27003,3578741117,3578741144,27
2,1160,27004,3578741117,3578741149,32
2,1160,27005,3578741117,3578741149,32
2,1160,27006,3578741117,3578741152,35
2,1160,27007,3578741117,3578741154,37
2,1160,27008,3578741117,3578741154,37
2,1160,27009,3578741117,3578741155,38
2,1160,27010,3578741117,3578741155,38
2,1160,27011,3578741117,3578741155,38
2,1160,27012,3578741117,3578741155,38
2,1160,27013,3578741117,3578741158,41
2,1160,27014,3578741117,3578741159,42
2,1160,27015,3578741117,3578741162,45
2,1160,27016,3578741117,3578741163,46
2,1160,27017,3578741117,3578741164,47
2,1160,27018,3578741117,3578741166,49
2,1160,27019,3578741117,3578741166,49
2,1160,27020,3578741117,3578741166,49
2,1160,27021,3578741117,3578741166,49
2,1160,27022,3578741117,3578741167,50
2,1161,27023,3578741181,3578741181,0
2,1161,27024,3578741181,3578741181,0
2,1161,27025,3578741181,3578741181,0
2,1161,27026,3578741181,3578741181,0
2,1161,27027,3578741181,3578741181,0
2,1161,27028,3578741181,3578741181,0
2,1161,27029,3578741181,3578741181,0
2,1161,27030,3578741181,3578741181,0
2,1161,27031,3578741181,3578741181,0
2,1161,27032,3578741181,3578741181,0
2,1161,27033,3578741181,3578741181,0
2,1161,27034,3578741181,3578741181,0
2,1161,27035,3578741181,3578741181,0
2,1161,27036,3578741181,3578741181,0
2,1161,27037,3578741181,3578741181,0
2,1161,27038,3578741181,3578741181,0
2,1161,27039,3578741181,3578741184,3
2,1161,27040,3578741181,3578741184,3
2,1161,27041,3578741181,3578741184,3
2,1161,27042,3578741181,3578741185,4
2,1161,27043,3578741181,3578741185,4
2,1161,27044,3578741181,3578741186,5
2,1161,27045,3578741181,3578741189,8
2,1161,27046,3578741181,3578741189,8
2,1161,27047,3578741181,3578741190,9
2,1161,27048,3578741181,3578741191,10
2,1161,27049,3578741181,3578741192,11
2,1161,27050,3578741181,3578741192,11
2,1161,27051,3578741181,3578741193,12
2,1161,27052,3578741181,3578741194,13
2,1161,27053,3578741181,3578741194,13
2,1161,27054,3578741181,3578741194,13
2,1161,27055,3578741181,3578741195,14
2,1161,27056,3578741181,3578741195,14
2,1161,27057,3578741181,3578741197,16
2,1161,27058,3578741181,3578741200,19
2,1161,27059,3578741181,3578741200,19
2,1161,27060,3578741181,3578741200,19
2,1161,27061,3578741181,3578741201,20
2,1161,27062,3578741181,3578741203,22
2,1161,27063,3578741181,3578741204,23
2,1161,27064,3578741181,3578741204,23
2,1161,27065,3578741181,3578741206,25
2,1161,27066,3578741181,3578741207,26
2,1161,27067,3578741181,3578741213,32
2,1161,27068,3578741181,3578741213,32
2,1161,27069,3578741181,3578741214,33
2,1161,27070,3578741181,3578741214,33
2,1161,27071,3578741181,3578741215,34
2,1161,27072,3578741181,3578741215,34
2,1161,27073,3578741181,3578741217,36
2,1161,27074,3578741181,3578741218,37
2,1161,27075,3578741181,3578741221,40
2,1161,27076,3578741181,3578741221,40
2,1161,27077,3578741181,3578741221,40
2,1161,27078,3578741181,3578741223,42
2,1161,27079,3578741181,3578741224,43
2,1161,27080,3578741181,3578741226,45
2,1161,27081,3578741181,3578741226,45
2,1161,27082,3578741181,3578741226,45
2,1161,27083,3578741181,3578741227,46
2,1161,27084,3578741181,3578741227,46
2,1161,27085,3578741181,3578741228,47
2,1161,27086,3578741181,3578741228,47
2,1161,27087,3578741181,3578741229,48
2,1161,27088,3578741181,3578741230,49
2,1162,27089,3578741242,3578741242,0
2,1162,27090,3578741242,3578741242,0
2,1162,27091,3578741242,3578741242,0
2,1162,27092,3578741242,3578741242,0
2,1162,27093,3578741242,3578741242,0
2,1162,27094,3578741242,3578741242,0
2,1162,27095,3578741242,3578741242,0
2,1162,27096,3578741242,3578741242,0
2,1162,27097,3578741242,3578741242,0
2,1162,27098,3578741242,3578741242,0
2,1162,27099,3578741242,3578741242,0
2,1162,27100,3578741242,3578741242,0
2,1162,27101,3578741242,3578741242,0
2,1162,27102,3578741242,3578741242,0
2,1162,27103,3578741242,3578741242,0
2,1162,27104,3578741242,3578741242,0
2,1162,27105,3578741242,3578741242,0
2,1162,27106,3578741242,3578741242,0
2,1162,27107,3578741242,3578741242,0
2,1162,27108,3578741242,3578741242,0
2,1162,27109,3578741242,3578741242,0
2,1162,27110,3578741242,3578741243,1
2,1162,27111,3578741242,3578741246,4
2,1162,27112,3578741242,3578741246,4
2,1162,27113,3578741242,3578741246,4
2,1162,27114,3578741242,3578741246,4
2,1162,27115,3578741242,3578741247,5
2,1162,27116,3578741242,3578741247,5
2,1162,27117,3578741242,3578741248,6
2,1162,27118,3578741242,3578741250,8
2,1162,27119,3578741242,3578741250,8
2,1162,27120,3578741242,3578741251,9
2,1162,27121,3578741242,3578741252,10
2,1162,27122,3578741242,3578741252,10
2,1162,27123,3578741242,3578741252,10
2,1162,27124,3578741242,3578741254,12
2,1162,27125,3578741242,3578741254,12
2,1162,27126,3578741242,3578741255,13
2,1162,27127,3578741242,3578741255,13
2,1162,27128,3578741242,3578741256,14
2,1162,27129,3578741242,3578741256,14
2,1162,27130,3578741242,3578741257,15
2,1162,27131,3578741242,3578741258,16
2,1162,27132,3578741242,3578741259,17
2,1162,27133,3578741242,3578741259,17
2,1162,27134,3578741242,3578741260,18
2,1162,27135,3578741242,3578741261,19
2,1162,27136,3578741242,3578741262,20
2,1162,27137,3578741242,3578741262,20
2,1162,27138,3578741242,3578741265,23
2,1162,27139,3578741242,3578741267,25
2,1162,27140,3578741242,3578741267,25
2,1162,27141,3578741242,3578741268,26
2,1162,27142,3578741242,3578741268,26
2,1162,27143,3578741242,3578741269,27
2,1162,27144,3578741242,3578741269,27
2,1162,27145,3578741242,3578741270,28
2,1162,27146,3578741242,3578741271,29
2,1162,27147,3578741242,3578741272,30
2,1162,27148,3578741242,3578741277,35
2,1162,27149,3578741242,3578741279,37
2,1162,27150,3578741242,3578741281,39
2,1162,27151,3578741242,3578741282,40
2,1162,27152,3578741242,3578741283,41
2,1162,27153,3578741242,3578741283,41
2,1162,27154,3578741242,3578741284,42
2,1162,27155,3578741242,3578741285,43
2,1162,27156,3578741242,3578741285,43
2,1162,27157,3578741242,3578741286,44
2,1162,27158,3578741242,3578741287,45
2,1162,27159,3578741242,3578741288,46
2,1162,27160,3578741242,3578741288,46
2,1162,27161,3578741242,3578741289,47
2,1162,27162,3578741242,3578741290,48
2,1162,27163,3578741242,3578741290,48
2,1163,27164,3578741302,3578741302,0
2,1163,27165,3578741302,3578741302,0
2,1163,27166,3578741302,3578741302,0
2,1163,27167,3578741302,3578741302,0
2,1163,27168,3578741302,3578741302,0
2,1163,27169,3578741302,3578741302,0
2,1163,27170,3578741302,3578741302,0
2,1163,27171,3578741302,3578741302,0
2,1163,27172,3578741302,3578741302,0
2,1163,27173,3578741302,3578741302,0
2,1163,27174,3578741302,3578741302,0
2,1163,27175,3578741302,3578741302,0
2,1163,27176,3578741302,3578741302,0
2,1163,27177,3578741302,3578741302,0
2,1163,27178,3578741302,3578741302,0
2,1163,27179,3578741302,3578741302,0
2,1163,27180,3578741302,3578741302,0
2,1163,27181,3578741302,3578741302,0
2,1163,27182,3578741302,3578741302,0
2,1163,27183,3578741302,3578741303,1
2,1163,27184,3578741302,3578741305,3
2,1163,27185,3578741302,3578741306,4
2,1163,27186,3578741302,3578741309,7
2,1163,27187,3578741302,3578741310,8
2,1163,27188,3578741302,3578741310,8
2,1163,27189,3578741302,3578741310,8
2,1163,27190,3578741302,3578741313,11
2,1163,27191,3578741302,3578741313,11
2,1163,27192,3578741302,3578741313,11
2,1163,27193,3578741302,3578741315,13
2,1163,27194,3578741302,3578741315,13
2,1163,27195,3578741302,3578741316,14
2,1163,27196,3578741302,3578741316,14
2,1163,27197,3578741302,3578741316,14
2,1163,27198,3578741302,3578741317,15
2,1163,27199,3578741302,3578741318,16
2,1163,27200,3578741302,3578741318,16
2,1163,27201,3578741302,3578741319,17
2,1163,27202,3578741302,3578741321,19
2,1163,27203,3578741302,3578741322,20
2,1163,27204,3578741302,3578741322,20
2,1163,27205,3578741302,3578741322,20
2,1163,27206,3578741302,3578741322,20
2,1163,27207,3578741302,3578741323,21
2,1163,27208,3578741302,3578741324,22
2,1163,27209,3578741302,3578741324,22
2,1163,27210,3578741302,3578741324,22
2,1163,27211,3578741302,3578741325,23
2,1163,27212,3578741302,3578741326,24
2,1163,27213,3578741302,3578741326,24
2,1163,27214,3578741302,3578741327,25
2,1163,27215,3578741302,3578741327,25
2,1163,27216,3578741302,3578741328,26
2,1163,27217,3578741302,3578741329,27
2,1163,27218,3578741302,3578741329,27
2,1163,27219,3578741302,3578741331,29
2,1163,27220,3578741302,3578741333,31
2,1163,27221,3578741302,3578741333,31
2,1163,27222,3578741302,3578741333,31
2,1163,27223,3578741302,3578741335,33
2,1163,27224,3578741302,3578741336,34
2,1163,27225,3578741302,3578741337,35
2,1163,27226,3578741302,3578741338,36
2,1163,27227,3578741302,3578741338,36
2,1163,27228,3578741302,3578741338,36
2,1163,27229,3578741302,3578741339,37
2,1163,27230,3578741302,3578741340,38
2,1163,27231,3578741302,3578741341,39
2,1163,27232,3578741302,3578741341,39
2,1163,27233,3578741302,3578741343,41
2,1163,27234,3578741302,3578741343,41
2,1163,27235,3578741302,3578741344,42
2,1163,27236,3578741302,3578741344,42
2,1163,27237,3578741302,3578741344,42
2,1163,27238,3578741302,3578741344,42
2,1163,27239,3578741302,3578741348,46
2,1163,27240,3578741302,3578741348,46
2,1163,27241,3578741302,3578741349,47
2,1163,27242,3578741302,3578741352,50
2,1164,27243,3578741366,3578741367,1
2,1164,27244,3578741366,3578741367,1
2,1164,27245,3578741366,3578741367,1
2,1164,27246,3578741366,3578741367,1
2,1164,27247,3578741366,3578741367,1
2,1164,27248,3578741366,3578741367,1
2,1164,27249,3578741366,3578741367,1
2,1164,27250,3578741366,3578741367,1
2,1164,27251,3578741366,3578741367,1
2,1164,27252,3578741366,3578741367,1
2,1164,27253,3578741366,3578741367,1
2,1164,27254,3578741366,3578741367,1
2,1164,27255,3578741366,3578741367,1
2,1164,27256,3578741366,3578741367,1
2,1164,27257,3578741366,3578741367,1
2,1164,27258,3578741366,3578741367,1
2,1164,27259,3578741366,3578741367,1
2,1164,27260,3578741366,3578741367,1
2,1164,27261,3578741366,3578741368,2
2,1164,27262,3578741366,3578741369,3
2,1164,27263,3578741366,3578741370,4
2,1164,27264,3578741366,3578741373,7
2,1164,27265,3578741366,3578741375,9
2,1164,27266,3578741366,3578741378,12
2,1164,27267,3578741366,3578741378,12
2,1164,27268,3578741366,3578741378,12
2,1164,27269,3578741366,3578741379,13
2,1164,27270,3578741366,3578741379,13
2,1164,27271,3578741366,3578741380,14
2,1164,27272,3578741366,3578741380,14
2,1164,27273,3578741366,3578741381,15
2,1164,27274,3578741366,3578741381,15
2,1164,27275,3578741366,3578741384,18
2,1164,27276,3578741366,3578741384,18
2,1164,27277,3578741366,3578741384,18
2,1164,27278,3578741366,3578741384,18
2,1164,27279,3578741366,3578741385,19
2,1164,27280,3578741366,3578741385,19
2,1164,27281,3578741366,3578741389,23
2,1164,27282,3578741366,3578741389,23
2,1164,27283,3578741366,3578741390,24
2,1164,27284,3578741366,3578741391,25
2,1164,27285,3578741366,3578741391,25
2,1164,27286,3578741366,3578741391,25
2,1164,27287,3578741366,3578741393,27
2,1164,27288,3578741366,3578741393,27
2,1164,27289,3578741366,3578741394,28
2,1164,27290,3578741366,3578741394,28
2,1164,27291,3578741366,3578741395,29
2,1164,27292,3578741366,3578741397,31
2,1164,27293,3578741366,3578741400,34
2,1164,27294,3578741366,3578741400,34
2,1164,27295,3578741366,3578741401,35
2,1164,27296,3578741366,3578741403,37
2,1164,27297,3578741366,3578741404,38
2,1164,27298,3578741366,3578741405,39
2,1164,27299,3578741366,3578741406,40
2,1164,27300,3578741366,3578741407,41
2,1164,27301,3578741366,3578741413,47
2,1164,27302,3578741366,3578741413,47
2,1164,27303,3578741366,3578741414,48
2,1164,27304,3578741366,3578741415,49
2,1164,27305,3578741366,3578741415,49
2,1164,27306,3578741366,3578741416,50
2,1165,27307,3578741427,3578741427,0
2,1165,27308,3578741427,3578741427,0
2,1165,27309,3578741427,3578741427,0
2,1165,27310,3578741427,3578741427,0
2,1165,27311,3578741427,3578741427,0
2,1165,27312,3578741427,3578741427,0
2,1165,27313,3578741427,3578741427,0
2,1165,27314,3578741427,3578741427,0
2,1165,27315,3578741427,3578741427,0
2,1165,27316,3578741427,3578741427,0
2,1165,27317,3578741427,3578741427,0
2,1165,27318,3578741427,3578741427,0
2,1165,27319,3578741427,3578741427,0
2,1165,27320,3578741427,3578741428,1
2,1165,27321,3578741427,3578741428,1
2,1165,27322,3578741427,3578741430,3
2,1165,27323,3578741427,3578741430,3
2,1165,27324,3578741427,3578741431,4
2,1165,27325,3578741427,3578741432,5
2,1165,27326,3578741427,3578741432,5
2,1165,27327,3578741427,3578741432,5
2,1165,27328,3578741427,3578741432,5
2,1165,27329,3578741427,3578741432,5
2,1165,27330,3578741427,3578741433,6
2,1165,27331,3578741427,3578741433,6
2,1165,27332,3578741427,3578741434,7
2,1165,27333,3578741427,3578741436,9
2,1165,27334,3578741427,3578741437,10
2,1165,27335,3578741427,3578741437,10
2,1165,27336,3578741427,3578741438,11
2,1165,27337,3578741427,3578741438,11
2,1165,27338,3578741427,3578741438,11
2,1165,27339,3578741427,3578741439,12
2,1165,27340,3578741427,3578741441,14
2,1165,27341,3578741427,3578741441,14
2,1165,27342,3578741427,3578741442,15
2,1165,27343,3578741427,3578741442,15
2,1165,27344,3578741427,3578741442,15
2,1165,27345,3578741427,3578741443,16
2,1165,27346,3578741427,3578741443,16
2,1165,27347,3578741427,3578741446,19
2,1165,27348,3578741427,3578741447,20
2,1165,27349,3578741427,3578741447,20
2,1165,27350,3578741427,3578741447,20
2,1165,27351,3578741427,3578741447,20
2,1165,27352,3578741427,3578741448,21
2,1165,27353,3578741427,3578741450,23
2,1165,27354,3578741427,3578741450,23
2,1165,27355,3578741427,3578741451,24
2,1165,27356,3578741427,3578741452,25
2,1165,27357,3578741427,3578741452,25
2,1165,27358,3578741427,3578741453,26
2,1165,27359,3578741427,3578741453,26
2,1165,27360,3578741427,3578741455,28
2,1165,27361,3578741427,3578741456,29
2,1165,27362,3578741427,3578741456,29
2,1165,27363,3578741427,3578741458,31
2,1165,27364,3578741427,3578741460,33
2,1165,27365,3578741427,3578741460,33
2,1165,27366,3578741427,3578741461,34
2,1165,27367,3578741427,3578741462,35
2,1165,27368,3578741427,3578741462,35
2,1165,27369,3578741427,3578741465,38
2,1165,27370,3578741427,3578741465,38
2,1165,27371,3578741427,3578741467,40
2,1165,27372,3578741427,3578741467,40
2,1165,27373,3578741427,3578741468,41
2,1165,27374,3578741427,3578741469,42
2,1165,27375,3578741427,3578741469,42
2,1165,27376,3578741427,3578741471,44
2,1165,27377,3578741427,3578741471,44
2,1165,27378,3578741427,3578741471,44
2,1166,27379,3578741489,3578741489,0
2,1166,27380,3578741489,3578741489,0
2,1166,27381,3578741489,3578741489,0
2,1166,27382,3578741489,3578741489,0
2,1166,27383,3578741489,3578741489,0
2,1166,27384,3578741489,3578741489,0
2,1166,27385,3578741489,3578741489,0
2,1166,27386,3578741489,3578741489,0
2,1166,27387,3578741489,3578741489,0
2,1166,27388,3578741489,3578741489,0
2,1166,27389,3578741489,3578741489,0
2,1166,27390,3578741489,3578741489,0
2,1166,27391,3578741489,3578741489,0
2,1166,27392,3578741489,3578741489,0
2,1166,27393,3578741489,3578741489,0
2,1166,27394,3578741489,3578741492,3
2,1166,27395,3578741489,3578741492,3
2,1166,27396,3578741489,3578741492,3
2,1166,27397,3578741489,3578741492,3
2,1166,27398,3578741489,3578741493,4
2,1166,27399,3578741489,3578741494,5
2,1166,27400,3578741489,3578741494,5
2,1166,27401,3578741489,3578741495,6
2,1166,27402,3578741489,3578741495,6
2,1166,27403,3578741489,3578741496,7
2,1166,27404,3578741489,3578741496,7
2,1166,27405,3578741489,3578741496,7
2,1166,27406,3578741489,3578741497,8
2,1166,27407,3578741489,3578741497,8
2,1166,27408,3578741489,3578741498,9
2,1166,27409,3578741489,3578741499,10
2,1166,27410,3578741489,3578741500,11
2,1166,27411,3578741489,3578741501,12
2,1166,27412,3578741489,3578741502,13
2,1166,27413,3578741489,3578741504,15
2,1166,27414,3578741489,3578741506,17
2,1166,27415,3578741489,3578741507,18
2,1166,27416,3578741489,3578741508,19
2,1166,27417,3578741489,3578741508,19
2,1166,27418,3578741489,3578741509,20
2,1166,27419,3578741489,3578741510,21
2,1166,27420,3578741489,3578741510,21
2,1166,27421,3578741489,3578741511,22
2,1166,27422,3578741489,3578741512,23
2,1166,27423,3578741489,3578741512,23
2,1166,27424,3578741489,3578741515,26
2,1166,27425,3578741489,3578741515,26
2,1166,27426,3578741489,3578741515,26
2,1166,27427,3578741489,3578741515,26
2,1166,27428,3578741489,3578741517,28
2,1166,27429,3578741489,3578741517,28
2,1166,27430,3578741489,3578741518,29
2,1166,27431,3578741489,3578741520,31
2,1166,27432,3578741489,3578741521,32
2,1166,27433,3578741489,3578741521,32
2,1166,27434,3578741489,3578741521,32
2,1166,27435,3578741489,3578741522,33
2,1166,27436,3578741489,3578741522,33
2,1166,27437,3578741489,3578741523,34
2,1166,27438,3578741489,3578741523,34
2,1166,27439,3578741489,3578741524,35
2,1166,27440,3578741489,3578741524,35
2,1166,27441,3578741489,3578741524,35
2,1166,27442,3578741489,3578741525,36
2,1166,27443,3578741489,3578741526,37
2,1166,27444,3578741489,3578741526,37
2,1166,27445,3578741489,3578741528,39
2,1166,27446,3578741489,3578741528,39
2,1166,27447,3578741489,3578741528,39
2,1166,27448,3578741489,3578741530,41
2,1166,27449,3578741489,3578741531,42
2,1166,27450,3578741489,3578741532,43
2,1166,27451,3578741489,3578741533,44
2,1166,27452,3578741489,3578741535,46
2,1166,27453,3578741489,3578741536,47
2,1166,27454,3578741489,3578741536,47
2,1166,27455,3578741489,3578741537,48
2,1166,27456,3578741489,3578741538,49
2,1166,27457,3578741489,3578741538,49
2,1166,27458,3578741489,3578741538,49
2,1167,27459,3578741552,3578741552,0
2,1167,27460,3578741552,3578741552,0
2,1167,27461,3578741552,3578741552,0
2,1167,27462,3578741552,3578741552,0
2,1167,27463,3578741552,3578741552,0
2,1167,27464,3578741552,3578741552,0
2,1167,27465,3578741552,3578741552,0
2,1167,27466,3578741552,3578741552,0
2,1167,27467,3578741552,3578741552,0
2,1167,27468,3578741552,3578741552,0
2,1167,27469,3578741552,3578741552,0
2,1167,27470,3578741552,3578741552,0
2,1167,27471,3578741552,3578741552,0
2,1167,27472,3578741552,3578741552,0
2,1167,27473,3578741552,3578741552,0
2,1167,27474,3578741552,3578741553,1
2,1167,27475,3578741552,3578741554,2
2,1167,27476,3578741552,3578741555,3
2,1167,27477,3578741552,3578741555,3
2,1167,27478,3578741552,3578741555,3
2,1167,27479,3578741552,3578741555,3
2,1167,27480,3578741552,3578741556,4
2,1167,27481,3578741552,3578741557,5
2,1167,27482,3578741552,3578741559,7
2,1167,27483,3578741552,3578741561,9
2,1167,27484,3578741552,3578741561,9
2,1167,27485,3578741552,3578741562,10
2,1167,27486,3578741552,3578741563,11
2,1167,27487,3578741552,3578741564,12
2,1167,27488,3578741552,3578741564,12
2,1167,27489,3578741552,3578741565,13
2,1167,27490,3578741552,3578741566,14
2,1167,27491,3578741552,3578741566,14
2,1167,27492,3578741552,3578741567,15
2,1167,27493,3578741552,3578741568,16
2,1167,27494,3578741552,3578741568,16
2,1167,27495,3578741552,3578741568,16
2,1167,27496,3578741552,3578741571,19
2,1167,27497,3578741552,3578741575,23
2,1167,27498,3578741552,3578741577,25
2,1167,27499,3578741552,3578741577,25
2,1167,27500,3578741552,3578741578,26
2,1167,27501,3578741552,3578741578,26
2,1167,27502,3578741552,3578741579,27
2,1167,27503,3578741552,3578741580,28
2,1167,27504,3578741552,3578741581,29
2,1167,27505,3578741552,3578741583,31
2,1167,27506,3578741552,3578741583,31
2,1167,27507,3578741552,3578741584,32
2,1167,27508,3578741552,3578741585,33
2,1167,27509,3578741552,3578741585,33
2,1167,27510,3578741552,3578741587,35
2,1167,27511,3578741552,3578741588,36
2,1167,27512,3578741552,3578741589,37
2,1167,27513,3578741552,3578741589,37
2,1167,27514,3578741552,3578741589,37
2,1167,27515,3578741552,3578741590,38
2,1167,27516,3578741552,3578741591,39
2,1167,27517,3578741552,3578741594,42
2,1167,27518,3578741552,3578741594,42
2,1167,27519,3578741552,3578741594,42
2,1167,27520,3578741552,3578741594,42
2,1167,27521,3578741552,3578741594,42
2,1167,27522,3578741552,3578741596,44
2,1167,27523,3578741552,3578741599,47
2,1167,27524,3578741552,3578741599,47
2,1167,27525,3578741552,3578741599,47
2,1167,27526,3578741552,3578741600,48
2,1168,27527,3578741615,3578741615,0
2,1168,27528,3578741615,3578741615,0
2,1168,27529,3578741615,3578741615,0
2,1168,27530,3578741615,3578741616,1
2,1168,27531,3578741615,3578741616,1
2,1168,27532,3578741615,3578741616,1
2,1168,27533,3578741615,3578741616,1
2,1168,27534,3578741615,3578741616,1
2,1168,27535,3578741615,3578741616,1
2,1168,27536,3578741615,3578741616,1
2,1168,27537,3578741615,3578741616,1
2,1168,27538,3578741615,3578741621,6
2,1168,27539,3578741615,3578741621,6
2,1168,27540,3578741615,3578741622,7
2,1168,27541,3578741615,3578741622,7
2,1168,27542,3578741615,3578741622,7
2,1168,27543,3578741615,3578741623,8
2,1168,27544,3578741615,3578741625,10
2,1168,27545,3578741615,3578741625,10
2,1168,27546,3578741615,3578741626,11
2,1168,27547,3578741615,3578741627,12
2,1168,27548,3578741615,3578741628,13
2,1168,27549,3578741615,3578741628,13
2,1168,27550,3578741615,3578741632,17
2,1168,27551,3578741615,3578741632,17
2,1168,27552,3578741615,3578741632,17
2,1168,27553,3578741615,3578741632,17
2,1168,27554,3578741615,3578741632,17
2,1168,27555,3578741615,3578741632,17
2,1168,27556,3578741615,3578741632,17
2,1168,27557,3578741615,3578741632,17
2,1168,27558,3578741615,3578741633,18
2,1168,27559,3578741615,3578741633,18
2,1168,27560,3578741615,3578741635,20
2,1168,27561,3578741615,3578741636,21
2,1168,27562,3578741615,3578741636,21
2,1168,27563,3578741615,3578741637,22
2,1168,27564,3578741615,3578741638,23
2,1168,27565,3578741615,3578741638,23
2,1168,27566,3578741615,3578741640,25
2,1168,27567,3578741615,3578741641,26
2,1168,27568,3578741615,3578741641,26
2,1168,27569,3578741615,3578741641,26
2,1168,27570,3578741615,3578741641,26
2,1168,27571,3578741615,3578741641,26
2,1168,27572,3578741615,3578741642,27
2,1168,27573,3578741615,3578741645,30
2,1168,27574,3578741615,3578741646,31
2,1168,27575,3578741615,3578741646,31
2,1168,27576,3578741615,3578741646,31
2,1168,27577,3578741615,3578741646,31
2,1168,27578,3578741615,3578741648,33
2,1168,27579,3578741615,3578741650,35
2,1168,27580,3578741615,3578741650,35
2,1168,27581,3578741615,3578741651,36
2,1168,27582,3578741615,3578741651,36
2,1168,27583,3578741615,3578741652,37
2,1168,27584,3578741615,3578741652,37
2,1168,27585,3578741615,3578741653,38
2,1168,27586,3578741615,3578741654,39
2,1168,27587,3578741615,3578741655,40
2,1168,27588,3578741615,3578741655,40
2,1168,27589,3578741615,3578741657,42
2,1168,27590,3578741615,3578741659,44
2,1168,27591,3578741615,3578741660,45
2,1168,27592,3578741615,3578741660,45
2,1168,27593,3578741615,3578741661,46
2,1169,27594,3578741677,3578741677,0
2,1169,27595,3578741677,3578741677,0
2,1169,27596,3578741677,3578741677,0
2,1169,27597,3578741677,3578741677,0
2,1169,27598,3578741677,3578741677,0
2,1169,27599,3578741677,3578741677,0
2,1169,27600,3578741677,3578741677,0
2,1169,27601,3578741677,3578741677,0
2,1169,27602,3578741677,3578741677,0
2,1169,27603,3578741677,3578741677,0
2,1169,27604,3578741677,3578741678,1
2,1169,27605,3578741677,3578741680,3
2,1169,27606,3578741677,3578741681,4
2,1169,27607,3578741677,3578741681,4
2,1169,27608,3578741677,3578741681,4
2,1169,27609,3578741677,3578741683,6
2,1169,27610,3578741677,3578741683,6
2,1169,27611,3578741677,3578741683,6
2,1169,27612,3578741677,3578741684,7
2,1169,27613,3578741677,3578741685,8
2,1169,27614,3578741677,3578741685,8
2,1169,27615,3578741677,3578741687,10
2,1169,27616,3578741677,3578741688,11
2,1169,27617,3578741677,3578741688,11
2,1169,27618,3578741677,3578741689,12
2,1169,27619,3578741677,3578741689,12
2,1169,27620,3578741677,3578741689,12
2,1169,27621,3578741677,3578741690,13
2,1169,27622,3578741677,3578741692,15
2,1169,27623,3578741677,3578741692,15
2,1169,27624,3578741677,3578741692,15
2,1169,27625,3578741677,3578741693,16
2,1169,27626,3578741677,3578741693,16
2,1169,27627,3578741677,3578741693,16
2,1169,27628,3578741677,3578741695,18
2,1169,27629,3578741677,3578741695,18
2,1169,27630,3578741677,3578741695,18
2,1169,27631,3578741677,3578741696,19
2,1169,27632,3578741677,3578741696,19
2,1169,27633,3578741677,3578741696,19
2,1169,27634,3578741677,3578741697,20
2,1169,27635,3578741677,3578741697,20
2,1169,27636,3578741677,3578741698,21
2,1169,27637,3578741677,3578741701,24
2,1169,27638,3578741677,3578741701,24
2,1169,27639,3578741677,3578741703,26
2,1169,27640,3578741677,3578741705,28
2,1169,27641,3578741677,3578741706,29
2,1169,27642,3578741677,3578741707,30
2,1169,27643,3578741677,3578741709,32
2,1169,27644,3578741677,3578741709,32
2,1169,27645,3578741677,3578741709,32
2,1169,27646,3578741677,3578741710,33
2,1169,27647,3578741677,3578741710,33
2,1169,27648,3578741677,3578741711,34
2,1169,27649,3578741677,3578741712,35
2,1169,27650,3578741677,3578741712,35
2,1169,27651,3578741677,3578741714,37
2,1169,27652,3578741677,3578741715,38
2,1169,27653,3578741677,3578741715,38
2,1169,27654,3578741677,3578741715,38
2,1169,27655,3578741677,3578741717,40
2,1169,27656,3578741677,3578741717,40
2,1169,27657,3578741677,3578741717,40
2,1169,27658,3578741677,3578741718,41
2,1169,27659,3578741677,3578741719,42
2,1169,27660,3578741677,3578741720,43
2,1169,27661,3578741677,3578741721,44
2,1169,27662,3578741677,3578741721,44
2,1169,27663,3578741677,3578741721,44
2,1169,27664,3578741677,3578741722,45
2,1169,27665,3578741677,3578741723,46
2,1169,27666,3578741677,3578741723,46
2,1169,27667,3578741677,3578741723,46
2,1169,27668,3578741677,3578741724,47
2,1169,27669,3578741677,3578741725,48
2,1169,27670,3578741677,3578741726,49
2,1169,27671,3578741677,3578741727,50
2,1170,27672,3578741738,3578741738,0
2,1170,27673,3578741738,3578741738,0
2,1170,27674,3578741738,3578741738,0
2,1170,27675,3578741738,3578741738,0
2,1170,27676,3578741738,3578741738,0
2,1170,27677,3578741738,3578741738,0
2,1170,27678,3578741738,3578741738,0
2,1170,27679,3578741738,3578741738,0
2,1170,27680,3578741738,3578741738,0
2,1170,27681,3578741738,3578741738,0
2,1170,27682,3578741738,3578741738,0
2,1170,27683,3578741738,3578741738,0
2,1170,27684,3578741738,3578741740,2
2,1170,27685,3578741738,3578741741,3
2,1170,27686,3578741738,3578741741,3
2,1170,27687,3578741738,3578741742,4
2,1170,27688,3578741738,3578741743,5
2,1170,27689,3578741738,3578741743,5
2,1170,27690,3578741738,3578741743,5
2,1170,27691,3578741738,3578741745,7
2,1170,27692,3578741738,3578741747,9
2,1170,27693,3578741738,3578741748,10
2,1170,27694,3578741738,3578741748,10
2,1170,27695,3578741738,3578741751,13
2,1170,27696,3578741738,3578741751,13
2,1170,27697,3578741738,3578741752,14
2,1170,27698,3578741738,3578741754,16
2,1170,27699,3578741738,3578741754,16
2,1170,27700,3578741738,3578741755,17
2,1170,27701,3578741738,3578741755,17
2,1170,27702,3578741738,3578741755,17
2,1170,27703,3578741738,3578741756,18
2,1170,27704,3578741738,3578741757,19
2,1170,27705,3578741738,3578741757,19
2,1170,27706,3578741738,3578741759,21
2,1170,27707,3578741738,3578741761,23
2,1170,27708,3578741738,3578741761,23
2,1170,27709,3578741738,3578741764,26
2,1170,27710,3578741738,3578741764,26
2,1170,27711,3578741738,3578741764,26
2,1170,27712,3578741738,3578741764,26
2,1170,27713,3578741738,3578741765,27
2,1170,27714,3578741738,3578741766,28
2,1170,27715,3578741738,3578741766,28
2,1170,27716,3578741738,3578741767,29
2,1170,27717,3578741738,3578741768,30
2,1170,27718,3578741738,3578741768,30
2,1170,27719,3578741738,3578741769,31
2,1170,27720,3578741738,3578741772,34
2,1170,27721,3578741738,3578741774,36
2,1170,27722,3578741738,3578741775,37
2,1170,27723,3578741738,3578741777,39
2,1170,27724,3578741738,3578741778,40
2,1170,27725,3578741738,3578741778,40
2,1170,27726,3578741738,3578741778,40
2,1170,27727,3578741738,3578741779,41
2,1170,27728,3578741738,3578741779,41
2,1170,27729,3578741738,3578741779,41
2,1170,27730,3578741738,3578741780,42
2,1170,27731,3578741738,3578741781,43
2,1170,27732,3578741738,3578741783,45
2,1170,27733,3578741738,3578741784,46
2,1170,27734,3578741738,3578741784,46
2,1170,27735,3578741738,3578741784,46
2,1170,27736,3578741738,3578741785,47
2,1171,27737,3578741800,3578741800,0
2,1171,27738,3578741800,3578741800,0
2,1171,27739,3578741800,3578741800,0
2,1171,27740,3578741800,3578741800,0
2,1171,27741,3578741800,3578741800,0
2,1171,27742,3578741800,3578741800,0
2,1171,27743,3578741800,3578741800,0
2,1171,27744,3578741800,3578741800,0
2,1171,27745,3578741800,3578741800,0
2,1171,27746,3578741800,3578741800,0
2,1171,27747,3578741800,3578741800,0
2,1171,27748,3578741800,3578741800,0
2,1171,27749,3578741800,3578741800,0
2,1171,27750,3578741800,3578741800,0
2,1171,27751,3578741800,3578741800,0
2,1171,27752,3578741800,3578741800,0
2,1171,27753,3578741800,3578741800,0
2,1171,27754,3578741800,3578741800,0
2,1171,27755,3578741800,3578741803,3
2,1171,27756,3578741800,3578741803,3
2,1171,27757,3578741800,3578741804,4
2,1171,27758,3578741800,3578741806,6
2,1171,27759,3578741800,3578741806,6
2,1171,27760,3578741800,3578741812,12
2,1171,27761,3578741800,3578741812,12
2,1171,27762,3578741800,3578741813,13
2,1171,27763,3578741800,3578741814,14
2,1171,27764,3578741800,3578741814,14
2,1171,27765,3578741800,3578741816,16
2,1171,27766,3578741800,3578741816,16
2,1171,27767,3578741800,3578741817,17
2,1171,27768,3578741800,3578741821,21
2,1171,27769,3578741800,3578741821,21
2,1171,27770,3578741800,3578741822,22
2,1171,27771,3578741800,3578741822,22
2,1171,27772,3578741800,3578741823,23
2,1171,27773,3578741800,3578741826,26
2,1171,27774,3578741800,3578741826,26
2,1171,27775,3578741800,3578741826,26
2,1171,27776,3578741800,3578741826,26
2,1171,27777,3578741800,3578741828,28
2,1171,27778,3578741800,3578741828,28
2,1171,27779,3578741800,3578741829,29
2,1171,27780,3578741800,3578741830,30
2,1171,27781,3578741800,3578741830,30
2,1171,27782,3578741800,3578741830,30
2,1171,27783,3578741800,3578741832,32
2,1171,27784,3578741800,3578741832,32
2,1171,27785,3578741800,3578741832,32
2,1171,27786,3578741800,3578741832,32
2,1171,27787,3578741800,3578741833,33
2,1171,27788,3578741800,3578741833,33
2,1171,27789,3578741800,3578741833,33
2,1171,27790,3578741800,3578741835,35
2,1171,27791,3578741800,3578741837,37
2,1171,27792,3578741800,3578741837,37
2,1171,27793,3578741800,3578741838,38
2,1171,27794,3578741800,3578741838,38
2,1171,27795,3578741800,3578741840,40
2,1171,27796,3578741800,3578741840,40
2,1171,27797,3578741800,3578741840,40
2,1171,27798,3578741800,3578741841,41
2,1171,27799,3578741800,3578741841,41
2,1171,27800,3578741800,3578741841,41
2,1171,27801,3578741800,3578741842,42
2,1171,27802,3578741800,3578741845,45
2,1171,27803,3578741800,3578741845,45
2,1171,27804,3578741800,3578741845,45
2,1171,27805,3578741800,3578741846,46
2,1171,27806,3578741800,3578741847,47
2,1171,27807,3578741800,3578741849,49
2,1171,27808,3578741800,3578741850,50
2,1172,27809,3578741861,3578741861,0
2,1172,27810,3578741861,3578741861,0
2,1172,27811,3578741861,3578741861,0
2,1172,27812,3578741861,3578741861,0
2,1172,27813,3578741861,3578741861,0
2,1172,27814,3578741861,3578741861,0
2,1172,27815,3578741861,3578741861,0
2,1172,27816,3578741861,3578741861,0
2,1172,27817,3578741861,3578741861,0
2,1172,27818,3578741861,3578741861,0
2,1172,27819,3578741861,3578741861,0
2,1172,27820,3578741861,3578741861,0
2,1172,27821,3578741861,3578741861,0
2,1172,27822,3578741861,3578741861,0
2,1172,27823,3578741861,3578741861,0
2,1172,27824,3578741861,3578741861,0
2,1172,27825,3578741861,3578741866,5
2,1172,27826,3578741861,3578741866,5
2,1172,27827,3578741861,3578741867,6
2,1172,27828,3578741861,3578741867,6
2,1172,27829,3578741861,3578741870,9
2,1172,27830,3578741861,3578741871,10
2,1172,27831,3578741861,3578741871,10
2,1172,27832,3578741861,3578741871,10
2,1172,27833,3578741861,3578741878,17
2,1172,27834,3578741861,3578741878,17
2,1172,27835,3578741861,3578741881,20
2,1172,27836,3578741861,3578741881,20
2,1172,27837,3578741861,3578741881,20
2,1172,27838,3578741861,3578741882,21
2,1172,27839,3578741861,3578741882,21
2,1172,27840,3578741861,3578741883,22
2,1172,27841,3578741861,3578741885,24
2,1172,27842,3578741861,3578741885,24
2,1172,27843,3578741861,3578741885,24
2,1172,27844,3578741861,3578741887,26
2,1172,27845,3578741861,3578741888,27
2,1172,27846,3578741861,3578741888,27
2,1172,27847,3578741861,3578741888,27
2,1172,27848,3578741861,3578741889,28
2,1172,27849,3578741861,3578741889,28
2,1172,27850,3578741861,3578741890,29
2,1172,27851,3578741861,3578741890,29
2,1172,27852,3578741861,3578741892,31
2,1172,27853,3578741861,3578741893,32
2,1172,27854,3578741861,3578741893,32
2,1172,27855,3578741861,3578741893,32
2,1172,27856,3578741861,3578741893,32
2,1172,27857,3578741861,3578741894,33
2,1172,27858,3578741861,3578741895,34
2,1172,27859,3578741861,3578741895,34
2,1172,27860,3578741861,3578741895,34
2,1172,27861,3578741861,3578741896,35
2,1172,27862,3578741861,3578741896,35
2,1172,27863,3578741861,3578741897,36
2,1172,27864,3578741861,3578741897,36
2,1172,27865,3578741861,3578741898,37
2,1172,27866,3578741861,3578741898,37
2,1172,27867,3578741861,3578741900,39
2,1172,27868,3578741861,3578741900,39
2,1172,27869,3578741861,3578741901,40
2,1172,27870,3578741861,3578741902,41
2,1172,27871,3578741861,3578741906,45
2,1172,27872,3578741861,3578741907,46
2,1172,27873,3578741861,3578741908,47
2,1172,27874,3578741861,3578741909,48
2,1172,27875,3578741861,3578741909,48
2,1172,27876,3578741861,3578741910,49
2,1172,27877,3578741861,3578741910,49
2,1173,27878,3578741924,3578741924,0
2,1173,27879,3578741924,3578741924,0
2,1173,27880,3578741924,3578741924,0
2,1173,27881,3578741924,3578741924,0
2,1173,27882,3578741924,3578741924,0
2,1173,27883,3578741924,3578741924,0
2,1173,27884,3578741924,3578741924,0
2,1173,27885,3578741924,3578741924,0
2,1173,27886,3578741924,3578741924,0
2,1173,27887,3578741924,3578741924,0
2,1173,27888,3578741924,3578741924,0
2,1173,27889,3578741924,3578741924,0
2,1173,27890,3578741924,3578741924,0
2,1173,27891,3578741924,3578741924,0
2,1173,27892,3578741924,3578741924,0
2,1173,27893,3578741924,3578741924,0
2,1173,27894,3578741924,3578741924,0
2,1173,27895,3578741924,3578741924,0
2,1173,27896,3578741924,3578741924,0
2,1173,27897,3578741924,3578741924,0
2,1173,27898,3578741924,3578741924,0
2,1173,27899,3578741924,3578741924,0
2,1173,27900,3578741924,3578741924,0
2,1173,27901,3578741924,3578741925,1
2,1173,27902,3578741924,3578741925,1
2,1173,27903,3578741924,3578741927,3
2,1173,27904,3578741924,3578741928,4
2,1173,27905,3578741924,3578741932,8
2,1173,27906,3578741924,3578741932,8
2,1173,27907,3578741924,3578741933,9
2,1173,27908,3578741924,3578741933,9
2,1173,27909,3578741924,3578741933,9
2,1173,27910,3578741924,3578741933,9
2,1173,27911,3578741924,3578741934,10
2,1173,27912,3578741924,3578741935,11
2,1173,27913,3578741924,3578741935,11
2,1173,27914,3578741924,3578741936,12
2,1173,27915,3578741924,3578741937,13
2,1173,27916,3578741924,3578741937,13
2,1173,27917,3578741924,3578741938,14
2,1173,27918,3578741924,3578741939,15
2,1173,27919,3578741924,3578741940,16
2,1173,27920,3578741924,3578741941,17
2,1173,27921,3578741924,3578741941,17
2,1173,27922,3578741924,3578741942,18
2,1173,27923,3578741924,3578741942,18
2,1173,27924,3578741924,3578741943,19
2,1173,27925,3578741924,3578741944,20
2,1173,27926,3578741924,3578741944,20
2,1173,27927,3578741924,3578741944,20
2,1173,27928,3578741924,3578741947,23
2,1173,27929,3578741924,3578741948,24
2,1173,27930,3578741924,3578741948,24
2,1173,27931,3578741924,3578741951,27
2,1173,27932,3578741924,3578741951,27
2,1173,27933,3578741924,3578741952,28
2,1173,27934,3578741924,3578741955,31
2,1173,27935,3578741924,3578741955,31
2,1173,27936,3578741924,3578741955,31
2,1173,27937,3578741924,3578741955,31
2,1173,27938,3578741924,3578741956,32
2,1173,27939,3578741924,3578741957,33
2,1173,27940,3578741924,3578741957,33
2,1173,27941,3578741924,3578741959,35
2,1173,27942,3578741924,3578741960,36
2,1173,27943,3578741924,3578741963,39
2,1173,27944,3578741924,3578741963,39
2,1173,27945,3578741924,3578741964,40
2,1173,27946,3578741924,3578741965,41
2,1173,27947,3578741924,3578741966,42
2,1173,27948,3578741924,3578741966,42
2,1173,27949,3578741924,3578741966,42
2,1173,27950,3578741924,3578741966,42
2,1173,27951,3578741924,3578741967,43
2,1173,27952,3578741924,3578741968,44
2,1173,27953,3578741924,3578741968,44
2,1173,27954,3578741924,3578741969,45
2,1173,27955,3578741924,3578741973,49
2,1174,27956,3578741987,3578741987,0
2,1174,27957,3578741987,3578741987,0
2,1174,27958,3578741987,3578741987,0
2,1174,27959,3578741987,3578741987,0
2,1174,27960,3578741987,3578741987,0
2,1174,27961,3578741987,3578741987,0
2,1174,27962,3578741987,3578741987,0
2,1174,27963,3578741987,3578741987,0
2,1174,27964,3578741987,3578741987,0
2,1174,27965,3578741987,3578741987,0
2,1174,27966,3578741987,3578741987,0
2,1174,27967,3578741987,3578741987,0
2,1174,27968,3578741987,3578741987,0
2,1174,27969,3578741987,3578741987,0
2,1174,27970,3578741987,3578741987,0
2,1174,27971,3578741987,3578741987,0
2,1174,27972,3578741987,3578741989,2
2,1174,27973,3578741987,3578741990,3
2,1174,27974,3578741987,3578741991,4
2,1174,27975,3578741987,3578741991,4
2,1174,27976,3578741987,3578741993,6
2,1174,27977,3578741987,3578741993,6
2,1174,27978,3578741987,3578741994,7
2,1174,27979,3578741987,3578741994,7
2,1174,27980,3578741987,3578741994,7
2,1174,27981,3578741987,3578741994,7
2,1174,27982,3578741987,3578741994,7
2,1174,27983,3578741987,3578741996,9
2,1174,27984,3578741987,3578741997,10
2,1174,27985,3578741987,3578742000,13
2,1174,27986,3578741987,3578742000,13
2,1174,27987,3578741987,3578742000,13
2,1174,27988,3578741987,3578742003,16
2,1174,27989,3578741987,3578742004,17
2,1174,27990,3578741987,3578742006,19
2,1174,27991,3578741987,3578742007,20
2,1174,27992,3578741987,3578742013,26
2,1174,27993,3578741987,3578742013,26
2,1174,27994,3578741987,3578742014,27
2,1174,27995,3578741987,3578742014,27
2,1174,27996,3578741987,3578742014,27
2,1174,27997,3578741987,3578742015,28
2,1174,27998,3578741987,3578742016,29
2,1174,27999,3578741987,3578742017,30
2,1174,28000,3578741987,3578742019,32
2,1174,28001,3578741987,3578742020,33
2,1174,28002,3578741987,3578742021,34
2,1174,28003,3578741987,3578742022,35
2,1174,28004,3578741987,3578742022,35
2,1174,28005,3578741987,3578742024,37
2,1174,28006,3578741987,3578742026,39
2,1174,28007,3578741987,3578742026,39
2,1174,28008,3578741987,3578742026,39
2,1174,28009,3578741987,3578742027,40
2,1174,28010,3578741987,3578742028,41
2,1174,28011,3578741987,3578742028,41
2,1174,28012,3578741987,3578742029,42
2,1174,28013,3578741987,3578742029,42
2,1174,28014,3578741987,3578742029,42
2,1174,28015,3578741987,3578742030,43
2,1174,28016,3578741987,3578742031,44
2,1174,28017,3578741987,3578742032,45
2,1174,28018,3578741987,3578742032,45
2,1174,28019,3578741987,3578742033,46
2,1174,28020,3578741987,3578742033,46
2,1174,28021,3578741987,3578742033,46
2,1174,28022,3578741987,3578742033,46
2,1174,28023,3578741987,3578742035,48
2,1174,28024,3578741987,3578742037,50
2,1175,28025,3578742051,3578742051,0
2,1175,28026,3578742051,3578742051,0
2,1175,28027,3578742051,3578742051,0
2,1175,28028,3578742051,3578742051,0
2,1175,28029,3578742051,3578742051,0
2,1175,28030,3578742051,3578742051,0
2,1175,28031,3578742051,3578742051,0
2,1175,28032,3578742051,3578742051,0
2,1175,28033,3578742051,3578742051,0
2,1175,28034,3578742051,3578742051,0
2,1175,28035,3578742051,3578742051,0
2,1175,28036,3578742051,3578742051,0
2,1175,28037,3578742051,3578742051,0
2,1175,28038,3578742051,3578742051,0
2,1175,28039,3578742051,3578742051,0
2,1175,28040,3578742051,3578742051,0
2,1175,28041,3578742051,3578742051,0
2,1175,28042,3578742051,3578742051,0
2,1175,28043,3578742051,3578742051,0
2,1175,28044,3578742051,3578742051,0
2,1175,28045,3578742051,3578742051,0
2,1175,28046,3578742051,3578742052,1
2,1175,28047,3578742051,3578742053,2
2,1175,28048,3578742051,3578742054,3
2,1175,28049,3578742051,3578742054,3
2,1175,28050,3578742051,3578742054,3
2,1175,28051,3578742051,3578742055,4
2,1175,28052,3578742051,3578742055,4
2,1175,28053,3578742051,3578742057,6
2,1175,28054,3578742051,3578742058,7
2,1175,28055,3578742051,3578742059,8
2,1175,28056,3578742051,3578742060,9
2,1175,28057,3578742051,3578742060,9
2,1175,28058,3578742051,3578742061,10
2,1175,28059,3578742051,3578742061,10
2,1175,28060,3578742051,3578742065,14
2,1175,28061,3578742051,3578742066,15
2,1175,28062,3578742051,3578742067,16
2,1175,28063,3578742051,3578742067,16
2,1175,28064,3578742051,3578742067,16
2,1175,28065,3578742051,3578742070,19
2,1175,28066,3578742051,3578742070,19
2,1175,28067,3578742051,3578742070,19
2,1175,28068,3578742051,3578742072,21
2,1175,28069,3578742051,3578742077,26
2,1175,28070,3578742051,3578742078,27
2,1175,28071,3578742051,3578742080,29
2,1175,28072,3578742051,3578742081,30
2,1175,28073,3578742051,3578742081,30
2,1175,28074,3578742051,3578742081,30
2,1175,28075,3578742051,3578742082,31
2,1175,28076,3578742051,3578742083,32
2,1175,28077,3578742051,3578742084,33
2,1175,28078,3578742051,3578742084,33
2,1175,28079,3578742051,3578742084,33
2,1175,28080,3578742051,3578742086,35
2,1175,28081,3578742051,3578742086,35
2,1175,28082,3578742051,3578742087,36
2,1175,28083,3578742051,3578742088,37
2,1175,28084,3578742051,3578742089,38
2,1175,28085,3578742051,3578742089,38
2,1175,28086,3578742051,3578742090,39
2,1175,28087,3578742051,3578742092,41
2,1175,28088,3578742051,3578742092,41
2,1175,28089,3578742051,3578742092,41
2,1175,28090,3578742051,3578742093,42
2,1175,28091,3578742051,3578742094,43
2,1175,28092,3578742051,3578742094,43
2,1175,28093,3578742051,3578742095,44
2,1175,28094,3578742051,3578742095,44
2,1175,28095,3578742051,3578742096,45
2,1175,28096,3578742051,3578742096,45
2,1175,28097,3578742051,3578742097,46
2,1175,28098,3578742051,3578742097,46
2,1175,28099,3578742051,3578742097,46
2,1175,28100,3578742051,3578742098,47
2,1175,28101,3578742051,3578742099,48
2,1175,28102,3578742051,3578742100,49
2,1175,28103,3578742051,3578742101,50
2,1176,28104,3578742114,3578742114,0
2,1176,28105,3578742114,3578742114,0
2,1176,28106,3578742114,3578742114,0
2,1176,28107,3578742114,3578742114,0
2,1176,28108,3578742114,3578742114,0
2,1176,28109,3578742114,3578742114,0
2,1176,28110,3578742114,3578742114,0
2,1176,28111,3578742114,3578742114,0
2,1176,28112,3578742114,3578742114,0
2,1176,28113,3578742114,3578742114,0
2,1176,28114,3578742114,3578742114,0
2,1176,28115,3578742114,3578742114,0
2,1176,28116,3578742114,3578742115,1
2,1176,28117,3578742114,3578742115,1
2,1176,28118,3578742114,3578742116,2
2,1176,28119,3578742114,3578742116,2
2,1176,28120,3578742114,3578742117,3
2,1176,28121,3578742114,3578742117,3
2,1176,28122,3578742114,3578742117,3
2,1176,28123,3578742114,3578742118,4
2,1176,28124,3578742114,3578742118,4
2,1176,28125,3578742114,3578742119,5
2,1176,28126,3578742114,3578742121,7
2,1176,28127,3578742114,3578742122,8
2,1176,28128,3578742114,3578742122,8
2,1176,28129,3578742114,3578742122,8
2,1176,28130,3578742114,3578742122,8
2,1176,28131,3578742114,3578742124,10
2,1176,28132,3578742114,3578742124,10
2,1176,28133,3578742114,3578742124,10
2,1176,28134,3578742114,3578742124,10
2,1176,28135,3578742114,3578742125,11
2,1176,28136,3578742114,3578742125,11
2,1176,28137,3578742114,3578742127,13
2,1176,28138,3578742114,3578742128,14
2,1176,28139,3578742114,3578742131,17
2,1176,28140,3578742114,3578742132,18
2,1176,28141,3578742114,3578742132,18
2,1176,28142,3578742114,3578742133,19
2,1176,28143,3578742114,3578742133,19
2,1176,28144,3578742114,3578742133,19
2,1176,28145,3578742114,3578742134,20
2,1176,28146,3578742114,3578742134,20
2,1176,28147,3578742114,3578742135,21
2,1176,28148,3578742114,3578742136,22
2,1176,28149,3578742114,3578742137,23
2,1176,28150,3578742114,3578742138,24
2,1176,28151,3578742114,3578742138,24
2,1176,28152,3578742114,3578742138,24
2,1176,28153,3578742114,3578742140,26
2,1176,28154,3578742114,3578742141,27
2,1176,28155,3578742114,3578742141,27
2,1176,28156,3578742114,3578742142,28
2,1176,28157,3578742114,3578742143,29
2,1176,28158,3578742114,3578742143,29
2,1176,28159,3578742114,3578742144,30
2,1176,28160,3578742114,3578742144,30
2,1176,28161,3578742114,3578742144,30
2,1176,28162,3578742114,3578742147,33
2,1176,28163,3578742114,3578742147,33
2,1176,28164,3578742114,3578742148,34
2,1176,28165,3578742114,3578742151,37
2,1176,28166,3578742114,3578742151,37
2,1176,28167,3578742114,3578742152,38
2,1176,28168,3578742114,3578742154,40
2,1176,28169,3578742114,3578742154,40
2,1176,28170,3578742114,3578742156,42
2,1176,28171,3578742114,3578742156,42
2,1176,28172,3578742114,3578742156,42
2,1176,28173,3578742114,3578742157,43
2,1176,28174,3578742114,3578742157,43
2,1176,28175,3578742114,3578742159,45
2,1176,28176,3578742114,3578742162,48
2,1176,28177,3578742114,3578742163,49
2,1176,28178,3578742114,3578742164,50
2,1177,28179,3578742176,3578742176,0
2,1177,28180,3578742176,3578742176,0
2,1177,28181,3578742176,3578742176,0
2,1177,28182,3578742176,3578742176,0
2,1177,28183,3578742176,3578742176,0
2,1177,28184,3578742176,3578742176,0
2,1177,28185,3578742176,3578742176,0
2,1177,28186,3578742176,3578742176,0
2,1177,28187,3578742176,3578742176,0
2,1177,28188,3578742176,3578742176,0
2,1177,28189,3578742176,3578742176,0
2,1177,28190,3578742176,3578742176,0
2,1177,28191,3578742176,3578742176,0
2,1177,28192,3578742176,3578742178,2
2,1177,28193,3578742176,3578742178,2
2,1177,28194,3578742176,3578742180,4
2,1177,28195,3578742176,3578742180,4
2,1177,28196,3578742176,3578742180,4
2,1177,28197,3578742176,3578742180,4
2,1177,28198,3578742176,3578742180,4
2,1177,28199,3578742176,3578742181,5
2,1177,28200,3578742176,3578742183,7
2,1177,28201,3578742176,3578742184,8
2,1177,28202,3578742176,3578742184,8
2,1177,28203,3578742176,3578742185,9
2,1177,28204,3578742176,3578742185,9
2,1177,28205,3578742176,3578742186,10
2,1177,28206,3578742176,3578742189,13
2,1177,28207,3578742176,3578742191,15
2,1177,28208,3578742176,3578742191,15
2,1177,28209,3578742176,3578742193,17
2,1177,28210,3578742176,3578742194,18
2,1177,28211,3578742176,3578742194,18
2,1177,28212,3578742176,3578742194,18
2,1177,28213,3578742176,3578742194,18
2,1177,28214,3578742176,3578742194,18
2,1177,28215,3578742176,3578742195,19
2,1177,28216,3578742176,3578742196,20
2,1177,28217,3578742176,3578742197,21
2,1177,28218,3578742176,3578742199,23
2,1177,28219,3578742176,3578742200,24
2,1177,28220,3578742176,3578742200,24
2,1177,28221,3578742176,3578742200,24
2,1177,28222,3578742176,3578742204,28
2,1177,28223,3578742176,3578742204,28
2,1177,28224,3578742176,3578742206,30
2,1177,28225,3578742176,3578742207,31
2,1177,28226,3578742176,3578742213,37
2,1177,28227,3578742176,3578742213,37
2,1177,28228,3578742176,3578742214,38
2,1177,28229,3578742176,3578742214,38
2,1177,28230,3578742176,3578742215,39
2,1177,28231,3578742176,3578742216,40
2,1177,28232,3578742176,3578742216,40
2,1177,28233,3578742176,3578742216,40
2,1177,28234,3578742176,3578742218,42
2,1177,28235,3578742176,3578742219,43
2,1177,28236,3578742176,3578742220,44
2,1177,28237,3578742176,3578742222,46
2,1177,28238,3578742176,3578742222,46
2,1177,28239,3578742176,3578742223,47
2,1177,28240,3578742176,3578742223,47
2,1177,28241,3578742176,3578742226,50
2,1178,28242,3578742240,3578742240,0
2,1178,28243,3578742240,3578742240,0
2,1178,28244,3578742240,3578742240,0
2,1178,28245,3578742240,3578742240,0
2,1178,28246,3578742240,3578742240,0
2,1178,28247,3578742240,3578742240,0
2,1178,28248,3578742240,3578742240,0
2,1178,28249,3578742240,3578742240,0
2,1178,28250,3578742240,3578742240,0
2,1178,28251,3578742240,3578742240,0
2,1178,28252,3578742240,3578742240,0
2,1178,28253,3578742240,3578742240,0
2,1178,28254,3578742240,3578742240,0
2,1178,28255,3578742240,3578742240,0
2,1178,28256,3578742240,3578742240,0
2,1178,28257,3578742240,3578742240,0
2,1178,28258,3578742240,3578742240,0
2,1178,28259,3578742240,3578742240,0
2,1178,28260,3578742240,3578742240,0
2,1178,28261,3578742240,3578742240,0
2,1178,28262,3578742240,3578742240,0
2,1178,28263,3578742240,3578742240,0
2,1178,28264,3578742240,3578742240,0
2,1178,28265,3578742240,3578742240,0
2,1178,28266,3578742240,3578742241,1
2,1178,28267,3578742240,3578742241,1
2,1178,28268,3578742240,3578742242,2
2,1178,28269,3578742240,3578742242,2
2,1178,28270,3578742240,3578742242,2
2,1178,28271,3578742240,3578742242,2
2,1178,28272,3578742240,3578742243,3
2,1178,28273,3578742240,3578742245,5
2,1178,28274,3578742240,3578742245,5
2,1178,28275,3578742240,3578742246,6
2,1178,28276,3578742240,3578742246,6
2,1178,28277,3578742240,3578742247,7
2,1178,28278,3578742240,3578742247,7
2,1178,28279,3578742240,3578742249,9
2,1178,28280,3578742240,3578742250,10
2,1178,28281,3578742240,3578742250,10
2,1178,28282,3578742240,3578742252,12
2,1178,28283,3578742240,3578742252,12
2,1178,28284,3578742240,3578742252,12
2,1178,28285,3578742240,3578742254,14
2,1178,28286,3578742240,3578742254,14
2,1178,28287,3578742240,3578742255,15
2,1178,28288,3578742240,3578742255,15
2,1178,28289,3578742240,3578742255,15
2,1178,28290,3578742240,3578742257,17
2,1178,28291,3578742240,3578742258,18
2,1178,28292,3578742240,3578742259,19
2,1178,28293,3578742240,3578742260,20
2,1178,28294,3578742240,3578742261,21
2,1178,28295,3578742240,3578742261,21
2,1178,28296,3578742240,3578742261,21
2,1178,28297,3578742240,3578742262,22
2,1178,28298,3578742240,3578742265,25
2,1178,28299,3578742240,3578742265,25
2,1178,28300,3578742240,3578742266,26
2,1178,28301,3578742240,3578742268,28
2,1178,28302,3578742240,3578742268,28
2,1178,28303,3578742240,3578742269,29
2,1178,28304,3578742240,3578742270,30
2,1178,28305,3578742240,3578742270,30
2,1178,28306,3578742240,3578742270,30
2,1178,28307,3578742240,3578742271,31
2,1178,28308,3578742240,3578742273,33
2,1178,28309,3578742240,3578742277,37
2,1178,28310,3578742240,3578742279,39
2,1178,28311,3578742240,3578742280,40
2,1178,28312,3578742240,3578742281,41
2,1178,28313,3578742240,3578742281,41
2,1178,28314,3578742240,3578742282,42
2,1178,28315,3578742240,3578742282,42
2,1178,28316,3578742240,3578742284,44
2,1178,28317,3578742240,3578742284,44
2,1178,28318,3578742240,3578742285,45
2,1178,28319,3578742240,3578742286,46
2,1178,28320,3578742240,3578742287,47
2,1178,28321,3578742240,3578742287,47
2,1178,28322,3578742240,3578742288,48
2,1178,28323,3578742240,3578742289,49
2,1178,28324,3578742240,3578742290,50
2,1179,28325,3578742301,3578742301,0
2,1179,28326,3578742301,3578742301,0
2,1179,28327,3578742301,3578742301,0
2,1179,28328,3578742301,3578742301,0
2,1179,28329,3578742301,3578742301,0
2,1179,28330,3578742301,3578742301,0
2,1179,28331,3578742301,3578742301,0
2,1179,28332,3578742301,3578742301,0
2,1179,28333,3578742301,3578742301,0
2,1179,28334,3578742301,3578742301,0
2,1179,28335,3578742301,3578742301,0
2,1179,28336,3578742301,3578742301,0
2,1179,28337,3578742301,3578742301,0
2,1179,28338,3578742301,3578742301,0
2,1179,28339,3578742301,3578742301,0
2,1179,28340,3578742301,3578742301,0
2,1179,28341,3578742301,3578742301,0
2,1179,28342,3578742301,3578742302,1
2,1179,28343,3578742301,3578742306,5
2,1179,28344,3578742301,3578742308,7
2,1179,28345,3578742301,3578742309,8
2,1179,28346,3578742301,3578742309,8
2,1179,28347,3578742301,3578742309,8
2,1179,28348,3578742301,3578742310,9
2,1179,28349,3578742301,3578742311,10
2,1179,28350,3578742301,3578742312,11
2,1179,28351,3578742301,3578742313,12
2,1179,28352,3578742301,3578742313,12
2,1179,28353,3578742301,3578742314,13
2,1179,28354,3578742301,3578742315,14
2,1179,28355,3578742301,3578742315,14
2,1179,28356,3578742301,3578742316,15
2,1179,28357,3578742301,3578742318,17
2,1179,28358,3578742301,3578742318,17
2,1179,28359,3578742301,3578742318,17
2,1179,28360,3578742301,3578742318,17
2,1179,28361,3578742301,3578742320,19
2,1179,28362,3578742301,3578742320,19
2,1179,28363,3578742301,3578742322,21
2,1179,28364,3578742301,3578742322,21
2,1179,28365,3578742301,3578742322,21
2,1179,28366,3578742301,3578742323,22
2,1179,28367,3578742301,3578742323,22
2,1179,28368,3578742301,3578742324,23
2,1179,28369,3578742301,3578742324,23
2,1179,28370,3578742301,3578742324,23
2,1179,28371,3578742301,3578742324,23
2,1179,28372,3578742301,3578742325,24
2,1179,28373,3578742301,3578742326,25
2,1179,28374,3578742301,3578742326,25
2,1179,28375,3578742301,3578742327,26
2,1179,28376,3578742301,3578742328,27
2,1179,28377,3578742301,3578742329,28
2,1179,28378,3578742301,3578742332,31
2,1179,28379,3578742301,3578742332,31
2,1179,28380,3578742301,3578742332,31
2,1179,28381,3578742301,3578742333,32
2,1179,28382,3578742301,3578742333,32
2,1179,28383,3578742301,3578742333,32
2,1179,28384,3578742301,3578742334,33
2,1179,28385,3578742301,3578742334,33
2,1179,28386,3578742301,3578742335,34
2,1179,28387,3578742301,3578742336,35
2,1179,28388,3578742301,3578742337,36
2,1179,28389,3578742301,3578742337,36
2,1179,28390,3578742301,3578742338,37
2,1179,28391,3578742301,3578742338,37
2,1179,28392,3578742301,3578742340,39
2,1179,28393,3578742301,3578742341,40
2,1179,28394,3578742301,3578742341,40
2,1179,28395,3578742301,3578742343,42
2,1179,28396,3578742301,3578742343,42
2,1179,28397,3578742301,3578742343,42
2,1179,28398,3578742301,3578742343,42
2,1179,28399,3578742301,3578742343,42
2,1179,28400,3578742301,3578742344,43
2,1179,28401,3578742301,3578742348,47
2,1179,28402,3578742301,3578742348,47
2,1179,28403,3578742301,3578742348,47
2,1180,28404,3578742364,3578742364,0
2,1180,28405,3578742364,3578742364,0
2,1180,28406,3578742364,3578742364,0
2,1180,28407,3578742364,3578742364,0
2,1180,28408,3578742364,3578742364,0
2,1180,28409,3578742364,3578742364,0
2,1180,28410,3578742364,3578742364,0
2,1180,28411,3578742364,3578742364,0
2,1180,28412,3578742364,3578742364,0
2,1180,28413,3578742364,3578742364,0
2,1180,28414,3578742364,3578742364,0
2,1180,28415,3578742364,3578742364,0
2,1180,28416,3578742364,3578742364,0
2,1180,28417,3578742364,3578742364,0
2,1180,28418,3578742364,3578742365,1
2,1180,28419,3578742364,3578742366,2
2,1180,28420,3578742364,3578742366,2
2,1180,28421,3578742364,3578742366,2
2,1180,28422,3578742364,3578742367,3
2,1180,28423,3578742364,3578742367,3
2,1180,28424,3578742364,3578742368,4
2,1180,28425,3578742364,3578742369,5
2,1180,28426,3578742364,3578742369,5
2,1180,28427,3578742364,3578742373,9
2,1180,28428,3578742364,3578742375,11
2,1180,28429,3578742364,3578742376,12
2,1180,28430,3578742364,3578742377,13
2,1180,28431,3578742364,3578742377,13
2,1180,28432,3578742364,3578742379,15
2,1180,28433,3578742364,3578742379,15
2,1180,28434,3578742364,3578742379,15
2,1180,28435,3578742364,3578742380,16
2,1180,28436,3578742364,3578742380,16
2,1180,28437,3578742364,3578742380,16
2,1180,28438,3578742364,3578742381,17
2,1180,28439,3578742364,3578742383,19
2,1180,28440,3578742364,3578742383,19
2,1180,28441,3578742364,3578742384,20
2,1180,28442,3578742364,3578742385,21
2,1180,28443,3578742364,3578742385,21
2,1180,28444,3578742364,3578742386,22
2,1180,28445,3578742364,3578742386,22
2,1180,28446,3578742364,3578742389,25
2,1180,28447,3578742364,3578742390,26
2,1180,28448,3578742364,3578742390,26
2,1180,28449,3578742364,3578742391,27
2,1180,28450,3578742364,3578742391,27
2,1180,28451,3578742364,3578742393,29
2,1180,28452,3578742364,3578742393,29
2,1180,28453,3578742364,3578742394,30
2,1180,28454,3578742364,3578742394,30
2,1180,28455,3578742364,3578742394,30
2,1180,28456,3578742364,3578742394,30
2,1180,28457,3578742364,3578742394,30
2,1180,28458,3578742364,3578742395,31
2,1180,28459,3578742364,3578742396,32
2,1180,28460,3578742364,3578742399,35
2,1180,28461,3578742364,3578742400,36
2,1180,28462,3578742364,3578742400,36
2,1180,28463,3578742364,3578742400,36
2,1180,28464,3578742364,3578742404,40
2,1180,28465,3578742364,3578742405,41
2,1180,28466,3578742364,3578742406,42
2,1180,28467,3578742364,3578742407,43
2,1180,28468,3578742364,3578742412,48
2,1180,28469,3578742364,3578742414,50
2,1181,28470,3578742426,3578742426,0
2,1181,28471,3578742426,3578742426,0
2,1181,28472,3578742426,3578742426,0
2,1181,28473,3578742426,3578742426,0
2,1181,28474,3578742426,3578742426,0
2,1181,28475,3578742426,3578742426,0
2,1181,28476,3578742426,3578742426,0
2,1181,28477,3578742426,3578742426,0
2,1181,28478,3578742426,3578742426,0
2,1181,28479,3578742426,3578742426,0
2,1181,28480,3578742426,3578742426,0
2,1181,28481,3578742426,3578742426,0
2,1181,28482,3578742426,3578742426,0
2,1181,28483,3578742426,3578742427,1
2,1181,28484,3578742426,3578742427,1
2,1181,28485,3578742426,3578742428,2
2,1181,28486,3578742426,3578742429,3
2,1181,28487,3578742426,3578742430,4
2,1181,28488,3578742426,3578742431,5
2,1181,28489,3578742426,3578742431,5
2,1181,28490,3578742426,3578742431,5
2,1181,28491,3578742426,3578742432,6
2,1181,28492,3578742426,3578742432,6
2,1181,28493,3578742426,3578742433,7
2,1181,28494,3578742426,3578742433,7
2,1181,28495,3578742426,3578742433,7
2,1181,28496,3578742426,3578742433,7
2,1181,28497,3578742426,3578742433,7
2,1181,28498,3578742426,3578742433,7
2,1181,28499,3578742426,3578742435,9
2,1181,28500,3578742426,3578742437,11
2,1181,28501,3578742426,3578742437,11
2,1181,28502,3578742426,3578742437,11
2,1181,28503,3578742426,3578742438,12
2,1181,28504,3578742426,3578742438,12
2,1181,28505,3578742426,3578742439,13
2,1181,28506,3578742426,3578742441,15
2,1181,28507,3578742426,3578742442,16
2,1181,28508,3578742426,3578742442,16
2,1181,28509,3578742426,3578742442,16
2,1181,28510,3578742426,3578742442,16
2,1181,28511,3578742426,3578742443,17
2,1181,28512,3578742426,3578742443,17
2,1181,28513,3578742426,3578742446,20
2,1181,28514,3578742426,3578742446,20
2,1181,28515,3578742426,3578742446,20
2,1181,28516,3578742426,3578742447,21
2,1181,28517,3578742426,3578742447,21
2,1181,28518,3578742426,3578742449,23
2,1181,28519,3578742426,3578742449,23
2,1181,28520,3578742426,3578742451,25
2,1181,28521,3578742426,3578742452,26
2,1181,28522,3578742426,3578742452,26
2,1181,28523,3578742426,3578742453,27
2,1181,28524,3578742426,3578742454,28
2,1181,28525,3578742426,3578742455,29
2,1181,28526,3578742426,3578742455,29
2,1181,28527,3578742426,3578742455,29
2,1181,28528,3578742426,3578742455,29
2,1181,28529,3578742426,3578742455,29
2,1181,28530,3578742426,3578742456,30
2,1181,28531,3578742426,3578742458,32
2,1181,28532,3578742426,3578742459,33
2,1181,28533,3578742426,3578742460,34
2,1181,28534,3578742426,3578742461,35
2,1181,28535,3578742426,3578742461,35
2,1181,28536,3578742426,3578742461,35
2,1181,28537,3578742426,3578742462,36
2,1181,28538,3578742426,3578742465,39
2,1181,28539,3578742426,3578742466,40
2,1181,28540,3578742426,3578742466,40
2,1181,28541,3578742426,3578742467,41
2,1181,28542,3578742426,3578742468,42
2,1181,28543,3578742426,3578742469,43
2,1181,28544,3578742426,3578742470,44
2,1181,28545,3578742426,3578742470,44
2,1181,28546,3578742426,3578742471,45
2,1181,28547,3578742426,3578742471,45
2,1181,28548,3578742426,3578742473,47
2,1182,28549,3578742490,3578742490,0
2,1182,28550,3578742490,3578742490,0
2,1182,28551,3578742490,3578742490,0
2,1182,28552,3578742490,3578742490,0
2,1182,28553,3578742490,3578742490,0
2,1182,28554,3578742490,3578742490,0
2,1182,28555,3578742490,3578742490,0
2,1182,28556,3578742490,3578742490,0
2,1182,28557,3578742490,3578742490,0
2,1182,28558,3578742490,3578742490,0
2,1182,28559,3578742490,3578742490,0
2,1182,28560,3578742490,3578742490,0
2,1182,28561,3578742490,3578742490,0
2,1182,28562,3578742490,3578742490,0
2,1182,28563,3578742490,3578742490,0
2,1182,28564,3578742490,3578742490,0
2,1182,28565,3578742490,3578742490,0
2,1182,28566,3578742490,3578742490,0
2,1182,28567,3578742490,3578742490,0
2,1182,28568,3578742490,3578742490,0
2,1182,28569,3578742490,3578742491,1
2,1182,28570,3578742490,3578742491,1
2,1182,28571,3578742490,3578742493,3
2,1182,28572,3578742490,3578742493,3
2,1182,28573,3578742490,3578742494,4
2,1182,28574,3578742490,3578742494,4
2,1182,28575,3578742490,3578742494,4
2,1182,28576,3578742490,3578742494,4
2,1182,28577,3578742490,3578742494,4
2,1182,28578,3578742490,3578742495,5
2,1182,28579,3578742490,3578742495,5
2,1182,28580,3578742490,3578742497,7
2,1182,28581,3578742490,3578742498,8
2,1182,28582,3578742490,3578742498,8
2,1182,28583,3578742490,3578742499,9
2,1182,28584,3578742490,3578742500,10
2,1182,28585,3578742490,3578742501,11
2,1182,28586,3578742490,3578742501,11
2,1182,28587,3578742490,3578742506,16
2,1182,28588,3578742490,3578742506,16
2,1182,28589,3578742490,3578742508,18
2,1182,28590,3578742490,3578742508,18
2,1182,28591,3578742490,3578742508,18
2,1182,28592,3578742490,3578742509,19
2,1182,28593,3578742490,3578742509,19
2,1182,28594,3578742490,3578742510,20
2,1182,28595,3578742490,3578742511,21
2,1182,28596,3578742490,3578742512,22
2,1182,28597,3578742490,3578742512,22
2,1182,28598,3578742490,3578742514,24
2,1182,28599,3578742490,3578742514,24
2,1182,28600,3578742490,3578742515,25
2,1182,28601,3578742490,3578742517,27
2,1182,28602,3578742490,3578742517,27
2,1182,28603,3578742490,3578742517,27
2,1182,28604,3578742490,3578742518,28
2,1182,28605,3578742490,3578742518,28
2,1182,28606,3578742490,3578742519,29
2,1182,28607,3578742490,3578742521,31
2,1182,28608,3578742490,3578742521,31
2,1182,28609,3578742490,3578742522,32
2,1182,28610,3578742490,3578742522,32
2,1182,28611,3578742490,3578742522,32
2,1182,28612,3578742490,3578742522,32
2,1182,28613,3578742490,3578742523,33
2,1182,28614,3578742490,3578742523,33
2,1182,28615,3578742490,3578742523,33
2,1182,28616,3578742490,3578742524,34
2,1182,28617,3578742490,3578742525,35
2,1182,28618,3578742490,3578742526,36
2,1182,28619,3578742490,3578742527,37
2,1182,28620,3578742490,3578742527,37
2,1182,28621,3578742490,3578742527,37
2,1182,28622,3578742490,3578742531,41
2,1182,28623,3578742490,3578742532,42
2,1182,28624,3578742490,3578742532,42
2,1182,28625,3578742490,3578742532,42
2,1182,28626,3578742490,3578742532,42
2,1182,28627,3578742490,3578742532,42
2,1182,28628,3578742490,3578742533,43
2,1182,28629,3578742490,3578742534,44
2,1182,28630,3578742490,3578742535,45
2,1182,28631,3578742490,3578742536,46
2,1182,28632,3578742490,3578742536,46
2,1182,28633,3578742490,3578742537,47
2,1182,28634,3578742490,3578742538,48
2,1182,28635,3578742490,3578742539,49
2,1182,28636,3578742490,3578742539,49
2,1182,28637,3578742490,3578742540,50
2,1183,28638,3578742552,3578742552,0
2,1183,28639,3578742552,3578742552,0
2,1183,28640,3578742552,3578742552,0
2,1183,28641,3578742552,3578742552,0
2,1183,28642,3578742552,3578742552,0
2,1183,28643,3578742552,3578742552,0
2,1183,28644,3578742552,3578742552,0
2,1183,28645,3578742552,3578742552,0
2,1183,28646,3578742552,3578742552,0
2,1183,28647,3578742552,3578742554,2
2,1183,28648,3578742552,3578742554,2
2,1183,28649,3578742552,3578742554,2
2,1183,28650,3578742552,3578742555,3
2,1183,28651,3578742552,3578742555,3
2,1183,28652,3578742552,3578742556,4
2,1183,28653,3578742552,3578742556,4
2,1183,28654,3578742552,3578742559,7
2,1183,28655,3578742552,3578742560,8
2,1183,28656,3578742552,3578742561,9
2,1183,28657,3578742552,3578742562,10
2,1183,28658,3578742552,3578742563,11
2,1183,28659,3578742552,3578742564,12
2,1183,28660,3578742552,3578742564,12
2,1183,28661,3578742552,3578742564,12
2,1183,28662,3578742552,3578742565,13
2,1183,28663,3578742552,3578742565,13
2,1183,28664,3578742552,3578742566,14
2,1183,28665,3578742552,3578742566,14
2,1183,28666,3578742552,3578742567,15
2,1183,28667,3578742552,3578742568,16
2,1183,28668,3578742552,3578742569,17
2,1183,28669,3578742552,3578742574,22
2,1183,28670,3578742552,3578742575,23
2,1183,28671,3578742552,3578742577,25
2,1183,28672,3578742552,3578742578,26
2,1183,28673,3578742552,3578742578,26
2,1183,28674,3578742552,3578742578,26
2,1183,28675,3578742552,3578742578,26
2,1183,28676,3578742552,3578742579,27
2,1183,28677,3578742552,3578742579,27
2,1183,28678,3578742552,3578742579,27
2,1183,28679,3578742552,3578742580,28
2,1183,28680,3578742552,3578742581,29
2,1183,28681,3578742552,3578742582,30
2,1183,28682,3578742552,3578742582,30
2,1183,28683,3578742552,3578742583,31
2,1183,28684,3578742552,3578742583,31
2,1183,28685,3578742552,3578742584,32
2,1183,28686,3578742552,3578742584,32
2,1183,28687,3578742552,3578742584,32
2,1183,28688,3578742552,3578742585,33
2,1183,28689,3578742552,3578742587,35
2,1183,28690,3578742552,3578742589,37
2,1183,28691,3578742552,3578742589,37
2,1183,28692,3578742552,3578742589,37
2,1183,28693,3578742552,3578742590,38
2,1183,28694,3578742552,3578742591,39
2,1183,28695,3578742552,3578742592,40
2,1183,28696,3578742552,3578742593,41
2,1183,28697,3578742552,3578742593,41
2,1183,28698,3578742552,3578742593,41
2,1183,28699,3578742552,3578742593,41
2,1183,28700,3578742552,3578742595,43
2,1183,28701,3578742552,3578742595,43
2,1183,28702,3578742552,3578742596,44
2,1183,28703,3578742552,3578742598,46
2,1183,28704,3578742552,3578742598,46
2,1183,28705,3578742552,3578742599,47
2,1183,28706,3578742552,3578742599,47
2,1184,28707,3578742617,3578742617,0
2,1184,28708,3578742617,3578742617,0
2,1184,28709,3578742617,3578742617,0
2,1184,28710,3578742617,3578742617,0
2,1184,28711,3578742617,3578742617,0
2,1184,28712,3578742617,3578742617,0
2,1184,28713,3578742617,3578742617,0
2,1184,28714,3578742617,3578742617,0
2,1184,28715,3578742617,3578742617,0
2,1184,28716,3578742617,3578742617,0
2,1184,28717,3578742617,3578742617,0
2,1184,28718,3578742617,3578742617,0
2,1184,28719,3578742617,3578742617,0
2,1184,28720,3578742617,3578742618,1
2,1184,28721,3578742617,3578742619,2
2,1184,28722,3578742617,3578742621,4
2,1184,28723,3578742617,3578742621,4
2,1184,28724,3578742617,3578742621,4
2,1184,28725,3578742617,3578742622,5
2,1184,28726,3578742617,3578742622,5
2,1184,28727,3578742617,3578742623,6
2,1184,28728,3578742617,3578742626,9
2,1184,28729,3578742617,3578742626,9
2,1184,28730,3578742617,3578742627,10
2,1184,28731,3578742617,3578742628,11
2,1184,28732,3578742617,3578742629,12
2,1184,28733,3578742617,3578742629,12
2,1184,28734,3578742617,3578742630,13
2,1184,28735,3578742617,3578742630,13
2,1184,28736,3578742617,3578742631,14
2,1184,28737,3578742617,3578742631,14
2,1184,28738,3578742617,3578742632,15
2,1184,28739,3578742617,3578742632,15
2,1184,28740,3578742617,3578742632,15
2,1184,28741,3578742617,3578742632,15
2,1184,28742,3578742617,3578742632,15
2,1184,28743,3578742617,3578742633,16
2,1184,28744,3578742617,3578742636,19
2,1184,28745,3578742617,3578742636,19
2,1184,28746,3578742617,3578742637,20
2,1184,28747,3578742617,3578742637,20
2,1184,28748,3578742617,3578742637,20
2,1184,28749,3578742617,3578742637,20
2,1184,28750,3578742617,3578742638,21
2,1184,28751,3578742617,3578742639,22
2,1184,28752,3578742617,3578742640,23
2,1184,28753,3578742617,3578742641,24
2,1184,28754,3578742617,3578742641,24
2,1184,28755,3578742617,3578742641,24
2,1184,28756,3578742617,3578742641,24
2,1184,28757,3578742617,3578742642,25
2,1184,28758,3578742617,3578742644,27
2,1184,28759,3578742617,3578742644,27
2,1184,28760,3578742617,3578742644,27
2,1184,28761,3578742617,3578742646,29
2,1184,28762,3578742617,3578742647,30
2,1184,28763,3578742617,3578742647,30
2,1184,28764,3578742617,3578742649,32
2,1184,28765,3578742617,3578742650,33
2,1184,28766,3578742617,3578742651,34
2,1184,28767,3578742617,3578742651,34
2,1184,28768,3578742617,3578742652,35
2,1184,28769,3578742617,3578742653,36
2,1184,28770,3578742617,3578742653,36
2,1184,28771,3578742617,3578742654,37
2,1184,28772,3578742617,3578742655,38
2,1184,28773,3578742617,3578742655,38
2,1184,28774,3578742617,3578742655,38
2,1184,28775,3578742617,3578742657,40
2,1184,28776,3578742617,3578742657,40
2,1184,28777,3578742617,3578742659,42
2,1184,28778,3578742617,3578742659,42
2,1184,28779,3578742617,3578742659,42
2,1184,28780,3578742617,3578742660,43
2,1184,28781,3578742617,3578742660,43
2,1184,28782,3578742617,3578742661,44
2,1184,28783,3578742617,3578742664,47
2,1184,28784,3578742617,3578742665,48
2,1184,28785,3578742617,3578742666,49
2,1184,28786,3578742617,3578742667,50
2,1184,28787,3578742617,3578742667,50
2,1185,28788,3578742679,3578742679,0
2,1185,28789,3578742679,3578742679,0
2,1185,28790,3578742679,3578742679,0
2,1185,28791,3578742679,3578742679,0
2,1185,28792,3578742679,3578742679,0
2,1185,28793,3578742679,3578742679,0
2,1185,28794,3578742679,3578742679,0
2,1185,28795,3578742679,3578742679,0
2,1185,28796,3578742679,3578742680,1
2,1185,28797,3578742679,3578742680,1
2,1185,28798,3578742679,3578742680,1
2,1185,28799,3578742679,3578742681,2
2,1185,28800,3578742679,3578742682,3
2,1185,28801,3578742679,3578742682,3
2,1185,28802,3578742679,3578742683,4
2,1185,28803,3578742679,3578742683,4
2,1185,28804,3578742679,3578742683,4
2,1185,28805,3578742679,3578742684,5
2,1185,28806,3578742679,3578742684,5
2,1185,28807,3578742679,3578742686,7
2,1185,28808,3578742679,3578742687,8
2,1185,28809,3578742679,3578742687,8
2,1185,28810,3578742679,3578742688,9
2,1185,28811,3578742679,3578742688,9
2,1185,28812,3578742679,3578742690,11
2,1185,28813,3578742679,3578742690,11
2,1185,28814,3578742679,3578742691,12
2,1185,28815,3578742679,3578742691,12
2,1185,28816,3578742679,3578742692,13
2,1185,28817,3578742679,3578742692,13
2,1185,28818,3578742679,3578742694,15
2,1185,28819,3578742679,3578742694,15
2,1185,28820,3578742679,3578742694,15
2,1185,28821,3578742679,3578742695,16
2,1185,28822,3578742679,3578742695,16
2,1185,28823,3578742679,3578742695,16
2,1185,28824,3578742679,3578742695,16
2,1185,28825,3578742679,3578742696,17
2,1185,28826,3578742679,3578742696,17
2,1185,28827,3578742679,3578742697,18
2,1185,28828,3578742679,3578742698,19
2,1185,28829,3578742679,3578742699,20
2,1185,28830,3578742679,3578742699,20
2,1185,28831,3578742679,3578742701,22
2,1185,28832,3578742679,3578742701,22
2,1185,28833,3578742679,3578742705,26
2,1185,28834,3578742679,3578742707,28
2,1185,28835,3578742679,3578742708,29
2,1185,28836,3578742679,3578742708,29
2,1185,28837,3578742679,3578742709,30
2,1185,28838,3578742679,3578742709,30
2,1185,28839,3578742679,3578742709,30
2,1185,28840,3578742679,3578742711,32
2,1185,28841,3578742679,3578742711,32
2,1185,28842,3578742679,3578742713,34
2,1185,28843,3578742679,3578742714,35
2,1185,28844,3578742679,3578742715,36
2,1185,28845,3578742679,3578742715,36
2,1185,28846,3578742679,3578742717,38
2,1185,28847,3578742679,3578742717,38
2,1185,28848,3578742679,3578742717,38
2,1185,28849,3578742679,3578742717,38
2,1185,28850,3578742679,3578742719,40
2,1185,28851,3578742679,3578742719,40
2,1185,28852,3578742679,3578742720,41
2,1185,28853,3578742679,3578742721,42
2,1185,28854,3578742679,3578742722,43
2,1185,28855,3578742679,3578742722,43
2,1185,28856,3578742679,3578742722,43
2,1185,28857,3578742679,3578742722,43
2,1185,28858,3578742679,3578742723,44
2,1185,28859,3578742679,3578742723,44
2,1185,28860,3578742679,3578742724,45
2,1185,28861,3578742679,3578742725,46
2,1185,28862,3578742679,3578742726,47
2,1185,28863,3578742679,3578742726,47
2,1185,28864,3578742679,3578742726,47
2,1185,28865,3578742679,3578742727,48
2,1185,28866,3578742679,3578742728,49
2,1186,28867,3578742741,3578742741,0
2,1186,28868,3578742741,3578742741,0
2,1186,28869,3578742741,3578742741,0
2,1186,28870,3578742741,3578742741,0
2,1186,28871,3578742741,3578742741,0
2,1186,28872,3578742741,3578742741,0
2,1186,28873,3578742741,3578742741,0
2,1186,28874,3578742741,3578742741,0
2,1186,28875,3578742741,3578742741,0
2,1186,28876,3578742741,3578742741,0
2,1186,28877,3578742741,3578742741,0
2,1186,28878,3578742741,3578742741,0
2,1186,28879,3578742741,3578742741,0
2,1186,28880,3578742741,3578742741,0
2,1186,28881,3578742741,3578742742,1
2,1186,28882,3578742741,3578742742,1
2,1186,28883,3578742741,3578742742,1
2,1186,28884,3578742741,3578742743,2
2,1186,28885,3578742741,3578742743,2
2,1186,28886,3578742741,3578742745,4
2,1186,28887,3578742741,3578742748,7
2,1186,28888,3578742741,3578742750,9
2,1186,28889,3578742741,3578742750,9
2,1186,28890,3578742741,3578742751,10
2,1186,28891,3578742741,3578742754,13
2,1186,28892,3578742741,3578742754,13
2,1186,28893,3578742741,3578742754,13
2,1186,28894,3578742741,3578742754,13
2,1186,28895,3578742741,3578742756,15
2,1186,28896,3578742741,3578742757,16
2,1186,28897,3578742741,3578742758,17
2,1186,28898,3578742741,3578742760,19
2,1186,28899,3578742741,3578742761,20
2,1186,28900,3578742741,3578742763,22
2,1186,28901,3578742741,3578742763,22
2,1186,28902,3578742741,3578742764,23
2,1186,28903,3578742741,3578742764,23
2,1186,28904,3578742741,3578742764,23
2,1186,28905,3578742741,3578742766,25
2,1186,28906,3578742741,3578742767,26
2,1186,28907,3578742741,3578742767,26
2,1186,28908,3578742741,3578742768,27
2,1186,28909,3578742741,3578742769,28
2,1186,28910,3578742741,3578742769,28
2,1186,28911,3578742741,3578742772,31
2,1186,28912,3578742741,3578742774,33
2,1186,28913,3578742741,3578742775,34
2,1186,28914,3578742741,3578742777,36
2,1186,28915,3578742741,3578742778,37
2,1186,28916,3578742741,3578742778,37
2,1186,28917,3578742741,3578742778,37
2,1186,28918,3578742741,3578742778,37
2,1186,28919,3578742741,3578742778,37
2,1186,28920,3578742741,3578742778,37
2,1186,28921,3578742741,3578742779,38
2,1186,28922,3578742741,3578742780,39
2,1186,28923,3578742741,3578742780,39
2,1186,28924,3578742741,3578742782,41
2,1186,28925,3578742741,3578742783,42
2,1186,28926,3578742741,3578742783,42
2,1186,28927,3578742741,3578742785,44
2,1186,28928,3578742741,3578742785,44
2,1186,28929,3578742741,3578742785,44
2,1186,28930,3578742741,3578742785,44
2,1186,28931,3578742741,3578742785,44
2,1186,28932,3578742741,3578742788,47
2,1186,28933,3578742741,3578742789,48
2,1186,28934,3578742741,3578742789,48
2,1186,28935,3578742741,3578742790,49
2,1186,28936,3578742741,3578742790,49
2,1186,28937,3578742741,3578742790,49
2,1187,28938,3578742804,3578742804,0
2,1187,28939,3578742804,3578742804,0
2,1187,28940,3578742804,3578742804,0
2,1187,28941,3578742804,3578742804,0
2,1187,28942,3578742804,3578742804,0
2,1187,28943,3578742804,3578742804,0
2,1187,28944,3578742804,3578742804,0
2,1187,28945,3578742804,3578742804,0
2,1187,28946,3578742804,3578742804,0
2,1187,28947,3578742804,3578742804,0
2,1187,28948,3578742804,3578742804,0
2,1187,28949,3578742804,3578742804,0
2,1187,28950,3578742804,3578742804,0
2,1187,28951,3578742804,3578742804,0
2,1187,28952,3578742804,3578742804,0
2,1187,28953,3578742804,3578742806,2
2,1187,28954,3578742804,3578742806,2
2,1187,28955,3578742804,3578742806,2
2,1187,28956,3578742804,3578742813,9
2,1187,28957,3578742804,3578742813,9
2,1187,28958,3578742804,3578742814,10
2,1187,28959,3578742804,3578742814,10
2,1187,28960,3578742804,3578742814,10
2,1187,28961,3578742804,3578742815,11
2,1187,28962,3578742804,3578742815,11
2,1187,28963,3578742804,3578742817,13
2,1187,28964,3578742804,3578742819,15
2,1187,28965,3578742804,3578742819,15
2,1187,28966,3578742804,3578742819,15
2,1187,28967,3578742804,3578742821,17
2,1187,28968,3578742804,3578742821,17
2,1187,28969,3578742804,3578742822,18
2,1187,28970,3578742804,3578742822,18
2,1187,28971,3578742804,3578742823,19
2,1187,28972,3578742804,3578742823,19
2,1187,28973,3578742804,3578742825,21
2,1187,28974,3578742804,3578742826,22
2,1187,28975,3578742804,3578742826,22
2,1187,28976,3578742804,3578742826,22
2,1187,28977,3578742804,3578742827,23
2,1187,28978,3578742804,3578742827,23
2,1187,28979,3578742804,3578742829,25
2,1187,28980,3578742804,3578742829,25
2,1187,28981,3578742804,3578742830,26
2,1187,28982,3578742804,3578742830,26
2,1187,28983,3578742804,3578742831,27
2,1187,28984,3578742804,3578742832,28
2,1187,28985,3578742804,3578742832,28
2,1187,28986,3578742804,3578742832,28
2,1187,28987,3578742804,3578742832,28
2,1187,28988,3578742804,3578742832,28
2,1187,28989,3578742804,3578742833,29
2,1187,28990,3578742804,3578742835,31
2,1187,28991,3578742804,3578742836,32
2,1187,28992,3578742804,3578742836,32
2,1187,28993,3578742804,3578742836,32
2,1187,28994,3578742804,3578742836,32
2,1187,28995,3578742804,3578742838,34
2,1187,28996,3578742804,3578742838,34
2,1187,28997,3578742804,3578742840,36
2,1187,28998,3578742804,3578742841,37
2,1187,28999,3578742804,3578742841,37
2,1187,29000,3578742804,3578742841,37
2,1187,29001,3578742804,3578742841,37
2,1187,29002,3578742804,3578742842,38
2,1187,29003,3578742804,3578742842,38
2,1187,29004,3578742804,3578742844,40
2,1187,29005,3578742804,3578742844,40
2,1187,29006,3578742804,3578742845,41
2,1187,29007,3578742804,3578742846,42
2,1187,29008,3578742804,3578742846,42
2,1187,29009,3578742804,3578742847,43
2,1187,29010,3578742804,3578742849,45
2,1187,29011,3578742804,3578742849,45
2,1187,29012,3578742804,3578742850,46
2,1187,29013,3578742804,3578742851,47
2,1187,29014,3578742804,3578742852,48
2,1187,29015,3578742804,3578742852,48
2,1188,29016,3578742866,3578742866,0
2,1188,29017,3578742866,3578742866,0
2,1188,29018,3578742866,3578742866,0
2,1188,29019,3578742866,3578742866,0
2,1188,29020,3578742866,3578742866,0
2,1188,29021,3578742866,3578742866,0
2,1188,29022,3578742866,3578742866,0
2,1188,29023,3578742866,3578742866,0
2,1188,29024,3578742866,3578742866,0
2,1188,29025,3578742866,3578742866,0
2,1188,29026,3578742866,3578742866,0
2,1188,29027,3578742866,3578742866,0
2,1188,29028,3578742866,3578742866,0
2,1188,29029,3578742866,3578742866,0
2,1188,29030,3578742866,3578742866,0
2,1188,29031,3578742866,3578742866,0
2,1188,29032,3578742866,3578742867,1
2,1188,29033,3578742866,3578742867,1
2,1188,29034,3578742866,3578742868,2
2,1188,29035,3578742866,3578742869,3
2,1188,29036,3578742866,3578742869,3
2,1188,29037,3578742866,3578742869,3
2,1188,29038,3578742866,3578742871,5
2,1188,29039,3578742866,3578742872,6
2,1188,29040,3578742866,3578742874,8
2,1188,29041,3578742866,3578742879,13
2,1188,29042,3578742866,3578742879,13
2,1188,29043,3578742866,3578742880,14
2,1188,29044,3578742866,3578742880,14
2,1188,29045,3578742866,3578742881,15
2,1188,29046,3578742866,3578742881,15
2,1188,29047,3578742866,3578742882,16
2,1188,29048,3578742866,3578742882,16
2,1188,29049,3578742866,3578742883,17
2,1188,29050,3578742866,3578742884,18
2,1188,29051,3578742866,3578742884,18
2,1188,29052,3578742866,3578742884,18
2,1188,29053,3578742866,3578742884,18
2,1188,29054,3578742866,3578742886,20
2,1188,29055,3578742866,3578742886,20
2,1188,29056,3578742866,3578742888,22
2,1188,29057,3578742866,3578742889,23
2,1188,29058,3578742866,3578742889,23
2,1188,29059,3578742866,3578742889,23
2,1188,29060,3578742866,3578742891,25
2,1188,29061,3578742866,3578742891,25
2,1188,29062,3578742866,3578742891,25
2,1188,29063,3578742866,3578742893,27
2,1188,29064,3578742866,3578742893,27
2,1188,29065,3578742866,3578742893,27
2,1188,29066,3578742866,3578742894,28
2,1188,29067,3578742866,3578742894,28
2,1188,29068,3578742866,3578742895,29
2,1188,29069,3578742866,3578742895,29
2,1188,29070,3578742866,3578742895,29
2,1188,29071,3578742866,3578742895,29
2,1188,29072,3578742866,3578742896,30
2,1188,29073,3578742866,3578742896,30
2,1188,29074,3578742866,3578742897,31
2,1188,29075,3578742866,3578742898,32
2,1188,29076,3578742866,3578742898,32
2,1188,29077,3578742866,3578742899,33
2,1188,29078,3578742866,3578742900,34
2,1188,29079,3578742866,3578742901,35
2,1188,29080,3578742866,3578742901,35
2,1188,29081,3578742866,3578742905,39
2,1188,29082,3578742866,3578742906,40
2,1188,29083,3578742866,3578742908,42
2,1188,29084,3578742866,3578742908,42
2,1188,29085,3578742866,3578742909,43
2,1188,29086,3578742866,3578742909,43
2,1188,29087,3578742866,3578742909,43
2,1188,29088,3578742866,3578742910,44
2,1188,29089,3578742866,3578742912,46
2,1188,29090,3578742866,3578742913,47
2,1188,29091,3578742866,3578742913,47
2,1188,29092,3578742866,3578742915,49
2,1188,29093,3578742866,3578742915,49
2,1188,29094,3578742866,3578742915,49
2,1189,29095,3578742928,3578742928,0
2,1189,29096,3578742928,3578742928,0
2,1189,29097,3578742928,3578742928,0
2,1189,29098,3578742928,3578742928,0
2,1189,29099,3578742928,3578742928,0
2,1189,29100,3578742928,3578742928,0
2,1189,29101,3578742928,3578742928,0
2,1189,29102,3578742928,3578742928,0
2,1189,29103,3578742928,3578742928,0
2,1189,29104,3578742928,3578742928,0
2,1189,29105,3578742928,3578742928,0
2,1189,29106,3578742928,3578742928,0
2,1189,29107,3578742928,3578742928,0
2,1189,29108,3578742928,3578742928,0
2,1189,29109,3578742928,3578742928,0
2,1189,29110,3578742928,3578742928,0
2,1189,29111,3578742928,3578742928,0
2,1189,29112,3578742928,3578742928,0
2,1189,29113,3578742928,3578742928,0
2,1189,29114,3578742928,3578742928,0
2,1189,29115,3578742928,3578742931,3
2,1189,29116,3578742928,3578742932,4
2,1189,29117,3578742928,3578742932,4
2,1189,29118,3578742928,3578742933,5
2,1189,29119,3578742928,3578742933,5
2,1189,29120,3578742928,3578742934,6
2,1189,29121,3578742928,3578742934,6
2,1189,29122,3578742928,3578742936,8
2,1189,29123,3578742928,3578742937,9
2,1189,29124,3578742928,3578742937,9
2,1189,29125,3578742928,3578742938,10
2,1189,29126,3578742928,3578742940,12
2,1189,29127,3578742928,3578742940,12
2,1189,29128,3578742928,3578742940,12
2,1189,29129,3578742928,3578742943,15
2,1189,29130,3578742928,3578742943,15
2,1189,29131,3578742928,3578742943,15
2,1189,29132,3578742928,3578742943,15
2,1189,29133,3578742928,3578742943,15
2,1189,29134,3578742928,3578742946,18
2,1189,29135,3578742928,3578742947,19
2,1189,29136,3578742928,3578742947,19
2,1189,29137,3578742928,3578742950,22
2,1189,29138,3578742928,3578742950,22
2,1189,29139,3578742928,3578742951,23
2,1189,29140,3578742928,3578742954,26
2,1189,29141,3578742928,3578742954,26
2,1189,29142,3578742928,3578742955,27
2,1189,29143,3578742928,3578742955,27
2,1189,29144,3578742928,3578742956,28
2,1189,29145,3578742928,3578742958,30
2,1189,29146,3578742928,3578742959,31
2,1189,29147,3578742928,3578742961,33
2,1189,29148,3578742928,3578742963,35
2,1189,29149,3578742928,3578742964,36
2,1189,29150,3578742928,3578742965,37
2,1189,29151,3578742928,3578742965,37
2,1189,29152,3578742928,3578742965,37
2,1189,29153,3578742928,3578742966,38
2,1189,29154,3578742928,3578742966,38
2,1189,29155,3578742928,3578742966,38
2,1189,29156,3578742928,3578742967,39
2,1189,29157,3578742928,3578742968,40
2,1189,29158,3578742928,3578742968,40
2,1189,29159,3578742928,3578742969,41
2,1189,29160,3578742928,3578742973,45
2,1189,29161,3578742928,3578742974,46
2,1189,29162,3578742928,3578742977,49
2,1189,29163,3578742928,3578742978,50
2,1190,29164,3578742990,3578742990,0
2,1190,29165,3578742990,3578742990,0
2,1190,29166,3578742990,3578742990,0
2,1190,29167,3578742990,3578742990,0
2,1190,29168,3578742990,3578742990,0
2,1190,29169,3578742990,3578742990,0
2,1190,29170,3578742990,3578742990,0
2,1190,29171,3578742990,3578742990,0
2,1190,29172,3578742990,3578742990,0
2,1190,29173,3578742990,3578742990,0
2,1190,29174,3578742990,3578742990,0
2,1190,29175,3578742990,3578742990,0
2,1190,29176,3578742990,3578742990,0
2,1190,29177,3578742990,3578742990,0
2,1190,29178,3578742990,3578742990,0
2,1190,29179,3578742990,3578742990,0
2,1190,29180,3578742990,3578742990,0
2,1190,29181,3578742990,3578742990,0
2,1190,29182,3578742990,3578742991,1
2,1190,29183,3578742990,3578742991,1
2,1190,29184,3578742990,3578742991,1
2,1190,29185,3578742990,3578742992,2
2,1190,29186,3578742990,3578742992,2
2,1190,29187,3578742990,3578742993,3
2,1190,29188,3578742990,3578742993,3
2,1190,29189,3578742990,3578742994,4
2,1190,29190,3578742990,3578742994,4
2,1190,29191,3578742990,3578742995,5
2,1190,29192,3578742990,3578742995,5
2,1190,29193,3578742990,3578742996,6
2,1190,29194,3578742990,3578742999,9
2,1190,29195,3578742990,3578743000,10
2,1190,29196,3578742990,3578743000,10
2,1190,29197,3578742990,3578743000,10
2,1190,29198,3578742990,3578743003,13
2,1190,29199,3578742990,3578743003,13
2,1190,29200,3578742990,3578743004,14
2,1190,29201,3578742990,3578743005,15
2,1190,29202,3578742990,3578743006,16
2,1190,29203,3578742990,3578743006,16
2,1190,29204,3578742990,3578743013,23
2,1190,29205,3578742990,3578743013,23
2,1190,29206,3578742990,3578743014,24
2,1190,29207,3578742990,3578743014,24
2,1190,29208,3578742990,3578743014,24
2,1190,29209,3578742990,3578743016,26
2,1190,29210,3578742990,3578743016,26
2,1190,29211,3578742990,3578743018,28
2,1190,29212,3578742990,3578743020,30
2,1190,29213,3578742990,3578743020,30
2,1190,29214,3578742990,3578743021,31
2,1190,29215,3578742990,3578743021,31
2,1190,29216,3578742990,3578743021,31
2,1190,29217,3578742990,3578743023,33
2,1190,29218,3578742990,3578743023,33
2,1190,29219,3578742990,3578743024,34
2,1190,29220,3578742990,3578743025,35
2,1190,29221,3578742990,3578743026,36
2,1190,29222,3578742990,3578743026,36
2,1190,29223,3578742990,3578743027,37
2,1190,29224,3578742990,3578743027,37
2,1190,29225,3578742990,3578743029,39
2,1190,29226,3578742990,3578743029,39
2,1190,29227,3578742990,3578743030,40
2,1190,29228,3578742990,3578743030,40
2,1190,29229,3578742990,3578743030,40
2,1190,29230,3578742990,3578743031,41
2,1190,29231,3578742990,3578743032,42
2,1190,29232,3578742990,3578743032,42
2,1190,29233,3578742990,3578743032,42
2,1190,29234,3578742990,3578743032,42
2,1190,29235,3578742990,3578743033,43
2,1190,29236,3578742990,3578743033,43
2,1190,29237,3578742990,3578743035,45
2,1190,29238,3578742990,3578743036,46
2,1190,29239,3578742990,3578743036,46
2,1190,29240,3578742990,3578743037,47
2,1190,29241,3578742990,3578743037,47
2,1190,29242,3578742990,3578743037,47
2,1190,29243,3578742990,3578743038,48
2,1191,29244,3578743053,3578743053,0
2,1191,29245,3578743053,3578743053,0
2,1191,29246,3578743053,3578743053,0
2,1191,29247,3578743053,3578743053,0
2,1191,29248,3578743053,3578743053,0
2,1191,29249,3578743053,3578743053,0
2,1191,29250,3578743053,3578743053,0
2,1191,29251,3578743053,3578743053,0
2,1191,29252,3578743053,3578743053,0
2,1191,29253,3578743053,3578743053,0
2,1191,29254,3578743053,3578743053,0
2,1191,29255,3578743053,3578743053,0
2,1191,29256,3578743053,3578743053,0
2,1191,29257,3578743053,3578743053,0
2,1191,29258,3578743053,3578743053,0
2,1191,29259,3578743053,3578743053,0
2,1191,29260,3578743053,3578743053,0
2,1191,29261,3578743053,3578743053,0
2,1191,29262,3578743053,3578743054,1
2,1191,29263,3578743053,3578743055,2
2,1191,29264,3578743053,3578743055,2
2,1191,29265,3578743053,3578743056,3
2,1191,29266,3578743053,3578743057,4
2,1191,29267,3578743053,3578743058,5
2,1191,29268,3578743053,3578743059,6
2,1191,29269,3578743053,3578743060,7
2,1191,29270,3578743053,3578743060,7
2,1191,29271,3578743053,3578743060,7
2,1191,29272,3578743053,3578743060,7
2,1191,29273,3578743053,3578743064,11
2,1191,29274,3578743053,3578743065,12
2,1191,29275,3578743053,3578743066,13
2,1191,29276,3578743053,3578743067,14
2,1191,29277,3578743053,3578743069,16
2,1191,29278,3578743053,3578743069,16
2,1191,29279,3578743053,3578743070,17
2,1191,29280,3578743053,3578743072,19
2,1191,29281,3578743053,3578743073,20
2,1191,29282,3578743053,3578743074,21
2,1191,29283,3578743053,3578743078,25
2,1191,29284,3578743053,3578743080,27
2,1191,29285,3578743053,3578743080,27
2,1191,29286,3578743053,3578743081,28
2,1191,29287,3578743053,3578743081,28
2,1191,29288,3578743053,3578743083,30
2,1191,29289,3578743053,3578743083,30
2,1191,29290,3578743053,3578743083,30
2,1191,29291,3578743053,3578743083,30
2,1191,29292,3578743053,3578743084,31
2,1191,29293,3578743053,3578743084,31
2,1191,29294,3578743053,3578743085,32
2,1191,29295,3578743053,3578743087,34
2,1191,29296,3578743053,3578743087,34
2,1191,29297,3578743053,3578743087,34
2,1191,29298,3578743053,3578743088,35
2,1191,29299,3578743053,3578743089,36
2,1191,29300,3578743053,3578743089,36
2,1191,29301,3578743053,3578743090,37
2,1191,29302,3578743053,3578743090,37
2,1191,29303,3578743053,3578743091,38
2,1191,29304,3578743053,3578743092,39
2,1191,29305,3578743053,3578743093,40
2,1191,29306,3578743053,3578743094,41
2,1191,29307,3578743053,3578743094,41
2,1191,29308,3578743053,3578743094,41
2,1191,29309,3578743053,3578743095,42
2,1191,29310,3578743053,3578743095,42
2,1191,29311,3578743053,3578743096,43
2,1191,29312,3578743053,3578743096,43
2,1191,29313,3578743053,3578743096,43
2,1191,29314,3578743053,3578743097,44
2,1191,29315,3578743053,3578743099,46
2,1191,29316,3578743053,3578743100,47
2,1191,29317,3578743053,3578743101,48
2,1191,29318,3578743053,3578743102,49
2,1192,29319,3578743114,3578743114,0
2,1192,29320,3578743114,3578743114,0
2,1192,29321,3578743114,3578743114,0
2,1192,29322,3578743114,3578743114,0
2,1192,29323,3578743114,3578743114,0
2,1192,29324,3578743114,3578743114,0
2,1192,29325,3578743114,3578743114,0
2,1192,29326,3578743114,3578743114,0
2,1192,29327,3578743114,3578743114,0
2,1192,29328,3578743114,3578743114,0
2,1192,29329,3578743114,3578743114,0
2,1192,29330,3578743114,3578743115,1
2,1192,29331,3578743114,3578743115,1
2,1192,29332,3578743114,3578743115,1
2,1192,29333,3578743114,3578743116,2
2,1192,29334,3578743114,3578743116,2
2,1192,29335,3578743114,3578743117,3
2,1192,29336,3578743114,3578743118,4
2,1192,29337,3578743114,3578743119,5
2,1192,29338,3578743114,3578743119,5
2,1192,29339,3578743114,3578743120,6
2,1192,29340,3578743114,3578743121,7
2,1192,29341,3578743114,3578743122,8
2,1192,29342,3578743114,3578743122,8
2,1192,29343,3578743114,3578743122,8
2,1192,29344,3578743114,3578743123,9
2,1192,29345,3578743114,3578743123,9
2,1192,29346,3578743114,3578743123,9
2,1192,29347,3578743114,3578743125,11
2,1192,29348,3578743114,3578743126,12
2,1192,29349,3578743114,3578743126,12
2,1192,29350,3578743114,3578743127,13
2,1192,29351,3578743114,3578743127,13
2,1192,29352,3578743114,3578743128,14
2,1192,29353,3578743114,3578743132,18
2,1192,29354,3578743114,3578743132,18
2,1192,29355,3578743114,3578743132,18
2,1192,29356,3578743114,3578743133,19
2,1192,29357,3578743114,3578743133,19
2,1192,29358,3578743114,3578743134,20
2,1192,29359,3578743114,3578743134,20
2,1192,29360,3578743114,3578743134,20
2,1192,29361,3578743114,3578743136,22
2,1192,29362,3578743114,3578743137,23
2,1192,29363,3578743114,3578743137,23
2,1192,29364,3578743114,3578743137,23
2,1192,29365,3578743114,3578743138,24
2,1192,29366,3578743114,3578743140,26
2,1192,29367,3578743114,3578743140,26
2,1192,29368,3578743114,3578743140,26
2,1192,29369,3578743114,3578743143,29
2,1192,29370,3578743114,3578743143,29
2,1192,29371,3578743114,3578743143,29
2,1192,29372,3578743114,3578743143,29
2,1192,29373,3578743114,3578743145,31
2,1192,29374,3578743114,3578743148,34
2,1192,29375,3578743114,3578743148,34
2,1192,29376,3578743114,3578743150,36
2,1192,29377,3578743114,3578743150,36
2,1192,29378,3578743114,3578743151,37
2,1192,29379,3578743114,3578743154,40
2,1192,29380,3578743114,3578743154,40
2,1192,29381,3578743114,3578743155,41
2,1192,29382,3578743114,3578743155,41
2,1192,29383,3578743114,3578743157,43
2,1192,29384,3578743114,3578743157,43
2,1192,29385,3578743114,3578743159,45
2,1192,29386,3578743114,3578743162,48
2,1192,29387,3578743114,3578743163,49
2,1192,29388,3578743114,3578743164,50
2,1193,29389,3578743175,3578743175,0
2,1193,29390,3578743175,3578743175,0
2,1193,29391,3578743175,3578743175,0
2,1193,29392,3578743175,3578743175,0
2,1193,29393,3578743175,3578743175,0
2,1193,29394,3578743175,3578743175,0
2,1193,29395,3578743175,3578743175,0
2,1193,29396,3578743175,3578743175,0
2,1193,29397,3578743175,3578743175,0
2,1193,29398,3578743175,3578743175,0
2,1193,29399,3578743175,3578743175,0
2,1193,29400,3578743175,3578743175,0
2,1193,29401,3578743175,3578743176,1
2,1193,29402,3578743175,3578743178,3
2,1193,29403,3578743175,3578743178,3
2,1193,29404,3578743175,3578743178,3
2,1193,29405,3578743175,3578743179,4
2,1193,29406,3578743175,3578743179,4
2,1193,29407,3578743175,3578743179,4
2,1193,29408,3578743175,3578743180,5
2,1193,29409,3578743175,3578743180,5
2,1193,29410,3578743175,3578743182,7
2,1193,29411,3578743175,3578743182,7
2,1193,29412,3578743175,3578743182,7
2,1193,29413,3578743175,3578743184,9
2,1193,29414,3578743175,3578743185,10
2,1193,29415,3578743175,3578743185,10
2,1193,29416,3578743175,3578743185,10
2,1193,29417,3578743175,3578743188,13
2,1193,29418,3578743175,3578743189,14
2,1193,29419,3578743175,3578743189,14
2,1193,29420,3578743175,3578743190,15
2,1193,29421,3578743175,3578743191,16
2,1193,29422,3578743175,3578743192,17
2,1193,29423,3578743175,3578743193,18
2,1193,29424,3578743175,3578743193,18
2,1193,29425,3578743175,3578743194,19
2,1193,29426,3578743175,3578743194,19
2,1193,29427,3578743175,3578743194,19
2,1193,29428,3578743175,3578743194,19
2,1193,29429,3578743175,3578743196,21
2,1193,29430,3578743175,3578743196,21
2,1193,29431,3578743175,3578743200,25
2,1193,29432,3578743175,3578743200,25
2,1193,29433,3578743175,3578743200,25
2,1193,29434,3578743175,3578743200,25
2,1193,29435,3578743175,3578743204,29
2,1193,29436,3578743175,3578743204,29
2,1193,29437,3578743175,3578743204,29
2,1193,29438,3578743175,3578743205,30
2,1193,29439,3578743175,3578743205,30
2,1193,29440,3578743175,3578743206,31
2,1193,29441,3578743175,3578743212,37
2,1193,29442,3578743175,3578743213,38
2,1193,29443,3578743175,3578743214,39
2,1193,29444,3578743175,3578743214,39
2,1193,29445,3578743175,3578743215,40
2,1193,29446,3578743175,3578743215,40
2,1193,29447,3578743175,3578743215,40
2,1193,29448,3578743175,3578743218,43
2,1193,29449,3578743175,3578743220,45
2,1193,29450,3578743175,3578743221,46
2,1193,29451,3578743175,3578743221,46
2,1193,29452,3578743175,3578743221,46
2,1193,29453,3578743175,3578743221,46
2,1193,29454,3578743175,3578743223,48
2,1193,29455,3578743175,3578743223,48
2,1193,29456,3578743175,3578743224,49
2,1194,29457,3578743237,3578743237,0
2,1194,29458,3578743237,3578743237,0
2,1194,29459,3578743237,3578743237,0
2,1194,29460,3578743237,3578743237,0
2,1194,29461,3578743237,3578743237,0
2,1194,29462,3578743237,3578743237,0
2,1194,29463,3578743237,3578743237,0
2,1194,29464,3578743237,3578743237,0
2,1194,29465,3578743237,3578743237,0
2,1194,29466,3578743237,3578743237,0
2,1194,29467,3578743237,3578743237,0
2,1194,29468,3578743237,3578743237,0
2,1194,29469,3578743237,3578743237,0
2,1194,29470,3578743237,3578743237,0
2,1194,29471,3578743237,3578743237,0
2,1194,29472,3578743237,3578743237,0
2,1194,29473,3578743237,3578743237,0
2,1194,29474,3578743237,3578743237,0
2,1194,29475,3578743237,3578743237,0
2,1194,29476,3578743237,3578743237,0
2,1194,29477,3578743237,3578743237,0
2,1194,29478,3578743237,3578743238,1
2,1194,29479,3578743237,3578743239,2
2,1194,29480,3578743237,3578743240,3
2,1194,29481,3578743237,3578743241,4
2,1194,29482,3578743237,3578743241,4
2,1194,29483,3578743237,3578743241,4
2,1194,29484,3578743237,3578743241,4
2,1194,29485,3578743237,3578743242,5
2,1194,29486,3578743237,3578743245,8
2,1194,29487,3578743237,3578743246,9
2,1194,29488,3578743237,3578743247,10
2,1194,29489,3578743237,3578743247,10
2,1194,29490,3578743237,3578743249,12
2,1194,29491,3578743237,3578743249,12
2,1194,29492,3578743237,3578743249,12
2,1194,29493,3578743237,3578743251,14
2,1194,29494,3578743237,3578743252,15
2,1194,29495,3578743237,3578743252,15
2,1194,29496,3578743237,3578743253,16
2,1194,29497,3578743237,3578743254,17
2,1194,29498,3578743237,3578743254,17
2,1194,29499,3578743237,3578743255,18
2,1194,29500,3578743237,3578743255,18
2,1194,29501,3578743237,3578743257,20
2,1194,29502,3578743237,3578743258,21
2,1194,29503,3578743237,3578743259,22
2,1194,29504,3578743237,3578743259,22
2,1194,29505,3578743237,3578743260,23
2,1194,29506,3578743237,3578743261,24
2,1194,29507,3578743237,3578743261,24
2,1194,29508,3578743237,3578743264,27
2,1194,29509,3578743237,3578743266,29
2,1194,29510,3578743237,3578743267,30
2,1194,29511,3578743237,3578743268,31
2,1194,29512,3578743237,3578743269,32
2,1194,29513,3578743237,3578743269,32
2,1194,29514,3578743237,3578743270,33
2,1194,29515,3578743237,3578743272,35
2,1194,29516,3578743237,3578743273,36
2,1194,29517,3578743237,3578743274,37
2,1194,29518,3578743237,3578743279,42
2,1194,29519,3578743237,3578743280,43
2,1194,29520,3578743237,3578743281,44
2,1194,29521,3578743237,3578743281,44
2,1194,29522,3578743237,3578743281,44
2,1194,29523,3578743237,3578743282,45
2,1194,29524,3578743237,3578743283,46
2,1194,29525,3578743237,3578743283,46
2,1194,29526,3578743237,3578743284,47
2,1194,29527,3578743237,3578743284,47
2,1194,29528,3578743237,3578743284,47
2,1194,29529,3578743237,3578743284,47
2,1194,29530,3578743237,3578743286,49
2,1194,29531,3578743237,3578743287,50
2,1195,29532,3578743298,3578743298,0
2,1195,29533,3578743298,3578743298,0
2,1195,29534,3578743298,3578743298,0
2,1195,29535,3578743298,3578743298,0
2,1195,29536,3578743298,3578743298,0
2,1195,29537,3578743298,3578743298,0
2,1195,29538,3578743298,3578743298,0
2,1195,29539,3578743298,3578743298,0
2,1195,29540,3578743298,3578743298,0
2,1195,29541,3578743298,3578743298,0
2,1195,29542,3578743298,3578743298,0
2,1195,29543,3578743298,3578743298,0
2,1195,29544,3578743298,3578743298,0
2,1195,29545,3578743298,3578743298,0
2,1195,29546,3578743298,3578743298,0
2,1195,29547,3578743298,3578743298,0
2,1195,29548,3578743298,3578743298,0
2,1195,29549,3578743298,3578743298,0
2,1195,29550,3578743298,3578743298,0
2,1195,29551,3578743298,3578743298,0
2,1195,29552,3578743298,3578743299,1
2,1195,29553,3578743298,3578743300,2
2,1195,29554,3578743298,3578743301,3
2,1195,29555,3578743298,3578743301,3
2,1195,29556,3578743298,3578743305,7
2,1195,29557,3578743298,3578743306,8
2,1195,29558,3578743298,3578743308,10
2,1195,29559,3578743298,3578743309,11
2,1195,29560,3578743298,3578743309,11
2,1195,29561,3578743298,3578743309,11
2,1195,29562,3578743298,3578743309,11
2,1195,29563,3578743298,3578743311,13
2,1195,29564,3578743298,3578743313,15
2,1195,29565,3578743298,3578743313,15
2,1195,29566,3578743298,3578743314,16
2,1195,29567,3578743298,3578743315,17
2,1195,29568,3578743298,3578743316,18
2,1195,29569,3578743298,3578743316,18
2,1195,29570,3578743298,3578743317,19
2,1195,29571,3578743298,3578743318,20
2,1195,29572,3578743298,3578743319,21
2,1195,29573,3578743298,3578743320,22
2,1195,29574,3578743298,3578743321,23
2,1195,29575,3578743298,3578743322,24
2,1195,29576,3578743298,3578743322,24
2,1195,29577,3578743298,3578743322,24
2,1195,29578,3578743298,3578743323,25
2,1195,29579,3578743298,3578743323,25
2,1195,29580,3578743298,3578743323,25
2,1195,29581,3578743298,3578743323,25
2,1195,29582,3578743298,3578743325,27
2,1195,29583,3578743298,3578743326,28
2,1195,29584,3578743298,3578743326,28
2,1195,29585,3578743298,3578743326,28
2,1195,29586,3578743298,3578743327,29
2,1195,29587,3578743298,3578743327,29
2,1195,29588,3578743298,3578743327,29
2,1195,29589,3578743298,3578743332,34
2,1195,29590,3578743298,3578743332,34
2,1195,29591,3578743298,3578743332,34
2,1195,29592,3578743298,3578743333,35
2,1195,29593,3578743298,3578743333,35
2,1195,29594,3578743298,3578743333,35
2,1195,29595,3578743298,3578743334,36
2,1195,29596,3578743298,3578743334,36
2,1195,29597,3578743298,3578743336,38
2,1195,29598,3578743298,3578743337,39
2,1195,29599,3578743298,3578743338,40
2,1195,29600,3578743298,3578743338,40
2,1195,29601,3578743298,3578743339,41
2,1195,29602,3578743298,3578743341,43
2,1195,29603,3578743298,3578743341,43
2,1195,29604,3578743298,3578743341,43
2,1195,29605,3578743298,3578743342,44
2,1195,29606,3578743298,3578743342,44
2,1195,29607,3578743298,3578743343,45
2,1195,29608,3578743298,3578743343,45
2,1195,29609,3578743298,3578743347,49
2,1195,29610,3578743298,3578743348,50
2,1196,29611,3578743361,3578743361,0
2,1196,29612,3578743361,3578743361,0
2,1196,29613,3578743361,3578743361,0
2,1196,29614,3578743361,3578743361,0
2,1196,29615,3578743361,3578743361,0
2,1196,29616,3578743361,3578743361,0
2,1196,29617,3578743361,3578743361,0
2,1196,29618,3578743361,3578743361,0
2,1196,29619,3578743361,3578743361,0
2,1196,29620,3578743361,3578743362,1
2,1196,29621,3578743361,3578743363,2
2,1196,29622,3578743361,3578743363,2
2,1196,29623,3578743361,3578743364,3
2,1196,29624,3578743361,3578743365,4
2,1196,29625,3578743361,3578743365,4
2,1196,29626,3578743361,3578743366,5
2,1196,29627,3578743361,3578743366,5
2,1196,29628,3578743361,3578743366,5
2,1196,29629,3578743361,3578743367,6
2,1196,29630,3578743361,3578743367,6
2,1196,29631,3578743361,3578743368,7
2,1196,29632,3578743361,3578743370,9
2,1196,29633,3578743361,3578743372,11
2,1196,29634,3578743361,3578743373,12
2,1196,29635,3578743361,3578743376,15
2,1196,29636,3578743361,3578743377,16
2,1196,29637,3578743361,3578743378,17
2,1196,29638,3578743361,3578743379,18
2,1196,29639,3578743361,3578743379,18
2,1196,29640,3578743361,3578743379,18
2,1196,29641,3578743361,3578743380,19
2,1196,29642,3578743361,3578743380,19
2,1196,29643,3578743361,3578743380,19
2,1196,29644,3578743361,3578743380,19
2,1196,29645,3578743361,3578743382,21
2,1196,29646,3578743361,3578743383,22
2,1196,29647,3578743361,3578743383,22
2,1196,29648,3578743361,3578743385,24
2,1196,29649,3578743361,3578743385,24
2,1196,29650,3578743361,3578743385,24
2,1196,29651,3578743361,3578743385,24
2,1196,29652,3578743361,3578743385,24
2,1196,29653,3578743361,3578743389,28
2,1196,29654,3578743361,3578743389,28
2,1196,29655,3578743361,3578743390,29
2,1196,29656,3578743361,3578743391,30
2,1196,29657,3578743361,3578743391,30
2,1196,29658,3578743361,3578743392,31
2,1196,29659,3578743361,3578743393,32
2,1196,29660,3578743361,3578743393,32
2,1196,29661,3578743361,3578743394,33
2,1196,29662,3578743361,3578743394,33
2,1196,29663,3578743361,3578743394,33
2,1196,29664,3578743361,3578743394,33
2,1196,29665,3578743361,3578743396,35
2,1196,29666,3578743361,3578743396,35
2,1196,29667,3578743361,3578743399,38
2,1196,29668,3578743361,3578743400,39
2,1196,29669,3578743361,3578743400,39
2,1196,29670,3578743361,3578743400,39
2,1196,29671,3578743361,3578743403,42
2,1196,29672,3578743361,3578743404,43
2,1196,29673,3578743361,3578743405,44
2,1196,29674,3578743361,3578743405,44
2,1196,29675,3578743361,3578743406,45
2,1196,29676,3578743361,3578743406,45
2,1197,29677,3578743423,3578743424,1
2,1197,29678,3578743423,3578743424,1
2,1197,29679,3578743423,3578743424,1
2,1197,29680,3578743423,3578743424,1
2,1197,29681,3578743423,3578743424,1
2,1197,29682,3578743423,3578743424,1
2,1197,29683,3578743423,3578743424,1
2,1197,29684,3578743423,3578743424,1
2,1197,29685,3578743423,3578743424,1
2,1197,29686,3578743423,3578743424,1
2,1197,29687,3578743423,3578743424,1
2,1197,29688,3578743423,3578743424,1
2,1197,29689,3578743423,3578743424,1
2,1197,29690,3578743423,3578743424,1
2,1197,29691,3578743423,3578743424,1
2,1197,29692,3578743423,3578743425,2
2,1197,29693,3578743423,3578743426,3
2,1197,29694,3578743423,3578743426,3
2,1197,29695,3578743423,3578743427,4
2,1197,29696,3578743423,3578743428,5
2,1197,29697,3578743423,3578743430,7
2,1197,29698,3578743423,3578743430,7
2,1197,29699,3578743423,3578743430,7
2,1197,29700,3578743423,3578743431,8
2,1197,29701,3578743423,3578743431,8
2,1197,29702,3578743423,3578743431,8
2,1197,29703,3578743423,3578743432,9
2,1197,29704,3578743423,3578743432,9
2,1197,29705,3578743423,3578743432,9
2,1197,29706,3578743423,3578743433,10
2,1197,29707,3578743423,3578743434,11
2,1197,29708,3578743423,3578743436,13
2,1197,29709,3578743423,3578743437,14
2,1197,29710,3578743423,3578743438,15
2,1197,29711,3578743423,3578743438,15
2,1197,29712,3578743423,3578743438,15
2,1197,29713,3578743423,3578743439,16
2,1197,29714,3578743423,3578743439,16
2,1197,29715,3578743423,3578743441,18
2,1197,29716,3578743423,3578743441,18
2,1197,29717,3578743423,3578743441,18
2,1197,29718,3578743423,3578743442,19
2,1197,29719,3578743423,3578743442,19
2,1197,29720,3578743423,3578743443,20
2,1197,29721,3578743423,3578743445,22
2,1197,29722,3578743423,3578743447,24
2,1197,29723,3578743423,3578743447,24
2,1197,29724,3578743423,3578743447,24
2,1197,29725,3578743423,3578743450,27
2,1197,29726,3578743423,3578743450,27
2,1197,29727,3578743423,3578743450,27
2,1197,29728,3578743423,3578743451,28
2,1197,29729,3578743423,3578743451,28
2,1197,29730,3578743423,3578743452,29
2,1197,29731,3578743423,3578743454,31
2,1197,29732,3578743423,3578743455,32
2,1197,29733,3578743423,3578743455,32
2,1197,29734,3578743423,3578743455,32
2,1197,29735,3578743423,3578743456,33
2,1197,29736,3578743423,3578743456,33
2,1197,29737,3578743423,3578743458,35
2,1197,29738,3578743423,3578743459,36
2,1197,29739,3578743423,3578743459,36
2,1197,29740,3578743423,3578743459,36
2,1197,29741,3578743423,3578743460,37
2,1197,29742,3578743423,3578743461,38
2,1197,29743,3578743423,3578743464,41
2,1197,29744,3578743423,3578743466,43
2,1197,29745,3578743423,3578743467,44
2,1197,29746,3578743423,3578743468,45
2,1197,29747,3578743423,3578743469,46
2,1197,29748,3578743423,3578743469,46
2,1197,29749,3578743423,3578743470,47
2,1197,29750,3578743423,3578743472,49
2,1198,29751,3578743486,3578743486,0
2,1198,29752,3578743486,3578743486,0
2,1198,29753,3578743486,3578743486,0
2,1198,29754,3578743486,3578743486,0
2,1198,29755,3578743486,3578743486,0
2,1198,29756,3578743486,3578743486,0
2,1198,29757,3578743486,3578743486,0
2,1198,29758,3578743486,3578743486,0
2,1198,29759,3578743486,3578743486,0
2,1198,29760,3578743486,3578743486,0
2,1198,29761,3578743486,3578743486,0
2,1198,29762,3578743486,3578743486,0
2,1198,29763,3578743486,3578743486,0
2,1198,29764,3578743486,3578743486,0
2,1198,29765,3578743486,3578743486,0
2,1198,29766,3578743486,3578743486,0
2,1198,29767,3578743486,3578743487,1
2,1198,29768,3578743486,3578743487,1
2,1198,29769,3578743486,3578743488,2
2,1198,29770,3578743486,3578743488,2
2,1198,29771,3578743486,3578743489,3
2,1198,29772,3578743486,3578743490,4
2,1198,29773,3578743486,3578743491,5
2,1198,29774,3578743486,3578743491,5
2,1198,29775,3578743486,3578743491,5
2,1198,29776,3578743486,3578743492,6
2,1198,29777,3578743486,3578743493,7
2,1198,29778,3578743486,3578743493,7
2,1198,29779,3578743486,3578743494,8
2,1198,29780,3578743486,3578743494,8
2,1198,29781,3578743486,3578743494,8
2,1198,29782,3578743486,3578743494,8
2,1198,29783,3578743486,3578743495,9
2,1198,29784,3578743486,3578743496,10
2,1198,29785,3578743486,3578743497,11
2,1198,29786,3578743486,3578743499,13
2,1198,29787,3578743486,3578743500,14
2,1198,29788,3578743486,3578743500,14
2,1198,29789,3578743486,3578743504,18
2,1198,29790,3578743486,3578743507,21
2,1198,29791,3578743486,3578743508,22
2,1198,29792,3578743486,3578743508,22
2,1198,29793,3578743486,3578743508,22
2,1198,29794,3578743486,3578743509,23
2,1198,29795,3578743486,3578743509,23
2,1198,29796,3578743486,3578743512,26
2,1198,29797,3578743486,3578743512,26
2,1198,29798,3578743486,3578743514,28
2,1198,29799,3578743486,3578743515,29
2,1198,29800,3578743486,3578743515,29
2,1198,29801,3578743486,3578743515,29
2,1198,29802,3578743486,3578743515,29
2,1198,29803,3578743486,3578743516,30
2,1198,29804,3578743486,3578743516,30
2,1198,29805,3578743486,3578743517,31
2,1198,29806,3578743486,3578743517,31
2,1198,29807,3578743486,3578743519,33
2,1198,29808,3578743486,3578743519,33
2,1198,29809,3578743486,3578743520,34
2,1198,29810,3578743486,3578743521,35
2,1198,29811,3578743486,3578743521,35
2,1198,29812,3578743486,3578743521,35
2,1198,29813,3578743486,3578743522,36
2,1198,29814,3578743486,3578743522,36
2,1198,29815,3578743486,3578743524,38
2,1198,29816,3578743486,3578743524,38
2,1198,29817,3578743486,3578743524,38
2,1198,29818,3578743486,3578743525,39
2,1198,29819,3578743486,3578743525,39
2,1198,29820,3578743486,3578743526,40
2,1198,29821,3578743486,3578743526,40
2,1198,29822,3578743486,3578743527,41
2,1198,29823,3578743486,3578743530,44
2,1198,29824,3578743486,3578743530,44
2,1198,29825,3578743486,3578743531,45
2,1198,29826,3578743486,3578743532,46
2,1198,29827,3578743486,3578743532,46
2,1198,29828,3578743486,3578743532,46
2,1198,29829,3578743486,3578743534,48
2,1198,29830,3578743486,3578743534,48
2,1198,29831,3578743486,3578743535,49
2,1198,29832,3578743486,3578743535,49
2,1198,29833,3578743486,3578743536,50
2,1199,29834,3578743548,3578743548,0
2,1199,29835,3578743548,3578743548,0
2,1199,29836,3578743548,3578743548,0
2,1199,29837,3578743548,3578743548,0
2,1199,29838,3578743548,3578743548,0
2,1199,29839,3578743548,3578743548,0
2,1199,29840,3578743548,3578743548,0
2,1199,29841,3578743548,3578743548,0
2,1199,29842,3578743548,3578743548,0
2,1199,29843,3578743548,3578743548,0
2,1199,29844,3578743548,3578743548,0
2,1199,29845,3578743548,3578743548,0
2,1199,29846,3578743548,3578743549,1
2,1199,29847,3578743548,3578743549,1
2,1199,29848,3578743548,3578743549,1
2,1199,29849,3578743548,3578743550,2
2,1199,29850,3578743548,3578743553,5
2,1199,29851,3578743548,3578743554,6
2,1199,29852,3578743548,3578743554,6
2,1199,29853,3578743548,3578743556,8
2,1199,29854,3578743548,3578743557,9
2,1199,29855,3578743548,3578743561,13
2,1199,29856,3578743548,3578743562,14
2,1199,29857,3578743548,3578743563,15
2,1199,29858,3578743548,3578743563,15
2,1199,29859,3578743548,3578743563,15
2,1199,29860,3578743548,3578743564,16
2,1199,29861,3578743548,3578743565,17
2,1199,29862,3578743548,3578743565,17
2,1199,29863,3578743548,3578743566,18
2,1199,29864,3578743548,3578743567,19
2,1199,29865,3578743548,3578743567,19
2,1199,29866,3578743548,3578743569,21
2,1199,29867,3578743548,3578743569,21
2,1199,29868,3578743548,3578743569,21
2,1199,29869,3578743548,3578743571,23
2,1199,29870,3578743548,3578743572,24
2,1199,29871,3578743548,3578743574,26
2,1199,29872,3578743548,3578743576,28
2,1199,29873,3578743548,3578743576,28
2,1199,29874,3578743548,3578743577,29
2,1199,29875,3578743548,3578743578,30
2,1199,29876,3578743548,3578743578,30
2,1199,29877,3578743548,3578743578,30
2,1199,29878,3578743548,3578743578,30
2,1199,29879,3578743548,3578743579,31
2,1199,29880,3578743548,3578743579,31
2,1199,29881,3578743548,3578743580,32
2,1199,29882,3578743548,3578743581,33
2,1199,29883,3578743548,3578743581,33
2,1199,29884,3578743548,3578743582,34
2,1199,29885,3578743548,3578743583,35
2,1199,29886,3578743548,3578743584,36
2,1199,29887,3578743548,3578743584,36
2,1199,29888,3578743548,3578743588,40
2,1199,29889,3578743548,3578743588,40
2,1199,29890,3578743548,3578743589,41
2,1199,29891,3578743548,3578743589,41
2,1199,29892,3578743548,3578743590,42
2,1199,29893,3578743548,3578743591,43
2,1199,29894,3578743548,3578743591,43
2,1199,29895,3578743548,3578743591,43
2,1199,29896,3578743548,3578743593,45
2,1199,29897,3578743548,3578743593,45
2,1199,29898,3578743548,3578743593,45
2,1199,29899,3578743548,3578743593,45
2,1199,29900,3578743548,3578743594,46
2,1199,29901,3578743548,3578743595,47
2,1199,29902,3578743548,3578743595,47
2,1200,29903,3578743610,3578743610,0
2,1200,29904,3578743610,3578743610,0
2,1200,29905,3578743610,3578743610,0
2,1200,29906,3578743610,3578743610,0
2,1200,29907,3578743610,3578743610,0
2,1200,29908,3578743610,3578743610,0
2,1200,29909,3578743610,3578743610,0
2,1200,29910,3578743610,3578743610,0
2,1200,29911,3578743610,3578743610,0
2,1200,29912,3578743610,3578743610,0
2,1200,29913,3578743610,3578743612,2
2,1200,29914,3578743610,3578743612,2
2,1200,29915,3578743610,3578743614,4
2,1200,29916,3578743610,3578743614,4
2,1200,29917,3578743610,3578743615,5
2,1200,29918,3578743610,3578743615,5
2,1200,29919,3578743610,3578743616,6
2,1200,29920,3578743610,3578743618,8
2,1200,29921,3578743610,3578743619,9
2,1200,29922,3578743610,3578743620,10
2,1200,29923,3578743610,3578743620,10
2,1200,29924,3578743610,3578743621,11
2,1200,29925,3578743610,3578743621,11
2,1200,29926,3578743610,3578743622,12
2,1200,29927,3578743610,3578743622,12
2,1200,29928,3578743610,3578743624,14
2,1200,29929,3578743610,3578743625,15
2,1200,29930,3578743610,3578743626,16
2,1200,29931,3578743610,3578743626,16
2,1200,29932,3578743610,3578743629,19
2,1200,29933,3578743610,3578743629,19
2,1200,29934,3578743610,3578743630,20
2,1200,29935,3578743610,3578743630,20
2,1200,29936,3578743610,3578743630,20
2,1200,29937,3578743610,3578743631,21
2,1200,29938,3578743610,3578743631,21
2,1200,29939,3578743610,3578743631,21
2,1200,29940,3578743610,3578743632,22
2,1200,29941,3578743610,3578743632,22
2,1200,29942,3578743610,3578743636,26
2,1200,29943,3578743610,3578743636,26
2,1200,29944,3578743610,3578743637,27
2,1200,29945,3578743610,3578743637,27
2,1200,29946,3578743610,3578743638,28
2,1200,29947,3578743610,3578743638,28
2,1200,29948,3578743610,3578743639,29
2,1200,29949,3578743610,3578743640,30
2,1200,29950,3578743610,3578743640,30
2,1200,29951,3578743610,3578743640,30
2,1200,29952,3578743610,3578743641,31
2,1200,29953,3578743610,3578743641,31
2,1200,29954,3578743610,3578743641,31
2,1200,29955,3578743610,3578743645,35
2,1200,29956,3578743610,3578743645,35
2,1200,29957,3578743610,3578743646,36
2,1200,29958,3578743610,3578743646,36
2,1200,29959,3578743610,3578743649,39
2,1200,29960,3578743610,3578743649,39
2,1200,29961,3578743610,3578743650,40
2,1200,29962,3578743610,3578743650,40
2,1200,29963,3578743610,3578743651,41
2,1200,29964,3578743610,3578743651,41
2,1200,29965,3578743610,3578743654,44
2,1200,29966,3578743610,3578743654,44
2,1200,29967,3578743610,3578743654,44
2,1200,29968,3578743610,3578743654,44
2,1200,29969,3578743610,3578743654,44
2,1200,29970,3578743610,3578743657,47
2,1200,29971,3578743610,3578743657,47
2,1200,29972,3578743610,3578743658,48
2,1200,29973,3578743610,3578743658,48
2,1200,29974,3578743610,3578743659,49
2,1200,29975,3578743610,3578743659,49
2,1200,29976,3578743610,3578743660,50
2,1201,29977,3578743672,3578743672,0
2,1201,29978,3578743672,3578743672,0
2,1201,29979,3578743672,3578743672,0
2,1201,29980,3578743672,3578743672,0
2,1201,29981,3578743672,3578743672,0
2,1201,29982,3578743672,3578743672,0
2,1201,29983,3578743672,3578743672,0
2,1201,29984,3578743672,3578743672,0
2,1201,29985,3578743672,3578743672,0
2,1201,29986,3578743672,3578743672,0
2,1201,29987,3578743672,3578743673,1
2,1201,29988,3578743672,3578743675,3
2,1201,29989,3578743672,3578743679,7
2,1201,29990,3578743672,3578743679,7
2,1201,29991,3578743672,3578743680,8
2,1201,29992,3578743672,3578743680,8
2,1201,29993,3578743672,3578743681,9
2,1201,29994,3578743672,3578743681,9
2,1201,29995,3578743672,3578743681,9
2,1201,29996,3578743672,3578743682,10
2,1201,29997,3578743672,3578743682,10
2,1201,29998,3578743672,3578743684,12
2,1201,29999,3578743672,3578743684,12
2,1201,30000,3578743672,3578743684,12
2,1201,30001,3578743672,3578743686,14
2,1201,30002,3578743672,3578743687,15
2,1201,30003,3578743672,3578743688,16
2,1201,30004,3578743672,3578743689,17
2,1201,30005,3578743672,3578743689,17
2,1201,30006,3578743672,3578743690,18
2,1201,30007,3578743672,3578743690,18
2,1201,30008,3578743672,3578743691,19
2,1201,30009,3578743672,3578743691,19
2,1201,30010,3578743672,3578743691,19
2,1201,30011,3578743672,3578743693,21
2,1201,30012,3578743672,3578743693,21
2,1201,30013,3578743672,3578743693,21
2,1201,30014,3578743672,3578743694,22
2,1201,30015,3578743672,3578743694,22
2,1201,30016,3578743672,3578743694,22
2,1201,30017,3578743672,3578743694,22
2,1201,30018,3578743672,3578743694,22
2,1201,30019,3578743672,3578743695,23
2,1201,30020,3578743672,3578743695,23
2,1201,30021,3578743672,3578743696,24
2,1201,30022,3578743672,3578743697,25
2,1201,30023,3578743672,3578743698,26
2,1201,30024,3578743672,3578743699,27
2,1201,30025,3578743672,3578743699,27
2,1201,30026,3578743672,3578743700,28
2,1201,30027,3578743672,3578743700,28
2,1201,30028,3578743672,3578743705,33
2,1201,30029,3578743672,3578743706,34
2,1201,30030,3578743672,3578743707,35
2,1201,30031,3578743672,3578743708,36
2,1201,30032,3578743672,3578743708,36
2,1201,30033,3578743672,3578743709,37
2,1201,30034,3578743672,3578743710,38
2,1201,30035,3578743672,3578743711,39
2,1201,30036,3578743672,3578743712,40
2,1201,30037,3578743672,3578743714,42
2,1201,30038,3578743672,3578743714,42
2,1201,30039,3578743672,3578743715,43
2,1201,30040,3578743672,3578743715,43
2,1201,30041,3578743672,3578743716,44
2,1201,30042,3578743672,3578743716,44
2,1201,30043,3578743672,3578743717,45
2,1201,30044,3578743672,3578743717,45
2,1201,30045,3578743672,3578743717,45
2,1201,30046,3578743672,3578743718,46
2,1201,30047,3578743672,3578743719,47
2,1201,30048,3578743672,3578743720,48
2,1201,30049,3578743672,3578743721,49
2,1201,30050,3578743672,3578743721,49
2,1201,30051,3578743672,3578743721,49
2,1201,30052,3578743672,3578743721,49
2,1201,30053,3578743672,3578743722,50
2,1202,30054,3578743733,3578743733,0
2,1202,30055,3578743733,3578743733,0
2,1202,30056,3578743733,3578743733,0
2,1202,30057,3578743733,3578743733,0
2,1202,30058,3578743733,3578743733,0
2,1202,30059,3578743733,3578743733,0
2,1202,30060,3578743733,3578743733,0
2,1202,30061,3578743733,3578743733,0
2,1202,30062,3578743733,3578743733,0
2,1202,30063,3578743733,3578743733,0
2,1202,30064,3578743733,3578743733,0
2,1202,30065,3578743733,3578743733,0
2,1202,30066,3578743733,3578743733,0
2,1202,30067,3578743733,3578743733,0
2,1202,30068,3578743733,3578743735,2
2,1202,30069,3578743733,3578743735,2
2,1202,30070,3578743733,3578743736,3
2,1202,30071,3578743733,3578743737,4
2,1202,30072,3578743733,3578743737,4
2,1202,30073,3578743733,3578743739,6
2,1202,30074,3578743733,3578743740,7
2,1202,30075,3578743733,3578743740,7
2,1202,30076,3578743733,3578743740,7
2,1202,30077,3578743733,3578743741,8
2,1202,30078,3578743733,3578743741,8
2,1202,30079,3578743733,3578743743,10
2,1202,30080,3578743733,3578743744,11
2,1202,30081,3578743733,3578743744,11
2,1202,30082,3578743733,3578743745,12
2,1202,30083,3578743733,3578743747,14
2,1202,30084,3578743733,3578743748,15
2,1202,30085,3578743733,3578743749,16
2,1202,30086,3578743733,3578743749,16
2,1202,30087,3578743733,3578743750,17
2,1202,30088,3578743733,3578743753,20
2,1202,30089,3578743733,3578743754,21
2,1202,30090,3578743733,3578743754,21
2,1202,30091,3578743733,3578743755,22
2,1202,30092,3578743733,3578743756,23
2,1202,30093,3578743733,3578743759,26
2,1202,30094,3578743733,3578743759,26
2,1202,30095,3578743733,3578743761,28
2,1202,30096,3578743733,3578743762,29
2,1202,30097,3578743733,3578743763,30
2,1202,30098,3578743733,3578743764,31
2,1202,30099,3578743733,3578743764,31
2,1202,30100,3578743733,3578743765,32
2,1202,30101,3578743733,3578743766,33
2,1202,30102,3578743733,3578743766,33
2,1202,30103,3578743733,3578743766,33
2,1202,30104,3578743733,3578743766,33
2,1202,30105,3578743733,3578743767,34
2,1202,30106,3578743733,3578743767,34
2,1202,30107,3578743733,3578743769,36
2,1202,30108,3578743733,3578743769,36
2,1202,30109,3578743733,3578743771,38
2,1202,30110,3578743733,3578743772,39
2,1202,30111,3578743733,3578743774,41
2,1202,30112,3578743733,3578743775,42
2,1202,30113,3578743733,3578743776,43
2,1202,30114,3578743733,3578743777,44
2,1202,30115,3578743733,3578743778,45
2,1202,30116,3578743733,3578743778,45
2,1202,30117,3578743733,3578743778,45
2,1202,30118,3578743733,3578743778,45
2,1202,30119,3578743733,3578743778,45
2,1202,30120,3578743733,3578743779,46
2,1202,30121,3578743733,3578743780,47
2,1202,30122,3578743733,3578743781,48
2,1202,30123,3578743733,3578743782,49
2,1203,30124,3578743795,3578743795,0
2,1203,30125,3578743795,3578743795,0
2,1203,30126,3578743795,3578743795,0
2,1203,30127,3578743795,3578743795,0
2,1203,30128,3578743795,3578743795,0
2,1203,30129,3578743795,3578743795,0
2,1203,30130,3578743795,3578743795,0
2,1203,30131,3578743795,3578743795,0
2,1203,30132,3578743795,3578743795,0
2,1203,30133,3578743795,3578743795,0
2,1203,30134,3578743795,3578743795,0
2,1203,30135,3578743795,3578743795,0
2,1203,30136,3578743795,3578743795,0
2,1203,30137,3578743795,3578743795,0
2,1203,30138,3578743795,3578743795,0
2,1203,30139,3578743795,3578743795,0
2,1203,30140,3578743795,3578743795,0
2,1203,30141,3578743795,3578743796,1
2,1203,30142,3578743795,3578743798,3
2,1203,30143,3578743795,3578743798,3
2,1203,30144,3578743795,3578743799,4
2,1203,30145,3578743795,3578743799,4
2,1203,30146,3578743795,3578743803,8
2,1203,30147,3578743795,3578743803,8
2,1203,30148,3578743795,3578743804,9
2,1203,30149,3578743795,3578743804,9
2,1203,30150,3578743795,3578743805,10
2,1203,30151,3578743795,3578743806,11
2,1203,30152,3578743795,3578743812,17
2,1203,30153,3578743795,3578743813,18
2,1203,30154,3578743795,3578743814,19
2,1203,30155,3578743795,3578743814,19
2,1203,30156,3578743795,3578743814,19
2,1203,30157,3578743795,3578743815,20
2,1203,30158,3578743795,3578743817,22
2,1203,30159,3578743795,3578743818,23
2,1203,30160,3578743795,3578743820,25
2,1203,30161,3578743795,3578743820,25
2,1203,30162,3578743795,3578743821,26
2,1203,30163,3578743795,3578743821,26
2,1203,30164,3578743795,3578743822,27
2,1203,30165,3578743795,3578743822,27
2,1203,30166,3578743795,3578743823,28
2,1203,30167,3578743795,3578743824,29
2,1203,30168,3578743795,3578743824,29
2,1203,30169,3578743795,3578743825,30
2,1203,30170,3578743795,3578743826,31
2,1203,30171,3578743795,3578743827,32
2,1203,30172,3578743795,3578743828,33
2,1203,30173,3578743795,3578743829,34
2,1203,30174,3578743795,3578743829,34
2,1203,30175,3578743795,3578743829,34
2,1203,30176,3578743795,3578743829,34
2,1203,30177,3578743795,3578743830,35
2,1203,30178,3578743795,3578743831,36
2,1203,30179,3578743795,3578743832,37
2,1203,30180,3578743795,3578743832,37
2,1203,30181,3578743795,3578743833,38
2,1203,30182,3578743795,3578743833,38
2,1203,30183,3578743795,3578743834,39
2,1203,30184,3578743795,3578743835,40
2,1203,30185,3578743795,3578743836,41
2,1203,30186,3578743795,3578743837,42
2,1203,30187,3578743795,3578743837,42
2,1203,30188,3578743795,3578743837,42
2,1203,30189,3578743795,3578743838,43
2,1203,30190,3578743795,3578743840,45
2,1203,30191,3578743795,3578743840,45
2,1203,30192,3578743795,3578743840,45
2,1203,30193,3578743795,3578743841,46
2,1203,30194,3578743795,3578743841,46
2,1203,30195,3578743795,3578743842,47
2,1203,30196,3578743795,3578743842,47
2,1203,30197,3578743795,3578743843,48
2,1203,30198,3578743795,3578743844,49
2,1203,30199,3578743795,3578743845,50
2,1204,30200,3578743858,3578743858,0
2,1204,30201,3578743858,3578743858,0
2,1204,30202,3578743858,3578743858,0
2,1204,30203,3578743858,3578743858,0
2,1204,30204,3578743858,3578743858,0
2,1204,30205,3578743858,3578743858,0
2,1204,30206,3578743858,3578743858,0
2,1204,30207,3578743858,3578743858,0
2,1204,30208,3578743858,3578743858,0
2,1204,30209,3578743858,3578743858,0
2,1204,30210,3578743858,3578743858,0
2,1204,30211,3578743858,3578743858,0
2,1204,30212,3578743858,3578743858,0
2,1204,30213,3578743858,3578743858,0
2,1204,30214,3578743858,3578743858,0
2,1204,30215,3578743858,3578743858,0
2,1204,30216,3578743858,3578743858,0
2,1204,30217,3578743858,3578743859,1
2,1204,30218,3578743858,3578743860,2
2,1204,30219,3578743858,3578743860,2
2,1204,30220,3578743858,3578743860,2
2,1204,30221,3578743858,3578743861,3
2,1204,30222,3578743858,3578743863,5
2,1204,30223,3578743858,3578743865,7
2,1204,30224,3578743858,3578743865,7
2,1204,30225,3578743858,3578743866,8
2,1204,30226,3578743858,3578743866,8
2,1204,30227,3578743858,3578743868,10
2,1204,30228,3578743858,3578743868,10
2,1204,30229,3578743858,3578743870,12
2,1204,30230,3578743858,3578743872,14
2,1204,30231,3578743858,3578743874,16
2,1204,30232,3578743858,3578743876,18
2,1204,30233,3578743858,3578743878,20
2,1204,30234,3578743858,3578743880,22
2,1204,30235,3578743858,3578743880,22
2,1204,30236,3578743858,3578743881,23
2,1204,30237,3578743858,3578743881,23
2,1204,30238,3578743858,3578743881,23
2,1204,30239,3578743858,3578743882,24
2,1204,30240,3578743858,3578743882,24
2,1204,30241,3578743858,3578743883,25
2,1204,30242,3578743858,3578743883,25
2,1204,30243,3578743858,3578743884,26
2,1204,30244,3578743858,3578743884,26
2,1204,30245,3578743858,3578743886,28
2,1204,30246,3578743858,3578743887,29
2,1204,30247,3578743858,3578743888,30
2,1204,30248,3578743858,3578743889,31
2,1204,30249,3578743858,3578743889,31
2,1204,30250,3578743858,3578743890,32
2,1204,30251,3578743858,3578743890,32
2,1204,30252,3578743858,3578743890,32
2,1204,30253,3578743858,3578743890,32
2,1204,30254,3578743858,3578743891,33
2,1204,30255,3578743858,3578743892,34
2,1204,30256,3578743858,3578743893,35
2,1204,30257,3578743858,3578743893,35
2,1204,30258,3578743858,3578743894,36
2,1204,30259,3578743858,3578743894,36
2,1204,30260,3578743858,3578743894,36
2,1204,30261,3578743858,3578743894,36
2,1204,30262,3578743858,3578743894,36
2,1204,30263,3578743858,3578743895,37
2,1204,30264,3578743858,3578743895,37
2,1204,30265,3578743858,3578743896,38
2,1204,30266,3578743858,3578743897,39
2,1204,30267,3578743858,3578743898,40
2,1204,30268,3578743858,3578743900,42
2,1204,30269,3578743858,3578743900,42
2,1204,30270,3578743858,3578743900,42
2,1204,30271,3578743858,3578743900,42
2,1204,30272,3578743858,3578743905,47
2,1204,30273,3578743858,3578743907,49
2,1204,30274,3578743858,3578743907,49
2,1204,30275,3578743858,3578743908,50
2,1205,30276,3578743919,3578743919,0
2,1205,30277,3578743919,3578743919,0
2,1205,30278,3578743919,3578743919,0
2,1205,30279,3578743919,3578743919,0
2,1205,30280,3578743919,3578743919,0
2,1205,30281,3578743919,3578743919,0
2,1205,30282,3578743919,3578743919,0
2,1205,30283,3578743919,3578743919,0
2,1205,30284,3578743919,3578743919,0
2,1205,30285,3578743919,3578743919,0
2,1205,30286,3578743919,3578743919,0
2,1205,30287,3578743919,3578743919,0
2,1205,30288,3578743919,3578743919,0
2,1205,30289,3578743919,3578743919,0
2,1205,30290,3578743919,3578743919,0
2,1205,30291,3578743919,3578743919,0
2,1205,30292,3578743919,3578743919,0
2,1205,30293,3578743919,3578743921,2
2,1205,30294,3578743919,3578743921,2
2,1205,30295,3578743919,3578743921,2
2,1205,30296,3578743919,3578743921,2
2,1205,30297,3578743919,3578743922,3
2,1205,30298,3578743919,3578743922,3
2,1205,30299,3578743919,3578743923,4
2,1205,30300,3578743919,3578743923,4
2,1205,30301,3578743919,3578743924,5
2,1205,30302,3578743919,3578743925,6
2,1205,30303,3578743919,3578743926,7
2,1205,30304,3578743919,3578743927,8
2,1205,30305,3578743919,3578743927,8
2,1205,30306,3578743919,3578743927,8
2,1205,30307,3578743919,3578743930,11
2,1205,30308,3578743919,3578743930,11
2,1205,30309,3578743919,3578743930,11
2,1205,30310,3578743919,3578743932,13
2,1205,30311,3578743919,3578743933,14
2,1205,30312,3578743919,3578743933,14
2,1205,30313,3578743919,3578743936,17
2,1205,30314,3578743919,3578743936,17
2,1205,30315,3578743919,3578743936,17
2,1205,30316,3578743919,3578743937,18
2,1205,30317,3578743919,3578743938,19
2,1205,30318,3578743919,3578743938,19
2,1205,30319,3578743919,3578743940,21
2,1205,30320,3578743919,3578743940,21
2,1205,30321,3578743919,3578743941,22
2,1205,30322,3578743919,3578743941,22
2,1205,30323,3578743919,3578743941,22
2,1205,30324,3578743919,3578743942,23
2,1205,30325,3578743919,3578743944,25
2,1205,30326,3578743919,3578743944,25
2,1205,30327,3578743919,3578743945,26
2,1205,30328,3578743919,3578743947,28
2,1205,30329,3578743919,3578743948,29
2,1205,30330,3578743919,3578743948,29
2,1205,30331,3578743919,3578743949,30
2,1205,30332,3578743919,3578743950,31
2,1205,30333,3578743919,3578743950,31
2,1205,30334,3578743919,3578743953,34
2,1205,30335,3578743919,3578743954,35
2,1205,30336,3578743919,3578743955,36
2,1205,30337,3578743919,3578743955,36
2,1205,30338,3578743919,3578743955,36
2,1205,30339,3578743919,3578743956,37
2,1205,30340,3578743919,3578743959,40
2,1205,30341,3578743919,3578743959,40
2,1205,30342,3578743919,3578743961,42
2,1205,30343,3578743919,3578743962,43
2,1205,30344,3578743919,3578743963,44
2,1205,30345,3578743919,3578743963,44
2,1205,30346,3578743919,3578743964,45
2,1205,30347,3578743919,3578743964,45
2,1205,30348,3578743919,3578743965,46
2,1205,30349,3578743919,3578743965,46
2,1205,30350,3578743919,3578743966,47
2,1205,30351,3578743919,3578743966,47
2,1205,30352,3578743919,3578743966,47
2,1205,30353,3578743919,3578743967,48
2,1205,30354,3578743919,3578743967,48
2,1205,30355,3578743919,3578743968,49
2,1206,30356,3578743981,3578743981,0
2,1206,30357,3578743981,3578743981,0
2,1206,30358,3578743981,3578743981,0
2,1206,30359,3578743981,3578743981,0
2,1206,30360,3578743981,3578743981,0
2,1206,30361,3578743981,3578743981,0
2,1206,30362,3578743981,3578743981,0
2,1206,30363,3578743981,3578743981,0
2,1206,30364,3578743981,3578743981,0
2,1206,30365,3578743981,3578743981,0
2,1206,30366,3578743981,3578743981,0
2,1206,30367,3578743981,3578743981,0
2,1206,30368,3578743981,3578743981,0
2,1206,30369,3578743981,3578743981,0
2,1206,30370,3578743981,3578743982,1
2,1206,30371,3578743981,3578743982,1
2,1206,30372,3578743981,3578743982,1
2,1206,30373,3578743981,3578743984,3
2,1206,30374,3578743981,3578743984,3
2,1206,30375,3578743981,3578743984,3
2,1206,30376,3578743981,3578743984,3
2,1206,30377,3578743981,3578743985,4
2,1206,30378,3578743981,3578743987,6
2,1206,30379,3578743981,3578743989,8
2,1206,30380,3578743981,3578743989,8
2,1206,30381,3578743981,3578743990,9
2,1206,30382,3578743981,3578743990,9
2,1206,30383,3578743981,3578743990,9
2,1206,30384,3578743981,3578743992,11
2,1206,30385,3578743981,3578743993,12
2,1206,30386,3578743981,3578743993,12
2,1206,30387,3578743981,3578743994,13
2,1206,30388,3578743981,3578743994,13
2,1206,30389,3578743981,3578743995,14
2,1206,30390,3578743981,3578743995,14
2,1206,30391,3578743981,3578743996,15
2,1206,30392,3578743981,3578743998,17
2,1206,30393,3578743981,3578743999,18
2,1206,30394,3578743981,3578744000,19
2,1206,30395,3578743981,3578744000,19
2,1206,30396,3578743981,3578744002,21
2,1206,30397,3578743981,3578744003,22
2,1206,30398,3578743981,3578744004,23
2,1206,30399,3578743981,3578744004,23
2,1206,30400,3578743981,3578744005,24
2,1206,30401,3578743981,3578744006,25
2,1206,30402,3578743981,3578744013,32
2,1206,30403,3578743981,3578744013,32
2,1206,30404,3578743981,3578744013,32
2,1206,30405,3578743981,3578744014,33
2,1206,30406,3578743981,3578744014,33
2,1206,30407,3578743981,3578744014,33
2,1206,30408,3578743981,3578744014,33
2,1206,30409,3578743981,3578744018,37
2,1206,30410,3578743981,3578744018,37
2,1206,30411,3578743981,3578744018,37
2,1206,30412,3578743981,3578744020,39
2,1206,30413,3578743981,3578744020,39
2,1206,30414,3578743981,3578744021,40
2,1206,30415,3578743981,3578744021,40
2,1206,30416,3578743981,3578744021,40
2,1206,30417,3578743981,3578744022,41
2,1206,30418,3578743981,3578744024,43
2,1206,30419,3578743981,3578744024,43
2,1206,30420,3578743981,3578744024,43
2,1206,30421,3578743981,3578744025,44
2,1206,30422,3578743981,3578744026,45
2,1206,30423,3578743981,3578744026,45
2,1206,30424,3578743981,3578744028,47
2,1206,30425,3578743981,3578744028,47
2,1206,30426,3578743981,3578744029,48
2,1206,30427,3578743981,3578744029,48
2,1206,30428,3578743981,3578744030,49
2,1206,30429,3578743981,3578744030,49
2,1207,30430,3578744043,3578744043,0
2,1207,30431,3578744043,3578744043,0
2,1207,30432,3578744043,3578744043,0
2,1207,30433,3578744043,3578744043,0
2,1207,30434,3578744043,3578744043,0
2,1207,30435,3578744043,3578744043,0
2,1207,30436,3578744043,3578744043,0
2,1207,30437,3578744043,3578744043,0
2,1207,30438,3578744043,3578744043,0
2,1207,30439,3578744043,3578744043,0
2,1207,30440,3578744043,3578744043,0
2,1207,30441,3578744043,3578744043,0
2,1207,30442,3578744043,3578744043,0
2,1207,30443,3578744043,3578744043,0
2,1207,30444,3578744043,3578744043,0
2,1207,30445,3578744043,3578744043,0
2,1207,30446,3578744043,3578744043,0
2,1207,30447,3578744043,3578744043,0
2,1207,30448,3578744043,3578744043,0
2,1207,30449,3578744043,3578744044,1
2,1207,30450,3578744043,3578744045,2
2,1207,30451,3578744043,3578744046,3
2,1207,30452,3578744043,3578744046,3
2,1207,30453,3578744043,3578744046,3
2,1207,30454,3578744043,3578744049,6
2,1207,30455,3578744043,3578744049,6
2,1207,30456,3578744043,3578744050,7
2,1207,30457,3578744043,3578744051,8
2,1207,30458,3578744043,3578744051,8
2,1207,30459,3578744043,3578744051,8
2,1207,30460,3578744043,3578744053,10
2,1207,30461,3578744043,3578744054,11
2,1207,30462,3578744043,3578744054,11
2,1207,30463,3578744043,3578744054,11
2,1207,30464,3578744043,3578744054,11
2,1207,30465,3578744043,3578744055,12
2,1207,30466,3578744043,3578744057,14
2,1207,30467,3578744043,3578744057,14
2,1207,30468,3578744043,3578744059,16
2,1207,30469,3578744043,3578744060,17
2,1207,30470,3578744043,3578744060,17
2,1207,30471,3578744043,3578744060,17
2,1207,30472,3578744043,3578744061,18
2,1207,30473,3578744043,3578744063,20
2,1207,30474,3578744043,3578744065,22
2,1207,30475,3578744043,3578744066,23
2,1207,30476,3578744043,3578744067,24
2,1207,30477,3578744043,3578744068,25
2,1207,30478,3578744043,3578744068,25
2,1207,30479,3578744043,3578744070,27
2,1207,30480,3578744043,3578744071,28
2,1207,30481,3578744043,3578744075,32
2,1207,30482,3578744043,3578744076,33
2,1207,30483,3578744043,3578744078,35
2,1207,30484,3578744043,3578744080,37
2,1207,30485,3578744043,3578744080,37
2,1207,30486,3578744043,3578744080,37
2,1207,30487,3578744043,3578744081,38
2,1207,30488,3578744043,3578744081,38
2,1207,30489,3578744043,3578744081,38
2,1207,30490,3578744043,3578744082,39
2,1207,30491,3578744043,3578744082,39
2,1207,30492,3578744043,3578744083,40
2,1207,30493,3578744043,3578744083,40
2,1207,30494,3578744043,3578744084,41
2,1207,30495,3578744043,3578744084,41
2,1207,30496,3578744043,3578744086,43
2,1207,30497,3578744043,3578744087,44
2,1207,30498,3578744043,3578744087,44
2,1207,30499,3578744043,3578744088,45
2,1207,30500,3578744043,3578744089,46
2,1207,30501,3578744043,3578744090,47
2,1207,30502,3578744043,3578744090,47
2,1207,30503,3578744043,3578744090,47
2,1207,30504,3578744043,3578744090,47
2,1207,30505,3578744043,3578744092,49
2,1207,30506,3578744043,3578744093,50
2,1208,30507,3578744106,3578744106,0
2,1208,30508,3578744106,3578744106,0
2,1208,30509,3578744106,3578744106,0
2,1208,30510,3578744106,3578744106,0
2,1208,30511,3578744106,3578744106,0
2,1208,30512,3578744106,3578744106,0
2,1208,30513,3578744106,3578744106,0
2,1208,30514,3578744106,3578744106,0
2,1208,30515,3578744106,3578744106,0
2,1208,30516,3578744106,3578744106,0
2,1208,30517,3578744106,3578744106,0
2,1208,30518,3578744106,3578744106,0
2,1208,30519,3578744106,3578744106,0
2,1208,30520,3578744106,3578744106,0
2,1208,30521,3578744106,3578744106,0
2,1208,30522,3578744106,3578744106,0
2,1208,30523,3578744106,3578744106,0
2,1208,30524,3578744106,3578744107,1
2,1208,30525,3578744106,3578744107,1
2,1208,30526,3578744106,3578744108,2
2,1208,30527,3578744106,3578744108,2
2,1208,30528,3578744106,3578744109,3
2,1208,30529,3578744106,3578744111,5
2,1208,30530,3578744106,3578744111,5
2,1208,30531,3578744106,3578744112,6
2,1208,30532,3578744106,3578744112,6
2,1208,30533,3578744106,3578744114,8
2,1208,30534,3578744106,3578744115,9
2,1208,30535,3578744106,3578744115,9
2,1208,30536,3578744106,3578744116,10
2,1208,30537,3578744106,3578744116,10
2,1208,30538,3578744106,3578744117,11
2,1208,30539,3578744106,3578744117,11
2,1208,30540,3578744106,3578744117,11
2,1208,30541,3578744106,3578744119,13
2,1208,30542,3578744106,3578744119,13
2,1208,30543,3578744106,3578744119,13
2,1208,30544,3578744106,3578744120,14
2,1208,30545,3578744106,3578744121,15
2,1208,30546,3578744106,3578744121,15
2,1208,30547,3578744106,3578744122,16
2,1208,30548,3578744106,3578744122,16
2,1208,30549,3578744106,3578744123,17
2,1208,30550,3578744106,3578744123,17
2,1208,30551,3578744106,3578744124,18
2,1208,30552,3578744106,3578744124,18
2,1208,30553,3578744106,3578744125,19
2,1208,30554,3578744106,3578744126,20
2,1208,30555,3578744106,3578744127,21
2,1208,30556,3578744106,3578744127,21
2,1208,30557,3578744106,3578744128,22
2,1208,30558,3578744106,3578744130,24
2,1208,30559,3578744106,3578744130,24
2,1208,30560,3578744106,3578744131,25
2,1208,30561,3578744106,3578744132,26
2,1208,30562,3578744106,3578744133,27
2,1208,30563,3578744106,3578744133,27
2,1208,30564,3578744106,3578744136,30
2,1208,30565,3578744106,3578744136,30
2,1208,30566,3578744106,3578744137,31
2,1208,30567,3578744106,3578744138,32
2,1208,30568,3578744106,3578744138,32
2,1208,30569,3578744106,3578744138,32
2,1208,30570,3578744106,3578744140,34
2,1208,30571,3578744106,3578744141,35
2,1208,30572,3578744106,3578744141,35
2,1208,30573,3578744106,3578744141,35
2,1208,30574,3578744106,3578744142,36
2,1208,30575,3578744106,3578744143,37
2,1208,30576,3578744106,3578744145,39
2,1208,30577,3578744106,3578744145,39
2,1208,30578,3578744106,3578744147,41
2,1208,30579,3578744106,3578744148,42
2,1208,30580,3578744106,3578744149,43
2,1208,30581,3578744106,3578744150,44
2,1208,30582,3578744106,3578744151,45
2,1208,30583,3578744106,3578744153,47
2,1208,30584,3578744106,3578744154,48
2,1208,30585,3578744106,3578744155,49
2,1208,30586,3578744106,3578744155,49
2,1208,30587,3578744106,3578744155,49
2,1208,30588,3578744106,3578744156,50
2,1209,30589,3578744169,3578744169,0
2,1209,30590,3578744169,3578744169,0
2,1209,30591,3578744169,3578744169,0
2,1209,30592,3578744169,3578744169,0
2,1209,30593,3578744169,3578744169,0
2,1209,30594,3578744169,3578744169,0
2,1209,30595,3578744169,3578744169,0
2,1209,30596,3578744169,3578744169,0
2,1209,30597,3578744169,3578744169,0
2,1209,30598,3578744169,3578744169,0
2,1209,30599,3578744169,3578744169,0
2,1209,30600,3578744169,3578744169,0
2,1209,30601,3578744169,3578744169,0
2,1209,30602,3578744169,3578744170,1
2,1209,30603,3578744169,3578744172,3
2,1209,30604,3578744169,3578744173,4
2,1209,30605,3578744169,3578744174,5
2,1209,30606,3578744169,3578744176,7
2,1209,30607,3578744169,3578744177,8
2,1209,30608,3578744169,3578744178,9
2,1209,30609,3578744169,3578744178,9
2,1209,30610,3578744169,3578744178,9
2,1209,30611,3578744169,3578744178,9
2,1209,30612,3578744169,3578744179,10
2,1209,30613,3578744169,3578744179,10
2,1209,30614,3578744169,3578744180,11
2,1209,30615,3578744169,3578744180,11
2,1209,30616,3578744169,3578744181,12
2,1209,30617,3578744169,3578744182,13
2,1209,30618,3578744169,3578744183,14
2,1209,30619,3578744169,3578744184,15
2,1209,30620,3578744169,3578744184,15
2,1209,30621,3578744169,3578744184,15
2,1209,30622,3578744169,3578744184,15
2,1209,30623,3578744169,3578744186,17
2,1209,30624,3578744169,3578744188,19
2,1209,30625,3578744169,3578744189,20
2,1209,30626,3578744169,3578744190,21
2,1209,30627,3578744169,3578744190,21
2,1209,30628,3578744169,3578744192,23
2,1209,30629,3578744169,3578744193,24
2,1209,30630,3578744169,3578744193,24
2,1209,30631,3578744169,3578744193,24
2,1209,30632,3578744169,3578744194,25
2,1209,30633,3578744169,3578744194,25
2,1209,30634,3578744169,3578744195,26
2,1209,30635,3578744169,3578744196,27
2,1209,30636,3578744169,3578744198,29
2,1209,30637,3578744169,3578744199,30
2,1209,30638,3578744169,3578744200,31
2,1209,30639,3578744169,3578744201,32
2,1209,30640,3578744169,3578744204,35
2,1209,30641,3578744169,3578744204,35
2,1209,30642,3578744169,3578744205,36
2,1209,30643,3578744169,3578744205,36
2,1209,30644,3578744169,3578744206,37
2,1209,30645,3578744169,3578744212,43
2,1209,30646,3578744169,3578744213,44
2,1209,30647,3578744169,3578744213,44
2,1209,30648,3578744169,3578744213,44
2,1209,30649,3578744169,3578744214,45
2,1209,30650,3578744169,3578744214,45
2,1209,30651,3578744169,3578744214,45
2,1209,30652,3578744169,3578744217,48
2,1209,30653,3578744169,3578744219,50
2,1210,30654,3578744231,3578744231,0
2,1210,30655,3578744231,3578744231,0
2,1210,30656,3578744231,3578744231,0
2,1210,30657,3578744231,3578744231,0
2,1210,30658,3578744231,3578744231,0
2,1210,30659,3578744231,3578744231,0
2,1210,30660,3578744231,3578744231,0
2,1210,30661,3578744231,3578744231,0
2,1210,30662,3578744231,3578744231,0
2,1210,30663,3578744231,3578744231,0
2,1210,30664,3578744231,3578744231,0
2,1210,30665,3578744231,3578744231,0
2,1210,30666,3578744231,3578744231,0
2,1210,30667,3578744231,3578744231,0
2,1210,30668,3578744231,3578744231,0
2,1210,30669,3578744231,3578744231,0
2,1210,30670,3578744231,3578744231,0
2,1210,30671,3578744231,3578744231,0
2,1210,30672,3578744231,3578744232,1
2,1210,30673,3578744231,3578744232,1
2,1210,30674,3578744231,3578744233,2
2,1210,30675,3578744231,3578744233,2
2,1210,30676,3578744231,3578744234,3
2,1210,30677,3578744231,3578744235,4
2,1210,30678,3578744231,3578744237,6
2,1210,30679,3578744231,3578744237,6
2,1210,30680,3578744231,3578744237,6
2,1210,30681,3578744231,3578744237,6
2,1210,30682,3578744231,3578744238,7
2,1210,30683,3578744231,3578744239,8
2,1210,30684,3578744231,3578744240,9
2,1210,30685,3578744231,3578744240,9
2,1210,30686,3578744231,3578744241,10
2,1210,30687,3578744231,3578744242,11
2,1210,30688,3578744231,3578744242,11
2,1210,30689,3578744231,3578744242,11
2,1210,30690,3578744231,3578744244,13
2,1210,30691,3578744231,3578744244,13
2,1210,30692,3578744231,3578744246,15
2,1210,30693,3578744231,3578744246,15
2,1210,30694,3578744231,3578744246,15
2,1210,30695,3578744231,3578744250,19
2,1210,30696,3578744231,3578744250,19
2,1210,30697,3578744231,3578744250,19
2,1210,30698,3578744231,3578744251,20
2,1210,30699,3578744231,3578744252,21
2,1210,30700,3578744231,3578744252,21
2,1210,30701,3578744231,3578744254,23
2,1210,30702,3578744231,3578744254,23
2,1210,30703,3578744231,3578744254,23
2,1210,30704,3578744231,3578744254,23
2,1210,30705,3578744231,3578744254,23
2,1210,30706,3578744231,3578744254,23
2,1210,30707,3578744231,3578744257,26
2,1210,30708,3578744231,3578744257,26
2,1210,30709,3578744231,3578744259,28
2,1210,30710,3578744231,3578744260,29
2,1210,30711,3578744231,3578744260,29
2,1210,30712,3578744231,3578744260,29
2,1210,30713,3578744231,3578744263,32
2,1210,30714,3578744231,3578744265,34
2,1210,30715,3578744231,3578744266,35
2,1210,30716,3578744231,3578744266,35
2,1210,30717,3578744231,3578744268,37
2,1210,30718,3578744231,3578744268,37
2,1210,30719,3578744231,3578744269,38
2,1210,30720,3578744231,3578744270,39
2,1210,30721,3578744231,3578744272,41
2,1210,30722,3578744231,3578744274,43
2,1210,30723,3578744231,3578744276,45
2,1210,30724,3578744231,3578744278,47
2,1210,30725,3578744231,3578744280,49
2,1210,30726,3578744231,3578744281,50
2,1210,30727,3578744231,3578744281,50
2,1211,30728,3578744292,3578744292,0
2,1211,30729,3578744292,3578744292,0
2,1211,30730,3578744292,3578744292,0
2,1211,30731,3578744292,3578744292,0
2,1211,30732,3578744292,3578744292,0
2,1211,30733,3578744292,3578744292,0
2,1211,30734,3578744292,3578744292,0
2,1211,30735,3578744292,3578744292,0
2,1211,30736,3578744292,3578744292,0
2,1211,30737,3578744292,3578744292,0
2,1211,30738,3578744292,3578744292,0
2,1211,30739,3578744292,3578744292,0
2,1211,30740,3578744292,3578744292,0
2,1211,30741,3578744292,3578744292,0
2,1211,30742,3578744292,3578744292,0
2,1211,30743,3578744292,3578744292,0
2,1211,30744,3578744292,3578744292,0
2,1211,30745,3578744292,3578744292,0
2,1211,30746,3578744292,3578744292,0
2,1211,30747,3578744292,3578744292,0
2,1211,30748,3578744292,3578744293,1
2,1211,30749,3578744292,3578744293,1
2,1211,30750,3578744292,3578744294,2
2,1211,30751,3578744292,3578744294,2
2,1211,30752,3578744292,3578744294,2
2,1211,30753,3578744292,3578744294,2
2,1211,30754,3578744292,3578744294,2
2,1211,30755,3578744292,3578744294,2
2,1211,30756,3578744292,3578744295,3
2,1211,30757,3578744292,3578744295,3
2,1211,30758,3578744292,3578744296,4
2,1211,30759,3578744292,3578744297,5
2,1211,30760,3578744292,3578744299,7
2,1211,30761,3578744292,3578744299,7
2,1211,30762,3578744292,3578744300,8
2,1211,30763,3578744292,3578744300,8
2,1211,30764,3578744292,3578744301,9
2,1211,30765,3578744292,3578744305,13
2,1211,30766,3578744292,3578744307,15
2,1211,30767,3578744292,3578744307,15
2,1211,30768,3578744292,3578744308,16
2,1211,30769,3578744292,3578744309,17
2,1211,30770,3578744292,3578744309,17
2,1211,30771,3578744292,3578744311,19
2,1211,30772,3578744292,3578744311,19
2,1211,30773,3578744292,3578744312,20
2,1211,30774,3578744292,3578744313,21
2,1211,30775,3578744292,3578744314,22
2,1211,30776,3578744292,3578744314,22
2,1211,30777,3578744292,3578744315,23
2,1211,30778,3578744292,3578744315,23
2,1211,30779,3578744292,3578744316,24
2,1211,30780,3578744292,3578744317,25
2,1211,30781,3578744292,3578744317,25
2,1211,30782,3578744292,3578744318,26
2,1211,30783,3578744292,3578744318,26
2,1211,30784,3578744292,3578744319,27
2,1211,30785,3578744292,3578744321,29
2,1211,30786,3578744292,3578744321,29
2,1211,30787,3578744292,3578744321,29
2,1211,30788,3578744292,3578744322,30
2,1211,30789,3578744292,3578744322,30
2,1211,30790,3578744292,3578744323,31
2,1211,30791,3578744292,3578744323,31
2,1211,30792,3578744292,3578744324,32
2,1211,30793,3578744292,3578744324,32
2,1211,30794,3578744292,3578744325,33
2,1211,30795,3578744292,3578744326,34
2,1211,30796,3578744292,3578744326,34
2,1211,30797,3578744292,3578744327,35
2,1211,30798,3578744292,3578744327,35
2,1211,30799,3578744292,3578744331,39
2,1211,30800,3578744292,3578744331,39
2,1211,30801,3578744292,3578744331,39
2,1211,30802,3578744292,3578744332,40
2,1211,30803,3578744292,3578744333,41
2,1211,30804,3578744292,3578744336,44
2,1211,30805,3578744292,3578744336,44
2,1211,30806,3578744292,3578744337,45
2,1211,30807,3578744292,3578744338,46
2,1211,30808,3578744292,3578744339,47
2,1211,30809,3578744292,3578744339,47
2,1211,30810,3578744292,3578744341,49
2,1211,30811,3578744292,3578744341,49
2,1211,30812,3578744292,3578744341,49
2,1211,30813,3578744292,3578744341,49
2,1211,30814,3578744292,3578744342,50
2,1212,30815,3578744354,3578744354,0
2,1212,30816,3578744354,3578744354,0
2,1212,30817,3578744354,3578744354,0
2,1212,30818,3578744354,3578744354,0
2,1212,30819,3578744354,3578744354,0
2,1212,30820,3578744354,3578744354,0
2,1212,30821,3578744354,3578744354,0
2,1212,30822,3578744354,3578744354,0
2,1212,30823,3578744354,3578744354,0
2,1212,30824,3578744354,3578744354,0
2,1212,30825,3578744354,3578744355,1
2,1212,30826,3578744354,3578744356,2
2,1212,30827,3578744354,3578744357,3
2,1212,30828,3578744354,3578744357,3
2,1212,30829,3578744354,3578744358,4
2,1212,30830,3578744354,3578744359,5
2,1212,30831,3578744354,3578744361,7
2,1212,30832,3578744354,3578744362,8
2,1212,30833,3578744354,3578744363,9
2,1212,30834,3578744354,3578744363,9
2,1212,30835,3578744354,3578744364,10
2,1212,30836,3578744354,3578744365,11
2,1212,30837,3578744354,3578744366,12
2,1212,30838,3578744354,3578744366,12
2,1212,30839,3578744354,3578744367,13
2,1212,30840,3578744354,3578744367,13
2,1212,30841,3578744354,3578744367,13
2,1212,30842,3578744354,3578744368,14
2,1212,30843,3578744354,3578744370,16
2,1212,30844,3578744354,3578744370,16
2,1212,30845,3578744354,3578744372,18
2,1212,30846,3578744354,3578744374,20
2,1212,30847,3578744354,3578744375,21
2,1212,30848,3578744354,3578744376,22
2,1212,30849,3578744354,3578744377,23
2,1212,30850,3578744354,3578744378,24
2,1212,30851,3578744354,3578744378,24
2,1212,30852,3578744354,3578744378,24
2,1212,30853,3578744354,3578744378,24
2,1212,30854,3578744354,3578744378,24
2,1212,30855,3578744354,3578744380,26
2,1212,30856,3578744354,3578744380,26
2,1212,30857,3578744354,3578744380,26
2,1212,30858,3578744354,3578744382,28
2,1212,30859,3578744354,3578744382,28
2,1212,30860,3578744354,3578744382,28
2,1212,30861,3578744354,3578744384,30
2,1212,30862,3578744354,3578744384,30
2,1212,30863,3578744354,3578744385,31
2,1212,30864,3578744354,3578744385,31
2,1212,30865,3578744354,3578744386,32
2,1212,30866,3578744354,3578744389,35
2,1212,30867,3578744354,3578744390,36
2,1212,30868,3578744354,3578744390,36
2,1212,30869,3578744354,3578744390,36
2,1212,30870,3578744354,3578744391,37
2,1212,30871,3578744354,3578744391,37
2,1212,30872,3578744354,3578744392,38
2,1212,30873,3578744354,3578744393,39
2,1212,30874,3578744354,3578744394,40
2,1212,30875,3578744354,3578744394,40
2,1212,30876,3578744354,3578744394,40
2,1212,30877,3578744354,3578744395,41
2,1212,30878,3578744354,3578744395,41
2,1212,30879,3578744354,3578744396,42
2,1212,30880,3578744354,3578744399,45
2,1212,30881,3578744354,3578744399,45
2,1212,30882,3578744354,3578744400,46
2,1212,30883,3578744354,3578744402,48
2,1212,30884,3578744354,3578744403,49
2,1213,30885,3578744415,3578744415,0
2,1213,30886,3578744415,3578744415,0
2,1213,30887,3578744415,3578744415,0
2,1213,30888,3578744415,3578744415,0
2,1213,30889,3578744415,3578744415,0
2,1213,30890,3578744415,3578744415,0
2,1213,30891,3578744415,3578744415,0
2,1213,30892,3578744415,3578744415,0
2,1213,30893,3578744415,3578744415,0
2,1213,30894,3578744415,3578744415,0
2,1213,30895,3578744415,3578744417,2
2,1213,30896,3578744415,3578744419,4
2,1213,30897,3578744415,3578744419,4
2,1213,30898,3578744415,3578744420,5
2,1213,30899,3578744415,3578744421,6
2,1213,30900,3578744415,3578744421,6
2,1213,30901,3578744415,3578744421,6
2,1213,30902,3578744415,3578744422,7
2,1213,30903,3578744415,3578744424,9
2,1213,30904,3578744415,3578744424,9
2,1213,30905,3578744415,3578744424,9
2,1213,30906,3578744415,3578744425,10
2,1213,30907,3578744415,3578744425,10
2,1213,30908,3578744415,3578744427,12
2,1213,30909,3578744415,3578744427,12
2,1213,30910,3578744415,3578744428,13
2,1213,30911,3578744415,3578744429,14
2,1213,30912,3578744415,3578744430,15
2,1213,30913,3578744415,3578744430,15
2,1213,30914,3578744415,3578744431,16
2,1213,30915,3578744415,3578744431,16
2,1213,30916,3578744415,3578744432,17
2,1213,30917,3578744415,3578744433,18
2,1213,30918,3578744415,3578744433,18
2,1213,30919,3578744415,3578744434,19
2,1213,30920,3578744415,3578744436,21
2,1213,30921,3578744415,3578744436,21
2,1213,30922,3578744415,3578744437,22
2,1213,30923,3578744415,3578744438,23
2,1213,30924,3578744415,3578744438,23
2,1213,30925,3578744415,3578744438,23
2,1213,30926,3578744415,3578744439,24
2,1213,30927,3578744415,3578744440,25
2,1213,30928,3578744415,3578744440,25
2,1213,30929,3578744415,3578744441,26
2,1213,30930,3578744415,3578744441,26
2,1213,30931,3578744415,3578744441,26
2,1213,30932,3578744415,3578744442,27
2,1213,30933,3578744415,3578744444,29
2,1213,30934,3578744415,3578744445,30
2,1213,30935,3578744415,3578744445,30
2,1213,30936,3578744415,3578744446,31
2,1213,30937,3578744415,3578744447,32
2,1213,30938,3578744415,3578744447,32
2,1213,30939,3578744415,3578744449,34
2,1213,30940,3578744415,3578744449,34
2,1213,30941,3578744415,3578744449,34
2,1213,30942,3578744415,3578744451,36
2,1213,30943,3578744415,3578744452,37
2,1213,30944,3578744415,3578744452,37
2,1213,30945,3578744415,3578744454,39
2,1213,30946,3578744415,3578744454,39
2,1213,30947,3578744415,3578744454,39
2,1213,30948,3578744415,3578744454,39
2,1213,30949,3578744415,3578744454,39
2,1213,30950,3578744415,3578744455,40
2,1213,30951,3578744415,3578744455,40
2,1213,30952,3578744415,3578744456,41
2,1213,30953,3578744415,3578744458,43
2,1213,30954,3578744415,3578744459,44
2,1213,30955,3578744415,3578744460,45
2,1213,30956,3578744415,3578744460,45
2,1213,30957,3578744415,3578744461,46
2,1213,30958,3578744415,3578744462,47
2,1213,30959,3578744415,3578744463,48
2,1214,30960,3578744476,3578744476,0
2,1214,30961,3578744476,3578744476,0
2,1214,30962,3578744476,3578744476,0
2,1214,30963,3578744476,3578744476,0
2,1214,30964,3578744476,3578744476,0
2,1214,30965,3578744476,3578744476,0
2,1214,30966,3578744476,3578744476,0
2,1214,30967,3578744476,3578744476,0
2,1214,30968,3578744476,3578744476,0
2,1214,30969,3578744476,3578744476,0
2,1214,30970,3578744476,3578744478,2
2,1214,30971,3578744476,3578744479,3
2,1214,30972,3578744476,3578744479,3
2,1214,30973,3578744476,3578744479,3
2,1214,30974,3578744476,3578744480,4
2,1214,30975,3578744476,3578744481,5
2,1214,30976,3578744476,3578744481,5
2,1214,30977,3578744476,3578744481,5
2,1214,30978,3578744476,3578744482,6
2,1214,30979,3578744476,3578744482,6
2,1214,30980,3578744476,3578744482,6
2,1214,30981,3578744476,3578744482,6
2,1214,30982,3578744476,3578744484,8
2,1214,30983,3578744476,3578744484,8
2,1214,30984,3578744476,3578744485,9
2,1214,30985,3578744476,3578744486,10
2,1214,30986,3578744476,3578744487,11
2,1214,30987,3578744476,3578744488,12
2,1214,30988,3578744476,3578744488,12
2,1214,30989,3578744476,3578744489,13
2,1214,30990,3578744476,3578744489,13
2,1214,30991,3578744476,3578744489,13
2,1214,30992,3578744476,3578744490,14
2,1214,30993,3578744476,3578744491,15
2,1214,30994,3578744476,3578744492,16
2,1214,30995,3578744476,3578744493,17
2,1214,30996,3578744476,3578744494,18
2,1214,30997,3578744476,3578744494,18
2,1214,30998,3578744476,3578744494,18
2,1214,30999,3578744476,3578744494,18
2,1214,31000,3578744476,3578744494,18
2,1214,31001,3578744476,3578744494,18
2,1214,31002,3578744476,3578744495,19
2,1214,31003,3578744476,3578744496,20
2,1214,31004,3578744476,3578744497,21
2,1214,31005,3578744476,3578744497,21
2,1214,31006,3578744476,3578744498,22
2,1214,31007,3578744476,3578744498,22
2,1214,31008,3578744476,3578744500,24
2,1214,31009,3578744476,3578744501,25
2,1214,31010,3578744476,3578744501,25
2,1214,31011,3578744476,3578744504,28
2,1214,31012,3578744476,3578744506,30
2,1214,31013,3578744476,3578744507,31
2,1214,31014,3578744476,3578744508,32
2,1214,31015,3578744476,3578744509,33
2,1214,31016,3578744476,3578744509,33
2,1214,31017,3578744476,3578744510,34
2,1214,31018,3578744476,3578744511,35
2,1214,31019,3578744476,3578744511,35
2,1214,31020,3578744476,3578744511,35
2,1214,31021,3578744476,3578744513,37
2,1214,31022,3578744476,3578744514,38
2,1214,31023,3578744476,3578744515,39
2,1214,31024,3578744476,3578744515,39
2,1214,31025,3578744476,3578744516,40
2,1214,31026,3578744476,3578744517,41
2,1214,31027,3578744476,3578744517,41
2,1214,31028,3578744476,3578744517,41
2,1214,31029,3578744476,3578744518,42
2,1214,31030,3578744476,3578744520,44
2,1214,31031,3578744476,3578744521,45
2,1214,31032,3578744476,3578744521,45
2,1214,31033,3578744476,3578744522,46
2,1214,31034,3578744476,3578744522,46
2,1214,31035,3578744476,3578744522,46
2,1214,31036,3578744476,3578744522,46
2,1214,31037,3578744476,3578744524,48
2,1214,31038,3578744476,3578744524,48
2,1214,31039,3578744476,3578744524,48
2,1214,31040,3578744476,3578744525,49
2,1214,31041,3578744476,3578744525,49
2,1214,31042,3578744476,3578744526,50
2,1215,31043,3578744539,3578744539,0
2,1215,31044,3578744539,3578744539,0
2,1215,31045,3578744539,3578744539,0
2,1215,31046,3578744539,3578744539,0
2,1215,31047,3578744539,3578744539,0
2,1215,31048,3578744539,3578744539,0
2,1215,31049,3578744539,3578744539,0
2,1215,31050,3578744539,3578744539,0
2,1215,31051,3578744539,3578744539,0
2,1215,31052,3578744539,3578744539,0
2,1215,31053,3578744539,3578744539,0
2,1215,31054,3578744539,3578744539,0
2,1215,31055,3578744539,3578744540,1
2,1215,31056,3578744539,3578744540,1
2,1215,31057,3578744539,3578744540,1
2,1215,31058,3578744539,3578744541,2
2,1215,31059,3578744539,3578744541,2
2,1215,31060,3578744539,3578744543,4
2,1215,31061,3578744539,3578744543,4
2,1215,31062,3578744539,3578744545,6
2,1215,31063,3578744539,3578744545,6
2,1215,31064,3578744539,3578744548,9
2,1215,31065,3578744539,3578744548,9
2,1215,31066,3578744539,3578744549,10
2,1215,31067,3578744539,3578744550,11
2,1215,31068,3578744539,3578744553,14
2,1215,31069,3578744539,3578744553,14
2,1215,31070,3578744539,3578744554,15
2,1215,31071,3578744539,3578744555,16
2,1215,31072,3578744539,3578744555,16
2,1215,31073,3578744539,3578744555,16
2,1215,31074,3578744539,3578744557,18
2,1215,31075,3578744539,3578744561,22
2,1215,31076,3578744539,3578744562,23
2,1215,31077,3578744539,3578744562,23
2,1215,31078,3578744539,3578744563,24
2,1215,31079,3578744539,3578744564,25
2,1215,31080,3578744539,3578744565,26
2,1215,31081,3578744539,3578744565,26
2,1215,31082,3578744539,3578744565,26
2,1215,31083,3578744539,3578744566,27
2,1215,31084,3578744539,3578744566,27
2,1215,31085,3578744539,3578744566,27
2,1215,31086,3578744539,3578744568,29
2,1215,31087,3578744539,3578744568,29
2,1215,31088,3578744539,3578744569,30
2,1215,31089,3578744539,3578744571,32
2,1215,31090,3578744539,3578744573,34
2,1215,31091,3578744539,3578744575,36
2,1215,31092,3578744539,3578744576,37
2,1215,31093,3578744539,3578744577,38
2,1215,31094,3578744539,3578744577,38
2,1215,31095,3578744539,3578744577,38
2,1215,31096,3578744539,3578744577,38
2,1215,31097,3578744539,3578744577,38
2,1215,31098,3578744539,3578744579,40
2,1215,31099,3578744539,3578744579,40
2,1215,31100,3578744539,3578744579,40
2,1215,31101,3578744539,3578744580,41
2,1215,31102,3578744539,3578744580,41
2,1215,31103,3578744539,3578744581,42
2,1215,31104,3578744539,3578744582,43
2,1215,31105,3578744539,3578744583,44
2,1215,31106,3578744539,3578744583,44
2,1215,31107,3578744539,3578744584,45
2,1215,31108,3578744539,3578744585,46
2,1215,31109,3578744539,3578744588,49
2,1215,31110,3578744539,3578744588,49
2,1215,31111,3578744539,3578744589,50
2,1216,31112,3578744600,3578744600,0
2,1216,31113,3578744600,3578744600,0
2,1216,31114,3578744600,3578744600,0
2,1216,31115,3578744600,3578744600,0
2,1216,31116,3578744600,3578744600,0
2,1216,31117,3578744600,3578744600,0
2,1216,31118,3578744600,3578744600,0
2,1216,31119,3578744600,3578744600,0
2,1216,31120,3578744600,3578744600,0
2,1216,31121,3578744600,3578744600,0
2,1216,31122,3578744600,3578744600,0
2,1216,31123,3578744600,3578744600,0
2,1216,31124,3578744600,3578744600,0
2,1216,31125,3578744600,3578744601,1
2,1216,31126,3578744600,3578744603,3
2,1216,31127,3578744600,3578744603,3
2,1216,31128,3578744600,3578744604,4
2,1216,31129,3578744600,3578744604,4
2,1216,31130,3578744600,3578744611,11
2,1216,31131,3578744600,3578744612,12
2,1216,31132,3578744600,3578744612,12
2,1216,31133,3578744600,3578744613,13
2,1216,31134,3578744600,3578744613,13
2,1216,31135,3578744600,3578744614,14
2,1216,31136,3578744600,3578744615,15
2,1216,31137,3578744600,3578744616,16
2,1216,31138,3578744600,3578744619,19
2,1216,31139,3578744600,3578744619,19
2,1216,31140,3578744600,3578744619,19
2,1216,31141,3578744600,3578744619,19
2,1216,31142,3578744600,3578744620,20
2,1216,31143,3578744600,3578744620,20
2,1216,31144,3578744600,3578744621,21
2,1216,31145,3578744600,3578744622,22
2,1216,31146,3578744600,3578744623,23
2,1216,31147,3578744600,3578744624,24
2,1216,31148,3578744600,3578744625,25
2,1216,31149,3578744600,3578744625,25
2,1216,31150,3578744600,3578744626,26
2,1216,31151,3578744600,3578744626,26
2,1216,31152,3578744600,3578744627,27
2,1216,31153,3578744600,3578744628,28
2,1216,31154,3578744600,3578744629,29
2,1216,31155,3578744600,3578744629,29
2,1216,31156,3578744600,3578744630,30
2,1216,31157,3578744600,3578744631,31
2,1216,31158,3578744600,3578744632,32
2,1216,31159,3578744600,3578744632,32
2,1216,31160,3578744600,3578744633,33
2,1216,31161,3578744600,3578744634,34
2,1216,31162,3578744600,3578744635,35
2,1216,31163,3578744600,3578744635,35
2,1216,31164,3578744600,3578744636,36
2,1216,31165,3578744600,3578744637,37
2,1216,31166,3578744600,3578744637,37
2,1216,31167,3578744600,3578744637,37
2,1216,31168,3578744600,3578744638,38
2,1216,31169,3578744600,3578744639,39
2,1216,31170,3578744600,3578744640,40
2,1216,31171,3578744600,3578744641,41
2,1216,31172,3578744600,3578744641,41
2,1216,31173,3578744600,3578744641,41
2,1216,31174,3578744600,3578744642,42
2,1216,31175,3578744600,3578744644,44
2,1216,31176,3578744600,3578744644,44
2,1216,31177,3578744600,3578744645,45
2,1216,31178,3578744600,3578744646,46
2,1216,31179,3578744600,3578744646,46
2,1216,31180,3578744600,3578744648,48
2,1216,31181,3578744600,3578744649,49
2,1216,31182,3578744600,3578744649,49
2,1217,31183,3578744663,3578744663,0
2,1217,31184,3578744663,3578744663,0
2,1217,31185,3578744663,3578744663,0
2,1217,31186,3578744663,3578744663,0
2,1217,31187,3578744663,3578744663,0
2,1217,31188,3578744663,3578744663,0
2,1217,31189,3578744663,3578744663,0
2,1217,31190,3578744663,3578744663,0
2,1217,31191,3578744663,3578744663,0
2,1217,31192,3578744663,3578744663,0
2,1217,31193,3578744663,3578744663,0
2,1217,31194,3578744663,3578744663,0
2,1217,31195,3578744663,3578744663,0
2,1217,31196,3578744663,3578744663,0
2,1217,31197,3578744663,3578744663,0
2,1217,31198,3578744663,3578744663,0
2,1217,31199,3578744663,3578744663,0
2,1217,31200,3578744663,3578744663,0
2,1217,31201,3578744663,3578744663,0
2,1217,31202,3578744663,3578744664,1
2,1217,31203,3578744663,3578744666,3
2,1217,31204,3578744663,3578744666,3
2,1217,31205,3578744663,3578744667,4
2,1217,31206,3578744663,3578744668,5
2,1217,31207,3578744663,3578744669,6
2,1217,31208,3578744663,3578744669,6
2,1217,31209,3578744663,3578744672,9
2,1217,31210,3578744663,3578744673,10
2,1217,31211,3578744663,3578744674,11
2,1217,31212,3578744663,3578744675,12
2,1217,31213,3578744663,3578744678,15
2,1217,31214,3578744663,3578744679,16
2,1217,31215,3578744663,3578744679,16
2,1217,31216,3578744663,3578744680,17
2,1217,31217,3578744663,3578744680,17
2,1217,31218,3578744663,3578744681,18
2,1217,31219,3578744663,3578744682,19
2,1217,31220,3578744663,3578744682,19
2,1217,31221,3578744663,3578744682,19
2,1217,31222,3578744663,3578744683,20
2,1217,31223,3578744663,3578744683,20
2,1217,31224,3578744663,3578744683,20
2,1217,31225,3578744663,3578744685,22
2,1217,31226,3578744663,3578744685,22
2,1217,31227,3578744663,3578744685,22
2,1217,31228,3578744663,3578744687,24
2,1217,31229,3578744663,3578744687,24
2,1217,31230,3578744663,3578744688,25
2,1217,31231,3578744663,3578744688,25
2,1217,31232,3578744663,3578744689,26
2,1217,31233,3578744663,3578744690,27
2,1217,31234,3578744663,3578744690,27
2,1217,31235,3578744663,3578744690,27
2,1217,31236,3578744663,3578744692,29
2,1217,31237,3578744663,3578744692,29
2,1217,31238,3578744663,3578744693,30
2,1217,31239,3578744663,3578744693,30
2,1217,31240,3578744663,3578744694,31
2,1217,31241,3578744663,3578744694,31
2,1217,31242,3578744663,3578744694,31
2,1217,31243,3578744663,3578744695,32
2,1217,31244,3578744663,3578744696,33
2,1217,31245,3578744663,3578744696,33
2,1217,31246,3578744663,3578744697,34
2,1217,31247,3578744663,3578744697,34
2,1217,31248,3578744663,3578744699,36
2,1217,31249,3578744663,3578744699,36
2,1217,31250,3578744663,3578744699,36
2,1217,31251,3578744663,3578744701,38
2,1217,31252,3578744663,3578744701,38
2,1217,31253,3578744663,3578744701,38
2,1217,31254,3578744663,3578744705,42
2,1217,31255,3578744663,3578744706,43
2,1217,31256,3578744663,3578744707,44
2,1217,31257,3578744663,3578744707,44
2,1217,31258,3578744663,3578744709,46
2,1217,31259,3578744663,3578744709,46
2,1217,31260,3578744663,3578744710,47
2,1217,31261,3578744663,3578744711,48
2,1217,31262,3578744663,3578744712,49
2,1217,31263,3578744663,3578744712,49
2,1218,31264,3578744726,3578744726,0
2,1218,31265,3578744726,3578744726,0
2,1218,31266,3578744726,3578744726,0
2,1218,31267,3578744726,3578744726,0
2,1218,31268,3578744726,3578744726,0
2,1218,31269,3578744726,3578744726,0
2,1218,31270,3578744726,3578744726,0
2,1218,31271,3578744726,3578744726,0
2,1218,31272,3578744726,3578744726,0
2,1218,31273,3578744726,3578744726,0
2,1218,31274,3578744726,3578744726,0
2,1218,31275,3578744726,3578744726,0
2,1218,31276,3578744726,3578744726,0
2,1218,31277,3578744726,3578744726,0
2,1218,31278,3578744726,3578744726,0
2,1218,31279,3578744726,3578744726,0
2,1218,31280,3578744726,3578744726,0
2,1218,31281,3578744726,3578744726,0
2,1218,31282,3578744726,3578744726,0
2,1218,31283,3578744726,3578744726,0
2,1218,31284,3578744726,3578744726,0
2,1218,31285,3578744726,3578744726,0
2,1218,31286,3578744726,3578744727,1
2,1218,31287,3578744726,3578744728,2
2,1218,31288,3578744726,3578744730,4
2,1218,31289,3578744726,3578744731,5
2,1218,31290,3578744726,3578744731,5
2,1218,31291,3578744726,3578744732,6
2,1218,31292,3578744726,3578744733,7
2,1218,31293,3578744726,3578744733,7
2,1218,31294,3578744726,3578744735,9
2,1218,31295,3578744726,3578744736,10
2,1218,31296,3578744726,3578744736,10
2,1218,31297,3578744726,3578744737,11
2,1218,31298,3578744726,3578744738,12
2,1218,31299,3578744726,3578744738,12
2,1218,31300,3578744726,3578744740,14
2,1218,31301,3578744726,3578744740,14
2,1218,31302,3578744726,3578744741,15
2,1218,31303,3578744726,3578744741,15
2,1218,31304,3578744726,3578744741,15
2,1218,31305,3578744726,3578744743,17
2,1218,31306,3578744726,3578744743,17
2,1218,31307,3578744726,3578744745,19
2,1218,31308,3578744726,3578744745,19
2,1218,31309,3578744726,3578744748,22
2,1218,31310,3578744726,3578744748,22
2,1218,31311,3578744726,3578744749,23
2,1218,31312,3578744726,3578744750,24
2,1218,31313,3578744726,3578744753,27
2,1218,31314,3578744726,3578744753,27
2,1218,31315,3578744726,3578744754,28
2,1218,31316,3578744726,3578744755,29
2,1218,31317,3578744726,3578744755,29
2,1218,31318,3578744726,3578744756,30
2,1218,31319,3578744726,3578744757,31
2,1218,31320,3578744726,3578744761,35
2,1218,31321,3578744726,3578744761,35
2,1218,31322,3578744726,3578744761,35
2,1218,31323,3578744726,3578744763,37
2,1218,31324,3578744726,3578744763,37
2,1218,31325,3578744726,3578744764,38
2,1218,31326,3578744726,3578744764,38
2,1218,31327,3578744726,3578744765,39
2,1218,31328,3578744726,3578744765,39
2,1218,31329,3578744726,3578744766,40
2,1218,31330,3578744726,3578744766,40
2,1218,31331,3578744726,3578744767,41
2,1218,31332,3578744726,3578744768,42
2,1218,31333,3578744726,3578744769,43
2,1218,31334,3578744726,3578744769,43
2,1218,31335,3578744726,3578744771,45
2,1218,31336,3578744726,3578744773,47
2,1218,31337,3578744726,3578744775,49
2,1218,31338,3578744726,3578744775,49
2,1219,31339,3578744788,3578744788,0
2,1219,31340,3578744788,3578744788,0
2,1219,31341,3578744788,3578744788,0
2,1219,31342,3578744788,3578744788,0
2,1219,31343,3578744788,3578744788,0
2,1219,31344,3578744788,3578744788,0
2,1219,31345,3578744788,3578744788,0
2,1219,31346,3578744788,3578744788,0
2,1219,31347,3578744788,3578744788,0
2,1219,31348,3578744788,3578744788,0
2,1219,31349,3578744788,3578744788,0
2,1219,31350,3578744788,3578744788,0
2,1219,31351,3578744788,3578744788,0
2,1219,31352,3578744788,3578744788,0
2,1219,31353,3578744788,3578744788,0
2,1219,31354,3578744788,3578744788,0
2,1219,31355,3578744788,3578744788,0
2,1219,31356,3578744788,3578744789,1
2,1219,31357,3578744788,3578744789,1
2,1219,31358,3578744788,3578744789,1
2,1219,31359,3578744788,3578744790,2
2,1219,31360,3578744788,3578744792,4
2,1219,31361,3578744788,3578744792,4
2,1219,31362,3578744788,3578744793,5
2,1219,31363,3578744788,3578744793,5
2,1219,31364,3578744788,3578744793,5
2,1219,31365,3578744788,3578744794,6
2,1219,31366,3578744788,3578744794,6
2,1219,31367,3578744788,3578744794,6
2,1219,31368,3578744788,3578744798,10
2,1219,31369,3578744788,3578744799,11
2,1219,31370,3578744788,3578744799,11
2,1219,31371,3578744788,3578744802,14
2,1219,31372,3578744788,3578744803,15
2,1219,31373,3578744788,3578744803,15
2,1219,31374,3578744788,3578744804,16
2,1219,31375,3578744788,3578744805,17
2,1219,31376,3578744788,3578744805,17
2,1219,31377,3578744788,3578744812,24
2,1219,31378,3578744788,3578744812,24
2,1219,31379,3578744788,3578744812,24
2,1219,31380,3578744788,3578744813,25
2,1219,31381,3578744788,3578744813,25
2,1219,31382,3578744788,3578744814,26
2,1219,31383,3578744788,3578744815,27
2,1219,31384,3578744788,3578744817,29
2,1219,31385,3578744788,3578744818,30
2,1219,31386,3578744788,3578744819,31
2,1219,31387,3578744788,3578744819,31
2,1219,31388,3578744788,3578744820,32
2,1219,31389,3578744788,3578744820,32
2,1219,31390,3578744788,3578744821,33
2,1219,31391,3578744788,3578744823,35
2,1219,31392,3578744788,3578744823,35
2,1219,31393,3578744788,3578744824,36
2,1219,31394,3578744788,3578744825,37
2,1219,31395,3578744788,3578744825,37
2,1219,31396,3578744788,3578744826,38
2,1219,31397,3578744788,3578744826,38
2,1219,31398,3578744788,3578744827,39
2,1219,31399,3578744788,3578744828,40
2,1219,31400,3578744788,3578744829,41
2,1219,31401,3578744788,3578744829,41
2,1219,31402,3578744788,3578744829,41
2,1219,31403,3578744788,3578744830,42
2,1219,31404,3578744788,3578744831,43
2,1219,31405,3578744788,3578744833,45
2,1219,31406,3578744788,3578744833,45
2,1219,31407,3578744788,3578744833,45
2,1219,31408,3578744788,3578744834,46
2,1219,31409,3578744788,3578744835,47
2,1219,31410,3578744788,3578744835,47
2,1219,31411,3578744788,3578744836,48
2,1219,31412,3578744788,3578744837,49
2,1219,31413,3578744788,3578744837,49
2,1219,31414,3578744788,3578744837,49
2,1220,31415,3578744852,3578744852,0
2,1220,31416,3578744852,3578744852,0
2,1220,31417,3578744852,3578744852,0
2,1220,31418,3578744852,3578744852,0
2,1220,31419,3578744852,3578744852,0
2,1220,31420,3578744852,3578744852,0
2,1220,31421,3578744852,3578744852,0
2,1220,31422,3578744852,3578744852,0
2,1220,31423,3578744852,3578744852,0
2,1220,31424,3578744852,3578744852,0
2,1220,31425,3578744852,3578744852,0
2,1220,31426,3578744852,3578744852,0
2,1220,31427,3578744852,3578744852,0
2,1220,31428,3578744852,3578744852,0
2,1220,31429,3578744852,3578744852,0
2,1220,31430,3578744852,3578744852,0
2,1220,31431,3578744852,3578744852,0
2,1220,31432,3578744852,3578744852,0
2,1220,31433,3578744852,3578744852,0
2,1220,31434,3578744852,3578744853,1
2,1220,31435,3578744852,3578744853,1
2,1220,31436,3578744852,3578744853,1
2,1220,31437,3578744852,3578744853,1
2,1220,31438,3578744852,3578744854,2
2,1220,31439,3578744852,3578744854,2
2,1220,31440,3578744852,3578744854,2
2,1220,31441,3578744852,3578744857,5
2,1220,31442,3578744852,3578744857,5
2,1220,31443,3578744852,3578744858,6
2,1220,31444,3578744852,3578744859,7
2,1220,31445,3578744852,3578744859,7
2,1220,31446,3578744852,3578744860,8
2,1220,31447,3578744852,3578744860,8
2,1220,31448,3578744852,3578744861,9
2,1220,31449,3578744852,3578744862,10
2,1220,31450,3578744852,3578744865,13
2,1220,31451,3578744852,3578744865,13
2,1220,31452,3578744852,3578744866,14
2,1220,31453,3578744852,3578744868,16
2,1220,31454,3578744852,3578744868,16
2,1220,31455,3578744852,3578744869,17
2,1220,31456,3578744852,3578744870,18
2,1220,31457,3578744852,3578744872,20
2,1220,31458,3578744852,3578744874,22
2,1220,31459,3578744852,3578744875,23
2,1220,31460,3578744852,3578744875,23
2,1220,31461,3578744852,3578744878,26
2,1220,31462,3578744852,3578744879,27
2,1220,31463,3578744852,3578744879,27
2,1220,31464,3578744852,3578744879,27
2,1220,31465,3578744852,3578744880,28
2,1220,31466,3578744852,3578744881,29
2,1220,31467,3578744852,3578744881,29
2,1220,31468,3578744852,3578744882,30
2,1220,31469,3578744852,3578744882,30
2,1220,31470,3578744852,3578744883,31
2,1220,31471,3578744852,3578744883,31
2,1220,31472,3578744852,3578744884,32
2,1220,31473,3578744852,3578744885,33
2,1220,31474,3578744852,3578744885,33
2,1220,31475,3578744852,3578744885,33
2,1220,31476,3578744852,3578744887,35
2,1220,31477,3578744852,3578744888,36
2,1220,31478,3578744852,3578744888,36
2,1220,31479,3578744852,3578744889,37
2,1220,31480,3578744852,3578744890,38
2,1220,31481,3578744852,3578744890,38
2,1220,31482,3578744852,3578744890,38
2,1220,31483,3578744852,3578744892,40
2,1220,31484,3578744852,3578744892,40
2,1220,31485,3578744852,3578744893,41
2,1220,31486,3578744852,3578744894,42
2,1220,31487,3578744852,3578744894,42
2,1220,31488,3578744852,3578744894,42
2,1220,31489,3578744852,3578744894,42
2,1220,31490,3578744852,3578744895,43
2,1220,31491,3578744852,3578744896,44
2,1220,31492,3578744852,3578744896,44
2,1220,31493,3578744852,3578744898,46
2,1220,31494,3578744852,3578744898,46
2,1220,31495,3578744852,3578744901,49
2,1220,31496,3578744852,3578744901,49
2,1221,31497,3578744914,3578744914,0
2,1221,31498,3578744914,3578744914,0
2,1221,31499,3578744914,3578744914,0
2,1221,31500,3578744914,3578744914,0
2,1221,31501,3578744914,3578744914,0
2,1221,31502,3578744914,3578744914,0
2,1221,31503,3578744914,3578744914,0
2,1221,31504,3578744914,3578744914,0
2,1221,31505,3578744914,3578744914,0
2,1221,31506,3578744914,3578744914,0
2,1221,31507,3578744914,3578744914,0
2,1221,31508,3578744914,3578744914,0
2,1221,31509,3578744914,3578744915,1
2,1221,31510,3578744914,3578744915,1
2,1221,31511,3578744914,3578744917,3
2,1221,31512,3578744914,3578744917,3
2,1221,31513,3578744914,3578744918,4
2,1221,31514,3578744914,3578744919,5
2,1221,31515,3578744914,3578744919,5
2,1221,31516,3578744914,3578744921,7
2,1221,31517,3578744914,3578744921,7
2,1221,31518,3578744914,3578744922,8
2,1221,31519,3578744914,3578744922,8
2,1221,31520,3578744914,3578744923,9
2,1221,31521,3578744914,3578744923,9
2,1221,31522,3578744914,3578744923,9
2,1221,31523,3578744914,3578744925,11
2,1221,31524,3578744914,3578744925,11
2,1221,31525,3578744914,3578744925,11
2,1221,31526,3578744914,3578744926,12
2,1221,31527,3578744914,3578744926,12
2,1221,31528,3578744914,3578744926,12
2,1221,31529,3578744914,3578744927,13
2,1221,31530,3578744914,3578744928,14
2,1221,31531,3578744914,3578744929,15
2,1221,31532,3578744914,3578744930,16
2,1221,31533,3578744914,3578744930,16
2,1221,31534,3578744914,3578744932,18
2,1221,31535,3578744914,3578744933,19
2,1221,31536,3578744914,3578744933,19
2,1221,31537,3578744914,3578744936,22
2,1221,31538,3578744914,3578744936,22
2,1221,31539,3578744914,3578744936,22
2,1221,31540,3578744914,3578744937,23
2,1221,31541,3578744914,3578744938,24
2,1221,31542,3578744914,3578744938,24
2,1221,31543,3578744914,3578744940,26
2,1221,31544,3578744914,3578744940,26
2,1221,31545,3578744914,3578744940,26
2,1221,31546,3578744914,3578744941,27
2,1221,31547,3578744914,3578744941,27
2,1221,31548,3578744914,3578744942,28
2,1221,31549,3578744914,3578744943,29
2,1221,31550,3578744914,3578744944,30
2,1221,31551,3578744914,3578744945,31
2,1221,31552,3578744914,3578744945,31
2,1221,31553,3578744914,3578744947,33
2,1221,31554,3578744914,3578744948,34
2,1221,31555,3578744914,3578744950,36
2,1221,31556,3578744914,3578744950,36
2,1221,31557,3578744914,3578744953,39
2,1221,31558,3578744914,3578744953,39
2,1221,31559,3578744914,3578744955,41
2,1221,31560,3578744914,3578744955,41
2,1221,31561,3578744914,3578744955,41
2,1221,31562,3578744914,3578744955,41
2,1221,31563,3578744914,3578744958,44
2,1221,31564,3578744914,3578744959,45
2,1221,31565,3578744914,3578744960,46
2,1221,31566,3578744914,3578744961,47
2,1221,31567,3578744914,3578744962,48
2,1221,31568,3578744914,3578744962,48
2,1221,31569,3578744914,3578744963,49
2,1221,31570,3578744914,3578744964,50
2,1222,31571,3578744977,3578744977,0
2,1222,31572,3578744977,3578744977,0
2,1222,31573,3578744977,3578744977,0
2,1222,31574,3578744977,3578744977,0
2,1222,31575,3578744977,3578744977,0
2,1222,31576,3578744977,3578744977,0
2,1222,31577,3578744977,3578744977,0
2,1222,31578,3578744977,3578744977,0
2,1222,31579,3578744977,3578744977,0
2,1222,31580,3578744977,3578744977,0
2,1222,31581,3578744977,3578744977,0
2,1222,31582,3578744977,3578744977,0
2,1222,31583,3578744977,3578744977,0
2,1222,31584,3578744977,3578744977,0
2,1222,31585,3578744977,3578744977,0
2,1222,31586,3578744977,3578744978,1
2,1222,31587,3578744977,3578744978,1
2,1222,31588,3578744977,3578744978,1
2,1222,31589,3578744977,3578744979,2
2,1222,31590,3578744977,3578744979,2
2,1222,31591,3578744977,3578744980,3
2,1222,31592,3578744977,3578744980,3
2,1222,31593,3578744977,3578744981,4
2,1222,31594,3578744977,3578744982,5
2,1222,31595,3578744977,3578744983,6
2,1222,31596,3578744977,3578744983,6
2,1222,31597,3578744977,3578744984,7
2,1222,31598,3578744977,3578744985,8
2,1222,31599,3578744977,3578744985,8
2,1222,31600,3578744977,3578744989,12
2,1222,31601,3578744977,3578744989,12
2,1222,31602,3578744977,3578744989,12
2,1222,31603,3578744977,3578744989,12
2,1222,31604,3578744977,3578744992,15
2,1222,31605,3578744977,3578744993,16
2,1222,31606,3578744977,3578744993,16
2,1222,31607,3578744977,3578744993,16
2,1222,31608,3578744977,3578744993,16
2,1222,31609,3578744977,3578744994,17
2,1222,31610,3578744977,3578744994,17
2,1222,31611,3578744977,3578744994,17
2,1222,31612,3578744977,3578744999,22
2,1222,31613,3578744977,3578744999,22
2,1222,31614,3578744977,3578745000,23
2,1222,31615,3578744977,3578745002,25
2,1222,31616,3578744977,3578745003,26
2,1222,31617,3578744977,3578745003,26
2,1222,31618,3578744977,3578745003,26
2,1222,31619,3578744977,3578745004,27
2,1222,31620,3578744977,3578745006,29
2,1222,31621,3578744977,3578745012,35
2,1222,31622,3578744977,3578745012,35
2,1222,31623,3578744977,3578745013,36
2,1222,31624,3578744977,3578745013,36
2,1222,31625,3578744977,3578745014,37
2,1222,31626,3578744977,3578745015,38
2,1222,31627,3578744977,3578745015,38
2,1222,31628,3578744977,3578745017,40
2,1222,31629,3578744977,3578745019,42
2,1222,31630,3578744977,3578745019,42
2,1222,31631,3578744977,3578745019,42
2,1222,31632,3578744977,3578745020,43
2,1222,31633,3578744977,3578745021,44
2,1222,31634,3578744977,3578745021,44
2,1222,31635,3578744977,3578745022,45
2,1222,31636,3578744977,3578745022,45
2,1222,31637,3578744977,3578745024,47
2,1222,31638,3578744977,3578745024,47
2,1222,31639,3578744977,3578745025,48
2,1222,31640,3578744977,3578745025,48
2,1222,31641,3578744977,3578745026,49
2,1223,31642,3578745039,3578745039,0
2,1223,31643,3578745039,3578745039,0
2,1223,31644,3578745039,3578745039,0
2,1223,31645,3578745039,3578745039,0
2,1223,31646,3578745039,3578745039,0
2,1223,31647,3578745039,3578745039,0
2,1223,31648,3578745039,3578745039,0
2,1223,31649,3578745039,3578745039,0
2,1223,31650,3578745039,3578745039,0
2,1223,31651,3578745039,3578745039,0
2,1223,31652,3578745039,3578745039,0
2,1223,31653,3578745039,3578745039,0
2,1223,31654,3578745039,3578745039,0
2,1223,31655,3578745039,3578745039,0
2,1223,31656,3578745039,3578745039,0
2,1223,31657,3578745039,3578745039,0
2,1223,31658,3578745039,3578745039,0
2,1223,31659,3578745039,3578745039,0
2,1223,31660,3578745039,3578745039,0
2,1223,31661,3578745039,3578745039,0
2,1223,31662,3578745039,3578745040,1
2,1223,31663,3578745039,3578745040,1
2,1223,31664,3578745039,3578745041,2
2,1223,31665,3578745039,3578745041,2
2,1223,31666,3578745039,3578745042,3
2,1223,31667,3578745039,3578745042,3
2,1223,31668,3578745039,3578745043,4
2,1223,31669,3578745039,3578745045,6
2,1223,31670,3578745039,3578745045,6
2,1223,31671,3578745039,3578745045,6
2,1223,31672,3578745039,3578745046,7
2,1223,31673,3578745039,3578745049,10
2,1223,31674,3578745039,3578745050,11
2,1223,31675,3578745039,3578745050,11
2,1223,31676,3578745039,3578745051,12
2,1223,31677,3578745039,3578745052,13
2,1223,31678,3578745039,3578745053,14
2,1223,31679,3578745039,3578745053,14
2,1223,31680,3578745039,3578745053,14
2,1223,31681,3578745039,3578745054,15
2,1223,31682,3578745039,3578745054,15
2,1223,31683,3578745039,3578745054,15
2,1223,31684,3578745039,3578745056,17
2,1223,31685,3578745039,3578745057,18
2,1223,31686,3578745039,3578745057,18
2,1223,31687,3578745039,3578745058,19
2,1223,31688,3578745039,3578745059,20
2,1223,31689,3578745039,3578745060,21
2,1223,31690,3578745039,3578745060,21
2,1223,31691,3578745039,3578745061,22
2,1223,31692,3578745039,3578745062,23
2,1223,31693,3578745039,3578745065,26
2,1223,31694,3578745039,3578745066,27
2,1223,31695,3578745039,3578745066,27
2,1223,31696,3578745039,3578745067,28
2,1223,31697,3578745039,3578745068,29
2,1223,31698,3578745039,3578745069,30
2,1223,31699,3578745039,3578745070,31
2,1223,31700,3578745039,3578745074,35
2,1223,31701,3578745039,3578745074,35
2,1223,31702,3578745039,3578745075,36
2,1223,31703,3578745039,3578745078,39
2,1223,31704,3578745039,3578745079,40
2,1223,31705,3578745039,3578745079,40
2,1223,31706,3578745039,3578745080,41
2,1223,31707,3578745039,3578745080,41
2,1223,31708,3578745039,3578745081,42
2,1223,31709,3578745039,3578745081,42
2,1223,31710,3578745039,3578745082,43
2,1223,31711,3578745039,3578745082,43
2,1223,31712,3578745039,3578745082,43
2,1223,31713,3578745039,3578745083,44
2,1223,31714,3578745039,3578745083,44
2,1223,31715,3578745039,3578745085,46
2,1223,31716,3578745039,3578745085,46
2,1223,31717,3578745039,3578745086,47
2,1223,31718,3578745039,3578745087,48
2,1223,31719,3578745039,3578745088,49
2,1223,31720,3578745039,3578745088,49
2,1223,31721,3578745039,3578745089,50
2,1224,31722,3578745100,3578745100,0
2,1224,31723,3578745100,3578745100,0
2,1224,31724,3578745100,3578745100,0
2,1224,31725,3578745100,3578745100,0
2,1224,31726,3578745100,3578745100,0
2,1224,31727,3578745100,3578745100,0
2,1224,31728,3578745100,3578745100,0
2,1224,31729,3578745100,3578745100,0
2,1224,31730,3578745100,3578745100,0
2,1224,31731,3578745100,3578745100,0
2,1224,31732,3578745100,3578745100,0
2,1224,31733,3578745100,3578745100,0
2,1224,31734,3578745100,3578745100,0
2,1224,31735,3578745100,3578745100,0
2,1224,31736,3578745100,3578745100,0
2,1224,31737,3578745100,3578745100,0
2,1224,31738,3578745100,3578745101,1
2,1224,31739,3578745100,3578745101,1
2,1224,31740,3578745100,3578745102,2
2,1224,31741,3578745100,3578745106,6
2,1224,31742,3578745100,3578745107,7
2,1224,31743,3578745100,3578745107,7
2,1224,31744,3578745100,3578745108,8
2,1224,31745,3578745100,3578745109,9
2,1224,31746,3578745100,3578745111,11
2,1224,31747,3578745100,3578745111,11
2,1224,31748,3578745100,3578745112,12
2,1224,31749,3578745100,3578745112,12
2,1224,31750,3578745100,3578745113,13
2,1224,31751,3578745100,3578745113,13
2,1224,31752,3578745100,3578745115,15
2,1224,31753,3578745100,3578745115,15
2,1224,31754,3578745100,3578745115,15
2,1224,31755,3578745100,3578745117,17
2,1224,31756,3578745100,3578745117,17
2,1224,31757,3578745100,3578745118,18
2,1224,31758,3578745100,3578745118,18
2,1224,31759,3578745100,3578745119,19
2,1224,31760,3578745100,3578745120,20
2,1224,31761,3578745100,3578745120,20
2,1224,31762,3578745100,3578745121,21
2,1224,31763,3578745100,3578745122,22
2,1224,31764,3578745100,3578745122,22
2,1224,31765,3578745100,3578745122,22
2,1224,31766,3578745100,3578745122,22
2,1224,31767,3578745100,3578745123,23
2,1224,31768,3578745100,3578745125,25
2,1224,31769,3578745100,3578745125,25
2,1224,31770,3578745100,3578745126,26
2,1224,31771,3578745100,3578745126,26
2,1224,31772,3578745100,3578745126,26
2,1224,31773,3578745100,3578745127,27
2,1224,31774,3578745100,3578745128,28
2,1224,31775,3578745100,3578745129,29
2,1224,31776,3578745100,3578745131,31
2,1224,31777,3578745100,3578745131,31
2,1224,31778,3578745100,3578745133,33
2,1224,31779,3578745100,3578745133,33
2,1224,31780,3578745100,3578745133,33
2,1224,31781,3578745100,3578745135,35
2,1224,31782,3578745100,3578745136,36
2,1224,31783,3578745100,3578745137,37
2,1224,31784,3578745100,3578745137,37
2,1224,31785,3578745100,3578745138,38
2,1224,31786,3578745100,3578745138,38
2,1224,31787,3578745100,3578745140,40
2,1224,31788,3578745100,3578745140,40
2,1224,31789,3578745100,3578745140,40
2,1224,31790,3578745100,3578745141,41
2,1224,31791,3578745100,3578745141,41
2,1224,31792,3578745100,3578745142,42
2,1224,31793,3578745100,3578745143,43
2,1224,31794,3578745100,3578745144,44
2,1224,31795,3578745100,3578745145,45
2,1224,31796,3578745100,3578745145,45
2,1224,31797,3578745100,3578745147,47
2,1224,31798,3578745100,3578745148,48
2,1225,31799,3578745161,3578745161,0
2,1225,31800,3578745161,3578745161,0
2,1225,31801,3578745161,3578745161,0
2,1225,31802,3578745161,3578745161,0
2,1225,31803,3578745161,3578745161,0
2,1225,31804,3578745161,3578745161,0
2,1225,31805,3578745161,3578745161,0
2,1225,31806,3578745161,3578745161,0
2,1225,31807,3578745161,3578745161,0
2,1225,31808,3578745161,3578745161,0
2,1225,31809,3578745161,3578745162,1
2,1225,31810,3578745161,3578745162,1
2,1225,31811,3578745161,3578745162,1
2,1225,31812,3578745161,3578745164,3
2,1225,31813,3578745161,3578745164,3
2,1225,31814,3578745161,3578745164,3
2,1225,31815,3578745161,3578745165,4
2,1225,31816,3578745161,3578745165,4
2,1225,31817,3578745161,3578745166,5
2,1225,31818,3578745161,3578745166,5
2,1225,31819,3578745161,3578745166,5
2,1225,31820,3578745161,3578745167,6
2,1225,31821,3578745161,3578745168,7
2,1225,31822,3578745161,3578745168,7
2,1225,31823,3578745161,3578745169,8
2,1225,31824,3578745161,3578745172,11
2,1225,31825,3578745161,3578745173,12
2,1225,31826,3578745161,3578745176,15
2,1225,31827,3578745161,3578745177,16
2,1225,31828,3578745161,3578745177,16
2,1225,31829,3578745161,3578745178,17
2,1225,31830,3578745161,3578745178,17
2,1225,31831,3578745161,3578745179,18
2,1225,31832,3578745161,3578745179,18
2,1225,31833,3578745161,3578745180,19
2,1225,31834,3578745161,3578745180,19
2,1225,31835,3578745161,3578745181,20
2,1225,31836,3578745161,3578745181,20
2,1225,31837,3578745161,3578745182,21
2,1225,31838,3578745161,3578745183,22
2,1225,31839,3578745161,3578745184,23
2,1225,31840,3578745161,3578745185,24
2,1225,31841,3578745161,3578745185,24
2,1225,31842,3578745161,3578745189,28
2,1225,31843,3578745161,3578745189,28
2,1225,31844,3578745161,3578745190,29
2,1225,31845,3578745161,3578745190,29
2,1225,31846,3578745161,3578745192,31
2,1225,31847,3578745161,3578745192,31
2,1225,31848,3578745161,3578745193,32
2,1225,31849,3578745161,3578745193,32
2,1225,31850,3578745161,3578745194,33
2,1225,31851,3578745161,3578745194,33
2,1225,31852,3578745161,3578745199,38
2,1225,31853,3578745161,3578745199,38
2,1225,31854,3578745161,3578745200,39
2,1225,31855,3578745161,3578745202,41
2,1225,31856,3578745161,3578745203,42
2,1225,31857,3578745161,3578745203,42
2,1225,31858,3578745161,3578745204,43
2,1225,31859,3578745161,3578745204,43
2,1225,31860,3578745161,3578745206,45
2,1226,31861,3578745222,3578745222,0
2,1226,31862,3578745222,3578745222,0
2,1226,31863,3578745222,3578745222,0
2,1226,31864,3578745222,3578745222,0
2,1226,31865,3578745222,3578745222,0
2,1226,31866,3578745222,3578745222,0
2,1226,31867,3578745222,3578745222,0
2,1226,31868,3578745222,3578745222,0
2,1226,31869,3578745222,3578745222,0
2,1226,31870,3578745222,3578745222,0
2,1226,31871,3578745222,3578745222,0
2,1226,31872,3578745222,3578745222,0
2,1226,31873,3578745222,3578745222,0
2,1226,31874,3578745222,3578745222,0
2,1226,31875,3578745222,3578745222,0
2,1226,31876,3578745222,3578745223,1
2,1226,31877,3578745222,3578745224,2
2,1226,31878,3578745222,3578745224,2
2,1226,31879,3578745222,3578745224,2
2,1226,31880,3578745222,3578745225,3
2,1226,31881,3578745222,3578745226,4
2,1226,31882,3578745222,3578745227,5
2,1226,31883,3578745222,3578745228,6
2,1226,31884,3578745222,3578745229,7
2,1226,31885,3578745222,3578745229,7
2,1226,31886,3578745222,3578745230,8
2,1226,31887,3578745222,3578745230,8
2,1226,31888,3578745222,3578745231,9
2,1226,31889,3578745222,3578745231,9
2,1226,31890,3578745222,3578745232,10
2,1226,31891,3578745222,3578745233,11
2,1226,31892,3578745222,3578745233,11
2,1226,31893,3578745222,3578745234,12
2,1226,31894,3578745222,3578745236,14
2,1226,31895,3578745222,3578745236,14
2,1226,31896,3578745222,3578745237,15
2,1226,31897,3578745222,3578745237,15
2,1226,31898,3578745222,3578745237,15
2,1226,31899,3578745222,3578745237,15
2,1226,31900,3578745222,3578745238,16
2,1226,31901,3578745222,3578745239,17
2,1226,31902,3578745222,3578745239,17
2,1226,31903,3578745222,3578745240,18
2,1226,31904,3578745222,3578745240,18
2,1226,31905,3578745222,3578745242,20
2,1226,31906,3578745222,3578745242,20
2,1226,31907,3578745222,3578745242,20
2,1226,31908,3578745222,3578745243,21
2,1226,31909,3578745222,3578745245,23
2,1226,31910,3578745222,3578745245,23
2,1226,31911,3578745222,3578745245,23
2,1226,31912,3578745222,3578745246,24
2,1226,31913,3578745222,3578745248,26
2,1226,31914,3578745222,3578745248,26
2,1226,31915,3578745222,3578745250,28
2,1226,31916,3578745222,3578745251,29
2,1226,31917,3578745222,3578745251,29
2,1226,31918,3578745222,3578745252,30
2,1226,31919,3578745222,3578745253,31
2,1226,31920,3578745222,3578745253,31
2,1226,31921,3578745222,3578745254,32
2,1226,31922,3578745222,3578745254,32
2,1226,31923,3578745222,3578745254,32
2,1226,31924,3578745222,3578745255,33
2,1226,31925,3578745222,3578745255,33
2,1226,31926,3578745222,3578745256,34
2,1226,31927,3578745222,3578745257,35
2,1226,31928,3578745222,3578745257,35
2,1226,31929,3578745222,3578745258,36
2,1226,31930,3578745222,3578745258,36
2,1226,31931,3578745222,3578745259,37
2,1226,31932,3578745222,3578745260,38
2,1226,31933,3578745222,3578745261,39
2,1226,31934,3578745222,3578745262,40
2,1226,31935,3578745222,3578745265,43
2,1226,31936,3578745222,3578745266,44
2,1226,31937,3578745222,3578745266,44
2,1226,31938,3578745222,3578745268,46
2,1226,31939,3578745222,3578745269,47
2,1226,31940,3578745222,3578745269,47
2,1226,31941,3578745222,3578745270,48
2,1226,31942,3578745222,3578745271,49
2,1227,31943,3578745285,3578745285,0
2,1227,31944,3578745285,3578745285,0
2,1227,31945,3578745285,3578745285,0
2,1227,31946,3578745285,3578745285,0
2,1227,31947,3578745285,3578745285,0
2,1227,31948,3578745285,3578745285,0
2,1227,31949,3578745285,3578745285,0
2,1227,31950,3578745285,3578745285,0
2,1227,31951,3578745285,3578745285,0
2,1227,31952,3578745285,3578745285,0
2,1227,31953,3578745285,3578745285,0
2,1227,31954,3578745285,3578745285,0
2,1227,31955,3578745285,3578745285,0
2,1227,31956,3578745285,3578745285,0
2,1227,31957,3578745285,3578745285,0
2,1227,31958,3578745285,3578745285,0
2,1227,31959,3578745285,3578745286,1
2,1227,31960,3578745285,3578745287,2
2,1227,31961,3578745285,3578745288,3
2,1227,31962,3578745285,3578745288,3
2,1227,31963,3578745285,3578745289,4
2,1227,31964,3578745285,3578745290,5
2,1227,31965,3578745285,3578745290,5
2,1227,31966,3578745285,3578745291,6
2,1227,31967,3578745285,3578745292,7
2,1227,31968,3578745285,3578745293,8
2,1227,31969,3578745285,3578745294,9
2,1227,31970,3578745285,3578745294,9
2,1227,31971,3578745285,3578745294,9
2,1227,31972,3578745285,3578745294,9
2,1227,31973,3578745285,3578745294,9
2,1227,31974,3578745285,3578745295,10
2,1227,31975,3578745285,3578745295,10
2,1227,31976,3578745285,3578745296,11
2,1227,31977,3578745285,3578745296,11
2,1227,31978,3578745285,3578745297,12
2,1227,31979,3578745285,3578745298,13
2,1227,31980,3578745285,3578745298,13
2,1227,31981,3578745285,3578745301,16
2,1227,31982,3578745285,3578745301,16
2,1227,31983,3578745285,3578745301,16
2,1227,31984,3578745285,3578745302,17
2,1227,31985,3578745285,3578745307,22
2,1227,31986,3578745285,3578745307,22
2,1227,31987,3578745285,3578745308,23
2,1227,31988,3578745285,3578745308,23
2,1227,31989,3578745285,3578745309,24
2,1227,31990,3578745285,3578745311,26
2,1227,31991,3578745285,3578745312,27
2,1227,31992,3578745285,3578745312,27
2,1227,31993,3578745285,3578745312,27
2,1227,31994,3578745285,3578745313,28
2,1227,31995,3578745285,3578745314,29
2,1227,31996,3578745285,3578745315,30
2,1227,31997,3578745285,3578745315,30
2,1227,31998,3578745285,3578745316,31
2,1227,31999,3578745285,3578745317,32
2,1227,32000,3578745285,3578745317,32
2,1227,32001,3578745285,3578745318,33
2,1227,32002,3578745285,3578745318,33
2,1227,32003,3578745285,3578745318,33
2,1227,32004,3578745285,3578745320,35
2,1227,32005,3578745285,3578745320,35
2,1227,32006,3578745285,3578745321,36
2,1227,32007,3578745285,3578745322,37
2,1227,32008,3578745285,3578745322,37
2,1227,32009,3578745285,3578745322,37
2,1227,32010,3578745285,3578745323,38
2,1227,32011,3578745285,3578745323,38
2,1227,32012,3578745285,3578745325,40
2,1227,32013,3578745285,3578745325,40
2,1227,32014,3578745285,3578745325,40
2,1227,32015,3578745285,3578745326,41
2,1227,32016,3578745285,3578745326,41
2,1227,32017,3578745285,3578745326,41
2,1227,32018,3578745285,3578745326,41
2,1227,32019,3578745285,3578745328,43
2,1227,32020,3578745285,3578745330,45
2,1227,32021,3578745285,3578745330,45
2,1227,32022,3578745285,3578745333,48
2,1227,32023,3578745285,3578745333,48
2,1227,32024,3578745285,3578745333,48
2,1227,32025,3578745285,3578745335,50
2,1228,32026,3578745346,3578745346,0
2,1228,32027,3578745346,3578745346,0
2,1228,32028,3578745346,3578745346,0
2,1228,32029,3578745346,3578745346,0
2,1228,32030,3578745346,3578745346,0
2,1228,32031,3578745346,3578745346,0
2,1228,32032,3578745346,3578745346,0
2,1228,32033,3578745346,3578745346,0
2,1228,32034,3578745346,3578745346,0
2,1228,32035,3578745346,3578745346,0
2,1228,32036,3578745346,3578745346,0
2,1228,32037,3578745346,3578745346,0
2,1228,32038,3578745346,3578745346,0
2,1228,32039,3578745346,3578745346,0
2,1228,32040,3578745346,3578745346,0
2,1228,32041,3578745346,3578745348,2
2,1228,32042,3578745346,3578745348,2
2,1228,32043,3578745346,3578745350,4
2,1228,32044,3578745346,3578745351,5
2,1228,32045,3578745346,3578745353,7
2,1228,32046,3578745346,3578745354,8
2,1228,32047,3578745346,3578745355,9
2,1228,32048,3578745346,3578745355,9
2,1228,32049,3578745346,3578745356,10
2,1228,32050,3578745346,3578745357,11
2,1228,32051,3578745346,3578745357,11
2,1228,32052,3578745346,3578745359,13
2,1228,32053,3578745346,3578745361,15
2,1228,32054,3578745346,3578745362,16
2,1228,32055,3578745346,3578745362,16
2,1228,32056,3578745346,3578745363,17
2,1228,32057,3578745346,3578745363,17
2,1228,32058,3578745346,3578745364,18
2,1228,32059,3578745346,3578745365,19
2,1228,32060,3578745346,3578745365,19
2,1228,32061,3578745346,3578745366,20
2,1228,32062,3578745346,3578745367,21
2,1228,32063,3578745346,3578745367,21
2,1228,32064,3578745346,3578745367,21
2,1228,32065,3578745346,3578745369,23
2,1228,32066,3578745346,3578745369,23
2,1228,32067,3578745346,3578745370,24
2,1228,32068,3578745346,3578745374,28
2,1228,32069,3578745346,3578745376,30
2,1228,32070,3578745346,3578745376,30
2,1228,32071,3578745346,3578745377,31
2,1228,32072,3578745346,3578745378,32
2,1228,32073,3578745346,3578745378,32
2,1228,32074,3578745346,3578745378,32
2,1228,32075,3578745346,3578745379,33
2,1228,32076,3578745346,3578745379,33
2,1228,32077,3578745346,3578745380,34
2,1228,32078,3578745346,3578745380,34
2,1228,32079,3578745346,3578745381,35
2,1228,32080,3578745346,3578745381,35
2,1228,32081,3578745346,3578745381,35
2,1228,32082,3578745346,3578745383,37
2,1228,32083,3578745346,3578745384,38
2,1228,32084,3578745346,3578745384,38
2,1228,32085,3578745346,3578745384,38
2,1228,32086,3578745346,3578745385,39
2,1228,32087,3578745346,3578745389,43
2,1228,32088,3578745346,3578745390,44
2,1228,32089,3578745346,3578745390,44
2,1228,32090,3578745346,3578745391,45
2,1228,32091,3578745346,3578745391,45
2,1228,32092,3578745346,3578745391,45
2,1228,32093,3578745346,3578745392,46
2,1228,32094,3578745346,3578745394,48
2,1228,32095,3578745346,3578745394,48
2,1228,32096,3578745346,3578745394,48
2,1228,32097,3578745346,3578745395,49
2,1229,32098,3578745407,3578745407,0
2,1229,32099,3578745407,3578745407,0
2,1229,32100,3578745407,3578745407,0
2,1229,32101,3578745407,3578745407,0
2,1229,32102,3578745407,3578745407,0
2,1229,32103,3578745407,3578745407,0
2,1229,32104,3578745407,3578745407,0
2,1229,32105,3578745407,3578745407,0
2,1229,32106,3578745407,3578745411,4
2,1229,32107,3578745407,3578745412,5
2,1229,32108,3578745407,3578745413,6
2,1229,32109,3578745407,3578745414,7
2,1229,32110,3578745407,3578745414,7
2,1229,32111,3578745407,3578745415,8
2,1229,32112,3578745407,3578745415,8
2,1229,32113,3578745407,3578745417,10
2,1229,32114,3578745407,3578745418,11
2,1229,32115,3578745407,3578745419,12
2,1229,32116,3578745407,3578745420,13
2,1229,32117,3578745407,3578745421,14
2,1229,32118,3578745407,3578745422,15
2,1229,32119,3578745407,3578745422,15
2,1229,32120,3578745407,3578745423,16
2,1229,32121,3578745407,3578745424,17
2,1229,32122,3578745407,3578745424,17
2,1229,32123,3578745407,3578745424,17
2,1229,32124,3578745407,3578745425,18
2,1229,32125,3578745407,3578745426,19
2,1229,32126,3578745407,3578745427,20
2,1229,32127,3578745407,3578745428,21
2,1229,32128,3578745407,3578745429,22
2,1229,32129,3578745407,3578745429,22
2,1229,32130,3578745407,3578745430,23
2,1229,32131,3578745407,3578745430,23
2,1229,32132,3578745407,3578745430,23
2,1229,32133,3578745407,3578745431,24
2,1229,32134,3578745407,3578745432,25
2,1229,32135,3578745407,3578745433,26
2,1229,32136,3578745407,3578745433,26
2,1229,32137,3578745407,3578745434,27
2,1229,32138,3578745407,3578745436,29
2,1229,32139,3578745407,3578745437,30
2,1229,32140,3578745407,3578745437,30
2,1229,32141,3578745407,3578745437,30
2,1229,32142,3578745407,3578745438,31
2,1229,32143,3578745407,3578745438,31
2,1229,32144,3578745407,3578745439,32
2,1229,32145,3578745407,3578745439,32
2,1229,32146,3578745407,3578745439,32
2,1229,32147,3578745407,3578745440,33
2,1229,32148,3578745407,3578745441,34
2,1229,32149,3578745407,3578745442,35
2,1229,32150,3578745407,3578745442,35
2,1229,32151,3578745407,3578745442,35
2,1229,32152,3578745407,3578745442,35
2,1229,32153,3578745407,3578745444,37
2,1229,32154,3578745407,3578745445,38
2,1229,32155,3578745407,3578745446,39
2,1229,32156,3578745407,3578745447,40
2,1229,32157,3578745407,3578745448,41
2,1229,32158,3578745407,3578745450,43
2,1229,32159,3578745407,3578745451,44
2,1229,32160,3578745407,3578745452,45
2,1229,32161,3578745407,3578745452,45
2,1229,32162,3578745407,3578745453,46
2,1229,32163,3578745407,3578745454,47
2,1229,32164,3578745407,3578745454,47
2,1229,32165,3578745407,3578745454,47
2,1229,32166,3578745407,3578745455,48
2,1229,32167,3578745407,3578745455,48
2,1229,32168,3578745407,3578745455,48
2,1229,32169,3578745407,3578745456,49
2,1229,32170,3578745407,3578745456,49
2,1229,32171,3578745407,3578745457,50
2,1230,32172,3578745470,3578745470,0
2,1230,32173,3578745470,3578745470,0
2,1230,32174,3578745470,3578745470,0
2,1230,32175,3578745470,3578745470,0
2,1230,32176,3578745470,3578745470,0
2,1230,32177,3578745470,3578745470,0
2,1230,32178,3578745470,3578745470,0
2,1230,32179,3578745470,3578745470,0
2,1230,32180,3578745470,3578745470,0
2,1230,32181,3578745470,3578745470,0
2,1230,32182,3578745470,3578745470,0
2,1230,32183,3578745470,3578745470,0
2,1230,32184,3578745470,3578745471,1
2,1230,32185,3578745470,3578745472,2
2,1230,32186,3578745470,3578745474,4
2,1230,32187,3578745470,3578745474,4
2,1230,32188,3578745470,3578745478,8
2,1230,32189,3578745470,3578745479,9
2,1230,32190,3578745470,3578745479,9
2,1230,32191,3578745470,3578745479,9
2,1230,32192,3578745470,3578745480,10
2,1230,32193,3578745470,3578745481,11
2,1230,32194,3578745470,3578745481,11
2,1230,32195,3578745470,3578745482,12
2,1230,32196,3578745470,3578745482,12
2,1230,32197,3578745470,3578745482,12
2,1230,32198,3578745470,3578745482,12
2,1230,32199,3578745470,3578745483,13
2,1230,32200,3578745470,3578745484,14
2,1230,32201,3578745470,3578745485,15
2,1230,32202,3578745470,3578745485,15
2,1230,32203,3578745470,3578745485,15
2,1230,32204,3578745470,3578745487,17
2,1230,32205,3578745470,3578745488,18
2,1230,32206,3578745470,3578745488,18
2,1230,32207,3578745470,3578745489,19
2,1230,32208,3578745470,3578745489,19
2,1230,32209,3578745470,3578745490,20
2,1230,32210,3578745470,3578745490,20
2,1230,32211,3578745470,3578745491,21
2,1230,32212,3578745470,3578745492,22
2,1230,32213,3578745470,3578745493,23
2,1230,32214,3578745470,3578745494,24
2,1230,32215,3578745470,3578745494,24
2,1230,32216,3578745470,3578745494,24
2,1230,32217,3578745470,3578745494,24
2,1230,32218,3578745470,3578745495,25
2,1230,32219,3578745470,3578745495,25
2,1230,32220,3578745470,3578745496,26
2,1230,32221,3578745470,3578745497,27
2,1230,32222,3578745470,3578745497,27
2,1230,32223,3578745470,3578745498,28
2,1230,32224,3578745470,3578745499,29
2,1230,32225,3578745470,3578745499,29
2,1230,32226,3578745470,3578745499,29
2,1230,32227,3578745470,3578745501,31
2,1230,32228,3578745470,3578745501,31
2,1230,32229,3578745470,3578745502,32
2,1230,32230,3578745470,3578745503,33
2,1230,32231,3578745470,3578745507,37
2,1230,32232,3578745470,3578745507,37
2,1230,32233,3578745470,3578745507,37
2,1230,32234,3578745470,3578745508,38
2,1230,32235,3578745470,3578745510,40
2,1230,32236,3578745470,3578745511,41
2,1230,32237,3578745470,3578745512,42
2,1230,32238,3578745470,3578745512,42
2,1230,32239,3578745470,3578745513,43
2,1230,32240,3578745470,3578745513,43
2,1230,32241,3578745470,3578745514,44
2,1230,32242,3578745470,3578745515,45
2,1230,32243,3578745470,3578745515,45
2,1230,32244,3578745470,3578745516,46
2,1230,32245,3578745470,3578745517,47
2,1230,32246,3578745470,3578745517,47
2,1230,32247,3578745470,3578745518,48
2,1230,32248,3578745470,3578745518,48
2,1230,32249,3578745470,3578745519,49
2,1230,32250,3578745470,3578745520,50
2,1231,32251,3578745534,3578745534,0
2,1231,32252,3578745534,3578745534,0
2,1231,32253,3578745534,3578745534,0
2,1231,32254,3578745534,3578745534,0
2,1231,32255,3578745534,3578745534,0
2,1231,32256,3578745534,3578745534,0
2,1231,32257,3578745534,3578745534,0
2,1231,32258,3578745534,3578745534,0
2,1231,32259,3578745534,3578745534,0
2,1231,32260,3578745534,3578745534,0
2,1231,32261,3578745534,3578745534,0
2,1231,32262,3578745534,3578745534,0
2,1231,32263,3578745534,3578745534,0
2,1231,32264,3578745534,3578745534,0
2,1231,32265,3578745534,3578745534,0
2,1231,32266,3578745534,3578745534,0
2,1231,32267,3578745534,3578745534,0
2,1231,32268,3578745534,3578745534,0
2,1231,32269,3578745534,3578745534,0
2,1231,32270,3578745534,3578745534,0
2,1231,32271,3578745534,3578745534,0
2,1231,32272,3578745534,3578745534,0
2,1231,32273,3578745534,3578745535,1
2,1231,32274,3578745534,3578745536,2
2,1231,32275,3578745534,3578745537,3
2,1231,32276,3578745534,3578745537,3
2,1231,32277,3578745534,3578745539,5
2,1231,32278,3578745534,3578745540,6
2,1231,32279,3578745534,3578745540,6
2,1231,32280,3578745534,3578745541,7
2,1231,32281,3578745534,3578745542,8
2,1231,32282,3578745534,3578745543,9
2,1231,32283,3578745534,3578745544,10
2,1231,32284,3578745534,3578745544,10
2,1231,32285,3578745534,3578745545,11
2,1231,32286,3578745534,3578745547,13
2,1231,32287,3578745534,3578745548,14
2,1231,32288,3578745534,3578745549,15
2,1231,32289,3578745534,3578745550,16
2,1231,32290,3578745534,3578745552,18
2,1231,32291,3578745534,3578745553,19
2,1231,32292,3578745534,3578745554,20
2,1231,32293,3578745534,3578745555,21
2,1231,32294,3578745534,3578745555,21
2,1231,32295,3578745534,3578745556,22
2,1231,32296,3578745534,3578745556,22
2,1231,32297,3578745534,3578745557,23
2,1231,32298,3578745534,3578745561,27
2,1231,32299,3578745534,3578745561,27
2,1231,32300,3578745534,3578745562,28
2,1231,32301,3578745534,3578745562,28
2,1231,32302,3578745534,3578745563,29
2,1231,32303,3578745534,3578745563,29
2,1231,32304,3578745534,3578745563,29
2,1231,32305,3578745534,3578745564,30
2,1231,32306,3578745534,3578745565,31
2,1231,32307,3578745534,3578745565,31
2,1231,32308,3578745534,3578745565,31
2,1231,32309,3578745534,3578745566,32
2,1231,32310,3578745534,3578745568,34
2,1231,32311,3578745534,3578745568,34
2,1231,32312,3578745534,3578745569,35
2,1231,32313,3578745534,3578745571,37
2,1231,32314,3578745534,3578745572,38
2,1231,32315,3578745534,3578745573,39
2,1231,32316,3578745534,3578745575,41
2,1231,32317,3578745534,3578745576,42
2,1231,32318,3578745534,3578745576,42
2,1231,32319,3578745534,3578745577,43
2,1231,32320,3578745534,3578745578,44
2,1231,32321,3578745534,3578745579,45
2,1231,32322,3578745534,3578745579,45
2,1231,32323,3578745534,3578745579,45
2,1231,32324,3578745534,3578745580,46
2,1231,32325,3578745534,3578745580,46
2,1231,32326,3578745534,3578745581,47
2,1231,32327,3578745534,3578745582,48
2,1231,32328,3578745534,3578745583,49
2,1231,32329,3578745534,3578745584,50
2,1232,32330,3578745597,3578745597,0
2,1232,32331,3578745597,3578745597,0
2,1232,32332,3578745597,3578745597,0
2,1232,32333,3578745597,3578745597,0
2,1232,32334,3578745597,3578745597,0
2,1232,32335,3578745597,3578745597,0
2,1232,32336,3578745597,3578745597,0
2,1232,32337,3578745597,3578745597,0
2,1232,32338,3578745597,3578745597,0
2,1232,32339,3578745597,3578745597,0
2,1232,32340,3578745597,3578745597,0
2,1232,32341,3578745597,3578745597,0
2,1232,32342,3578745597,3578745597,0
2,1232,32343,3578745597,3578745598,1
2,1232,32344,3578745597,3578745598,1
2,1232,32345,3578745597,3578745599,2
2,1232,32346,3578745597,3578745601,4
2,1232,32347,3578745597,3578745602,5
2,1232,32348,3578745597,3578745603,6
2,1232,32349,3578745597,3578745604,7
2,1232,32350,3578745597,3578745606,9
2,1232,32351,3578745597,3578745610,13
2,1232,32352,3578745597,3578745611,14
2,1232,32353,3578745597,3578745612,15
2,1232,32354,3578745597,3578745613,16
2,1232,32355,3578745597,3578745613,16
2,1232,32356,3578745597,3578745613,16
2,1232,32357,3578745597,3578745614,17
2,1232,32358,3578745597,3578745615,18
2,1232,32359,3578745597,3578745618,21
2,1232,32360,3578745597,3578745618,21
2,1232,32361,3578745597,3578745618,21
2,1232,32362,3578745597,3578745620,23
2,1232,32363,3578745597,3578745620,23
2,1232,32364,3578745597,3578745621,24
2,1232,32365,3578745597,3578745622,25
2,1232,32366,3578745597,3578745623,26
2,1232,32367,3578745597,3578745623,26
2,1232,32368,3578745597,3578745624,27
2,1232,32369,3578745597,3578745625,28
2,1232,32370,3578745597,3578745626,29
2,1232,32371,3578745597,3578745626,29
2,1232,32372,3578745597,3578745628,31
2,1232,32373,3578745597,3578745628,31
2,1232,32374,3578745597,3578745628,31
2,1232,32375,3578745597,3578745628,31
2,1232,32376,3578745597,3578745629,32
2,1232,32377,3578745597,3578745629,32
2,1232,32378,3578745597,3578745631,34
2,1232,32379,3578745597,3578745631,34
2,1232,32380,3578745597,3578745632,35
2,1232,32381,3578745597,3578745632,35
2,1232,32382,3578745597,3578745633,36
2,1232,32383,3578745597,3578745635,38
2,1232,32384,3578745597,3578745635,38
2,1232,32385,3578745597,3578745636,39
2,1232,32386,3578745597,3578745636,39
2,1232,32387,3578745597,3578745636,39
2,1232,32388,3578745597,3578745637,40
2,1232,32389,3578745597,3578745637,40
2,1232,32390,3578745597,3578745638,41
2,1232,32391,3578745597,3578745638,41
2,1232,32392,3578745597,3578745638,41
2,1232,32393,3578745597,3578745640,43
2,1232,32394,3578745597,3578745640,43
2,1232,32395,3578745597,3578745641,44
2,1232,32396,3578745597,3578745641,44
2,1232,32397,3578745597,3578745641,44
2,1232,32398,3578745597,3578745642,45
2,1232,32399,3578745597,3578745643,46
2,1232,32400,3578745597,3578745644,47
2,1232,32401,3578745597,3578745644,47
2,1232,32402,3578745597,3578745646,49
2,1232,32403,3578745597,3578745646,49
2,1233,32404,3578745658,3578745658,0
2,1233,32405,3578745658,3578745658,0
2,1233,32406,3578745658,3578745658,0
2,1233,32407,3578745658,3578745658,0
2,1233,32408,3578745658,3578745658,0
2,1233,32409,3578745658,3578745658,0
2,1233,32410,3578745658,3578745658,0
2,1233,32411,3578745658,3578745658,0
2,1233,32412,3578745658,3578745658,0
2,1233,32413,3578745658,3578745658,0
2,1233,32414,3578745658,3578745658,0
2,1233,32415,3578745658,3578745658,0
2,1233,32416,3578745658,3578745658,0
2,1233,32417,3578745658,3578745659,1
2,1233,32418,3578745658,3578745659,1
2,1233,32419,3578745658,3578745659,1
2,1233,32420,3578745658,3578745659,1
2,1233,32421,3578745658,3578745659,1
2,1233,32422,3578745658,3578745659,1
2,1233,32423,3578745658,3578745660,2
2,1233,32424,3578745658,3578745660,2
2,1233,32425,3578745658,3578745661,3
2,1233,32426,3578745658,3578745664,6
2,1233,32427,3578745658,3578745665,7
2,1233,32428,3578745658,3578745665,7
2,1233,32429,3578745658,3578745667,9
2,1233,32430,3578745658,3578745668,10
2,1233,32431,3578745658,3578745670,12
2,1233,32432,3578745658,3578745671,13
2,1233,32433,3578745658,3578745674,16
2,1233,32434,3578745658,3578745675,17
2,1233,32435,3578745658,3578745675,17
2,1233,32436,3578745658,3578745678,20
2,1233,32437,3578745658,3578745679,21
2,1233,32438,3578745658,3578745680,22
2,1233,32439,3578745658,3578745680,22
2,1233,32440,3578745658,3578745680,22
2,1233,32441,3578745658,3578745681,23
2,1233,32442,3578745658,3578745681,23
2,1233,32443,3578745658,3578745682,24
2,1233,32444,3578745658,3578745682,24
2,1233,32445,3578745658,3578745682,24
2,1233,32446,3578745658,3578745683,25
2,1233,32447,3578745658,3578745684,26
2,1233,32448,3578745658,3578745685,27
2,1233,32449,3578745658,3578745685,27
2,1233,32450,3578745658,3578745687,29
2,1233,32451,3578745658,3578745689,31
2,1233,32452,3578745658,3578745689,31
2,1233,32453,3578745658,3578745689,31
2,1233,32454,3578745658,3578745690,32
2,1233,32455,3578745658,3578745690,32
2,1233,32456,3578745658,3578745691,33
2,1233,32457,3578745658,3578745692,34
2,1233,32458,3578745658,3578745693,35
2,1233,32459,3578745658,3578745694,36
2,1233,32460,3578745658,3578745694,36
2,1233,32461,3578745658,3578745694,36
2,1233,32462,3578745658,3578745694,36
2,1233,32463,3578745658,3578745694,36
2,1233,32464,3578745658,3578745695,37
2,1233,32465,3578745658,3578745695,37
2,1233,32466,3578745658,3578745696,38
2,1233,32467,3578745658,3578745696,38
2,1233,32468,3578745658,3578745696,38
2,1233,32469,3578745658,3578745698,40
2,1233,32470,3578745658,3578745700,42
2,1233,32471,3578745658,3578745700,42
2,1233,32472,3578745658,3578745700,42
2,1233,32473,3578745658,3578745701,43
2,1233,32474,3578745658,3578745701,43
2,1233,32475,3578745658,3578745701,43
2,1233,32476,3578745658,3578745702,44
2,1233,32477,3578745658,3578745702,44
2,1233,32478,3578745658,3578745707,49
2,1233,32479,3578745658,3578745708,50
2,1234,32480,3578745720,3578745720,0
2,1234,32481,3578745720,3578745720,0
2,1234,32482,3578745720,3578745720,0
2,1234,32483,3578745720,3578745720,0
2,1234,32484,3578745720,3578745720,0
2,1234,32485,3578745720,3578745720,0
2,1234,32486,3578745720,3578745720,0
2,1234,32487,3578745720,3578745720,0
2,1234,32488,3578745720,3578745720,0
2,1234,32489,3578745720,3578745720,0
2,1234,32490,3578745720,3578745720,0
2,1234,32491,3578745720,3578745720,0
2,1234,32492,3578745720,3578745720,0
2,1234,32493,3578745720,3578745720,0
2,1234,32494,3578745720,3578745720,0
2,1234,32495,3578745720,3578745721,1
2,1234,32496,3578745720,3578745722,2
2,1234,32497,3578745720,3578745722,2
2,1234,32498,3578745720,3578745722,2
2,1234,32499,3578745720,3578745722,2
2,1234,32500,3578745720,3578745723,3
2,1234,32501,3578745720,3578745723,3
2,1234,32502,3578745720,3578745724,4
2,1234,32503,3578745720,3578745725,5
2,1234,32504,3578745720,3578745725,5
2,1234,32505,3578745720,3578745726,6
2,1234,32506,3578745720,3578745726,6
2,1234,32507,3578745720,3578745727,7
2,1234,32508,3578745720,3578745727,7
2,1234,32509,3578745720,3578745728,8
2,1234,32510,3578745720,3578745729,9
2,1234,32511,3578745720,3578745730,10
2,1234,32512,3578745720,3578745731,11
2,1234,32513,3578745720,3578745731,11
2,1234,32514,3578745720,3578745732,12
2,1234,32515,3578745720,3578745733,13
2,1234,32516,3578745720,3578745735,15
2,1234,32517,3578745720,3578745736,16
2,1234,32518,3578745720,3578745737,17
2,1234,32519,3578745720,3578745737,17
2,1234,32520,3578745720,3578745738,18
2,1234,32521,3578745720,3578745739,19
2,1234,32522,3578745720,3578745740,20
2,1234,32523,3578745720,3578745740,20
2,1234,32524,3578745720,3578745741,21
2,1234,32525,3578745720,3578745742,22
2,1234,32526,3578745720,3578745743,23
2,1234,32527,3578745720,3578745745,25
2,1234,32528,3578745720,3578745745,25
2,1234,32529,3578745720,3578745747,27
2,1234,32530,3578745720,3578745748,28
2,1234,32531,3578745720,3578745749,29
2,1234,32532,3578745720,3578745751,31
2,1234,32533,3578745720,3578745753,33
2,1234,32534,3578745720,3578745753,33
2,1234,32535,3578745720,3578745754,34
2,1234,32536,3578745720,3578745754,34
2,1234,32537,3578745720,3578745756,36
2,1234,32538,3578745720,3578745756,36
2,1234,32539,3578745720,3578745757,37
2,1234,32540,3578745720,3578745757,37
2,1234,32541,3578745720,3578745761,41
2,1234,32542,3578745720,3578745761,41
2,1234,32543,3578745720,3578745762,42
2,1234,32544,3578745720,3578745763,43
2,1234,32545,3578745720,3578745763,43
2,1234,32546,3578745720,3578745763,43
2,1234,32547,3578745720,3578745764,44
2,1234,32548,3578745720,3578745764,44
2,1234,32549,3578745720,3578745765,45
2,1234,32550,3578745720,3578745766,46
2,1234,32551,3578745720,3578745767,47
2,1234,32552,3578745720,3578745767,47
2,1234,32553,3578745720,3578745768,48
2,1234,32554,3578745720,3578745768,48
2,1234,32555,3578745720,3578745770,50
2,1235,32556,3578745782,3578745782,0
2,1235,32557,3578745782,3578745782,0
2,1235,32558,3578745782,3578745782,0
2,1235,32559,3578745782,3578745782,0
2,1235,32560,3578745782,3578745782,0
2,1235,32561,3578745782,3578745782,0
2,1235,32562,3578745782,3578745782,0
2,1235,32563,3578745782,3578745782,0
2,1235,32564,3578745782,3578745782,0
2,1235,32565,3578745782,3578745782,0
2,1235,32566,3578745782,3578745782,0
2,1235,32567,3578745782,3578745782,0
2,1235,32568,3578745782,3578745782,0
2,1235,32569,3578745782,3578745782,0
2,1235,32570,3578745782,3578745782,0
2,1235,32571,3578745782,3578745783,1
2,1235,32572,3578745782,3578745783,1
2,1235,32573,3578745782,3578745785,3
2,1235,32574,3578745782,3578745785,3
2,1235,32575,3578745782,3578745788,6
2,1235,32576,3578745782,3578745788,6
2,1235,32577,3578745782,3578745788,6
2,1235,32578,3578745782,3578745789,7
2,1235,32579,3578745782,3578745790,8
2,1235,32580,3578745782,3578745790,8
2,1235,32581,3578745782,3578745791,9
2,1235,32582,3578745782,3578745791,9
2,1235,32583,3578745782,3578745793,11
2,1235,32584,3578745782,3578745793,11
2,1235,32585,3578745782,3578745794,12
2,1235,32586,3578745782,3578745794,12
2,1235,32587,3578745782,3578745794,12
2,1235,32588,3578745782,3578745795,13
2,1235,32589,3578745782,3578745799,17
2,1235,32590,3578745782,3578745800,18
2,1235,32591,3578745782,3578745801,19
2,1235,32592,3578745782,3578745802,20
2,1235,32593,3578745782,3578745803,21
2,1235,32594,3578745782,3578745804,22
2,1235,32595,3578745782,3578745806,24
2,1235,32596,3578745782,3578745811,29
2,1235,32597,3578745782,3578745813,31
2,1235,32598,3578745782,3578745813,31
2,1235,32599,3578745782,3578745813,31
2,1235,32600,3578745782,3578745815,33
2,1235,32601,3578745782,3578745817,35
2,1235,32602,3578745782,3578745818,36
2,1235,32603,3578745782,3578745818,36
2,1235,32604,3578745782,3578745819,37
2,1235,32605,3578745782,3578745820,38
2,1235,32606,3578745782,3578745820,38
2,1235,32607,3578745782,3578745821,39
2,1235,32608,3578745782,3578745822,40
2,1235,32609,3578745782,3578745823,41
2,1235,32610,3578745782,3578745823,41
2,1235,32611,3578745782,3578745825,43
2,1235,32612,3578745782,3578745825,43
2,1235,32613,3578745782,3578745825,43
2,1235,32614,3578745782,3578745826,44
2,1235,32615,3578745782,3578745828,46
2,1235,32616,3578745782,3578745828,46
2,1235,32617,3578745782,3578745829,47
2,1235,32618,3578745782,3578745829,47
2,1235,32619,3578745782,3578745829,47
2,1235,32620,3578745782,3578745830,48
2,1235,32621,3578745782,3578745831,49
2,1235,32622,3578745782,3578745832,50
2,1236,32623,3578745843,3578745843,0
2,1236,32624,3578745843,3578745843,0
2,1236,32625,3578745843,3578745843,0
2,1236,32626,3578745843,3578745843,0
2,1236,32627,3578745843,3578745843,0
2,1236,32628,3578745843,3578745843,0
2,1236,32629,3578745843,3578745843,0
2,1236,32630,3578745843,3578745843,0
2,1236,32631,3578745843,3578745843,0
2,1236,32632,3578745843,3578745843,0
2,1236,32633,3578745843,3578745843,0
2,1236,32634,3578745843,3578745843,0
2,1236,32635,3578745843,3578745843,0
2,1236,32636,3578745843,3578745843,0
2,1236,32637,3578745843,3578745843,0
2,1236,32638,3578745843,3578745843,0
2,1236,32639,3578745843,3578745843,0
2,1236,32640,3578745843,3578745844,1
2,1236,32641,3578745843,3578745845,2
2,1236,32642,3578745843,3578745846,3
2,1236,32643,3578745843,3578745846,3
2,1236,32644,3578745843,3578745847,4
2,1236,32645,3578745843,3578745849,6
2,1236,32646,3578745843,3578745850,7
2,1236,32647,3578745843,3578745851,8
2,1236,32648,3578745843,3578745851,8
2,1236,32649,3578745843,3578745853,10
2,1236,32650,3578745843,3578745853,10
2,1236,32651,3578745843,3578745853,10
2,1236,32652,3578745843,3578745854,11
2,1236,32653,3578745843,3578745854,11
2,1236,32654,3578745843,3578745855,12
2,1236,32655,3578745843,3578745857,14
2,1236,32656,3578745843,3578745857,14
2,1236,32657,3578745843,3578745857,14
2,1236,32658,3578745843,3578745858,15
2,1236,32659,3578745843,3578745858,15
2,1236,32660,3578745843,3578745859,16
2,1236,32661,3578745843,3578745861,18
2,1236,32662,3578745843,3578745861,18
2,1236,32663,3578745843,3578745865,22
2,1236,32664,3578745843,3578745865,22
2,1236,32665,3578745843,3578745865,22
2,1236,32666,3578745843,3578745866,23
2,1236,32667,3578745843,3578745868,25
2,1236,32668,3578745843,3578745868,25
2,1236,32669,3578745843,3578745869,26
2,1236,32670,3578745843,3578745871,28
2,1236,32671,3578745843,3578745875,32
2,1236,32672,3578745843,3578745875,32
2,1236,32673,3578745843,3578745876,33
2,1236,32674,3578745843,3578745878,35
2,1236,32675,3578745843,3578745879,36
2,1236,32676,3578745843,3578745879,36
2,1236,32677,3578745843,3578745880,37
2,1236,32678,3578745843,3578745880,37
2,1236,32679,3578745843,3578745881,38
2,1236,32680,3578745843,3578745882,39
2,1236,32681,3578745843,3578745882,39
2,1236,32682,3578745843,3578745882,39
2,1236,32683,3578745843,3578745882,39
2,1236,32684,3578745843,3578745883,40
2,1236,32685,3578745843,3578745884,41
2,1236,32686,3578745843,3578745885,42
2,1236,32687,3578745843,3578745885,42
2,1236,32688,3578745843,3578745888,45
2,1236,32689,3578745843,3578745888,45
2,1236,32690,3578745843,3578745889,46
2,1236,32691,3578745843,3578745889,46
2,1236,32692,3578745843,3578745889,46
2,1236,32693,3578745843,3578745890,47
2,1236,32694,3578745843,3578745890,47
2,1236,32695,3578745843,3578745892,49
2,1236,32696,3578745843,3578745892,49
2,1237,32697,3578745905,3578745905,0
2,1237,32698,3578745905,3578745905,0
2,1237,32699,3578745905,3578745905,0
2,1237,32700,3578745905,3578745905,0
2,1237,32701,3578745905,3578745905,0
2,1237,32702,3578745905,3578745905,0
2,1237,32703,3578745905,3578745905,0
2,1237,32704,3578745905,3578745905,0
2,1237,32705,3578745905,3578745905,0
2,1237,32706,3578745905,3578745905,0
2,1237,32707,3578745905,3578745905,0
2,1237,32708,3578745905,3578745905,0
2,1237,32709,3578745905,3578745905,0
2,1237,32710,3578745905,3578745905,0
2,1237,32711,3578745905,3578745905,0
2,1237,32712,3578745905,3578745905,0
2,1237,32713,3578745905,3578745905,0
2,1237,32714,3578745905,3578745905,0
2,1237,32715,3578745905,3578745905,0
2,1237,32716,3578745905,3578745905,0
2,1237,32717,3578745905,3578745907,2
2,1237,32718,3578745905,3578745908,3
2,1237,32719,3578745905,3578745908,3
2,1237,32720,3578745905,3578745910,5
2,1237,32721,3578745905,3578745911,6
2,1237,32722,3578745905,3578745912,7
2,1237,32723,3578745905,3578745912,7
2,1237,32724,3578745905,3578745914,9
2,1237,32725,3578745905,3578745914,9
2,1237,32726,3578745905,3578745914,9
2,1237,32727,3578745905,3578745915,10
2,1237,32728,3578745905,3578745917,12
2,1237,32729,3578745905,3578745917,12
2,1237,32730,3578745905,3578745918,13
2,1237,32731,3578745905,3578745918,13
2,1237,32732,3578745905,3578745920,15
2,1237,32733,3578745905,3578745921,16
2,1237,32734,3578745905,3578745921,16
2,1237,32735,3578745905,3578745922,17
2,1237,32736,3578745905,3578745922,17
2,1237,32737,3578745905,3578745922,17
2,1237,32738,3578745905,3578745922,17
2,1237,32739,3578745905,3578745923,18
2,1237,32740,3578745905,3578745923,18
2,1237,32741,3578745905,3578745925,20
2,1237,32742,3578745905,3578745925,20
2,1237,32743,3578745905,3578745926,21
2,1237,32744,3578745905,3578745926,21
2,1237,32745,3578745905,3578745926,21
2,1237,32746,3578745905,3578745927,22
2,1237,32747,3578745905,3578745928,23
2,1237,32748,3578745905,3578745928,23
2,1237,32749,3578745905,3578745929,24
2,1237,32750,3578745905,3578745930,25
2,1237,32751,3578745905,3578745931,26
2,1237,32752,3578745905,3578745933,28
2,1237,32753,3578745905,3578745933,28
2,1237,32754,3578745905,3578745933,28
2,1237,32755,3578745905,3578745935,30
2,1237,32756,3578745905,3578745936,31
2,1237,32757,3578745905,3578745937,32
2,1237,32758,3578745905,3578745937,32
2,1237,32759,3578745905,3578745938,33
2,1237,32760,3578745905,3578745940,35
2,1237,32761,3578745905,3578745940,35
2,1237,32762,3578745905,3578745940,35
2,1237,32763,3578745905,3578745941,36
2,1237,32764,3578745905,3578745941,36
2,1237,32765,3578745905,3578745942,37
2,1237,32766,3578745905,3578745943,38
2,1237,32767,3578745905,3578745944,39
2,1237,32768,3578745905,3578745945,40
2,1237,32769,3578745905,3578745945,40
2,1237,32770,3578745905,3578745948,43
2,1237,32771,3578745905,3578745948,43
2,1237,32772,3578745905,3578745950,45
2,1237,32773,3578745905,3578745951,46
2,1237,32774,3578745905,3578745952,47
2,1237,32775,3578745905,3578745952,47
2,1237,32776,3578745905,3578745954,49
2,1237,32777,3578745905,3578745955,50
2,1238,32778,3578745968,3578745968,0
2,1238,32779,3578745968,3578745968,0
2,1238,32780,3578745968,3578745968,0
2,1238,32781,3578745968,3578745968,0
2,1238,32782,3578745968,3578745968,0
2,1238,32783,3578745968,3578745968,0
2,1238,32784,3578745968,3578745968,0
2,1238,32785,3578745968,3578745968,0
2,1238,32786,3578745968,3578745968,0
2,1238,32787,3578745968,3578745968,0
2,1238,32788,3578745968,3578745968,0
2,1238,32789,3578745968,3578745968,0
2,1238,32790,3578745968,3578745968,0
2,1238,32791,3578745968,3578745968,0
2,1238,32792,3578745968,3578745968,0
2,1238,32793,3578745968,3578745968,0
2,1238,32794,3578745968,3578745968,0
2,1238,32795,3578745968,3578745971,3
2,1238,32796,3578745968,3578745973,5
2,1238,32797,3578745968,3578745974,6
2,1238,32798,3578745968,3578745975,7
2,1238,32799,3578745968,3578745975,7
2,1238,32800,3578745968,3578745977,9
2,1238,32801,3578745968,3578745977,9
2,1238,32802,3578745968,3578745977,9
2,1238,32803,3578745968,3578745978,10
2,1238,32804,3578745968,3578745979,11
2,1238,32805,3578745968,3578745980,12
2,1238,32806,3578745968,3578745980,12
2,1238,32807,3578745968,3578745981,13
2,1238,32808,3578745968,3578745981,13
2,1238,32809,3578745968,3578745983,15
2,1238,32810,3578745968,3578745983,15
2,1238,32811,3578745968,3578745984,16
2,1238,32812,3578745968,3578745985,17
2,1238,32813,3578745968,3578745988,20
2,1238,32814,3578745968,3578745988,20
2,1238,32815,3578745968,3578745989,21
2,1238,32816,3578745968,3578745989,21
2,1238,32817,3578745968,3578745990,22
2,1238,32818,3578745968,3578745990,22
2,1238,32819,3578745968,3578745993,25
2,1238,32820,3578745968,3578745994,26
2,1238,32821,3578745968,3578745994,26
2,1238,32822,3578745968,3578745994,26
2,1238,32823,3578745968,3578745994,26
2,1238,32824,3578745968,3578745994,26
2,1238,32825,3578745968,3578745998,30
2,1238,32826,3578745968,3578745999,31
2,1238,32827,3578745968,3578746001,33
2,1238,32828,3578745968,3578746002,34
2,1238,32829,3578745968,3578746003,35
2,1238,32830,3578745968,3578746005,37
2,1238,32831,3578745968,3578746006,38
2,1238,32832,3578745968,3578746011,43
2,1238,32833,3578745968,3578746013,45
2,1238,32834,3578745968,3578746013,45
2,1238,32835,3578745968,3578746013,45
2,1238,32836,3578745968,3578746014,46
2,1238,32837,3578745968,3578746014,46
2,1238,32838,3578745968,3578746014,46
2,1238,32839,3578745968,3578746018,50
2,1239,32840,3578746030,3578746030,0
2,1239,32841,3578746030,3578746030,0
2,1239,32842,3578746030,3578746030,0
2,1239,32843,3578746030,3578746030,0
2,1239,32844,3578746030,3578746030,0
2,1239,32845,3578746030,3578746030,0
2,1239,32846,3578746030,3578746030,0
2,1239,32847,3578746030,3578746030,0
2,1239,32848,3578746030,3578746030,0
2,1239,32849,3578746030,3578746030,0
2,1239,32850,3578746030,3578746030,0
2,1239,32851,3578746030,3578746030,0
2,1239,32852,3578746030,3578746030,0
2,1239,32853,3578746030,3578746030,0
2,1239,32854,3578746030,3578746030,0
2,1239,32855,3578746030,3578746030,0
2,1239,32856,3578746030,3578746030,0
2,1239,32857,3578746030,3578746030,0
2,1239,32858,3578746030,3578746030,0
2,1239,32859,3578746030,3578746031,1
2,1239,32860,3578746030,3578746031,1
2,1239,32861,3578746030,3578746032,2
2,1239,32862,3578746030,3578746032,2
2,1239,32863,3578746030,3578746033,3
2,1239,32864,3578746030,3578746033,3
2,1239,32865,3578746030,3578746036,6
2,1239,32866,3578746030,3578746036,6
2,1239,32867,3578746030,3578746037,7
2,1239,32868,3578746030,3578746037,7
2,1239,32869,3578746030,3578746037,7
2,1239,32870,3578746030,3578746037,7
2,1239,32871,3578746030,3578746037,7
2,1239,32872,3578746030,3578746038,8
2,1239,32873,3578746030,3578746038,8
2,1239,32874,3578746030,3578746038,8
2,1239,32875,3578746030,3578746040,10
2,1239,32876,3578746030,3578746041,11
2,1239,32877,3578746030,3578746041,11
2,1239,32878,3578746030,3578746042,12
2,1239,32879,3578746030,3578746044,14
2,1239,32880,3578746030,3578746044,14
2,1239,32881,3578746030,3578746046,16
2,1239,32882,3578746030,3578746046,16
2,1239,32883,3578746030,3578746046,16
2,1239,32884,3578746030,3578746047,17
2,1239,32885,3578746030,3578746050,20
2,1239,32886,3578746030,3578746051,21
2,1239,32887,3578746030,3578746053,23
2,1239,32888,3578746030,3578746053,23
2,1239,32889,3578746030,3578746053,23
2,1239,32890,3578746030,3578746054,24
2,1239,32891,3578746030,3578746054,24
2,1239,32892,3578746030,3578746055,25
2,1239,32893,3578746030,3578746056,26
2,1239,32894,3578746030,3578746056,26
2,1239,32895,3578746030,3578746057,27
2,1239,32896,3578746030,3578746058,28
2,1239,32897,3578746030,3578746059,29
2,1239,32898,3578746030,3578746060,30
2,1239,32899,3578746030,3578746060,30
2,1239,32900,3578746030,3578746061,31
2,1239,32901,3578746030,3578746061,31
2,1239,32902,3578746030,3578746065,35
2,1239,32903,3578746030,3578746065,35
2,1239,32904,3578746030,3578746066,36
2,1239,32905,3578746030,3578746068,38
2,1239,32906,3578746030,3578746069,39
2,1239,32907,3578746030,3578746069,39
2,1239,32908,3578746030,3578746072,42
2,1239,32909,3578746030,3578746074,44
2,1239,32910,3578746030,3578746075,45
2,1239,32911,3578746030,3578746075,45
2,1239,32912,3578746030,3578746078,48
2,1239,32913,3578746030,3578746079,49
2,1239,32914,3578746030,3578746080,50
2,1240,32915,3578746092,3578746092,0
2,1240,32916,3578746092,3578746092,0
2,1240,32917,3578746092,3578746092,0
2,1240,32918,3578746092,3578746092,0
2,1240,32919,3578746092,3578746092,0
2,1240,32920,3578746092,3578746092,0
2,1240,32921,3578746092,3578746092,0
2,1240,32922,3578746092,3578746092,0
2,1240,32923,3578746092,3578746092,0
2,1240,32924,3578746092,3578746092,0
2,1240,32925,3578746092,3578746092,0
2,1240,32926,3578746092,3578746092,0
2,1240,32927,3578746092,3578746092,0
2,1240,32928,3578746092,3578746092,0
2,1240,32929,3578746092,3578746092,0
2,1240,32930,3578746092,3578746092,0
2,1240,32931,3578746092,3578746092,0
2,1240,32932,3578746092,3578746092,0
2,1240,32933,3578746092,3578746093,1
2,1240,32934,3578746092,3578746093,1
2,1240,32935,3578746092,3578746094,2
2,1240,32936,3578746092,3578746094,2
2,1240,32937,3578746092,3578746094,2
2,1240,32938,3578746092,3578746094,2
2,1240,32939,3578746092,3578746095,3
2,1240,32940,3578746092,3578746095,3
2,1240,32941,3578746092,3578746096,4
2,1240,32942,3578746092,3578746096,4
2,1240,32943,3578746092,3578746096,4
2,1240,32944,3578746092,3578746097,5
2,1240,32945,3578746092,3578746099,7
2,1240,32946,3578746092,3578746100,8
2,1240,32947,3578746092,3578746100,8
2,1240,32948,3578746092,3578746101,9
2,1240,32949,3578746092,3578746101,9
2,1240,32950,3578746092,3578746102,10
2,1240,32951,3578746092,3578746102,10
2,1240,32952,3578746092,3578746103,11
2,1240,32953,3578746092,3578746107,15
2,1240,32954,3578746092,3578746108,16
2,1240,32955,3578746092,3578746108,16
2,1240,32956,3578746092,3578746109,17
2,1240,32957,3578746092,3578746111,19
2,1240,32958,3578746092,3578746112,20
2,1240,32959,3578746092,3578746112,20
2,1240,32960,3578746092,3578746113,21
2,1240,32961,3578746092,3578746114,22
2,1240,32962,3578746092,3578746114,22
2,1240,32963,3578746092,3578746115,23
2,1240,32964,3578746092,3578746115,23
2,1240,32965,3578746092,3578746116,24
2,1240,32966,3578746092,3578746117,25
2,1240,32967,3578746092,3578746118,26
2,1240,32968,3578746092,3578746118,26
2,1240,32969,3578746092,3578746119,27
2,1240,32970,3578746092,3578746121,29
2,1240,32971,3578746092,3578746122,30
2,1240,32972,3578746092,3578746122,30
2,1240,32973,3578746092,3578746122,30
2,1240,32974,3578746092,3578746122,30
2,1240,32975,3578746092,3578746122,30
2,1240,32976,3578746092,3578746123,31
2,1240,32977,3578746092,3578746123,31
2,1240,32978,3578746092,3578746124,32
2,1240,32979,3578746092,3578746125,33
2,1240,32980,3578746092,3578746126,34
2,1240,32981,3578746092,3578746126,34
2,1240,32982,3578746092,3578746127,35
2,1240,32983,3578746092,3578746127,35
2,1240,32984,3578746092,3578746127,35
2,1240,32985,3578746092,3578746128,36
2,1240,32986,3578746092,3578746130,38
2,1240,32987,3578746092,3578746130,38
2,1240,32988,3578746092,3578746131,39
2,1240,32989,3578746092,3578746132,40
2,1240,32990,3578746092,3578746132,40
2,1240,32991,3578746092,3578746133,41
2,1240,32992,3578746092,3578746133,41
2,1240,32993,3578746092,3578746134,42
2,1240,32994,3578746092,3578746137,45
2,1240,32995,3578746092,3578746137,45
2,1240,32996,3578746092,3578746138,46
2,1240,32997,3578746092,3578746139,47
2,1240,32998,3578746092,3578746140,48
2,1240,32999,3578746092,3578746140,48
2,1240,33000,3578746092,3578746141,49
2,1240,33001,3578746092,3578746141,49
2,1240,33002,3578746092,3578746142,50
2,1241,33003,3578746154,3578746154,0
2,1241,33004,3578746154,3578746154,0
2,1241,33005,3578746154,3578746154,0
2,1241,33006,3578746154,3578746154,0
2,1241,33007,3578746154,3578746154,0
2,1241,33008,3578746154,3578746154,0
2,1241,33009,3578746154,3578746154,0
2,1241,33010,3578746154,3578746154,0
2,1241,33011,3578746154,3578746154,0
2,1241,33012,3578746154,3578746154,0
2,1241,33013,3578746154,3578746155,1
2,1241,33014,3578746154,3578746156,2
2,1241,33015,3578746154,3578746156,2
2,1241,33016,3578746154,3578746157,3
2,1241,33017,3578746154,3578746157,3
2,1241,33018,3578746154,3578746158,4
2,1241,33019,3578746154,3578746161,7
2,1241,33020,3578746154,3578746162,8
2,1241,33021,3578746154,3578746162,8
2,1241,33022,3578746154,3578746163,9
2,1241,33023,3578746154,3578746163,9
2,1241,33024,3578746154,3578746163,9
2,1241,33025,3578746154,3578746164,10
2,1241,33026,3578746154,3578746165,11
2,1241,33027,3578746154,3578746166,12
2,1241,33028,3578746154,3578746166,12
2,1241,33029,3578746154,3578746168,14
2,1241,33030,3578746154,3578746168,14
2,1241,33031,3578746154,3578746168,14
2,1241,33032,3578746154,3578746169,15
2,1241,33033,3578746154,3578746172,18
2,1241,33034,3578746154,3578746173,19
2,1241,33035,3578746154,3578746175,21
2,1241,33036,3578746154,3578746175,21
2,1241,33037,3578746154,3578746176,22
2,1241,33038,3578746154,3578746176,22
2,1241,33039,3578746154,3578746177,23
2,1241,33040,3578746154,3578746177,23
2,1241,33041,3578746154,3578746178,24
2,1241,33042,3578746154,3578746179,25
2,1241,33043,3578746154,3578746180,26
2,1241,33044,3578746154,3578746180,26
2,1241,33045,3578746154,3578746180,26
2,1241,33046,3578746154,3578746181,27
2,1241,33047,3578746154,3578746181,27
2,1241,33048,3578746154,3578746183,29
2,1241,33049,3578746154,3578746183,29
2,1241,33050,3578746154,3578746184,30
2,1241,33051,3578746154,3578746185,31
2,1241,33052,3578746154,3578746189,35
2,1241,33053,3578746154,3578746189,35
2,1241,33054,3578746154,3578746190,36
2,1241,33055,3578746154,3578746190,36
2,1241,33056,3578746154,3578746190,36
2,1241,33057,3578746154,3578746192,38
2,1241,33058,3578746154,3578746194,40
2,1241,33059,3578746154,3578746194,40
2,1241,33060,3578746154,3578746194,40
2,1241,33061,3578746154,3578746194,40
2,1241,33062,3578746154,3578746194,40
2,1241,33063,3578746154,3578746194,40
2,1241,33064,3578746154,3578746198,44
2,1241,33065,3578746154,3578746198,44
2,1241,33066,3578746154,3578746200,46
2,1241,33067,3578746154,3578746201,47
2,1241,33068,3578746154,3578746203,49
2,1241,33069,3578746154,3578746204,50
2,1242,33070,3578746215,3578746215,0
2,1242,33071,3578746215,3578746215,0
2,1242,33072,3578746215,3578746215,0
2,1242,33073,3578746215,3578746215,0
2,1242,33074,3578746215,3578746215,0
2,1242,33075,3578746215,3578746215,0
2,1242,33076,3578746215,3578746215,0
2,1242,33077,3578746215,3578746215,0
2,1242,33078,3578746215,3578746215,0
2,1242,33079,3578746215,3578746215,0
2,1242,33080,3578746215,3578746217,2
2,1242,33081,3578746215,3578746218,3
2,1242,33082,3578746215,3578746218,3
2,1242,33083,3578746215,3578746219,4
2,1242,33084,3578746215,3578746220,5
2,1242,33085,3578746215,3578746220,5
2,1242,33086,3578746215,3578746220,5
2,1242,33087,3578746215,3578746222,7
2,1242,33088,3578746215,3578746222,7
2,1242,33089,3578746215,3578746223,8
2,1242,33090,3578746215,3578746224,9
2,1242,33091,3578746215,3578746224,9
2,1242,33092,3578746215,3578746226,11
2,1242,33093,3578746215,3578746227,12
2,1242,33094,3578746215,3578746227,12
2,1242,33095,3578746215,3578746228,13
2,1242,33096,3578746215,3578746228,13
2,1242,33097,3578746215,3578746229,14
2,1242,33098,3578746215,3578746229,14
2,1242,33099,3578746215,3578746231,16
2,1242,33100,3578746215,3578746231,16
2,1242,33101,3578746215,3578746232,17
2,1242,33102,3578746215,3578746233,18
2,1242,33103,3578746215,3578746233,18
2,1242,33104,3578746215,3578746233,18
2,1242,33105,3578746215,3578746236,21
2,1242,33106,3578746215,3578746236,21
2,1242,33107,3578746215,3578746236,21
2,1242,33108,3578746215,3578746237,22
2,1242,33109,3578746215,3578746237,22
2,1242,33110,3578746215,3578746239,24
2,1242,33111,3578746215,3578746239,24
2,1242,33112,3578746215,3578746239,24
2,1242,33113,3578746215,3578746240,25
2,1242,33114,3578746215,3578746240,25
2,1242,33115,3578746215,3578746240,25
2,1242,33116,3578746215,3578746241,26
2,1242,33117,3578746215,3578746242,27
2,1242,33118,3578746215,3578746244,29
2,1242,33119,3578746215,3578746244,29
2,1242,33120,3578746215,3578746245,30
2,1242,33121,3578746215,3578746246,31
2,1242,33122,3578746215,3578746247,32
2,1242,33123,3578746215,3578746247,32
2,1242,33124,3578746215,3578746248,33
2,1242,33125,3578746215,3578746250,35
2,1242,33126,3578746215,3578746252,37
2,1242,33127,3578746215,3578746252,37
2,1242,33128,3578746215,3578746253,38
2,1242,33129,3578746215,3578746253,38
2,1242,33130,3578746215,3578746253,38
2,1242,33131,3578746215,3578746254,39
2,1242,33132,3578746215,3578746254,39
2,1242,33133,3578746215,3578746255,40
2,1242,33134,3578746215,3578746255,40
2,1242,33135,3578746215,3578746256,41
2,1242,33136,3578746215,3578746257,42
2,1242,33137,3578746215,3578746257,42
2,1242,33138,3578746215,3578746259,44
2,1242,33139,3578746215,3578746259,44
2,1242,33140,3578746215,3578746259,44
2,1242,33141,3578746215,3578746260,45
2,1242,33142,3578746215,3578746261,46
2,1242,33143,3578746215,3578746261,46
2,1243,33144,3578746276,3578746276,0
2,1243,33145,3578746276,3578746276,0
2,1243,33146,3578746276,3578746276,0
2,1243,33147,3578746276,3578746276,0
2,1243,33148,3578746276,3578746276,0
2,1243,33149,3578746276,3578746276,0
2,1243,33150,3578746276,3578746276,0
2,1243,33151,3578746276,3578746276,0
2,1243,33152,3578746276,3578746276,0
2,1243,33153,3578746276,3578746276,0
2,1243,33154,3578746276,3578746279,3
2,1243,33155,3578746276,3578746279,3
2,1243,33156,3578746276,3578746279,3
2,1243,33157,3578746276,3578746280,4
2,1243,33158,3578746276,3578746280,4
2,1243,33159,3578746276,3578746281,5
2,1243,33160,3578746276,3578746281,5
2,1243,33161,3578746276,3578746282,6
2,1243,33162,3578746276,3578746283,7
2,1243,33163,3578746276,3578746283,7
2,1243,33164,3578746276,3578746283,7
2,1243,33165,3578746276,3578746284,8
2,1243,33166,3578746276,3578746285,9
2,1243,33167,3578746276,3578746286,10
2,1243,33168,3578746276,3578746287,11
2,1243,33169,3578746276,3578746288,12
2,1243,33170,3578746276,3578746288,12
2,1243,33171,3578746276,3578746289,13
2,1243,33172,3578746276,3578746290,14
2,1243,33173,3578746276,3578746290,14
2,1243,33174,3578746276,3578746292,16
2,1243,33175,3578746276,3578746293,17
2,1243,33176,3578746276,3578746294,18
2,1243,33177,3578746276,3578746294,18
2,1243,33178,3578746276,3578746294,18
2,1243,33179,3578746276,3578746294,18
2,1243,33180,3578746276,3578746295,19
2,1243,33181,3578746276,3578746295,19
2,1243,33182,3578746276,3578746296,20
2,1243,33183,3578746276,3578746296,20
2,1243,33184,3578746276,3578746296,20
2,1243,33185,3578746276,3578746296,20
2,1243,33186,3578746276,3578746298,22
2,1243,33187,3578746276,3578746299,23
2,1243,33188,3578746276,3578746299,23
2,1243,33189,3578746276,3578746299,23
2,1243,33190,3578746276,3578746301,25
2,1243,33191,3578746276,3578746301,25
2,1243,33192,3578746276,3578746301,25
2,1243,33193,3578746276,3578746302,26
2,1243,33194,3578746276,3578746303,27
2,1243,33195,3578746276,3578746307,31
2,1243,33196,3578746276,3578746308,32
2,1243,33197,3578746276,3578746308,32
2,1243,33198,3578746276,3578746309,33
2,1243,33199,3578746276,3578746309,33
2,1243,33200,3578746276,3578746311,35
2,1243,33201,3578746276,3578746312,36
2,1243,33202,3578746276,3578746312,36
2,1243,33203,3578746276,3578746313,37
2,1243,33204,3578746276,3578746313,37
2,1243,33205,3578746276,3578746315,39
2,1243,33206,3578746276,3578746315,39
2,1243,33207,3578746276,3578746315,39
2,1243,33208,3578746276,3578746316,40
2,1243,33209,3578746276,3578746317,41
2,1243,33210,3578746276,3578746318,42
2,1243,33211,3578746276,3578746318,42
2,1243,33212,3578746276,3578746318,42
2,1243,33213,3578746276,3578746319,43
2,1243,33214,3578746276,3578746321,45
2,1243,33215,3578746276,3578746322,46
2,1243,33216,3578746276,3578746322,46
2,1243,33217,3578746276,3578746322,46
2,1243,33218,3578746276,3578746322,46
2,1243,33219,3578746276,3578746322,46
2,1243,33220,3578746276,3578746323,47
2,1243,33221,3578746276,3578746323,47
2,1243,33222,3578746276,3578746325,49
2,1243,33223,3578746276,3578746325,49
2,1243,33224,3578746276,3578746326,50
2,1244,33225,3578746339,3578746339,0
2,1244,33226,3578746339,3578746339,0
2,1244,33227,3578746339,3578746339,0
2,1244,33228,3578746339,3578746339,0
2,1244,33229,3578746339,3578746339,0
2,1244,33230,3578746339,3578746339,0
2,1244,33231,3578746339,3578746339,0
2,1244,33232,3578746339,3578746339,0
2,1244,33233,3578746339,3578746339,0
2,1244,33234,3578746339,3578746339,0
2,1244,33235,3578746339,3578746339,0
2,1244,33236,3578746339,3578746339,0
2,1244,33237,3578746339,3578746339,0
2,1244,33238,3578746339,3578746339,0
2,1244,33239,3578746339,3578746339,0
2,1244,33240,3578746339,3578746340,1
2,1244,33241,3578746339,3578746341,2
2,1244,33242,3578746339,3578746341,2
2,1244,33243,3578746339,3578746341,2
2,1244,33244,3578746339,3578746342,3
2,1244,33245,3578746339,3578746343,4
2,1244,33246,3578746339,3578746345,6
2,1244,33247,3578746339,3578746345,6
2,1244,33248,3578746339,3578746348,9
2,1244,33249,3578746339,3578746348,9
2,1244,33250,3578746339,3578746350,11
2,1244,33251,3578746339,3578746351,12
2,1244,33252,3578746339,3578746352,13
2,1244,33253,3578746339,3578746352,13
2,1244,33254,3578746339,3578746353,14
2,1244,33255,3578746339,3578746355,16
2,1244,33256,3578746339,3578746356,17
2,1244,33257,3578746339,3578746356,17
2,1244,33258,3578746339,3578746357,18
2,1244,33259,3578746339,3578746358,19
2,1244,33260,3578746339,3578746358,19
2,1244,33261,3578746339,3578746361,22
2,1244,33262,3578746339,3578746362,23
2,1244,33263,3578746339,3578746362,23
2,1244,33264,3578746339,3578746363,24
2,1244,33265,3578746339,3578746364,25
2,1244,33266,3578746339,3578746364,25
2,1244,33267,3578746339,3578746364,25
2,1244,33268,3578746339,3578746365,26
2,1244,33269,3578746339,3578746366,27
2,1244,33270,3578746339,3578746366,27
2,1244,33271,3578746339,3578746367,28
2,1244,33272,3578746339,3578746367,28
2,1244,33273,3578746339,3578746368,29
2,1244,33274,3578746339,3578746369,30
2,1244,33275,3578746339,3578746370,31
2,1244,33276,3578746339,3578746372,33
2,1244,33277,3578746339,3578746373,34
2,1244,33278,3578746339,3578746374,35
2,1244,33279,3578746339,3578746375,36
2,1244,33280,3578746339,3578746376,37
2,1244,33281,3578746339,3578746376,37
2,1244,33282,3578746339,3578746376,37
2,1244,33283,3578746339,3578746377,38
2,1244,33284,3578746339,3578746378,39
2,1244,33285,3578746339,3578746379,40
2,1244,33286,3578746339,3578746379,40
2,1244,33287,3578746339,3578746380,41
2,1244,33288,3578746339,3578746380,41
2,1244,33289,3578746339,3578746380,41
2,1244,33290,3578746339,3578746381,42
2,1244,33291,3578746339,3578746382,43
2,1244,33292,3578746339,3578746382,43
2,1244,33293,3578746339,3578746383,44
2,1244,33294,3578746339,3578746383,44
2,1244,33295,3578746339,3578746385,46
2,1244,33296,3578746339,3578746385,46
2,1244,33297,3578746339,3578746388,49
2,1244,33298,3578746339,3578746389,50
2,1245,33299,3578746402,3578746402,0
2,1245,33300,3578746402,3578746402,0
2,1245,33301,3578746402,3578746402,0
2,1245,33302,3578746402,3578746402,0
2,1245,33303,3578746402,3578746402,0
2,1245,33304,3578746402,3578746402,0
2,1245,33305,3578746402,3578746402,0
2,1245,33306,3578746402,3578746402,0
2,1245,33307,3578746402,3578746402,0
2,1245,33308,3578746402,3578746402,0
2,1245,33309,3578746402,3578746402,0
2,1245,33310,3578746402,3578746402,0
2,1245,33311,3578746402,3578746402,0
2,1245,33312,3578746402,3578746404,2
2,1245,33313,3578746402,3578746404,2
2,1245,33314,3578746402,3578746406,4
2,1245,33315,3578746402,3578746406,4
2,1245,33316,3578746402,3578746411,9
2,1245,33317,3578746402,3578746412,10
2,1245,33318,3578746402,3578746413,11
2,1245,33319,3578746402,3578746413,11
2,1245,33320,3578746402,3578746413,11
2,1245,33321,3578746402,3578746414,12
2,1245,33322,3578746402,3578746414,12
2,1245,33323,3578746402,3578746414,12
2,1245,33324,3578746402,3578746417,15
2,1245,33325,3578746402,3578746418,16
2,1245,33326,3578746402,3578746418,16
2,1245,33327,3578746402,3578746419,17
2,1245,33328,3578746402,3578746420,18
2,1245,33329,3578746402,3578746421,19
2,1245,33330,3578746402,3578746422,20
2,1245,33331,3578746402,3578746422,20
2,1245,33332,3578746402,3578746422,20
2,1245,33333,3578746402,3578746423,21
2,1245,33334,3578746402,3578746424,22
2,1245,33335,3578746402,3578746426,24
2,1245,33336,3578746402,3578746427,25
2,1245,33337,3578746402,3578746428,26
2,1245,33338,3578746402,3578746428,26
2,1245,33339,3578746402,3578746429,27
2,1245,33340,3578746402,3578746429,27
2,1245,33341,3578746402,3578746430,28
2,1245,33342,3578746402,3578746431,29
2,1245,33343,3578746402,3578746431,29
2,1245,33344,3578746402,3578746432,30
2,1245,33345,3578746402,3578746433,31
2,1245,33346,3578746402,3578746433,31
2,1245,33347,3578746402,3578746434,32
2,1245,33348,3578746402,3578746436,34
2,1245,33349,3578746402,3578746437,35
2,1245,33350,3578746402,3578746438,36
2,1245,33351,3578746402,3578746438,36
2,1245,33352,3578746402,3578746438,36
2,1245,33353,3578746402,3578746438,36
2,1245,33354,3578746402,3578746439,37
2,1245,33355,3578746402,3578746439,37
2,1245,33356,3578746402,3578746440,38
2,1245,33357,3578746402,3578746440,38
2,1245,33358,3578746402,3578746441,39
2,1245,33359,3578746402,3578746441,39
2,1245,33360,3578746402,3578746442,40
2,1245,33361,3578746402,3578746442,40
2,1245,33362,3578746402,3578746445,43
2,1245,33363,3578746402,3578746445,43
2,1245,33364,3578746402,3578746446,44
2,1245,33365,3578746402,3578746447,45
2,1245,33366,3578746402,3578746448,46
2,1245,33367,3578746402,3578746449,47
2,1245,33368,3578746402,3578746451,49
2,1246,33369,3578746464,3578746464,0
2,1246,33370,3578746464,3578746464,0
2,1246,33371,3578746464,3578746464,0
2,1246,33372,3578746464,3578746464,0
2,1246,33373,3578746464,3578746464,0
2,1246,33374,3578746464,3578746464,0
2,1246,33375,3578746464,3578746464,0
2,1246,33376,3578746464,3578746464,0
2,1246,33377,3578746464,3578746464,0
2,1246,33378,3578746464,3578746464,0
2,1246,33379,3578746464,3578746464,0
2,1246,33380,3578746464,3578746464,0
2,1246,33381,3578746464,3578746464,0
2,1246,33382,3578746464,3578746464,0
2,1246,33383,3578746464,3578746464,0
2,1246,33384,3578746464,3578746464,0
2,1246,33385,3578746464,3578746466,2
2,1246,33386,3578746464,3578746466,2
2,1246,33387,3578746464,3578746466,2
2,1246,33388,3578746464,3578746468,4
2,1246,33389,3578746464,3578746468,4
2,1246,33390,3578746464,3578746470,6
2,1246,33391,3578746464,3578746470,6
2,1246,33392,3578746464,3578746472,8
2,1246,33393,3578746464,3578746474,10
2,1246,33394,3578746464,3578746475,11
2,1246,33395,3578746464,3578746477,13
2,1246,33396,3578746464,3578746478,14
2,1246,33397,3578746464,3578746479,15
2,1246,33398,3578746464,3578746480,16
2,1246,33399,3578746464,3578746480,16
2,1246,33400,3578746464,3578746481,17
2,1246,33401,3578746464,3578746481,17
2,1246,33402,3578746464,3578746481,17
2,1246,33403,3578746464,3578746481,17
2,1246,33404,3578746464,3578746482,18
2,1246,33405,3578746464,3578746483,19
2,1246,33406,3578746464,3578746483,19
2,1246,33407,3578746464,3578746484,20
2,1246,33408,3578746464,3578746485,21
2,1246,33409,3578746464,3578746486,22
2,1246,33410,3578746464,3578746487,23
2,1246,33411,3578746464,3578746488,24
2,1246,33412,3578746464,3578746489,25
2,1246,33413,3578746464,3578746489,25
2,1246,33414,3578746464,3578746490,26
2,1246,33415,3578746464,3578746491,27
2,1246,33416,3578746464,3578746491,27
2,1246,33417,3578746464,3578746493,29
2,1246,33418,3578746464,3578746494,30
2,1246,33419,3578746464,3578746494,30
2,1246,33420,3578746464,3578746494,30
2,1246,33421,3578746464,3578746495,31
2,1246,33422,3578746464,3578746495,31
2,1246,33423,3578746464,3578746495,31
2,1246,33424,3578746464,3578746496,32
2,1246,33425,3578746464,3578746496,32
2,1246,33426,3578746464,3578746497,33
2,1246,33427,3578746464,3578746499,35
2,1246,33428,3578746464,3578746499,35
2,1246,33429,3578746464,3578746499,35
2,1246,33430,3578746464,3578746500,36
2,1246,33431,3578746464,3578746501,37
2,1246,33432,3578746464,3578746501,37
2,1246,33433,3578746464,3578746503,39
2,1246,33434,3578746464,3578746503,39
2,1246,33435,3578746464,3578746507,43
2,1246,33436,3578746464,3578746508,44
2,1246,33437,3578746464,3578746508,44
2,1246,33438,3578746464,3578746509,45
2,1246,33439,3578746464,3578746509,45
2,1246,33440,3578746464,3578746511,47
2,1246,33441,3578746464,3578746512,48
2,1246,33442,3578746464,3578746513,49
2,1246,33443,3578746464,3578746513,49
2,1246,33444,3578746464,3578746513,49
2,1246,33445,3578746464,3578746514,50
2,1247,33446,3578746527,3578746527,0
2,1247,33447,3578746527,3578746527,0
2,1247,33448,3578746527,3578746527,0
2,1247,33449,3578746527,3578746527,0
2,1247,33450,3578746527,3578746527,0
2,1247,33451,3578746527,3578746527,0
2,1247,33452,3578746527,3578746527,0
2,1247,33453,3578746527,3578746527,0
2,1247,33454,3578746527,3578746527,0
2,1247,33455,3578746527,3578746527,0
2,1247,33456,3578746527,3578746527,0
2,1247,33457,3578746527,3578746527,0
2,1247,33458,3578746527,3578746527,0
2,1247,33459,3578746527,3578746527,0
2,1247,33460,3578746527,3578746527,0
2,1247,33461,3578746527,3578746527,0
2,1247,33462,3578746527,3578746527,0
2,1247,33463,3578746527,3578746527,0
2,1247,33464,3578746527,3578746527,0
2,1247,33465,3578746527,3578746527,0
2,1247,33466,3578746527,3578746527,0
2,1247,33467,3578746527,3578746529,2
2,1247,33468,3578746527,3578746529,2
2,1247,33469,3578746527,3578746530,3
2,1247,33470,3578746527,3578746531,4
2,1247,33471,3578746527,3578746532,5
2,1247,33472,3578746527,3578746532,5
2,1247,33473,3578746527,3578746534,7
2,1247,33474,3578746527,3578746535,8
2,1247,33475,3578746527,3578746536,9
2,1247,33476,3578746527,3578746536,9
2,1247,33477,3578746527,3578746536,9
2,1247,33478,3578746527,3578746537,10
2,1247,33479,3578746527,3578746540,13
2,1247,33480,3578746527,3578746540,13
2,1247,33481,3578746527,3578746540,13
2,1247,33482,3578746527,3578746540,13
2,1247,33483,3578746527,3578746540,13
2,1247,33484,3578746527,3578746541,14
2,1247,33485,3578746527,3578746543,16
2,1247,33486,3578746527,3578746544,17
2,1247,33487,3578746527,3578746544,17
2,1247,33488,3578746527,3578746547,20
2,1247,33489,3578746527,3578746548,21
2,1247,33490,3578746527,3578746549,22
2,1247,33491,3578746527,3578746550,23
2,1247,33492,3578746527,3578746552,25
2,1247,33493,3578746527,3578746553,26
2,1247,33494,3578746527,3578746553,26
2,1247,33495,3578746527,3578746554,27
2,1247,33496,3578746527,3578746555,28
2,1247,33497,3578746527,3578746556,29
2,1247,33498,3578746527,3578746557,30
2,1247,33499,3578746527,3578746560,33
2,1247,33500,3578746527,3578746561,34
2,1247,33501,3578746527,3578746562,35
2,1247,33502,3578746527,3578746562,35
2,1247,33503,3578746527,3578746562,35
2,1247,33504,3578746527,3578746563,36
2,1247,33505,3578746527,3578746563,36
2,1247,33506,3578746527,3578746564,37
2,1247,33507,3578746527,3578746565,38
2,1247,33508,3578746527,3578746566,39
2,1247,33509,3578746527,3578746566,39
2,1247,33510,3578746527,3578746567,40
2,1247,33511,3578746527,3578746567,40
2,1247,33512,3578746527,3578746568,41
2,1247,33513,3578746527,3578746568,41
2,1247,33514,3578746527,3578746570,43
2,1247,33515,3578746527,3578746572,45
2,1247,33516,3578746527,3578746574,47
2,1247,33517,3578746527,3578746574,47
2,1247,33518,3578746527,3578746575,48
2,1247,33519,3578746527,3578746575,48
2,1247,33520,3578746527,3578746575,48
2,1247,33521,3578746527,3578746576,49
2,1248,33522,3578746589,3578746589,0
2,1248,33523,3578746589,3578746589,0
2,1248,33524,3578746589,3578746589,0
2,1248,33525,3578746589,3578746589,0
2,1248,33526,3578746589,3578746589,0
2,1248,33527,3578746589,3578746589,0
2,1248,33528,3578746589,3578746589,0
2,1248,33529,3578746589,3578746589,0
2,1248,33530,3578746589,3578746589,0
2,1248,33531,3578746589,3578746589,0
2,1248,33532,3578746589,3578746589,0
2,1248,33533,3578746589,3578746589,0
2,1248,33534,3578746589,3578746589,0
2,1248,33535,3578746589,3578746589,0
2,1248,33536,3578746589,3578746589,0
2,1248,33537,3578746589,3578746590,1
2,1248,33538,3578746589,3578746593,4
2,1248,33539,3578746589,3578746593,4
2,1248,33540,3578746589,3578746593,4
2,1248,33541,3578746589,3578746593,4
2,1248,33542,3578746589,3578746594,5
2,1248,33543,3578746589,3578746594,5
2,1248,33544,3578746589,3578746594,5
2,1248,33545,3578746589,3578746597,8
2,1248,33546,3578746589,3578746598,9
2,1248,33547,3578746589,3578746599,10
2,1248,33548,3578746589,3578746603,14
2,1248,33549,3578746589,3578746603,14
2,1248,33550,3578746589,3578746604,15
2,1248,33551,3578746589,3578746606,17
2,1248,33552,3578746589,3578746611,22
2,1248,33553,3578746589,3578746611,22
2,1248,33554,3578746589,3578746612,23
2,1248,33555,3578746589,3578746612,23
2,1248,33556,3578746589,3578746613,24
2,1248,33557,3578746589,3578746613,24
2,1248,33558,3578746589,3578746617,28
2,1248,33559,3578746589,3578746617,28
2,1248,33560,3578746589,3578746618,29
2,1248,33561,3578746589,3578746619,30
2,1248,33562,3578746589,3578746619,30
2,1248,33563,3578746589,3578746619,30
2,1248,33564,3578746589,3578746621,32
2,1248,33565,3578746589,3578746621,32
2,1248,33566,3578746589,3578746621,32
2,1248,33567,3578746589,3578746623,34
2,1248,33568,3578746589,3578746623,34
2,1248,33569,3578746589,3578746625,36
2,1248,33570,3578746589,3578746626,37
2,1248,33571,3578746589,3578746627,38
2,1248,33572,3578746589,3578746628,39
2,1248,33573,3578746589,3578746628,39
2,1248,33574,3578746589,3578746629,40
2,1248,33575,3578746589,3578746629,40
2,1248,33576,3578746589,3578746631,42
2,1248,33577,3578746589,3578746632,43
2,1248,33578,3578746589,3578746632,43
2,1248,33579,3578746589,3578746632,43
2,1248,33580,3578746589,3578746632,43
2,1248,33581,3578746589,3578746635,46
2,1248,33582,3578746589,3578746636,47
2,1248,33583,3578746589,3578746637,48
2,1248,33584,3578746589,3578746637,48
2,1248,33585,3578746589,3578746637,48
2,1248,33586,3578746589,3578746637,48
2,1248,33587,3578746589,3578746638,49
2,1248,33588,3578746589,3578746638,49
2,1248,33589,3578746589,3578746639,50
2,1249,33590,3578746651,3578746651,0
2,1249,33591,3578746651,3578746651,0
2,1249,33592,3578746651,3578746651,0
2,1249,33593,3578746651,3578746651,0
2,1249,33594,3578746651,3578746651,0
2,1249,33595,3578746651,3578746651,0
2,1249,33596,3578746651,3578746651,0
2,1249,33597,3578746651,3578746651,0
2,1249,33598,3578746651,3578746651,0
2,1249,33599,3578746651,3578746651,0
2,1249,33600,3578746651,3578746651,0
2,1249,33601,3578746651,3578746651,0
2,1249,33602,3578746651,3578746651,0
2,1249,33603,3578746651,3578746651,0
2,1249,33604,3578746651,3578746652,1
2,1249,33605,3578746651,3578746652,1
2,1249,33606,3578746651,3578746652,1
2,1249,33607,3578746651,3578746652,1
2,1249,33608,3578746651,3578746653,2
2,1249,33609,3578746651,3578746654,3
2,1249,33610,3578746651,3578746654,3
2,1249,33611,3578746651,3578746655,4
2,1249,33612,3578746651,3578746656,5
2,1249,33613,3578746651,3578746657,6
2,1249,33614,3578746651,3578746657,6
2,1249,33615,3578746651,3578746658,7
2,1249,33616,3578746651,3578746658,7
2,1249,33617,3578746651,3578746659,8
2,1249,33618,3578746651,3578746659,8
2,1249,33619,3578746651,3578746660,9
2,1249,33620,3578746651,3578746665,14
2,1249,33621,3578746651,3578746665,14
2,1249,33622,3578746651,3578746666,15
2,1249,33623,3578746651,3578746667,16
2,1249,33624,3578746651,3578746667,16
2,1249,33625,3578746651,3578746668,17
2,1249,33626,3578746651,3578746670,19
2,1249,33627,3578746651,3578746673,22
2,1249,33628,3578746651,3578746674,23
2,1249,33629,3578746651,3578746675,24
2,1249,33630,3578746651,3578746677,26
2,1249,33631,3578746651,3578746678,27
2,1249,33632,3578746651,3578746679,28
2,1249,33633,3578746651,3578746680,29
2,1249,33634,3578746651,3578746681,30
2,1249,33635,3578746651,3578746682,31
2,1249,33636,3578746651,3578746682,31
2,1249,33637,3578746651,3578746682,31
2,1249,33638,3578746651,3578746683,32
2,1249,33639,3578746651,3578746683,32
2,1249,33640,3578746651,3578746684,33
2,1249,33641,3578746651,3578746687,36
2,1249,33642,3578746651,3578746687,36
2,1249,33643,3578746651,3578746688,37
2,1249,33644,3578746651,3578746689,38
2,1249,33645,3578746651,3578746689,38
2,1249,33646,3578746651,3578746690,39
2,1249,33647,3578746651,3578746690,39
2,1249,33648,3578746651,3578746691,40
2,1249,33649,3578746651,3578746691,40
2,1249,33650,3578746651,3578746692,41
2,1249,33651,3578746651,3578746693,42
2,1249,33652,3578746651,3578746694,43
2,1249,33653,3578746651,3578746694,43
2,1249,33654,3578746651,3578746695,44
2,1249,33655,3578746651,3578746695,44
2,1249,33656,3578746651,3578746695,44
2,1249,33657,3578746651,3578746695,44
2,1249,33658,3578746651,3578746696,45
2,1249,33659,3578746651,3578746697,46
2,1249,33660,3578746651,3578746699,48
2,1249,33661,3578746651,3578746699,48
2,1249,33662,3578746651,3578746700,49
2,1249,33663,3578746651,3578746700,49
2,1250,33664,3578746714,3578746714,0
2,1250,33665,3578746714,3578746714,0
2,1250,33666,3578746714,3578746714,0
2,1250,33667,3578746714,3578746714,0
2,1250,33668,3578746714,3578746714,0
2,1250,33669,3578746714,3578746714,0
2,1250,33670,3578746714,3578746714,0
2,1250,33671,3578746714,3578746714,0
2,1250,33672,3578746714,3578746714,0
2,1250,33673,3578746714,3578746714,0
2,1250,33674,3578746714,3578746714,0
2,1250,33675,3578746714,3578746714,0
2,1250,33676,3578746714,3578746714,0
2,1250,33677,3578746714,3578746714,0
2,1250,33678,3578746714,3578746714,0
2,1250,33679,3578746714,3578746715,1
2,1250,33680,3578746714,3578746715,1
2,1250,33681,3578746714,3578746716,2
2,1250,33682,3578746714,3578746717,3
2,1250,33683,3578746714,3578746717,3
2,1250,33684,3578746714,3578746718,4
2,1250,33685,3578746714,3578746718,4
2,1250,33686,3578746714,3578746719,5
2,1250,33687,3578746714,3578746720,6
2,1250,33688,3578746714,3578746721,7
2,1250,33689,3578746714,3578746721,7
2,1250,33690,3578746714,3578746721,7
2,1250,33691,3578746714,3578746722,8
2,1250,33692,3578746714,3578746722,8
2,1250,33693,3578746714,3578746722,8
2,1250,33694,3578746714,3578746724,10
2,1250,33695,3578746714,3578746725,11
2,1250,33696,3578746714,3578746725,11
2,1250,33697,3578746714,3578746726,12
2,1250,33698,3578746714,3578746727,13
2,1250,33699,3578746714,3578746727,13
2,1250,33700,3578746714,3578746727,13
2,1250,33701,3578746714,3578746729,15
2,1250,33702,3578746714,3578746729,15
2,1250,33703,3578746714,3578746730,16
2,1250,33704,3578746714,3578746731,17
2,1250,33705,3578746714,3578746732,18
2,1250,33706,3578746714,3578746733,19
2,1250,33707,3578746714,3578746734,20
2,1250,33708,3578746714,3578746735,21
2,1250,33709,3578746714,3578746736,22
2,1250,33710,3578746714,3578746736,22
2,1250,33711,3578746714,3578746737,23
2,1250,33712,3578746714,3578746739,25
2,1250,33713,3578746714,3578746739,25
2,1250,33714,3578746714,3578746740,26
2,1250,33715,3578746714,3578746740,26
2,1250,33716,3578746714,3578746740,26
2,1250,33717,3578746714,3578746741,27
2,1250,33718,3578746714,3578746743,29
2,1250,33719,3578746714,3578746744,30
2,1250,33720,3578746714,3578746745,31
2,1250,33721,3578746714,3578746748,34
2,1250,33722,3578746714,3578746748,34
2,1250,33723,3578746714,3578746749,35
2,1250,33724,3578746714,3578746751,37
2,1250,33725,3578746714,3578746752,38
2,1250,33726,3578746714,3578746752,38
2,1250,33727,3578746714,3578746753,39
2,1250,33728,3578746714,3578746753,39
2,1250,33729,3578746714,3578746755,41
2,1250,33730,3578746714,3578746755,41
2,1250,33731,3578746714,3578746755,41
2,1250,33732,3578746714,3578746758,44
2,1250,33733,3578746714,3578746760,46
2,1250,33734,3578746714,3578746761,47
2,1250,33735,3578746714,3578746761,47
2,1250,33736,3578746714,3578746761,47
2,1250,33737,3578746714,3578746763,49
2,1250,33738,3578746714,3578746763,49
2,1250,33739,3578746714,3578746764,50
2,1251,33740,3578746776,3578746776,0
2,1251,33741,3578746776,3578746776,0
2,1251,33742,3578746776,3578746776,0
2,1251,33743,3578746776,3578746776,0
2,1251,33744,3578746776,3578746776,0
2,1251,33745,3578746776,3578746776,0
2,1251,33746,3578746776,3578746776,0
2,1251,33747,3578746776,3578746776,0
2,1251,33748,3578746776,3578746776,0
2,1251,33749,3578746776,3578746776,0
2,1251,33750,3578746776,3578746776,0
2,1251,33751,3578746776,3578746776,0
2,1251,33752,3578746776,3578746776,0
2,1251,33753,3578746776,3578746776,0
2,1251,33754,3578746776,3578746777,1
2,1251,33755,3578746776,3578746777,1
2,1251,33756,3578746776,3578746778,2
2,1251,33757,3578746776,3578746779,3
2,1251,33758,3578746776,3578746779,3
2,1251,33759,3578746776,3578746780,4
2,1251,33760,3578746776,3578746780,4
2,1251,33761,3578746776,3578746781,5
2,1251,33762,3578746776,3578746781,5
2,1251,33763,3578746776,3578746781,5
2,1251,33764,3578746776,3578746782,6
2,1251,33765,3578746776,3578746784,8
2,1251,33766,3578746776,3578746785,9
2,1251,33767,3578746776,3578746788,12
2,1251,33768,3578746776,3578746788,12
2,1251,33769,3578746776,3578746790,14
2,1251,33770,3578746776,3578746791,15
2,1251,33771,3578746776,3578746792,16
2,1251,33772,3578746776,3578746792,16
2,1251,33773,3578746776,3578746793,17
2,1251,33774,3578746776,3578746794,18
2,1251,33775,3578746776,3578746794,18
2,1251,33776,3578746776,3578746794,18
2,1251,33777,3578746776,3578746795,19
2,1251,33778,3578746776,3578746798,22
2,1251,33779,3578746776,3578746798,22
2,1251,33780,3578746776,3578746799,23
2,1251,33781,3578746776,3578746802,26
2,1251,33782,3578746776,3578746803,27
2,1251,33783,3578746776,3578746804,28
2,1251,33784,3578746776,3578746806,30
2,1251,33785,3578746776,3578746810,34
2,1251,33786,3578746776,3578746811,35
2,1251,33787,3578746776,3578746812,36
2,1251,33788,3578746776,3578746813,37
2,1251,33789,3578746776,3578746813,37
2,1251,33790,3578746776,3578746813,37
2,1251,33791,3578746776,3578746814,38
2,1251,33792,3578746776,3578746814,38
2,1251,33793,3578746776,3578746816,40
2,1251,33794,3578746776,3578746817,41
2,1251,33795,3578746776,3578746817,41
2,1251,33796,3578746776,3578746819,43
2,1251,33797,3578746776,3578746819,43
2,1251,33798,3578746776,3578746820,44
2,1251,33799,3578746776,3578746821,45
2,1251,33800,3578746776,3578746821,45
2,1251,33801,3578746776,3578746822,46
2,1251,33802,3578746776,3578746822,46
2,1251,33803,3578746776,3578746823,47
2,1251,33804,3578746776,3578746825,49
2,1252,33805,3578746838,3578746838,0
2,1252,33806,3578746838,3578746838,0
2,1252,33807,3578746838,3578746838,0
2,1252,33808,3578746838,3578746838,0
2,1252,33809,3578746838,3578746838,0
2,1252,33810,3578746838,3578746838,0
2,1252,33811,3578746838,3578746838,0
2,1252,33812,3578746838,3578746838,0
2,1252,33813,3578746838,3578746838,0
2,1252,33814,3578746838,3578746838,0
2,1252,33815,3578746838,3578746838,0
2,1252,33816,3578746838,3578746838,0
2,1252,33817,3578746838,3578746838,0
2,1252,33818,3578746838,3578746838,0
2,1252,33819,3578746838,3578746838,0
2,1252,33820,3578746838,3578746838,0
2,1252,33821,3578746838,3578746838,0
2,1252,33822,3578746838,3578746838,0
2,1252,33823,3578746838,3578746838,0
2,1252,33824,3578746838,3578746839,1
2,1252,33825,3578746838,3578746840,2
2,1252,33826,3578746838,3578746840,2
2,1252,33827,3578746838,3578746841,3
2,1252,33828,3578746838,3578746841,3
2,1252,33829,3578746838,3578746841,3
2,1252,33830,3578746838,3578746842,4
2,1252,33831,3578746838,3578746844,6
2,1252,33832,3578746838,3578746844,6
2,1252,33833,3578746838,3578746845,7
2,1252,33834,3578746838,3578746846,8
2,1252,33835,3578746838,3578746846,8
2,1252,33836,3578746838,3578746847,9
2,1252,33837,3578746838,3578746849,11
2,1252,33838,3578746838,3578746850,12
2,1252,33839,3578746838,3578746852,14
2,1252,33840,3578746838,3578746852,14
2,1252,33841,3578746838,3578746852,14
2,1252,33842,3578746838,3578746853,15
2,1252,33843,3578746838,3578746854,16
2,1252,33844,3578746838,3578746854,16
2,1252,33845,3578746838,3578746855,17
2,1252,33846,3578746838,3578746855,17
2,1252,33847,3578746838,3578746857,19
2,1252,33848,3578746838,3578746857,19
2,1252,33849,3578746838,3578746857,19
2,1252,33850,3578746838,3578746859,21
2,1252,33851,3578746838,3578746860,22
2,1252,33852,3578746838,3578746861,23
2,1252,33853,3578746838,3578746865,27
2,1252,33854,3578746838,3578746865,27
2,1252,33855,3578746838,3578746866,28
2,1252,33856,3578746838,3578746867,29
2,1252,33857,3578746838,3578746867,29
2,1252,33858,3578746838,3578746870,32
2,1252,33859,3578746838,3578746872,34
2,1252,33860,3578746838,3578746875,37
2,1252,33861,3578746838,3578746875,37
2,1252,33862,3578746838,3578746878,40
2,1252,33863,3578746838,3578746879,41
2,1252,33864,3578746838,3578746880,42
2,1252,33865,3578746838,3578746881,43
2,1252,33866,3578746838,3578746882,44
2,1252,33867,3578746838,3578746882,44
2,1252,33868,3578746838,3578746882,44
2,1252,33869,3578746838,3578746883,45
2,1252,33870,3578746838,3578746883,45
2,1252,33871,3578746838,3578746883,45
2,1252,33872,3578746838,3578746884,46
2,1252,33873,3578746838,3578746885,47
2,1252,33874,3578746838,3578746887,49
2,1252,33875,3578746838,3578746887,49
2,1253,33876,3578746899,3578746899,0
2,1253,33877,3578746899,3578746899,0
2,1253,33878,3578746899,3578746899,0
2,1253,33879,3578746899,3578746899,0
2,1253,33880,3578746899,3578746899,0
2,1253,33881,3578746899,3578746899,0
2,1253,33882,3578746899,3578746899,0
2,1253,33883,3578746899,3578746899,0
2,1253,33884,3578746899,3578746899,0
2,1253,33885,3578746899,3578746899,0
2,1253,33886,3578746899,3578746899,0
2,1253,33887,3578746899,3578746899,0
2,1253,33888,3578746899,3578746899,0
2,1253,33889,3578746899,3578746899,0
2,1253,33890,3578746899,3578746899,0
2,1253,33891,3578746899,3578746899,0
2,1253,33892,3578746899,3578746899,0
2,1253,33893,3578746899,3578746899,0
2,1253,33894,3578746899,3578746899,0
2,1253,33895,3578746899,3578746899,0
2,1253,33896,3578746899,3578746899,0
2,1253,33897,3578746899,3578746899,0
2,1253,33898,3578746899,3578746901,2
2,1253,33899,3578746899,3578746902,3
2,1253,33900,3578746899,3578746902,3
2,1253,33901,3578746899,3578746903,4
2,1253,33902,3578746899,3578746907,8
2,1253,33903,3578746899,3578746907,8
2,1253,33904,3578746899,3578746908,9
2,1253,33905,3578746899,3578746910,11
2,1253,33906,3578746899,3578746910,11
2,1253,33907,3578746899,3578746910,11
2,1253,33908,3578746899,3578746912,13
2,1253,33909,3578746899,3578746912,13
2,1253,33910,3578746899,3578746913,14
2,1253,33911,3578746899,3578746914,15
2,1253,33912,3578746899,3578746914,15
2,1253,33913,3578746899,3578746914,15
2,1253,33914,3578746899,3578746915,16
2,1253,33915,3578746899,3578746917,18
2,1253,33916,3578746899,3578746917,18
2,1253,33917,3578746899,3578746917,18
2,1253,33918,3578746899,3578746919,20
2,1253,33919,3578746899,3578746919,20
2,1253,33920,3578746899,3578746921,22
2,1253,33921,3578746899,3578746921,22
2,1253,33922,3578746899,3578746922,23
2,1253,33923,3578746899,3578746922,23
2,1253,33924,3578746899,3578746922,23
2,1253,33925,3578746899,3578746923,24
2,1253,33926,3578746899,3578746924,25
2,1253,33927,3578746899,3578746925,26
2,1253,33928,3578746899,3578746925,26
2,1253,33929,3578746899,3578746926,27
2,1253,33930,3578746899,3578746927,28
2,1253,33931,3578746899,3578746927,28
2,1253,33932,3578746899,3578746927,28
2,1253,33933,3578746899,3578746929,30
2,1253,33934,3578746899,3578746929,30
2,1253,33935,3578746899,3578746930,31
2,1253,33936,3578746899,3578746932,33
2,1253,33937,3578746899,3578746933,34
2,1253,33938,3578746899,3578746933,34
2,1253,33939,3578746899,3578746934,35
2,1253,33940,3578746899,3578746936,37
2,1253,33941,3578746899,3578746936,37
2,1253,33942,3578746899,3578746936,37
2,1253,33943,3578746899,3578746937,38
2,1253,33944,3578746899,3578746939,40
2,1253,33945,3578746899,3578746939,40
2,1253,33946,3578746899,3578746939,40
2,1253,33947,3578746899,3578746940,41
2,1253,33948,3578746899,3578746940,41
2,1253,33949,3578746899,3578746942,43
2,1253,33950,3578746899,3578746942,43
2,1253,33951,3578746899,3578746943,44
2,1253,33952,3578746899,3578746943,44
2,1253,33953,3578746899,3578746944,45
2,1253,33954,3578746899,3578746944,45
2,1253,33955,3578746899,3578746948,49
2,1254,33956,3578746961,3578746961,0
2,1254,33957,3578746961,3578746961,0
2,1254,33958,3578746961,3578746961,0
2,1254,33959,3578746961,3578746961,0
2,1254,33960,3578746961,3578746961,0
2,1254,33961,3578746961,3578746961,0
2,1254,33962,3578746961,3578746961,0
2,1254,33963,3578746961,3578746961,0
2,1254,33964,3578746961,3578746961,0
2,1254,33965,3578746961,3578746961,0
2,1254,33966,3578746961,3578746961,0
2,1254,33967,3578746961,3578746961,0
2,1254,33968,3578746961,3578746961,0
2,1254,33969,3578746961,3578746963,2
2,1254,33970,3578746961,3578746963,2
2,1254,33971,3578746961,3578746963,2
2,1254,33972,3578746961,3578746965,4
2,1254,33973,3578746961,3578746965,4
2,1254,33974,3578746961,3578746966,5
2,1254,33975,3578746961,3578746967,6
2,1254,33976,3578746961,3578746967,6
2,1254,33977,3578746961,3578746968,7
2,1254,33978,3578746961,3578746968,7
2,1254,33979,3578746961,3578746972,11
2,1254,33980,3578746961,3578746973,12
2,1254,33981,3578746961,3578746974,13
2,1254,33982,3578746961,3578746975,14
2,1254,33983,3578746961,3578746976,15
2,1254,33984,3578746961,3578746976,15
2,1254,33985,3578746961,3578746976,15
2,1254,33986,3578746961,3578746976,15
2,1254,33987,3578746961,3578746977,16
2,1254,33988,3578746961,3578746977,16
2,1254,33989,3578746961,3578746978,17
2,1254,33990,3578746961,3578746978,17
2,1254,33991,3578746961,3578746979,18
2,1254,33992,3578746961,3578746980,19
2,1254,33993,3578746961,3578746980,19
2,1254,33994,3578746961,3578746980,19
2,1254,33995,3578746961,3578746981,20
2,1254,33996,3578746961,3578746982,21
2,1254,33997,3578746961,3578746982,21
2,1254,33998,3578746961,3578746984,23
2,1254,33999,3578746961,3578746985,24
2,1254,34000,3578746961,3578746985,24
2,1254,34001,3578746961,3578746988,27
2,1254,34002,3578746961,3578746988,27
2,1254,34003,3578746961,3578746990,29
2,1254,34004,3578746961,3578746991,30
2,1254,34005,3578746961,3578746991,30
2,1254,34006,3578746961,3578746993,32
2,1254,34007,3578746961,3578746993,32
2,1254,34008,3578746961,3578746993,32
2,1254,34009,3578746961,3578746994,33
2,1254,34010,3578746961,3578746994,33
2,1254,34011,3578746961,3578746994,33
2,1254,34012,3578746961,3578746994,33
2,1254,34013,3578746961,3578746998,37
2,1254,34014,3578746961,3578747000,39
2,1254,34015,3578746961,3578747002,41
2,1254,34016,3578746961,3578747003,42
2,1254,34017,3578746961,3578747005,44
2,1254,34018,3578746961,3578747006,45
2,1254,34019,3578746961,3578747010,49
2,1254,34020,3578746961,3578747011,50
2,1255,34021,3578747024,3578747024,0
2,1255,34022,3578747024,3578747024,0
2,1255,34023,3578747024,3578747024,0
2,1255,34024,3578747024,3578747024,0
2,1255,34025,3578747024,3578747024,0
2,1255,34026,3578747024,3578747024,0
2,1255,34027,3578747024,3578747024,0
2,1255,34028,3578747024,3578747024,0
2,1255,34029,3578747024,3578747024,0
2,1255,34030,3578747024,3578747024,0
2,1255,34031,3578747024,3578747024,0
2,1255,34032,3578747024,3578747024,0
2,1255,34033,3578747024,3578747024,0
2,1255,34034,3578747024,3578747024,0
2,1255,34035,3578747024,3578747024,0
2,1255,34036,3578747024,3578747024,0
2,1255,34037,3578747024,3578747024,0
2,1255,34038,3578747024,3578747024,0
2,1255,34039,3578747024,3578747025,1
2,1255,34040,3578747024,3578747026,2
2,1255,34041,3578747024,3578747027,3
2,1255,34042,3578747024,3578747028,4
2,1255,34043,3578747024,3578747029,5
2,1255,34044,3578747024,3578747031,7
2,1255,34045,3578747024,3578747031,7
2,1255,34046,3578747024,3578747032,8
2,1255,34047,3578747024,3578747032,8
2,1255,34048,3578747024,3578747033,9
2,1255,34049,3578747024,3578747033,9
2,1255,34050,3578747024,3578747036,12
2,1255,34051,3578747024,3578747036,12
2,1255,34052,3578747024,3578747036,12
2,1255,34053,3578747024,3578747037,13
2,1255,34054,3578747024,3578747037,13
2,1255,34055,3578747024,3578747037,13
2,1255,34056,3578747024,3578747037,13
2,1255,34057,3578747024,3578747038,14
2,1255,34058,3578747024,3578747038,14
2,1255,34059,3578747024,3578747038,14
2,1255,34060,3578747024,3578747040,16
2,1255,34061,3578747024,3578747040,16
2,1255,34062,3578747024,3578747041,17
2,1255,34063,3578747024,3578747041,17
2,1255,34064,3578747024,3578747042,18
2,1255,34065,3578747024,3578747042,18
2,1255,34066,3578747024,3578747044,20
2,1255,34067,3578747024,3578747044,20
2,1255,34068,3578747024,3578747045,21
2,1255,34069,3578747024,3578747046,22
2,1255,34070,3578747024,3578747046,22
2,1255,34071,3578747024,3578747047,23
2,1255,34072,3578747024,3578747050,26
2,1255,34073,3578747024,3578747050,26
2,1255,34074,3578747024,3578747052,28
2,1255,34075,3578747024,3578747052,28
2,1255,34076,3578747024,3578747053,29
2,1255,34077,3578747024,3578747053,29
2,1255,34078,3578747024,3578747053,29
2,1255,34079,3578747024,3578747054,30
2,1255,34080,3578747024,3578747054,30
2,1255,34081,3578747024,3578747054,30
2,1255,34082,3578747024,3578747055,31
2,1255,34083,3578747024,3578747056,32
2,1255,34084,3578747024,3578747056,32
2,1255,34085,3578747024,3578747057,33
2,1255,34086,3578747024,3578747059,35
2,1255,34087,3578747024,3578747059,35
2,1255,34088,3578747024,3578747060,36
2,1255,34089,3578747024,3578747061,37
2,1255,34090,3578747024,3578747061,37
2,1255,34091,3578747024,3578747065,41
2,1255,34092,3578747024,3578747065,41
2,1255,34093,3578747024,3578747066,42
2,1255,34094,3578747024,3578747067,43
2,1255,34095,3578747024,3578747068,44
2,1255,34096,3578747024,3578747070,46
2,1255,34097,3578747024,3578747072,48
2,1256,34098,3578747086,3578747086,0
2,1256,34099,3578747086,3578747086,0
2,1256,34100,3578747086,3578747086,0
2,1256,34101,3578747086,3578747086,0
2,1256,34102,3578747086,3578747086,0
2,1256,34103,3578747086,3578747086,0
2,1256,34104,3578747086,3578747086,0
2,1256,34105,3578747086,3578747086,0
2,1256,34106,3578747086,3578747086,0
2,1256,34107,3578747086,3578747086,0
2,1256,34108,3578747086,3578747086,0
2,1256,34109,3578747086,3578747086,0
2,1256,34110,3578747086,3578747086,0
2,1256,34111,3578747086,3578747086,0
2,1256,34112,3578747086,3578747086,0
2,1256,34113,3578747086,3578747086,0
2,1256,34114,3578747086,3578747086,0
2,1256,34115,3578747086,3578747087,1
2,1256,34116,3578747086,3578747087,1
2,1256,34117,3578747086,3578747088,2
2,1256,34118,3578747086,3578747089,3
2,1256,34119,3578747086,3578747089,3
2,1256,34120,3578747086,3578747090,4
2,1256,34121,3578747086,3578747091,5
2,1256,34122,3578747086,3578747091,5
2,1256,34123,3578747086,3578747091,5
2,1256,34124,3578747086,3578747094,8
2,1256,34125,3578747086,3578747094,8
2,1256,34126,3578747086,3578747096,10
2,1256,34127,3578747086,3578747096,10
2,1256,34128,3578747086,3578747097,11
2,1256,34129,3578747086,3578747097,11
2,1256,34130,3578747086,3578747098,12
2,1256,34131,3578747086,3578747099,13
2,1256,34132,3578747086,3578747099,13
2,1256,34133,3578747086,3578747100,14
2,1256,34134,3578747086,3578747100,14
2,1256,34135,3578747086,3578747101,15
2,1256,34136,3578747086,3578747102,16
2,1256,34137,3578747086,3578747102,16
2,1256,34138,3578747086,3578747107,21
2,1256,34139,3578747086,3578747107,21
2,1256,34140,3578747086,3578747108,22
2,1256,34141,3578747086,3578747111,25
2,1256,34142,3578747086,3578747111,25
2,1256,34143,3578747086,3578747111,25
2,1256,34144,3578747086,3578747112,26
2,1256,34145,3578747086,3578747113,27
2,1256,34146,3578747086,3578747113,27
2,1256,34147,3578747086,3578747113,27
2,1256,34148,3578747086,3578747114,28
2,1256,34149,3578747086,3578747114,28
2,1256,34150,3578747086,3578747115,29
2,1256,34151,3578747086,3578747116,30
2,1256,34152,3578747086,3578747116,30
2,1256,34153,3578747086,3578747117,31
2,1256,34154,3578747086,3578747117,31
2,1256,34155,3578747086,3578747117,31
2,1256,34156,3578747086,3578747119,33
2,1256,34157,3578747086,3578747120,34
2,1256,34158,3578747086,3578747121,35
2,1256,34159,3578747086,3578747121,35
2,1256,34160,3578747086,3578747121,35
2,1256,34161,3578747086,3578747122,36
2,1256,34162,3578747086,3578747122,36
2,1256,34163,3578747086,3578747122,36
2,1256,34164,3578747086,3578747123,37
2,1256,34165,3578747086,3578747124,38
2,1256,34166,3578747086,3578747125,39
2,1256,34167,3578747086,3578747126,40
2,1256,34168,3578747086,3578747126,40
2,1256,34169,3578747086,3578747127,41
2,1256,34170,3578747086,3578747128,42
2,1256,34171,3578747086,3578747128,42
2,1256,34172,3578747086,3578747129,43
2,1256,34173,3578747086,3578747130,44
2,1256,34174,3578747086,3578747131,45
2,1256,34175,3578747086,3578747132,46
2,1256,34176,3578747086,3578747133,47
2,1256,34177,3578747086,3578747134,48
2,1257,34178,3578747148,3578747148,0
2,1257,34179,3578747148,3578747148,0
2,1257,34180,3578747148,3578747148,0
2,1257,34181,3578747148,3578747148,0
2,1257,34182,3578747148,3578747148,0
2,1257,34183,3578747148,3578747148,0
2,1257,34184,3578747148,3578747148,0
2,1257,34185,3578747148,3578747148,0
2,1257,34186,3578747148,3578747148,0
2,1257,34187,3578747148,3578747148,0
2,1257,34188,3578747148,3578747148,0
2,1257,34189,3578747148,3578747148,0
2,1257,34190,3578747148,3578747148,0
2,1257,34191,3578747148,3578747150,2
2,1257,34192,3578747148,3578747151,3
2,1257,34193,3578747148,3578747152,4
2,1257,34194,3578747148,3578747153,5
2,1257,34195,3578747148,3578747155,7
2,1257,34196,3578747148,3578747155,7
2,1257,34197,3578747148,3578747155,7
2,1257,34198,3578747148,3578747155,7
2,1257,34199,3578747148,3578747157,9
2,1257,34200,3578747148,3578747157,9
2,1257,34201,3578747148,3578747161,13
2,1257,34202,3578747148,3578747161,13
2,1257,34203,3578747148,3578747162,14
2,1257,34204,3578747148,3578747162,14
2,1257,34205,3578747148,3578747163,15
2,1257,34206,3578747148,3578747163,15
2,1257,34207,3578747148,3578747164,16
2,1257,34208,3578747148,3578747164,16
2,1257,34209,3578747148,3578747165,17
2,1257,34210,3578747148,3578747166,18
2,1257,34211,3578747148,3578747167,19
2,1257,34212,3578747148,3578747168,20
2,1257,34213,3578747148,3578747168,20
2,1257,34214,3578747148,3578747168,20
2,1257,34215,3578747148,3578747172,24
2,1257,34216,3578747148,3578747173,25
2,1257,34217,3578747148,3578747174,26
2,1257,34218,3578747148,3578747175,27
2,1257,34219,3578747148,3578747176,28
2,1257,34220,3578747148,3578747176,28
2,1257,34221,3578747148,3578747177,29
2,1257,34222,3578747148,3578747177,29
2,1257,34223,3578747148,3578747178,30
2,1257,34224,3578747148,3578747178,30
2,1257,34225,3578747148,3578747179,31
2,1257,34226,3578747148,3578747179,31
2,1257,34227,3578747148,3578747180,32
2,1257,34228,3578747148,3578747180,32
2,1257,34229,3578747148,3578747181,33
2,1257,34230,3578747148,3578747182,34
2,1257,34231,3578747148,3578747183,35
2,1257,34232,3578747148,3578747183,35
2,1257,34233,3578747148,3578747184,36
2,1257,34234,3578747148,3578747185,37
2,1257,34235,3578747148,3578747185,37
2,1257,34236,3578747148,3578747189,41
2,1257,34237,3578747148,3578747190,42
2,1257,34238,3578747148,3578747190,42
2,1257,34239,3578747148,3578747191,43
2,1257,34240,3578747148,3578747192,44
2,1257,34241,3578747148,3578747193,45
2,1257,34242,3578747148,3578747194,46
2,1257,34243,3578747148,3578747194,46
2,1257,34244,3578747148,3578747194,46
2,1257,34245,3578747148,3578747198,50
2,1258,34246,3578747210,3578747210,0
2,1258,34247,3578747210,3578747210,0
2,1258,34248,3578747210,3578747210,0
2,1258,34249,3578747210,3578747210,0
2,1258,34250,3578747210,3578747210,0
2,1258,34251,3578747210,3578747210,0
2,1258,34252,3578747210,3578747211,1
2,1258,34253,3578747210,3578747211,1
2,1258,34254,3578747210,3578747213,3
2,1258,34255,3578747210,3578747213,3
2,1258,34256,3578747210,3578747214,4
2,1258,34257,3578747210,3578747214,4
2,1258,34258,3578747210,3578747215,5
2,1258,34259,3578747210,3578747215,5
2,1258,34260,3578747210,3578747217,7
2,1258,34261,3578747210,3578747217,7
2,1258,34262,3578747210,3578747217,7
2,1258,34263,3578747210,3578747219,9
2,1258,34264,3578747210,3578747220,10
2,1258,34265,3578747210,3578747220,10
2,1258,34266,3578747210,3578747222,12
2,1258,34267,3578747210,3578747222,12
2,1258,34268,3578747210,3578747222,12
2,1258,34269,3578747210,3578747222,12
2,1258,34270,3578747210,3578747224,14
2,1258,34271,3578747210,3578747224,14
2,1258,34272,3578747210,3578747224,14
2,1258,34273,3578747210,3578747226,16
2,1258,34274,3578747210,3578747227,17
2,1258,34275,3578747210,3578747227,17
2,1258,34276,3578747210,3578747228,18
2,1258,34277,3578747210,3578747228,18
2,1258,34278,3578747210,3578747229,19
2,1258,34279,3578747210,3578747231,21
2,1258,34280,3578747210,3578747231,21
2,1258,34281,3578747210,3578747232,22
2,1258,34282,3578747210,3578747232,22
2,1258,34283,3578747210,3578747233,23
2,1258,34284,3578747210,3578747236,26
2,1258,34285,3578747210,3578747237,27
2,1258,34286,3578747210,3578747237,27
2,1258,34287,3578747210,3578747237,27
2,1258,34288,3578747210,3578747237,27
2,1258,34289,3578747210,3578747237,27
2,1258,34290,3578747210,3578747238,28
2,1258,34291,3578747210,3578747239,29
2,1258,34292,3578747210,3578747239,29
2,1258,34293,3578747210,3578747240,30
2,1258,34294,3578747210,3578747240,30
2,1258,34295,3578747210,3578747240,30
2,1258,34296,3578747210,3578747241,31
2,1258,34297,3578747210,3578747242,32
2,1258,34298,3578747210,3578747244,34
2,1258,34299,3578747210,3578747245,35
2,1258,34300,3578747210,3578747246,36
2,1258,34301,3578747210,3578747246,36
2,1258,34302,3578747210,3578747247,37
2,1258,34303,3578747210,3578747247,37
2,1258,34304,3578747210,3578747250,40
2,1258,34305,3578747210,3578747251,41
2,1258,34306,3578747210,3578747252,42
2,1258,34307,3578747210,3578747252,42
2,1258,34308,3578747210,3578747253,43
2,1258,34309,3578747210,3578747253,43
2,1258,34310,3578747210,3578747254,44
2,1258,34311,3578747210,3578747254,44
2,1258,34312,3578747210,3578747254,44
2,1258,34313,3578747210,3578747255,45
2,1258,34314,3578747210,3578747255,45
2,1258,34315,3578747210,3578747256,46
2,1258,34316,3578747210,3578747256,46
2,1258,34317,3578747210,3578747257,47
2,1258,34318,3578747210,3578747258,48
2,1258,34319,3578747210,3578747259,49
2,1258,34320,3578747210,3578747259,49
2,1258,34321,3578747210,3578747260,50
2,1259,34322,3578747272,3578747272,0
2,1259,34323,3578747272,3578747272,0
2,1259,34324,3578747272,3578747272,0
2,1259,34325,3578747272,3578747272,0
2,1259,34326,3578747272,3578747272,0
2,1259,34327,3578747272,3578747272,0
2,1259,34328,3578747272,3578747272,0
2,1259,34329,3578747272,3578747272,0
2,1259,34330,3578747272,3578747272,0
2,1259,34331,3578747272,3578747273,1
2,1259,34332,3578747272,3578747274,2
2,1259,34333,3578747272,3578747277,5
2,1259,34334,3578747272,3578747277,5
2,1259,34335,3578747272,3578747278,6
2,1259,34336,3578747272,3578747279,7
2,1259,34337,3578747272,3578747279,7
2,1259,34338,3578747272,3578747281,9
2,1259,34339,3578747272,3578747282,10
2,1259,34340,3578747272,3578747282,10
2,1259,34341,3578747272,3578747283,11
2,1259,34342,3578747272,3578747283,11
2,1259,34343,3578747272,3578747283,11
2,1259,34344,3578747272,3578747285,13
2,1259,34345,3578747272,3578747286,14
2,1259,34346,3578747272,3578747287,15
2,1259,34347,3578747272,3578747288,16
2,1259,34348,3578747272,3578747288,16
2,1259,34349,3578747272,3578747289,17
2,1259,34350,3578747272,3578747289,17
2,1259,34351,3578747272,3578747290,18
2,1259,34352,3578747272,3578747291,19
2,1259,34353,3578747272,3578747291,19
2,1259,34354,3578747272,3578747291,19
2,1259,34355,3578747272,3578747293,21
2,1259,34356,3578747272,3578747294,22
2,1259,34357,3578747272,3578747294,22
2,1259,34358,3578747272,3578747295,23
2,1259,34359,3578747272,3578747295,23
2,1259,34360,3578747272,3578747296,24
2,1259,34361,3578747272,3578747296,24
2,1259,34362,3578747272,3578747296,24
2,1259,34363,3578747272,3578747296,24
2,1259,34364,3578747272,3578747297,25
2,1259,34365,3578747272,3578747298,26
2,1259,34366,3578747272,3578747299,27
2,1259,34367,3578747272,3578747299,27
2,1259,34368,3578747272,3578747299,27
2,1259,34369,3578747272,3578747299,27
2,1259,34370,3578747272,3578747302,30
2,1259,34371,3578747272,3578747303,31
2,1259,34372,3578747272,3578747304,32
2,1259,34373,3578747272,3578747307,35
2,1259,34374,3578747272,3578747308,36
2,1259,34375,3578747272,3578747308,36
2,1259,34376,3578747272,3578747311,39
2,1259,34377,3578747272,3578747311,39
2,1259,34378,3578747272,3578747312,40
2,1259,34379,3578747272,3578747313,41
2,1259,34380,3578747272,3578747313,41
2,1259,34381,3578747272,3578747314,42
2,1259,34382,3578747272,3578747314,42
2,1259,34383,3578747272,3578747315,43
2,1259,34384,3578747272,3578747315,43
2,1259,34385,3578747272,3578747316,44
2,1259,34386,3578747272,3578747317,45
2,1259,34387,3578747272,3578747318,46
2,1259,34388,3578747272,3578747318,46
2,1259,34389,3578747272,3578747319,47
2,1259,34390,3578747272,3578747321,49
2,1259,34391,3578747272,3578747321,49
2,1259,34392,3578747272,3578747321,49
2,1259,34393,3578747272,3578747322,50
2,1260,34394,3578747334,3578747334,0
2,1260,34395,3578747334,3578747334,0
2,1260,34396,3578747334,3578747334,0
2,1260,34397,3578747334,3578747334,0
2,1260,34398,3578747334,3578747334,0
2,1260,34399,3578747334,3578747334,0
2,1260,34400,3578747334,3578747334,0
2,1260,34401,3578747334,3578747334,0
2,1260,34402,3578747334,3578747334,0
2,1260,34403,3578747334,3578747334,0
2,1260,34404,3578747334,3578747334,0
2,1260,34405,3578747334,3578747334,0
2,1260,34406,3578747334,3578747334,0
2,1260,34407,3578747334,3578747334,0
2,1260,34408,3578747334,3578747334,0
2,1260,34409,3578747334,3578747334,0
2,1260,34410,3578747334,3578747334,0
2,1260,34411,3578747334,3578747334,0
2,1260,34412,3578747334,3578747334,0
2,1260,34413,3578747334,3578747336,2
2,1260,34414,3578747334,3578747337,3
2,1260,34415,3578747334,3578747338,4
2,1260,34416,3578747334,3578747338,4
2,1260,34417,3578747334,3578747340,6
2,1260,34418,3578747334,3578747341,7
2,1260,34419,3578747334,3578747341,7
2,1260,34420,3578747334,3578747341,7
2,1260,34421,3578747334,3578747342,8
2,1260,34422,3578747334,3578747343,9
2,1260,34423,3578747334,3578747343,9
2,1260,34424,3578747334,3578747344,10
2,1260,34425,3578747334,3578747344,10
2,1260,34426,3578747334,3578747348,14
2,1260,34427,3578747334,3578747349,15
2,1260,34428,3578747334,3578747350,16
2,1260,34429,3578747334,3578747351,17
2,1260,34430,3578747334,3578747352,18
2,1260,34431,3578747334,3578747354,20
2,1260,34432,3578747334,3578747354,20
2,1260,34433,3578747334,3578747356,22
2,1260,34434,3578747334,3578747356,22
2,1260,34435,3578747334,3578747357,23
2,1260,34436,3578747334,3578747357,23
2,1260,34437,3578747334,3578747357,23
2,1260,34438,3578747334,3578747360,26
2,1260,34439,3578747334,3578747361,27
2,1260,34440,3578747334,3578747362,28
2,1260,34441,3578747334,3578747362,28
2,1260,34442,3578747334,3578747363,29
2,1260,34443,3578747334,3578747363,29
2,1260,34444,3578747334,3578747364,30
2,1260,34445,3578747334,3578747365,31
2,1260,34446,3578747334,3578747366,32
2,1260,34447,3578747334,3578747366,32
2,1260,34448,3578747334,3578747367,33
2,1260,34449,3578747334,3578747367,33
2,1260,34450,3578747334,3578747368,34
2,1260,34451,3578747334,3578747369,35
2,1260,34452,3578747334,3578747372,38
2,1260,34453,3578747334,3578747372,38
2,1260,34454,3578747334,3578747374,40
2,1260,34455,3578747334,3578747374,40
2,1260,34456,3578747334,3578747376,42
2,1260,34457,3578747334,3578747376,42
2,1260,34458,3578747334,3578747376,42
2,1260,34459,3578747334,3578747376,42
2,1260,34460,3578747334,3578747378,44
2,1260,34461,3578747334,3578747378,44
2,1260,34462,3578747334,3578747379,45
2,1260,34463,3578747334,3578747379,45
2,1260,34464,3578747334,3578747380,46
2,1260,34465,3578747334,3578747380,46
2,1260,34466,3578747334,3578747382,48
2,1260,34467,3578747334,3578747382,48
2,1260,34468,3578747334,3578747383,49
2,1260,34469,3578747334,3578747383,49
2,1260,34470,3578747334,3578747383,49
2,1261,34471,3578747396,3578747396,0
2,1261,34472,3578747396,3578747396,0
2,1261,34473,3578747396,3578747396,0
2,1261,34474,3578747396,3578747396,0
2,1261,34475,3578747396,3578747396,0
2,1261,34476,3578747396,3578747396,0
2,1261,34477,3578747396,3578747396,0
2,1261,34478,3578747396,3578747396,0
2,1261,34479,3578747396,3578747396,0
2,1261,34480,3578747396,3578747396,0
2,1261,34481,3578747396,3578747396,0
2,1261,34482,3578747396,3578747396,0
2,1261,34483,3578747396,3578747396,0
2,1261,34484,3578747396,3578747398,2
2,1261,34485,3578747396,3578747400,4
2,1261,34486,3578747396,3578747400,4
2,1261,34487,3578747396,3578747403,7
2,1261,34488,3578747396,3578747405,9
2,1261,34489,3578747396,3578747405,9
2,1261,34490,3578747396,3578747410,14
2,1261,34491,3578747396,3578747411,15
2,1261,34492,3578747396,3578747413,17
2,1261,34493,3578747396,3578747413,17
2,1261,34494,3578747396,3578747414,18
2,1261,34495,3578747396,3578747414,18
2,1261,34496,3578747396,3578747414,18
2,1261,34497,3578747396,3578747416,20
2,1261,34498,3578747396,3578747417,21
2,1261,34499,3578747396,3578747417,21
2,1261,34500,3578747396,3578747419,23
2,1261,34501,3578747396,3578747420,24
2,1261,34502,3578747396,3578747420,24
2,1261,34503,3578747396,3578747421,25
2,1261,34504,3578747396,3578747421,25
2,1261,34505,3578747396,3578747422,26
2,1261,34506,3578747396,3578747422,26
2,1261,34507,3578747396,3578747424,28
2,1261,34508,3578747396,3578747424,28
2,1261,34509,3578747396,3578747425,29
2,1261,34510,3578747396,3578747427,31
2,1261,34511,3578747396,3578747427,31
2,1261,34512,3578747396,3578747427,31
2,1261,34513,3578747396,3578747429,33
2,1261,34514,3578747396,3578747430,34
2,1261,34515,3578747396,3578747430,34
2,1261,34516,3578747396,3578747430,34
2,1261,34517,3578747396,3578747431,35
2,1261,34518,3578747396,3578747432,36
2,1261,34519,3578747396,3578747432,36
2,1261,34520,3578747396,3578747433,37
2,1261,34521,3578747396,3578747436,40
2,1261,34522,3578747396,3578747437,41
2,1261,34523,3578747396,3578747437,41
2,1261,34524,3578747396,3578747438,42
2,1261,34525,3578747396,3578747438,42
2,1261,34526,3578747396,3578747438,42
2,1261,34527,3578747396,3578747438,42
2,1261,34528,3578747396,3578747438,42
2,1261,34529,3578747396,3578747439,43
2,1261,34530,3578747396,3578747440,44
2,1261,34531,3578747396,3578747440,44
2,1261,34532,3578747396,3578747440,44
2,1261,34533,3578747396,3578747441,45
2,1261,34534,3578747396,3578747442,46
2,1261,34535,3578747396,3578747442,46
2,1261,34536,3578747396,3578747442,46
2,1261,34537,3578747396,3578747443,47
2,1261,34538,3578747396,3578747445,49
2,1261,34539,3578747396,3578747445,49
2,1261,34540,3578747396,3578747445,49
2,1262,34541,3578747459,3578747459,0
2,1262,34542,3578747459,3578747459,0
2,1262,34543,3578747459,3578747459,0
2,1262,34544,3578747459,3578747459,0
2,1262,34545,3578747459,3578747459,0
2,1262,34546,3578747459,3578747459,0
2,1262,34547,3578747459,3578747459,0
2,1262,34548,3578747459,3578747459,0
2,1262,34549,3578747459,3578747459,0
2,1262,34550,3578747459,3578747459,0
2,1262,34551,3578747459,3578747459,0
2,1262,34552,3578747459,3578747459,0
2,1262,34553,3578747459,3578747459,0
2,1262,34554,3578747459,3578747459,0
2,1262,34555,3578747459,3578747459,0
2,1262,34556,3578747459,3578747459,0
2,1262,34557,3578747459,3578747459,0
2,1262,34558,3578747459,3578747459,0
2,1262,34559,3578747459,3578747459,0
2,1262,34560,3578747459,3578747460,1
2,1262,34561,3578747459,3578747460,1
2,1262,34562,3578747459,3578747461,2
2,1262,34563,3578747459,3578747462,3
2,1262,34564,3578747459,3578747466,7
2,1262,34565,3578747459,3578747466,7
2,1262,34566,3578747459,3578747466,7
2,1262,34567,3578747459,3578747468,9
2,1262,34568,3578747459,3578747468,9
2,1262,34569,3578747459,3578747470,11
2,1262,34570,3578747459,3578747472,13
2,1262,34571,3578747459,3578747474,15
2,1262,34572,3578747459,3578747476,17
2,1262,34573,3578747459,3578747477,18
2,1262,34574,3578747459,3578747478,19
2,1262,34575,3578747459,3578747479,20
2,1262,34576,3578747459,3578747480,21
2,1262,34577,3578747459,3578747481,22
2,1262,34578,3578747459,3578747481,22
2,1262,34579,3578747459,3578747482,23
2,1262,34580,3578747459,3578747482,23
2,1262,34581,3578747459,3578747482,23
2,1262,34582,3578747459,3578747483,24
2,1262,34583,3578747459,3578747483,24
2,1262,34584,3578747459,3578747484,25
2,1262,34585,3578747459,3578747486,27
2,1262,34586,3578747459,3578747486,27
2,1262,34587,3578747459,3578747487,28
2,1262,34588,3578747459,3578747488,29
2,1262,34589,3578747459,3578747489,30
2,1262,34590,3578747459,3578747490,31
2,1262,34591,3578747459,3578747490,31
2,1262,34592,3578747459,3578747491,32
2,1262,34593,3578747459,3578747491,32
2,1262,34594,3578747459,3578747492,33
2,1262,34595,3578747459,3578747494,35
2,1262,34596,3578747459,3578747494,35
2,1262,34597,3578747459,3578747494,35
2,1262,34598,3578747459,3578747494,35
2,1262,34599,3578747459,3578747495,36
2,1262,34600,3578747459,3578747496,37
2,1262,34601,3578747459,3578747496,37
2,1262,34602,3578747459,3578747496,37
2,1262,34603,3578747459,3578747497,38
2,1262,34604,3578747459,3578747498,39
2,1262,34605,3578747459,3578747499,40
2,1262,34606,3578747459,3578747500,41
2,1262,34607,3578747459,3578747500,41
2,1262,34608,3578747459,3578747501,42
2,1262,34609,3578747459,3578747502,43
2,1262,34610,3578747459,3578747502,43
2,1262,34611,3578747459,3578747505,46
2,1262,34612,3578747459,3578747507,48
2,1262,34613,3578747459,3578747508,49
2,1262,34614,3578747459,3578747509,50
2,1263,34615,3578747523,3578747523,0
2,1263,34616,3578747523,3578747523,0
2,1263,34617,3578747523,3578747523,0
2,1263,34618,3578747523,3578747523,0
2,1263,34619,3578747523,3578747523,0
2,1263,34620,3578747523,3578747523,0
2,1263,34621,3578747523,3578747523,0
2,1263,34622,3578747523,3578747523,0
2,1263,34623,3578747523,3578747523,0
2,1263,34624,3578747523,3578747523,0
2,1263,34625,3578747523,3578747523,0
2,1263,34626,3578747523,3578747523,0
2,1263,34627,3578747523,3578747523,0
2,1263,34628,3578747523,3578747523,0
2,1263,34629,3578747523,3578747523,0
2,1263,34630,3578747523,3578747523,0
2,1263,34631,3578747523,3578747523,0
2,1263,34632,3578747523,3578747523,0
2,1263,34633,3578747523,3578747523,0
2,1263,34634,3578747523,3578747523,0
2,1263,34635,3578747523,3578747523,0
2,1263,34636,3578747523,3578747523,0
2,1263,34637,3578747523,3578747523,0
2,1263,34638,3578747523,3578747523,0
2,1263,34639,3578747523,3578747523,0
2,1263,34640,3578747523,3578747524,1
2,1263,34641,3578747523,3578747524,1
2,1263,34642,3578747523,3578747525,2
2,1263,34643,3578747523,3578747527,4
2,1263,34644,3578747523,3578747528,5
2,1263,34645,3578747523,3578747529,6
2,1263,34646,3578747523,3578747529,6
2,1263,34647,3578747523,3578747531,8
2,1263,34648,3578747523,3578747532,9
2,1263,34649,3578747523,3578747532,9
2,1263,34650,3578747523,3578747533,10
2,1263,34651,3578747523,3578747534,11
2,1263,34652,3578747523,3578747535,12
2,1263,34653,3578747523,3578747537,14
2,1263,34654,3578747523,3578747537,14
2,1263,34655,3578747523,3578747538,15
2,1263,34656,3578747523,3578747540,17
2,1263,34657,3578747523,3578747540,17
2,1263,34658,3578747523,3578747540,17
2,1263,34659,3578747523,3578747542,19
2,1263,34660,3578747523,3578747543,20
2,1263,34661,3578747523,3578747543,20
2,1263,34662,3578747523,3578747543,20
2,1263,34663,3578747523,3578747547,24
2,1263,34664,3578747523,3578747547,24
2,1263,34665,3578747523,3578747549,26
2,1263,34666,3578747523,3578747550,27
2,1263,34667,3578747523,3578747551,28
2,1263,34668,3578747523,3578747553,30
2,1263,34669,3578747523,3578747553,30
2,1263,34670,3578747523,3578747554,31
2,1263,34671,3578747523,3578747555,32
2,1263,34672,3578747523,3578747555,32
2,1263,34673,3578747523,3578747556,33
2,1263,34674,3578747523,3578747556,33
2,1263,34675,3578747523,3578747560,37
2,1263,34676,3578747523,3578747561,38
2,1263,34677,3578747523,3578747561,38
2,1263,34678,3578747523,3578747562,39
2,1263,34679,3578747523,3578747562,39
2,1263,34680,3578747523,3578747563,40
2,1263,34681,3578747523,3578747564,41
2,1263,34682,3578747523,3578747565,42
2,1263,34683,3578747523,3578747565,42
2,1263,34684,3578747523,3578747566,43
2,1263,34685,3578747523,3578747567,44
2,1263,34686,3578747523,3578747567,44
2,1263,34687,3578747523,3578747568,45
2,1263,34688,3578747523,3578747569,46
2,1263,34689,3578747523,3578747571,48
2,1263,34690,3578747523,3578747571,48
2,1263,34691,3578747523,3578747573,50
2,1264,34692,3578747585,3578747585,0
2,1264,34693,3578747585,3578747585,0
2,1264,34694,3578747585,3578747585,0
2,1264,34695,3578747585,3578747585,0
2,1264,34696,3578747585,3578747585,0
2,1264,34697,3578747585,3578747585,0
2,1264,34698,3578747585,3578747585,0
2,1264,34699,3578747585,3578747585,0
2,1264,34700,3578747585,3578747585,0
2,1264,34701,3578747585,3578747585,0
2,1264,34702,3578747585,3578747585,0
2,1264,34703,3578747585,3578747585,0
2,1264,34704,3578747585,3578747585,0
2,1264,34705,3578747585,3578747585,0
2,1264,34706,3578747585,3578747585,0
2,1264,34707,3578747585,3578747585,0
2,1264,34708,3578747585,3578747585,0
2,1264,34709,3578747585,3578747585,0
2,1264,34710,3578747585,3578747585,0
2,1264,34711,3578747585,3578747588,3
2,1264,34712,3578747585,3578747588,3
2,1264,34713,3578747585,3578747590,5
2,1264,34714,3578747585,3578747591,6
2,1264,34715,3578747585,3578747592,7
2,1264,34716,3578747585,3578747593,8
2,1264,34717,3578747585,3578747593,8
2,1264,34718,3578747585,3578747594,9
2,1264,34719,3578747585,3578747594,9
2,1264,34720,3578747585,3578747597,12
2,1264,34721,3578747585,3578747599,14
2,1264,34722,3578747585,3578747600,15
2,1264,34723,3578747585,3578747602,17
2,1264,34724,3578747585,3578747604,19
2,1264,34725,3578747585,3578747605,20
2,1264,34726,3578747585,3578747610,25
2,1264,34727,3578747585,3578747610,25
2,1264,34728,3578747585,3578747612,27
2,1264,34729,3578747585,3578747612,27
2,1264,34730,3578747585,3578747612,27
2,1264,34731,3578747585,3578747613,28
2,1264,34732,3578747585,3578747613,28
2,1264,34733,3578747585,3578747615,30
2,1264,34734,3578747585,3578747616,31
2,1264,34735,3578747585,3578747616,31
2,1264,34736,3578747585,3578747618,33
2,1264,34737,3578747585,3578747618,33
2,1264,34738,3578747585,3578747620,35
2,1264,34739,3578747585,3578747620,35
2,1264,34740,3578747585,3578747621,36
2,1264,34741,3578747585,3578747621,36
2,1264,34742,3578747585,3578747623,38
2,1264,34743,3578747585,3578747623,38
2,1264,34744,3578747585,3578747624,39
2,1264,34745,3578747585,3578747626,41
2,1264,34746,3578747585,3578747626,41
2,1264,34747,3578747585,3578747626,41
2,1264,34748,3578747585,3578747627,42
2,1264,34749,3578747585,3578747628,43
2,1264,34750,3578747585,3578747628,43
2,1264,34751,3578747585,3578747630,45
2,1264,34752,3578747585,3578747630,45
2,1264,34753,3578747585,3578747631,46
2,1264,34754,3578747585,3578747631,46
2,1264,34755,3578747585,3578747631,46
2,1264,34756,3578747585,3578747632,47
2,1265,34757,3578747646,3578747646,0
2,1265,34758,3578747646,3578747646,0
2,1265,34759,3578747646,3578747646,0
2,1265,34760,3578747646,3578747646,0
2,1265,34761,3578747646,3578747646,0
2,1265,34762,3578747646,3578747646,0
2,1265,34763,3578747646,3578747646,0
2,1265,34764,3578747646,3578747646,0
2,1265,34765,3578747646,3578747646,0
2,1265,34766,3578747646,3578747646,0
2,1265,34767,3578747646,3578747646,0
2,1265,34768,3578747646,3578747646,0
2,1265,34769,3578747646,3578747646,0
2,1265,34770,3578747646,3578747646,0
2,1265,34771,3578747646,3578747646,0
2,1265,34772,3578747646,3578747646,0
2,1265,34773,3578747646,3578747646,0
2,1265,34774,3578747646,3578747646,0
2,1265,34775,3578747646,3578747646,0
2,1265,34776,3578747646,3578747646,0
2,1265,34777,3578747646,3578747646,0
2,1265,34778,3578747646,3578747646,0
2,1265,34779,3578747646,3578747647,1
2,1265,34780,3578747646,3578747650,4
2,1265,34781,3578747646,3578747650,4
2,1265,34782,3578747646,3578747650,4
2,1265,34783,3578747646,3578747652,6
2,1265,34784,3578747646,3578747652,6
2,1265,34785,3578747646,3578747652,6
2,1265,34786,3578747646,3578747653,7
2,1265,34787,3578747646,3578747653,7
2,1265,34788,3578747646,3578747653,7
2,1265,34789,3578747646,3578747654,8
2,1265,34790,3578747646,3578747655,9
2,1265,34791,3578747646,3578747656,10
2,1265,34792,3578747646,3578747656,10
2,1265,34793,3578747646,3578747656,10
2,1265,34794,3578747646,3578747657,11
2,1265,34795,3578747646,3578747658,12
2,1265,34796,3578747646,3578747658,12
2,1265,34797,3578747646,3578747660,14
2,1265,34798,3578747646,3578747660,14
2,1265,34799,3578747646,3578747661,15
2,1265,34800,3578747646,3578747665,19
2,1265,34801,3578747646,3578747667,21
2,1265,34802,3578747646,3578747667,21
2,1265,34803,3578747646,3578747669,23
2,1265,34804,3578747646,3578747669,23
2,1265,34805,3578747646,3578747672,26
2,1265,34806,3578747646,3578747676,30
2,1265,34807,3578747646,3578747677,31
2,1265,34808,3578747646,3578747679,33
2,1265,34809,3578747646,3578747679,33
2,1265,34810,3578747646,3578747680,34
2,1265,34811,3578747646,3578747682,36
2,1265,34812,3578747646,3578747682,36
2,1265,34813,3578747646,3578747682,36
2,1265,34814,3578747646,3578747682,36
2,1265,34815,3578747646,3578747682,36
2,1265,34816,3578747646,3578747683,37
2,1265,34817,3578747646,3578747684,38
2,1265,34818,3578747646,3578747685,39
2,1265,34819,3578747646,3578747686,40
2,1265,34820,3578747646,3578747687,41
2,1265,34821,3578747646,3578747688,42
2,1265,34822,3578747646,3578747688,42
2,1265,34823,3578747646,3578747689,43
2,1265,34824,3578747646,3578747689,43
2,1265,34825,3578747646,3578747689,43
2,1265,34826,3578747646,3578747692,46
2,1265,34827,3578747646,3578747692,46
2,1265,34828,3578747646,3578747693,47
2,1265,34829,3578747646,3578747694,48
2,1265,34830,3578747646,3578747694,48
2,1265,34831,3578747646,3578747694,48
2,1265,34832,3578747646,3578747695,49
2,1265,34833,3578747646,3578747695,49
2,1265,34834,3578747646,3578747696,50
2,1266,34835,3578747710,3578747710,0
2,1266,34836,3578747710,3578747710,0
2,1266,34837,3578747710,3578747710,0
2,1266,34838,3578747710,3578747710,0
2,1266,34839,3578747710,3578747710,0
2,1266,34840,3578747710,3578747710,0
2,1266,34841,3578747710,3578747710,0
2,1266,34842,3578747710,3578747710,0
2,1266,34843,3578747710,3578747710,0
2,1266,34844,3578747710,3578747710,0
2,1266,34845,3578747710,3578747710,0
2,1266,34846,3578747710,3578747710,0
2,1266,34847,3578747710,3578747710,0
2,1266,34848,3578747710,3578747711,1
2,1266,34849,3578747710,3578747711,1
2,1266,34850,3578747710,3578747712,2
2,1266,34851,3578747710,3578747712,2
2,1266,34852,3578747710,3578747712,2
2,1266,34853,3578747710,3578747713,3
2,1266,34854,3578747710,3578747714,4
2,1266,34855,3578747710,3578747715,5
2,1266,34856,3578747710,3578747715,5
2,1266,34857,3578747710,3578747715,5
2,1266,34858,3578747710,3578747715,5
2,1266,34859,3578747710,3578747716,6
2,1266,34860,3578747710,3578747717,7
2,1266,34861,3578747710,3578747717,7
2,1266,34862,3578747710,3578747717,7
2,1266,34863,3578747710,3578747718,8
2,1266,34864,3578747710,3578747719,9
2,1266,34865,3578747710,3578747720,10
2,1266,34866,3578747710,3578747720,10
2,1266,34867,3578747710,3578747721,11
2,1266,34868,3578747710,3578747721,11
2,1266,34869,3578747710,3578747721,11
2,1266,34870,3578747710,3578747722,12
2,1266,34871,3578747710,3578747723,13
2,1266,34872,3578747710,3578747723,13
2,1266,34873,3578747710,3578747723,13
2,1266,34874,3578747710,3578747725,15
2,1266,34875,3578747710,3578747726,16
2,1266,34876,3578747710,3578747726,16
2,1266,34877,3578747710,3578747727,17
2,1266,34878,3578747710,3578747728,18
2,1266,34879,3578747710,3578747730,20
2,1266,34880,3578747710,3578747732,22
2,1266,34881,3578747710,3578747732,22
2,1266,34882,3578747710,3578747732,22
2,1266,34883,3578747710,3578747733,23
2,1266,34884,3578747710,3578747735,25
2,1266,34885,3578747710,3578747735,25
2,1266,34886,3578747710,3578747736,26
2,1266,34887,3578747710,3578747736,26
2,1266,34888,3578747710,3578747736,26
2,1266,34889,3578747710,3578747739,29
2,1266,34890,3578747710,3578747740,30
2,1266,34891,3578747710,3578747740,30
2,1266,34892,3578747710,3578747740,30
2,1266,34893,3578747710,3578747741,31
2,1266,34894,3578747710,3578747742,32
2,1266,34895,3578747710,3578747743,33
2,1266,34896,3578747710,3578747743,33
2,1266,34897,3578747710,3578747744,34
2,1266,34898,3578747710,3578747744,34
2,1266,34899,3578747710,3578747748,38
2,1266,34900,3578747710,3578747748,38
2,1266,34901,3578747710,3578747749,39
2,1266,34902,3578747710,3578747750,40
2,1266,34903,3578747710,3578747752,42
2,1266,34904,3578747710,3578747753,43
2,1266,34905,3578747710,3578747754,44
2,1266,34906,3578747710,3578747754,44
2,1266,34907,3578747710,3578747756,46
2,1266,34908,3578747710,3578747756,46
2,1266,34909,3578747710,3578747756,46
2,1266,34910,3578747710,3578747756,46
2,1266,34911,3578747710,3578747760,50
2,1267,34912,3578747772,3578747772,0
2,1267,34913,3578747772,3578747772,0
2,1267,34914,3578747772,3578747772,0
2,1267,34915,3578747772,3578747772,0
2,1267,34916,3578747772,3578747772,0
2,1267,34917,3578747772,3578747772,0
2,1267,34918,3578747772,3578747772,0
2,1267,34919,3578747772,3578747772,0
2,1267,34920,3578747772,3578747772,0
2,1267,34921,3578747772,3578747772,0
2,1267,34922,3578747772,3578747772,0
2,1267,34923,3578747772,3578747772,0
2,1267,34924,3578747772,3578747772,0
2,1267,34925,3578747772,3578747772,0
2,1267,34926,3578747772,3578747772,0
2,1267,34927,3578747772,3578747772,0
2,1267,34928,3578747772,3578747773,1
2,1267,34929,3578747772,3578747773,1
2,1267,34930,3578747772,3578747775,3
2,1267,34931,3578747772,3578747775,3
2,1267,34932,3578747772,3578747776,4
2,1267,34933,3578747772,3578747776,4
2,1267,34934,3578747772,3578747777,5
2,1267,34935,3578747772,3578747777,5
2,1267,34936,3578747772,3578747778,6
2,1267,34937,3578747772,3578747778,6
2,1267,34938,3578747772,3578747779,7
2,1267,34939,3578747772,3578747781,9
2,1267,34940,3578747772,3578747781,9
2,1267,34941,3578747772,3578747781,9
2,1267,34942,3578747772,3578747782,10
2,1267,34943,3578747772,3578747782,10
2,1267,34944,3578747772,3578747784,12
2,1267,34945,3578747772,3578747784,12
2,1267,34946,3578747772,3578747788,16
2,1267,34947,3578747772,3578747788,16
2,1267,34948,3578747772,3578747790,18
2,1267,34949,3578747772,3578747790,18
2,1267,34950,3578747772,3578747791,19
2,1267,34951,3578747772,3578747793,21
2,1267,34952,3578747772,3578747793,21
2,1267,34953,3578747772,3578747793,21
2,1267,34954,3578747772,3578747793,21
2,1267,34955,3578747772,3578747793,21
2,1267,34956,3578747772,3578747794,22
2,1267,34957,3578747772,3578747794,22
2,1267,34958,3578747772,3578747798,26
2,1267,34959,3578747772,3578747799,27
2,1267,34960,3578747772,3578747800,28
2,1267,34961,3578747772,3578747803,31
2,1267,34962,3578747772,3578747803,31
2,1267,34963,3578747772,3578747804,32
2,1267,34964,3578747772,3578747805,33
2,1267,34965,3578747772,3578747809,37
2,1267,34966,3578747772,3578747811,39
2,1267,34967,3578747772,3578747812,40
2,1267,34968,3578747772,3578747813,41
2,1267,34969,3578747772,3578747813,41
2,1267,34970,3578747772,3578747813,41
2,1267,34971,3578747772,3578747815,43
2,1267,34972,3578747772,3578747816,44
2,1267,34973,3578747772,3578747817,45
2,1267,34974,3578747772,3578747818,46
2,1267,34975,3578747772,3578747818,46
2,1267,34976,3578747772,3578747818,46
2,1267,34977,3578747772,3578747820,48
2,1267,34978,3578747772,3578747821,49
2,1267,34979,3578747772,3578747821,49
2,1268,34980,3578747834,3578747834,0
2,1268,34981,3578747834,3578747834,0
2,1268,34982,3578747834,3578747834,0
2,1268,34983,3578747834,3578747834,0
2,1268,34984,3578747834,3578747834,0
2,1268,34985,3578747834,3578747834,0
2,1268,34986,3578747834,3578747834,0
2,1268,34987,3578747834,3578747834,0
2,1268,34988,3578747834,3578747834,0
2,1268,34989,3578747834,3578747834,0
2,1268,34990,3578747834,3578747834,0
2,1268,34991,3578747834,3578747834,0
2,1268,34992,3578747834,3578747834,0
2,1268,34993,3578747834,3578747834,0
2,1268,34994,3578747834,3578747834,0
2,1268,34995,3578747834,3578747834,0
2,1268,34996,3578747834,3578747834,0
2,1268,34997,3578747834,3578747835,1
2,1268,34998,3578747834,3578747836,2
2,1268,34999,3578747834,3578747837,3
2,1268,35000,3578747834,3578747837,3
2,1268,35001,3578747834,3578747837,3
2,1268,35002,3578747834,3578747837,3
2,1268,35003,3578747834,3578747837,3
2,1268,35004,3578747834,3578747838,4
2,1268,35005,3578747834,3578747838,4
2,1268,35006,3578747834,3578747839,5
2,1268,35007,3578747834,3578747839,5
2,1268,35008,3578747834,3578747840,6
2,1268,35009,3578747834,3578747840,6
2,1268,35010,3578747834,3578747842,8
2,1268,35011,3578747834,3578747842,8
2,1268,35012,3578747834,3578747844,10
2,1268,35013,3578747834,3578747845,11
2,1268,35014,3578747834,3578747845,11
2,1268,35015,3578747834,3578747846,12
2,1268,35016,3578747834,3578747846,12
2,1268,35017,3578747834,3578747847,13
2,1268,35018,3578747834,3578747849,15
2,1268,35019,3578747834,3578747850,16
2,1268,35020,3578747834,3578747851,17
2,1268,35021,3578747834,3578747852,18
2,1268,35022,3578747834,3578747853,19
2,1268,35023,3578747834,3578747853,19
2,1268,35024,3578747834,3578747854,20
2,1268,35025,3578747834,3578747854,20
2,1268,35026,3578747834,3578747854,20
2,1268,35027,3578747834,3578747855,21
2,1268,35028,3578747834,3578747856,22
2,1268,35029,3578747834,3578747857,23
2,1268,35030,3578747834,3578747857,23
2,1268,35031,3578747834,3578747859,25
2,1268,35032,3578747834,3578747859,25
2,1268,35033,3578747834,3578747861,27
2,1268,35034,3578747834,3578747861,27
2,1268,35035,3578747834,3578747864,30
2,1268,35036,3578747834,3578747866,32
2,1268,35037,3578747834,3578747866,32
2,1268,35038,3578747834,3578747867,33
2,1268,35039,3578747834,3578747869,35
2,1268,35040,3578747834,3578747869,35
2,1268,35041,3578747834,3578747873,39
2,1268,35042,3578747834,3578747875,41
2,1268,35043,3578747834,3578747876,42
2,1268,35044,3578747834,3578747877,43
2,1268,35045,3578747834,3578747878,44
2,1268,35046,3578747834,3578747879,45
2,1268,35047,3578747834,3578747880,46
2,1268,35048,3578747834,3578747881,47
2,1268,35049,3578747834,3578747882,48
2,1268,35050,3578747834,3578747882,48
2,1268,35051,3578747834,3578747882,48
2,1268,35052,3578747834,3578747882,48
2,1268,35053,3578747834,3578747883,49
2,1268,35054,3578747834,3578747883,49
2,1268,35055,3578747834,3578747884,50
2,1269,35056,3578747896,3578747897,1
2,1269,35057,3578747896,3578747897,1
2,1269,35058,3578747896,3578747897,1
2,1269,35059,3578747896,3578747897,1
2,1269,35060,3578747896,3578747897,1
2,1269,35061,3578747896,3578747897,1
2,1269,35062,3578747896,3578747897,1
2,1269,35063,3578747896,3578747897,1
2,1269,35064,3578747896,3578747897,1
2,1269,35065,3578747896,3578747897,1
2,1269,35066,3578747896,3578747897,1
2,1269,35067,3578747896,3578747897,1
2,1269,35068,3578747896,3578747897,1
2,1269,35069,3578747896,3578747897,1
2,1269,35070,3578747896,3578747897,1
2,1269,35071,3578747896,3578747897,1
2,1269,35072,3578747896,3578747897,1
2,1269,35073,3578747896,3578747897,1
2,1269,35074,3578747896,3578747897,1
2,1269,35075,3578747896,3578747897,1
2,1269,35076,3578747896,3578747898,2
2,1269,35077,3578747896,3578747898,2
2,1269,35078,3578747896,3578747899,3
2,1269,35079,3578747896,3578747899,3
2,1269,35080,3578747896,3578747900,4
2,1269,35081,3578747896,3578747903,7
2,1269,35082,3578747896,3578747907,11
2,1269,35083,3578747896,3578747908,12
2,1269,35084,3578747896,3578747909,13
2,1269,35085,3578747896,3578747911,15
2,1269,35086,3578747896,3578747911,15
2,1269,35087,3578747896,3578747912,16
2,1269,35088,3578747896,3578747913,17
2,1269,35089,3578747896,3578747913,17
2,1269,35090,3578747896,3578747913,17
2,1269,35091,3578747896,3578747914,18
2,1269,35092,3578747896,3578747914,18
2,1269,35093,3578747896,3578747915,19
2,1269,35094,3578747896,3578747915,19
2,1269,35095,3578747896,3578747916,20
2,1269,35096,3578747896,3578747917,21
2,1269,35097,3578747896,3578747917,21
2,1269,35098,3578747896,3578747917,21
2,1269,35099,3578747896,3578747918,22
2,1269,35100,3578747896,3578747918,22
2,1269,35101,3578747896,3578747920,24
2,1269,35102,3578747896,3578747920,24
2,1269,35103,3578747896,3578747921,25
2,1269,35104,3578747896,3578747922,26
2,1269,35105,3578747896,3578747922,26
2,1269,35106,3578747896,3578747922,26
2,1269,35107,3578747896,3578747922,26
2,1269,35108,3578747896,3578747923,27
2,1269,35109,3578747896,3578747924,28
2,1269,35110,3578747896,3578747925,29
2,1269,35111,3578747896,3578747926,30
2,1269,35112,3578747896,3578747926,30
2,1269,35113,3578747896,3578747927,31
2,1269,35114,3578747896,3578747928,32
2,1269,35115,3578747896,3578747929,33
2,1269,35116,3578747896,3578747930,34
2,1269,35117,3578747896,3578747932,36
2,1269,35118,3578747896,3578747933,37
2,1269,35119,3578747896,3578747933,37
2,1269,35120,3578747896,3578747934,38
2,1269,35121,3578747896,3578747935,39
2,1269,35122,3578747896,3578747936,40
2,1269,35123,3578747896,3578747936,40
2,1269,35124,3578747896,3578747937,41
2,1269,35125,3578747896,3578747938,42
2,1269,35126,3578747896,3578747939,43
2,1269,35127,3578747896,3578747939,43
2,1269,35128,3578747896,3578747940,44
2,1269,35129,3578747896,3578747940,44
2,1269,35130,3578747896,3578747941,45
2,1269,35131,3578747896,3578747942,46
2,1269,35132,3578747896,3578747943,47
2,1269,35133,3578747896,3578747943,47
2,1269,35134,3578747896,3578747944,48
2,1270,35135,3578747959,3578747959,0
2,1270,35136,3578747959,3578747959,0
2,1270,35137,3578747959,3578747959,0
2,1270,35138,3578747959,3578747959,0
2,1270,35139,3578747959,3578747959,0
2,1270,35140,3578747959,3578747959,0
2,1270,35141,3578747959,3578747959,0
2,1270,35142,3578747959,3578747959,0
2,1270,35143,3578747959,3578747959,0
2,1270,35144,3578747959,3578747959,0
2,1270,35145,3578747959,3578747959,0
2,1270,35146,3578747959,3578747960,1
2,1270,35147,3578747959,3578747961,2
2,1270,35148,3578747959,3578747961,2
2,1270,35149,3578747959,3578747961,2
2,1270,35150,3578747959,3578747962,3
2,1270,35151,3578747959,3578747963,4
2,1270,35152,3578747959,3578747964,5
2,1270,35153,3578747959,3578747965,6
2,1270,35154,3578747959,3578747965,6
2,1270,35155,3578747959,3578747966,7
2,1270,35156,3578747959,3578747967,8
2,1270,35157,3578747959,3578747967,8
2,1270,35158,3578747959,3578747968,9
2,1270,35159,3578747959,3578747968,9
2,1270,35160,3578747959,3578747969,10
2,1270,35161,3578747959,3578747972,13
2,1270,35162,3578747959,3578747973,14
2,1270,35163,3578747959,3578747973,14
2,1270,35164,3578747959,3578747973,14
2,1270,35165,3578747959,3578747975,16
2,1270,35166,3578747959,3578747975,16
2,1270,35167,3578747959,3578747975,16
2,1270,35168,3578747959,3578747976,17
2,1270,35169,3578747959,3578747977,18
2,1270,35170,3578747959,3578747978,19
2,1270,35171,3578747959,3578747978,19
2,1270,35172,3578747959,3578747979,20
2,1270,35173,3578747959,3578747979,20
2,1270,35174,3578747959,3578747979,20
2,1270,35175,3578747959,3578747979,20
2,1270,35176,3578747959,3578747981,22
2,1270,35177,3578747959,3578747981,22
2,1270,35178,3578747959,3578747981,22
2,1270,35179,3578747959,3578747982,23
2,1270,35180,3578747959,3578747982,23
2,1270,35181,3578747959,3578747984,25
2,1270,35182,3578747959,3578747985,26
2,1270,35183,3578747959,3578747985,26
2,1270,35184,3578747959,3578747988,29
2,1270,35185,3578747959,3578747989,30
2,1270,35186,3578747959,3578747990,31
2,1270,35187,3578747959,3578747991,32
2,1270,35188,3578747959,3578747992,33
2,1270,35189,3578747959,3578747993,34
2,1270,35190,3578747959,3578747993,34
2,1270,35191,3578747959,3578747993,34
2,1270,35192,3578747959,3578747993,34
2,1270,35193,3578747959,3578747994,35
2,1270,35194,3578747959,3578747995,36
2,1270,35195,3578747959,3578747998,39
2,1270,35196,3578747959,3578748000,41
2,1270,35197,3578747959,3578748003,44
2,1270,35198,3578747959,3578748004,45
2,1270,35199,3578747959,3578748004,45
2,1270,35200,3578747959,3578748005,46
2,1270,35201,3578747959,3578748006,47
2,1271,35202,3578748022,3578748022,0
2,1271,35203,3578748022,3578748022,0
2,1271,35204,3578748022,3578748022,0
2,1271,35205,3578748022,3578748022,0
2,1271,35206,3578748022,3578748022,0
2,1271,35207,3578748022,3578748022,0
2,1271,35208,3578748022,3578748022,0
2,1271,35209,3578748022,3578748022,0
2,1271,35210,3578748022,3578748022,0
2,1271,35211,3578748022,3578748022,0
2,1271,35212,3578748022,3578748022,0
2,1271,35213,3578748022,3578748022,0
2,1271,35214,3578748022,3578748022,0
2,1271,35215,3578748022,3578748022,0
2,1271,35216,3578748022,3578748022,0
2,1271,35217,3578748022,3578748022,0
2,1271,35218,3578748022,3578748022,0
2,1271,35219,3578748022,3578748022,0
2,1271,35220,3578748022,3578748024,2
2,1271,35221,3578748022,3578748024,2
2,1271,35222,3578748022,3578748024,2
2,1271,35223,3578748022,3578748026,4
2,1271,35224,3578748022,3578748026,4
2,1271,35225,3578748022,3578748027,5
2,1271,35226,3578748022,3578748028,6
2,1271,35227,3578748022,3578748028,6
2,1271,35228,3578748022,3578748030,8
2,1271,35229,3578748022,3578748030,8
2,1271,35230,3578748022,3578748030,8
2,1271,35231,3578748022,3578748031,9
2,1271,35232,3578748022,3578748032,10
2,1271,35233,3578748022,3578748032,10
2,1271,35234,3578748022,3578748033,11
2,1271,35235,3578748022,3578748036,14
2,1271,35236,3578748022,3578748037,15
2,1271,35237,3578748022,3578748037,15
2,1271,35238,3578748022,3578748037,15
2,1271,35239,3578748022,3578748037,15
2,1271,35240,3578748022,3578748037,15
2,1271,35241,3578748022,3578748037,15
2,1271,35242,3578748022,3578748038,16
2,1271,35243,3578748022,3578748038,16
2,1271,35244,3578748022,3578748039,17
2,1271,35245,3578748022,3578748039,17
2,1271,35246,3578748022,3578748041,19
2,1271,35247,3578748022,3578748041,19
2,1271,35248,3578748022,3578748042,20
2,1271,35249,3578748022,3578748042,20
2,1271,35250,3578748022,3578748042,20
2,1271,35251,3578748022,3578748044,22
2,1271,35252,3578748022,3578748044,22
2,1271,35253,3578748022,3578748046,24
2,1271,35254,3578748022,3578748046,24
2,1271,35255,3578748022,3578748048,26
2,1271,35256,3578748022,3578748050,28
2,1271,35257,3578748022,3578748050,28
2,1271,35258,3578748022,3578748052,30
2,1271,35259,3578748022,3578748052,30
2,1271,35260,3578748022,3578748052,30
2,1271,35261,3578748022,3578748053,31
2,1271,35262,3578748022,3578748053,31
2,1271,35263,3578748022,3578748054,32
2,1271,35264,3578748022,3578748055,33
2,1271,35265,3578748022,3578748055,33
2,1271,35266,3578748022,3578748056,34
2,1271,35267,3578748022,3578748057,35
2,1271,35268,3578748022,3578748058,36
2,1271,35269,3578748022,3578748058,36
2,1271,35270,3578748022,3578748059,37
2,1271,35271,3578748022,3578748060,38
2,1271,35272,3578748022,3578748061,39
2,1271,35273,3578748022,3578748061,39
2,1271,35274,3578748022,3578748064,42
2,1271,35275,3578748022,3578748066,44
2,1271,35276,3578748022,3578748066,44
2,1271,35277,3578748022,3578748068,46
2,1271,35278,3578748022,3578748069,47
2,1271,35279,3578748022,3578748070,48
2,1272,35280,3578748083,3578748083,0
2,1272,35281,3578748083,3578748083,0
2,1272,35282,3578748083,3578748083,0
2,1272,35283,3578748083,3578748083,0
2,1272,35284,3578748083,3578748083,0
2,1272,35285,3578748083,3578748083,0
2,1272,35286,3578748083,3578748083,0
2,1272,35287,3578748083,3578748083,0
2,1272,35288,3578748083,3578748083,0
2,1272,35289,3578748083,3578748083,0
2,1272,35290,3578748083,3578748083,0
2,1272,35291,3578748083,3578748083,0
2,1272,35292,3578748083,3578748083,0
2,1272,35293,3578748083,3578748085,2
2,1272,35294,3578748083,3578748085,2
2,1272,35295,3578748083,3578748086,3
2,1272,35296,3578748083,3578748087,4
2,1272,35297,3578748083,3578748087,4
2,1272,35298,3578748083,3578748088,5
2,1272,35299,3578748083,3578748089,6
2,1272,35300,3578748083,3578748089,6
2,1272,35301,3578748083,3578748090,7
2,1272,35302,3578748083,3578748091,8
2,1272,35303,3578748083,3578748092,9
2,1272,35304,3578748083,3578748093,10
2,1272,35305,3578748083,3578748094,11
2,1272,35306,3578748083,3578748094,11
2,1272,35307,3578748083,3578748095,12
2,1272,35308,3578748083,3578748095,12
2,1272,35309,3578748083,3578748096,13
2,1272,35310,3578748083,3578748096,13
2,1272,35311,3578748083,3578748097,14
2,1272,35312,3578748083,3578748097,14
2,1272,35313,3578748083,3578748098,15
2,1272,35314,3578748083,3578748098,15
2,1272,35315,3578748083,3578748100,17
2,1272,35316,3578748083,3578748100,17
2,1272,35317,3578748083,3578748101,18
2,1272,35318,3578748083,3578748102,19
2,1272,35319,3578748083,3578748107,24
2,1272,35320,3578748083,3578748108,25
2,1272,35321,3578748083,3578748109,26
2,1272,35322,3578748083,3578748110,27
2,1272,35323,3578748083,3578748112,29
2,1272,35324,3578748083,3578748112,29
2,1272,35325,3578748083,3578748112,29
2,1272,35326,3578748083,3578748113,30
2,1272,35327,3578748083,3578748113,30
2,1272,35328,3578748083,3578748114,31
2,1272,35329,3578748083,3578748114,31
2,1272,35330,3578748083,3578748115,32
2,1272,35331,3578748083,3578748115,32
2,1272,35332,3578748083,3578748115,32
2,1272,35333,3578748083,3578748117,34
2,1272,35334,3578748083,3578748117,34
2,1272,35335,3578748083,3578748117,34
2,1272,35336,3578748083,3578748117,34
2,1272,35337,3578748083,3578748118,35
2,1272,35338,3578748083,3578748118,35
2,1272,35339,3578748083,3578748119,36
2,1272,35340,3578748083,3578748120,37
2,1272,35341,3578748083,3578748120,37
2,1272,35342,3578748083,3578748121,38
2,1272,35343,3578748083,3578748122,39
2,1272,35344,3578748083,3578748122,39
2,1272,35345,3578748083,3578748123,40
2,1272,35346,3578748083,3578748123,40
2,1272,35347,3578748083,3578748123,40
2,1272,35348,3578748083,3578748125,42
2,1272,35349,3578748083,3578748126,43
2,1272,35350,3578748083,3578748126,43
2,1272,35351,3578748083,3578748127,44
2,1272,35352,3578748083,3578748127,44
2,1272,35353,3578748083,3578748128,45
2,1272,35354,3578748083,3578748130,47
2,1272,35355,3578748083,3578748130,47
2,1272,35356,3578748083,3578748131,48
2,1272,35357,3578748083,3578748132,49
2,1272,35358,3578748083,3578748133,50
2,1273,35359,3578748146,3578748146,0
2,1273,35360,3578748146,3578748146,0
2,1273,35361,3578748146,3578748146,0
2,1273,35362,3578748146,3578748146,0
2,1273,35363,3578748146,3578748146,0
2,1273,35364,3578748146,3578748146,0
2,1273,35365,3578748146,3578748146,0
2,1273,35366,3578748146,3578748146,0
2,1273,35367,3578748146,3578748146,0
2,1273,35368,3578748146,3578748146,0
2,1273,35369,3578748146,3578748146,0
2,1273,35370,3578748146,3578748146,0
2,1273,35371,3578748146,3578748146,0
2,1273,35372,3578748146,3578748146,0
2,1273,35373,3578748146,3578748146,0
2,1273,35374,3578748146,3578748146,0
2,1273,35375,3578748146,3578748148,2
2,1273,35376,3578748146,3578748150,4
2,1273,35377,3578748146,3578748151,5
2,1273,35378,3578748146,3578748151,5
2,1273,35379,3578748146,3578748151,5
2,1273,35380,3578748146,3578748153,7
2,1273,35381,3578748146,3578748155,9
2,1273,35382,3578748146,3578748155,9
2,1273,35383,3578748146,3578748155,9
2,1273,35384,3578748146,3578748156,10
2,1273,35385,3578748146,3578748156,10
2,1273,35386,3578748146,3578748157,11
2,1273,35387,3578748146,3578748160,14
2,1273,35388,3578748146,3578748161,15
2,1273,35389,3578748146,3578748161,15
2,1273,35390,3578748146,3578748162,16
2,1273,35391,3578748146,3578748162,16
2,1273,35392,3578748146,3578748164,18
2,1273,35393,3578748146,3578748165,19
2,1273,35394,3578748146,3578748165,19
2,1273,35395,3578748146,3578748166,20
2,1273,35396,3578748146,3578748166,20
2,1273,35397,3578748146,3578748168,22
2,1273,35398,3578748146,3578748168,22
2,1273,35399,3578748146,3578748168,22
2,1273,35400,3578748146,3578748172,26
2,1273,35401,3578748146,3578748173,27
2,1273,35402,3578748146,3578748173,27
2,1273,35403,3578748146,3578748174,28
2,1273,35404,3578748146,3578748175,29
2,1273,35405,3578748146,3578748175,29
2,1273,35406,3578748146,3578748175,29
2,1273,35407,3578748146,3578748176,30
2,1273,35408,3578748146,3578748177,31
2,1273,35409,3578748146,3578748178,32
2,1273,35410,3578748146,3578748178,32
2,1273,35411,3578748146,3578748178,32
2,1273,35412,3578748146,3578748179,33
2,1273,35413,3578748146,3578748179,33
2,1273,35414,3578748146,3578748181,35
2,1273,35415,3578748146,3578748181,35
2,1273,35416,3578748146,3578748181,35
2,1273,35417,3578748146,3578748182,36
2,1273,35418,3578748146,3578748183,37
2,1273,35419,3578748146,3578748184,38
2,1273,35420,3578748146,3578748185,39
2,1273,35421,3578748146,3578748185,39
2,1273,35422,3578748146,3578748188,42
2,1273,35423,3578748146,3578748189,43
2,1273,35424,3578748146,3578748191,45
2,1273,35425,3578748146,3578748191,45
2,1273,35426,3578748146,3578748192,46
2,1273,35427,3578748146,3578748193,47
2,1273,35428,3578748146,3578748193,47
2,1273,35429,3578748146,3578748193,47
2,1273,35430,3578748146,3578748194,48
2,1273,35431,3578748146,3578748194,48
2,1273,35432,3578748146,3578748195,49
2,1274,35433,3578748208,3578748208,0
2,1274,35434,3578748208,3578748208,0
2,1274,35435,3578748208,3578748208,0
2,1274,35436,3578748208,3578748208,0
2,1274,35437,3578748208,3578748208,0
2,1274,35438,3578748208,3578748208,0
2,1274,35439,3578748208,3578748211,3
2,1274,35440,3578748208,3578748212,4
2,1274,35441,3578748208,3578748213,5
2,1274,35442,3578748208,3578748214,6
2,1274,35443,3578748208,3578748214,6
2,1274,35444,3578748208,3578748214,6
2,1274,35445,3578748208,3578748215,7
2,1274,35446,3578748208,3578748217,9
2,1274,35447,3578748208,3578748217,9
2,1274,35448,3578748208,3578748218,10
2,1274,35449,3578748208,3578748218,10
2,1274,35450,3578748208,3578748220,12
2,1274,35451,3578748208,3578748220,12
2,1274,35452,3578748208,3578748220,12
2,1274,35453,3578748208,3578748221,13
2,1274,35454,3578748208,3578748221,13
2,1274,35455,3578748208,3578748222,14
2,1274,35456,3578748208,3578748224,16
2,1274,35457,3578748208,3578748224,16
2,1274,35458,3578748208,3578748227,19
2,1274,35459,3578748208,3578748227,19
2,1274,35460,3578748208,3578748227,19
2,1274,35461,3578748208,3578748228,20
2,1274,35462,3578748208,3578748229,21
2,1274,35463,3578748208,3578748229,21
2,1274,35464,3578748208,3578748231,23
2,1274,35465,3578748208,3578748231,23
2,1274,35466,3578748208,3578748231,23
2,1274,35467,3578748208,3578748232,24
2,1274,35468,3578748208,3578748232,24
2,1274,35469,3578748208,3578748233,25
2,1274,35470,3578748208,3578748233,25
2,1274,35471,3578748208,3578748237,29
2,1274,35472,3578748208,3578748237,29
2,1274,35473,3578748208,3578748237,29
2,1274,35474,3578748208,3578748237,29
2,1274,35475,3578748208,3578748238,30
2,1274,35476,3578748208,3578748239,31
2,1274,35477,3578748208,3578748239,31
2,1274,35478,3578748208,3578748239,31
2,1274,35479,3578748208,3578748240,32
2,1274,35480,3578748208,3578748240,32
2,1274,35481,3578748208,3578748241,33
2,1274,35482,3578748208,3578748242,34
2,1274,35483,3578748208,3578748242,34
2,1274,35484,3578748208,3578748242,34
2,1274,35485,3578748208,3578748244,36
2,1274,35486,3578748208,3578748245,37
2,1274,35487,3578748208,3578748245,37
2,1274,35488,3578748208,3578748248,40
2,1274,35489,3578748208,3578748250,42
2,1274,35490,3578748208,3578748251,43
2,1274,35491,3578748208,3578748252,44
2,1274,35492,3578748208,3578748252,44
2,1274,35493,3578748208,3578748253,45
2,1274,35494,3578748208,3578748254,46
2,1274,35495,3578748208,3578748254,46
2,1274,35496,3578748208,3578748255,47
2,1274,35497,3578748208,3578748255,47
2,1274,35498,3578748208,3578748255,47
2,1274,35499,3578748208,3578748256,48
2,1274,35500,3578748208,3578748257,49
2,1275,35501,3578748271,3578748271,0
2,1275,35502,3578748271,3578748271,0
2,1275,35503,3578748271,3578748271,0
2,1275,35504,3578748271,3578748271,0
2,1275,35505,3578748271,3578748271,0
2,1275,35506,3578748271,3578748271,0
2,1275,35507,3578748271,3578748271,0
2,1275,35508,3578748271,3578748271,0
2,1275,35509,3578748271,3578748271,0
2,1275,35510,3578748271,3578748271,0
2,1275,35511,3578748271,3578748271,0
2,1275,35512,3578748271,3578748271,0
2,1275,35513,3578748271,3578748272,1
2,1275,35514,3578748271,3578748275,4
2,1275,35515,3578748271,3578748276,5
2,1275,35516,3578748271,3578748278,7
2,1275,35517,3578748271,3578748280,9
2,1275,35518,3578748271,3578748280,9
2,1275,35519,3578748271,3578748282,11
2,1275,35520,3578748271,3578748282,11
2,1275,35521,3578748271,3578748282,11
2,1275,35522,3578748271,3578748282,11
2,1275,35523,3578748271,3578748283,12
2,1275,35524,3578748271,3578748285,14
2,1275,35525,3578748271,3578748285,14
2,1275,35526,3578748271,3578748285,14
2,1275,35527,3578748271,3578748286,15
2,1275,35528,3578748271,3578748287,16
2,1275,35529,3578748271,3578748288,17
2,1275,35530,3578748271,3578748289,18
2,1275,35531,3578748271,3578748289,18
2,1275,35532,3578748271,3578748290,19
2,1275,35533,3578748271,3578748290,19
2,1275,35534,3578748271,3578748292,21
2,1275,35535,3578748271,3578748293,22
2,1275,35536,3578748271,3578748293,22
2,1275,35537,3578748271,3578748294,23
2,1275,35538,3578748271,3578748294,23
2,1275,35539,3578748271,3578748295,24
2,1275,35540,3578748271,3578748296,25
2,1275,35541,3578748271,3578748297,26
2,1275,35542,3578748271,3578748297,26
2,1275,35543,3578748271,3578748298,27
2,1275,35544,3578748271,3578748298,27
2,1275,35545,3578748271,3578748299,28
2,1275,35546,3578748271,3578748299,28
2,1275,35547,3578748271,3578748299,28
2,1275,35548,3578748271,3578748299,28
2,1275,35549,3578748271,3578748301,30
2,1275,35550,3578748271,3578748302,31
2,1275,35551,3578748271,3578748307,36
2,1275,35552,3578748271,3578748308,37
2,1275,35553,3578748271,3578748311,40
2,1275,35554,3578748271,3578748312,41
2,1275,35555,3578748271,3578748312,41
2,1275,35556,3578748271,3578748312,41
2,1275,35557,3578748271,3578748313,42
2,1275,35558,3578748271,3578748314,43
2,1275,35559,3578748271,3578748315,44
2,1275,35560,3578748271,3578748315,44
2,1275,35561,3578748271,3578748315,44
2,1275,35562,3578748271,3578748316,45
2,1275,35563,3578748271,3578748317,46
2,1275,35564,3578748271,3578748317,46
2,1275,35565,3578748271,3578748317,46
2,1275,35566,3578748271,3578748318,47
2,1275,35567,3578748271,3578748318,47
2,1275,35568,3578748271,3578748318,47
2,1275,35569,3578748271,3578748319,48
2,1275,35570,3578748271,3578748320,49
2,1275,35571,3578748271,3578748320,49
2,1276,35572,3578748334,3578748334,0
2,1276,35573,3578748334,3578748334,0
2,1276,35574,3578748334,3578748334,0
2,1276,35575,3578748334,3578748334,0
2,1276,35576,3578748334,3578748334,0
2,1276,35577,3578748334,3578748334,0
2,1276,35578,3578748334,3578748334,0
2,1276,35579,3578748334,3578748334,0
2,1276,35580,3578748334,3578748334,0
2,1276,35581,3578748334,3578748334,0
2,1276,35582,3578748334,3578748334,0
2,1276,35583,3578748334,3578748334,0
2,1276,35584,3578748334,3578748334,0
2,1276,35585,3578748334,3578748334,0
2,1276,35586,3578748334,3578748334,0
2,1276,35587,3578748334,3578748334,0
2,1276,35588,3578748334,3578748334,0
2,1276,35589,3578748334,3578748334,0
2,1276,35590,3578748334,3578748334,0
2,1276,35591,3578748334,3578748334,0
2,1276,35592,3578748334,3578748335,1
2,1276,35593,3578748334,3578748335,1
2,1276,35594,3578748334,3578748337,3
2,1276,35595,3578748334,3578748337,3
2,1276,35596,3578748334,3578748338,4
2,1276,35597,3578748334,3578748338,4
2,1276,35598,3578748334,3578748339,5
2,1276,35599,3578748334,3578748341,7
2,1276,35600,3578748334,3578748341,7
2,1276,35601,3578748334,3578748341,7
2,1276,35602,3578748334,3578748343,9
2,1276,35603,3578748334,3578748343,9
2,1276,35604,3578748334,3578748343,9
2,1276,35605,3578748334,3578748344,10
2,1276,35606,3578748334,3578748348,14
2,1276,35607,3578748334,3578748350,16
2,1276,35608,3578748334,3578748350,16
2,1276,35609,3578748334,3578748351,17
2,1276,35610,3578748334,3578748351,17
2,1276,35611,3578748334,3578748354,20
2,1276,35612,3578748334,3578748354,20
2,1276,35613,3578748334,3578748355,21
2,1276,35614,3578748334,3578748355,21
2,1276,35615,3578748334,3578748356,22
2,1276,35616,3578748334,3578748357,23
2,1276,35617,3578748334,3578748357,23
2,1276,35618,3578748334,3578748360,26
2,1276,35619,3578748334,3578748360,26
2,1276,35620,3578748334,3578748361,27
2,1276,35621,3578748334,3578748362,28
2,1276,35622,3578748334,3578748364,30
2,1276,35623,3578748334,3578748365,31
2,1276,35624,3578748334,3578748366,32
2,1276,35625,3578748334,3578748366,32
2,1276,35626,3578748334,3578748366,32
2,1276,35627,3578748334,3578748368,34
2,1276,35628,3578748334,3578748368,34
2,1276,35629,3578748334,3578748369,35
2,1276,35630,3578748334,3578748370,36
2,1276,35631,3578748334,3578748372,38
2,1276,35632,3578748334,3578748372,38
2,1276,35633,3578748334,3578748373,39
2,1276,35634,3578748334,3578748374,40
2,1276,35635,3578748334,3578748375,41
2,1276,35636,3578748334,3578748376,42
2,1276,35637,3578748334,3578748376,42
2,1276,35638,3578748334,3578748376,42
2,1276,35639,3578748334,3578748377,43
2,1276,35640,3578748334,3578748377,43
2,1276,35641,3578748334,3578748379,45
2,1276,35642,3578748334,3578748379,45
2,1276,35643,3578748334,3578748379,45
2,1276,35644,3578748334,3578748380,46
2,1276,35645,3578748334,3578748381,47
2,1276,35646,3578748334,3578748381,47
2,1276,35647,3578748334,3578748381,47
2,1276,35648,3578748334,3578748383,49
2,1276,35649,3578748334,3578748384,50
2,1277,35650,3578748396,3578748396,0
2,1277,35651,3578748396,3578748396,0
2,1277,35652,3578748396,3578748396,0
2,1277,35653,3578748396,3578748396,0
2,1277,35654,3578748396,3578748396,0
2,1277,35655,3578748396,3578748396,0
2,1277,35656,3578748396,3578748396,0
2,1277,35657,3578748396,3578748396,0
2,1277,35658,3578748396,3578748396,0
2,1277,35659,3578748396,3578748396,0
2,1277,35660,3578748396,3578748396,0
2,1277,35661,3578748396,3578748396,0
2,1277,35662,3578748396,3578748396,0
2,1277,35663,3578748396,3578748396,0
2,1277,35664,3578748396,3578748398,2
2,1277,35665,3578748396,3578748399,3
2,1277,35666,3578748396,3578748403,7
2,1277,35667,3578748396,3578748404,8
2,1277,35668,3578748396,3578748405,9
2,1277,35669,3578748396,3578748405,9
2,1277,35670,3578748396,3578748406,10
2,1277,35671,3578748396,3578748410,14
2,1277,35672,3578748396,3578748411,15
2,1277,35673,3578748396,3578748412,16
2,1277,35674,3578748396,3578748413,17
2,1277,35675,3578748396,3578748413,17
2,1277,35676,3578748396,3578748414,18
2,1277,35677,3578748396,3578748414,18
2,1277,35678,3578748396,3578748414,18
2,1277,35679,3578748396,3578748417,21
2,1277,35680,3578748396,3578748418,22
2,1277,35681,3578748396,3578748418,22
2,1277,35682,3578748396,3578748419,23
2,1277,35683,3578748396,3578748420,24
2,1277,35684,3578748396,3578748421,25
2,1277,35685,3578748396,3578748422,26
2,1277,35686,3578748396,3578748422,26
2,1277,35687,3578748396,3578748422,26
2,1277,35688,3578748396,3578748425,29
2,1277,35689,3578748396,3578748427,31
2,1277,35690,3578748396,3578748427,31
2,1277,35691,3578748396,3578748427,31
2,1277,35692,3578748396,3578748427,31
2,1277,35693,3578748396,3578748429,33
2,1277,35694,3578748396,3578748430,34
2,1277,35695,3578748396,3578748430,34
2,1277,35696,3578748396,3578748431,35
2,1277,35697,3578748396,3578748431,35
2,1277,35698,3578748396,3578748432,36
2,1277,35699,3578748396,3578748432,36
2,1277,35700,3578748396,3578748433,37
2,1277,35701,3578748396,3578748433,37
2,1277,35702,3578748396,3578748436,40
2,1277,35703,3578748396,3578748437,41
2,1277,35704,3578748396,3578748438,42
2,1277,35705,3578748396,3578748438,42
2,1277,35706,3578748396,3578748438,42
2,1277,35707,3578748396,3578748438,42
2,1277,35708,3578748396,3578748439,43
2,1277,35709,3578748396,3578748439,43
2,1277,35710,3578748396,3578748440,44
2,1277,35711,3578748396,3578748441,45
2,1277,35712,3578748396,3578748441,45
2,1277,35713,3578748396,3578748442,46
2,1277,35714,3578748396,3578748442,46
2,1277,35715,3578748396,3578748442,46
2,1277,35716,3578748396,3578748444,48
2,1277,35717,3578748396,3578748445,49
2,1277,35718,3578748396,3578748446,50
2,1278,35719,3578748461,3578748461,0
2,1278,35720,3578748461,3578748461,0
2,1278,35721,3578748461,3578748461,0
2,1278,35722,3578748461,3578748461,0
2,1278,35723,3578748461,3578748461,0
2,1278,35724,3578748461,3578748461,0
2,1278,35725,3578748461,3578748461,0
2,1278,35726,3578748461,3578748461,0
2,1278,35727,3578748461,3578748461,0
2,1278,35728,3578748461,3578748461,0
2,1278,35729,3578748461,3578748461,0
2,1278,35730,3578748461,3578748461,0
2,1278,35731,3578748461,3578748461,0
2,1278,35732,3578748461,3578748461,0
2,1278,35733,3578748461,3578748461,0
2,1278,35734,3578748461,3578748461,0
2,1278,35735,3578748461,3578748461,0
2,1278,35736,3578748461,3578748461,0
2,1278,35737,3578748461,3578748462,1
2,1278,35738,3578748461,3578748465,4
2,1278,35739,3578748461,3578748466,5
2,1278,35740,3578748461,3578748466,5
2,1278,35741,3578748461,3578748468,7
2,1278,35742,3578748461,3578748468,7
2,1278,35743,3578748461,3578748469,8
2,1278,35744,3578748461,3578748470,9
2,1278,35745,3578748461,3578748473,12
2,1278,35746,3578748461,3578748475,14
2,1278,35747,3578748461,3578748476,15
2,1278,35748,3578748461,3578748477,16
2,1278,35749,3578748461,3578748479,18
2,1278,35750,3578748461,3578748480,19
2,1278,35751,3578748461,3578748481,20
2,1278,35752,3578748461,3578748481,20
2,1278,35753,3578748461,3578748482,21
2,1278,35754,3578748461,3578748482,21
2,1278,35755,3578748461,3578748482,21
2,1278,35756,3578748461,3578748483,22
2,1278,35757,3578748461,3578748483,22
2,1278,35758,3578748461,3578748485,24
2,1278,35759,3578748461,3578748485,24
2,1278,35760,3578748461,3578748486,25
2,1278,35761,3578748461,3578748487,26
2,1278,35762,3578748461,3578748487,26
2,1278,35763,3578748461,3578748488,27
2,1278,35764,3578748461,3578748489,28
2,1278,35765,3578748461,3578748489,28
2,1278,35766,3578748461,3578748489,28
2,1278,35767,3578748461,3578748490,29
2,1278,35768,3578748461,3578748491,30
2,1278,35769,3578748461,3578748492,31
2,1278,35770,3578748461,3578748493,32
2,1278,35771,3578748461,3578748494,33
2,1278,35772,3578748461,3578748494,33
2,1278,35773,3578748461,3578748494,33
2,1278,35774,3578748461,3578748495,34
2,1278,35775,3578748461,3578748495,34
2,1278,35776,3578748461,3578748495,34
2,1278,35777,3578748461,3578748496,35
2,1278,35778,3578748461,3578748497,36
2,1278,35779,3578748461,3578748497,36
2,1278,35780,3578748461,3578748498,37
2,1278,35781,3578748461,3578748499,38
2,1278,35782,3578748461,3578748499,38
2,1278,35783,3578748461,3578748499,38
2,1278,35784,3578748461,3578748500,39
2,1278,35785,3578748461,3578748501,40
2,1278,35786,3578748461,3578748504,43
2,1278,35787,3578748461,3578748507,46
2,1278,35788,3578748461,3578748508,47
2,1278,35789,3578748461,3578748510,49
2,1278,35790,3578748461,3578748511,50
2,1279,35791,3578748524,3578748524,0
2,1279,35792,3578748524,3578748524,0
2,1279,35793,3578748524,3578748524,0
2,1279,35794,3578748524,3578748524,0
2,1279,35795,3578748524,3578748524,0
2,1279,35796,3578748524,3578748524,0
2,1279,35797,3578748524,3578748524,0
2,1279,35798,3578748524,3578748524,0
2,1279,35799,3578748524,3578748524,0
2,1279,35800,3578748524,3578748524,0
2,1279,35801,3578748524,3578748524,0
2,1279,35802,3578748524,3578748524,0
2,1279,35803,3578748524,3578748524,0
2,1279,35804,3578748524,3578748524,0
2,1279,35805,3578748524,3578748524,0
2,1279,35806,3578748524,3578748524,0
2,1279,35807,3578748524,3578748524,0
2,1279,35808,3578748524,3578748524,0
2,1279,35809,3578748524,3578748524,0
2,1279,35810,3578748524,3578748524,0
2,1279,35811,3578748524,3578748524,0
2,1279,35812,3578748524,3578748524,0
2,1279,35813,3578748524,3578748524,0
2,1279,35814,3578748524,3578748524,0
2,1279,35815,3578748524,3578748524,0
2,1279,35816,3578748524,3578748524,0
2,1279,35817,3578748524,3578748525,1
2,1279,35818,3578748524,3578748526,2
2,1279,35819,3578748524,3578748526,2
2,1279,35820,3578748524,3578748526,2
2,1279,35821,3578748524,3578748528,4
2,1279,35822,3578748524,3578748529,5
2,1279,35823,3578748524,3578748529,5
2,1279,35824,3578748524,3578748529,5
2,1279,35825,3578748524,3578748531,7
2,1279,35826,3578748524,3578748532,8
2,1279,35827,3578748524,3578748532,8
2,1279,35828,3578748524,3578748535,11
2,1279,35829,3578748524,3578748535,11
2,1279,35830,3578748524,3578748536,12
2,1279,35831,3578748524,3578748536,12
2,1279,35832,3578748524,3578748536,12
2,1279,35833,3578748524,3578748537,13
2,1279,35834,3578748524,3578748537,13
2,1279,35835,3578748524,3578748539,15
2,1279,35836,3578748524,3578748540,16
2,1279,35837,3578748524,3578748540,16
2,1279,35838,3578748524,3578748540,16
2,1279,35839,3578748524,3578748542,18
2,1279,35840,3578748524,3578748542,18
2,1279,35841,3578748524,3578748542,18
2,1279,35842,3578748524,3578748543,19
2,1279,35843,3578748524,3578748543,19
2,1279,35844,3578748524,3578748547,23
2,1279,35845,3578748524,3578748549,25
2,1279,35846,3578748524,3578748550,26
2,1279,35847,3578748524,3578748550,26
2,1279,35848,3578748524,3578748550,26
2,1279,35849,3578748524,3578748553,29
2,1279,35850,3578748524,3578748553,29
2,1279,35851,3578748524,3578748554,30
2,1279,35852,3578748524,3578748555,31
2,1279,35853,3578748524,3578748556,32
2,1279,35854,3578748524,3578748556,32
2,1279,35855,3578748524,3578748559,35
2,1279,35856,3578748524,3578748560,36
2,1279,35857,3578748524,3578748560,36
2,1279,35858,3578748524,3578748561,37
2,1279,35859,3578748524,3578748561,37
2,1279,35860,3578748524,3578748563,39
2,1279,35861,3578748524,3578748564,40
2,1279,35862,3578748524,3578748564,40
2,1279,35863,3578748524,3578748565,41
2,1279,35864,3578748524,3578748565,41
2,1279,35865,3578748524,3578748567,43
2,1279,35866,3578748524,3578748567,43
2,1279,35867,3578748524,3578748569,45
2,1279,35868,3578748524,3578748571,47
2,1279,35869,3578748524,3578748572,48
2,1279,35870,3578748524,3578748573,49
2,1279,35871,3578748524,3578748574,50
2,1280,35872,3578748587,3578748587,0
2,1280,35873,3578748587,3578748587,0
2,1280,35874,3578748587,3578748587,0
2,1280,35875,3578748587,3578748587,0
2,1280,35876,3578748587,3578748587,0
2,1280,35877,3578748587,3578748587,0
2,1280,35878,3578748587,3578748587,0
2,1280,35879,3578748587,3578748587,0
2,1280,35880,3578748587,3578748587,0
2,1280,35881,3578748587,3578748587,0
2,1280,35882,3578748587,3578748587,0
2,1280,35883,3578748587,3578748587,0
2,1280,35884,3578748587,3578748587,0
2,1280,35885,3578748587,3578748587,0
2,1280,35886,3578748587,3578748587,0
2,1280,35887,3578748587,3578748587,0
2,1280,35888,3578748587,3578748588,1
2,1280,35889,3578748587,3578748588,1
2,1280,35890,3578748587,3578748590,3
2,1280,35891,3578748587,3578748590,3
2,1280,35892,3578748587,3578748592,5
2,1280,35893,3578748587,3578748592,5
2,1280,35894,3578748587,3578748593,6
2,1280,35895,3578748587,3578748593,6
2,1280,35896,3578748587,3578748593,6
2,1280,35897,3578748587,3578748594,7
2,1280,35898,3578748587,3578748595,8
2,1280,35899,3578748587,3578748597,10
2,1280,35900,3578748587,3578748598,11
2,1280,35901,3578748587,3578748599,12
2,1280,35902,3578748587,3578748603,16
2,1280,35903,3578748587,3578748604,17
2,1280,35904,3578748587,3578748605,18
2,1280,35905,3578748587,3578748606,19
2,1280,35906,3578748587,3578748608,21
2,1280,35907,3578748587,3578748610,23
2,1280,35908,3578748587,3578748611,24
2,1280,35909,3578748587,3578748611,24
2,1280,35910,3578748587,3578748613,26
2,1280,35911,3578748587,3578748613,26
2,1280,35912,3578748587,3578748613,26
2,1280,35913,3578748587,3578748614,27
2,1280,35914,3578748587,3578748616,29
2,1280,35915,3578748587,3578748617,30
2,1280,35916,3578748587,3578748617,30
2,1280,35917,3578748587,3578748618,31
2,1280,35918,3578748587,3578748618,31
2,1280,35919,3578748587,3578748620,33
2,1280,35920,3578748587,3578748620,33
2,1280,35921,3578748587,3578748620,33
2,1280,35922,3578748587,3578748621,34
2,1280,35923,3578748587,3578748621,34
2,1280,35924,3578748587,3578748623,36
2,1280,35925,3578748587,3578748625,38
2,1280,35926,3578748587,3578748626,39
2,1280,35927,3578748587,3578748626,39
2,1280,35928,3578748587,3578748626,39
2,1280,35929,3578748587,3578748627,40
2,1280,35930,3578748587,3578748629,42
2,1280,35931,3578748587,3578748629,42
2,1280,35932,3578748587,3578748630,43
2,1280,35933,3578748587,3578748631,44
2,1280,35934,3578748587,3578748631,44
2,1280,35935,3578748587,3578748632,45
2,1280,35936,3578748587,3578748632,45
2,1280,35937,3578748587,3578748632,45
2,1280,35938,3578748587,3578748636,49
2,1280,35939,3578748587,3578748636,49
2,1280,35940,3578748587,3578748636,49
2,1280,35941,3578748587,3578748636,49
2,1280,35942,3578748587,3578748636,49
2,1280,35943,3578748587,3578748637,50
2,1281,35944,3578748650,3578748650,0
2,1281,35945,3578748650,3578748650,0
2,1281,35946,3578748650,3578748650,0
2,1281,35947,3578748650,3578748650,0
2,1281,35948,3578748650,3578748650,0
2,1281,35949,3578748650,3578748650,0
2,1281,35950,3578748650,3578748650,0
2,1281,35951,3578748650,3578748650,0
2,1281,35952,3578748650,3578748650,0
2,1281,35953,3578748650,3578748650,0
2,1281,35954,3578748650,3578748650,0
2,1281,35955,3578748650,3578748650,0
2,1281,35956,3578748650,3578748650,0
2,1281,35957,3578748650,3578748650,0
2,1281,35958,3578748650,3578748650,0
2,1281,35959,3578748650,3578748650,0
2,1281,35960,3578748650,3578748651,1
2,1281,35961,3578748650,3578748652,2
2,1281,35962,3578748650,3578748653,3
2,1281,35963,3578748650,3578748653,3
2,1281,35964,3578748650,3578748654,4
2,1281,35965,3578748650,3578748654,4
2,1281,35966,3578748650,3578748654,4
2,1281,35967,3578748650,3578748655,5
2,1281,35968,3578748650,3578748657,7
2,1281,35969,3578748650,3578748657,7
2,1281,35970,3578748650,3578748657,7
2,1281,35971,3578748650,3578748657,7
2,1281,35972,3578748650,3578748658,8
2,1281,35973,3578748650,3578748659,9
2,1281,35974,3578748650,3578748660,10
2,1281,35975,3578748650,3578748660,10
2,1281,35976,3578748650,3578748663,13
2,1281,35977,3578748650,3578748664,14
2,1281,35978,3578748650,3578748665,15
2,1281,35979,3578748650,3578748666,16
2,1281,35980,3578748650,3578748666,16
2,1281,35981,3578748650,3578748668,18
2,1281,35982,3578748650,3578748670,20
2,1281,35983,3578748650,3578748673,23
2,1281,35984,3578748650,3578748675,25
2,1281,35985,3578748650,3578748677,27
2,1281,35986,3578748650,3578748678,28
2,1281,35987,3578748650,3578748679,29
2,1281,35988,3578748650,3578748680,30
2,1281,35989,3578748650,3578748681,31
2,1281,35990,3578748650,3578748681,31
2,1281,35991,3578748650,3578748682,32
2,1281,35992,3578748650,3578748682,32
2,1281,35993,3578748650,3578748683,33
2,1281,35994,3578748650,3578748683,33
2,1281,35995,3578748650,3578748684,34
2,1281,35996,3578748650,3578748684,34
2,1281,35997,3578748650,3578748685,35
2,1281,35998,3578748650,3578748686,36
2,1281,35999,3578748650,3578748686,36
2,1281,36000,3578748650,3578748687,37
2,1281,36001,3578748650,3578748688,38
2,1281,36002,3578748650,3578748689,39
2,1281,36003,3578748650,3578748690,40
2,1281,36004,3578748650,3578748690,40
2,1281,36005,3578748650,3578748690,40
2,1281,36006,3578748650,3578748691,41
2,1281,36007,3578748650,3578748692,42
2,1281,36008,3578748650,3578748692,42
2,1281,36009,3578748650,3578748693,43
2,1281,36010,3578748650,3578748693,43
2,1281,36011,3578748650,3578748694,44
2,1281,36012,3578748650,3578748695,45
2,1281,36013,3578748650,3578748696,46
2,1281,36014,3578748650,3578748696,46
2,1281,36015,3578748650,3578748696,46
2,1281,36016,3578748650,3578748697,47
2,1281,36017,3578748650,3578748697,47
2,1281,36018,3578748650,3578748698,48
2,1281,36019,3578748650,3578748698,48
2,1281,36020,3578748650,3578748699,49
2,1281,36021,3578748650,3578748700,50
2,1282,36022,3578748712,3578748712,0
2,1282,36023,3578748712,3578748712,0
2,1282,36024,3578748712,3578748712,0
2,1282,36025,3578748712,3578748712,0
2,1282,36026,3578748712,3578748712,0
2,1282,36027,3578748712,3578748712,0
2,1282,36028,3578748712,3578748712,0
2,1282,36029,3578748712,3578748712,0
2,1282,36030,3578748712,3578748712,0
2,1282,36031,3578748712,3578748712,0
2,1282,36032,3578748712,3578748713,1
2,1282,36033,3578748712,3578748713,1
2,1282,36034,3578748712,3578748713,1
2,1282,36035,3578748712,3578748714,2
2,1282,36036,3578748712,3578748715,3
2,1282,36037,3578748712,3578748715,3
2,1282,36038,3578748712,3578748715,3
2,1282,36039,3578748712,3578748716,4
2,1282,36040,3578748712,3578748717,5
2,1282,36041,3578748712,3578748717,5
2,1282,36042,3578748712,3578748717,5
2,1282,36043,3578748712,3578748717,5
2,1282,36044,3578748712,3578748717,5
2,1282,36045,3578748712,3578748718,6
2,1282,36046,3578748712,3578748718,6
2,1282,36047,3578748712,3578748719,7
2,1282,36048,3578748712,3578748719,7
2,1282,36049,3578748712,3578748721,9
2,1282,36050,3578748712,3578748721,9
2,1282,36051,3578748712,3578748721,9
2,1282,36052,3578748712,3578748721,9
2,1282,36053,3578748712,3578748722,10
2,1282,36054,3578748712,3578748722,10
2,1282,36055,3578748712,3578748724,12
2,1282,36056,3578748712,3578748726,14
2,1282,36057,3578748712,3578748726,14
2,1282,36058,3578748712,3578748726,14
2,1282,36059,3578748712,3578748726,14
2,1282,36060,3578748712,3578748728,16
2,1282,36061,3578748712,3578748728,16
2,1282,36062,3578748712,3578748729,17
2,1282,36063,3578748712,3578748729,17
2,1282,36064,3578748712,3578748732,20
2,1282,36065,3578748712,3578748732,20
2,1282,36066,3578748712,3578748733,21
2,1282,36067,3578748712,3578748734,22
2,1282,36068,3578748712,3578748734,22
2,1282,36069,3578748712,3578748735,23
2,1282,36070,3578748712,3578748735,23
2,1282,36071,3578748712,3578748736,24
2,1282,36072,3578748712,3578748738,26
2,1282,36073,3578748712,3578748738,26
2,1282,36074,3578748712,3578748739,27
2,1282,36075,3578748712,3578748740,28
2,1282,36076,3578748712,3578748740,28
2,1282,36077,3578748712,3578748741,29
2,1282,36078,3578748712,3578748742,30
2,1282,36079,3578748712,3578748742,30
2,1282,36080,3578748712,3578748742,30
2,1282,36081,3578748712,3578748743,31
2,1282,36082,3578748712,3578748744,32
2,1282,36083,3578748712,3578748748,36
2,1282,36084,3578748712,3578748749,37
2,1282,36085,3578748712,3578748750,38
2,1282,36086,3578748712,3578748750,38
2,1282,36087,3578748712,3578748750,38
2,1282,36088,3578748712,3578748753,41
2,1282,36089,3578748712,3578748754,42
2,1282,36090,3578748712,3578748755,43
2,1282,36091,3578748712,3578748755,43
2,1282,36092,3578748712,3578748755,43
2,1282,36093,3578748712,3578748755,43
2,1282,36094,3578748712,3578748756,44
2,1282,36095,3578748712,3578748757,45
2,1282,36096,3578748712,3578748759,47
2,1282,36097,3578748712,3578748759,47
2,1282,36098,3578748712,3578748760,48
2,1282,36099,3578748712,3578748760,48
2,1282,36100,3578748712,3578748761,49
2,1283,36101,3578748775,3578748775,0
2,1283,36102,3578748775,3578748775,0
2,1283,36103,3578748775,3578748775,0
2,1283,36104,3578748775,3578748775,0
2,1283,36105,3578748775,3578748775,0
2,1283,36106,3578748775,3578748775,0
2,1283,36107,3578748775,3578748775,0
2,1283,36108,3578748775,3578748775,0
2,1283,36109,3578748775,3578748775,0
2,1283,36110,3578748775,3578748775,0
2,1283,36111,3578748775,3578748775,0
2,1283,36112,3578748775,3578748775,0
2,1283,36113,3578748775,3578748775,0
2,1283,36114,3578748775,3578748775,0
2,1283,36115,3578748775,3578748776,1
2,1283,36116,3578748775,3578748776,1
2,1283,36117,3578748775,3578748777,2
2,1283,36118,3578748775,3578748778,3
2,1283,36119,3578748775,3578748778,3
2,1283,36120,3578748775,3578748780,5
2,1283,36121,3578748775,3578748780,5
2,1283,36122,3578748775,3578748780,5
2,1283,36123,3578748775,3578748780,5
2,1283,36124,3578748775,3578748782,7
2,1283,36125,3578748775,3578748782,7
2,1283,36126,3578748775,3578748783,8
2,1283,36127,3578748775,3578748784,9
2,1283,36128,3578748775,3578748785,10
2,1283,36129,3578748775,3578748788,13
2,1283,36130,3578748775,3578748789,14
2,1283,36131,3578748775,3578748790,15
2,1283,36132,3578748775,3578748791,16
2,1283,36133,3578748775,3578748792,17
2,1283,36134,3578748775,3578748792,17
2,1283,36135,3578748775,3578748792,17
2,1283,36136,3578748775,3578748792,17
2,1283,36137,3578748775,3578748793,18
2,1283,36138,3578748775,3578748794,19
2,1283,36139,3578748775,3578748794,19
2,1283,36140,3578748775,3578748795,20
2,1283,36141,3578748775,3578748798,23
2,1283,36142,3578748775,3578748798,23
2,1283,36143,3578748775,3578748800,25
2,1283,36144,3578748775,3578748803,28
2,1283,36145,3578748775,3578748803,28
2,1283,36146,3578748775,3578748804,29
2,1283,36147,3578748775,3578748804,29
2,1283,36148,3578748775,3578748806,31
2,1283,36149,3578748775,3578748808,33
2,1283,36150,3578748775,3578748811,36
2,1283,36151,3578748775,3578748812,37
2,1283,36152,3578748775,3578748813,38
2,1283,36153,3578748775,3578748813,38
2,1283,36154,3578748775,3578748813,38
2,1283,36155,3578748775,3578748814,39
2,1283,36156,3578748775,3578748816,41
2,1283,36157,3578748775,3578748816,41
2,1283,36158,3578748775,3578748818,43
2,1283,36159,3578748775,3578748819,44
2,1283,36160,3578748775,3578748819,44
2,1283,36161,3578748775,3578748819,44
2,1283,36162,3578748775,3578748820,45
2,1283,36163,3578748775,3578748821,46
2,1283,36164,3578748775,3578748821,46
2,1283,36165,3578748775,3578748822,47
2,1283,36166,3578748775,3578748823,48
2,1283,36167,3578748775,3578748825,50
2,1284,36168,3578748837,3578748837,0
2,1284,36169,3578748837,3578748837,0
2,1284,36170,3578748837,3578748837,0
2,1284,36171,3578748837,3578748837,0
2,1284,36172,3578748837,3578748837,0
2,1284,36173,3578748837,3578748837,0
2,1284,36174,3578748837,3578748838,1
2,1284,36175,3578748837,3578748838,1
2,1284,36176,3578748837,3578748838,1
2,1284,36177,3578748837,3578748838,1
2,1284,36178,3578748837,3578748838,1
2,1284,36179,3578748837,3578748838,1
2,1284,36180,3578748837,3578748838,1
2,1284,36181,3578748837,3578748838,1
2,1284,36182,3578748837,3578748838,1
2,1284,36183,3578748837,3578748838,1
2,1284,36184,3578748837,3578748838,1
2,1284,36185,3578748837,3578748838,1
2,1284,36186,3578748837,3578748838,1
2,1284,36187,3578748837,3578748838,1
2,1284,36188,3578748837,3578748838,1
2,1284,36189,3578748837,3578748838,1
2,1284,36190,3578748837,3578748840,3
2,1284,36191,3578748837,3578748841,4
2,1284,36192,3578748837,3578748841,4
2,1284,36193,3578748837,3578748842,5
2,1284,36194,3578748837,3578748842,5
2,1284,36195,3578748837,3578748844,7
2,1284,36196,3578748837,3578748844,7
2,1284,36197,3578748837,3578748845,8
2,1284,36198,3578748837,3578748846,9
2,1284,36199,3578748837,3578748847,10
2,1284,36200,3578748837,3578748847,10
2,1284,36201,3578748837,3578748849,12
2,1284,36202,3578748837,3578748851,14
2,1284,36203,3578748837,3578748851,14
2,1284,36204,3578748837,3578748852,15
2,1284,36205,3578748837,3578748853,16
2,1284,36206,3578748837,3578748853,16
2,1284,36207,3578748837,3578748854,17
2,1284,36208,3578748837,3578748854,17
2,1284,36209,3578748837,3578748855,18
2,1284,36210,3578748837,3578748855,18
2,1284,36211,3578748837,3578748856,19
2,1284,36212,3578748837,3578748856,19
2,1284,36213,3578748837,3578748856,19
2,1284,36214,3578748837,3578748857,20
2,1284,36215,3578748837,3578748859,22
2,1284,36216,3578748837,3578748859,22
2,1284,36217,3578748837,3578748859,22
2,1284,36218,3578748837,3578748860,23
2,1284,36219,3578748837,3578748861,24
2,1284,36220,3578748837,3578748863,26
2,1284,36221,3578748837,3578748865,28
2,1284,36222,3578748837,3578748866,29
2,1284,36223,3578748837,3578748866,29
2,1284,36224,3578748837,3578748867,30
2,1284,36225,3578748837,3578748869,32
2,1284,36226,3578748837,3578748873,36
2,1284,36227,3578748837,3578748874,37
2,1284,36228,3578748837,3578748877,40
2,1284,36229,3578748837,3578748878,41
2,1284,36230,3578748837,3578748879,42
2,1284,36231,3578748837,3578748880,43
2,1284,36232,3578748837,3578748881,44
2,1284,36233,3578748837,3578748882,45
2,1284,36234,3578748837,3578748882,45
2,1284,36235,3578748837,3578748883,46
2,1284,36236,3578748837,3578748883,46
2,1284,36237,3578748837,3578748884,47
2,1284,36238,3578748837,3578748884,47
2,1284,36239,3578748837,3578748884,47
2,1284,36240,3578748837,3578748885,48
2,1284,36241,3578748837,3578748886,49
2,1284,36242,3578748837,3578748887,50
2,1285,36243,3578748899,3578748899,0
2,1285,36244,3578748899,3578748899,0
2,1285,36245,3578748899,3578748899,0
2,1285,36246,3578748899,3578748899,0
2,1285,36247,3578748899,3578748899,0
2,1285,36248,3578748899,3578748899,0
2,1285,36249,3578748899,3578748899,0
2,1285,36250,3578748899,3578748899,0
2,1285,36251,3578748899,3578748899,0
2,1285,36252,3578748899,3578748899,0
2,1285,36253,3578748899,3578748899,0
2,1285,36254,3578748899,3578748899,0
2,1285,36255,3578748899,3578748899,0
2,1285,36256,3578748899,3578748899,0
2,1285,36257,3578748899,3578748899,0
2,1285,36258,3578748899,3578748899,0
2,1285,36259,3578748899,3578748899,0
2,1285,36260,3578748899,3578748899,0
2,1285,36261,3578748899,3578748899,0
2,1285,36262,3578748899,3578748899,0
2,1285,36263,3578748899,3578748900,1
2,1285,36264,3578748899,3578748901,2
2,1285,36265,3578748899,3578748901,2
2,1285,36266,3578748899,3578748902,3
2,1285,36267,3578748899,3578748903,4
2,1285,36268,3578748899,3578748904,5
2,1285,36269,3578748899,3578748907,8
2,1285,36270,3578748899,3578748908,9
2,1285,36271,3578748899,3578748910,11
2,1285,36272,3578748899,3578748910,11
2,1285,36273,3578748899,3578748912,13
2,1285,36274,3578748899,3578748912,13
2,1285,36275,3578748899,3578748913,14
2,1285,36276,3578748899,3578748913,14
2,1285,36277,3578748899,3578748914,15
2,1285,36278,3578748899,3578748915,16
2,1285,36279,3578748899,3578748916,17
2,1285,36280,3578748899,3578748917,18
2,1285,36281,3578748899,3578748917,18
2,1285,36282,3578748899,3578748917,18
2,1285,36283,3578748899,3578748918,19
2,1285,36284,3578748899,3578748918,19
2,1285,36285,3578748899,3578748918,19
2,1285,36286,3578748899,3578748919,20
2,1285,36287,3578748899,3578748919,20
2,1285,36288,3578748899,3578748920,21
2,1285,36289,3578748899,3578748921,22
2,1285,36290,3578748899,3578748922,23
2,1285,36291,3578748899,3578748922,23
2,1285,36292,3578748899,3578748922,23
2,1285,36293,3578748899,3578748922,23
2,1285,36294,3578748899,3578748922,23
2,1285,36295,3578748899,3578748925,26
2,1285,36296,3578748899,3578748925,26
2,1285,36297,3578748899,3578748926,27
2,1285,36298,3578748899,3578748926,27
2,1285,36299,3578748899,3578748927,28
2,1285,36300,3578748899,3578748928,29
2,1285,36301,3578748899,3578748929,30
2,1285,36302,3578748899,3578748929,30
2,1285,36303,3578748899,3578748933,34
2,1285,36304,3578748899,3578748933,34
2,1285,36305,3578748899,3578748934,35
2,1285,36306,3578748899,3578748934,35
2,1285,36307,3578748899,3578748935,36
2,1285,36308,3578748899,3578748935,36
2,1285,36309,3578748899,3578748936,37
2,1285,36310,3578748899,3578748936,37
2,1285,36311,3578748899,3578748936,37
2,1285,36312,3578748899,3578748938,39
2,1285,36313,3578748899,3578748938,39
2,1285,36314,3578748899,3578748940,41
2,1285,36315,3578748899,3578748940,41
2,1285,36316,3578748899,3578748941,42
2,1285,36317,3578748899,3578748942,43
2,1285,36318,3578748899,3578748942,43
2,1285,36319,3578748899,3578748942,43
2,1285,36320,3578748899,3578748943,44
2,1285,36321,3578748899,3578748944,45
2,1285,36322,3578748899,3578748948,49
2,1285,36323,3578748899,3578748948,49
2,1286,36324,3578748961,3578748961,0
2,1286,36325,3578748961,3578748961,0
2,1286,36326,3578748961,3578748961,0
2,1286,36327,3578748961,3578748961,0
2,1286,36328,3578748961,3578748961,0
2,1286,36329,3578748961,3578748961,0
2,1286,36330,3578748961,3578748961,0
2,1286,36331,3578748961,3578748961,0
2,1286,36332,3578748961,3578748961,0
2,1286,36333,3578748961,3578748961,0
2,1286,36334,3578748961,3578748961,0
2,1286,36335,3578748961,3578748961,0
2,1286,36336,3578748961,3578748961,0
2,1286,36337,3578748961,3578748961,0
2,1286,36338,3578748961,3578748961,0
2,1286,36339,3578748961,3578748963,2
2,1286,36340,3578748961,3578748964,3
2,1286,36341,3578748961,3578748964,3
2,1286,36342,3578748961,3578748965,4
2,1286,36343,3578748961,3578748965,4
2,1286,36344,3578748961,3578748966,5
2,1286,36345,3578748961,3578748968,7
2,1286,36346,3578748961,3578748968,7
2,1286,36347,3578748961,3578748970,9
2,1286,36348,3578748961,3578748972,11
2,1286,36349,3578748961,3578748973,12
2,1286,36350,3578748961,3578748973,12
2,1286,36351,3578748961,3578748974,13
2,1286,36352,3578748961,3578748975,14
2,1286,36353,3578748961,3578748976,15
2,1286,36354,3578748961,3578748976,15
2,1286,36355,3578748961,3578748976,15
2,1286,36356,3578748961,3578748977,16
2,1286,36357,3578748961,3578748978,17
2,1286,36358,3578748961,3578748979,18
2,1286,36359,3578748961,3578748979,18
2,1286,36360,3578748961,3578748980,19
2,1286,36361,3578748961,3578748981,20
2,1286,36362,3578748961,3578748981,20
2,1286,36363,3578748961,3578748981,20
2,1286,36364,3578748961,3578748982,21
2,1286,36365,3578748961,3578748984,23
2,1286,36366,3578748961,3578748984,23
2,1286,36367,3578748961,3578748985,24
2,1286,36368,3578748961,3578748988,27
2,1286,36369,3578748961,3578748988,27
2,1286,36370,3578748961,3578748990,29
2,1286,36371,3578748961,3578748990,29
2,1286,36372,3578748961,3578748990,29
2,1286,36373,3578748961,3578748991,30
2,1286,36374,3578748961,3578748992,31
2,1286,36375,3578748961,3578748993,32
2,1286,36376,3578748961,3578748993,32
2,1286,36377,3578748961,3578748994,33
2,1286,36378,3578748961,3578748994,33
2,1286,36379,3578748961,3578748995,34
2,1286,36380,3578748961,3578748998,37
2,1286,36381,3578748961,3578748999,38
2,1286,36382,3578748961,3578749000,39
2,1286,36383,3578748961,3578749000,39
2,1286,36384,3578748961,3578749003,42
2,1286,36385,3578748961,3578749004,43
2,1286,36386,3578748961,3578749005,44
2,1286,36387,3578748961,3578749006,45
2,1286,36388,3578748961,3578749008,47
2,1286,36389,3578748961,3578749011,50
2,1287,36390,3578749024,3578749024,0
2,1287,36391,3578749024,3578749024,0
2,1287,36392,3578749024,3578749024,0
2,1287,36393,3578749024,3578749024,0
2,1287,36394,3578749024,3578749024,0
2,1287,36395,3578749024,3578749024,0
2,1287,36396,3578749024,3578749024,0
2,1287,36397,3578749024,3578749024,0
2,1287,36398,3578749024,3578749024,0
2,1287,36399,3578749024,3578749024,0
2,1287,36400,3578749024,3578749024,0
2,1287,36401,3578749024,3578749024,0
2,1287,36402,3578749024,3578749024,0
2,1287,36403,3578749024,3578749024,0
2,1287,36404,3578749024,3578749024,0
2,1287,36405,3578749024,3578749024,0
2,1287,36406,3578749024,3578749026,2
2,1287,36407,3578749024,3578749026,2
2,1287,36408,3578749024,3578749026,2
2,1287,36409,3578749024,3578749027,3
2,1287,36410,3578749024,3578749029,5
2,1287,36411,3578749024,3578749029,5
2,1287,36412,3578749024,3578749031,7
2,1287,36413,3578749024,3578749031,7
2,1287,36414,3578749024,3578749032,8
2,1287,36415,3578749024,3578749032,8
2,1287,36416,3578749024,3578749032,8
2,1287,36417,3578749024,3578749033,9
2,1287,36418,3578749024,3578749036,12
2,1287,36419,3578749024,3578749036,12
2,1287,36420,3578749024,3578749037,13
2,1287,36421,3578749024,3578749037,13
2,1287,36422,3578749024,3578749037,13
2,1287,36423,3578749024,3578749037,13
2,1287,36424,3578749024,3578749038,14
2,1287,36425,3578749024,3578749038,14
2,1287,36426,3578749024,3578749038,14
2,1287,36427,3578749024,3578749038,14
2,1287,36428,3578749024,3578749039,15
2,1287,36429,3578749024,3578749040,16
2,1287,36430,3578749024,3578749041,17
2,1287,36431,3578749024,3578749041,17
2,1287,36432,3578749024,3578749042,18
2,1287,36433,3578749024,3578749042,18
2,1287,36434,3578749024,3578749044,20
2,1287,36435,3578749024,3578749044,20
2,1287,36436,3578749024,3578749045,21
2,1287,36437,3578749024,3578749046,22
2,1287,36438,3578749024,3578749046,22
2,1287,36439,3578749024,3578749047,23
2,1287,36440,3578749024,3578749048,24
2,1287,36441,3578749024,3578749049,25
2,1287,36442,3578749024,3578749050,26
2,1287,36443,3578749024,3578749052,28
2,1287,36444,3578749024,3578749052,28
2,1287,36445,3578749024,3578749052,28
2,1287,36446,3578749024,3578749053,29
2,1287,36447,3578749024,3578749053,29
2,1287,36448,3578749024,3578749054,30
2,1287,36449,3578749024,3578749054,30
2,1287,36450,3578749024,3578749055,31
2,1287,36451,3578749024,3578749056,32
2,1287,36452,3578749024,3578749057,33
2,1287,36453,3578749024,3578749057,33
2,1287,36454,3578749024,3578749057,33
2,1287,36455,3578749024,3578749058,34
2,1287,36456,3578749024,3578749059,35
2,1287,36457,3578749024,3578749060,36
2,1287,36458,3578749024,3578749060,36
2,1287,36459,3578749024,3578749061,37
2,1287,36460,3578749024,3578749065,41
2,1287,36461,3578749024,3578749065,41
2,1287,36462,3578749024,3578749067,43
2,1287,36463,3578749024,3578749067,43
2,1287,36464,3578749024,3578749067,43
2,1287,36465,3578749024,3578749068,44
2,1287,36466,3578749024,3578749070,46
2,1287,36467,3578749024,3578749073,49
2,1288,36468,3578749087,3578749087,0
2,1288,36469,3578749087,3578749087,0
2,1288,36470,3578749087,3578749087,0
2,1288,36471,3578749087,3578749087,0
2,1288,36472,3578749087,3578749087,0
2,1288,36473,3578749087,3578749087,0
2,1288,36474,3578749087,3578749087,0
2,1288,36475,3578749087,3578749087,0
2,1288,36476,3578749087,3578749087,0
2,1288,36477,3578749087,3578749087,0
2,1288,36478,3578749087,3578749087,0
2,1288,36479,3578749087,3578749087,0
2,1288,36480,3578749087,3578749087,0
2,1288,36481,3578749087,3578749087,0
2,1288,36482,3578749087,3578749087,0
2,1288,36483,3578749087,3578749087,0
2,1288,36484,3578749087,3578749087,0
2,1288,36485,3578749087,3578749088,1
2,1288,36486,3578749087,3578749089,2
2,1288,36487,3578749087,3578749090,3
2,1288,36488,3578749087,3578749090,3
2,1288,36489,3578749087,3578749092,5
2,1288,36490,3578749087,3578749093,6
2,1288,36491,3578749087,3578749094,7
2,1288,36492,3578749087,3578749094,7
2,1288,36493,3578749087,3578749094,7
2,1288,36494,3578749087,3578749095,8
2,1288,36495,3578749087,3578749096,9
2,1288,36496,3578749087,3578749097,10
2,1288,36497,3578749087,3578749097,10
2,1288,36498,3578749087,3578749098,11
2,1288,36499,3578749087,3578749099,12
2,1288,36500,3578749087,3578749099,12
2,1288,36501,3578749087,3578749100,13
2,1288,36502,3578749087,3578749101,14
2,1288,36503,3578749087,3578749102,15
2,1288,36504,3578749087,3578749104,17
2,1288,36505,3578749087,3578749104,17
2,1288,36506,3578749087,3578749104,17
2,1288,36507,3578749087,3578749107,20
2,1288,36508,3578749087,3578749108,21
2,1288,36509,3578749087,3578749110,23
2,1288,36510,3578749087,3578749111,24
2,1288,36511,3578749087,3578749112,25
2,1288,36512,3578749087,3578749113,26
2,1288,36513,3578749087,3578749114,27
2,1288,36514,3578749087,3578749114,27
2,1288,36515,3578749087,3578749114,27
2,1288,36516,3578749087,3578749115,28
2,1288,36517,3578749087,3578749116,29
2,1288,36518,3578749087,3578749117,30
2,1288,36519,3578749087,3578749117,30
2,1288,36520,3578749087,3578749117,30
2,1288,36521,3578749087,3578749117,30
2,1288,36522,3578749087,3578749118,31
2,1288,36523,3578749087,3578749118,31
2,1288,36524,3578749087,3578749119,32
2,1288,36525,3578749087,3578749119,32
2,1288,36526,3578749087,3578749119,32
2,1288,36527,3578749087,3578749122,35
2,1288,36528,3578749087,3578749122,35
2,1288,36529,3578749087,3578749122,35
2,1288,36530,3578749087,3578749122,35
2,1288,36531,3578749087,3578749122,35
2,1288,36532,3578749087,3578749123,36
2,1288,36533,3578749087,3578749125,38
2,1288,36534,3578749087,3578749126,39
2,1288,36535,3578749087,3578749126,39
2,1288,36536,3578749087,3578749126,39
2,1288,36537,3578749087,3578749127,40
2,1288,36538,3578749087,3578749128,41
2,1288,36539,3578749087,3578749129,42
2,1288,36540,3578749087,3578749129,42
2,1288,36541,3578749087,3578749132,45
2,1288,36542,3578749087,3578749133,46
2,1288,36543,3578749087,3578749134,47
2,1288,36544,3578749087,3578749135,48
2,1288,36545,3578749087,3578749135,48
2,1288,36546,3578749087,3578749135,48
2,1288,36547,3578749087,3578749136,49
2,1288,36548,3578749087,3578749137,50
2,1289,36549,3578749150,3578749150,0
2,1289,36550,3578749150,3578749150,0
2,1289,36551,3578749150,3578749150,0
2,1289,36552,3578749150,3578749150,0
2,1289,36553,3578749150,3578749150,0
2,1289,36554,3578749150,3578749150,0
2,1289,36555,3578749150,3578749150,0
2,1289,36556,3578749150,3578749150,0
2,1289,36557,3578749150,3578749150,0
2,1289,36558,3578749150,3578749150,0
2,1289,36559,3578749150,3578749150,0
2,1289,36560,3578749150,3578749150,0
2,1289,36561,3578749150,3578749150,0
2,1289,36562,3578749150,3578749151,1
2,1289,36563,3578749150,3578749153,3
2,1289,36564,3578749150,3578749154,4
2,1289,36565,3578749150,3578749155,5
2,1289,36566,3578749150,3578749155,5
2,1289,36567,3578749150,3578749156,6
2,1289,36568,3578749150,3578749156,6
2,1289,36569,3578749150,3578749159,9
2,1289,36570,3578749150,3578749160,10
2,1289,36571,3578749150,3578749161,11
2,1289,36572,3578749150,3578749161,11
2,1289,36573,3578749150,3578749164,14
2,1289,36574,3578749150,3578749164,14
2,1289,36575,3578749150,3578749165,15
2,1289,36576,3578749150,3578749165,15
2,1289,36577,3578749150,3578749166,16
2,1289,36578,3578749150,3578749167,17
2,1289,36579,3578749150,3578749167,17
2,1289,36580,3578749150,3578749168,18
2,1289,36581,3578749150,3578749169,19
2,1289,36582,3578749150,3578749171,21
2,1289,36583,3578749150,3578749172,22
2,1289,36584,3578749150,3578749172,22
2,1289,36585,3578749150,3578749173,23
2,1289,36586,3578749150,3578749174,24
2,1289,36587,3578749150,3578749175,25
2,1289,36588,3578749150,3578749176,26
2,1289,36589,3578749150,3578749176,26
2,1289,36590,3578749150,3578749176,26
2,1289,36591,3578749150,3578749177,27
2,1289,36592,3578749150,3578749178,28
2,1289,36593,3578749150,3578749179,29
2,1289,36594,3578749150,3578749179,29
2,1289,36595,3578749150,3578749180,30
2,1289,36596,3578749150,3578749181,31
2,1289,36597,3578749150,3578749181,31
2,1289,36598,3578749150,3578749182,32
2,1289,36599,3578749150,3578749183,33
2,1289,36600,3578749150,3578749184,34
2,1289,36601,3578749150,3578749184,34
2,1289,36602,3578749150,3578749185,35
2,1289,36603,3578749150,3578749189,39
2,1289,36604,3578749150,3578749189,39
2,1289,36605,3578749150,3578749190,40
2,1289,36606,3578749150,3578749190,40
2,1289,36607,3578749150,3578749191,41
2,1289,36608,3578749150,3578749192,42
2,1289,36609,3578749150,3578749192,42
2,1289,36610,3578749150,3578749193,43
2,1289,36611,3578749150,3578749193,43
2,1289,36612,3578749150,3578749194,44
2,1289,36613,3578749150,3578749194,44
2,1289,36614,3578749150,3578749194,44
2,1289,36615,3578749150,3578749195,45
2,1289,36616,3578749150,3578749199,49
2,1289,36617,3578749150,3578749199,49
2,1289,36618,3578749150,3578749200,50
2,1289,36619,3578749150,3578749200,50
2,1290,36620,3578749212,3578749212,0
2,1290,36621,3578749212,3578749212,0
2,1290,36622,3578749212,3578749212,0
2,1290,36623,3578749212,3578749212,0
2,1290,36624,3578749212,3578749212,0
2,1290,36625,3578749212,3578749212,0
2,1290,36626,3578749212,3578749213,1
2,1290,36627,3578749212,3578749214,2
2,1290,36628,3578749212,3578749215,3
2,1290,36629,3578749212,3578749215,3
2,1290,36630,3578749212,3578749216,4
2,1290,36631,3578749212,3578749217,5
2,1290,36632,3578749212,3578749219,7
2,1290,36633,3578749212,3578749219,7
2,1290,36634,3578749212,3578749220,8
2,1290,36635,3578749212,3578749220,8
2,1290,36636,3578749212,3578749221,9
2,1290,36637,3578749212,3578749222,10
2,1290,36638,3578749212,3578749222,10
2,1290,36639,3578749212,3578749224,12
2,1290,36640,3578749212,3578749227,15
2,1290,36641,3578749212,3578749227,15
2,1290,36642,3578749212,3578749227,15
2,1290,36643,3578749212,3578749227,15
2,1290,36644,3578749212,3578749229,17
2,1290,36645,3578749212,3578749229,17
2,1290,36646,3578749212,3578749230,18
2,1290,36647,3578749212,3578749231,19
2,1290,36648,3578749212,3578749231,19
2,1290,36649,3578749212,3578749232,20
2,1290,36650,3578749212,3578749232,20
2,1290,36651,3578749212,3578749233,21
2,1290,36652,3578749212,3578749233,21
2,1290,36653,3578749212,3578749236,24
2,1290,36654,3578749212,3578749237,25
2,1290,36655,3578749212,3578749237,25
2,1290,36656,3578749212,3578749237,25
2,1290,36657,3578749212,3578749237,25
2,1290,36658,3578749212,3578749237,25
2,1290,36659,3578749212,3578749238,26
2,1290,36660,3578749212,3578749239,27
2,1290,36661,3578749212,3578749239,27
2,1290,36662,3578749212,3578749239,27
2,1290,36663,3578749212,3578749239,27
2,1290,36664,3578749212,3578749240,28
2,1290,36665,3578749212,3578749240,28
2,1290,36666,3578749212,3578749241,29
2,1290,36667,3578749212,3578749242,30
2,1290,36668,3578749212,3578749244,32
2,1290,36669,3578749212,3578749245,33
2,1290,36670,3578749212,3578749245,33
2,1290,36671,3578749212,3578749246,34
2,1290,36672,3578749212,3578749246,34
2,1290,36673,3578749212,3578749249,37
2,1290,36674,3578749212,3578749250,38
2,1290,36675,3578749212,3578749251,39
2,1290,36676,3578749212,3578749252,40
2,1290,36677,3578749212,3578749252,40
2,1290,36678,3578749212,3578749253,41
2,1290,36679,3578749212,3578749253,41
2,1290,36680,3578749212,3578749254,42
2,1290,36681,3578749212,3578749255,43
2,1290,36682,3578749212,3578749255,43
2,1290,36683,3578749212,3578749255,43
2,1290,36684,3578749212,3578749256,44
2,1290,36685,3578749212,3578749256,44
2,1290,36686,3578749212,3578749257,45
2,1290,36687,3578749212,3578749257,45
2,1290,36688,3578749212,3578749260,48
2,1290,36689,3578749212,3578749260,48
2,1290,36690,3578749212,3578749260,48
2,1290,36691,3578749212,3578749261,49
2,1291,36692,3578749275,3578749275,0
2,1291,36693,3578749275,3578749275,0
2,1291,36694,3578749275,3578749275,0
2,1291,36695,3578749275,3578749275,0
2,1291,36696,3578749275,3578749275,0
2,1291,36697,3578749275,3578749275,0
2,1291,36698,3578749275,3578749275,0
2,1291,36699,3578749275,3578749275,0
2,1291,36700,3578749275,3578749275,0
2,1291,36701,3578749275,3578749276,1
2,1291,36702,3578749275,3578749279,4
2,1291,36703,3578749275,3578749279,4
2,1291,36704,3578749275,3578749281,6
2,1291,36705,3578749275,3578749282,7
2,1291,36706,3578749275,3578749282,7
2,1291,36707,3578749275,3578749283,8
2,1291,36708,3578749275,3578749284,9
2,1291,36709,3578749275,3578749284,9
2,1291,36710,3578749275,3578749284,9
2,1291,36711,3578749275,3578749285,10
2,1291,36712,3578749275,3578749285,10
2,1291,36713,3578749275,3578749288,13
2,1291,36714,3578749275,3578749288,13
2,1291,36715,3578749275,3578749290,15
2,1291,36716,3578749275,3578749290,15
2,1291,36717,3578749275,3578749290,15
2,1291,36718,3578749275,3578749291,16
2,1291,36719,3578749275,3578749291,16
2,1291,36720,3578749275,3578749292,17
2,1291,36721,3578749275,3578749293,18
2,1291,36722,3578749275,3578749294,19
2,1291,36723,3578749275,3578749294,19
2,1291,36724,3578749275,3578749294,19
2,1291,36725,3578749275,3578749294,19
2,1291,36726,3578749275,3578749296,21
2,1291,36727,3578749275,3578749296,21
2,1291,36728,3578749275,3578749297,22
2,1291,36729,3578749275,3578749297,22
2,1291,36730,3578749275,3578749297,22
2,1291,36731,3578749275,3578749299,24
2,1291,36732,3578749275,3578749299,24
2,1291,36733,3578749275,3578749299,24
2,1291,36734,3578749275,3578749300,25
2,1291,36735,3578749275,3578749300,25
2,1291,36736,3578749275,3578749301,26
2,1291,36737,3578749275,3578749303,28
2,1291,36738,3578749275,3578749303,28
2,1291,36739,3578749275,3578749304,29
2,1291,36740,3578749275,3578749304,29
2,1291,36741,3578749275,3578749308,33
2,1291,36742,3578749275,3578749309,34
2,1291,36743,3578749275,3578749310,35
2,1291,36744,3578749275,3578749312,37
2,1291,36745,3578749275,3578749312,37
2,1291,36746,3578749275,3578749312,37
2,1291,36747,3578749275,3578749313,38
2,1291,36748,3578749275,3578749314,39
2,1291,36749,3578749275,3578749314,39
2,1291,36750,3578749275,3578749315,40
2,1291,36751,3578749275,3578749317,42
2,1291,36752,3578749275,3578749317,42
2,1291,36753,3578749275,3578749317,42
2,1291,36754,3578749275,3578749318,43
2,1291,36755,3578749275,3578749318,43
2,1291,36756,3578749275,3578749319,44
2,1291,36757,3578749275,3578749319,44
2,1291,36758,3578749275,3578749319,44
2,1291,36759,3578749275,3578749322,47
2,1291,36760,3578749275,3578749322,47
2,1291,36761,3578749275,3578749322,47
2,1291,36762,3578749275,3578749322,47
2,1291,36763,3578749275,3578749322,47
2,1291,36764,3578749275,3578749322,47
2,1291,36765,3578749275,3578749324,49
2,1292,36766,3578749337,3578749337,0
2,1292,36767,3578749337,3578749337,0
2,1292,36768,3578749337,3578749337,0
2,1292,36769,3578749337,3578749337,0
2,1292,36770,3578749337,3578749337,0
2,1292,36771,3578749337,3578749337,0
2,1292,36772,3578749337,3578749337,0
2,1292,36773,3578749337,3578749337,0
2,1292,36774,3578749337,3578749337,0
2,1292,36775,3578749337,3578749337,0
2,1292,36776,3578749337,3578749337,0
2,1292,36777,3578749337,3578749337,0
2,1292,36778,3578749337,3578749337,0
2,1292,36779,3578749337,3578749337,0
2,1292,36780,3578749337,3578749337,0
2,1292,36781,3578749337,3578749337,0
2,1292,36782,3578749337,3578749338,1
2,1292,36783,3578749337,3578749338,1
2,1292,36784,3578749337,3578749338,1
2,1292,36785,3578749337,3578749341,4
2,1292,36786,3578749337,3578749341,4
2,1292,36787,3578749337,3578749341,4
2,1292,36788,3578749337,3578749341,4
2,1292,36789,3578749337,3578749343,6
2,1292,36790,3578749337,3578749343,6
2,1292,36791,3578749337,3578749343,6
2,1292,36792,3578749337,3578749344,7
2,1292,36793,3578749337,3578749349,12
2,1292,36794,3578749337,3578749350,13
2,1292,36795,3578749337,3578749351,14
2,1292,36796,3578749337,3578749354,17
2,1292,36797,3578749337,3578749354,17
2,1292,36798,3578749337,3578749355,18
2,1292,36799,3578749337,3578749355,18
2,1292,36800,3578749337,3578749356,19
2,1292,36801,3578749337,3578749357,20
2,1292,36802,3578749337,3578749359,22
2,1292,36803,3578749337,3578749360,23
2,1292,36804,3578749337,3578749362,25
2,1292,36805,3578749337,3578749362,25
2,1292,36806,3578749337,3578749363,26
2,1292,36807,3578749337,3578749365,28
2,1292,36808,3578749337,3578749365,28
2,1292,36809,3578749337,3578749366,29
2,1292,36810,3578749337,3578749367,30
2,1292,36811,3578749337,3578749367,30
2,1292,36812,3578749337,3578749368,31
2,1292,36813,3578749337,3578749368,31
2,1292,36814,3578749337,3578749370,33
2,1292,36815,3578749337,3578749372,35
2,1292,36816,3578749337,3578749372,35
2,1292,36817,3578749337,3578749372,35
2,1292,36818,3578749337,3578749374,37
2,1292,36819,3578749337,3578749375,38
2,1292,36820,3578749337,3578749376,39
2,1292,36821,3578749337,3578749376,39
2,1292,36822,3578749337,3578749376,39
2,1292,36823,3578749337,3578749377,40
2,1292,36824,3578749337,3578749378,41
2,1292,36825,3578749337,3578749379,42
2,1292,36826,3578749337,3578749380,43
2,1292,36827,3578749337,3578749381,44
2,1292,36828,3578749337,3578749382,45
2,1292,36829,3578749337,3578749383,46
2,1292,36830,3578749337,3578749383,46
2,1292,36831,3578749337,3578749384,47
2,1292,36832,3578749337,3578749384,47
2,1292,36833,3578749337,3578749385,48
2,1293,36834,3578749400,3578749400,0
2,1293,36835,3578749400,3578749400,0
2,1293,36836,3578749400,3578749400,0
2,1293,36837,3578749400,3578749400,0
2,1293,36838,3578749400,3578749400,0
2,1293,36839,3578749400,3578749400,0
2,1293,36840,3578749400,3578749400,0
2,1293,36841,3578749400,3578749400,0
2,1293,36842,3578749400,3578749400,0
2,1293,36843,3578749400,3578749400,0
2,1293,36844,3578749400,3578749400,0
2,1293,36845,3578749400,3578749400,0
2,1293,36846,3578749400,3578749400,0
2,1293,36847,3578749400,3578749400,0
2,1293,36848,3578749400,3578749400,0
2,1293,36849,3578749400,3578749400,0
2,1293,36850,3578749400,3578749400,0
2,1293,36851,3578749400,3578749403,3
2,1293,36852,3578749400,3578749404,4
2,1293,36853,3578749400,3578749405,5
2,1293,36854,3578749400,3578749405,5
2,1293,36855,3578749400,3578749406,6
2,1293,36856,3578749400,3578749408,8
2,1293,36857,3578749400,3578749411,11
2,1293,36858,3578749400,3578749413,13
2,1293,36859,3578749400,3578749414,14
2,1293,36860,3578749400,3578749414,14
2,1293,36861,3578749400,3578749415,15
2,1293,36862,3578749400,3578749417,17
2,1293,36863,3578749400,3578749417,17
2,1293,36864,3578749400,3578749418,18
2,1293,36865,3578749400,3578749419,19
2,1293,36866,3578749400,3578749419,19
2,1293,36867,3578749400,3578749420,20
2,1293,36868,3578749400,3578749420,20
2,1293,36869,3578749400,3578749421,21
2,1293,36870,3578749400,3578749421,21
2,1293,36871,3578749400,3578749423,23
2,1293,36872,3578749400,3578749424,24
2,1293,36873,3578749400,3578749427,27
2,1293,36874,3578749400,3578749427,27
2,1293,36875,3578749400,3578749428,28
2,1293,36876,3578749400,3578749430,30
2,1293,36877,3578749400,3578749430,30
2,1293,36878,3578749400,3578749430,30
2,1293,36879,3578749400,3578749431,31
2,1293,36880,3578749400,3578749432,32
2,1293,36881,3578749400,3578749432,32
2,1293,36882,3578749400,3578749432,32
2,1293,36883,3578749400,3578749433,33
2,1293,36884,3578749400,3578749433,33
2,1293,36885,3578749400,3578749435,35
2,1293,36886,3578749400,3578749437,37
2,1293,36887,3578749400,3578749437,37
2,1293,36888,3578749400,3578749437,37
2,1293,36889,3578749400,3578749438,38
2,1293,36890,3578749400,3578749438,38
2,1293,36891,3578749400,3578749438,38
2,1293,36892,3578749400,3578749439,39
2,1293,36893,3578749400,3578749439,39
2,1293,36894,3578749400,3578749439,39
2,1293,36895,3578749400,3578749440,40
2,1293,36896,3578749400,3578749441,41
2,1293,36897,3578749400,3578749441,41
2,1293,36898,3578749400,3578749442,42
2,1293,36899,3578749400,3578749444,44
2,1293,36900,3578749400,3578749444,44
2,1293,36901,3578749400,3578749445,45
2,1293,36902,3578749400,3578749445,45
2,1293,36903,3578749400,3578749445,45
2,1293,36904,3578749400,3578749447,47
2,1293,36905,3578749400,3578749447,47
2,1293,36906,3578749400,3578749448,48
2,1293,36907,3578749400,3578749449,49
2,1294,36908,3578749463,3578749463,0
2,1294,36909,3578749463,3578749463,0
2,1294,36910,3578749463,3578749463,0
2,1294,36911,3578749463,3578749463,0
2,1294,36912,3578749463,3578749463,0
2,1294,36913,3578749463,3578749463,0
2,1294,36914,3578749463,3578749463,0
2,1294,36915,3578749463,3578749463,0
2,1294,36916,3578749463,3578749463,0
2,1294,36917,3578749463,3578749463,0
2,1294,36918,3578749463,3578749463,0
2,1294,36919,3578749463,3578749463,0
2,1294,36920,3578749463,3578749463,0
2,1294,36921,3578749463,3578749463,0
2,1294,36922,3578749463,3578749463,0
2,1294,36923,3578749463,3578749463,0
2,1294,36924,3578749463,3578749463,0
2,1294,36925,3578749463,3578749465,2
2,1294,36926,3578749463,3578749466,3
2,1294,36927,3578749463,3578749467,4
2,1294,36928,3578749463,3578749468,5
2,1294,36929,3578749463,3578749468,5
2,1294,36930,3578749463,3578749468,5
2,1294,36931,3578749463,3578749469,6
2,1294,36932,3578749463,3578749473,10
2,1294,36933,3578749463,3578749475,12
2,1294,36934,3578749463,3578749477,14
2,1294,36935,3578749463,3578749479,16
2,1294,36936,3578749463,3578749479,16
2,1294,36937,3578749463,3578749480,17
2,1294,36938,3578749463,3578749481,18
2,1294,36939,3578749463,3578749482,19
2,1294,36940,3578749463,3578749482,19
2,1294,36941,3578749463,3578749482,19
2,1294,36942,3578749463,3578749483,20
2,1294,36943,3578749463,3578749484,21
2,1294,36944,3578749463,3578749484,21
2,1294,36945,3578749463,3578749484,21
2,1294,36946,3578749463,3578749485,22
2,1294,36947,3578749463,3578749485,22
2,1294,36948,3578749463,3578749487,24
2,1294,36949,3578749463,3578749488,25
2,1294,36950,3578749463,3578749489,26
2,1294,36951,3578749463,3578749489,26
2,1294,36952,3578749463,3578749489,26
2,1294,36953,3578749463,3578749490,27
2,1294,36954,3578749463,3578749491,28
2,1294,36955,3578749463,3578749491,28
2,1294,36956,3578749463,3578749492,29
2,1294,36957,3578749463,3578749494,31
2,1294,36958,3578749463,3578749494,31
2,1294,36959,3578749463,3578749494,31
2,1294,36960,3578749463,3578749495,32
2,1294,36961,3578749463,3578749496,33
2,1294,36962,3578749463,3578749496,33
2,1294,36963,3578749463,3578749496,33
2,1294,36964,3578749463,3578749496,33
2,1294,36965,3578749463,3578749498,35
2,1294,36966,3578749463,3578749499,36
2,1294,36967,3578749463,3578749499,36
2,1294,36968,3578749463,3578749499,36
2,1294,36969,3578749463,3578749500,37
2,1294,36970,3578749463,3578749500,37
2,1294,36971,3578749463,3578749501,38
2,1294,36972,3578749463,3578749503,40
2,1294,36973,3578749463,3578749503,40
2,1294,36974,3578749463,3578749504,41
2,1294,36975,3578749463,3578749505,42
2,1294,36976,3578749463,3578749507,44
2,1294,36977,3578749463,3578749508,45
2,1294,36978,3578749463,3578749510,47
2,1294,36979,3578749463,3578749512,49
2,1294,36980,3578749463,3578749512,49
2,1294,36981,3578749463,3578749512,49
2,1294,36982,3578749463,3578749512,49
2,1294,36983,3578749463,3578749513,50
2,1295,36984,3578749525,3578749525,0
2,1295,36985,3578749525,3578749525,0
2,1295,36986,3578749525,3578749525,0
2,1295,36987,3578749525,3578749525,0
2,1295,36988,3578749525,3578749525,0
2,1295,36989,3578749525,3578749525,0
2,1295,36990,3578749525,3578749525,0
2,1295,36991,3578749525,3578749525,0
2,1295,36992,3578749525,3578749525,0
2,1295,36993,3578749525,3578749525,0
2,1295,36994,3578749525,3578749525,0
2,1295,36995,3578749525,3578749525,0
2,1295,36996,3578749525,3578749525,0
2,1295,36997,3578749525,3578749525,0
2,1295,36998,3578749525,3578749525,0
2,1295,36999,3578749525,3578749525,0
2,1295,37000,3578749525,3578749525,0
2,1295,37001,3578749525,3578749525,0
2,1295,37002,3578749525,3578749525,0
2,1295,37003,3578749525,3578749525,0
2,1295,37004,3578749525,3578749525,0
2,1295,37005,3578749525,3578749525,0
2,1295,37006,3578749525,3578749525,0
2,1295,37007,3578749525,3578749526,1
2,1295,37008,3578749525,3578749527,2
2,1295,37009,3578749525,3578749527,2
2,1295,37010,3578749525,3578749529,4
2,1295,37011,3578749525,3578749530,5
2,1295,37012,3578749525,3578749532,7
2,1295,37013,3578749525,3578749533,8
2,1295,37014,3578749525,3578749533,8
2,1295,37015,3578749525,3578749534,9
2,1295,37016,3578749525,3578749534,9
2,1295,37017,3578749525,3578749534,9
2,1295,37018,3578749525,3578749535,10
2,1295,37019,3578749525,3578749537,12
2,1295,37020,3578749525,3578749537,12
2,1295,37021,3578749525,3578749537,12
2,1295,37022,3578749525,3578749537,12
2,1295,37023,3578749525,3578749538,13
2,1295,37024,3578749525,3578749539,14
2,1295,37025,3578749525,3578749540,15
2,1295,37026,3578749525,3578749540,15
2,1295,37027,3578749525,3578749541,16
2,1295,37028,3578749525,3578749542,17
2,1295,37029,3578749525,3578749542,17
2,1295,37030,3578749525,3578749543,18
2,1295,37031,3578749525,3578749544,19
2,1295,37032,3578749525,3578749547,22
2,1295,37033,3578749525,3578749548,23
2,1295,37034,3578749525,3578749549,24
2,1295,37035,3578749525,3578749550,25
2,1295,37036,3578749525,3578749553,28
2,1295,37037,3578749525,3578749554,29
2,1295,37038,3578749525,3578749555,30
2,1295,37039,3578749525,3578749555,30
2,1295,37040,3578749525,3578749555,30
2,1295,37041,3578749525,3578749555,30
2,1295,37042,3578749525,3578749558,33
2,1295,37043,3578749525,3578749559,34
2,1295,37044,3578749525,3578749560,35
2,1295,37045,3578749525,3578749560,35
2,1295,37046,3578749525,3578749562,37
2,1295,37047,3578749525,3578749563,38
2,1295,37048,3578749525,3578749563,38
2,1295,37049,3578749525,3578749565,40
2,1295,37050,3578749525,3578749565,40
2,1295,37051,3578749525,3578749565,40
2,1295,37052,3578749525,3578749566,41
2,1295,37053,3578749525,3578749567,42
2,1295,37054,3578749525,3578749567,42
2,1295,37055,3578749525,3578749570,45
2,1295,37056,3578749525,3578749571,46
2,1295,37057,3578749525,3578749572,47
2,1295,37058,3578749525,3578749575,50
2,1296,37059,3578749588,3578749588,0
2,1296,37060,3578749588,3578749588,0
2,1296,37061,3578749588,3578749588,0
2,1296,37062,3578749588,3578749588,0
2,1296,37063,3578749588,3578749588,0
2,1296,37064,3578749588,3578749588,0
2,1296,37065,3578749588,3578749588,0
2,1296,37066,3578749588,3578749588,0
2,1296,37067,3578749588,3578749588,0
2,1296,37068,3578749588,3578749588,0
2,1296,37069,3578749588,3578749588,0
2,1296,37070,3578749588,3578749588,0
2,1296,37071,3578749588,3578749588,0
2,1296,37072,3578749588,3578749588,0
2,1296,37073,3578749588,3578749589,1
2,1296,37074,3578749588,3578749590,2
2,1296,37075,3578749588,3578749590,2
2,1296,37076,3578749588,3578749590,2
2,1296,37077,3578749588,3578749592,4
2,1296,37078,3578749588,3578749592,4
2,1296,37079,3578749588,3578749593,5
2,1296,37080,3578749588,3578749593,5
2,1296,37081,3578749588,3578749593,5
2,1296,37082,3578749588,3578749594,6
2,1296,37083,3578749588,3578749595,7
2,1296,37084,3578749588,3578749598,10
2,1296,37085,3578749588,3578749598,10
2,1296,37086,3578749588,3578749599,11
2,1296,37087,3578749588,3578749599,11
2,1296,37088,3578749588,3578749602,14
2,1296,37089,3578749588,3578749603,15
2,1296,37090,3578749588,3578749604,16
2,1296,37091,3578749588,3578749604,16
2,1296,37092,3578749588,3578749606,18
2,1296,37093,3578749588,3578749607,19
2,1296,37094,3578749588,3578749610,22
2,1296,37095,3578749588,3578749611,23
2,1296,37096,3578749588,3578749612,24
2,1296,37097,3578749588,3578749613,25
2,1296,37098,3578749588,3578749613,25
2,1296,37099,3578749588,3578749613,25
2,1296,37100,3578749588,3578749614,26
2,1296,37101,3578749588,3578749616,28
2,1296,37102,3578749588,3578749617,29
2,1296,37103,3578749588,3578749617,29
2,1296,37104,3578749588,3578749619,31
2,1296,37105,3578749588,3578749619,31
2,1296,37106,3578749588,3578749619,31
2,1296,37107,3578749588,3578749620,32
2,1296,37108,3578749588,3578749620,32
2,1296,37109,3578749588,3578749622,34
2,1296,37110,3578749588,3578749624,36
2,1296,37111,3578749588,3578749624,36
2,1296,37112,3578749588,3578749626,38
2,1296,37113,3578749588,3578749626,38
2,1296,37114,3578749588,3578749626,38
2,1296,37115,3578749588,3578749626,38
2,1296,37116,3578749588,3578749628,40
2,1296,37117,3578749588,3578749629,41
2,1296,37118,3578749588,3578749629,41
2,1296,37119,3578749588,3578749630,42
2,1296,37120,3578749588,3578749630,42
2,1296,37121,3578749588,3578749631,43
2,1296,37122,3578749588,3578749632,44
2,1296,37123,3578749588,3578749633,45
2,1296,37124,3578749588,3578749635,47
2,1296,37125,3578749588,3578749636,48
2,1296,37126,3578749588,3578749636,48
2,1296,37127,3578749588,3578749636,48
2,1296,37128,3578749588,3578749637,49
2,1296,37129,3578749588,3578749637,49
2,1296,37130,3578749588,3578749638,50
2,1297,37131,3578749651,3578749651,0
2,1297,37132,3578749651,3578749651,0
2,1297,37133,3578749651,3578749651,0
2,1297,37134,3578749651,3578749651,0
2,1297,37135,3578749651,3578749651,0
2,1297,37136,3578749651,3578749651,0
2,1297,37137,3578749651,3578749651,0
2,1297,37138,3578749651,3578749651,0
2,1297,37139,3578749651,3578749651,0
2,1297,37140,3578749651,3578749651,0
2,1297,37141,3578749651,3578749651,0
2,1297,37142,3578749651,3578749651,0
2,1297,37143,3578749651,3578749651,0
2,1297,37144,3578749651,3578749651,0
2,1297,37145,3578749651,3578749651,0
2,1297,37146,3578749651,3578749651,0
2,1297,37147,3578749651,3578749651,0
2,1297,37148,3578749651,3578749652,1
2,1297,37149,3578749651,3578749653,2
2,1297,37150,3578749651,3578749654,3
2,1297,37151,3578749651,3578749654,3
2,1297,37152,3578749651,3578749656,5
2,1297,37153,3578749651,3578749656,5
2,1297,37154,3578749651,3578749657,6
2,1297,37155,3578749651,3578749657,6
2,1297,37156,3578749651,3578749658,7
2,1297,37157,3578749651,3578749658,7
2,1297,37158,3578749651,3578749659,8
2,1297,37159,3578749651,3578749659,8
2,1297,37160,3578749651,3578749665,14
2,1297,37161,3578749651,3578749665,14
2,1297,37162,3578749651,3578749666,15
2,1297,37163,3578749651,3578749667,16
2,1297,37164,3578749651,3578749667,16
2,1297,37165,3578749651,3578749667,16
2,1297,37166,3578749651,3578749670,19
2,1297,37167,3578749651,3578749672,21
2,1297,37168,3578749651,3578749674,23
2,1297,37169,3578749651,3578749677,26
2,1297,37170,3578749651,3578749679,28
2,1297,37171,3578749651,3578749679,28
2,1297,37172,3578749651,3578749680,29
2,1297,37173,3578749651,3578749681,30
2,1297,37174,3578749651,3578749681,30
2,1297,37175,3578749651,3578749682,31
2,1297,37176,3578749651,3578749683,32
2,1297,37177,3578749651,3578749683,32
2,1297,37178,3578749651,3578749684,33
2,1297,37179,3578749651,3578749684,33
2,1297,37180,3578749651,3578749684,33
2,1297,37181,3578749651,3578749685,34
2,1297,37182,3578749651,3578749685,34
2,1297,37183,3578749651,3578749687,36
2,1297,37184,3578749651,3578749687,36
2,1297,37185,3578749651,3578749688,37
2,1297,37186,3578749651,3578749689,38
2,1297,37187,3578749651,3578749690,39
2,1297,37188,3578749651,3578749691,40
2,1297,37189,3578749651,3578749692,41
2,1297,37190,3578749651,3578749692,41
2,1297,37191,3578749651,3578749692,41
2,1297,37192,3578749651,3578749694,43
2,1297,37193,3578749651,3578749694,43
2,1297,37194,3578749651,3578749694,43
2,1297,37195,3578749651,3578749695,44
2,1297,37196,3578749651,3578749696,45
2,1297,37197,3578749651,3578749696,45
2,1297,37198,3578749651,3578749696,45
2,1297,37199,3578749651,3578749697,46
2,1297,37200,3578749651,3578749698,47
2,1297,37201,3578749651,3578749698,47
2,1297,37202,3578749651,3578749699,48
2,1297,37203,3578749651,3578749699,48
2,1297,37204,3578749651,3578749700,49
2,1297,37205,3578749651,3578749701,50
2,1297,37206,3578749651,3578749701,50
2,1298,37207,3578749713,3578749713,0
2,1298,37208,3578749713,3578749713,0
2,1298,37209,3578749713,3578749713,0
2,1298,37210,3578749713,3578749713,0
2,1298,37211,3578749713,3578749713,0
2,1298,37212,3578749713,3578749713,0
2,1298,37213,3578749713,3578749713,0
2,1298,37214,3578749713,3578749713,0
2,1298,37215,3578749713,3578749713,0
2,1298,37216,3578749713,3578749713,0
2,1298,37217,3578749713,3578749713,0
2,1298,37218,3578749713,3578749713,0
2,1298,37219,3578749713,3578749714,1
2,1298,37220,3578749713,3578749714,1
2,1298,37221,3578749713,3578749715,2
2,1298,37222,3578749713,3578749716,3
2,1298,37223,3578749713,3578749716,3
2,1298,37224,3578749713,3578749717,4
2,1298,37225,3578749713,3578749717,4
2,1298,37226,3578749713,3578749717,4
2,1298,37227,3578749713,3578749718,5
2,1298,37228,3578749713,3578749719,6
2,1298,37229,3578749713,3578749719,6
2,1298,37230,3578749713,3578749720,7
2,1298,37231,3578749713,3578749721,8
2,1298,37232,3578749713,3578749721,8
2,1298,37233,3578749713,3578749722,9
2,1298,37234,3578749713,3578749722,9
2,1298,37235,3578749713,3578749722,9
2,1298,37236,3578749713,3578749723,10
2,1298,37237,3578749713,3578749724,11
2,1298,37238,3578749713,3578749725,12
2,1298,37239,3578749713,3578749725,12
2,1298,37240,3578749713,3578749725,12
2,1298,37241,3578749713,3578749726,13
2,1298,37242,3578749713,3578749727,14
2,1298,37243,3578749713,3578749727,14
2,1298,37244,3578749713,3578749729,16
2,1298,37245,3578749713,3578749730,17
2,1298,37246,3578749713,3578749733,20
2,1298,37247,3578749713,3578749733,20
2,1298,37248,3578749713,3578749733,20
2,1298,37249,3578749713,3578749734,21
2,1298,37250,3578749713,3578749735,22
2,1298,37251,3578749713,3578749735,22
2,1298,37252,3578749713,3578749737,24
2,1298,37253,3578749713,3578749737,24
2,1298,37254,3578749713,3578749738,25
2,1298,37255,3578749713,3578749738,25
2,1298,37256,3578749713,3578749738,25
2,1298,37257,3578749713,3578749740,27
2,1298,37258,3578749713,3578749740,27
2,1298,37259,3578749713,3578749741,28
2,1298,37260,3578749713,3578749741,28
2,1298,37261,3578749713,3578749742,29
2,1298,37262,3578749713,3578749742,29
2,1298,37263,3578749713,3578749742,29
2,1298,37264,3578749713,3578749743,30
2,1298,37265,3578749713,3578749743,30
2,1298,37266,3578749713,3578749748,35
2,1298,37267,3578749713,3578749748,35
2,1298,37268,3578749713,3578749749,36
2,1298,37269,3578749713,3578749749,36
2,1298,37270,3578749713,3578749749,36
2,1298,37271,3578749713,3578749753,40
2,1298,37272,3578749713,3578749754,41
2,1298,37273,3578749713,3578749754,41
2,1298,37274,3578749713,3578749755,42
2,1298,37275,3578749713,3578749756,43
2,1298,37276,3578749713,3578749756,43
2,1298,37277,3578749713,3578749757,44
2,1298,37278,3578749713,3578749758,45
2,1298,37279,3578749713,3578749759,46
2,1298,37280,3578749713,3578749760,47
2,1298,37281,3578749713,3578749761,48
2,1298,37282,3578749713,3578749761,48
2,1298,37283,3578749713,3578749763,50
2,1299,37284,3578749776,3578749776,0
2,1299,37285,3578749776,3578749776,0
2,1299,37286,3578749776,3578749776,0
2,1299,37287,3578749776,3578749776,0
2,1299,37288,3578749776,3578749776,0
2,1299,37289,3578749776,3578749776,0
2,1299,37290,3578749776,3578749776,0
2,1299,37291,3578749776,3578749776,0
2,1299,37292,3578749776,3578749776,0
2,1299,37293,3578749776,3578749776,0
2,1299,37294,3578749776,3578749776,0
2,1299,37295,3578749776,3578749776,0
2,1299,37296,3578749776,3578749776,0
2,1299,37297,3578749776,3578749776,0
2,1299,37298,3578749776,3578749776,0
2,1299,37299,3578749776,3578749776,0
2,1299,37300,3578749776,3578749776,0
2,1299,37301,3578749776,3578749776,0
2,1299,37302,3578749776,3578749777,1
2,1299,37303,3578749776,3578749778,2
2,1299,37304,3578749776,3578749778,2
2,1299,37305,3578749776,3578749778,2
2,1299,37306,3578749776,3578749779,3
2,1299,37307,3578749776,3578749780,4
2,1299,37308,3578749776,3578749780,4
2,1299,37309,3578749776,3578749781,5
2,1299,37310,3578749776,3578749782,6
2,1299,37311,3578749776,3578749783,7
2,1299,37312,3578749776,3578749785,9
2,1299,37313,3578749776,3578749785,9
2,1299,37314,3578749776,3578749788,12
2,1299,37315,3578749776,3578749789,13
2,1299,37316,3578749776,3578749789,13
2,1299,37317,3578749776,3578749790,14
2,1299,37318,3578749776,3578749791,15
2,1299,37319,3578749776,3578749791,15
2,1299,37320,3578749776,3578749792,16
2,1299,37321,3578749776,3578749792,16
2,1299,37322,3578749776,3578749792,16
2,1299,37323,3578749776,3578749793,17
2,1299,37324,3578749776,3578749793,17
2,1299,37325,3578749776,3578749794,18
2,1299,37326,3578749776,3578749794,18
2,1299,37327,3578749776,3578749798,22
2,1299,37328,3578749776,3578749798,22
2,1299,37329,3578749776,3578749799,23
2,1299,37330,3578749776,3578749799,23
2,1299,37331,3578749776,3578749802,26
2,1299,37332,3578749776,3578749803,27
2,1299,37333,3578749776,3578749803,27
2,1299,37334,3578749776,3578749804,28
2,1299,37335,3578749776,3578749806,30
2,1299,37336,3578749776,3578749808,32
2,1299,37337,3578749776,3578749811,35
2,1299,37338,3578749776,3578749811,35
2,1299,37339,3578749776,3578749813,37
2,1299,37340,3578749776,3578749813,37
2,1299,37341,3578749776,3578749813,37
2,1299,37342,3578749776,3578749813,37
2,1299,37343,3578749776,3578749814,38
2,1299,37344,3578749776,3578749816,40
2,1299,37345,3578749776,3578749817,41
2,1299,37346,3578749776,3578749817,41
2,1299,37347,3578749776,3578749817,41
2,1299,37348,3578749776,3578749819,43
2,1299,37349,3578749776,3578749819,43
2,1299,37350,3578749776,3578749820,44
2,1299,37351,3578749776,3578749821,45
2,1299,37352,3578749776,3578749822,46
2,1299,37353,3578749776,3578749824,48
2,1299,37354,3578749776,3578749825,49
2,1299,37355,3578749776,3578749825,49
2,1299,37356,3578749776,3578749825,49
2,1299,37357,3578749776,3578749826,50
2,1300,37358,3578749837,3578749838,1
2,1300,37359,3578749837,3578749838,1
2,1300,37360,3578749837,3578749838,1
2,1300,37361,3578749837,3578749838,1
2,1300,37362,3578749837,3578749838,1
2,1300,37363,3578749837,3578749838,1
2,1300,37364,3578749837,3578749838,1
2,1300,37365,3578749837,3578749838,1
2,1300,37366,3578749837,3578749838,1
2,1300,37367,3578749837,3578749838,1
2,1300,37368,3578749837,3578749838,1
2,1300,37369,3578749837,3578749838,1
2,1300,37370,3578749837,3578749838,1
2,1300,37371,3578749837,3578749838,1
2,1300,37372,3578749837,3578749838,1
2,1300,37373,3578749837,3578749838,1
2,1300,37374,3578749837,3578749838,1
2,1300,37375,3578749837,3578749838,1
2,1300,37376,3578749837,3578749838,1
2,1300,37377,3578749837,3578749838,1
2,1300,37378,3578749837,3578749839,2
2,1300,37379,3578749837,3578749841,4
2,1300,37380,3578749837,3578749841,4
2,1300,37381,3578749837,3578749841,4
2,1300,37382,3578749837,3578749843,6
2,1300,37383,3578749837,3578749844,7
2,1300,37384,3578749837,3578749845,8
2,1300,37385,3578749837,3578749845,8
2,1300,37386,3578749837,3578749845,8
2,1300,37387,3578749837,3578749846,9
2,1300,37388,3578749837,3578749846,9
2,1300,37389,3578749837,3578749848,11
2,1300,37390,3578749837,3578749849,12
2,1300,37391,3578749837,3578749850,13
2,1300,37392,3578749837,3578749851,14
2,1300,37393,3578749837,3578749853,16
2,1300,37394,3578749837,3578749853,16
2,1300,37395,3578749837,3578749853,16
2,1300,37396,3578749837,3578749854,17
2,1300,37397,3578749837,3578749855,18
2,1300,37398,3578749837,3578749857,20
2,1300,37399,3578749837,3578749857,20
2,1300,37400,3578749837,3578749857,20
2,1300,37401,3578749837,3578749857,20
2,1300,37402,3578749837,3578749858,21
2,1300,37403,3578749837,3578749859,22
2,1300,37404,3578749837,3578749860,23
2,1300,37405,3578749837,3578749860,23
2,1300,37406,3578749837,3578749861,24
2,1300,37407,3578749837,3578749865,28
2,1300,37408,3578749837,3578749866,29
2,1300,37409,3578749837,3578749866,29
2,1300,37410,3578749837,3578749867,30
2,1300,37411,3578749837,3578749867,30
2,1300,37412,3578749837,3578749870,33
2,1300,37413,3578749837,3578749875,38
2,1300,37414,3578749837,3578749876,39
2,1300,37415,3578749837,3578749879,42
2,1300,37416,3578749837,3578749880,43
2,1300,37417,3578749837,3578749880,43
2,1300,37418,3578749837,3578749881,44
2,1300,37419,3578749837,3578749882,45
2,1300,37420,3578749837,3578749883,46
2,1300,37421,3578749837,3578749883,46
2,1300,37422,3578749837,3578749884,47
2,1300,37423,3578749837,3578749884,47
2,1300,37424,3578749837,3578749885,48
2,1300,37425,3578749837,3578749885,48
2,1300,37426,3578749837,3578749885,48
2,1300,37427,3578749837,3578749886,49
2,1301,37428,3578749898,3578749898,0
2,1301,37429,3578749898,3578749898,0
2,1301,37430,3578749898,3578749898,0
2,1301,37431,3578749898,3578749898,0
2,1301,37432,3578749898,3578749898,0
2,1301,37433,3578749898,3578749898,0
2,1301,37434,3578749898,3578749898,0
2,1301,37435,3578749898,3578749898,0
2,1301,37436,3578749898,3578749898,0
2,1301,37437,3578749898,3578749898,0
2,1301,37438,3578749898,3578749898,0
2,1301,37439,3578749898,3578749898,0
2,1301,37440,3578749898,3578749898,0
2,1301,37441,3578749898,3578749898,0
2,1301,37442,3578749898,3578749898,0
2,1301,37443,3578749898,3578749898,0
2,1301,37444,3578749898,3578749899,1
2,1301,37445,3578749898,3578749900,2
2,1301,37446,3578749898,3578749900,2
2,1301,37447,3578749898,3578749901,3
2,1301,37448,3578749898,3578749901,3
2,1301,37449,3578749898,3578749902,4
2,1301,37450,3578749898,3578749903,5
2,1301,37451,3578749898,3578749904,6
2,1301,37452,3578749898,3578749905,7
2,1301,37453,3578749898,3578749906,8
2,1301,37454,3578749898,3578749907,9
2,1301,37455,3578749898,3578749908,10
2,1301,37456,3578749898,3578749910,12
2,1301,37457,3578749898,3578749911,13
2,1301,37458,3578749898,3578749912,14
2,1301,37459,3578749898,3578749912,14
2,1301,37460,3578749898,3578749913,15
2,1301,37461,3578749898,3578749913,15
2,1301,37462,3578749898,3578749913,15
2,1301,37463,3578749898,3578749914,16
2,1301,37464,3578749898,3578749914,16
2,1301,37465,3578749898,3578749915,17
2,1301,37466,3578749898,3578749916,18
2,1301,37467,3578749898,3578749916,18
2,1301,37468,3578749898,3578749917,19
2,1301,37469,3578749898,3578749917,19
2,1301,37470,3578749898,3578749917,19
2,1301,37471,3578749898,3578749917,19
2,1301,37472,3578749898,3578749918,20
2,1301,37473,3578749898,3578749919,21
2,1301,37474,3578749898,3578749919,21
2,1301,37475,3578749898,3578749919,21
2,1301,37476,3578749898,3578749920,22
2,1301,37477,3578749898,3578749921,23
2,1301,37478,3578749898,3578749921,23
2,1301,37479,3578749898,3578749922,24
2,1301,37480,3578749898,3578749922,24
2,1301,37481,3578749898,3578749922,24
2,1301,37482,3578749898,3578749922,24
2,1301,37483,3578749898,3578749922,24
2,1301,37484,3578749898,3578749924,26
2,1301,37485,3578749898,3578749925,27
2,1301,37486,3578749898,3578749926,28
2,1301,37487,3578749898,3578749926,28
2,1301,37488,3578749898,3578749926,28
2,1301,37489,3578749898,3578749927,29
2,1301,37490,3578749898,3578749928,30
2,1301,37491,3578749898,3578749931,33
2,1301,37492,3578749898,3578749933,35
2,1301,37493,3578749898,3578749933,35
2,1301,37494,3578749898,3578749933,35
2,1301,37495,3578749898,3578749934,36
2,1301,37496,3578749898,3578749935,37
2,1301,37497,3578749898,3578749935,37
2,1301,37498,3578749898,3578749936,38
2,1301,37499,3578749898,3578749937,39
2,1301,37500,3578749898,3578749937,39
2,1301,37501,3578749898,3578749938,40
2,1301,37502,3578749898,3578749938,40
2,1301,37503,3578749898,3578749938,40
2,1301,37504,3578749898,3578749939,41
2,1301,37505,3578749898,3578749940,42
2,1301,37506,3578749898,3578749940,42
2,1301,37507,3578749898,3578749941,43
2,1301,37508,3578749898,3578749942,44
2,1301,37509,3578749898,3578749942,44
2,1301,37510,3578749898,3578749943,45
2,1301,37511,3578749898,3578749943,45
2,1301,37512,3578749898,3578749943,45
2,1301,37513,3578749898,3578749944,46
2,1301,37514,3578749898,3578749947,49
2,1301,37515,3578749898,3578749948,50
2,1302,37516,3578749961,3578749961,0
2,1302,37517,3578749961,3578749961,0
2,1302,37518,3578749961,3578749961,0
2,1302,37519,3578749961,3578749961,0
2,1302,37520,3578749961,3578749961,0
2,1302,37521,3578749961,3578749961,0
2,1302,37522,3578749961,3578749961,0
2,1302,37523,3578749961,3578749961,0
2,1302,37524,3578749961,3578749961,0
2,1302,37525,3578749961,3578749961,0
2,1302,37526,3578749961,3578749961,0
2,1302,37527,3578749961,3578749961,0
2,1302,37528,3578749961,3578749961,0
2,1302,37529,3578749961,3578749961,0
2,1302,37530,3578749961,3578749961,0
2,1302,37531,3578749961,3578749961,0
2,1302,37532,3578749961,3578749963,2
2,1302,37533,3578749961,3578749964,3
2,1302,37534,3578749961,3578749964,3
2,1302,37535,3578749961,3578749965,4
2,1302,37536,3578749961,3578749965,4
2,1302,37537,3578749961,3578749966,5
2,1302,37538,3578749961,3578749966,5
2,1302,37539,3578749961,3578749967,6
2,1302,37540,3578749961,3578749967,6
2,1302,37541,3578749961,3578749969,8
2,1302,37542,3578749961,3578749972,11
2,1302,37543,3578749961,3578749972,11
2,1302,37544,3578749961,3578749972,11
2,1302,37545,3578749961,3578749972,11
2,1302,37546,3578749961,3578749975,14
2,1302,37547,3578749961,3578749975,14
2,1302,37548,3578749961,3578749975,14
2,1302,37549,3578749961,3578749975,14
2,1302,37550,3578749961,3578749977,16
2,1302,37551,3578749961,3578749977,16
2,1302,37552,3578749961,3578749978,17
2,1302,37553,3578749961,3578749978,17
2,1302,37554,3578749961,3578749979,18
2,1302,37555,3578749961,3578749980,19
2,1302,37556,3578749961,3578749980,19
2,1302,37557,3578749961,3578749981,20
2,1302,37558,3578749961,3578749981,20
2,1302,37559,3578749961,3578749982,21
2,1302,37560,3578749961,3578749985,24
2,1302,37561,3578749961,3578749985,24
2,1302,37562,3578749961,3578749988,27
2,1302,37563,3578749961,3578749989,28
2,1302,37564,3578749961,3578749990,29
2,1302,37565,3578749961,3578749991,30
2,1302,37566,3578749961,3578749991,30
2,1302,37567,3578749961,3578749992,31
2,1302,37568,3578749961,3578749993,32
2,1302,37569,3578749961,3578749993,32
2,1302,37570,3578749961,3578749994,33
2,1302,37571,3578749961,3578749994,33
2,1302,37572,3578749961,3578749995,34
2,1302,37573,3578749961,3578749998,37
2,1302,37574,3578749961,3578749999,38
2,1302,37575,3578749961,3578750000,39
2,1302,37576,3578749961,3578750002,41
2,1302,37577,3578749961,3578750003,42
2,1302,37578,3578749961,3578750003,42
2,1302,37579,3578749961,3578750004,43
2,1302,37580,3578749961,3578750006,45
2,1302,37581,3578749961,3578750007,46
2,1302,37582,3578749961,3578750011,50
2,1303,37583,3578750024,3578750024,0
2,1303,37584,3578750024,3578750024,0
2,1303,37585,3578750024,3578750024,0
2,1303,37586,3578750024,3578750024,0
2,1303,37587,3578750024,3578750024,0
2,1303,37588,3578750024,3578750024,0
2,1303,37589,3578750024,3578750024,0
2,1303,37590,3578750024,3578750024,0
2,1303,37591,3578750024,3578750024,0
2,1303,37592,3578750024,3578750024,0
2,1303,37593,3578750024,3578750024,0
2,1303,37594,3578750024,3578750024,0
2,1303,37595,3578750024,3578750024,0
2,1303,37596,3578750024,3578750024,0
2,1303,37597,3578750024,3578750025,1
2,1303,37598,3578750024,3578750025,1
2,1303,37599,3578750024,3578750026,2
2,1303,37600,3578750024,3578750026,2
2,1303,37601,3578750024,3578750026,2
2,1303,37602,3578750024,3578750029,5
2,1303,37603,3578750024,3578750030,6
2,1303,37604,3578750024,3578750030,6
2,1303,37605,3578750024,3578750032,8
2,1303,37606,3578750024,3578750032,8
2,1303,37607,3578750024,3578750033,9
2,1303,37608,3578750024,3578750033,9
2,1303,37609,3578750024,3578750036,12
2,1303,37610,3578750024,3578750036,12
2,1303,37611,3578750024,3578750037,13
2,1303,37612,3578750024,3578750037,13
2,1303,37613,3578750024,3578750037,13
2,1303,37614,3578750024,3578750038,14
2,1303,37615,3578750024,3578750038,14
2,1303,37616,3578750024,3578750038,14
2,1303,37617,3578750024,3578750038,14
2,1303,37618,3578750024,3578750041,17
2,1303,37619,3578750024,3578750041,17
2,1303,37620,3578750024,3578750041,17
2,1303,37621,3578750024,3578750044,20
2,1303,37622,3578750024,3578750044,20
2,1303,37623,3578750024,3578750045,21
2,1303,37624,3578750024,3578750046,22
2,1303,37625,3578750024,3578750046,22
2,1303,37626,3578750024,3578750046,22
2,1303,37627,3578750024,3578750047,23
2,1303,37628,3578750024,3578750049,25
2,1303,37629,3578750024,3578750050,26
2,1303,37630,3578750024,3578750052,28
2,1303,37631,3578750024,3578750052,28
2,1303,37632,3578750024,3578750053,29
2,1303,37633,3578750024,3578750053,29
2,1303,37634,3578750024,3578750053,29
2,1303,37635,3578750024,3578750054,30
2,1303,37636,3578750024,3578750055,31
2,1303,37637,3578750024,3578750056,32
2,1303,37638,3578750024,3578750057,33
2,1303,37639,3578750024,3578750057,33
2,1303,37640,3578750024,3578750057,33
2,1303,37641,3578750024,3578750058,34
2,1303,37642,3578750024,3578750059,35
2,1303,37643,3578750024,3578750060,36
2,1303,37644,3578750024,3578750061,37
2,1303,37645,3578750024,3578750061,37
2,1303,37646,3578750024,3578750065,41
2,1303,37647,3578750024,3578750065,41
2,1303,37648,3578750024,3578750066,42
2,1303,37649,3578750024,3578750067,43
2,1303,37650,3578750024,3578750067,43
2,1303,37651,3578750024,3578750067,43
2,1303,37652,3578750024,3578750071,47
2,1304,37653,3578750087,3578750087,0
2,1304,37654,3578750087,3578750087,0
2,1304,37655,3578750087,3578750087,0
2,1304,37656,3578750087,3578750087,0
2,1304,37657,3578750087,3578750087,0
2,1304,37658,3578750087,3578750087,0
2,1304,37659,3578750087,3578750087,0
2,1304,37660,3578750087,3578750087,0
2,1304,37661,3578750087,3578750087,0
2,1304,37662,3578750087,3578750087,0
2,1304,37663,3578750087,3578750087,0
2,1304,37664,3578750087,3578750087,0
2,1304,37665,3578750087,3578750087,0
2,1304,37666,3578750087,3578750087,0
2,1304,37667,3578750087,3578750088,1
2,1304,37668,3578750087,3578750088,1
2,1304,37669,3578750087,3578750089,2
2,1304,37670,3578750087,3578750089,2
2,1304,37671,3578750087,3578750089,2
2,1304,37672,3578750087,3578750090,3
2,1304,37673,3578750087,3578750091,4
2,1304,37674,3578750087,3578750092,5
2,1304,37675,3578750087,3578750092,5
2,1304,37676,3578750087,3578750093,6
2,1304,37677,3578750087,3578750093,6
2,1304,37678,3578750087,3578750094,7
2,1304,37679,3578750087,3578750095,8
2,1304,37680,3578750087,3578750096,9
2,1304,37681,3578750087,3578750096,9
2,1304,37682,3578750087,3578750096,9
2,1304,37683,3578750087,3578750096,9
2,1304,37684,3578750087,3578750098,11
2,1304,37685,3578750087,3578750099,12
2,1304,37686,3578750087,3578750100,13
2,1304,37687,3578750087,3578750100,13
2,1304,37688,3578750087,3578750100,13
2,1304,37689,3578750087,3578750101,14
2,1304,37690,3578750087,3578750101,14
2,1304,37691,3578750087,3578750102,15
2,1304,37692,3578750087,3578750103,16
2,1304,37693,3578750087,3578750104,17
2,1304,37694,3578750087,3578750104,17
2,1304,37695,3578750087,3578750106,19
2,1304,37696,3578750087,3578750107,20
2,1304,37697,3578750087,3578750109,22
2,1304,37698,3578750087,3578750110,23
2,1304,37699,3578750087,3578750111,24
2,1304,37700,3578750087,3578750112,25
2,1304,37701,3578750087,3578750112,25
2,1304,37702,3578750087,3578750113,26
2,1304,37703,3578750087,3578750114,27
2,1304,37704,3578750087,3578750114,27
2,1304,37705,3578750087,3578750114,27
2,1304,37706,3578750087,3578750114,27
2,1304,37707,3578750087,3578750115,28
2,1304,37708,3578750087,3578750116,29
2,1304,37709,3578750087,3578750116,29
2,1304,37710,3578750087,3578750117,30
2,1304,37711,3578750087,3578750117,30
2,1304,37712,3578750087,3578750117,30
2,1304,37713,3578750087,3578750117,30
2,1304,37714,3578750087,3578750119,32
2,1304,37715,3578750087,3578750119,32
2,1304,37716,3578750087,3578750120,33
2,1304,37717,3578750087,3578750120,33
2,1304,37718,3578750087,3578750121,34
2,1304,37719,3578750087,3578750121,34
2,1304,37720,3578750087,3578750122,35
2,1304,37721,3578750087,3578750122,35
2,1304,37722,3578750087,3578750123,36
2,1304,37723,3578750087,3578750123,36
2,1304,37724,3578750087,3578750124,37
2,1304,37725,3578750087,3578750126,39
2,1304,37726,3578750087,3578750126,39
2,1304,37727,3578750087,3578750126,39
2,1304,37728,3578750087,3578750127,40
2,1304,37729,3578750087,3578750128,41
2,1304,37730,3578750087,3578750130,43
2,1304,37731,3578750087,3578750131,44
2,1304,37732,3578750087,3578750132,45
2,1304,37733,3578750087,3578750133,46
2,1304,37734,3578750087,3578750133,46
2,1304,37735,3578750087,3578750134,47
2,1304,37736,3578750087,3578750135,48
2,1304,37737,3578750087,3578750135,48
2,1304,37738,3578750087,3578750136,49
2,1305,37739,3578750150,3578750150,0
2,1305,37740,3578750150,3578750150,0
2,1305,37741,3578750150,3578750150,0
2,1305,37742,3578750150,3578750150,0
2,1305,37743,3578750150,3578750150,0
2,1305,37744,3578750150,3578750150,0
2,1305,37745,3578750150,3578750150,0
2,1305,37746,3578750150,3578750150,0
2,1305,37747,3578750150,3578750150,0
2,1305,37748,3578750150,3578750150,0
2,1305,37749,3578750150,3578750150,0
2,1305,37750,3578750150,3578750150,0
2,1305,37751,3578750150,3578750150,0
2,1305,37752,3578750150,3578750150,0
2,1305,37753,3578750150,3578750150,0
2,1305,37754,3578750150,3578750150,0
2,1305,37755,3578750150,3578750151,1
2,1305,37756,3578750150,3578750151,1
2,1305,37757,3578750150,3578750154,4
2,1305,37758,3578750150,3578750154,4
2,1305,37759,3578750150,3578750155,5
2,1305,37760,3578750150,3578750155,5
2,1305,37761,3578750150,3578750155,5
2,1305,37762,3578750150,3578750155,5
2,1305,37763,3578750150,3578750156,6
2,1305,37764,3578750150,3578750156,6
2,1305,37765,3578750150,3578750157,7
2,1305,37766,3578750150,3578750160,10
2,1305,37767,3578750150,3578750160,10
2,1305,37768,3578750150,3578750161,11
2,1305,37769,3578750150,3578750161,11
2,1305,37770,3578750150,3578750161,11
2,1305,37771,3578750150,3578750163,13
2,1305,37772,3578750150,3578750163,13
2,1305,37773,3578750150,3578750165,15
2,1305,37774,3578750150,3578750166,16
2,1305,37775,3578750150,3578750166,16
2,1305,37776,3578750150,3578750166,16
2,1305,37777,3578750150,3578750168,18
2,1305,37778,3578750150,3578750169,19
2,1305,37779,3578750150,3578750170,20
2,1305,37780,3578750150,3578750171,21
2,1305,37781,3578750150,3578750172,22
2,1305,37782,3578750150,3578750172,22
2,1305,37783,3578750150,3578750173,23
2,1305,37784,3578750150,3578750174,24
2,1305,37785,3578750150,3578750175,25
2,1305,37786,3578750150,3578750175,25
2,1305,37787,3578750150,3578750176,26
2,1305,37788,3578750150,3578750177,27
2,1305,37789,3578750150,3578750177,27
2,1305,37790,3578750150,3578750177,27
2,1305,37791,3578750150,3578750178,28
2,1305,37792,3578750150,3578750179,29
2,1305,37793,3578750150,3578750180,30
2,1305,37794,3578750150,3578750180,30
2,1305,37795,3578750150,3578750181,31
2,1305,37796,3578750150,3578750182,32
2,1305,37797,3578750150,3578750183,33
2,1305,37798,3578750150,3578750184,34
2,1305,37799,3578750150,3578750185,35
2,1305,37800,3578750150,3578750189,39
2,1305,37801,3578750150,3578750189,39
2,1305,37802,3578750150,3578750190,40
2,1305,37803,3578750150,3578750190,40
2,1305,37804,3578750150,3578750191,41
2,1305,37805,3578750150,3578750193,43
2,1305,37806,3578750150,3578750193,43
2,1305,37807,3578750150,3578750194,44
2,1305,37808,3578750150,3578750194,44
2,1305,37809,3578750150,3578750194,44
2,1305,37810,3578750150,3578750194,44
2,1305,37811,3578750150,3578750194,44
2,1305,37812,3578750150,3578750199,49
2,1305,37813,3578750150,3578750199,49
2,1305,37814,3578750150,3578750200,50
2,1306,37815,3578750212,3578750212,0
2,1306,37816,3578750212,3578750212,0
2,1306,37817,3578750212,3578750212,0
2,1306,37818,3578750212,3578750213,1
2,1306,37819,3578750212,3578750213,1
2,1306,37820,3578750212,3578750213,1
2,1306,37821,3578750212,3578750213,1
2,1306,37822,3578750212,3578750213,1
2,1306,37823,3578750212,3578750213,1
2,1306,37824,3578750212,3578750214,2
2,1306,37825,3578750212,3578750214,2
2,1306,37826,3578750212,3578750214,2
2,1306,37827,3578750212,3578750215,3
2,1306,37828,3578750212,3578750216,4
2,1306,37829,3578750212,3578750217,5
2,1306,37830,3578750212,3578750217,5
2,1306,37831,3578750212,3578750218,6
2,1306,37832,3578750212,3578750219,7
2,1306,37833,3578750212,3578750219,7
2,1306,37834,3578750212,3578750220,8
2,1306,37835,3578750212,3578750221,9
2,1306,37836,3578750212,3578750221,9
2,1306,37837,3578750212,3578750222,10
2,1306,37838,3578750212,3578750225,13
2,1306,37839,3578750212,3578750225,13
2,1306,37840,3578750212,3578750226,14
2,1306,37841,3578750212,3578750226,14
2,1306,37842,3578750212,3578750227,15
2,1306,37843,3578750212,3578750227,15
2,1306,37844,3578750212,3578750229,17
2,1306,37845,3578750212,3578750229,17
2,1306,37846,3578750212,3578750230,18
2,1306,37847,3578750212,3578750232,20
2,1306,37848,3578750212,3578750233,21
2,1306,37849,3578750212,3578750233,21
2,1306,37850,3578750212,3578750236,24
2,1306,37851,3578750212,3578750236,24
2,1306,37852,3578750212,3578750237,25
2,1306,37853,3578750212,3578750237,25
2,1306,37854,3578750212,3578750237,25
2,1306,37855,3578750212,3578750238,26
2,1306,37856,3578750212,3578750238,26
2,1306,37857,3578750212,3578750238,26
2,1306,37858,3578750212,3578750239,27
2,1306,37859,3578750212,3578750239,27
2,1306,37860,3578750212,3578750239,27
2,1306,37861,3578750212,3578750241,29
2,1306,37862,3578750212,3578750241,29
2,1306,37863,3578750212,3578750242,30
2,1306,37864,3578750212,3578750244,32
2,1306,37865,3578750212,3578750244,32
2,1306,37866,3578750212,3578750245,33
2,1306,37867,3578750212,3578750245,33
2,1306,37868,3578750212,3578750246,34
2,1306,37869,3578750212,3578750246,34
2,1306,37870,3578750212,3578750247,35
2,1306,37871,3578750212,3578750247,35
2,1306,37872,3578750212,3578750250,38
2,1306,37873,3578750212,3578750251,39
2,1306,37874,3578750212,3578750252,40
2,1306,37875,3578750212,3578750252,40
2,1306,37876,3578750212,3578750253,41
2,1306,37877,3578750212,3578750254,42
2,1306,37878,3578750212,3578750255,43
2,1306,37879,3578750212,3578750255,43
2,1306,37880,3578750212,3578750256,44
2,1306,37881,3578750212,3578750256,44
2,1306,37882,3578750212,3578750257,45
2,1306,37883,3578750212,3578750257,45
2,1306,37884,3578750212,3578750258,46
2,1306,37885,3578750212,3578750259,47
2,1306,37886,3578750212,3578750260,48
2,1306,37887,3578750212,3578750261,49
2,1307,37888,3578750274,3578750274,0
2,1307,37889,3578750274,3578750274,0
2,1307,37890,3578750274,3578750274,0
2,1307,37891,3578750274,3578750274,0
2,1307,37892,3578750274,3578750274,0
2,1307,37893,3578750274,3578750274,0
2,1307,37894,3578750274,3578750274,0
2,1307,37895,3578750274,3578750274,0
2,1307,37896,3578750274,3578750276,2
2,1307,37897,3578750274,3578750279,5
2,1307,37898,3578750274,3578750279,5
2,1307,37899,3578750274,3578750280,6
2,1307,37900,3578750274,3578750281,7
2,1307,37901,3578750274,3578750282,8
2,1307,37902,3578750274,3578750282,8
2,1307,37903,3578750274,3578750282,8
2,1307,37904,3578750274,3578750284,10
2,1307,37905,3578750274,3578750284,10
2,1307,37906,3578750274,3578750284,10
2,1307,37907,3578750274,3578750286,12
2,1307,37908,3578750274,3578750287,13
2,1307,37909,3578750274,3578750288,14
2,1307,37910,3578750274,3578750289,15
2,1307,37911,3578750274,3578750290,16
2,1307,37912,3578750274,3578750290,16
2,1307,37913,3578750274,3578750290,16
2,1307,37914,3578750274,3578750292,18
2,1307,37915,3578750274,3578750292,18
2,1307,37916,3578750274,3578750292,18
2,1307,37917,3578750274,3578750293,19
2,1307,37918,3578750274,3578750294,20
2,1307,37919,3578750274,3578750294,20
2,1307,37920,3578750274,3578750295,21
2,1307,37921,3578750274,3578750295,21
2,1307,37922,3578750274,3578750296,22
2,1307,37923,3578750274,3578750296,22
2,1307,37924,3578750274,3578750296,22
2,1307,37925,3578750274,3578750296,22
2,1307,37926,3578750274,3578750297,23
2,1307,37927,3578750274,3578750298,24
2,1307,37928,3578750274,3578750300,26
2,1307,37929,3578750274,3578750300,26
2,1307,37930,3578750274,3578750301,27
2,1307,37931,3578750274,3578750302,28
2,1307,37932,3578750274,3578750302,28
2,1307,37933,3578750274,3578750303,29
2,1307,37934,3578750274,3578750303,29
2,1307,37935,3578750274,3578750305,31
2,1307,37936,3578750274,3578750306,32
2,1307,37937,3578750274,3578750307,33
2,1307,37938,3578750274,3578750309,35
2,1307,37939,3578750274,3578750310,36
2,1307,37940,3578750274,3578750311,37
2,1307,37941,3578750274,3578750312,38
2,1307,37942,3578750274,3578750312,38
2,1307,37943,3578750274,3578750313,39
2,1307,37944,3578750274,3578750313,39
2,1307,37945,3578750274,3578750313,39
2,1307,37946,3578750274,3578750314,40
2,1307,37947,3578750274,3578750314,40
2,1307,37948,3578750274,3578750315,41
2,1307,37949,3578750274,3578750315,41
2,1307,37950,3578750274,3578750316,42
2,1307,37951,3578750274,3578750317,43
2,1307,37952,3578750274,3578750317,43
2,1307,37953,3578750274,3578750317,43
2,1307,37954,3578750274,3578750318,44
2,1307,37955,3578750274,3578750319,45
2,1307,37956,3578750274,3578750319,45
2,1307,37957,3578750274,3578750319,45
2,1307,37958,3578750274,3578750319,45
2,1307,37959,3578750274,3578750320,46
2,1307,37960,3578750274,3578750320,46
2,1307,37961,3578750274,3578750321,47
2,1307,37962,3578750274,3578750322,48
2,1307,37963,3578750274,3578750322,48
2,1307,37964,3578750274,3578750323,49
2,1308,37965,3578750336,3578750336,0
2,1308,37966,3578750336,3578750336,0
2,1308,37967,3578750336,3578750336,0
2,1308,37968,3578750336,3578750336,0
2,1308,37969,3578750336,3578750336,0
2,1308,37970,3578750336,3578750336,0
2,1308,37971,3578750336,3578750336,0
2,1308,37972,3578750336,3578750336,0
2,1308,37973,3578750336,3578750336,0
2,1308,37974,3578750336,3578750336,0
2,1308,37975,3578750336,3578750336,0
2,1308,37976,3578750336,3578750336,0
2,1308,37977,3578750336,3578750336,0
2,1308,37978,3578750336,3578750336,0
2,1308,37979,3578750336,3578750338,2
2,1308,37980,3578750336,3578750338,2
2,1308,37981,3578750336,3578750338,2
2,1308,37982,3578750336,3578750338,2
2,1308,37983,3578750336,3578750340,4
2,1308,37984,3578750336,3578750340,4
2,1308,37985,3578750336,3578750341,5
2,1308,37986,3578750336,3578750342,6
2,1308,37987,3578750336,3578750342,6
2,1308,37988,3578750336,3578750343,7
2,1308,37989,3578750336,3578750343,7
2,1308,37990,3578750336,3578750343,7
2,1308,37991,3578750336,3578750344,8
2,1308,37992,3578750336,3578750344,8
2,1308,37993,3578750336,3578750348,12
2,1308,37994,3578750336,3578750350,14
2,1308,37995,3578750336,3578750351,15
2,1308,37996,3578750336,3578750352,16
2,1308,37997,3578750336,3578750354,18
2,1308,37998,3578750336,3578750355,19
2,1308,37999,3578750336,3578750355,19
2,1308,38000,3578750336,3578750355,19
2,1308,38001,3578750336,3578750355,19
2,1308,38002,3578750336,3578750356,20
2,1308,38003,3578750336,3578750356,20
2,1308,38004,3578750336,3578750356,20
2,1308,38005,3578750336,3578750359,23
2,1308,38006,3578750336,3578750360,24
2,1308,38007,3578750336,3578750360,24
2,1308,38008,3578750336,3578750361,25
2,1308,38009,3578750336,3578750361,25
2,1308,38010,3578750336,3578750363,27
2,1308,38011,3578750336,3578750363,27
2,1308,38012,3578750336,3578750366,30
2,1308,38013,3578750336,3578750366,30
2,1308,38014,3578750336,3578750366,30
2,1308,38015,3578750336,3578750366,30
2,1308,38016,3578750336,3578750367,31
2,1308,38017,3578750336,3578750370,34
2,1308,38018,3578750336,3578750371,35
2,1308,38019,3578750336,3578750372,36
2,1308,38020,3578750336,3578750372,36
2,1308,38021,3578750336,3578750373,37
2,1308,38022,3578750336,3578750375,39
2,1308,38023,3578750336,3578750375,39
2,1308,38024,3578750336,3578750376,40
2,1308,38025,3578750336,3578750376,40
2,1308,38026,3578750336,3578750377,41
2,1308,38027,3578750336,3578750377,41
2,1308,38028,3578750336,3578750378,42
2,1308,38029,3578750336,3578750379,43
2,1308,38030,3578750336,3578750379,43
2,1308,38031,3578750336,3578750380,44
2,1308,38032,3578750336,3578750380,44
2,1308,38033,3578750336,3578750381,45
2,1308,38034,3578750336,3578750383,47
2,1308,38035,3578750336,3578750383,47
2,1308,38036,3578750336,3578750385,49
2,1308,38037,3578750336,3578750385,49
2,1309,38038,3578750399,3578750399,0
2,1309,38039,3578750399,3578750399,0
2,1309,38040,3578750399,3578750399,0
2,1309,38041,3578750399,3578750399,0
2,1309,38042,3578750399,3578750399,0
2,1309,38043,3578750399,3578750399,0
2,1309,38044,3578750399,3578750399,0
2,1309,38045,3578750399,3578750399,0
2,1309,38046,3578750399,3578750399,0
2,1309,38047,3578750399,3578750399,0
2,1309,38048,3578750399,3578750399,0
2,1309,38049,3578750399,3578750399,0
2,1309,38050,3578750399,3578750399,0
2,1309,38051,3578750399,3578750399,0
2,1309,38052,3578750399,3578750400,1
2,1309,38053,3578750399,3578750404,5
2,1309,38054,3578750399,3578750404,5
2,1309,38055,3578750399,3578750404,5
2,1309,38056,3578750399,3578750406,7
2,1309,38057,3578750399,3578750406,7
2,1309,38058,3578750399,3578750408,9
2,1309,38059,3578750399,3578750411,12
2,1309,38060,3578750399,3578750411,12
2,1309,38061,3578750399,3578750413,14
2,1309,38062,3578750399,3578750413,14
2,1309,38063,3578750399,3578750413,14
2,1309,38064,3578750399,3578750414,15
2,1309,38065,3578750399,3578750415,16
2,1309,38066,3578750399,3578750416,17
2,1309,38067,3578750399,3578750417,18
2,1309,38068,3578750399,3578750417,18
2,1309,38069,3578750399,3578750417,18
2,1309,38070,3578750399,3578750419,20
2,1309,38071,3578750399,3578750419,20
2,1309,38072,3578750399,3578750420,21
2,1309,38073,3578750399,3578750420,21
2,1309,38074,3578750399,3578750421,22
2,1309,38075,3578750399,3578750422,23
2,1309,38076,3578750399,3578750424,25
2,1309,38077,3578750399,3578750425,26
2,1309,38078,3578750399,3578750426,27
2,1309,38079,3578750399,3578750427,28
2,1309,38080,3578750399,3578750429,30
2,1309,38081,3578750399,3578750430,31
2,1309,38082,3578750399,3578750431,32
2,1309,38083,3578750399,3578750432,33
2,1309,38084,3578750399,3578750433,34
2,1309,38085,3578750399,3578750434,35
2,1309,38086,3578750399,3578750434,35
2,1309,38087,3578750399,3578750435,36
2,1309,38088,3578750399,3578750436,37
2,1309,38089,3578750399,3578750437,38
2,1309,38090,3578750399,3578750437,38
2,1309,38091,3578750399,3578750438,39
2,1309,38092,3578750399,3578750438,39
2,1309,38093,3578750399,3578750438,39
2,1309,38094,3578750399,3578750438,39
2,1309,38095,3578750399,3578750439,40
2,1309,38096,3578750399,3578750439,40
2,1309,38097,3578750399,3578750439,40
2,1309,38098,3578750399,3578750441,42
2,1309,38099,3578750399,3578750442,43
2,1309,38100,3578750399,3578750442,43
2,1309,38101,3578750399,3578750444,45
2,1309,38102,3578750399,3578750444,45
2,1309,38103,3578750399,3578750445,46
2,1309,38104,3578750399,3578750445,46
2,1309,38105,3578750399,3578750445,46
2,1309,38106,3578750399,3578750447,48
2,1309,38107,3578750399,3578750447,48
2,1309,38108,3578750399,3578750449,50
2,1310,38109,3578750461,3578750461,0
2,1310,38110,3578750461,3578750461,0
2,1310,38111,3578750461,3578750461,0
2,1310,38112,3578750461,3578750461,0
2,1310,38113,3578750461,3578750461,0
2,1310,38114,3578750461,3578750461,0
2,1310,38115,3578750461,3578750461,0
2,1310,38116,3578750461,3578750461,0
2,1310,38117,3578750461,3578750461,0
2,1310,38118,3578750461,3578750461,0
2,1310,38119,3578750461,3578750461,0
2,1310,38120,3578750461,3578750461,0
2,1310,38121,3578750461,3578750461,0
2,1310,38122,3578750461,3578750461,0
2,1310,38123,3578750461,3578750461,0
2,1310,38124,3578750461,3578750461,0
2,1310,38125,3578750461,3578750465,4
2,1310,38126,3578750461,3578750465,4
2,1310,38127,3578750461,3578750467,6
2,1310,38128,3578750461,3578750468,7
2,1310,38129,3578750461,3578750468,7
2,1310,38130,3578750461,3578750470,9
2,1310,38131,3578750461,3578750471,10
2,1310,38132,3578750461,3578750473,12
2,1310,38133,3578750461,3578750475,14
2,1310,38134,3578750461,3578750479,18
2,1310,38135,3578750461,3578750479,18
2,1310,38136,3578750461,3578750480,19
2,1310,38137,3578750461,3578750482,21
2,1310,38138,3578750461,3578750482,21
2,1310,38139,3578750461,3578750482,21
2,1310,38140,3578750461,3578750483,22
2,1310,38141,3578750461,3578750484,23
2,1310,38142,3578750461,3578750485,24
2,1310,38143,3578750461,3578750485,24
2,1310,38144,3578750461,3578750485,24
2,1310,38145,3578750461,3578750487,26
2,1310,38146,3578750461,3578750487,26
2,1310,38147,3578750461,3578750489,28
2,1310,38148,3578750461,3578750490,29
2,1310,38149,3578750461,3578750490,29
2,1310,38150,3578750461,3578750490,29
2,1310,38151,3578750461,3578750492,31
2,1310,38152,3578750461,3578750493,32
2,1310,38153,3578750461,3578750493,32
2,1310,38154,3578750461,3578750494,33
2,1310,38155,3578750461,3578750494,33
2,1310,38156,3578750461,3578750494,33
2,1310,38157,3578750461,3578750495,34
2,1310,38158,3578750461,3578750496,35
2,1310,38159,3578750461,3578750496,35
2,1310,38160,3578750461,3578750496,35
2,1310,38161,3578750461,3578750497,36
2,1310,38162,3578750461,3578750498,37
2,1310,38163,3578750461,3578750500,39
2,1310,38164,3578750461,3578750500,39
2,1310,38165,3578750461,3578750501,40
2,1310,38166,3578750461,3578750502,41
2,1310,38167,3578750461,3578750502,41
2,1310,38168,3578750461,3578750503,42
2,1310,38169,3578750461,3578750504,43
2,1310,38170,3578750461,3578750505,44
2,1310,38171,3578750461,3578750506,45
2,1310,38172,3578750461,3578750507,46
2,1310,38173,3578750461,3578750509,48
2,1310,38174,3578750461,3578750510,49
2,1310,38175,3578750461,3578750510,49
2,1311,38176,3578750523,3578750523,0
2,1311,38177,3578750523,3578750523,0
2,1311,38178,3578750523,3578750523,0
2,1311,38179,3578750523,3578750523,0
2,1311,38180,3578750523,3578750523,0
2,1311,38181,3578750523,3578750523,0
2,1311,38182,3578750523,3578750523,0
2,1311,38183,3578750523,3578750523,0
2,1311,38184,3578750523,3578750523,0
2,1311,38185,3578750523,3578750523,0
2,1311,38186,3578750523,3578750523,0
2,1311,38187,3578750523,3578750523,0
2,1311,38188,3578750523,3578750523,0
2,1311,38189,3578750523,3578750523,0
2,1311,38190,3578750523,3578750523,0
2,1311,38191,3578750523,3578750523,0
2,1311,38192,3578750523,3578750523,0
2,1311,38193,3578750523,3578750523,0
2,1311,38194,3578750523,3578750523,0
2,1311,38195,3578750523,3578750523,0
2,1311,38196,3578750523,3578750523,0
2,1311,38197,3578750523,3578750523,0
2,1311,38198,3578750523,3578750523,0
2,1311,38199,3578750523,3578750523,0
2,1311,38200,3578750523,3578750525,2
2,1311,38201,3578750523,3578750525,2
2,1311,38202,3578750523,3578750526,3
2,1311,38203,3578750523,3578750526,3
2,1311,38204,3578750523,3578750527,4
2,1311,38205,3578750523,3578750530,7
2,1311,38206,3578750523,3578750531,8
2,1311,38207,3578750523,3578750532,9
2,1311,38208,3578750523,3578750532,9
2,1311,38209,3578750523,3578750533,10
2,1311,38210,3578750523,3578750534,11
2,1311,38211,3578750523,3578750535,12
2,1311,38212,3578750523,3578750535,12
2,1311,38213,3578750523,3578750536,13
2,1311,38214,3578750523,3578750537,14
2,1311,38215,3578750523,3578750537,14
2,1311,38216,3578750523,3578750538,15
2,1311,38217,3578750523,3578750539,16
2,1311,38218,3578750523,3578750539,16
2,1311,38219,3578750523,3578750540,17
2,1311,38220,3578750523,3578750541,18
2,1311,38221,3578750523,3578750542,19
2,1311,38222,3578750523,3578750542,19
2,1311,38223,3578750523,3578750542,19
2,1311,38224,3578750523,3578750542,19
2,1311,38225,3578750523,3578750544,21
2,1311,38226,3578750523,3578750547,24
2,1311,38227,3578750523,3578750549,26
2,1311,38228,3578750523,3578750550,27
2,1311,38229,3578750523,3578750553,30
2,1311,38230,3578750523,3578750554,31
2,1311,38231,3578750523,3578750554,31
2,1311,38232,3578750523,3578750554,31
2,1311,38233,3578750523,3578750555,32
2,1311,38234,3578750523,3578750556,33
2,1311,38235,3578750523,3578750556,33
2,1311,38236,3578750523,3578750558,35
2,1311,38237,3578750523,3578750560,37
2,1311,38238,3578750523,3578750560,37
2,1311,38239,3578750523,3578750560,37
2,1311,38240,3578750523,3578750561,38
2,1311,38241,3578750523,3578750563,40
2,1311,38242,3578750523,3578750563,40
2,1311,38243,3578750523,3578750564,41
2,1311,38244,3578750523,3578750565,42
2,1311,38245,3578750523,3578750566,43
2,1311,38246,3578750523,3578750566,43
2,1311,38247,3578750523,3578750566,43
2,1311,38248,3578750523,3578750569,46
2,1311,38249,3578750523,3578750570,47
2,1311,38250,3578750523,3578750570,47
2,1311,38251,3578750523,3578750571,48
2,1311,38252,3578750523,3578750572,49
2,1312,38253,3578750584,3578750584,0
2,1312,38254,3578750584,3578750584,0
2,1312,38255,3578750584,3578750584,0
2,1312,38256,3578750584,3578750584,0
2,1312,38257,3578750584,3578750584,0
2,1312,38258,3578750584,3578750584,0
2,1312,38259,3578750584,3578750584,0
2,1312,38260,3578750584,3578750584,0
2,1312,38261,3578750584,3578750584,0
2,1312,38262,3578750584,3578750584,0
2,1312,38263,3578750584,3578750584,0
2,1312,38264,3578750584,3578750584,0
2,1312,38265,3578750584,3578750584,0
2,1312,38266,3578750584,3578750584,0
2,1312,38267,3578750584,3578750584,0
2,1312,38268,3578750584,3578750584,0
2,1312,38269,3578750584,3578750589,5
2,1312,38270,3578750584,3578750589,5
2,1312,38271,3578750584,3578750589,5
2,1312,38272,3578750584,3578750591,7
2,1312,38273,3578750584,3578750591,7
2,1312,38274,3578750584,3578750593,9
2,1312,38275,3578750584,3578750593,9
2,1312,38276,3578750584,3578750593,9
2,1312,38277,3578750584,3578750593,9
2,1312,38278,3578750584,3578750594,10
2,1312,38279,3578750584,3578750595,11
2,1312,38280,3578750584,3578750598,14
2,1312,38281,3578750584,3578750598,14
2,1312,38282,3578750584,3578750599,15
2,1312,38283,3578750584,3578750599,15
2,1312,38284,3578750584,3578750602,18
2,1312,38285,3578750584,3578750603,19
2,1312,38286,3578750584,3578750604,20
2,1312,38287,3578750584,3578750606,22
2,1312,38288,3578750584,3578750606,22
2,1312,38289,3578750584,3578750607,23
2,1312,38290,3578750584,3578750610,26
2,1312,38291,3578750584,3578750610,26
2,1312,38292,3578750584,3578750612,28
2,1312,38293,3578750584,3578750612,28
2,1312,38294,3578750584,3578750613,29
2,1312,38295,3578750584,3578750613,29
2,1312,38296,3578750584,3578750614,30
2,1312,38297,3578750584,3578750616,32
2,1312,38298,3578750584,3578750617,33
2,1312,38299,3578750584,3578750617,33
2,1312,38300,3578750584,3578750619,35
2,1312,38301,3578750584,3578750619,35
2,1312,38302,3578750584,3578750619,35
2,1312,38303,3578750584,3578750619,35
2,1312,38304,3578750584,3578750620,36
2,1312,38305,3578750584,3578750621,37
2,1312,38306,3578750584,3578750624,40
2,1312,38307,3578750584,3578750624,40
2,1312,38308,3578750584,3578750626,42
2,1312,38309,3578750584,3578750626,42
2,1312,38310,3578750584,3578750628,44
2,1312,38311,3578750584,3578750629,45
2,1312,38312,3578750584,3578750629,45
2,1312,38313,3578750584,3578750629,45
2,1312,38314,3578750584,3578750631,47
2,1312,38315,3578750584,3578750632,48
2,1312,38316,3578750584,3578750633,49
2,1312,38317,3578750584,3578750633,49
2,1313,38318,3578750646,3578750646,0
2,1313,38319,3578750646,3578750646,0
2,1313,38320,3578750646,3578750646,0
2,1313,38321,3578750646,3578750646,0
2,1313,38322,3578750646,3578750646,0
2,1313,38323,3578750646,3578750646,0
2,1313,38324,3578750646,3578750646,0
2,1313,38325,3578750646,3578750646,0
2,1313,38326,3578750646,3578750646,0
2,1313,38327,3578750646,3578750646,0
2,1313,38328,3578750646,3578750646,0
2,1313,38329,3578750646,3578750646,0
2,1313,38330,3578750646,3578750646,0
2,1313,38331,3578750646,3578750646,0
2,1313,38332,3578750646,3578750646,0
2,1313,38333,3578750646,3578750646,0
2,1313,38334,3578750646,3578750646,0
2,1313,38335,3578750646,3578750646,0
2,1313,38336,3578750646,3578750646,0
2,1313,38337,3578750646,3578750647,1
2,1313,38338,3578750646,3578750650,4
2,1313,38339,3578750646,3578750650,4
2,1313,38340,3578750646,3578750651,5
2,1313,38341,3578750646,3578750652,6
2,1313,38342,3578750646,3578750652,6
2,1313,38343,3578750646,3578750653,7
2,1313,38344,3578750646,3578750654,8
2,1313,38345,3578750646,3578750654,8
2,1313,38346,3578750646,3578750655,9
2,1313,38347,3578750646,3578750656,10
2,1313,38348,3578750646,3578750657,11
2,1313,38349,3578750646,3578750657,11
2,1313,38350,3578750646,3578750657,11
2,1313,38351,3578750646,3578750658,12
2,1313,38352,3578750646,3578750658,12
2,1313,38353,3578750646,3578750659,13
2,1313,38354,3578750646,3578750660,14
2,1313,38355,3578750646,3578750664,18
2,1313,38356,3578750646,3578750665,19
2,1313,38357,3578750646,3578750667,21
2,1313,38358,3578750646,3578750667,21
2,1313,38359,3578750646,3578750667,21
2,1313,38360,3578750646,3578750669,23
2,1313,38361,3578750646,3578750669,23
2,1313,38362,3578750646,3578750673,27
2,1313,38363,3578750646,3578750676,30
2,1313,38364,3578750646,3578750677,31
2,1313,38365,3578750646,3578750679,33
2,1313,38366,3578750646,3578750679,33
2,1313,38367,3578750646,3578750681,35
2,1313,38368,3578750646,3578750681,35
2,1313,38369,3578750646,3578750682,36
2,1313,38370,3578750646,3578750682,36
2,1313,38371,3578750646,3578750682,36
2,1313,38372,3578750646,3578750684,38
2,1313,38373,3578750646,3578750685,39
2,1313,38374,3578750646,3578750685,39
2,1313,38375,3578750646,3578750686,40
2,1313,38376,3578750646,3578750687,41
2,1313,38377,3578750646,3578750688,42
2,1313,38378,3578750646,3578750689,43
2,1313,38379,3578750646,3578750689,43
2,1313,38380,3578750646,3578750690,44
2,1313,38381,3578750646,3578750690,44
2,1313,38382,3578750646,3578750691,45
2,1313,38383,3578750646,3578750692,46
2,1313,38384,3578750646,3578750693,47
2,1313,38385,3578750646,3578750693,47
2,1313,38386,3578750646,3578750694,48
2,1313,38387,3578750646,3578750695,49
2,1313,38388,3578750646,3578750696,50
2,1314,38389,3578750708,3578750708,0
2,1314,38390,3578750708,3578750708,0
2,1314,38391,3578750708,3578750708,0
2,1314,38392,3578750708,3578750708,0
2,1314,38393,3578750708,3578750708,0
2,1314,38394,3578750708,3578750708,0
2,1314,38395,3578750708,3578750708,0
2,1314,38396,3578750708,3578750708,0
2,1314,38397,3578750708,3578750708,0
2,1314,38398,3578750708,3578750708,0
2,1314,38399,3578750708,3578750708,0
2,1314,38400,3578750708,3578750708,0
2,1314,38401,3578750708,3578750708,0
2,1314,38402,3578750708,3578750708,0
2,1314,38403,3578750708,3578750708,0
2,1314,38404,3578750708,3578750709,1
2,1314,38405,3578750708,3578750710,2
2,1314,38406,3578750708,3578750711,3
2,1314,38407,3578750708,3578750712,4
2,1314,38408,3578750708,3578750713,5
2,1314,38409,3578750708,3578750714,6
2,1314,38410,3578750708,3578750714,6
2,1314,38411,3578750708,3578750716,8
2,1314,38412,3578750708,3578750716,8
2,1314,38413,3578750708,3578750716,8
2,1314,38414,3578750708,3578750716,8
2,1314,38415,3578750708,3578750716,8
2,1314,38416,3578750708,3578750717,9
2,1314,38417,3578750708,3578750717,9
2,1314,38418,3578750708,3578750718,10
2,1314,38419,3578750708,3578750719,11
2,1314,38420,3578750708,3578750719,11
2,1314,38421,3578750708,3578750720,12
2,1314,38422,3578750708,3578750720,12
2,1314,38423,3578750708,3578750720,12
2,1314,38424,3578750708,3578750721,13
2,1314,38425,3578750708,3578750721,13
2,1314,38426,3578750708,3578750721,13
2,1314,38427,3578750708,3578750721,13
2,1314,38428,3578750708,3578750722,14
2,1314,38429,3578750708,3578750722,14
2,1314,38430,3578750708,3578750722,14
2,1314,38431,3578750708,3578750725,17
2,1314,38432,3578750708,3578750726,18
2,1314,38433,3578750708,3578750726,18
2,1314,38434,3578750708,3578750726,18
2,1314,38435,3578750708,3578750726,18
2,1314,38436,3578750708,3578750727,19
2,1314,38437,3578750708,3578750729,21
2,1314,38438,3578750708,3578750731,23
2,1314,38439,3578750708,3578750732,24
2,1314,38440,3578750708,3578750734,26
2,1314,38441,3578750708,3578750734,26
2,1314,38442,3578750708,3578750735,27
2,1314,38443,3578750708,3578750735,27
2,1314,38444,3578750708,3578750735,27
2,1314,38445,3578750708,3578750736,28
2,1314,38446,3578750708,3578750737,29
2,1314,38447,3578750708,3578750737,29
2,1314,38448,3578750708,3578750738,30
2,1314,38449,3578750708,3578750739,31
2,1314,38450,3578750708,3578750739,31
2,1314,38451,3578750708,3578750740,32
2,1314,38452,3578750708,3578750740,32
2,1314,38453,3578750708,3578750741,33
2,1314,38454,3578750708,3578750741,33
2,1314,38455,3578750708,3578750742,34
2,1314,38456,3578750708,3578750742,34
2,1314,38457,3578750708,3578750743,35
2,1314,38458,3578750708,3578750744,36
2,1314,38459,3578750708,3578750744,36
2,1314,38460,3578750708,3578750745,37
2,1314,38461,3578750708,3578750748,40
2,1314,38462,3578750708,3578750748,40
2,1314,38463,3578750708,3578750749,41
2,1314,38464,3578750708,3578750750,42
2,1314,38465,3578750708,3578750752,44
2,1314,38466,3578750708,3578750754,46
2,1314,38467,3578750708,3578750754,46
2,1314,38468,3578750708,3578750754,46
2,1314,38469,3578750708,3578750755,47
2,1314,38470,3578750708,3578750755,47
2,1314,38471,3578750708,3578750755,47
2,1314,38472,3578750708,3578750756,48
2,1315,38473,3578750770,3578750770,0
2,1315,38474,3578750770,3578750770,0
2,1315,38475,3578750770,3578750770,0
2,1315,38476,3578750770,3578750770,0
2,1315,38477,3578750770,3578750770,0
2,1315,38478,3578750770,3578750770,0
2,1315,38479,3578750770,3578750770,0
2,1315,38480,3578750770,3578750770,0
2,1315,38481,3578750770,3578750770,0
2,1315,38482,3578750770,3578750770,0
2,1315,38483,3578750770,3578750770,0
2,1315,38484,3578750770,3578750770,0
2,1315,38485,3578750770,3578750770,0
2,1315,38486,3578750770,3578750770,0
2,1315,38487,3578750770,3578750770,0
2,1315,38488,3578750770,3578750771,1
2,1315,38489,3578750770,3578750771,1
2,1315,38490,3578750770,3578750772,2
2,1315,38491,3578750770,3578750774,4
2,1315,38492,3578750770,3578750774,4
2,1315,38493,3578750770,3578750775,5
2,1315,38494,3578750770,3578750775,5
2,1315,38495,3578750770,3578750777,7
2,1315,38496,3578750770,3578750777,7
2,1315,38497,3578750770,3578750778,8
2,1315,38498,3578750770,3578750778,8
2,1315,38499,3578750770,3578750779,9
2,1315,38500,3578750770,3578750779,9
2,1315,38501,3578750770,3578750781,11
2,1315,38502,3578750770,3578750782,12
2,1315,38503,3578750770,3578750782,12
2,1315,38504,3578750770,3578750785,15
2,1315,38505,3578750770,3578750785,15
2,1315,38506,3578750770,3578750788,18
2,1315,38507,3578750770,3578750788,18
2,1315,38508,3578750770,3578750790,20
2,1315,38509,3578750770,3578750790,20
2,1315,38510,3578750770,3578750791,21
2,1315,38511,3578750770,3578750791,21
2,1315,38512,3578750770,3578750792,22
2,1315,38513,3578750770,3578750793,23
2,1315,38514,3578750770,3578750793,23
2,1315,38515,3578750770,3578750793,23
2,1315,38516,3578750770,3578750795,25
2,1315,38517,3578750770,3578750795,25
2,1315,38518,3578750770,3578750797,27
2,1315,38519,3578750770,3578750798,28
2,1315,38520,3578750770,3578750798,28
2,1315,38521,3578750770,3578750799,29
2,1315,38522,3578750770,3578750799,29
2,1315,38523,3578750770,3578750802,32
2,1315,38524,3578750770,3578750803,33
2,1315,38525,3578750770,3578750804,34
2,1315,38526,3578750770,3578750806,36
2,1315,38527,3578750770,3578750808,38
2,1315,38528,3578750770,3578750810,40
2,1315,38529,3578750770,3578750811,41
2,1315,38530,3578750770,3578750812,42
2,1315,38531,3578750770,3578750813,43
2,1315,38532,3578750770,3578750813,43
2,1315,38533,3578750770,3578750813,43
2,1315,38534,3578750770,3578750813,43
2,1315,38535,3578750770,3578750816,46
2,1315,38536,3578750770,3578750816,46
2,1315,38537,3578750770,3578750817,47
2,1315,38538,3578750770,3578750819,49
2,1315,38539,3578750770,3578750819,49
2,1315,38540,3578750770,3578750819,49
2,1315,38541,3578750770,3578750820,50
2,1316,38542,3578750832,3578750832,0
2,1316,38543,3578750832,3578750832,0
2,1316,38544,3578750832,3578750832,0
2,1316,38545,3578750832,3578750832,0
2,1316,38546,3578750832,3578750832,0
2,1316,38547,3578750832,3578750832,0
2,1316,38548,3578750832,3578750833,1
2,1316,38549,3578750832,3578750833,1
2,1316,38550,3578750832,3578750833,1
2,1316,38551,3578750832,3578750833,1
2,1316,38552,3578750832,3578750833,1
2,1316,38553,3578750832,3578750833,1
2,1316,38554,3578750832,3578750833,1
2,1316,38555,3578750832,3578750833,1
2,1316,38556,3578750832,3578750835,3
2,1316,38557,3578750832,3578750835,3
2,1316,38558,3578750832,3578750836,4
2,1316,38559,3578750832,3578750836,4
2,1316,38560,3578750832,3578750837,5
2,1316,38561,3578750832,3578750837,5
2,1316,38562,3578750832,3578750838,6
2,1316,38563,3578750832,3578750838,6
2,1316,38564,3578750832,3578750838,6
2,1316,38565,3578750832,3578750838,6
2,1316,38566,3578750832,3578750838,6
2,1316,38567,3578750832,3578750840,8
2,1316,38568,3578750832,3578750840,8
2,1316,38569,3578750832,3578750841,9
2,1316,38570,3578750832,3578750844,12
2,1316,38571,3578750832,3578750844,12
2,1316,38572,3578750832,3578750845,13
2,1316,38573,3578750832,3578750845,13
2,1316,38574,3578750832,3578750846,14
2,1316,38575,3578750832,3578750846,14
2,1316,38576,3578750832,3578750849,17
2,1316,38577,3578750832,3578750850,18
2,1316,38578,3578750832,3578750851,19
2,1316,38579,3578750832,3578750852,20
2,1316,38580,3578750832,3578750853,21
2,1316,38581,3578750832,3578750853,21
2,1316,38582,3578750832,3578750854,22
2,1316,38583,3578750832,3578750854,22
2,1316,38584,3578750832,3578750855,23
2,1316,38585,3578750832,3578750856,24
2,1316,38586,3578750832,3578750857,25
2,1316,38587,3578750832,3578750857,25
2,1316,38588,3578750832,3578750857,25
2,1316,38589,3578750832,3578750858,26
2,1316,38590,3578750832,3578750859,27
2,1316,38591,3578750832,3578750859,27
2,1316,38592,3578750832,3578750860,28
2,1316,38593,3578750832,3578750864,32
2,1316,38594,3578750832,3578750866,34
2,1316,38595,3578750832,3578750866,34
2,1316,38596,3578750832,3578750867,35
2,1316,38597,3578750832,3578750867,35
2,1316,38598,3578750832,3578750869,37
2,1316,38599,3578750832,3578750870,38
2,1316,38600,3578750832,3578750874,42
2,1316,38601,3578750832,3578750875,43
2,1316,38602,3578750832,3578750877,45
2,1316,38603,3578750832,3578750879,47
2,1316,38604,3578750832,3578750879,47
2,1316,38605,3578750832,3578750880,48
2,1316,38606,3578750832,3578750881,49
2,1317,38607,3578750896,3578750896,0
2,1317,38608,3578750896,3578750896,0
2,1317,38609,3578750896,3578750896,0
2,1317,38610,3578750896,3578750896,0
2,1317,38611,3578750896,3578750896,0
2,1317,38612,3578750896,3578750896,0
2,1317,38613,3578750896,3578750896,0
2,1317,38614,3578750896,3578750896,0
2,1317,38615,3578750896,3578750896,0
2,1317,38616,3578750896,3578750896,0
2,1317,38617,3578750896,3578750896,0
2,1317,38618,3578750896,3578750896,0
2,1317,38619,3578750896,3578750896,0
2,1317,38620,3578750896,3578750896,0
2,1317,38621,3578750896,3578750896,0
2,1317,38622,3578750896,3578750896,0
2,1317,38623,3578750896,3578750896,0
2,1317,38624,3578750896,3578750896,0
2,1317,38625,3578750896,3578750896,0
2,1317,38626,3578750896,3578750896,0
2,1317,38627,3578750896,3578750896,0
2,1317,38628,3578750896,3578750896,0
2,1317,38629,3578750896,3578750897,1
2,1317,38630,3578750896,3578750898,2
2,1317,38631,3578750896,3578750898,2
2,1317,38632,3578750896,3578750900,4
2,1317,38633,3578750896,3578750901,5
2,1317,38634,3578750896,3578750901,5
2,1317,38635,3578750896,3578750902,6
2,1317,38636,3578750896,3578750902,6
2,1317,38637,3578750896,3578750903,7
2,1317,38638,3578750896,3578750904,8
2,1317,38639,3578750896,3578750905,9
2,1317,38640,3578750896,3578750908,12
2,1317,38641,3578750896,3578750908,12
2,1317,38642,3578750896,3578750909,13
2,1317,38643,3578750896,3578750909,13
2,1317,38644,3578750896,3578750911,15
2,1317,38645,3578750896,3578750913,17
2,1317,38646,3578750896,3578750913,17
2,1317,38647,3578750896,3578750913,17
2,1317,38648,3578750896,3578750915,19
2,1317,38649,3578750896,3578750915,19
2,1317,38650,3578750896,3578750916,20
2,1317,38651,3578750896,3578750916,20
2,1317,38652,3578750896,3578750916,20
2,1317,38653,3578750896,3578750917,21
2,1317,38654,3578750896,3578750917,21
2,1317,38655,3578750896,3578750918,22
2,1317,38656,3578750896,3578750919,23
2,1317,38657,3578750896,3578750919,23
2,1317,38658,3578750896,3578750919,23
2,1317,38659,3578750896,3578750920,24
2,1317,38660,3578750896,3578750920,24
2,1317,38661,3578750896,3578750921,25
2,1317,38662,3578750896,3578750921,25
2,1317,38663,3578750896,3578750921,25
2,1317,38664,3578750896,3578750922,26
2,1317,38665,3578750896,3578750922,26
2,1317,38666,3578750896,3578750922,26
2,1317,38667,3578750896,3578750923,27
2,1317,38668,3578750896,3578750925,29
2,1317,38669,3578750896,3578750925,29
2,1317,38670,3578750896,3578750926,30
2,1317,38671,3578750896,3578750927,31
2,1317,38672,3578750896,3578750928,32
2,1317,38673,3578750896,3578750929,33
2,1317,38674,3578750896,3578750933,37
2,1317,38675,3578750896,3578750933,37
2,1317,38676,3578750896,3578750934,38
2,1317,38677,3578750896,3578750935,39
2,1317,38678,3578750896,3578750935,39
2,1317,38679,3578750896,3578750935,39
2,1317,38680,3578750896,3578750936,40
2,1317,38681,3578750896,3578750937,41
2,1317,38682,3578750896,3578750937,41
2,1317,38683,3578750896,3578750938,42
2,1317,38684,3578750896,3578750938,42
2,1317,38685,3578750896,3578750938,42
2,1317,38686,3578750896,3578750938,42
2,1317,38687,3578750896,3578750939,43
2,1317,38688,3578750896,3578750939,43
2,1317,38689,3578750896,3578750940,44
2,1317,38690,3578750896,3578750941,45
2,1317,38691,3578750896,3578750942,46
2,1317,38692,3578750896,3578750942,46
2,1317,38693,3578750896,3578750942,46
2,1317,38694,3578750896,3578750942,46
2,1317,38695,3578750896,3578750944,48
2,1317,38696,3578750896,3578750944,48
2,1317,38697,3578750896,3578750945,49
2,1318,38698,3578750959,3578750959,0
2,1318,38699,3578750959,3578750959,0
2,1318,38700,3578750959,3578750960,1
2,1318,38701,3578750959,3578750960,1
2,1318,38702,3578750959,3578750960,1
2,1318,38703,3578750959,3578750960,1
2,1318,38704,3578750959,3578750960,1
2,1318,38705,3578750959,3578750960,1
2,1318,38706,3578750959,3578750960,1
2,1318,38707,3578750959,3578750960,1
2,1318,38708,3578750959,3578750960,1
2,1318,38709,3578750959,3578750960,1
2,1318,38710,3578750959,3578750960,1
2,1318,38711,3578750959,3578750961,2
2,1318,38712,3578750959,3578750963,4
2,1318,38713,3578750959,3578750965,6
2,1318,38714,3578750959,3578750966,7
2,1318,38715,3578750959,3578750966,7
2,1318,38716,3578750959,3578750966,7
2,1318,38717,3578750959,3578750967,8
2,1318,38718,3578750959,3578750967,8
2,1318,38719,3578750959,3578750968,9
2,1318,38720,3578750959,3578750969,10
2,1318,38721,3578750959,3578750970,11
2,1318,38722,3578750959,3578750971,12
2,1318,38723,3578750959,3578750972,13
2,1318,38724,3578750959,3578750973,14
2,1318,38725,3578750959,3578750974,15
2,1318,38726,3578750959,3578750974,15
2,1318,38727,3578750959,3578750975,16
2,1318,38728,3578750959,3578750975,16
2,1318,38729,3578750959,3578750977,18
2,1318,38730,3578750959,3578750978,19
2,1318,38731,3578750959,3578750978,19
2,1318,38732,3578750959,3578750979,20
2,1318,38733,3578750959,3578750979,20
2,1318,38734,3578750959,3578750979,20
2,1318,38735,3578750959,3578750981,22
2,1318,38736,3578750959,3578750982,23
2,1318,38737,3578750959,3578750982,23
2,1318,38738,3578750959,3578750985,26
2,1318,38739,3578750959,3578750985,26
2,1318,38740,3578750959,3578750988,29
2,1318,38741,3578750959,3578750989,30
2,1318,38742,3578750959,3578750990,31
2,1318,38743,3578750959,3578750990,31
2,1318,38744,3578750959,3578750992,33
2,1318,38745,3578750959,3578750993,34
2,1318,38746,3578750959,3578750993,34
2,1318,38747,3578750959,3578750993,34
2,1318,38748,3578750959,3578750993,34
2,1318,38749,3578750959,3578750994,35
2,1318,38750,3578750959,3578750995,36
2,1318,38751,3578750959,3578750996,37
2,1318,38752,3578750959,3578750998,39
2,1318,38753,3578750959,3578750999,40
2,1318,38754,3578750959,3578751000,41
2,1318,38755,3578750959,3578751002,43
2,1318,38756,3578750959,3578751003,44
2,1318,38757,3578750959,3578751004,45
2,1318,38758,3578750959,3578751006,47
2,1318,38759,3578750959,3578751007,48
2,1318,38760,3578750959,3578751009,50
2,1319,38761,3578751021,3578751021,0
2,1319,38762,3578751021,3578751021,0
2,1319,38763,3578751021,3578751021,0
2,1319,38764,3578751021,3578751021,0
2,1319,38765,3578751021,3578751021,0
2,1319,38766,3578751021,3578751021,0
2,1319,38767,3578751021,3578751021,0
2,1319,38768,3578751021,3578751021,0
2,1319,38769,3578751021,3578751021,0
2,1319,38770,3578751021,3578751021,0
2,1319,38771,3578751021,3578751021,0
2,1319,38772,3578751021,3578751021,0
2,1319,38773,3578751021,3578751021,0
2,1319,38774,3578751021,3578751021,0
2,1319,38775,3578751021,3578751021,0
2,1319,38776,3578751021,3578751021,0
2,1319,38777,3578751021,3578751022,1
2,1319,38778,3578751021,3578751024,3
2,1319,38779,3578751021,3578751025,4
2,1319,38780,3578751021,3578751026,5
2,1319,38781,3578751021,3578751027,6
2,1319,38782,3578751021,3578751028,7
2,1319,38783,3578751021,3578751029,8
2,1319,38784,3578751021,3578751030,9
2,1319,38785,3578751021,3578751031,10
2,1319,38786,3578751021,3578751031,10
2,1319,38787,3578751021,3578751032,11
2,1319,38788,3578751021,3578751033,12
2,1319,38789,3578751021,3578751033,12
2,1319,38790,3578751021,3578751036,15
2,1319,38791,3578751021,3578751036,15
2,1319,38792,3578751021,3578751036,15
2,1319,38793,3578751021,3578751037,16
2,1319,38794,3578751021,3578751037,16
2,1319,38795,3578751021,3578751038,17
2,1319,38796,3578751021,3578751038,17
2,1319,38797,3578751021,3578751038,17
2,1319,38798,3578751021,3578751038,17
2,1319,38799,3578751021,3578751038,17
2,1319,38800,3578751021,3578751038,17
2,1319,38801,3578751021,3578751040,19
2,1319,38802,3578751021,3578751041,20
2,1319,38803,3578751021,3578751042,21
2,1319,38804,3578751021,3578751043,22
2,1319,38805,3578751021,3578751044,23
2,1319,38806,3578751021,3578751045,24
2,1319,38807,3578751021,3578751045,24
2,1319,38808,3578751021,3578751046,25
2,1319,38809,3578751021,3578751046,25
2,1319,38810,3578751021,3578751049,28
2,1319,38811,3578751021,3578751051,30
2,1319,38812,3578751021,3578751051,30
2,1319,38813,3578751021,3578751052,31
2,1319,38814,3578751021,3578751053,32
2,1319,38815,3578751021,3578751053,32
2,1319,38816,3578751021,3578751054,33
2,1319,38817,3578751021,3578751054,33
2,1319,38818,3578751021,3578751055,34
2,1319,38819,3578751021,3578751057,36
2,1319,38820,3578751021,3578751057,36
2,1319,38821,3578751021,3578751058,37
2,1319,38822,3578751021,3578751058,37
2,1319,38823,3578751021,3578751058,37
2,1319,38824,3578751021,3578751059,38
2,1319,38825,3578751021,3578751060,39
2,1319,38826,3578751021,3578751060,39
2,1319,38827,3578751021,3578751061,40
2,1319,38828,3578751021,3578751065,44
2,1319,38829,3578751021,3578751065,44
2,1319,38830,3578751021,3578751067,46
2,1319,38831,3578751021,3578751067,46
2,1319,38832,3578751021,3578751067,46
2,1319,38833,3578751021,3578751068,47
2,1319,38834,3578751021,3578751069,48
2,1319,38835,3578751021,3578751070,49
2,1320,38836,3578751083,3578751083,0
2,1320,38837,3578751083,3578751083,0
2,1320,38838,3578751083,3578751083,0
2,1320,38839,3578751083,3578751083,0
2,1320,38840,3578751083,3578751083,0
2,1320,38841,3578751083,3578751083,0
2,1320,38842,3578751083,3578751083,0
2,1320,38843,3578751083,3578751083,0
2,1320,38844,3578751083,3578751083,0
2,1320,38845,3578751083,3578751083,0
2,1320,38846,3578751083,3578751084,1
2,1320,38847,3578751083,3578751086,3
2,1320,38848,3578751083,3578751086,3
2,1320,38849,3578751083,3578751087,4
2,1320,38850,3578751083,3578751087,4
2,1320,38851,3578751083,3578751088,5
2,1320,38852,3578751083,3578751089,6
2,1320,38853,3578751083,3578751090,7
2,1320,38854,3578751083,3578751090,7
2,1320,38855,3578751083,3578751090,7
2,1320,38856,3578751083,3578751091,8
2,1320,38857,3578751083,3578751092,9
2,1320,38858,3578751083,3578751093,10
2,1320,38859,3578751083,3578751094,11
2,1320,38860,3578751083,3578751094,11
2,1320,38861,3578751083,3578751094,11
2,1320,38862,3578751083,3578751095,12
2,1320,38863,3578751083,3578751096,13
2,1320,38864,3578751083,3578751096,13
2,1320,38865,3578751083,3578751096,13
2,1320,38866,3578751083,3578751096,13
2,1320,38867,3578751083,3578751098,15
2,1320,38868,3578751083,3578751099,16
2,1320,38869,3578751083,3578751100,17
2,1320,38870,3578751083,3578751101,18
2,1320,38871,3578751083,3578751101,18
2,1320,38872,3578751083,3578751102,19
2,1320,38873,3578751083,3578751102,19
2,1320,38874,3578751083,3578751102,19
2,1320,38875,3578751083,3578751103,20
2,1320,38876,3578751083,3578751104,21
2,1320,38877,3578751083,3578751106,23
2,1320,38878,3578751083,3578751107,24
2,1320,38879,3578751083,3578751108,25
2,1320,38880,3578751083,3578751109,26
2,1320,38881,3578751083,3578751110,27
2,1320,38882,3578751083,3578751111,28
2,1320,38883,3578751083,3578751112,29
2,1320,38884,3578751083,3578751113,30
2,1320,38885,3578751083,3578751113,30
2,1320,38886,3578751083,3578751115,32
2,1320,38887,3578751083,3578751116,33
2,1320,38888,3578751083,3578751116,33
2,1320,38889,3578751083,3578751116,33
2,1320,38890,3578751083,3578751117,34
2,1320,38891,3578751083,3578751117,34
2,1320,38892,3578751083,3578751117,34
2,1320,38893,3578751083,3578751117,34
2,1320,38894,3578751083,3578751118,35
2,1320,38895,3578751083,3578751119,36
2,1320,38896,3578751083,3578751119,36
2,1320,38897,3578751083,3578751120,37
2,1320,38898,3578751083,3578751120,37
2,1320,38899,3578751083,3578751121,38
2,1320,38900,3578751083,3578751121,38
2,1320,38901,3578751083,3578751121,38
2,1320,38902,3578751083,3578751121,38
2,1320,38903,3578751083,3578751122,39
2,1320,38904,3578751083,3578751122,39
2,1320,38905,3578751083,3578751123,40
2,1320,38906,3578751083,3578751123,40
2,1320,38907,3578751083,3578751125,42
2,1320,38908,3578751083,3578751126,43
2,1320,38909,3578751083,3578751126,43
2,1320,38910,3578751083,3578751127,44
2,1320,38911,3578751083,3578751128,45
2,1320,38912,3578751083,3578751128,45
2,1320,38913,3578751083,3578751130,47
2,1321,38914,3578751144,3578751144,0
2,1321,38915,3578751144,3578751144,0
2,1321,38916,3578751144,3578751144,0
2,1321,38917,3578751144,3578751144,0
2,1321,38918,3578751144,3578751144,0
2,1321,38919,3578751144,3578751144,0
2,1321,38920,3578751144,3578751144,0
2,1321,38921,3578751144,3578751144,0
2,1321,38922,3578751144,3578751144,0
2,1321,38923,3578751144,3578751144,0
2,1321,38924,3578751144,3578751144,0
2,1321,38925,3578751144,3578751144,0
2,1321,38926,3578751144,3578751144,0
2,1321,38927,3578751144,3578751144,0
2,1321,38928,3578751144,3578751144,0
2,1321,38929,3578751144,3578751144,0
2,1321,38930,3578751144,3578751144,0
2,1321,38931,3578751144,3578751144,0
2,1321,38932,3578751144,3578751144,0
2,1321,38933,3578751144,3578751144,0
2,1321,38934,3578751144,3578751144,0
2,1321,38935,3578751144,3578751145,1
2,1321,38936,3578751144,3578751148,4
2,1321,38937,3578751144,3578751148,4
2,1321,38938,3578751144,3578751151,7
2,1321,38939,3578751144,3578751152,8
2,1321,38940,3578751144,3578751154,10
2,1321,38941,3578751144,3578751154,10
2,1321,38942,3578751144,3578751154,10
2,1321,38943,3578751144,3578751155,11
2,1321,38944,3578751144,3578751155,11
2,1321,38945,3578751144,3578751156,12
2,1321,38946,3578751144,3578751156,12
2,1321,38947,3578751144,3578751156,12
2,1321,38948,3578751144,3578751159,15
2,1321,38949,3578751144,3578751160,16
2,1321,38950,3578751144,3578751160,16
2,1321,38951,3578751144,3578751162,18
2,1321,38952,3578751144,3578751163,19
2,1321,38953,3578751144,3578751163,19
2,1321,38954,3578751144,3578751165,21
2,1321,38955,3578751144,3578751165,21
2,1321,38956,3578751144,3578751166,22
2,1321,38957,3578751144,3578751166,22
2,1321,38958,3578751144,3578751167,23
2,1321,38959,3578751144,3578751168,24
2,1321,38960,3578751144,3578751169,25
2,1321,38961,3578751144,3578751169,25
2,1321,38962,3578751144,3578751171,27
2,1321,38963,3578751144,3578751171,27
2,1321,38964,3578751144,3578751172,28
2,1321,38965,3578751144,3578751173,29
2,1321,38966,3578751144,3578751174,30
2,1321,38967,3578751144,3578751174,30
2,1321,38968,3578751144,3578751174,30
2,1321,38969,3578751144,3578751177,33
2,1321,38970,3578751144,3578751178,34
2,1321,38971,3578751144,3578751178,34
2,1321,38972,3578751144,3578751179,35
2,1321,38973,3578751144,3578751179,35
2,1321,38974,3578751144,3578751180,36
2,1321,38975,3578751144,3578751182,38
2,1321,38976,3578751144,3578751182,38
2,1321,38977,3578751144,3578751183,39
2,1321,38978,3578751144,3578751185,41
2,1321,38979,3578751144,3578751185,41
2,1321,38980,3578751144,3578751188,44
2,1321,38981,3578751144,3578751189,45
2,1321,38982,3578751144,3578751191,47
2,1321,38983,3578751144,3578751191,47
2,1321,38984,3578751144,3578751192,48
2,1321,38985,3578751144,3578751193,49
2,1321,38986,3578751144,3578751193,49
2,1321,38987,3578751144,3578751193,49
2,1321,38988,3578751144,3578751194,50
2,1322,38989,3578751208,3578751208,0
2,1322,38990,3578751208,3578751208,0
2,1322,38991,3578751208,3578751208,0
2,1322,38992,3578751208,3578751208,0
2,1322,38993,3578751208,3578751208,0
2,1322,38994,3578751208,3578751208,0
2,1322,38995,3578751208,3578751208,0
2,1322,38996,3578751208,3578751208,0
2,1322,38997,3578751208,3578751208,0
2,1322,38998,3578751208,3578751208,0
2,1322,38999,3578751208,3578751208,0
2,1322,39000,3578751208,3578751208,0
2,1322,39001,3578751208,3578751210,2
2,1322,39002,3578751208,3578751211,3
2,1322,39003,3578751208,3578751213,5
2,1322,39004,3578751208,3578751214,6
2,1322,39005,3578751208,3578751214,6
2,1322,39006,3578751208,3578751214,6
2,1322,39007,3578751208,3578751214,6
2,1322,39008,3578751208,3578751216,8
2,1322,39009,3578751208,3578751217,9
2,1322,39010,3578751208,3578751218,10
2,1322,39011,3578751208,3578751218,10
2,1322,39012,3578751208,3578751218,10
2,1322,39013,3578751208,3578751219,11
2,1322,39014,3578751208,3578751220,12
2,1322,39015,3578751208,3578751220,12
2,1322,39016,3578751208,3578751220,12
2,1322,39017,3578751208,3578751222,14
2,1322,39018,3578751208,3578751225,17
2,1322,39019,3578751208,3578751226,18
2,1322,39020,3578751208,3578751227,19
2,1322,39021,3578751208,3578751227,19
2,1322,39022,3578751208,3578751228,20
2,1322,39023,3578751208,3578751229,21
2,1322,39024,3578751208,3578751231,23
2,1322,39025,3578751208,3578751231,23
2,1322,39026,3578751208,3578751232,24
2,1322,39027,3578751208,3578751232,24
2,1322,39028,3578751208,3578751233,25
2,1322,39029,3578751208,3578751235,27
2,1322,39030,3578751208,3578751236,28
2,1322,39031,3578751208,3578751236,28
2,1322,39032,3578751208,3578751237,29
2,1322,39033,3578751208,3578751237,29
2,1322,39034,3578751208,3578751237,29
2,1322,39035,3578751208,3578751238,30
2,1322,39036,3578751208,3578751239,31
2,1322,39037,3578751208,3578751239,31
2,1322,39038,3578751208,3578751239,31
2,1322,39039,3578751208,3578751239,31
2,1322,39040,3578751208,3578751239,31
2,1322,39041,3578751208,3578751241,33
2,1322,39042,3578751208,3578751242,34
2,1322,39043,3578751208,3578751243,35
2,1322,39044,3578751208,3578751244,36
2,1322,39045,3578751208,3578751244,36
2,1322,39046,3578751208,3578751245,37
2,1322,39047,3578751208,3578751245,37
2,1322,39048,3578751208,3578751246,38
2,1322,39049,3578751208,3578751247,39
2,1322,39050,3578751208,3578751249,41
2,1322,39051,3578751208,3578751251,43
2,1322,39052,3578751208,3578751252,44
2,1322,39053,3578751208,3578751252,44
2,1322,39054,3578751208,3578751253,45
2,1322,39055,3578751208,3578751254,46
2,1322,39056,3578751208,3578751254,46
2,1322,39057,3578751208,3578751255,47
2,1322,39058,3578751208,3578751256,48
2,1322,39059,3578751208,3578751257,49
2,1322,39060,3578751208,3578751257,49
2,1322,39061,3578751208,3578751258,50
2,1323,39062,3578751271,3578751272,1
2,1323,39063,3578751271,3578751272,1
2,1323,39064,3578751271,3578751272,1
2,1323,39065,3578751271,3578751272,1
2,1323,39066,3578751271,3578751272,1
2,1323,39067,3578751271,3578751272,1
2,1323,39068,3578751271,3578751272,1
2,1323,39069,3578751271,3578751272,1
2,1323,39070,3578751271,3578751272,1
2,1323,39071,3578751271,3578751272,1
2,1323,39072,3578751271,3578751272,1
2,1323,39073,3578751271,3578751272,1
2,1323,39074,3578751271,3578751272,1
2,1323,39075,3578751271,3578751274,3
2,1323,39076,3578751271,3578751276,5
2,1323,39077,3578751271,3578751277,6
2,1323,39078,3578751271,3578751279,8
2,1323,39079,3578751271,3578751279,8
2,1323,39080,3578751271,3578751280,9
2,1323,39081,3578751271,3578751281,10
2,1323,39082,3578751271,3578751282,11
2,1323,39083,3578751271,3578751283,12
2,1323,39084,3578751271,3578751286,15
2,1323,39085,3578751271,3578751286,15
2,1323,39086,3578751271,3578751286,15
2,1323,39087,3578751271,3578751287,16
2,1323,39088,3578751271,3578751288,17
2,1323,39089,3578751271,3578751288,17
2,1323,39090,3578751271,3578751289,18
2,1323,39091,3578751271,3578751290,19
2,1323,39092,3578751271,3578751290,19
2,1323,39093,3578751271,3578751290,19
2,1323,39094,3578751271,3578751291,20
2,1323,39095,3578751271,3578751292,21
2,1323,39096,3578751271,3578751293,22
2,1323,39097,3578751271,3578751294,23
2,1323,39098,3578751271,3578751294,23
2,1323,39099,3578751271,3578751294,23
2,1323,39100,3578751271,3578751295,24
2,1323,39101,3578751271,3578751296,25
2,1323,39102,3578751271,3578751296,25
2,1323,39103,3578751271,3578751296,25
2,1323,39104,3578751271,3578751296,25
2,1323,39105,3578751271,3578751298,27
2,1323,39106,3578751271,3578751299,28
2,1323,39107,3578751271,3578751300,29
2,1323,39108,3578751271,3578751300,29
2,1323,39109,3578751271,3578751301,30
2,1323,39110,3578751271,3578751302,31
2,1323,39111,3578751271,3578751303,32
2,1323,39112,3578751271,3578751303,32
2,1323,39113,3578751271,3578751304,33
2,1323,39114,3578751271,3578751306,35
2,1323,39115,3578751271,3578751307,36
2,1323,39116,3578751271,3578751308,37
2,1323,39117,3578751271,3578751309,38
2,1323,39118,3578751271,3578751310,39
2,1323,39119,3578751271,3578751311,40
2,1323,39120,3578751271,3578751312,41
2,1323,39121,3578751271,3578751313,42
2,1323,39122,3578751271,3578751314,43
2,1323,39123,3578751271,3578751314,43
2,1323,39124,3578751271,3578751314,43
2,1323,39125,3578751271,3578751315,44
2,1323,39126,3578751271,3578751316,45
2,1323,39127,3578751271,3578751316,45
2,1323,39128,3578751271,3578751316,45
2,1323,39129,3578751271,3578751317,46
2,1323,39130,3578751271,3578751317,46
2,1323,39131,3578751271,3578751318,47
2,1323,39132,3578751271,3578751318,47
2,1323,39133,3578751271,3578751318,47
2,1323,39134,3578751271,3578751319,48
2,1323,39135,3578751271,3578751319,48
2,1323,39136,3578751271,3578751320,49
2,1323,39137,3578751271,3578751320,49
2,1323,39138,3578751271,3578751321,50
2,1324,39139,3578751333,3578751333,0
2,1324,39140,3578751333,3578751333,0
2,1324,39141,3578751333,3578751333,0
2,1324,39142,3578751333,3578751333,0
2,1324,39143,3578751333,3578751333,0
2,1324,39144,3578751333,3578751333,0
2,1324,39145,3578751333,3578751333,0
2,1324,39146,3578751333,3578751333,0
2,1324,39147,3578751333,3578751333,0
2,1324,39148,3578751333,3578751333,0
2,1324,39149,3578751333,3578751333,0
2,1324,39150,3578751333,3578751333,0
2,1324,39151,3578751333,3578751333,0
2,1324,39152,3578751333,3578751333,0
2,1324,39153,3578751333,3578751333,0
2,1324,39154,3578751333,3578751333,0
2,1324,39155,3578751333,3578751334,1
2,1324,39156,3578751333,3578751335,2
2,1324,39157,3578751333,3578751335,2
2,1324,39158,3578751333,3578751337,4
2,1324,39159,3578751333,3578751337,4
2,1324,39160,3578751333,3578751337,4
2,1324,39161,3578751333,3578751338,5
2,1324,39162,3578751333,3578751339,6
2,1324,39163,3578751333,3578751339,6
2,1324,39164,3578751333,3578751339,6
2,1324,39165,3578751333,3578751340,7
2,1324,39166,3578751333,3578751341,8
2,1324,39167,3578751333,3578751341,8
2,1324,39168,3578751333,3578751342,9
2,1324,39169,3578751333,3578751342,9
2,1324,39170,3578751333,3578751343,10
2,1324,39171,3578751333,3578751344,11
2,1324,39172,3578751333,3578751344,11
2,1324,39173,3578751333,3578751344,11
2,1324,39174,3578751333,3578751345,12
2,1324,39175,3578751333,3578751348,15
2,1324,39176,3578751333,3578751348,15
2,1324,39177,3578751333,3578751351,18
2,1324,39178,3578751333,3578751352,19
2,1324,39179,3578751333,3578751354,21
2,1324,39180,3578751333,3578751354,21
2,1324,39181,3578751333,3578751354,21
2,1324,39182,3578751333,3578751355,22
2,1324,39183,3578751333,3578751356,23
2,1324,39184,3578751333,3578751356,23
2,1324,39185,3578751333,3578751357,24
2,1324,39186,3578751333,3578751357,24
2,1324,39187,3578751333,3578751358,25
2,1324,39188,3578751333,3578751360,27
2,1324,39189,3578751333,3578751360,27
2,1324,39190,3578751333,3578751361,28
2,1324,39191,3578751333,3578751364,31
2,1324,39192,3578751333,3578751366,33
2,1324,39193,3578751333,3578751366,33
2,1324,39194,3578751333,3578751366,33
2,1324,39195,3578751333,3578751366,33
2,1324,39196,3578751333,3578751367,34
2,1324,39197,3578751333,3578751368,35
2,1324,39198,3578751333,3578751369,36
2,1324,39199,3578751333,3578751370,37
2,1324,39200,3578751333,3578751370,37
2,1324,39201,3578751333,3578751371,38
2,1324,39202,3578751333,3578751372,39
2,1324,39203,3578751333,3578751373,40
2,1324,39204,3578751333,3578751374,41
2,1324,39205,3578751333,3578751375,42
2,1324,39206,3578751333,3578751375,42
2,1324,39207,3578751333,3578751376,43
2,1324,39208,3578751333,3578751377,44
2,1324,39209,3578751333,3578751379,46
2,1324,39210,3578751333,3578751379,46
2,1324,39211,3578751333,3578751379,46
2,1324,39212,3578751333,3578751379,46
2,1324,39213,3578751333,3578751380,47
2,1324,39214,3578751333,3578751382,49
2,1324,39215,3578751333,3578751382,49
2,1324,39216,3578751333,3578751383,50
2,1325,39217,3578751396,3578751396,0
2,1325,39218,3578751396,3578751396,0
2,1325,39219,3578751396,3578751396,0
2,1325,39220,3578751396,3578751396,0
2,1325,39221,3578751396,3578751396,0
2,1325,39222,3578751396,3578751396,0
2,1325,39223,3578751396,3578751396,0
2,1325,39224,3578751396,3578751396,0
2,1325,39225,3578751396,3578751396,0
2,1325,39226,3578751396,3578751396,0
2,1325,39227,3578751396,3578751396,0
2,1325,39228,3578751396,3578751396,0
2,1325,39229,3578751396,3578751396,0
2,1325,39230,3578751396,3578751399,3
2,1325,39231,3578751396,3578751399,3
2,1325,39232,3578751396,3578751400,4
2,1325,39233,3578751396,3578751404,8
2,1325,39234,3578751396,3578751404,8
2,1325,39235,3578751396,3578751405,9
2,1325,39236,3578751396,3578751406,10
2,1325,39237,3578751396,3578751408,12
2,1325,39238,3578751396,3578751409,13
2,1325,39239,3578751396,3578751410,14
2,1325,39240,3578751396,3578751413,17
2,1325,39241,3578751396,3578751413,17
2,1325,39242,3578751396,3578751414,18
2,1325,39243,3578751396,3578751414,18
2,1325,39244,3578751396,3578751415,19
2,1325,39245,3578751396,3578751417,21
2,1325,39246,3578751396,3578751417,21
2,1325,39247,3578751396,3578751418,22
2,1325,39248,3578751396,3578751418,22
2,1325,39249,3578751396,3578751420,24
2,1325,39250,3578751396,3578751420,24
2,1325,39251,3578751396,3578751420,24
2,1325,39252,3578751396,3578751421,25
2,1325,39253,3578751396,3578751421,25
2,1325,39254,3578751396,3578751422,26
2,1325,39255,3578751396,3578751424,28
2,1325,39256,3578751396,3578751424,28
2,1325,39257,3578751396,3578751425,29
2,1325,39258,3578751396,3578751426,30
2,1325,39259,3578751396,3578751428,32
2,1325,39260,3578751396,3578751428,32
2,1325,39261,3578751396,3578751429,33
2,1325,39262,3578751396,3578751431,35
2,1325,39263,3578751396,3578751432,36
2,1325,39264,3578751396,3578751432,36
2,1325,39265,3578751396,3578751433,37
2,1325,39266,3578751396,3578751435,39
2,1325,39267,3578751396,3578751436,40
2,1325,39268,3578751396,3578751436,40
2,1325,39269,3578751396,3578751437,41
2,1325,39270,3578751396,3578751437,41
2,1325,39271,3578751396,3578751437,41
2,1325,39272,3578751396,3578751438,42
2,1325,39273,3578751396,3578751438,42
2,1325,39274,3578751396,3578751438,42
2,1325,39275,3578751396,3578751439,43
2,1325,39276,3578751396,3578751439,43
2,1325,39277,3578751396,3578751440,44
2,1325,39278,3578751396,3578751442,46
2,1325,39279,3578751396,3578751442,46
2,1325,39280,3578751396,3578751444,48
2,1325,39281,3578751396,3578751444,48
2,1325,39282,3578751396,3578751445,49
2,1325,39283,3578751396,3578751445,49
2,1325,39284,3578751396,3578751446,50
2,1326,39285,3578751458,3578751458,0
2,1326,39286,3578751458,3578751458,0
2,1326,39287,3578751458,3578751458,0
2,1326,39288,3578751458,3578751458,0
2,1326,39289,3578751458,3578751458,0
2,1326,39290,3578751458,3578751458,0
2,1326,39291,3578751458,3578751458,0
2,1326,39292,3578751458,3578751458,0
2,1326,39293,3578751458,3578751458,0
2,1326,39294,3578751458,3578751458,0
2,1326,39295,3578751458,3578751458,0
2,1326,39296,3578751458,3578751458,0
2,1326,39297,3578751458,3578751458,0
2,1326,39298,3578751458,3578751458,0
2,1326,39299,3578751458,3578751458,0
2,1326,39300,3578751458,3578751459,1
2,1326,39301,3578751458,3578751460,2
2,1326,39302,3578751458,3578751460,2
2,1326,39303,3578751458,3578751460,2
2,1326,39304,3578751458,3578751465,7
2,1326,39305,3578751458,3578751465,7
2,1326,39306,3578751458,3578751467,9
2,1326,39307,3578751458,3578751467,9
2,1326,39308,3578751458,3578751468,10
2,1326,39309,3578751458,3578751468,10
2,1326,39310,3578751458,3578751470,12
2,1326,39311,3578751458,3578751474,16
2,1326,39312,3578751458,3578751475,17
2,1326,39313,3578751458,3578751479,21
2,1326,39314,3578751458,3578751479,21
2,1326,39315,3578751458,3578751480,22
2,1326,39316,3578751458,3578751481,23
2,1326,39317,3578751458,3578751482,24
2,1326,39318,3578751458,3578751483,25
2,1326,39319,3578751458,3578751483,25
2,1326,39320,3578751458,3578751486,28
2,1326,39321,3578751458,3578751486,28
2,1326,39322,3578751458,3578751487,29
2,1326,39323,3578751458,3578751488,30
2,1326,39324,3578751458,3578751489,31
2,1326,39325,3578751458,3578751489,31
2,1326,39326,3578751458,3578751490,32
2,1326,39327,3578751458,3578751490,32
2,1326,39328,3578751458,3578751490,32
2,1326,39329,3578751458,3578751491,33
2,1326,39330,3578751458,3578751493,35
2,1326,39331,3578751458,3578751493,35
2,1326,39332,3578751458,3578751494,36
2,1326,39333,3578751458,3578751494,36
2,1326,39334,3578751458,3578751494,36
2,1326,39335,3578751458,3578751495,37
2,1326,39336,3578751458,3578751496,38
2,1326,39337,3578751458,3578751496,38
2,1326,39338,3578751458,3578751496,38
2,1326,39339,3578751458,3578751496,38
2,1326,39340,3578751458,3578751497,39
2,1326,39341,3578751458,3578751498,40
2,1326,39342,3578751458,3578751500,42
2,1326,39343,3578751458,3578751500,42
2,1326,39344,3578751458,3578751500,42
2,1326,39345,3578751458,3578751501,43
2,1326,39346,3578751458,3578751501,43
2,1326,39347,3578751458,3578751503,45
2,1326,39348,3578751458,3578751503,45
2,1326,39349,3578751458,3578751504,46
2,1326,39350,3578751458,3578751505,47
2,1326,39351,3578751458,3578751508,50
2,1327,39352,3578751521,3578751521,0
2,1327,39353,3578751521,3578751521,0
2,1327,39354,3578751521,3578751521,0
2,1327,39355,3578751521,3578751521,0
2,1327,39356,3578751521,3578751521,0
2,1327,39357,3578751521,3578751521,0
2,1327,39358,3578751521,3578751521,0
2,1327,39359,3578751521,3578751521,0
2,1327,39360,3578751521,3578751521,0
2,1327,39361,3578751521,3578751521,0
2,1327,39362,3578751521,3578751521,0
2,1327,39363,3578751521,3578751521,0
2,1327,39364,3578751521,3578751521,0
2,1327,39365,3578751521,3578751521,0
2,1327,39366,3578751521,3578751521,0
2,1327,39367,3578751521,3578751521,0
2,1327,39368,3578751521,3578751521,0
2,1327,39369,3578751521,3578751521,0
2,1327,39370,3578751521,3578751521,0
2,1327,39371,3578751521,3578751521,0
2,1327,39372,3578751521,3578751521,0
2,1327,39373,3578751521,3578751521,0
2,1327,39374,3578751521,3578751521,0
2,1327,39375,3578751521,3578751521,0
2,1327,39376,3578751521,3578751522,1
2,1327,39377,3578751521,3578751522,1
2,1327,39378,3578751521,3578751522,1
2,1327,39379,3578751521,3578751524,3
2,1327,39380,3578751521,3578751524,3
2,1327,39381,3578751521,3578751525,4
2,1327,39382,3578751521,3578751526,5
2,1327,39383,3578751521,3578751529,8
2,1327,39384,3578751521,3578751529,8
2,1327,39385,3578751521,3578751532,11
2,1327,39386,3578751521,3578751533,12
2,1327,39387,3578751521,3578751533,12
2,1327,39388,3578751521,3578751534,13
2,1327,39389,3578751521,3578751534,13
2,1327,39390,3578751521,3578751535,14
2,1327,39391,3578751521,3578751536,15
2,1327,39392,3578751521,3578751537,16
2,1327,39393,3578751521,3578751537,16
2,1327,39394,3578751521,3578751538,17
2,1327,39395,3578751521,3578751538,17
2,1327,39396,3578751521,3578751538,17
2,1327,39397,3578751521,3578751538,17
2,1327,39398,3578751521,3578751539,18
2,1327,39399,3578751521,3578751540,19
2,1327,39400,3578751521,3578751540,19
2,1327,39401,3578751521,3578751540,19
2,1327,39402,3578751521,3578751541,20
2,1327,39403,3578751521,3578751543,22
2,1327,39404,3578751521,3578751543,22
2,1327,39405,3578751521,3578751544,23
2,1327,39406,3578751521,3578751547,26
2,1327,39407,3578751521,3578751548,27
2,1327,39408,3578751521,3578751550,29
2,1327,39409,3578751521,3578751550,29
2,1327,39410,3578751521,3578751551,30
2,1327,39411,3578751521,3578751553,32
2,1327,39412,3578751521,3578751553,32
2,1327,39413,3578751521,3578751553,32
2,1327,39414,3578751521,3578751555,34
2,1327,39415,3578751521,3578751555,34
2,1327,39416,3578751521,3578751556,35
2,1327,39417,3578751521,3578751556,35
2,1327,39418,3578751521,3578751556,35
2,1327,39419,3578751521,3578751557,36
2,1327,39420,3578751521,3578751559,38
2,1327,39421,3578751521,3578751559,38
2,1327,39422,3578751521,3578751560,39
2,1327,39423,3578751521,3578751563,42
2,1327,39424,3578751521,3578751564,43
2,1327,39425,3578751521,3578751565,44
2,1327,39426,3578751521,3578751565,44
2,1327,39427,3578751521,3578751565,44
2,1327,39428,3578751521,3578751566,45
2,1327,39429,3578751521,3578751567,46
2,1327,39430,3578751521,3578751568,47
2,1327,39431,3578751521,3578751569,48
2,1327,39432,3578751521,3578751569,48
2,1327,39433,3578751521,3578751570,49
2,1327,39434,3578751521,3578751571,50
2,1328,39435,3578751583,3578751583,0
2,1328,39436,3578751583,3578751583,0
2,1328,39437,3578751583,3578751583,0
2,1328,39438,3578751583,3578751583,0
2,1328,39439,3578751583,3578751583,0
2,1328,39440,3578751583,3578751583,0
2,1328,39441,3578751583,3578751583,0
2,1328,39442,3578751583,3578751583,0
2,1328,39443,3578751583,3578751583,0
2,1328,39444,3578751583,3578751583,0
2,1328,39445,3578751583,3578751583,0
2,1328,39446,3578751583,3578751583,0
2,1328,39447,3578751583,3578751583,0
2,1328,39448,3578751583,3578751583,0
2,1328,39449,3578751583,3578751589,6
2,1328,39450,3578751583,3578751590,7
2,1328,39451,3578751583,3578751590,7
2,1328,39452,3578751583,3578751592,9
2,1328,39453,3578751583,3578751592,9
2,1328,39454,3578751583,3578751592,9
2,1328,39455,3578751583,3578751592,9
2,1328,39456,3578751583,3578751592,9
2,1328,39457,3578751583,3578751594,11
2,1328,39458,3578751583,3578751594,11
2,1328,39459,3578751583,3578751594,11
2,1328,39460,3578751583,3578751595,12
2,1328,39461,3578751583,3578751596,13
2,1328,39462,3578751583,3578751597,14
2,1328,39463,3578751583,3578751598,15
2,1328,39464,3578751583,3578751599,16
2,1328,39465,3578751583,3578751599,16
2,1328,39466,3578751583,3578751603,20
2,1328,39467,3578751583,3578751603,20
2,1328,39468,3578751583,3578751603,20
2,1328,39469,3578751583,3578751606,23
2,1328,39470,3578751583,3578751606,23
2,1328,39471,3578751583,3578751607,24
2,1328,39472,3578751583,3578751609,26
2,1328,39473,3578751583,3578751611,28
2,1328,39474,3578751583,3578751612,29
2,1328,39475,3578751583,3578751613,30
2,1328,39476,3578751583,3578751613,30
2,1328,39477,3578751583,3578751613,30
2,1328,39478,3578751583,3578751613,30
2,1328,39479,3578751583,3578751616,33
2,1328,39480,3578751583,3578751616,33
2,1328,39481,3578751583,3578751616,33
2,1328,39482,3578751583,3578751618,35
2,1328,39483,3578751583,3578751619,36
2,1328,39484,3578751583,3578751619,36
2,1328,39485,3578751583,3578751619,36
2,1328,39486,3578751583,3578751620,37
2,1328,39487,3578751583,3578751621,38
2,1328,39488,3578751583,3578751623,40
2,1328,39489,3578751583,3578751624,41
2,1328,39490,3578751583,3578751624,41
2,1328,39491,3578751583,3578751626,43
2,1328,39492,3578751583,3578751627,44
2,1328,39493,3578751583,3578751628,45
2,1328,39494,3578751583,3578751628,45
2,1328,39495,3578751583,3578751631,48
2,1328,39496,3578751583,3578751632,49
2,1328,39497,3578751583,3578751632,49
2,1329,39498,3578751645,3578751645,0
2,1329,39499,3578751645,3578751645,0
2,1329,39500,3578751645,3578751645,0
2,1329,39501,3578751645,3578751645,0
2,1329,39502,3578751645,3578751645,0
2,1329,39503,3578751645,3578751645,0
2,1329,39504,3578751645,3578751645,0
2,1329,39505,3578751645,3578751645,0
2,1329,39506,3578751645,3578751645,0
2,1329,39507,3578751645,3578751645,0
2,1329,39508,3578751645,3578751645,0
2,1329,39509,3578751645,3578751645,0
2,1329,39510,3578751645,3578751645,0
2,1329,39511,3578751645,3578751645,0
2,1329,39512,3578751645,3578751645,0
2,1329,39513,3578751645,3578751645,0
2,1329,39514,3578751645,3578751645,0
2,1329,39515,3578751645,3578751645,0
2,1329,39516,3578751645,3578751645,0
2,1329,39517,3578751645,3578751646,1
2,1329,39518,3578751645,3578751647,2
2,1329,39519,3578751645,3578751650,5
2,1329,39520,3578751645,3578751651,6
2,1329,39521,3578751645,3578751652,7
2,1329,39522,3578751645,3578751652,7
2,1329,39523,3578751645,3578751654,9
2,1329,39524,3578751645,3578751655,10
2,1329,39525,3578751645,3578751655,10
2,1329,39526,3578751645,3578751657,12
2,1329,39527,3578751645,3578751657,12
2,1329,39528,3578751645,3578751657,12
2,1329,39529,3578751645,3578751658,13
2,1329,39530,3578751645,3578751658,13
2,1329,39531,3578751645,3578751659,14
2,1329,39532,3578751645,3578751659,14
2,1329,39533,3578751645,3578751663,18
2,1329,39534,3578751645,3578751665,20
2,1329,39535,3578751645,3578751667,22
2,1329,39536,3578751645,3578751667,22
2,1329,39537,3578751645,3578751667,22
2,1329,39538,3578751645,3578751667,22
2,1329,39539,3578751645,3578751670,25
2,1329,39540,3578751645,3578751674,29
2,1329,39541,3578751645,3578751679,34
2,1329,39542,3578751645,3578751680,35
2,1329,39543,3578751645,3578751680,35
2,1329,39544,3578751645,3578751681,36
2,1329,39545,3578751645,3578751682,37
2,1329,39546,3578751645,3578751683,38
2,1329,39547,3578751645,3578751683,38
2,1329,39548,3578751645,3578751684,39
2,1329,39549,3578751645,3578751686,41
2,1329,39550,3578751645,3578751686,41
2,1329,39551,3578751645,3578751687,42
2,1329,39552,3578751645,3578751688,43
2,1329,39553,3578751645,3578751689,44
2,1329,39554,3578751645,3578751690,45
2,1329,39555,3578751645,3578751690,45
2,1329,39556,3578751645,3578751690,45
2,1329,39557,3578751645,3578751691,46
2,1329,39558,3578751645,3578751693,48
2,1329,39559,3578751645,3578751693,48
2,1329,39560,3578751645,3578751694,49
2,1329,39561,3578751645,3578751694,49
2,1329,39562,3578751645,3578751694,49
2,1330,39563,3578751707,3578751707,0
2,1330,39564,3578751707,3578751707,0
2,1330,39565,3578751707,3578751707,0
2,1330,39566,3578751707,3578751707,0
2,1330,39567,3578751707,3578751707,0
2,1330,39568,3578751707,3578751707,0
2,1330,39569,3578751707,3578751707,0
2,1330,39570,3578751707,3578751707,0
2,1330,39571,3578751707,3578751707,0
2,1330,39572,3578751707,3578751707,0
2,1330,39573,3578751707,3578751707,0
2,1330,39574,3578751707,3578751707,0
2,1330,39575,3578751707,3578751707,0
2,1330,39576,3578751707,3578751707,0
2,1330,39577,3578751707,3578751707,0
2,1330,39578,3578751707,3578751707,0
2,1330,39579,3578751707,3578751708,1
2,1330,39580,3578751707,3578751708,1
2,1330,39581,3578751707,3578751710,3
2,1330,39582,3578751707,3578751710,3
2,1330,39583,3578751707,3578751711,4
2,1330,39584,3578751707,3578751713,6
2,1330,39585,3578751707,3578751713,6
2,1330,39586,3578751707,3578751714,7
2,1330,39587,3578751707,3578751714,7
2,1330,39588,3578751707,3578751715,8
2,1330,39589,3578751707,3578751715,8
2,1330,39590,3578751707,3578751715,8
2,1330,39591,3578751707,3578751716,9
2,1330,39592,3578751707,3578751716,9
2,1330,39593,3578751707,3578751717,10
2,1330,39594,3578751707,3578751717,10
2,1330,39595,3578751707,3578751717,10
2,1330,39596,3578751707,3578751718,11
2,1330,39597,3578751707,3578751719,12
2,1330,39598,3578751707,3578751719,12
2,1330,39599,3578751707,3578751720,13
2,1330,39600,3578751707,3578751721,14
2,1330,39601,3578751707,3578751721,14
2,1330,39602,3578751707,3578751722,15
2,1330,39603,3578751707,3578751722,15
2,1330,39604,3578751707,3578751722,15
2,1330,39605,3578751707,3578751723,16
2,1330,39606,3578751707,3578751724,17
2,1330,39607,3578751707,3578751724,17
2,1330,39608,3578751707,3578751726,19
2,1330,39609,3578751707,3578751726,19
2,1330,39610,3578751707,3578751729,22
2,1330,39611,3578751707,3578751730,23
2,1330,39612,3578751707,3578751731,24
2,1330,39613,3578751707,3578751732,25
2,1330,39614,3578751707,3578751733,26
2,1330,39615,3578751707,3578751734,27
2,1330,39616,3578751707,3578751734,27
2,1330,39617,3578751707,3578751735,28
2,1330,39618,3578751707,3578751735,28
2,1330,39619,3578751707,3578751736,29
2,1330,39620,3578751707,3578751736,29
2,1330,39621,3578751707,3578751737,30
2,1330,39622,3578751707,3578751738,31
2,1330,39623,3578751707,3578751738,31
2,1330,39624,3578751707,3578751738,31
2,1330,39625,3578751707,3578751739,32
2,1330,39626,3578751707,3578751740,33
2,1330,39627,3578751707,3578751740,33
2,1330,39628,3578751707,3578751740,33
2,1330,39629,3578751707,3578751741,34
2,1330,39630,3578751707,3578751743,36
2,1330,39631,3578751707,3578751743,36
2,1330,39632,3578751707,3578751743,36
2,1330,39633,3578751707,3578751744,37
2,1330,39634,3578751707,3578751745,38
2,1330,39635,3578751707,3578751748,41
2,1330,39636,3578751707,3578751748,41
2,1330,39637,3578751707,3578751750,43
2,1330,39638,3578751707,3578751750,43
2,1330,39639,3578751707,3578751752,45
2,1330,39640,3578751707,3578751753,46
2,1330,39641,3578751707,3578751753,46
2,1330,39642,3578751707,3578751753,46
2,1330,39643,3578751707,3578751753,46
2,1330,39644,3578751707,3578751754,47
2,1330,39645,3578751707,3578751755,48
2,1330,39646,3578751707,3578751756,49
2,1330,39647,3578751707,3578751756,49
2,1330,39648,3578751707,3578751756,49
2,1330,39649,3578751707,3578751757,50
2,1331,39650,3578751770,3578751770,0
2,1331,39651,3578751770,3578751770,0
2,1331,39652,3578751770,3578751770,0
2,1331,39653,3578751770,3578751770,0
2,1331,39654,3578751770,3578751770,0
2,1331,39655,3578751770,3578751770,0
2,1331,39656,3578751770,3578751770,0
2,1331,39657,3578751770,3578751770,0
2,1331,39658,3578751770,3578751770,0
2,1331,39659,3578751770,3578751770,0
2,1331,39660,3578751770,3578751770,0
2,1331,39661,3578751770,3578751770,0
2,1331,39662,3578751770,3578751770,0
2,1331,39663,3578751770,3578751770,0
2,1331,39664,3578751770,3578751770,0
2,1331,39665,3578751770,3578751772,2
2,1331,39666,3578751770,3578751774,4
2,1331,39667,3578751770,3578751774,4
2,1331,39668,3578751770,3578751776,6
2,1331,39669,3578751770,3578751776,6
2,1331,39670,3578751770,3578751776,6
2,1331,39671,3578751770,3578751778,8
2,1331,39672,3578751770,3578751778,8
2,1331,39673,3578751770,3578751779,9
2,1331,39674,3578751770,3578751779,9
2,1331,39675,3578751770,3578751780,10
2,1331,39676,3578751770,3578751781,11
2,1331,39677,3578751770,3578751782,12
2,1331,39678,3578751770,3578751785,15
2,1331,39679,3578751770,3578751789,19
2,1331,39680,3578751770,3578751789,19
2,1331,39681,3578751770,3578751790,20
2,1331,39682,3578751770,3578751791,21
2,1331,39683,3578751770,3578751792,22
2,1331,39684,3578751770,3578751792,22
2,1331,39685,3578751770,3578751792,22
2,1331,39686,3578751770,3578751793,23
2,1331,39687,3578751770,3578751793,23
2,1331,39688,3578751770,3578751794,24
2,1331,39689,3578751770,3578751794,24
2,1331,39690,3578751770,3578751795,25
2,1331,39691,3578751770,3578751797,27
2,1331,39692,3578751770,3578751798,28
2,1331,39693,3578751770,3578751798,28
2,1331,39694,3578751770,3578751799,29
2,1331,39695,3578751770,3578751800,30
2,1331,39696,3578751770,3578751803,33
2,1331,39697,3578751770,3578751804,34
2,1331,39698,3578751770,3578751804,34
2,1331,39699,3578751770,3578751805,35
2,1331,39700,3578751770,3578751806,36
2,1331,39701,3578751770,3578751808,38
2,1331,39702,3578751770,3578751810,40
2,1331,39703,3578751770,3578751811,41
2,1331,39704,3578751770,3578751812,42
2,1331,39705,3578751770,3578751813,43
2,1331,39706,3578751770,3578751813,43
2,1331,39707,3578751770,3578751814,44
2,1331,39708,3578751770,3578751816,46
2,1331,39709,3578751770,3578751816,46
2,1331,39710,3578751770,3578751817,47
2,1331,39711,3578751770,3578751817,47
2,1331,39712,3578751770,3578751817,47
2,1331,39713,3578751770,3578751818,48
2,1331,39714,3578751770,3578751819,49
2,1331,39715,3578751770,3578751820,50
2,1332,39716,3578751833,3578751833,0
2,1332,39717,3578751833,3578751833,0
2,1332,39718,3578751833,3578751833,0
2,1332,39719,3578751833,3578751833,0
2,1332,39720,3578751833,3578751833,0
2,1332,39721,3578751833,3578751834,1
2,1332,39722,3578751833,3578751834,1
2,1332,39723,3578751833,3578751834,1
2,1332,39724,3578751833,3578751834,1
2,1332,39725,3578751833,3578751834,1
2,1332,39726,3578751833,3578751834,1
2,1332,39727,3578751833,3578751834,1
2,1332,39728,3578751833,3578751834,1
2,1332,39729,3578751833,3578751834,1
2,1332,39730,3578751833,3578751834,1
2,1332,39731,3578751833,3578751835,2
2,1332,39732,3578751833,3578751835,2
2,1332,39733,3578751833,3578751835,2
2,1332,39734,3578751833,3578751836,3
2,1332,39735,3578751833,3578751836,3
2,1332,39736,3578751833,3578751836,3
2,1332,39737,3578751833,3578751837,4
2,1332,39738,3578751833,3578751838,5
2,1332,39739,3578751833,3578751839,6
2,1332,39740,3578751833,3578751841,8
2,1332,39741,3578751833,3578751841,8
2,1332,39742,3578751833,3578751841,8
2,1332,39743,3578751833,3578751843,10
2,1332,39744,3578751833,3578751844,11
2,1332,39745,3578751833,3578751845,12
2,1332,39746,3578751833,3578751845,12
2,1332,39747,3578751833,3578751846,13
2,1332,39748,3578751833,3578751846,13
2,1332,39749,3578751833,3578751846,13
2,1332,39750,3578751833,3578751851,18
2,1332,39751,3578751833,3578751852,19
2,1332,39752,3578751833,3578751853,20
2,1332,39753,3578751833,3578751853,20
2,1332,39754,3578751833,3578751854,21
2,1332,39755,3578751833,3578751855,22
2,1332,39756,3578751833,3578751855,22
2,1332,39757,3578751833,3578751856,23
2,1332,39758,3578751833,3578751856,23
2,1332,39759,3578751833,3578751858,25
2,1332,39760,3578751833,3578751858,25
2,1332,39761,3578751833,3578751859,26
2,1332,39762,3578751833,3578751859,26
2,1332,39763,3578751833,3578751859,26
2,1332,39764,3578751833,3578751861,28
2,1332,39765,3578751833,3578751864,31
2,1332,39766,3578751833,3578751865,32
2,1332,39767,3578751833,3578751866,33
2,1332,39768,3578751833,3578751866,33
2,1332,39769,3578751833,3578751869,36
2,1332,39770,3578751833,3578751873,40
2,1332,39771,3578751833,3578751879,46
2,1332,39772,3578751833,3578751879,46
2,1332,39773,3578751833,3578751881,48
2,1332,39774,3578751833,3578751881,48
2,1332,39775,3578751833,3578751883,50
2,1333,39776,3578751895,3578751895,0
2,1333,39777,3578751895,3578751895,0
2,1333,39778,3578751895,3578751895,0
2,1333,39779,3578751895,3578751895,0
2,1333,39780,3578751895,3578751895,0
2,1333,39781,3578751895,3578751895,0
2,1333,39782,3578751895,3578751895,0
2,1333,39783,3578751895,3578751895,0
2,1333,39784,3578751895,3578751895,0
2,1333,39785,3578751895,3578751895,0
2,1333,39786,3578751895,3578751895,0
2,1333,39787,3578751895,3578751895,0
2,1333,39788,3578751895,3578751895,0
2,1333,39789,3578751895,3578751895,0
2,1333,39790,3578751895,3578751895,0
2,1333,39791,3578751895,3578751895,0
2,1333,39792,3578751895,3578751895,0
2,1333,39793,3578751895,3578751895,0
2,1333,39794,3578751895,3578751896,1
2,1333,39795,3578751895,3578751896,1
2,1333,39796,3578751895,3578751896,1
2,1333,39797,3578751895,3578751896,1
2,1333,39798,3578751895,3578751897,2
2,1333,39799,3578751895,3578751897,2
2,1333,39800,3578751895,3578751898,3
2,1333,39801,3578751895,3578751901,6
2,1333,39802,3578751895,3578751901,6
2,1333,39803,3578751895,3578751901,6
2,1333,39804,3578751895,3578751901,6
2,1333,39805,3578751895,3578751902,7
2,1333,39806,3578751895,3578751903,8
2,1333,39807,3578751895,3578751903,8
2,1333,39808,3578751895,3578751904,9
2,1333,39809,3578751895,3578751906,11
2,1333,39810,3578751895,3578751908,13
2,1333,39811,3578751895,3578751909,14
2,1333,39812,3578751895,3578751910,15
2,1333,39813,3578751895,3578751911,16
2,1333,39814,3578751895,3578751913,18
2,1333,39815,3578751895,3578751914,19
2,1333,39816,3578751895,3578751914,19
2,1333,39817,3578751895,3578751915,20
2,1333,39818,3578751895,3578751915,20
2,1333,39819,3578751895,3578751915,20
2,1333,39820,3578751895,3578751916,21
2,1333,39821,3578751895,3578751917,22
2,1333,39822,3578751895,3578751917,22
2,1333,39823,3578751895,3578751917,22
2,1333,39824,3578751895,3578751917,22
2,1333,39825,3578751895,3578751918,23
2,1333,39826,3578751895,3578751919,24
2,1333,39827,3578751895,3578751919,24
2,1333,39828,3578751895,3578751919,24
2,1333,39829,3578751895,3578751921,26
2,1333,39830,3578751895,3578751921,26
2,1333,39831,3578751895,3578751921,26
2,1333,39832,3578751895,3578751922,27
2,1333,39833,3578751895,3578751922,27
2,1333,39834,3578751895,3578751922,27
2,1333,39835,3578751895,3578751922,27
2,1333,39836,3578751895,3578751922,27
2,1333,39837,3578751895,3578751924,29
2,1333,39838,3578751895,3578751925,30
2,1333,39839,3578751895,3578751926,31
2,1333,39840,3578751895,3578751926,31
2,1333,39841,3578751895,3578751926,31
2,1333,39842,3578751895,3578751927,32
2,1333,39843,3578751895,3578751929,34
2,1333,39844,3578751895,3578751931,36
2,1333,39845,3578751895,3578751931,36
2,1333,39846,3578751895,3578751933,38
2,1333,39847,3578751895,3578751934,39
2,1333,39848,3578751895,3578751934,39
2,1333,39849,3578751895,3578751935,40
2,1333,39850,3578751895,3578751936,41
2,1333,39851,3578751895,3578751936,41
2,1333,39852,3578751895,3578751937,42
2,1333,39853,3578751895,3578751937,42
2,1333,39854,3578751895,3578751937,42
2,1333,39855,3578751895,3578751938,43
2,1333,39856,3578751895,3578751938,43
2,1333,39857,3578751895,3578751938,43
2,1333,39858,3578751895,3578751939,44
2,1333,39859,3578751895,3578751940,45
2,1333,39860,3578751895,3578751940,45
2,1333,39861,3578751895,3578751940,45
2,1333,39862,3578751895,3578751942,47
2,1333,39863,3578751895,3578751943,48
2,1333,39864,3578751895,3578751943,48
2,1333,39865,3578751895,3578751943,48
2,1333,39866,3578751895,3578751944,49
2,1333,39867,3578751895,3578751945,50
2,1334,39868,3578751957,3578751957,0
2,1334,39869,3578751957,3578751957,0
2,1334,39870,3578751957,3578751957,0
2,1334,39871,3578751957,3578751957,0
2,1334,39872,3578751957,3578751957,0
2,1334,39873,3578751957,3578751957,0
2,1334,39874,3578751957,3578751957,0
2,1334,39875,3578751957,3578751957,0
2,1334,39876,3578751957,3578751957,0
2,1334,39877,3578751957,3578751957,0
2,1334,39878,3578751957,3578751957,0
2,1334,39879,3578751957,3578751957,0
2,1334,39880,3578751957,3578751957,0
2,1334,39881,3578751957,3578751957,0
2,1334,39882,3578751957,3578751957,0
2,1334,39883,3578751957,3578751959,2
2,1334,39884,3578751957,3578751960,3
2,1334,39885,3578751957,3578751960,3
2,1334,39886,3578751957,3578751961,4
2,1334,39887,3578751957,3578751963,6
2,1334,39888,3578751957,3578751964,7
2,1334,39889,3578751957,3578751965,8
2,1334,39890,3578751957,3578751965,8
2,1334,39891,3578751957,3578751966,9
2,1334,39892,3578751957,3578751967,10
2,1334,39893,3578751957,3578751968,11
2,1334,39894,3578751957,3578751969,12
2,1334,39895,3578751957,3578751969,12
2,1334,39896,3578751957,3578751970,13
2,1334,39897,3578751957,3578751972,15
2,1334,39898,3578751957,3578751974,17
2,1334,39899,3578751957,3578751974,17
2,1334,39900,3578751957,3578751975,18
2,1334,39901,3578751957,3578751976,19
2,1334,39902,3578751957,3578751976,19
2,1334,39903,3578751957,3578751977,20
2,1334,39904,3578751957,3578751977,20
2,1334,39905,3578751957,3578751978,21
2,1334,39906,3578751957,3578751978,21
2,1334,39907,3578751957,3578751979,22
2,1334,39908,3578751957,3578751980,23
2,1334,39909,3578751957,3578751980,23
2,1334,39910,3578751957,3578751983,26
2,1334,39911,3578751957,3578751985,28
2,1334,39912,3578751957,3578751986,29
2,1334,39913,3578751957,3578751989,32
2,1334,39914,3578751957,3578751989,32
2,1334,39915,3578751957,3578751990,33
2,1334,39916,3578751957,3578751991,34
2,1334,39917,3578751957,3578751992,35
2,1334,39918,3578751957,3578751992,35
2,1334,39919,3578751957,3578751993,36
2,1334,39920,3578751957,3578751993,36
2,1334,39921,3578751957,3578751993,36
2,1334,39922,3578751957,3578751994,37
2,1334,39923,3578751957,3578751995,38
2,1334,39924,3578751957,3578751995,38
2,1334,39925,3578751957,3578751997,40
2,1334,39926,3578751957,3578751998,41
2,1334,39927,3578751957,3578751999,42
2,1334,39928,3578751957,3578752000,43
2,1334,39929,3578751957,3578752000,43
2,1334,39930,3578751957,3578752003,46
2,1334,39931,3578751957,3578752004,47
2,1334,39932,3578751957,3578752004,47
2,1334,39933,3578751957,3578752006,49
2,1334,39934,3578751957,3578752006,49
2,1335,39935,3578752018,3578752018,0
2,1335,39936,3578752018,3578752018,0
2,1335,39937,3578752018,3578752018,0
2,1335,39938,3578752018,3578752018,0
2,1335,39939,3578752018,3578752018,0
2,1335,39940,3578752018,3578752018,0
2,1335,39941,3578752018,3578752018,0
2,1335,39942,3578752018,3578752018,0
2,1335,39943,3578752018,3578752018,0
2,1335,39944,3578752018,3578752018,0
2,1335,39945,3578752018,3578752018,0
2,1335,39946,3578752018,3578752020,2
2,1335,39947,3578752018,3578752020,2
2,1335,39948,3578752018,3578752020,2
2,1335,39949,3578752018,3578752020,2
2,1335,39950,3578752018,3578752022,4
2,1335,39951,3578752018,3578752024,6
2,1335,39952,3578752018,3578752024,6
2,1335,39953,3578752018,3578752025,7
2,1335,39954,3578752018,3578752026,8
2,1335,39955,3578752018,3578752027,9
2,1335,39956,3578752018,3578752028,10
2,1335,39957,3578752018,3578752029,11
2,1335,39958,3578752018,3578752030,12
2,1335,39959,3578752018,3578752031,13
2,1335,39960,3578752018,3578752032,14
2,1335,39961,3578752018,3578752032,14
2,1335,39962,3578752018,3578752032,14
2,1335,39963,3578752018,3578752034,16
2,1335,39964,3578752018,3578752035,17
2,1335,39965,3578752018,3578752036,18
2,1335,39966,3578752018,3578752036,18
2,1335,39967,3578752018,3578752036,18
2,1335,39968,3578752018,3578752037,19
2,1335,39969,3578752018,3578752038,20
2,1335,39970,3578752018,3578752038,20
2,1335,39971,3578752018,3578752038,20
2,1335,39972,3578752018,3578752039,21
2,1335,39973,3578752018,3578752039,21
2,1335,39974,3578752018,3578752040,22
2,1335,39975,3578752018,3578752041,23
2,1335,39976,3578752018,3578752042,24
2,1335,39977,3578752018,3578752044,26
2,1335,39978,3578752018,3578752044,26
2,1335,39979,3578752018,3578752045,27
2,1335,39980,3578752018,3578752045,27
2,1335,39981,3578752018,3578752046,28
2,1335,39982,3578752018,3578752047,29
2,1335,39983,3578752018,3578752047,29
2,1335,39984,3578752018,3578752050,32
2,1335,39985,3578752018,3578752052,34
2,1335,39986,3578752018,3578752052,34
2,1335,39987,3578752018,3578752053,35
2,1335,39988,3578752018,3578752053,35
2,1335,39989,3578752018,3578752054,36
2,1335,39990,3578752018,3578752055,37
2,1335,39991,3578752018,3578752055,37
2,1335,39992,3578752018,3578752057,39
2,1335,39993,3578752018,3578752057,39
2,1335,39994,3578752018,3578752058,40
2,1335,39995,3578752018,3578752058,40
2,1335,39996,3578752018,3578752059,41
2,1335,39997,3578752018,3578752060,42
2,1335,39998,3578752018,3578752060,42
2,1335,39999,3578752018,3578752061,43
2,1335,40000,3578752018,3578752065,47
2,1335,40001,3578752018,3578752065,47
2,1335,40002,3578752018,3578752066,48
2,1335,40003,3578752018,3578752066,48
2,1335,40004,3578752018,3578752067,49
2,1336,40005,3578752080,3578752080,0
2,1336,40006,3578752080,3578752080,0
2,1336,40007,3578752080,3578752080,0
2,1336,40008,3578752080,3578752080,0
2,1336,40009,3578752080,3578752080,0
2,1336,40010,3578752080,3578752081,1
2,1336,40011,3578752080,3578752083,3
2,1336,40012,3578752080,3578752083,3
2,1336,40013,3578752080,3578752083,3
2,1336,40014,3578752080,3578752084,4
2,1336,40015,3578752080,3578752086,6
2,1336,40016,3578752080,3578752086,6
2,1336,40017,3578752080,3578752087,7
2,1336,40018,3578752080,3578752087,7
2,1336,40019,3578752080,3578752088,8
2,1336,40020,3578752080,3578752089,9
2,1336,40021,3578752080,3578752089,9
2,1336,40022,3578752080,3578752090,10
2,1336,40023,3578752080,3578752091,11
2,1336,40024,3578752080,3578752092,12
2,1336,40025,3578752080,3578752092,12
2,1336,40026,3578752080,3578752092,12
2,1336,40027,3578752080,3578752093,13
2,1336,40028,3578752080,3578752094,14
2,1336,40029,3578752080,3578752094,14
2,1336,40030,3578752080,3578752094,14
2,1336,40031,3578752080,3578752095,15
2,1336,40032,3578752080,3578752096,16
2,1336,40033,3578752080,3578752096,16
2,1336,40034,3578752080,3578752096,16
2,1336,40035,3578752080,3578752096,16
2,1336,40036,3578752080,3578752097,17
2,1336,40037,3578752080,3578752101,21
2,1336,40038,3578752080,3578752101,21
2,1336,40039,3578752080,3578752102,22
2,1336,40040,3578752080,3578752102,22
2,1336,40041,3578752080,3578752102,22
2,1336,40042,3578752080,3578752103,23
2,1336,40043,3578752080,3578752103,23
2,1336,40044,3578752080,3578752104,24
2,1336,40045,3578752080,3578752104,24
2,1336,40046,3578752080,3578752106,26
2,1336,40047,3578752080,3578752108,28
2,1336,40048,3578752080,3578752109,29
2,1336,40049,3578752080,3578752110,30
2,1336,40050,3578752080,3578752111,31
2,1336,40051,3578752080,3578752113,33
2,1336,40052,3578752080,3578752113,33
2,1336,40053,3578752080,3578752114,34
2,1336,40054,3578752080,3578752114,34
2,1336,40055,3578752080,3578752115,35
2,1336,40056,3578752080,3578752115,35
2,1336,40057,3578752080,3578752115,35
2,1336,40058,3578752080,3578752117,37
2,1336,40059,3578752080,3578752117,37
2,1336,40060,3578752080,3578752117,37
2,1336,40061,3578752080,3578752118,38
2,1336,40062,3578752080,3578752118,38
2,1336,40063,3578752080,3578752119,39
2,1336,40064,3578752080,3578752120,40
2,1336,40065,3578752080,3578752120,40
2,1336,40066,3578752080,3578752120,40
2,1336,40067,3578752080,3578752121,41
2,1336,40068,3578752080,3578752121,41
2,1336,40069,3578752080,3578752122,42
2,1336,40070,3578752080,3578752122,42
2,1336,40071,3578752080,3578752122,42
2,1336,40072,3578752080,3578752123,43
2,1336,40073,3578752080,3578752124,44
2,1336,40074,3578752080,3578752126,46
2,1336,40075,3578752080,3578752126,46
2,1336,40076,3578752080,3578752126,46
2,1336,40077,3578752080,3578752127,47
2,1336,40078,3578752080,3578752127,47
2,1336,40079,3578752080,3578752129,49
2,1337,40080,3578752142,3578752142,0
2,1337,40081,3578752142,3578752142,0
2,1337,40082,3578752142,3578752143,1
2,1337,40083,3578752142,3578752143,1
2,1337,40084,3578752142,3578752143,1
2,1337,40085,3578752142,3578752143,1
2,1337,40086,3578752142,3578752143,1
2,1337,40087,3578752142,3578752143,1
2,1337,40088,3578752142,3578752143,1
2,1337,40089,3578752142,3578752143,1
2,1337,40090,3578752142,3578752143,1
2,1337,40091,3578752142,3578752143,1
2,1337,40092,3578752142,3578752143,1
2,1337,40093,3578752142,3578752143,1
2,1337,40094,3578752142,3578752143,1
2,1337,40095,3578752142,3578752143,1
2,1337,40096,3578752142,3578752143,1
2,1337,40097,3578752142,3578752143,1
2,1337,40098,3578752142,3578752143,1
2,1337,40099,3578752142,3578752143,1
2,1337,40100,3578752142,3578752143,1
2,1337,40101,3578752142,3578752144,2
2,1337,40102,3578752142,3578752145,3
2,1337,40103,3578752142,3578752148,6
2,1337,40104,3578752142,3578752150,8
2,1337,40105,3578752142,3578752150,8
2,1337,40106,3578752142,3578752151,9
2,1337,40107,3578752142,3578752151,9
2,1337,40108,3578752142,3578752152,10
2,1337,40109,3578752142,3578752153,11
2,1337,40110,3578752142,3578752153,11
2,1337,40111,3578752142,3578752154,12
2,1337,40112,3578752142,3578752154,12
2,1337,40113,3578752142,3578752155,13
2,1337,40114,3578752142,3578752155,13
2,1337,40115,3578752142,3578752155,13
2,1337,40116,3578752142,3578752156,14
2,1337,40117,3578752142,3578752157,15
2,1337,40118,3578752142,3578752157,15
2,1337,40119,3578752142,3578752160,18
2,1337,40120,3578752142,3578752160,18
2,1337,40121,3578752142,3578752160,18
2,1337,40122,3578752142,3578752162,20
2,1337,40123,3578752142,3578752164,22
2,1337,40124,3578752142,3578752165,23
2,1337,40125,3578752142,3578752166,24
2,1337,40126,3578752142,3578752166,24
2,1337,40127,3578752142,3578752166,24
2,1337,40128,3578752142,3578752167,25
2,1337,40129,3578752142,3578752168,26
2,1337,40130,3578752142,3578752169,27
2,1337,40131,3578752142,3578752169,27
2,1337,40132,3578752142,3578752170,28
2,1337,40133,3578752142,3578752172,30
2,1337,40134,3578752142,3578752174,32
2,1337,40135,3578752142,3578752174,32
2,1337,40136,3578752142,3578752175,33
2,1337,40137,3578752142,3578752176,34
2,1337,40138,3578752142,3578752176,34
2,1337,40139,3578752142,3578752176,34
2,1337,40140,3578752142,3578752177,35
2,1337,40141,3578752142,3578752178,36
2,1337,40142,3578752142,3578752178,36
2,1337,40143,3578752142,3578752179,37
2,1337,40144,3578752142,3578752180,38
2,1337,40145,3578752142,3578752181,39
2,1337,40146,3578752142,3578752183,41
2,1337,40147,3578752142,3578752186,44
2,1337,40148,3578752142,3578752186,44
2,1337,40149,3578752142,3578752188,46
2,1337,40150,3578752142,3578752190,48
2,1337,40151,3578752142,3578752190,48
2,1337,40152,3578752142,3578752192,50
2,1338,40153,3578752205,3578752205,0
2,1338,40154,3578752205,3578752205,0
2,1338,40155,3578752205,3578752205,0
2,1338,40156,3578752205,3578752205,0
2,1338,40157,3578752205,3578752205,0
2,1338,40158,3578752205,3578752205,0
2,1338,40159,3578752205,3578752205,0
2,1338,40160,3578752205,3578752205,0
2,1338,40161,3578752205,3578752205,0
2,1338,40162,3578752205,3578752205,0
2,1338,40163,3578752205,3578752205,0
2,1338,40164,3578752205,3578752205,0
2,1338,40165,3578752205,3578752205,0
2,1338,40166,3578752205,3578752205,0
2,1338,40167,3578752205,3578752205,0
2,1338,40168,3578752205,3578752206,1
2,1338,40169,3578752205,3578752206,1
2,1338,40170,3578752205,3578752208,3
2,1338,40171,3578752205,3578752210,5
2,1338,40172,3578752205,3578752213,8
2,1338,40173,3578752205,3578752213,8
2,1338,40174,3578752205,3578752214,9
2,1338,40175,3578752205,3578752215,10
2,1338,40176,3578752205,3578752215,10
2,1338,40177,3578752205,3578752216,11
2,1338,40178,3578752205,3578752217,12
2,1338,40179,3578752205,3578752217,12
2,1338,40180,3578752205,3578752217,12
2,1338,40181,3578752205,3578752218,13
2,1338,40182,3578752205,3578752218,13
2,1338,40183,3578752205,3578752220,15
2,1338,40184,3578752205,3578752220,15
2,1338,40185,3578752205,3578752220,15
2,1338,40186,3578752205,3578752220,15
2,1338,40187,3578752205,3578752222,17
2,1338,40188,3578752205,3578752224,19
2,1338,40189,3578752205,3578752224,19
2,1338,40190,3578752205,3578752224,19
2,1338,40191,3578752205,3578752226,21
2,1338,40192,3578752205,3578752227,22
2,1338,40193,3578752205,3578752227,22
2,1338,40194,3578752205,3578752229,24
2,1338,40195,3578752205,3578752230,25
2,1338,40196,3578752205,3578752231,26
2,1338,40197,3578752205,3578752232,27
2,1338,40198,3578752205,3578752232,27
2,1338,40199,3578752205,3578752233,28
2,1338,40200,3578752205,3578752234,29
2,1338,40201,3578752205,3578752235,30
2,1338,40202,3578752205,3578752236,31
2,1338,40203,3578752205,3578752236,31
2,1338,40204,3578752205,3578752237,32
2,1338,40205,3578752205,3578752237,32
2,1338,40206,3578752205,3578752238,33
2,1338,40207,3578752205,3578752238,33
2,1338,40208,3578752205,3578752239,34
2,1338,40209,3578752205,3578752239,34
2,1338,40210,3578752205,3578752239,34
2,1338,40211,3578752205,3578752240,35
2,1338,40212,3578752205,3578752241,36
2,1338,40213,3578752205,3578752242,37
2,1338,40214,3578752205,3578752244,39
2,1338,40215,3578752205,3578752244,39
2,1338,40216,3578752205,3578752244,39
2,1338,40217,3578752205,3578752245,40
2,1338,40218,3578752205,3578752246,41
2,1338,40219,3578752205,3578752247,42
2,1338,40220,3578752205,3578752247,42
2,1338,40221,3578752205,3578752250,45
2,1338,40222,3578752205,3578752251,46
2,1338,40223,3578752205,3578752252,47
2,1338,40224,3578752205,3578752252,47
2,1338,40225,3578752205,3578752253,48
2,1338,40226,3578752205,3578752253,48
2,1338,40227,3578752205,3578752254,49
2,1338,40228,3578752205,3578752255,50
2,1339,40229,3578752268,3578752268,0
2,1339,40230,3578752268,3578752268,0
2,1339,40231,3578752268,3578752268,0
2,1339,40232,3578752268,3578752268,0
2,1339,40233,3578752268,3578752268,0
2,1339,40234,3578752268,3578752268,0
2,1339,40235,3578752268,3578752268,0
2,1339,40236,3578752268,3578752268,0
2,1339,40237,3578752268,3578752268,0
2,1339,40238,3578752268,3578752268,0
2,1339,40239,3578752268,3578752268,0
2,1339,40240,3578752268,3578752268,0
2,1339,40241,3578752268,3578752268,0
2,1339,40242,3578752268,3578752268,0
2,1339,40243,3578752268,3578752268,0
2,1339,40244,3578752268,3578752269,1
2,1339,40245,3578752268,3578752270,2
2,1339,40246,3578752268,3578752273,5
2,1339,40247,3578752268,3578752275,7
2,1339,40248,3578752268,3578752279,11
2,1339,40249,3578752268,3578752280,12
2,1339,40250,3578752268,3578752281,13
2,1339,40251,3578752268,3578752282,14
2,1339,40252,3578752268,3578752283,15
2,1339,40253,3578752268,3578752283,15
2,1339,40254,3578752268,3578752285,17
2,1339,40255,3578752268,3578752286,18
2,1339,40256,3578752268,3578752287,19
2,1339,40257,3578752268,3578752287,19
2,1339,40258,3578752268,3578752288,20
2,1339,40259,3578752268,3578752288,20
2,1339,40260,3578752268,3578752290,22
2,1339,40261,3578752268,3578752290,22
2,1339,40262,3578752268,3578752291,23
2,1339,40263,3578752268,3578752291,23
2,1339,40264,3578752268,3578752292,24
2,1339,40265,3578752268,3578752293,25
2,1339,40266,3578752268,3578752294,26
2,1339,40267,3578752268,3578752294,26
2,1339,40268,3578752268,3578752294,26
2,1339,40269,3578752268,3578752295,27
2,1339,40270,3578752268,3578752296,28
2,1339,40271,3578752268,3578752296,28
2,1339,40272,3578752268,3578752297,29
2,1339,40273,3578752268,3578752297,29
2,1339,40274,3578752268,3578752297,29
2,1339,40275,3578752268,3578752298,30
2,1339,40276,3578752268,3578752301,33
2,1339,40277,3578752268,3578752301,33
2,1339,40278,3578752268,3578752301,33
2,1339,40279,3578752268,3578752301,33
2,1339,40280,3578752268,3578752303,35
2,1339,40281,3578752268,3578752303,35
2,1339,40282,3578752268,3578752304,36
2,1339,40283,3578752268,3578752305,37
2,1339,40284,3578752268,3578752306,38
2,1339,40285,3578752268,3578752309,41
2,1339,40286,3578752268,3578752309,41
2,1339,40287,3578752268,3578752311,43
2,1339,40288,3578752268,3578752311,43
2,1339,40289,3578752268,3578752314,46
2,1339,40290,3578752268,3578752314,46
2,1339,40291,3578752268,3578752314,46
2,1339,40292,3578752268,3578752315,47
2,1339,40293,3578752268,3578752316,48
2,1339,40294,3578752268,3578752316,48
2,1339,40295,3578752268,3578752316,48
2,1339,40296,3578752268,3578752317,49
2,1339,40297,3578752268,3578752317,49
2,1339,40298,3578752268,3578752318,50
2,1340,40299,3578752330,3578752330,0
2,1340,40300,3578752330,3578752330,0
2,1340,40301,3578752330,3578752330,0
2,1340,40302,3578752330,3578752330,0
2,1340,40303,3578752330,3578752330,0
2,1340,40304,3578752330,3578752330,0
2,1340,40305,3578752330,3578752330,0
2,1340,40306,3578752330,3578752330,0
2,1340,40307,3578752330,3578752330,0
2,1340,40308,3578752330,3578752330,0
2,1340,40309,3578752330,3578752330,0
2,1340,40310,3578752330,3578752330,0
2,1340,40311,3578752330,3578752330,0
2,1340,40312,3578752330,3578752330,0
2,1340,40313,3578752330,3578752330,0
2,1340,40314,3578752330,3578752330,0
2,1340,40315,3578752330,3578752330,0
2,1340,40316,3578752330,3578752330,0
2,1340,40317,3578752330,3578752332,2
2,1340,40318,3578752330,3578752334,4
2,1340,40319,3578752330,3578752334,4
2,1340,40320,3578752330,3578752335,5
2,1340,40321,3578752330,3578752335,5
2,1340,40322,3578752330,3578752336,6
2,1340,40323,3578752330,3578752337,7
2,1340,40324,3578752330,3578752337,7
2,1340,40325,3578752330,3578752338,8
2,1340,40326,3578752330,3578752338,8
2,1340,40327,3578752330,3578752339,9
2,1340,40328,3578752330,3578752339,9
2,1340,40329,3578752330,3578752339,9
2,1340,40330,3578752330,3578752339,9
2,1340,40331,3578752330,3578752341,11
2,1340,40332,3578752330,3578752341,11
2,1340,40333,3578752330,3578752341,11
2,1340,40334,3578752330,3578752343,13
2,1340,40335,3578752330,3578752343,13
2,1340,40336,3578752330,3578752343,13
2,1340,40337,3578752330,3578752344,14
2,1340,40338,3578752330,3578752344,14
2,1340,40339,3578752330,3578752345,15
2,1340,40340,3578752330,3578752348,18
2,1340,40341,3578752330,3578752348,18
2,1340,40342,3578752330,3578752350,20
2,1340,40343,3578752330,3578752351,21
2,1340,40344,3578752330,3578752351,21
2,1340,40345,3578752330,3578752352,22
2,1340,40346,3578752330,3578752352,22
2,1340,40347,3578752330,3578752353,23
2,1340,40348,3578752330,3578752354,24
2,1340,40349,3578752330,3578752355,25
2,1340,40350,3578752330,3578752355,25
2,1340,40351,3578752330,3578752355,25
2,1340,40352,3578752330,3578752355,25
2,1340,40353,3578752330,3578752355,25
2,1340,40354,3578752330,3578752356,26
2,1340,40355,3578752330,3578752357,27
2,1340,40356,3578752330,3578752358,28
2,1340,40357,3578752330,3578752360,30
2,1340,40358,3578752330,3578752360,30
2,1340,40359,3578752330,3578752360,30
2,1340,40360,3578752330,3578752362,32
2,1340,40361,3578752330,3578752364,34
2,1340,40362,3578752330,3578752366,36
2,1340,40363,3578752330,3578752366,36
2,1340,40364,3578752330,3578752366,36
2,1340,40365,3578752330,3578752367,37
2,1340,40366,3578752330,3578752367,37
2,1340,40367,3578752330,3578752369,39
2,1340,40368,3578752330,3578752369,39
2,1340,40369,3578752330,3578752370,40
2,1340,40370,3578752330,3578752372,42
2,1340,40371,3578752330,3578752374,44
2,1340,40372,3578752330,3578752374,44
2,1340,40373,3578752330,3578752375,45
2,1340,40374,3578752330,3578752376,46
2,1340,40375,3578752330,3578752376,46
2,1340,40376,3578752330,3578752377,47
2,1340,40377,3578752330,3578752377,47
2,1340,40378,3578752330,3578752378,48
2,1340,40379,3578752330,3578752378,48
2,1340,40380,3578752330,3578752379,49
2,1340,40381,3578752330,3578752380,50
2,1341,40382,3578752393,3578752393,0
2,1341,40383,3578752393,3578752393,0
2,1341,40384,3578752393,3578752393,0
2,1341,40385,3578752393,3578752393,0
2,1341,40386,3578752393,3578752393,0
2,1341,40387,3578752393,3578752393,0
2,1341,40388,3578752393,3578752393,0
2,1341,40389,3578752393,3578752393,0
2,1341,40390,3578752393,3578752393,0
2,1341,40391,3578752393,3578752393,0
2,1341,40392,3578752393,3578752393,0
2,1341,40393,3578752393,3578752394,1
2,1341,40394,3578752393,3578752394,1
2,1341,40395,3578752393,3578752395,2
2,1341,40396,3578752393,3578752395,2
2,1341,40397,3578752393,3578752397,4
2,1341,40398,3578752393,3578752398,5
2,1341,40399,3578752393,3578752400,7
2,1341,40400,3578752393,3578752400,7
2,1341,40401,3578752393,3578752400,7
2,1341,40402,3578752393,3578752404,11
2,1341,40403,3578752393,3578752404,11
2,1341,40404,3578752393,3578752405,12
2,1341,40405,3578752393,3578752406,13
2,1341,40406,3578752393,3578752407,14
2,1341,40407,3578752393,3578752407,14
2,1341,40408,3578752393,3578752410,17
2,1341,40409,3578752393,3578752413,20
2,1341,40410,3578752393,3578752414,21
2,1341,40411,3578752393,3578752414,21
2,1341,40412,3578752393,3578752415,22
2,1341,40413,3578752393,3578752416,23
2,1341,40414,3578752393,3578752417,24
2,1341,40415,3578752393,3578752417,24
2,1341,40416,3578752393,3578752418,25
2,1341,40417,3578752393,3578752418,25
2,1341,40418,3578752393,3578752418,25
2,1341,40419,3578752393,3578752419,26
2,1341,40420,3578752393,3578752419,26
2,1341,40421,3578752393,3578752420,27
2,1341,40422,3578752393,3578752421,28
2,1341,40423,3578752393,3578752422,29
2,1341,40424,3578752393,3578752424,31
2,1341,40425,3578752393,3578752424,31
2,1341,40426,3578752393,3578752425,32
2,1341,40427,3578752393,3578752427,34
2,1341,40428,3578752393,3578752427,34
2,1341,40429,3578752393,3578752429,36
2,1341,40430,3578752393,3578752431,38
2,1341,40431,3578752393,3578752432,39
2,1341,40432,3578752393,3578752432,39
2,1341,40433,3578752393,3578752433,40
2,1341,40434,3578752393,3578752434,41
2,1341,40435,3578752393,3578752436,43
2,1341,40436,3578752393,3578752436,43
2,1341,40437,3578752393,3578752437,44
2,1341,40438,3578752393,3578752438,45
2,1341,40439,3578752393,3578752438,45
2,1341,40440,3578752393,3578752438,45
2,1341,40441,3578752393,3578752438,45
2,1341,40442,3578752393,3578752439,46
2,1341,40443,3578752393,3578752439,46
2,1341,40444,3578752393,3578752440,47
2,1341,40445,3578752393,3578752440,47
2,1341,40446,3578752393,3578752442,49
2,1341,40447,3578752393,3578752442,49
2,1342,40448,3578752455,3578752455,0
2,1342,40449,3578752455,3578752456,1
2,1342,40450,3578752455,3578752456,1
2,1342,40451,3578752455,3578752456,1
2,1342,40452,3578752455,3578752456,1
2,1342,40453,3578752455,3578752456,1
2,1342,40454,3578752455,3578752456,1
2,1342,40455,3578752455,3578752456,1
2,1342,40456,3578752455,3578752456,1
2,1342,40457,3578752455,3578752456,1
2,1342,40458,3578752455,3578752456,1
2,1342,40459,3578752455,3578752456,1
2,1342,40460,3578752455,3578752456,1
2,1342,40461,3578752455,3578752456,1
2,1342,40462,3578752455,3578752456,1
2,1342,40463,3578752455,3578752456,1
2,1342,40464,3578752455,3578752458,3
2,1342,40465,3578752455,3578752458,3
2,1342,40466,3578752455,3578752458,3
2,1342,40467,3578752455,3578752460,5
2,1342,40468,3578752455,3578752460,5
2,1342,40469,3578752455,3578752461,6
2,1342,40470,3578752455,3578752465,10
2,1342,40471,3578752455,3578752465,10
2,1342,40472,3578752455,3578752467,12
2,1342,40473,3578752455,3578752467,12
2,1342,40474,3578752455,3578752468,13
2,1342,40475,3578752455,3578752468,13
2,1342,40476,3578752455,3578752469,14
2,1342,40477,3578752455,3578752471,16
2,1342,40478,3578752455,3578752474,19
2,1342,40479,3578752455,3578752479,24
2,1342,40480,3578752455,3578752480,25
2,1342,40481,3578752455,3578752481,26
2,1342,40482,3578752455,3578752483,28
2,1342,40483,3578752455,3578752483,28
2,1342,40484,3578752455,3578752483,28
2,1342,40485,3578752455,3578752484,29
2,1342,40486,3578752455,3578752487,32
2,1342,40487,3578752455,3578752488,33
2,1342,40488,3578752455,3578752488,33
2,1342,40489,3578752455,3578752489,34
2,1342,40490,3578752455,3578752490,35
2,1342,40491,3578752455,3578752491,36
2,1342,40492,3578752455,3578752491,36
2,1342,40493,3578752455,3578752492,37
2,1342,40494,3578752455,3578752493,38
2,1342,40495,3578752455,3578752494,39
2,1342,40496,3578752455,3578752494,39
2,1342,40497,3578752455,3578752494,39
2,1342,40498,3578752455,3578752494,39
2,1342,40499,3578752455,3578752495,40
2,1342,40500,3578752455,3578752495,40
2,1342,40501,3578752455,3578752496,41
2,1342,40502,3578752455,3578752496,41
2,1342,40503,3578752455,3578752497,42
2,1342,40504,3578752455,3578752499,44
2,1342,40505,3578752455,3578752499,44
2,1342,40506,3578752455,3578752501,46
2,1342,40507,3578752455,3578752501,46
2,1342,40508,3578752455,3578752501,46
2,1342,40509,3578752455,3578752503,48
2,1342,40510,3578752455,3578752503,48
2,1342,40511,3578752455,3578752504,49
2,1342,40512,3578752455,3578752504,49
2,1342,40513,3578752455,3578752505,50
2,1343,40514,3578752518,3578752518,0
2,1343,40515,3578752518,3578752518,0
2,1343,40516,3578752518,3578752518,0
2,1343,40517,3578752518,3578752518,0
2,1343,40518,3578752518,3578752518,0
2,1343,40519,3578752518,3578752518,0
2,1343,40520,3578752518,3578752518,0
2,1343,40521,3578752518,3578752518,0
2,1343,40522,3578752518,3578752518,0
2,1343,40523,3578752518,3578752518,0
2,1343,40524,3578752518,3578752518,0
2,1343,40525,3578752518,3578752518,0
2,1343,40526,3578752518,3578752518,0
2,1343,40527,3578752518,3578752518,0
2,1343,40528,3578752518,3578752518,0
2,1343,40529,3578752518,3578752518,0
2,1343,40530,3578752518,3578752518,0
2,1343,40531,3578752518,3578752518,0
2,1343,40532,3578752518,3578752519,1
2,1343,40533,3578752518,3578752519,1
2,1343,40534,3578752518,3578752519,1
2,1343,40535,3578752518,3578752520,2
2,1343,40536,3578752518,3578752521,3
2,1343,40537,3578752518,3578752521,3
2,1343,40538,3578752518,3578752521,3
2,1343,40539,3578752518,3578752522,4
2,1343,40540,3578752518,3578752523,5
2,1343,40541,3578752518,3578752523,5
2,1343,40542,3578752518,3578752524,6
2,1343,40543,3578752518,3578752525,7
2,1343,40544,3578752518,3578752525,7
2,1343,40545,3578752518,3578752526,8
2,1343,40546,3578752518,3578752526,8
2,1343,40547,3578752518,3578752529,11
2,1343,40548,3578752518,3578752531,13
2,1343,40549,3578752518,3578752532,14
2,1343,40550,3578752518,3578752533,15
2,1343,40551,3578752518,3578752534,16
2,1343,40552,3578752518,3578752534,16
2,1343,40553,3578752518,3578752535,17
2,1343,40554,3578752518,3578752536,18
2,1343,40555,3578752518,3578752536,18
2,1343,40556,3578752518,3578752537,19
2,1343,40557,3578752518,3578752537,19
2,1343,40558,3578752518,3578752537,19
2,1343,40559,3578752518,3578752538,20
2,1343,40560,3578752518,3578752538,20
2,1343,40561,3578752518,3578752539,21
2,1343,40562,3578752518,3578752540,22
2,1343,40563,3578752518,3578752540,22
2,1343,40564,3578752518,3578752542,24
2,1343,40565,3578752518,3578752542,24
2,1343,40566,3578752518,3578752543,25
2,1343,40567,3578752518,3578752543,25
2,1343,40568,3578752518,3578752544,26
2,1343,40569,3578752518,3578752544,26
2,1343,40570,3578752518,3578752547,29
2,1343,40571,3578752518,3578752548,30
2,1343,40572,3578752518,3578752550,32
2,1343,40573,3578752518,3578752550,32
2,1343,40574,3578752518,3578752551,33
2,1343,40575,3578752518,3578752552,34
2,1343,40576,3578752518,3578752552,34
2,1343,40577,3578752518,3578752552,34
2,1343,40578,3578752518,3578752553,35
2,1343,40579,3578752518,3578752554,36
2,1343,40580,3578752518,3578752554,36
2,1343,40581,3578752518,3578752554,36
2,1343,40582,3578752518,3578752555,37
2,1343,40583,3578752518,3578752555,37
2,1343,40584,3578752518,3578752556,38
2,1343,40585,3578752518,3578752556,38
2,1343,40586,3578752518,3578752556,38
2,1343,40587,3578752518,3578752559,41
2,1343,40588,3578752518,3578752559,41
2,1343,40589,3578752518,3578752559,41
2,1343,40590,3578752518,3578752561,43
2,1343,40591,3578752518,3578752563,45
2,1343,40592,3578752518,3578752564,46
2,1343,40593,3578752518,3578752565,47
2,1343,40594,3578752518,3578752565,47
2,1343,40595,3578752518,3578752565,47
2,1343,40596,3578752518,3578752566,48
2,1343,40597,3578752518,3578752567,49
2,1343,40598,3578752518,3578752568,50
2,1344,40599,3578752581,3578752581,0
2,1344,40600,3578752581,3578752581,0
2,1344,40601,3578752581,3578752581,0
2,1344,40602,3578752581,3578752581,0
2,1344,40603,3578752581,3578752581,0
2,1344,40604,3578752581,3578752581,0
2,1344,40605,3578752581,3578752581,0
2,1344,40606,3578752581,3578752581,0
2,1344,40607,3578752581,3578752581,0
2,1344,40608,3578752581,3578752581,0
2,1344,40609,3578752581,3578752581,0
2,1344,40610,3578752581,3578752581,0
2,1344,40611,3578752581,3578752581,0
2,1344,40612,3578752581,3578752581,0
2,1344,40613,3578752581,3578752581,0
2,1344,40614,3578752581,3578752581,0
2,1344,40615,3578752581,3578752583,2
2,1344,40616,3578752581,3578752585,4
2,1344,40617,3578752581,3578752588,7
2,1344,40618,3578752581,3578752589,8
2,1344,40619,3578752581,3578752589,8
2,1344,40620,3578752581,3578752590,9
2,1344,40621,3578752581,3578752590,9
2,1344,40622,3578752581,3578752591,10
2,1344,40623,3578752581,3578752591,10
2,1344,40624,3578752581,3578752592,11
2,1344,40625,3578752581,3578752592,11
2,1344,40626,3578752581,3578752594,13
2,1344,40627,3578752581,3578752594,13
2,1344,40628,3578752581,3578752595,14
2,1344,40629,3578752581,3578752596,15
2,1344,40630,3578752581,3578752597,16
2,1344,40631,3578752581,3578752598,17
2,1344,40632,3578752581,3578752599,18
2,1344,40633,3578752581,3578752599,18
2,1344,40634,3578752581,3578752600,19
2,1344,40635,3578752581,3578752603,22
2,1344,40636,3578752581,3578752603,22
2,1344,40637,3578752581,3578752604,23
2,1344,40638,3578752581,3578752606,25
2,1344,40639,3578752581,3578752606,25
2,1344,40640,3578752581,3578752606,25
2,1344,40641,3578752581,3578752610,29
2,1344,40642,3578752581,3578752610,29
2,1344,40643,3578752581,3578752612,31
2,1344,40644,3578752581,3578752613,32
2,1344,40645,3578752581,3578752613,32
2,1344,40646,3578752581,3578752614,33
2,1344,40647,3578752581,3578752615,34
2,1344,40648,3578752581,3578752616,35
2,1344,40649,3578752581,3578752616,35
2,1344,40650,3578752581,3578752616,35
2,1344,40651,3578752581,3578752616,35
2,1344,40652,3578752581,3578752617,36
2,1344,40653,3578752581,3578752618,37
2,1344,40654,3578752581,3578752619,38
2,1344,40655,3578752581,3578752619,38
2,1344,40656,3578752581,3578752621,40
2,1344,40657,3578752581,3578752621,40
2,1344,40658,3578752581,3578752623,42
2,1344,40659,3578752581,3578752623,42
2,1344,40660,3578752581,3578752623,42
2,1344,40661,3578752581,3578752626,45
2,1344,40662,3578752581,3578752628,47
2,1344,40663,3578752581,3578752628,47
2,1344,40664,3578752581,3578752629,48
2,1344,40665,3578752581,3578752629,48
2,1344,40666,3578752581,3578752630,49
2,1345,40667,3578752643,3578752643,0
2,1345,40668,3578752643,3578752643,0
2,1345,40669,3578752643,3578752643,0
2,1345,40670,3578752643,3578752643,0
2,1345,40671,3578752643,3578752643,0
2,1345,40672,3578752643,3578752643,0
2,1345,40673,3578752643,3578752643,0
2,1345,40674,3578752643,3578752643,0
2,1345,40675,3578752643,3578752643,0
2,1345,40676,3578752643,3578752643,0
2,1345,40677,3578752643,3578752643,0
2,1345,40678,3578752643,3578752643,0
2,1345,40679,3578752643,3578752643,0
2,1345,40680,3578752643,3578752643,0
2,1345,40681,3578752643,3578752643,0
2,1345,40682,3578752643,3578752643,0
2,1345,40683,3578752643,3578752643,0
2,1345,40684,3578752643,3578752643,0
2,1345,40685,3578752643,3578752644,1
2,1345,40686,3578752643,3578752644,1
2,1345,40687,3578752643,3578752645,2
2,1345,40688,3578752643,3578752646,3
2,1345,40689,3578752643,3578752646,3
2,1345,40690,3578752643,3578752650,7
2,1345,40691,3578752643,3578752650,7
2,1345,40692,3578752643,3578752652,9
2,1345,40693,3578752643,3578752652,9
2,1345,40694,3578752643,3578752652,9
2,1345,40695,3578752643,3578752654,11
2,1345,40696,3578752643,3578752655,12
2,1345,40697,3578752643,3578752655,12
2,1345,40698,3578752643,3578752657,14
2,1345,40699,3578752643,3578752657,14
2,1345,40700,3578752643,3578752657,14
2,1345,40701,3578752643,3578752657,14
2,1345,40702,3578752643,3578752657,14
2,1345,40703,3578752643,3578752658,15
2,1345,40704,3578752643,3578752660,17
2,1345,40705,3578752643,3578752660,17
2,1345,40706,3578752643,3578752664,21
2,1345,40707,3578752643,3578752665,22
2,1345,40708,3578752643,3578752665,22
2,1345,40709,3578752643,3578752666,23
2,1345,40710,3578752643,3578752666,23
2,1345,40711,3578752643,3578752667,24
2,1345,40712,3578752643,3578752668,25
2,1345,40713,3578752643,3578752670,27
2,1345,40714,3578752643,3578752674,31
2,1345,40715,3578752643,3578752676,33
2,1345,40716,3578752643,3578752679,36
2,1345,40717,3578752643,3578752680,37
2,1345,40718,3578752643,3578752680,37
2,1345,40719,3578752643,3578752681,38
2,1345,40720,3578752643,3578752682,39
2,1345,40721,3578752643,3578752683,40
2,1345,40722,3578752643,3578752683,40
2,1345,40723,3578752643,3578752687,44
2,1345,40724,3578752643,3578752687,44
2,1345,40725,3578752643,3578752688,45
2,1345,40726,3578752643,3578752689,46
2,1345,40727,3578752643,3578752689,46
2,1345,40728,3578752643,3578752691,48
2,1345,40729,3578752643,3578752691,48
2,1345,40730,3578752643,3578752691,48
2,1345,40731,3578752643,3578752693,50
2,1346,40732,3578752706,3578752706,0
2,1346,40733,3578752706,3578752706,0
2,1346,40734,3578752706,3578752706,0
2,1346,40735,3578752706,3578752706,0
2,1346,40736,3578752706,3578752706,0
2,1346,40737,3578752706,3578752706,0
2,1346,40738,3578752706,3578752706,0
2,1346,40739,3578752706,3578752706,0
2,1346,40740,3578752706,3578752706,0
2,1346,40741,3578752706,3578752706,0
2,1346,40742,3578752706,3578752706,0
2,1346,40743,3578752706,3578752706,0
2,1346,40744,3578752706,3578752706,0
2,1346,40745,3578752706,3578752706,0
2,1346,40746,3578752706,3578752706,0
2,1346,40747,3578752706,3578752706,0
2,1346,40748,3578752706,3578752706,0
2,1346,40749,3578752706,3578752706,0
2,1346,40750,3578752706,3578752706,0
2,1346,40751,3578752706,3578752707,1
2,1346,40752,3578752706,3578752708,2
2,1346,40753,3578752706,3578752710,4
2,1346,40754,3578752706,3578752710,4
2,1346,40755,3578752706,3578752714,8
2,1346,40756,3578752706,3578752714,8
2,1346,40757,3578752706,3578752714,8
2,1346,40758,3578752706,3578752714,8
2,1346,40759,3578752706,3578752714,8
2,1346,40760,3578752706,3578752715,9
2,1346,40761,3578752706,3578752716,10
2,1346,40762,3578752706,3578752716,10
2,1346,40763,3578752706,3578752716,10
2,1346,40764,3578752706,3578752716,10
2,1346,40765,3578752706,3578752717,11
2,1346,40766,3578752706,3578752717,11
2,1346,40767,3578752706,3578752717,11
2,1346,40768,3578752706,3578752717,11
2,1346,40769,3578752706,3578752718,12
2,1346,40770,3578752706,3578752719,13
2,1346,40771,3578752706,3578752721,15
2,1346,40772,3578752706,3578752721,15
2,1346,40773,3578752706,3578752721,15
2,1346,40774,3578752706,3578752721,15
2,1346,40775,3578752706,3578752722,16
2,1346,40776,3578752706,3578752722,16
2,1346,40777,3578752706,3578752722,16
2,1346,40778,3578752706,3578752725,19
2,1346,40779,3578752706,3578752725,19
2,1346,40780,3578752706,3578752725,19
2,1346,40781,3578752706,3578752726,20
2,1346,40782,3578752706,3578752729,23
2,1346,40783,3578752706,3578752731,25
2,1346,40784,3578752706,3578752732,26
2,1346,40785,3578752706,3578752733,27
2,1346,40786,3578752706,3578752734,28
2,1346,40787,3578752706,3578752735,29
2,1346,40788,3578752706,3578752735,29
2,1346,40789,3578752706,3578752735,29
2,1346,40790,3578752706,3578752736,30
2,1346,40791,3578752706,3578752736,30
2,1346,40792,3578752706,3578752736,30
2,1346,40793,3578752706,3578752737,31
2,1346,40794,3578752706,3578752738,32
2,1346,40795,3578752706,3578752738,32
2,1346,40796,3578752706,3578752738,32
2,1346,40797,3578752706,3578752739,33
2,1346,40798,3578752706,3578752740,34
2,1346,40799,3578752706,3578752742,36
2,1346,40800,3578752706,3578752742,36
2,1346,40801,3578752706,3578752743,37
2,1346,40802,3578752706,3578752743,37
2,1346,40803,3578752706,3578752744,38
2,1346,40804,3578752706,3578752745,39
2,1346,40805,3578752706,3578752748,42
2,1346,40806,3578752706,3578752748,42
2,1346,40807,3578752706,3578752749,43
2,1346,40808,3578752706,3578752749,43
2,1346,40809,3578752706,3578752751,45
2,1346,40810,3578752706,3578752751,45
2,1346,40811,3578752706,3578752752,46
2,1346,40812,3578752706,3578752754,48
2,1346,40813,3578752706,3578752754,48
2,1346,40814,3578752706,3578752754,48
2,1346,40815,3578752706,3578752754,48
2,1346,40816,3578752706,3578752756,50
2,1347,40817,3578752768,3578752768,0
2,1347,40818,3578752768,3578752768,0
2,1347,40819,3578752768,3578752768,0
2,1347,40820,3578752768,3578752768,0
2,1347,40821,3578752768,3578752768,0
2,1347,40822,3578752768,3578752768,0
2,1347,40823,3578752768,3578752768,0
2,1347,40824,3578752768,3578752768,0
2,1347,40825,3578752768,3578752768,0
2,1347,40826,3578752768,3578752768,0
2,1347,40827,3578752768,3578752768,0
2,1347,40828,3578752768,3578752768,0
2,1347,40829,3578752768,3578752768,0
2,1347,40830,3578752768,3578752768,0
2,1347,40831,3578752768,3578752769,1
2,1347,40832,3578752768,3578752769,1
2,1347,40833,3578752768,3578752771,3
2,1347,40834,3578752768,3578752771,3
2,1347,40835,3578752768,3578752774,6
2,1347,40836,3578752768,3578752774,6
2,1347,40837,3578752768,3578752774,6
2,1347,40838,3578752768,3578752775,7
2,1347,40839,3578752768,3578752775,7
2,1347,40840,3578752768,3578752776,8
2,1347,40841,3578752768,3578752776,8
2,1347,40842,3578752768,3578752778,10
2,1347,40843,3578752768,3578752778,10
2,1347,40844,3578752768,3578752778,10
2,1347,40845,3578752768,3578752779,11
2,1347,40846,3578752768,3578752780,12
2,1347,40847,3578752768,3578752784,16
2,1347,40848,3578752768,3578752785,17
2,1347,40849,3578752768,3578752785,17
2,1347,40850,3578752768,3578752789,21
2,1347,40851,3578752768,3578752789,21
2,1347,40852,3578752768,3578752789,21
2,1347,40853,3578752768,3578752789,21
2,1347,40854,3578752768,3578752790,22
2,1347,40855,3578752768,3578752791,23
2,1347,40856,3578752768,3578752791,23
2,1347,40857,3578752768,3578752793,25
2,1347,40858,3578752768,3578752793,25
2,1347,40859,3578752768,3578752793,25
2,1347,40860,3578752768,3578752794,26
2,1347,40861,3578752768,3578752794,26
2,1347,40862,3578752768,3578752794,26
2,1347,40863,3578752768,3578752797,29
2,1347,40864,3578752768,3578752798,30
2,1347,40865,3578752768,3578752799,31
2,1347,40866,3578752768,3578752799,31
2,1347,40867,3578752768,3578752800,32
2,1347,40868,3578752768,3578752800,32
2,1347,40869,3578752768,3578752803,35
2,1347,40870,3578752768,3578752804,36
2,1347,40871,3578752768,3578752804,36
2,1347,40872,3578752768,3578752805,37
2,1347,40873,3578752768,3578752806,38
2,1347,40874,3578752768,3578752806,38
2,1347,40875,3578752768,3578752809,41
2,1347,40876,3578752768,3578752812,44
2,1347,40877,3578752768,3578752813,45
2,1347,40878,3578752768,3578752813,45
2,1347,40879,3578752768,3578752813,45
2,1347,40880,3578752768,3578752815,47
2,1347,40881,3578752768,3578752815,47
2,1347,40882,3578752768,3578752816,48
2,1347,40883,3578752768,3578752816,48
2,1347,40884,3578752768,3578752816,48
2,1347,40885,3578752768,3578752817,49
2,1348,40886,3578752831,3578752831,0
2,1348,40887,3578752831,3578752831,0
2,1348,40888,3578752831,3578752831,0
2,1348,40889,3578752831,3578752831,0
2,1348,40890,3578752831,3578752831,0
2,1348,40891,3578752831,3578752831,0
2,1348,40892,3578752831,3578752831,0
2,1348,40893,3578752831,3578752831,0
2,1348,40894,3578752831,3578752831,0
2,1348,40895,3578752831,3578752831,0
2,1348,40896,3578752831,3578752831,0
2,1348,40897,3578752831,3578752831,0
2,1348,40898,3578752831,3578752831,0
2,1348,40899,3578752831,3578752831,0
2,1348,40900,3578752831,3578752831,0
2,1348,40901,3578752831,3578752831,0
2,1348,40902,3578752831,3578752831,0
2,1348,40903,3578752831,3578752831,0
2,1348,40904,3578752831,3578752833,2
2,1348,40905,3578752831,3578752835,4
2,1348,40906,3578752831,3578752836,5
2,1348,40907,3578752831,3578752836,5
2,1348,40908,3578752831,3578752836,5
2,1348,40909,3578752831,3578752837,6
2,1348,40910,3578752831,3578752838,7
2,1348,40911,3578752831,3578752838,7
2,1348,40912,3578752831,3578752838,7
2,1348,40913,3578752831,3578752838,7
2,1348,40914,3578752831,3578752839,8
2,1348,40915,3578752831,3578752841,10
2,1348,40916,3578752831,3578752841,10
2,1348,40917,3578752831,3578752842,11
2,1348,40918,3578752831,3578752843,12
2,1348,40919,3578752831,3578752844,13
2,1348,40920,3578752831,3578752844,13
2,1348,40921,3578752831,3578752845,14
2,1348,40922,3578752831,3578752846,15
2,1348,40923,3578752831,3578752846,15
2,1348,40924,3578752831,3578752847,16
2,1348,40925,3578752831,3578752849,18
2,1348,40926,3578752831,3578752850,19
2,1348,40927,3578752831,3578752852,21
2,1348,40928,3578752831,3578752853,22
2,1348,40929,3578752831,3578752853,22
2,1348,40930,3578752831,3578752855,24
2,1348,40931,3578752831,3578752855,24
2,1348,40932,3578752831,3578752856,25
2,1348,40933,3578752831,3578752856,25
2,1348,40934,3578752831,3578752857,26
2,1348,40935,3578752831,3578752857,26
2,1348,40936,3578752831,3578752859,28
2,1348,40937,3578752831,3578752860,29
2,1348,40938,3578752831,3578752860,29
2,1348,40939,3578752831,3578752860,29
2,1348,40940,3578752831,3578752864,33
2,1348,40941,3578752831,3578752865,34
2,1348,40942,3578752831,3578752866,35
2,1348,40943,3578752831,3578752866,35
2,1348,40944,3578752831,3578752866,35
2,1348,40945,3578752831,3578752867,36
2,1348,40946,3578752831,3578752868,37
2,1348,40947,3578752831,3578752869,38
2,1348,40948,3578752831,3578752873,42
2,1348,40949,3578752831,3578752880,49
2,1348,40950,3578752831,3578752880,49
2,1348,40951,3578752831,3578752881,50
2,1349,40952,3578752894,3578752894,0
2,1349,40953,3578752894,3578752894,0
2,1349,40954,3578752894,3578752894,0
2,1349,40955,3578752894,3578752894,0
2,1349,40956,3578752894,3578752894,0
2,1349,40957,3578752894,3578752894,0
2,1349,40958,3578752894,3578752894,0
2,1349,40959,3578752894,3578752894,0
2,1349,40960,3578752894,3578752894,0
2,1349,40961,3578752894,3578752894,0
2,1349,40962,3578752894,3578752894,0
2,1349,40963,3578752894,3578752894,0
2,1349,40964,3578752894,3578752894,0
2,1349,40965,3578752894,3578752894,0
2,1349,40966,3578752894,3578752894,0
2,1349,40967,3578752894,3578752894,0
2,1349,40968,3578752894,3578752894,0
2,1349,40969,3578752894,3578752894,0
2,1349,40970,3578752894,3578752895,1
2,1349,40971,3578752894,3578752896,2
2,1349,40972,3578752894,3578752896,2
2,1349,40973,3578752894,3578752897,3
2,1349,40974,3578752894,3578752897,3
2,1349,40975,3578752894,3578752899,5
2,1349,40976,3578752894,3578752901,7
2,1349,40977,3578752894,3578752901,7
2,1349,40978,3578752894,3578752902,8
2,1349,40979,3578752894,3578752902,8
2,1349,40980,3578752894,3578752903,9
2,1349,40981,3578752894,3578752903,9
2,1349,40982,3578752894,3578752904,10
2,1349,40983,3578752894,3578752905,11
2,1349,40984,3578752894,3578752907,13
2,1349,40985,3578752894,3578752909,15
2,1349,40986,3578752894,3578752910,16
2,1349,40987,3578752894,3578752910,16
2,1349,40988,3578752894,3578752910,16
2,1349,40989,3578752894,3578752911,17
2,1349,40990,3578752894,3578752912,18
2,1349,40991,3578752894,3578752914,20
2,1349,40992,3578752894,3578752914,20
2,1349,40993,3578752894,3578752914,20
2,1349,40994,3578752894,3578752914,20
2,1349,40995,3578752894,3578752914,20
2,1349,40996,3578752894,3578752914,20
2,1349,40997,3578752894,3578752916,22
2,1349,40998,3578752894,3578752916,22
2,1349,40999,3578752894,3578752916,22
2,1349,41000,3578752894,3578752916,22
2,1349,41001,3578752894,3578752917,23
2,1349,41002,3578752894,3578752917,23
2,1349,41003,3578752894,3578752917,23
2,1349,41004,3578752894,3578752918,24
2,1349,41005,3578752894,3578752918,24
2,1349,41006,3578752894,3578752919,25
2,1349,41007,3578752894,3578752920,26
2,1349,41008,3578752894,3578752921,27
2,1349,41009,3578752894,3578752922,28
2,1349,41010,3578752894,3578752922,28
2,1349,41011,3578752894,3578752922,28
2,1349,41012,3578752894,3578752922,28
2,1349,41013,3578752894,3578752922,28
2,1349,41014,3578752894,3578752924,30
2,1349,41015,3578752894,3578752925,31
2,1349,41016,3578752894,3578752926,32
2,1349,41017,3578752894,3578752926,32
2,1349,41018,3578752894,3578752930,36
2,1349,41019,3578752894,3578752933,39
2,1349,41020,3578752894,3578752933,39
2,1349,41021,3578752894,3578752933,39
2,1349,41022,3578752894,3578752935,41
2,1349,41023,3578752894,3578752935,41
2,1349,41024,3578752894,3578752935,41
2,1349,41025,3578752894,3578752936,42
2,1349,41026,3578752894,3578752937,43
2,1349,41027,3578752894,3578752937,43
2,1349,41028,3578752894,3578752937,43
2,1349,41029,3578752894,3578752938,44
2,1349,41030,3578752894,3578752938,44
2,1349,41031,3578752894,3578752939,45
2,1349,41032,3578752894,3578752939,45
2,1349,41033,3578752894,3578752939,45
2,1349,41034,3578752894,3578752940,46
2,1349,41035,3578752894,3578752940,46
2,1349,41036,3578752894,3578752942,48
2,1349,41037,3578752894,3578752943,49
2,1349,41038,3578752894,3578752944,50
2,1350,41039,3578752956,3578752956,0
2,1350,41040,3578752956,3578752956,0
2,1350,41041,3578752956,3578752956,0
2,1350,41042,3578752956,3578752956,0
2,1350,41043,3578752956,3578752956,0
2,1350,41044,3578752956,3578752956,0
2,1350,41045,3578752956,3578752956,0
2,1350,41046,3578752956,3578752956,0
2,1350,41047,3578752956,3578752956,0
2,1350,41048,3578752956,3578752956,0
2,1350,41049,3578752956,3578752956,0
2,1350,41050,3578752956,3578752956,0
2,1350,41051,3578752956,3578752956,0
2,1350,41052,3578752956,3578752956,0
2,1350,41053,3578752956,3578752957,1
2,1350,41054,3578752956,3578752957,1
2,1350,41055,3578752956,3578752959,3
2,1350,41056,3578752956,3578752960,4
2,1350,41057,3578752956,3578752961,5
2,1350,41058,3578752956,3578752962,6
2,1350,41059,3578752956,3578752964,8
2,1350,41060,3578752956,3578752965,9
2,1350,41061,3578752956,3578752965,9
2,1350,41062,3578752956,3578752965,9
2,1350,41063,3578752956,3578752966,10
2,1350,41064,3578752956,3578752966,10
2,1350,41065,3578752956,3578752968,12
2,1350,41066,3578752956,3578752968,12
2,1350,41067,3578752956,3578752968,12
2,1350,41068,3578752956,3578752969,13
2,1350,41069,3578752956,3578752972,16
2,1350,41070,3578752956,3578752973,17
2,1350,41071,3578752956,3578752974,18
2,1350,41072,3578752956,3578752975,19
2,1350,41073,3578752956,3578752975,19
2,1350,41074,3578752956,3578752976,20
2,1350,41075,3578752956,3578752976,20
2,1350,41076,3578752956,3578752977,21
2,1350,41077,3578752956,3578752978,22
2,1350,41078,3578752956,3578752978,22
2,1350,41079,3578752956,3578752980,24
2,1350,41080,3578752956,3578752981,25
2,1350,41081,3578752956,3578752985,29
2,1350,41082,3578752956,3578752985,29
2,1350,41083,3578752956,3578752985,29
2,1350,41084,3578752956,3578752989,33
2,1350,41085,3578752956,3578752989,33
2,1350,41086,3578752956,3578752990,34
2,1350,41087,3578752956,3578752991,35
2,1350,41088,3578752956,3578752991,35
2,1350,41089,3578752956,3578752992,36
2,1350,41090,3578752956,3578752992,36
2,1350,41091,3578752956,3578752993,37
2,1350,41092,3578752956,3578752993,37
2,1350,41093,3578752956,3578752994,38
2,1350,41094,3578752956,3578752995,39
2,1350,41095,3578752956,3578752997,41
2,1350,41096,3578752956,3578752998,42
2,1350,41097,3578752956,3578752999,43
2,1350,41098,3578752956,3578753000,44
2,1350,41099,3578752956,3578753000,44
2,1350,41100,3578752956,3578753001,45
2,1350,41101,3578752956,3578753004,48
2,1350,41102,3578752956,3578753004,48
2,1350,41103,3578752956,3578753005,49
2,1350,41104,3578752956,3578753006,50
2,1351,41105,3578753018,3578753018,0
2,1351,41106,3578753018,3578753018,0
2,1351,41107,3578753018,3578753018,0
2,1351,41108,3578753018,3578753018,0
2,1351,41109,3578753018,3578753018,0
2,1351,41110,3578753018,3578753018,0
2,1351,41111,3578753018,3578753018,0
2,1351,41112,3578753018,3578753018,0
2,1351,41113,3578753018,3578753018,0
2,1351,41114,3578753018,3578753018,0
2,1351,41115,3578753018,3578753018,0
2,1351,41116,3578753018,3578753018,0
2,1351,41117,3578753018,3578753019,1
2,1351,41118,3578753018,3578753019,1
2,1351,41119,3578753018,3578753020,2
2,1351,41120,3578753018,3578753020,2
2,1351,41121,3578753018,3578753022,4
2,1351,41122,3578753018,3578753024,6
2,1351,41123,3578753018,3578753025,7
2,1351,41124,3578753018,3578753025,7
2,1351,41125,3578753018,3578753027,9
2,1351,41126,3578753018,3578753028,10
2,1351,41127,3578753018,3578753028,10
2,1351,41128,3578753018,3578753028,10
2,1351,41129,3578753018,3578753028,10
2,1351,41130,3578753018,3578753029,11
2,1351,41131,3578753018,3578753030,12
2,1351,41132,3578753018,3578753031,13
2,1351,41133,3578753018,3578753032,14
2,1351,41134,3578753018,3578753032,14
2,1351,41135,3578753018,3578753033,15
2,1351,41136,3578753018,3578753033,15
2,1351,41137,3578753018,3578753036,18
2,1351,41138,3578753018,3578753036,18
2,1351,41139,3578753018,3578753037,19
2,1351,41140,3578753018,3578753037,19
2,1351,41141,3578753018,3578753037,19
2,1351,41142,3578753018,3578753038,20
2,1351,41143,3578753018,3578753038,20
2,1351,41144,3578753018,3578753038,20
2,1351,41145,3578753018,3578753040,22
2,1351,41146,3578753018,3578753040,22
2,1351,41147,3578753018,3578753041,23
2,1351,41148,3578753018,3578753042,24
2,1351,41149,3578753018,3578753043,25
2,1351,41150,3578753018,3578753044,26
2,1351,41151,3578753018,3578753045,27
2,1351,41152,3578753018,3578753045,27
2,1351,41153,3578753018,3578753046,28
2,1351,41154,3578753018,3578753047,29
2,1351,41155,3578753018,3578753047,29
2,1351,41156,3578753018,3578753050,32
2,1351,41157,3578753018,3578753050,32
2,1351,41158,3578753018,3578753052,34
2,1351,41159,3578753018,3578753052,34
2,1351,41160,3578753018,3578753053,35
2,1351,41161,3578753018,3578753054,36
2,1351,41162,3578753018,3578753055,37
2,1351,41163,3578753018,3578753055,37
2,1351,41164,3578753018,3578753056,38
2,1351,41165,3578753018,3578753057,39
2,1351,41166,3578753018,3578753057,39
2,1351,41167,3578753018,3578753057,39
2,1351,41168,3578753018,3578753058,40
2,1351,41169,3578753018,3578753059,41
2,1351,41170,3578753018,3578753060,42
2,1351,41171,3578753018,3578753061,43
2,1351,41172,3578753018,3578753061,43
2,1351,41173,3578753018,3578753065,47
2,1351,41174,3578753018,3578753065,47
2,1351,41175,3578753018,3578753065,47
2,1351,41176,3578753018,3578753066,48
2,1351,41177,3578753018,3578753067,49
2,1351,41178,3578753018,3578753068,50
2,1352,41179,3578753080,3578753080,0
2,1352,41180,3578753080,3578753080,0
2,1352,41181,3578753080,3578753080,0
2,1352,41182,3578753080,3578753080,0
2,1352,41183,3578753080,3578753080,0
2,1352,41184,3578753080,3578753080,0
2,1352,41185,3578753080,3578753082,2
2,1352,41186,3578753080,3578753083,3
2,1352,41187,3578753080,3578753083,3
2,1352,41188,3578753080,3578753083,3
2,1352,41189,3578753080,3578753084,4
2,1352,41190,3578753080,3578753086,6
2,1352,41191,3578753080,3578753087,7
2,1352,41192,3578753080,3578753088,8
2,1352,41193,3578753080,3578753089,9
2,1352,41194,3578753080,3578753089,9
2,1352,41195,3578753080,3578753090,10
2,1352,41196,3578753080,3578753091,11
2,1352,41197,3578753080,3578753092,12
2,1352,41198,3578753080,3578753093,13
2,1352,41199,3578753080,3578753093,13
2,1352,41200,3578753080,3578753094,14
2,1352,41201,3578753080,3578753094,14
2,1352,41202,3578753080,3578753094,14
2,1352,41203,3578753080,3578753095,15
2,1352,41204,3578753080,3578753096,16
2,1352,41205,3578753080,3578753096,16
2,1352,41206,3578753080,3578753096,16
2,1352,41207,3578753080,3578753097,17
2,1352,41208,3578753080,3578753099,19
2,1352,41209,3578753080,3578753100,20
2,1352,41210,3578753080,3578753102,22
2,1352,41211,3578753080,3578753103,23
2,1352,41212,3578753080,3578753103,23
2,1352,41213,3578753080,3578753103,23
2,1352,41214,3578753080,3578753104,24
2,1352,41215,3578753080,3578753104,24
2,1352,41216,3578753080,3578753104,24
2,1352,41217,3578753080,3578753107,27
2,1352,41218,3578753080,3578753109,29
2,1352,41219,3578753080,3578753109,29
2,1352,41220,3578753080,3578753110,30
2,1352,41221,3578753080,3578753110,30
2,1352,41222,3578753080,3578753111,31
2,1352,41223,3578753080,3578753112,32
2,1352,41224,3578753080,3578753114,34
2,1352,41225,3578753080,3578753114,34
2,1352,41226,3578753080,3578753114,34
2,1352,41227,3578753080,3578753114,34
2,1352,41228,3578753080,3578753114,34
2,1352,41229,3578753080,3578753114,34
2,1352,41230,3578753080,3578753116,36
2,1352,41231,3578753080,3578753116,36
2,1352,41232,3578753080,3578753116,36
2,1352,41233,3578753080,3578753116,36
2,1352,41234,3578753080,3578753117,37
2,1352,41235,3578753080,3578753118,38
2,1352,41236,3578753080,3578753119,39
2,1352,41237,3578753080,3578753119,39
2,1352,41238,3578753080,3578753119,39
2,1352,41239,3578753080,3578753121,41
2,1352,41240,3578753080,3578753121,41
2,1352,41241,3578753080,3578753122,42
2,1352,41242,3578753080,3578753122,42
2,1352,41243,3578753080,3578753122,42
2,1352,41244,3578753080,3578753123,43
2,1352,41245,3578753080,3578753124,44
2,1352,41246,3578753080,3578753125,45
2,1352,41247,3578753080,3578753125,45
2,1352,41248,3578753080,3578753126,46
2,1352,41249,3578753080,3578753127,47
2,1352,41250,3578753080,3578753130,50
2,1353,41251,3578753142,3578753142,0
2,1353,41252,3578753142,3578753142,0
2,1353,41253,3578753142,3578753142,0
2,1353,41254,3578753142,3578753142,0
2,1353,41255,3578753142,3578753142,0
2,1353,41256,3578753142,3578753142,0
2,1353,41257,3578753142,3578753142,0
2,1353,41258,3578753142,3578753142,0
2,1353,41259,3578753142,3578753142,0
2,1353,41260,3578753142,3578753142,0
2,1353,41261,3578753142,3578753142,0
2,1353,41262,3578753142,3578753142,0
2,1353,41263,3578753142,3578753142,0
2,1353,41264,3578753142,3578753142,0
2,1353,41265,3578753142,3578753142,0
2,1353,41266,3578753142,3578753142,0
2,1353,41267,3578753142,3578753142,0
2,1353,41268,3578753142,3578753142,0
2,1353,41269,3578753142,3578753142,0
2,1353,41270,3578753142,3578753142,0
2,1353,41271,3578753142,3578753143,1
2,1353,41272,3578753142,3578753143,1
2,1353,41273,3578753142,3578753143,1
2,1353,41274,3578753142,3578753144,2
2,1353,41275,3578753142,3578753145,3
2,1353,41276,3578753142,3578753148,6
2,1353,41277,3578753142,3578753148,6
2,1353,41278,3578753142,3578753151,9
2,1353,41279,3578753142,3578753152,10
2,1353,41280,3578753142,3578753154,12
2,1353,41281,3578753142,3578753154,12
2,1353,41282,3578753142,3578753155,13
2,1353,41283,3578753142,3578753156,14
2,1353,41284,3578753142,3578753156,14
2,1353,41285,3578753142,3578753157,15
2,1353,41286,3578753142,3578753158,16
2,1353,41287,3578753142,3578753159,17
2,1353,41288,3578753142,3578753159,17
2,1353,41289,3578753142,3578753162,20
2,1353,41290,3578753142,3578753164,22
2,1353,41291,3578753142,3578753165,23
2,1353,41292,3578753142,3578753165,23
2,1353,41293,3578753142,3578753166,24
2,1353,41294,3578753142,3578753166,24
2,1353,41295,3578753142,3578753166,24
2,1353,41296,3578753142,3578753168,26
2,1353,41297,3578753142,3578753169,27
2,1353,41298,3578753142,3578753169,27
2,1353,41299,3578753142,3578753169,27
2,1353,41300,3578753142,3578753172,30
2,1353,41301,3578753142,3578753172,30
2,1353,41302,3578753142,3578753174,32
2,1353,41303,3578753142,3578753174,32
2,1353,41304,3578753142,3578753175,33
2,1353,41305,3578753142,3578753176,34
2,1353,41306,3578753142,3578753176,34
2,1353,41307,3578753142,3578753176,34
2,1353,41308,3578753142,3578753177,35
2,1353,41309,3578753142,3578753178,36
2,1353,41310,3578753142,3578753179,37
2,1353,41311,3578753142,3578753180,38
2,1353,41312,3578753142,3578753181,39
2,1353,41313,3578753142,3578753184,42
2,1353,41314,3578753142,3578753185,43
2,1353,41315,3578753142,3578753186,44
2,1353,41316,3578753142,3578753188,46
2,1353,41317,3578753142,3578753189,47
2,1353,41318,3578753142,3578753190,48
2,1353,41319,3578753142,3578753191,49
2,1353,41320,3578753142,3578753192,50
2,1354,41321,3578753204,3578753204,0
2,1354,41322,3578753204,3578753204,0
2,1354,41323,3578753204,3578753204,0
2,1354,41324,3578753204,3578753204,0
2,1354,41325,3578753204,3578753204,0
2,1354,41326,3578753204,3578753204,0
2,1354,41327,3578753204,3578753204,0
2,1354,41328,3578753204,3578753204,0
2,1354,41329,3578753204,3578753204,0
2,1354,41330,3578753204,3578753204,0
2,1354,41331,3578753204,3578753204,0
2,1354,41332,3578753204,3578753204,0
2,1354,41333,3578753204,3578753204,0
2,1354,41334,3578753204,3578753205,1
2,1354,41335,3578753204,3578753206,2
2,1354,41336,3578753204,3578753206,2
2,1354,41337,3578753204,3578753206,2
2,1354,41338,3578753204,3578753209,5
2,1354,41339,3578753204,3578753212,8
2,1354,41340,3578753204,3578753214,10
2,1354,41341,3578753204,3578753214,10
2,1354,41342,3578753204,3578753215,11
2,1354,41343,3578753204,3578753216,12
2,1354,41344,3578753204,3578753216,12
2,1354,41345,3578753204,3578753216,12
2,1354,41346,3578753204,3578753217,13
2,1354,41347,3578753204,3578753217,13
2,1354,41348,3578753204,3578753219,15
2,1354,41349,3578753204,3578753219,15
2,1354,41350,3578753204,3578753220,16
2,1354,41351,3578753204,3578753220,16
2,1354,41352,3578753204,3578753222,18
2,1354,41353,3578753204,3578753224,20
2,1354,41354,3578753204,3578753225,21
2,1354,41355,3578753204,3578753225,21
2,1354,41356,3578753204,3578753227,23
2,1354,41357,3578753204,3578753228,24
2,1354,41358,3578753204,3578753228,24
2,1354,41359,3578753204,3578753229,25
2,1354,41360,3578753204,3578753229,25
2,1354,41361,3578753204,3578753229,25
2,1354,41362,3578753204,3578753230,26
2,1354,41363,3578753204,3578753231,27
2,1354,41364,3578753204,3578753232,28
2,1354,41365,3578753204,3578753233,29
2,1354,41366,3578753204,3578753233,29
2,1354,41367,3578753204,3578753233,29
2,1354,41368,3578753204,3578753235,31
2,1354,41369,3578753204,3578753236,32
2,1354,41370,3578753204,3578753236,32
2,1354,41371,3578753204,3578753237,33
2,1354,41372,3578753204,3578753237,33
2,1354,41373,3578753204,3578753238,34
2,1354,41374,3578753204,3578753239,35
2,1354,41375,3578753204,3578753239,35
2,1354,41376,3578753204,3578753240,36
2,1354,41377,3578753204,3578753240,36
2,1354,41378,3578753204,3578753241,37
2,1354,41379,3578753204,3578753242,38
2,1354,41380,3578753204,3578753243,39
2,1354,41381,3578753204,3578753244,40
2,1354,41382,3578753204,3578753245,41
2,1354,41383,3578753204,3578753246,42
2,1354,41384,3578753204,3578753247,43
2,1354,41385,3578753204,3578753247,43
2,1354,41386,3578753204,3578753250,46
2,1354,41387,3578753204,3578753251,47
2,1354,41388,3578753204,3578753252,48
2,1354,41389,3578753204,3578753252,48
2,1354,41390,3578753204,3578753253,49
2,1354,41391,3578753204,3578753253,49
2,1354,41392,3578753204,3578753254,50
2,1355,41393,3578753266,3578753266,0
2,1355,41394,3578753266,3578753266,0
2,1355,41395,3578753266,3578753266,0
2,1355,41396,3578753266,3578753266,0
2,1355,41397,3578753266,3578753266,0
2,1355,41398,3578753266,3578753267,1
2,1355,41399,3578753266,3578753267,1
2,1355,41400,3578753266,3578753267,1
2,1355,41401,3578753266,3578753267,1
2,1355,41402,3578753266,3578753267,1
2,1355,41403,3578753266,3578753267,1
2,1355,41404,3578753266,3578753267,1
2,1355,41405,3578753266,3578753267,1
2,1355,41406,3578753266,3578753267,1
2,1355,41407,3578753266,3578753267,1
2,1355,41408,3578753266,3578753269,3
2,1355,41409,3578753266,3578753269,3
2,1355,41410,3578753266,3578753274,8
2,1355,41411,3578753266,3578753280,14
2,1355,41412,3578753266,3578753280,14
2,1355,41413,3578753266,3578753280,14
2,1355,41414,3578753266,3578753281,15
2,1355,41415,3578753266,3578753282,16
2,1355,41416,3578753266,3578753283,17
2,1355,41417,3578753266,3578753284,18
2,1355,41418,3578753266,3578753284,18
2,1355,41419,3578753266,3578753286,20
2,1355,41420,3578753266,3578753287,21
2,1355,41421,3578753266,3578753288,22
2,1355,41422,3578753266,3578753290,24
2,1355,41423,3578753266,3578753290,24
2,1355,41424,3578753266,3578753290,24
2,1355,41425,3578753266,3578753290,24
2,1355,41426,3578753266,3578753291,25
2,1355,41427,3578753266,3578753293,27
2,1355,41428,3578753266,3578753293,27
2,1355,41429,3578753266,3578753294,28
2,1355,41430,3578753266,3578753294,28
2,1355,41431,3578753266,3578753294,28
2,1355,41432,3578753266,3578753294,28
2,1355,41433,3578753266,3578753295,29
2,1355,41434,3578753266,3578753297,31
2,1355,41435,3578753266,3578753297,31
2,1355,41436,3578753266,3578753297,31
2,1355,41437,3578753266,3578753297,31
2,1355,41438,3578753266,3578753299,33
2,1355,41439,3578753266,3578753301,35
2,1355,41440,3578753266,3578753301,35
2,1355,41441,3578753266,3578753302,36
2,1355,41442,3578753266,3578753302,36
2,1355,41443,3578753266,3578753303,37
2,1355,41444,3578753266,3578753304,38
2,1355,41445,3578753266,3578753304,38
2,1355,41446,3578753266,3578753305,39
2,1355,41447,3578753266,3578753307,41
2,1355,41448,3578753266,3578753309,43
2,1355,41449,3578753266,3578753309,43
2,1355,41450,3578753266,3578753309,43
2,1355,41451,3578753266,3578753310,44
2,1355,41452,3578753266,3578753311,45
2,1355,41453,3578753266,3578753312,46
2,1355,41454,3578753266,3578753314,48
2,1355,41455,3578753266,3578753314,48
2,1355,41456,3578753266,3578753314,48
2,1355,41457,3578753266,3578753315,49
2,1355,41458,3578753266,3578753315,49
2,1355,41459,3578753266,3578753316,50
2,1356,41460,3578753330,3578753330,0
2,1356,41461,3578753330,3578753330,0
2,1356,41462,3578753330,3578753330,0
2,1356,41463,3578753330,3578753330,0
2,1356,41464,3578753330,3578753330,0
2,1356,41465,3578753330,3578753330,0
2,1356,41466,3578753330,3578753330,0
2,1356,41467,3578753330,3578753330,0
2,1356,41468,3578753330,3578753330,0
2,1356,41469,3578753330,3578753330,0
2,1356,41470,3578753330,3578753330,0
2,1356,41471,3578753330,3578753330,0
2,1356,41472,3578753330,3578753330,0
2,1356,41473,3578753330,3578753330,0
2,1356,41474,3578753330,3578753330,0
2,1356,41475,3578753330,3578753330,0
2,1356,41476,3578753330,3578753330,0
2,1356,41477,3578753330,3578753330,0
2,1356,41478,3578753330,3578753330,0
2,1356,41479,3578753330,3578753330,0
2,1356,41480,3578753330,3578753330,0
2,1356,41481,3578753330,3578753330,0
2,1356,41482,3578753330,3578753330,0
2,1356,41483,3578753330,3578753333,3
2,1356,41484,3578753330,3578753333,3
2,1356,41485,3578753330,3578753334,4
2,1356,41486,3578753330,3578753335,5
2,1356,41487,3578753330,3578753336,6
2,1356,41488,3578753330,3578753336,6
2,1356,41489,3578753330,3578753337,7
2,1356,41490,3578753330,3578753337,7
2,1356,41491,3578753330,3578753338,8
2,1356,41492,3578753330,3578753338,8
2,1356,41493,3578753330,3578753338,8
2,1356,41494,3578753330,3578753339,9
2,1356,41495,3578753330,3578753339,9
2,1356,41496,3578753330,3578753339,9
2,1356,41497,3578753330,3578753340,10
2,1356,41498,3578753330,3578753341,11
2,1356,41499,3578753330,3578753341,11
2,1356,41500,3578753330,3578753343,13
2,1356,41501,3578753330,3578753343,13
2,1356,41502,3578753330,3578753344,14
2,1356,41503,3578753330,3578753344,14
2,1356,41504,3578753330,3578753345,15
2,1356,41505,3578753330,3578753348,18
2,1356,41506,3578753330,3578753348,18
2,1356,41507,3578753330,3578753351,21
2,1356,41508,3578753330,3578753351,21
2,1356,41509,3578753330,3578753352,22
2,1356,41510,3578753330,3578753353,23
2,1356,41511,3578753330,3578753353,23
2,1356,41512,3578753330,3578753355,25
2,1356,41513,3578753330,3578753355,25
2,1356,41514,3578753330,3578753356,26
2,1356,41515,3578753330,3578753358,28
2,1356,41516,3578753330,3578753358,28
2,1356,41517,3578753330,3578753359,29
2,1356,41518,3578753330,3578753359,29
2,1356,41519,3578753330,3578753363,33
2,1356,41520,3578753330,3578753363,33
2,1356,41521,3578753330,3578753366,36
2,1356,41522,3578753330,3578753366,36
2,1356,41523,3578753330,3578753366,36
2,1356,41524,3578753330,3578753366,36
2,1356,41525,3578753330,3578753367,37
2,1356,41526,3578753330,3578753369,39
2,1356,41527,3578753330,3578753370,40
2,1356,41528,3578753330,3578753370,40
2,1356,41529,3578753330,3578753370,40
2,1356,41530,3578753330,3578753373,43
2,1356,41531,3578753330,3578753374,44
2,1356,41532,3578753330,3578753375,45
2,1356,41533,3578753330,3578753375,45
2,1356,41534,3578753330,3578753376,46
2,1356,41535,3578753330,3578753376,46
2,1356,41536,3578753330,3578753377,47
2,1356,41537,3578753330,3578753378,48
2,1356,41538,3578753330,3578753379,49
2,1356,41539,3578753330,3578753379,49
2,1357,41540,3578753393,3578753393,0
2,1357,41541,3578753393,3578753393,0
2,1357,41542,3578753393,3578753393,0
2,1357,41543,3578753393,3578753393,0
2,1357,41544,3578753393,3578753393,0
2,1357,41545,3578753393,3578753393,0
2,1357,41546,3578753393,3578753393,0
2,1357,41547,3578753393,3578753393,0
2,1357,41548,3578753393,3578753393,0
2,1357,41549,3578753393,3578753393,0
2,1357,41550,3578753393,3578753394,1
2,1357,41551,3578753393,3578753394,1
2,1357,41552,3578753393,3578753394,1
2,1357,41553,3578753393,3578753396,3
2,1357,41554,3578753393,3578753400,7
2,1357,41555,3578753393,3578753400,7
2,1357,41556,3578753393,3578753400,7
2,1357,41557,3578753393,3578753400,7
2,1357,41558,3578753393,3578753402,9
2,1357,41559,3578753393,3578753404,11
2,1357,41560,3578753393,3578753405,12
2,1357,41561,3578753393,3578753405,12
2,1357,41562,3578753393,3578753406,13
2,1357,41563,3578753393,3578753406,13
2,1357,41564,3578753393,3578753406,13
2,1357,41565,3578753393,3578753409,16
2,1357,41566,3578753393,3578753413,20
2,1357,41567,3578753393,3578753413,20
2,1357,41568,3578753393,3578753414,21
2,1357,41569,3578753393,3578753415,22
2,1357,41570,3578753393,3578753416,23
2,1357,41571,3578753393,3578753416,23
2,1357,41572,3578753393,3578753417,24
2,1357,41573,3578753393,3578753417,24
2,1357,41574,3578753393,3578753417,24
2,1357,41575,3578753393,3578753418,25
2,1357,41576,3578753393,3578753419,26
2,1357,41577,3578753393,3578753420,27
2,1357,41578,3578753393,3578753423,30
2,1357,41579,3578753393,3578753424,31
2,1357,41580,3578753393,3578753425,32
2,1357,41581,3578753393,3578753425,32
2,1357,41582,3578753393,3578753427,34
2,1357,41583,3578753393,3578753429,36
2,1357,41584,3578753393,3578753429,36
2,1357,41585,3578753393,3578753429,36
2,1357,41586,3578753393,3578753430,37
2,1357,41587,3578753393,3578753431,38
2,1357,41588,3578753393,3578753432,39
2,1357,41589,3578753393,3578753432,39
2,1357,41590,3578753393,3578753433,40
2,1357,41591,3578753393,3578753433,40
2,1357,41592,3578753393,3578753434,41
2,1357,41593,3578753393,3578753435,42
2,1357,41594,3578753393,3578753436,43
2,1357,41595,3578753393,3578753437,44
2,1357,41596,3578753393,3578753438,45
2,1357,41597,3578753393,3578753438,45
2,1357,41598,3578753393,3578753438,45
2,1357,41599,3578753393,3578753439,46
2,1357,41600,3578753393,3578753439,46
2,1357,41601,3578753393,3578753440,47
2,1357,41602,3578753393,3578753440,47
2,1357,41603,3578753393,3578753442,49
2,1357,41604,3578753393,3578753442,49
2,1358,41605,3578753455,3578753455,0
2,1358,41606,3578753455,3578753455,0
2,1358,41607,3578753455,3578753455,0
2,1358,41608,3578753455,3578753455,0
2,1358,41609,3578753455,3578753455,0
2,1358,41610,3578753455,3578753455,0
2,1358,41611,3578753455,3578753455,0
2,1358,41612,3578753455,3578753455,0
2,1358,41613,3578753455,3578753455,0
2,1358,41614,3578753455,3578753455,0
2,1358,41615,3578753455,3578753455,0
2,1358,41616,3578753455,3578753455,0
2,1358,41617,3578753455,3578753455,0
2,1358,41618,3578753455,3578753455,0
2,1358,41619,3578753455,3578753455,0
2,1358,41620,3578753455,3578753457,2
2,1358,41621,3578753455,3578753457,2
2,1358,41622,3578753455,3578753458,3
2,1358,41623,3578753455,3578753458,3
2,1358,41624,3578753455,3578753459,4
2,1358,41625,3578753455,3578753461,6
2,1358,41626,3578753455,3578753461,6
2,1358,41627,3578753455,3578753462,7
2,1358,41628,3578753455,3578753465,10
2,1358,41629,3578753455,3578753466,11
2,1358,41630,3578753455,3578753466,11
2,1358,41631,3578753455,3578753467,12
2,1358,41632,3578753455,3578753468,13
2,1358,41633,3578753455,3578753469,14
2,1358,41634,3578753455,3578753470,15
2,1358,41635,3578753455,3578753475,20
2,1358,41636,3578753455,3578753476,21
2,1358,41637,3578753455,3578753479,24
2,1358,41638,3578753455,3578753480,25
2,1358,41639,3578753455,3578753481,26
2,1358,41640,3578753455,3578753482,27
2,1358,41641,3578753455,3578753483,28
2,1358,41642,3578753455,3578753483,28
2,1358,41643,3578753455,3578753484,29
2,1358,41644,3578753455,3578753486,31
2,1358,41645,3578753455,3578753487,32
2,1358,41646,3578753455,3578753487,32
2,1358,41647,3578753455,3578753490,35
2,1358,41648,3578753455,3578753490,35
2,1358,41649,3578753455,3578753490,35
2,1358,41650,3578753455,3578753490,35
2,1358,41651,3578753455,3578753491,36
2,1358,41652,3578753455,3578753493,38
2,1358,41653,3578753455,3578753493,38
2,1358,41654,3578753455,3578753493,38
2,1358,41655,3578753455,3578753494,39
2,1358,41656,3578753455,3578753494,39
2,1358,41657,3578753455,3578753494,39
2,1358,41658,3578753455,3578753494,39
2,1358,41659,3578753455,3578753495,40
2,1358,41660,3578753455,3578753496,41
2,1358,41661,3578753455,3578753496,41
2,1358,41662,3578753455,3578753497,42
2,1358,41663,3578753455,3578753497,42
2,1358,41664,3578753455,3578753497,42
2,1358,41665,3578753455,3578753500,45
2,1358,41666,3578753455,3578753501,46
2,1358,41667,3578753455,3578753501,46
2,1358,41668,3578753455,3578753503,48
2,1358,41669,3578753455,3578753503,48
2,1358,41670,3578753455,3578753503,48
2,1358,41671,3578753455,3578753504,49
2,1358,41672,3578753455,3578753504,49
2,1358,41673,3578753455,3578753505,50
2,1359,41674,3578753517,3578753517,0
2,1359,41675,3578753517,3578753517,0
2,1359,41676,3578753517,3578753517,0
2,1359,41677,3578753517,3578753517,0
2,1359,41678,3578753517,3578753517,0
2,1359,41679,3578753517,3578753517,0
2,1359,41680,3578753517,3578753517,0
2,1359,41681,3578753517,3578753517,0
2,1359,41682,3578753517,3578753517,0
2,1359,41683,3578753517,3578753517,0
2,1359,41684,3578753517,3578753517,0
2,1359,41685,3578753517,3578753517,0
2,1359,41686,3578753517,3578753517,0
2,1359,41687,3578753517,3578753517,0
2,1359,41688,3578753517,3578753517,0
2,1359,41689,3578753517,3578753517,0
2,1359,41690,3578753517,3578753517,0
2,1359,41691,3578753517,3578753517,0
2,1359,41692,3578753517,3578753517,0
2,1359,41693,3578753517,3578753517,0
2,1359,41694,3578753517,3578753518,1
2,1359,41695,3578753517,3578753518,1
2,1359,41696,3578753517,3578753520,3
2,1359,41697,3578753517,3578753520,3
2,1359,41698,3578753517,3578753521,4
2,1359,41699,3578753517,3578753521,4
2,1359,41700,3578753517,3578753521,4
2,1359,41701,3578753517,3578753522,5
2,1359,41702,3578753517,3578753522,5
2,1359,41703,3578753517,3578753522,5
2,1359,41704,3578753517,3578753523,6
2,1359,41705,3578753517,3578753524,7
2,1359,41706,3578753517,3578753524,7
2,1359,41707,3578753517,3578753525,8
2,1359,41708,3578753517,3578753526,9
2,1359,41709,3578753517,3578753526,9
2,1359,41710,3578753517,3578753526,9
2,1359,41711,3578753517,3578753528,11
2,1359,41712,3578753517,3578753532,15
2,1359,41713,3578753517,3578753532,15
2,1359,41714,3578753517,3578753532,15
2,1359,41715,3578753517,3578753534,17
2,1359,41716,3578753517,3578753534,17
2,1359,41717,3578753517,3578753535,18
2,1359,41718,3578753517,3578753536,19
2,1359,41719,3578753517,3578753536,19
2,1359,41720,3578753517,3578753536,19
2,1359,41721,3578753517,3578753536,19
2,1359,41722,3578753517,3578753537,20
2,1359,41723,3578753517,3578753537,20
2,1359,41724,3578753517,3578753538,21
2,1359,41725,3578753517,3578753538,21
2,1359,41726,3578753517,3578753538,21
2,1359,41727,3578753517,3578753539,22
2,1359,41728,3578753517,3578753540,23
2,1359,41729,3578753517,3578753540,23
2,1359,41730,3578753517,3578753541,24
2,1359,41731,3578753517,3578753543,26
2,1359,41732,3578753517,3578753543,26
2,1359,41733,3578753517,3578753544,27
2,1359,41734,3578753517,3578753544,27
2,1359,41735,3578753517,3578753547,30
2,1359,41736,3578753517,3578753548,31
2,1359,41737,3578753517,3578753549,32
2,1359,41738,3578753517,3578753549,32
2,1359,41739,3578753517,3578753550,33
2,1359,41740,3578753517,3578753551,34
2,1359,41741,3578753517,3578753551,34
2,1359,41742,3578753517,3578753552,35
2,1359,41743,3578753517,3578753553,36
2,1359,41744,3578753517,3578753553,36
2,1359,41745,3578753517,3578753555,38
2,1359,41746,3578753517,3578753555,38
2,1359,41747,3578753517,3578753556,39
2,1359,41748,3578753517,3578753556,39
2,1359,41749,3578753517,3578753556,39
2,1359,41750,3578753517,3578753557,40
2,1359,41751,3578753517,3578753559,42
2,1359,41752,3578753517,3578753559,42
2,1359,41753,3578753517,3578753562,45
2,1359,41754,3578753517,3578753562,45
2,1359,41755,3578753517,3578753564,47
2,1359,41756,3578753517,3578753565,48
2,1359,41757,3578753517,3578753565,48
2,1359,41758,3578753517,3578753565,48
2,1359,41759,3578753517,3578753565,48
2,1360,41760,3578753580,3578753580,0
2,1360,41761,3578753580,3578753580,0
2,1360,41762,3578753580,3578753580,0
2,1360,41763,3578753580,3578753580,0
2,1360,41764,3578753580,3578753580,0
2,1360,41765,3578753580,3578753580,0
2,1360,41766,3578753580,3578753580,0
2,1360,41767,3578753580,3578753580,0
2,1360,41768,3578753580,3578753580,0
2,1360,41769,3578753580,3578753580,0
2,1360,41770,3578753580,3578753580,0
2,1360,41771,3578753580,3578753580,0
2,1360,41772,3578753580,3578753580,0
2,1360,41773,3578753580,3578753580,0
2,1360,41774,3578753580,3578753580,0
2,1360,41775,3578753580,3578753580,0
2,1360,41776,3578753580,3578753580,0
2,1360,41777,3578753580,3578753584,4
2,1360,41778,3578753580,3578753586,6
2,1360,41779,3578753580,3578753588,8
2,1360,41780,3578753580,3578753588,8
2,1360,41781,3578753580,3578753589,9
2,1360,41782,3578753580,3578753590,10
2,1360,41783,3578753580,3578753591,11
2,1360,41784,3578753580,3578753591,11
2,1360,41785,3578753580,3578753591,11
2,1360,41786,3578753580,3578753592,12
2,1360,41787,3578753580,3578753593,13
2,1360,41788,3578753580,3578753593,13
2,1360,41789,3578753580,3578753593,13
2,1360,41790,3578753580,3578753595,15
2,1360,41791,3578753580,3578753595,15
2,1360,41792,3578753580,3578753596,16
2,1360,41793,3578753580,3578753598,18
2,1360,41794,3578753580,3578753599,19
2,1360,41795,3578753580,3578753599,19
2,1360,41796,3578753580,3578753600,20
2,1360,41797,3578753580,3578753601,21
2,1360,41798,3578753580,3578753603,23
2,1360,41799,3578753580,3578753604,24
2,1360,41800,3578753580,3578753605,25
2,1360,41801,3578753580,3578753606,26
2,1360,41802,3578753580,3578753606,26
2,1360,41803,3578753580,3578753608,28
2,1360,41804,3578753580,3578753612,32
2,1360,41805,3578753580,3578753612,32
2,1360,41806,3578753580,3578753612,32
2,1360,41807,3578753580,3578753613,33
2,1360,41808,3578753580,3578753613,33
2,1360,41809,3578753580,3578753615,35
2,1360,41810,3578753580,3578753616,36
2,1360,41811,3578753580,3578753616,36
2,1360,41812,3578753580,3578753616,36
2,1360,41813,3578753580,3578753616,36
2,1360,41814,3578753580,3578753618,38
2,1360,41815,3578753580,3578753619,39
2,1360,41816,3578753580,3578753620,40
2,1360,41817,3578753580,3578753622,42
2,1360,41818,3578753580,3578753623,43
2,1360,41819,3578753580,3578753624,44
2,1360,41820,3578753580,3578753624,44
2,1360,41821,3578753580,3578753627,47
2,1360,41822,3578753580,3578753627,47
2,1360,41823,3578753580,3578753628,48
2,1360,41824,3578753580,3578753628,48
2,1360,41825,3578753580,3578753628,48
2,1360,41826,3578753580,3578753630,50
2,1361,41827,3578753643,3578753643,0
2,1361,41828,3578753643,3578753643,0
2,1361,41829,3578753643,3578753643,0
2,1361,41830,3578753643,3578753643,0
2,1361,41831,3578753643,3578753643,0
2,1361,41832,3578753643,3578753643,0
2,1361,41833,3578753643,3578753643,0
2,1361,41834,3578753643,3578753643,0
2,1361,41835,3578753643,3578753643,0
2,1361,41836,3578753643,3578753643,0
2,1361,41837,3578753643,3578753643,0
2,1361,41838,3578753643,3578753643,0
2,1361,41839,3578753643,3578753643,0
2,1361,41840,3578753643,3578753643,0
2,1361,41841,3578753643,3578753643,0
2,1361,41842,3578753643,3578753643,0
2,1361,41843,3578753643,3578753643,0
2,1361,41844,3578753643,3578753643,0
2,1361,41845,3578753643,3578753643,0
2,1361,41846,3578753643,3578753644,1
2,1361,41847,3578753643,3578753644,1
2,1361,41848,3578753643,3578753645,2
2,1361,41849,3578753643,3578753647,4
2,1361,41850,3578753643,3578753647,4
2,1361,41851,3578753643,3578753650,7
2,1361,41852,3578753643,3578753650,7
2,1361,41853,3578753643,3578753651,8
2,1361,41854,3578753643,3578753652,9
2,1361,41855,3578753643,3578753652,9
2,1361,41856,3578753643,3578753653,10
2,1361,41857,3578753643,3578753653,10
2,1361,41858,3578753643,3578753654,11
2,1361,41859,3578753643,3578753656,13
2,1361,41860,3578753643,3578753657,14
2,1361,41861,3578753643,3578753657,14
2,1361,41862,3578753643,3578753657,14
2,1361,41863,3578753643,3578753658,15
2,1361,41864,3578753643,3578753660,17
2,1361,41865,3578753643,3578753660,17
2,1361,41866,3578753643,3578753660,17
2,1361,41867,3578753643,3578753661,18
2,1361,41868,3578753643,3578753664,21
2,1361,41869,3578753643,3578753666,23
2,1361,41870,3578753643,3578753667,24
2,1361,41871,3578753643,3578753667,24
2,1361,41872,3578753643,3578753667,24
2,1361,41873,3578753643,3578753668,25
2,1361,41874,3578753643,3578753669,26
2,1361,41875,3578753643,3578753676,33
2,1361,41876,3578753643,3578753676,33
2,1361,41877,3578753643,3578753680,37
2,1361,41878,3578753643,3578753680,37
2,1361,41879,3578753643,3578753680,37
2,1361,41880,3578753643,3578753682,39
2,1361,41881,3578753643,3578753683,40
2,1361,41882,3578753643,3578753683,40
2,1361,41883,3578753643,3578753684,41
2,1361,41884,3578753643,3578753684,41
2,1361,41885,3578753643,3578753686,43
2,1361,41886,3578753643,3578753687,44
2,1361,41887,3578753643,3578753687,44
2,1361,41888,3578753643,3578753690,47
2,1361,41889,3578753643,3578753690,47
2,1361,41890,3578753643,3578753691,48
2,1361,41891,3578753643,3578753691,48
2,1361,41892,3578753643,3578753691,48
2,1361,41893,3578753643,3578753693,50
2,1362,41894,3578753706,3578753706,0
2,1362,41895,3578753706,3578753706,0
2,1362,41896,3578753706,3578753706,0
2,1362,41897,3578753706,3578753706,0
2,1362,41898,3578753706,3578753706,0
2,1362,41899,3578753706,3578753706,0
2,1362,41900,3578753706,3578753706,0
2,1362,41901,3578753706,3578753706,0
2,1362,41902,3578753706,3578753706,0
2,1362,41903,3578753706,3578753706,0
2,1362,41904,3578753706,3578753706,0
2,1362,41905,3578753706,3578753706,0
2,1362,41906,3578753706,3578753706,0
2,1362,41907,3578753706,3578753706,0
2,1362,41908,3578753706,3578753706,0
2,1362,41909,3578753706,3578753706,0
2,1362,41910,3578753706,3578753706,0
2,1362,41911,3578753706,3578753706,0
2,1362,41912,3578753706,3578753706,0
2,1362,41913,3578753706,3578753706,0
2,1362,41914,3578753706,3578753706,0
2,1362,41915,3578753706,3578753709,3
2,1362,41916,3578753706,3578753709,3
2,1362,41917,3578753706,3578753710,4
2,1362,41918,3578753706,3578753711,5
2,1362,41919,3578753706,3578753713,7
2,1362,41920,3578753706,3578753713,7
2,1362,41921,3578753706,3578753715,9
2,1362,41922,3578753706,3578753715,9
2,1362,41923,3578753706,3578753715,9
2,1362,41924,3578753706,3578753715,9
2,1362,41925,3578753706,3578753715,9
2,1362,41926,3578753706,3578753716,10
2,1362,41927,3578753706,3578753716,10
2,1362,41928,3578753706,3578753716,10
2,1362,41929,3578753706,3578753717,11
2,1362,41930,3578753706,3578753717,11
2,1362,41931,3578753706,3578753717,11
2,1362,41932,3578753706,3578753717,11
2,1362,41933,3578753706,3578753717,11
2,1362,41934,3578753706,3578753718,12
2,1362,41935,3578753706,3578753720,14
2,1362,41936,3578753706,3578753721,15
2,1362,41937,3578753706,3578753721,15
2,1362,41938,3578753706,3578753721,15
2,1362,41939,3578753706,3578753721,15
2,1362,41940,3578753706,3578753722,16
2,1362,41941,3578753706,3578753722,16
2,1362,41942,3578753706,3578753722,16
2,1362,41943,3578753706,3578753723,17
2,1362,41944,3578753706,3578753724,18
2,1362,41945,3578753706,3578753724,18
2,1362,41946,3578753706,3578753726,20
2,1362,41947,3578753706,3578753726,20
2,1362,41948,3578753706,3578753726,20
2,1362,41949,3578753706,3578753727,21
2,1362,41950,3578753706,3578753728,22
2,1362,41951,3578753706,3578753730,24
2,1362,41952,3578753706,3578753732,26
2,1362,41953,3578753706,3578753732,26
2,1362,41954,3578753706,3578753733,27
2,1362,41955,3578753706,3578753735,29
2,1362,41956,3578753706,3578753736,30
2,1362,41957,3578753706,3578753736,30
2,1362,41958,3578753706,3578753736,30
2,1362,41959,3578753706,3578753737,31
2,1362,41960,3578753706,3578753737,31
2,1362,41961,3578753706,3578753738,32
2,1362,41962,3578753706,3578753738,32
2,1362,41963,3578753706,3578753738,32
2,1362,41964,3578753706,3578753739,33
2,1362,41965,3578753706,3578753739,33
2,1362,41966,3578753706,3578753740,34
2,1362,41967,3578753706,3578753740,34
2,1362,41968,3578753706,3578753742,36
2,1362,41969,3578753706,3578753743,37
2,1362,41970,3578753706,3578753744,38
2,1362,41971,3578753706,3578753748,42
2,1362,41972,3578753706,3578753748,42
2,1362,41973,3578753706,3578753750,44
2,1362,41974,3578753706,3578753750,44
2,1362,41975,3578753706,3578753750,44
2,1362,41976,3578753706,3578753751,45
2,1362,41977,3578753706,3578753751,45
2,1362,41978,3578753706,3578753753,47
2,1362,41979,3578753706,3578753753,47
2,1362,41980,3578753706,3578753754,48
2,1362,41981,3578753706,3578753755,49
2,1362,41982,3578753706,3578753755,49
2,1362,41983,3578753706,3578753756,50
2,1363,41984,3578753769,3578753769,0
2,1363,41985,3578753769,3578753769,0
2,1363,41986,3578753769,3578753769,0
2,1363,41987,3578753769,3578753769,0
2,1363,41988,3578753769,3578753769,0
2,1363,41989,3578753769,3578753769,0
2,1363,41990,3578753769,3578753769,0
2,1363,41991,3578753769,3578753769,0
2,1363,41992,3578753769,3578753769,0
2,1363,41993,3578753769,3578753769,0
2,1363,41994,3578753769,3578753769,0
2,1363,41995,3578753769,3578753769,0
2,1363,41996,3578753769,3578753769,0
2,1363,41997,3578753769,3578753769,0
2,1363,41998,3578753769,3578753770,1
2,1363,41999,3578753769,3578753771,2
2,1363,42000,3578753769,3578753772,3
2,1363,42001,3578753769,3578753773,4
2,1363,42002,3578753769,3578753774,5
2,1363,42003,3578753769,3578753774,5
2,1363,42004,3578753769,3578753774,5
2,1363,42005,3578753769,3578753774,5
2,1363,42006,3578753769,3578753774,5
2,1363,42007,3578753769,3578753775,6
2,1363,42008,3578753769,3578753776,7
2,1363,42009,3578753769,3578753777,8
2,1363,42010,3578753769,3578753778,9
2,1363,42011,3578753769,3578753778,9
2,1363,42012,3578753769,3578753779,10
2,1363,42013,3578753769,3578753781,12
2,1363,42014,3578753769,3578753783,14
2,1363,42015,3578753769,3578753785,16
2,1363,42016,3578753769,3578753785,16
2,1363,42017,3578753769,3578753788,19
2,1363,42018,3578753769,3578753788,19
2,1363,42019,3578753769,3578753790,21
2,1363,42020,3578753769,3578753790,21
2,1363,42021,3578753769,3578753791,22
2,1363,42022,3578753769,3578753791,22
2,1363,42023,3578753769,3578753792,23
2,1363,42024,3578753769,3578753793,24
2,1363,42025,3578753769,3578753793,24
2,1363,42026,3578753769,3578753793,24
2,1363,42027,3578753769,3578753795,26
2,1363,42028,3578753769,3578753795,26
2,1363,42029,3578753769,3578753797,28
2,1363,42030,3578753769,3578753798,29
2,1363,42031,3578753769,3578753799,30
2,1363,42032,3578753769,3578753799,30
2,1363,42033,3578753769,3578753800,31
2,1363,42034,3578753769,3578753803,34
2,1363,42035,3578753769,3578753803,34
2,1363,42036,3578753769,3578753805,36
2,1363,42037,3578753769,3578753805,36
2,1363,42038,3578753769,3578753805,36
2,1363,42039,3578753769,3578753806,37
2,1363,42040,3578753769,3578753808,39
2,1363,42041,3578753769,3578753812,43
2,1363,42042,3578753769,3578753812,43
2,1363,42043,3578753769,3578753813,44
2,1363,42044,3578753769,3578753813,44
2,1363,42045,3578753769,3578753815,46
2,1363,42046,3578753769,3578753816,47
2,1363,42047,3578753769,3578753816,47
2,1363,42048,3578753769,3578753816,47
2,1363,42049,3578753769,3578753816,47
2,1363,42050,3578753769,3578753818,49
2,1363,42051,3578753769,3578753818,49
2,1364,42052,3578753832,3578753832,0
2,1364,42053,3578753832,3578753832,0
2,1364,42054,3578753832,3578753832,0
2,1364,42055,3578753832,3578753832,0
2,1364,42056,3578753832,3578753832,0
2,1364,42057,3578753832,3578753832,0
2,1364,42058,3578753832,3578753832,0
2,1364,42059,3578753832,3578753832,0
2,1364,42060,3578753832,3578753832,0
2,1364,42061,3578753832,3578753832,0
2,1364,42062,3578753832,3578753832,0
2,1364,42063,3578753832,3578753832,0
2,1364,42064,3578753832,3578753833,1
2,1364,42065,3578753832,3578753833,1
2,1364,42066,3578753832,3578753834,2
2,1364,42067,3578753832,3578753835,3
2,1364,42068,3578753832,3578753836,4
2,1364,42069,3578753832,3578753837,5
2,1364,42070,3578753832,3578753837,5
2,1364,42071,3578753832,3578753837,5
2,1364,42072,3578753832,3578753837,5
2,1364,42073,3578753832,3578753838,6
2,1364,42074,3578753832,3578753838,6
2,1364,42075,3578753832,3578753839,7
2,1364,42076,3578753832,3578753840,8
2,1364,42077,3578753832,3578753841,9
2,1364,42078,3578753832,3578753841,9
2,1364,42079,3578753832,3578753842,10
2,1364,42080,3578753832,3578753843,11
2,1364,42081,3578753832,3578753844,12
2,1364,42082,3578753832,3578753846,14
2,1364,42083,3578753832,3578753846,14
2,1364,42084,3578753832,3578753847,15
2,1364,42085,3578753832,3578753848,16
2,1364,42086,3578753832,3578753849,17
2,1364,42087,3578753832,3578753850,18
2,1364,42088,3578753832,3578753851,19
2,1364,42089,3578753832,3578753852,20
2,1364,42090,3578753832,3578753853,21
2,1364,42091,3578753832,3578753853,21
2,1364,42092,3578753832,3578753854,22
2,1364,42093,3578753832,3578753854,22
2,1364,42094,3578753832,3578753856,24
2,1364,42095,3578753832,3578753856,24
2,1364,42096,3578753832,3578753857,25
2,1364,42097,3578753832,3578753858,26
2,1364,42098,3578753832,3578753859,27
2,1364,42099,3578753832,3578753859,27
2,1364,42100,3578753832,3578753859,27
2,1364,42101,3578753832,3578753860,28
2,1364,42102,3578753832,3578753861,29
2,1364,42103,3578753832,3578753864,32
2,1364,42104,3578753832,3578753865,33
2,1364,42105,3578753832,3578753866,34
2,1364,42106,3578753832,3578753867,35
2,1364,42107,3578753832,3578753867,35
2,1364,42108,3578753832,3578753868,36
2,1364,42109,3578753832,3578753870,38
2,1364,42110,3578753832,3578753876,44
2,1364,42111,3578753832,3578753880,48
2,1364,42112,3578753832,3578753880,48
2,1364,42113,3578753832,3578753880,48
2,1364,42114,3578753832,3578753881,49
2,1365,42115,3578753893,3578753893,0
2,1365,42116,3578753893,3578753893,0
2,1365,42117,3578753893,3578753893,0
2,1365,42118,3578753893,3578753893,0
2,1365,42119,3578753893,3578753893,0
2,1365,42120,3578753893,3578753893,0
2,1365,42121,3578753893,3578753893,0
2,1365,42122,3578753893,3578753893,0
2,1365,42123,3578753893,3578753893,0
2,1365,42124,3578753893,3578753893,0
2,1365,42125,3578753893,3578753894,1
2,1365,42126,3578753893,3578753894,1
2,1365,42127,3578753893,3578753894,1
2,1365,42128,3578753893,3578753894,1
2,1365,42129,3578753893,3578753894,1
2,1365,42130,3578753893,3578753894,1
2,1365,42131,3578753893,3578753895,2
2,1365,42132,3578753893,3578753895,2
2,1365,42133,3578753893,3578753895,2
2,1365,42134,3578753893,3578753896,3
2,1365,42135,3578753893,3578753897,4
2,1365,42136,3578753893,3578753897,4
2,1365,42137,3578753893,3578753898,5
2,1365,42138,3578753893,3578753899,6
2,1365,42139,3578753893,3578753899,6
2,1365,42140,3578753893,3578753901,8
2,1365,42141,3578753893,3578753901,8
2,1365,42142,3578753893,3578753902,9
2,1365,42143,3578753893,3578753904,11
2,1365,42144,3578753893,3578753904,11
2,1365,42145,3578753893,3578753904,11
2,1365,42146,3578753893,3578753904,11
2,1365,42147,3578753893,3578753905,12
2,1365,42148,3578753893,3578753905,12
2,1365,42149,3578753893,3578753909,16
2,1365,42150,3578753893,3578753910,17
2,1365,42151,3578753893,3578753911,18
2,1365,42152,3578753893,3578753911,18
2,1365,42153,3578753893,3578753911,18
2,1365,42154,3578753893,3578753913,20
2,1365,42155,3578753893,3578753913,20
2,1365,42156,3578753893,3578753914,21
2,1365,42157,3578753893,3578753915,22
2,1365,42158,3578753893,3578753915,22
2,1365,42159,3578753893,3578753915,22
2,1365,42160,3578753893,3578753915,22
2,1365,42161,3578753893,3578753915,22
2,1365,42162,3578753893,3578753915,22
2,1365,42163,3578753893,3578753916,23
2,1365,42164,3578753893,3578753916,23
2,1365,42165,3578753893,3578753917,24
2,1365,42166,3578753893,3578753917,24
2,1365,42167,3578753893,3578753917,24
2,1365,42168,3578753893,3578753918,25
2,1365,42169,3578753893,3578753918,25
2,1365,42170,3578753893,3578753919,26
2,1365,42171,3578753893,3578753921,28
2,1365,42172,3578753893,3578753921,28
2,1365,42173,3578753893,3578753921,28
2,1365,42174,3578753893,3578753921,28
2,1365,42175,3578753893,3578753922,29
2,1365,42176,3578753893,3578753923,30
2,1365,42177,3578753893,3578753923,30
2,1365,42178,3578753893,3578753924,31
2,1365,42179,3578753893,3578753924,31
2,1365,42180,3578753893,3578753925,32
2,1365,42181,3578753893,3578753926,33
2,1365,42182,3578753893,3578753926,33
2,1365,42183,3578753893,3578753926,33
2,1365,42184,3578753893,3578753927,34
2,1365,42185,3578753893,3578753928,35
2,1365,42186,3578753893,3578753931,38
2,1365,42187,3578753893,3578753932,39
2,1365,42188,3578753893,3578753933,40
2,1365,42189,3578753893,3578753933,40
2,1365,42190,3578753893,3578753935,42
2,1365,42191,3578753893,3578753936,43
2,1365,42192,3578753893,3578753936,43
2,1365,42193,3578753893,3578753936,43
2,1365,42194,3578753893,3578753937,44
2,1365,42195,3578753893,3578753937,44
2,1365,42196,3578753893,3578753937,44
2,1365,42197,3578753893,3578753938,45
2,1365,42198,3578753893,3578753938,45
2,1365,42199,3578753893,3578753939,46
2,1365,42200,3578753893,3578753939,46
2,1365,42201,3578753893,3578753940,47
2,1365,42202,3578753893,3578753941,48
2,1365,42203,3578753893,3578753943,50
2,1366,42204,3578754072,3578754072,0
2,1366,42205,3578754072,3578754072,0
2,1366,42206,3578754072,3578754072,0
2,1366,42207,3578754072,3578754072,0
2,1366,42208,3578754072,3578754072,0
2,1366,42209,3578754072,3578754072,0
2,1366,42210,3578754072,3578754072,0
2,1366,42211,3578754072,3578754072,0
2,1366,42212,3578754072,3578754072,0
2,1366,42213,3578754072,3578754072,0
2,1366,42214,3578754072,3578754072,0
2,1366,42215,3578754072,3578754072,0
2,1366,42216,3578754072,3578754072,0
2,1366,42217,3578754072,3578754072,0
2,1366,42218,3578754072,3578754072,0
2,1366,42219,3578754072,3578754072,0
2,1366,42220,3578754072,3578754072,0
2,1366,42221,3578754072,3578754072,0
2,1366,42222,3578754072,3578754072,0
2,1366,42223,3578754072,3578754072,0
2,1366,42224,3578754072,3578754072,0
2,1366,42225,3578754072,3578754072,0
2,1366,42226,3578754072,3578754072,0
2,1366,42227,3578754072,3578754072,0
2,1366,42228,3578754072,3578754072,0
2,1366,42229,3578754072,3578754072,0
2,1366,42230,3578754072,3578754072,0
2,1366,42231,3578754072,3578754072,0
2,1366,42232,3578754072,3578754072,0
2,1366,42233,3578754072,3578754072,0
2,1366,42234,3578754072,3578754072,0
2,1366,42235,3578754072,3578754072,0
2,1366,42236,3578754072,3578754072,0
2,1366,42237,3578754072,3578754072,0
2,1366,42238,3578754072,3578754072,0
2,1366,42239,3578754072,3578754072,0
2,1366,42240,3578754072,3578754072,0
2,1366,42241,3578754072,3578754072,0
2,1366,42242,3578754072,3578754072,0
2,1366,42243,3578754072,3578754072,0
2,1366,42244,3578754072,3578754072,0
2,1366,42245,3578754072,3578754072,0
2,1366,42246,3578754072,3578754073,1
2,1366,42247,3578754072,3578754073,1
2,1366,42248,3578754072,3578754073,1
2,1366,42249,3578754072,3578754073,1
2,1366,42250,3578754072,3578754073,1
2,1366,42251,3578754072,3578754073,1
2,1366,42252,3578754072,3578754073,1
2,1366,42253,3578754072,3578754073,1
2,1366,42254,3578754072,3578754073,1
2,1366,42255,3578754072,3578754073,1
2,1366,42256,3578754072,3578754073,1
2,1366,42257,3578754072,3578754073,1
2,1366,42258,3578754072,3578754073,1
2,1366,42259,3578754072,3578754073,1
2,1366,42260,3578754072,3578754073,1
2,1366,42261,3578754072,3578754073,1
2,1366,42262,3578754072,3578754073,1
2,1366,42263,3578754072,3578754073,1
2,1366,42264,3578754072,3578754073,1
2,1366,42265,3578754072,3578754073,1
2,1366,42266,3578754072,3578754073,1
2,1366,42267,3578754072,3578754073,1
2,1366,42268,3578754072,3578754073,1
2,1366,42269,3578754072,3578754073,1
2,1366,42270,3578754072,3578754073,1
2,1366,42271,3578754072,3578754073,1
2,1366,42272,3578754072,3578754073,1
2,1366,42273,3578754072,3578754073,1
2,1366,42274,3578754072,3578754073,1
2,1366,42275,3578754072,3578754073,1
2,1366,42276,3578754072,3578754073,1
2,1366,42277,3578754072,3578754073,1
2,1366,42278,3578754072,3578754073,1
2,1366,42279,3578754072,3578754073,1
2,1366,42280,3578754072,3578754073,1
2,1366,42281,3578754072,3578754073,1
2,1366,42282,3578754072,3578754073,1
2,1366,42283,3578754072,3578754073,1
2,1366,42284,3578754072,3578754073,1
2,1366,42285,3578754072,3578754073,1
2,1366,42286,3578754072,3578754073,1
2,1366,42287,3578754072,3578754073,1
2,1366,42288,3578754072,3578754073,1
2,1366,42289,3578754072,3578754073,1
2,1366,42290,3578754072,3578754073,1
2,1366,42291,3578754072,3578754132,60
2,1366,42292,3578754072,3578754132,60
2,1366,42293,3578754072,3578754132,60
2,1366,42294,3578754072,3578754132,60
2,1366,42295,3578754072,3578754132,60
2,1366,42296,3578754072,3578754132,60
2,1366,42297,3578754072,3578754132,60
2,1366,42298,3578754072,3578754132,60
2,1366,42299,3578754072,3578754132,60
2,1366,42300,3578754072,3578754132,60
2,1366,42301,3578754072,3578754132,60
2,1366,42302,3578754072,3578754132,60
2,1366,42303,3578754072,3578754132,60
2,1366,42304,3578754072,3578754132,60
2,1366,42305,3578754072,3578754132,60
2,1366,42306,3578754072,3578754132,60
2,1366,42307,3578754072,3578754132,60
2,1366,42308,3578754072,3578754132,60
2,1366,42309,3578754072,3578754132,60
2,1366,42310,3578754072,3578754132,60
2,1366,42311,3578754072,3578754132,60
2,1366,42312,3578754072,3578754132,60
2,1366,42313,3578754072,3578754132,60
2,1366,42314,3578754072,3578754132,60
2,1366,42315,3578754072,3578754132,60
2,1366,42316,3578754072,3578754133,61
2,1366,42317,3578754072,3578754133,61
2,1366,42318,3578754072,3578754133,61
2,1366,42319,3578754072,3578754133,61
2,1366,42320,3578754072,3578754133,61
2,1366,42321,3578754072,3578754133,61
2,1366,42322,3578754072,3578754133,61
2,1366,42323,3578754072,3578754133,61
2,1366,42324,3578754072,3578754133,61
2,1366,42325,3578754072,3578754133,61
2,1366,42326,3578754072,3578754133,61
2,1366,42327,3578754072,3578754133,61
2,1366,42328,3578754072,3578754133,61
2,1366,42329,3578754072,3578754133,61
2,1366,42330,3578754072,3578754133,61
2,1366,42331,3578754072,3578754133,61
2,1366,42332,3578754072,3578754133,61
2,1366,42333,3578754072,3578754133,61
2,1366,42334,3578754072,3578754133,61
2,1366,42335,3578754072,3578754133,61
2,1366,42336,3578754072,3578754133,61
2,1366,42337,3578754072,3578754133,61
2,1366,42338,3578754072,3578754133,61
2,1366,42339,3578754072,3578754133,61
2,1366,42340,3578754072,3578754133,61
2,1366,42341,3578754072,3578754133,61
2,1366,42342,3578754072,3578754133,61
2,1366,42343,3578754072,3578754133,61
2,1366,42344,3578754072,3578754133,61
2,1366,42345,3578754072,3578754133,61
2,1366,42346,3578754072,3578754133,61
2,1366,42347,3578754072,3578754133,61
2,1366,42348,3578754072,3578754133,61
2,1366,42349,3578754072,3578754133,61
2,1366,42350,3578754072,3578754133,61
2,1366,42351,3578754072,3578754133,61
2,1366,42352,3578754072,3578754133,61
2,1366,42353,3578754072,3578754133,61
2,1366,42354,3578754072,3578754133,61
2,1366,42355,3578754072,3578754133,61
2,1366,42356,3578754072,3578754133,61
2,1366,42357,3578754072,3578754133,61
2,1366,42358,3578754072,3578754133,61
2,1366,42359,3578754072,3578754133,61
2,1366,42360,3578754072,3578754133,61
2,1366,42361,3578754072,3578754133,61
2,1366,42362,3578754072,3578754133,61
2,1366,42363,3578754072,3578754133,61
2,1366,42364,3578754072,3578754133,61
2,1366,42365,3578754072,3578754133,61
2,1366,42366,3578754072,3578754133,61
2,1366,42367,3578754072,3578754133,61
2,1366,42368,3578754072,3578754133,61
2,1366,42369,3578754072,3578754133,61
2,1366,42370,3578754072,3578754133,61
2,1366,42371,3578754072,3578754133,61
2,1366,42372,3578754072,3578754133,61
2,1366,42373,3578754072,3578754133,61
2,1366,42374,3578754072,3578754133,61
2,1366,42375,3578754072,3578754133,61
2,1366,42376,3578754072,3578754133,61
2,1366,42377,3578754072,3578754133,61
2,1366,42378,3578754072,3578754133,61
2,1366,42379,3578754072,3578754133,61
2,1366,42380,3578754072,3578754133,61
2,1366,42381,3578754072,3578754133,61
2,1366,42382,3578754072,3578754133,61
2,1366,42383,3578754072,3578754133,61
2,1366,42384,3578754072,3578754133,61
2,1366,42385,3578754072,3578754133,61
2,1366,42386,3578754072,3578754133,61
2,1366,42387,3578754072,3578754133,61
2,1366,42388,3578754072,3578754133,61
2,1366,42389,3578754072,3578754133,61
2,1366,42390,3578754072,3578754133,61
2,1366,42391,3578754072,3578754133,61
2,1366,42392,3578754072,3578754133,61
2,1366,42393,3578754072,3578754133,61
2,1366,42394,3578754072,3578754133,61
2,1366,42395,3578754072,3578754133,61
2,1366,42396,3578754072,3578754133,61
2,1366,42397,3578754072,3578754133,61
2,1366,42398,3578754072,3578754133,61
2,1366,42399,3578754072,3578754133,61
2,1366,42400,3578754072,3578754133,61
2,1366,42401,3578754072,3578754133,61
2,1366,42402,3578754072,3578754133,61
2,1366,42403,3578754072,3578754133,61
2,1366,42404,3578754072,3578754133,61
2,1366,42405,3578754072,3578754133,61
2,1366,42406,3578754072,3578754133,61
2,1366,42407,3578754072,3578754133,61
2,1366,42408,3578754072,3578754133,61
2,1366,42409,3578754072,3578754133,61
2,1366,42410,3578754072,3578754133,61
2,1366,42411,3578754072,3578754133,61
2,1366,42412,3578754072,3578754133,61
2,1366,42413,3578754072,3578754133,61
2,1366,42414,3578754072,3578754133,61
2,1366,42415,3578754072,3578754133,61
2,1366,42416,3578754072,3578754133,61
2,1366,42417,3578754072,3578754133,61
2,1366,42418,3578754072,3578754133,61
2,1367,42419,3578754147,3578754147,0
2,1367,42420,3578754147,3578754147,0
2,1367,42421,3578754147,3578754147,0
2,1367,42422,3578754147,3578754147,0
2,1367,42423,3578754147,3578754147,0
2,1367,42424,3578754147,3578754147,0
2,1367,42425,3578754147,3578754147,0
2,1367,42426,3578754147,3578754147,0
2,1367,42427,3578754147,3578754147,0
2,1367,42428,3578754147,3578754147,0
2,1367,42429,3578754147,3578754147,0
2,1367,42430,3578754147,3578754147,0
2,1367,42431,3578754147,3578754148,1
2,1367,42432,3578754147,3578754149,2
2,1367,42433,3578754147,3578754150,3
2,1367,42434,3578754147,3578754150,3
2,1367,42435,3578754147,3578754151,4
2,1367,42436,3578754147,3578754152,5
2,1367,42437,3578754147,3578754154,7
2,1367,42438,3578754147,3578754154,7
2,1367,42439,3578754147,3578754154,7
2,1367,42440,3578754147,3578754155,8
2,1367,42441,3578754147,3578754155,8
2,1367,42442,3578754147,3578754155,8
2,1367,42443,3578754147,3578754156,9
2,1367,42444,3578754147,3578754157,10
2,1367,42445,3578754147,3578754158,11
2,1367,42446,3578754147,3578754158,11
2,1367,42447,3578754147,3578754159,12
2,1367,42448,3578754147,3578754159,12
2,1367,42449,3578754147,3578754163,16
2,1367,42450,3578754147,3578754164,17
2,1367,42451,3578754147,3578754165,18
2,1367,42452,3578754147,3578754166,19
2,1367,42453,3578754147,3578754167,20
2,1367,42454,3578754147,3578754168,21
2,1367,42455,3578754147,3578754168,21
2,1367,42456,3578754147,3578754168,21
2,1367,42457,3578754147,3578754171,24
2,1367,42458,3578754147,3578754171,24
2,1367,42459,3578754147,3578754173,26
2,1367,42460,3578754147,3578754174,27
2,1367,42461,3578754147,3578754174,27
2,1367,42462,3578754147,3578754174,27
2,1367,42463,3578754147,3578754174,27
2,1367,42464,3578754147,3578754174,27
2,1367,42465,3578754147,3578754175,28
2,1367,42466,3578754147,3578754176,29
2,1367,42467,3578754147,3578754178,31
2,1367,42468,3578754147,3578754178,31
2,1367,42469,3578754147,3578754180,33
2,1367,42470,3578754147,3578754183,36
2,1367,42471,3578754147,3578754185,38
2,1367,42472,3578754147,3578754185,38
2,1367,42473,3578754147,3578754189,42
2,1367,42474,3578754147,3578754189,42
2,1367,42475,3578754147,3578754190,43
2,1367,42476,3578754147,3578754191,44
2,1367,42477,3578754147,3578754191,44
2,1367,42478,3578754147,3578754192,45
2,1367,42479,3578754147,3578754193,46
2,1367,42480,3578754147,3578754193,46
2,1367,42481,3578754147,3578754193,46
2,1367,42482,3578754147,3578754194,47
2,1367,42483,3578754147,3578754194,47
2,1367,42484,3578754147,3578754195,48
2,1368,42485,3578754210,3578754210,0
2,1368,42486,3578754210,3578754210,0
2,1368,42487,3578754210,3578754210,0
2,1368,42488,3578754210,3578754210,0
2,1368,42489,3578754210,3578754210,0
2,1368,42490,3578754210,3578754210,0
2,1368,42491,3578754210,3578754210,0
2,1368,42492,3578754210,3578754210,0
2,1368,42493,3578754210,3578754210,0
2,1368,42494,3578754210,3578754210,0
2,1368,42495,3578754210,3578754212,2
2,1368,42496,3578754210,3578754214,4
2,1368,42497,3578754210,3578754214,4
2,1368,42498,3578754210,3578754214,4
2,1368,42499,3578754210,3578754216,6
2,1368,42500,3578754210,3578754217,7
2,1368,42501,3578754210,3578754218,8
2,1368,42502,3578754210,3578754218,8
2,1368,42503,3578754210,3578754219,9
2,1368,42504,3578754210,3578754221,11
2,1368,42505,3578754210,3578754223,13
2,1368,42506,3578754210,3578754224,14
2,1368,42507,3578754210,3578754224,14
2,1368,42508,3578754210,3578754224,14
2,1368,42509,3578754210,3578754227,17
2,1368,42510,3578754210,3578754228,18
2,1368,42511,3578754210,3578754229,19
2,1368,42512,3578754210,3578754229,19
2,1368,42513,3578754210,3578754230,20
2,1368,42514,3578754210,3578754231,21
2,1368,42515,3578754210,3578754232,22
2,1368,42516,3578754210,3578754232,22
2,1368,42517,3578754210,3578754232,22
2,1368,42518,3578754210,3578754233,23
2,1368,42519,3578754210,3578754234,24
2,1368,42520,3578754210,3578754235,25
2,1368,42521,3578754210,3578754236,26
2,1368,42522,3578754210,3578754236,26
2,1368,42523,3578754210,3578754237,27
2,1368,42524,3578754210,3578754238,28
2,1368,42525,3578754210,3578754238,28
2,1368,42526,3578754210,3578754239,29
2,1368,42527,3578754210,3578754239,29
2,1368,42528,3578754210,3578754239,29
2,1368,42529,3578754210,3578754241,31
2,1368,42530,3578754210,3578754241,31
2,1368,42531,3578754210,3578754242,32
2,1368,42532,3578754210,3578754242,32
2,1368,42533,3578754210,3578754243,33
2,1368,42534,3578754210,3578754244,34
2,1368,42535,3578754210,3578754245,35
2,1368,42536,3578754210,3578754246,36
2,1368,42537,3578754210,3578754247,37
2,1368,42538,3578754210,3578754248,38
2,1368,42539,3578754210,3578754250,40
2,1368,42540,3578754210,3578754251,41
2,1368,42541,3578754210,3578754253,43
2,1368,42542,3578754210,3578754253,43
2,1368,42543,3578754210,3578754254,44
2,1368,42544,3578754210,3578754254,44
2,1368,42545,3578754210,3578754255,45
2,1368,42546,3578754210,3578754256,46
2,1368,42547,3578754210,3578754257,47
2,1368,42548,3578754210,3578754258,48
2,1368,42549,3578754210,3578754258,48
2,1368,42550,3578754210,3578754258,48
2,1368,42551,3578754210,3578754258,48
2,1368,42552,3578754210,3578754258,48
2,1368,42553,3578754210,3578754260,50
2,1369,42554,3578754274,3578754274,0
2,1369,42555,3578754274,3578754274,0
2,1369,42556,3578754274,3578754274,0
2,1369,42557,3578754274,3578754274,0
2,1369,42558,3578754274,3578754274,0
2,1369,42559,3578754274,3578754274,0
2,1369,42560,3578754274,3578754274,0
2,1369,42561,3578754274,3578754274,0
2,1369,42562,3578754274,3578754274,0
2,1369,42563,3578754274,3578754274,0
2,1369,42564,3578754274,3578754278,4
2,1369,42565,3578754274,3578754280,6
2,1369,42566,3578754274,3578754280,6
2,1369,42567,3578754274,3578754281,7
2,1369,42568,3578754274,3578754281,7
2,1369,42569,3578754274,3578754283,9
2,1369,42570,3578754274,3578754283,9
2,1369,42571,3578754274,3578754284,10
2,1369,42572,3578754274,3578754284,10
2,1369,42573,3578754274,3578754286,12
2,1369,42574,3578754274,3578754288,14
2,1369,42575,3578754274,3578754288,14
2,1369,42576,3578754274,3578754288,14
2,1369,42577,3578754274,3578754290,16
2,1369,42578,3578754274,3578754291,17
2,1369,42579,3578754274,3578754292,18
2,1369,42580,3578754274,3578754292,18
2,1369,42581,3578754274,3578754294,20
2,1369,42582,3578754274,3578754294,20
2,1369,42583,3578754274,3578754295,21
2,1369,42584,3578754274,3578754295,21
2,1369,42585,3578754274,3578754296,22
2,1369,42586,3578754274,3578754297,23
2,1369,42587,3578754274,3578754297,23
2,1369,42588,3578754274,3578754298,24
2,1369,42589,3578754274,3578754298,24
2,1369,42590,3578754274,3578754298,24
2,1369,42591,3578754274,3578754299,25
2,1369,42592,3578754274,3578754301,27
2,1369,42593,3578754274,3578754301,27
2,1369,42594,3578754274,3578754301,27
2,1369,42595,3578754274,3578754303,29
2,1369,42596,3578754274,3578754304,30
2,1369,42597,3578754274,3578754304,30
2,1369,42598,3578754274,3578754304,30
2,1369,42599,3578754274,3578754304,30
2,1369,42600,3578754274,3578754305,31
2,1369,42601,3578754274,3578754308,34
2,1369,42602,3578754274,3578754309,35
2,1369,42603,3578754274,3578754310,36
2,1369,42604,3578754274,3578754311,37
2,1369,42605,3578754274,3578754311,37
2,1369,42606,3578754274,3578754311,37
2,1369,42607,3578754274,3578754314,40
2,1369,42608,3578754274,3578754315,41
2,1369,42609,3578754274,3578754315,41
2,1369,42610,3578754274,3578754315,41
2,1369,42611,3578754274,3578754315,41
2,1369,42612,3578754274,3578754315,41
2,1369,42613,3578754274,3578754315,41
2,1369,42614,3578754274,3578754316,42
2,1369,42615,3578754274,3578754316,42
2,1369,42616,3578754274,3578754316,42
2,1369,42617,3578754274,3578754318,44
2,1369,42618,3578754274,3578754318,44
2,1369,42619,3578754274,3578754318,44
2,1369,42620,3578754274,3578754319,45
2,1369,42621,3578754274,3578754319,45
2,1369,42622,3578754274,3578754321,47
2,1369,42623,3578754274,3578754321,47
2,1369,42624,3578754274,3578754322,48
2,1369,42625,3578754274,3578754322,48
2,1369,42626,3578754274,3578754323,49
2,1369,42627,3578754274,3578754323,49
2,1369,42628,3578754274,3578754324,50
2,1370,42629,3578754338,3578754338,0
2,1370,42630,3578754338,3578754338,0
2,1370,42631,3578754338,3578754338,0
2,1370,42632,3578754338,3578754338,0
2,1370,42633,3578754338,3578754338,0
2,1370,42634,3578754338,3578754338,0
2,1370,42635,3578754338,3578754338,0
2,1370,42636,3578754338,3578754338,0
2,1370,42637,3578754338,3578754338,0
2,1370,42638,3578754338,3578754338,0
2,1370,42639,3578754338,3578754338,0
2,1370,42640,3578754338,3578754338,0
2,1370,42641,3578754338,3578754338,0
2,1370,42642,3578754338,3578754338,0
2,1370,42643,3578754338,3578754338,0
2,1370,42644,3578754338,3578754338,0
2,1370,42645,3578754338,3578754338,0
2,1370,42646,3578754338,3578754338,0
2,1370,42647,3578754338,3578754338,0
2,1370,42648,3578754338,3578754338,0
2,1370,42649,3578754338,3578754339,1
2,1370,42650,3578754338,3578754340,2
2,1370,42651,3578754338,3578754340,2
2,1370,42652,3578754338,3578754342,4
2,1370,42653,3578754338,3578754343,5
2,1370,42654,3578754338,3578754344,6
2,1370,42655,3578754338,3578754346,8
2,1370,42656,3578754338,3578754348,10
2,1370,42657,3578754338,3578754349,11
2,1370,42658,3578754338,3578754350,12
2,1370,42659,3578754338,3578754350,12
2,1370,42660,3578754338,3578754351,13
2,1370,42661,3578754338,3578754351,13
2,1370,42662,3578754338,3578754352,14
2,1370,42663,3578754338,3578754354,16
2,1370,42664,3578754338,3578754354,16
2,1370,42665,3578754338,3578754354,16
2,1370,42666,3578754338,3578754354,16
2,1370,42667,3578754338,3578754354,16
2,1370,42668,3578754338,3578754355,17
2,1370,42669,3578754338,3578754355,17
2,1370,42670,3578754338,3578754358,20
2,1370,42671,3578754338,3578754358,20
2,1370,42672,3578754338,3578754359,21
2,1370,42673,3578754338,3578754359,21
2,1370,42674,3578754338,3578754363,25
2,1370,42675,3578754338,3578754366,28
2,1370,42676,3578754338,3578754366,28
2,1370,42677,3578754338,3578754367,29
2,1370,42678,3578754338,3578754369,31
2,1370,42679,3578754338,3578754369,31
2,1370,42680,3578754338,3578754369,31
2,1370,42681,3578754338,3578754370,32
2,1370,42682,3578754338,3578754372,34
2,1370,42683,3578754338,3578754372,34
2,1370,42684,3578754338,3578754373,35
2,1370,42685,3578754338,3578754374,36
2,1370,42686,3578754338,3578754374,36
2,1370,42687,3578754338,3578754374,36
2,1370,42688,3578754338,3578754374,36
2,1370,42689,3578754338,3578754375,37
2,1370,42690,3578754338,3578754376,38
2,1370,42691,3578754338,3578754376,38
2,1370,42692,3578754338,3578754377,39
2,1370,42693,3578754338,3578754380,42
2,1370,42694,3578754338,3578754384,46
2,1370,42695,3578754338,3578754384,46
2,1370,42696,3578754338,3578754386,48
2,1371,42697,3578754401,3578754401,0
2,1371,42698,3578754401,3578754401,0
2,1371,42699,3578754401,3578754401,0
2,1371,42700,3578754401,3578754401,0
2,1371,42701,3578754401,3578754401,0
2,1371,42702,3578754401,3578754401,0
2,1371,42703,3578754401,3578754401,0
2,1371,42704,3578754401,3578754401,0
2,1371,42705,3578754401,3578754401,0
2,1371,42706,3578754401,3578754401,0
2,1371,42707,3578754401,3578754401,0
2,1371,42708,3578754401,3578754401,0
2,1371,42709,3578754401,3578754401,0
2,1371,42710,3578754401,3578754401,0
2,1371,42711,3578754401,3578754401,0
2,1371,42712,3578754401,3578754401,0
2,1371,42713,3578754401,3578754401,0
2,1371,42714,3578754401,3578754402,1
2,1371,42715,3578754401,3578754404,3
2,1371,42716,3578754401,3578754405,4
2,1371,42717,3578754401,3578754405,4
2,1371,42718,3578754401,3578754405,4
2,1371,42719,3578754401,3578754406,5
2,1371,42720,3578754401,3578754406,5
2,1371,42721,3578754401,3578754408,7
2,1371,42722,3578754401,3578754412,11
2,1371,42723,3578754401,3578754413,12
2,1371,42724,3578754401,3578754414,13
2,1371,42725,3578754401,3578754414,13
2,1371,42726,3578754401,3578754414,13
2,1371,42727,3578754401,3578754415,14
2,1371,42728,3578754401,3578754416,15
2,1371,42729,3578754401,3578754417,16
2,1371,42730,3578754401,3578754418,17
2,1371,42731,3578754401,3578754419,18
2,1371,42732,3578754401,3578754419,18
2,1371,42733,3578754401,3578754421,20
2,1371,42734,3578754401,3578754424,23
2,1371,42735,3578754401,3578754424,23
2,1371,42736,3578754401,3578754425,24
2,1371,42737,3578754401,3578754427,26
2,1371,42738,3578754401,3578754428,27
2,1371,42739,3578754401,3578754428,27
2,1371,42740,3578754401,3578754429,28
2,1371,42741,3578754401,3578754429,28
2,1371,42742,3578754401,3578754431,30
2,1371,42743,3578754401,3578754432,31
2,1371,42744,3578754401,3578754432,31
2,1371,42745,3578754401,3578754433,32
2,1371,42746,3578754401,3578754434,33
2,1371,42747,3578754401,3578754434,33
2,1371,42748,3578754401,3578754435,34
2,1371,42749,3578754401,3578754436,35
2,1371,42750,3578754401,3578754437,36
2,1371,42751,3578754401,3578754437,36
2,1371,42752,3578754401,3578754438,37
2,1371,42753,3578754401,3578754438,37
2,1371,42754,3578754401,3578754438,37
2,1371,42755,3578754401,3578754439,38
2,1371,42756,3578754401,3578754439,38
2,1371,42757,3578754401,3578754440,39
2,1371,42758,3578754401,3578754441,40
2,1371,42759,3578754401,3578754442,41
2,1371,42760,3578754401,3578754442,41
2,1371,42761,3578754401,3578754442,41
2,1371,42762,3578754401,3578754443,42
2,1371,42763,3578754401,3578754445,44
2,1371,42764,3578754401,3578754446,45
2,1371,42765,3578754401,3578754447,46
2,1371,42766,3578754401,3578754448,47
2,1371,42767,3578754401,3578754448,47
2,1371,42768,3578754401,3578754451,50
2,1372,42769,3578754464,3578754464,0
2,1372,42770,3578754464,3578754464,0
2,1372,42771,3578754464,3578754464,0
2,1372,42772,3578754464,3578754464,0
2,1372,42773,3578754464,3578754464,0
2,1372,42774,3578754464,3578754464,0
2,1372,42775,3578754464,3578754464,0
2,1372,42776,3578754464,3578754464,0
2,1372,42777,3578754464,3578754464,0
2,1372,42778,3578754464,3578754464,0
2,1372,42779,3578754464,3578754464,0
2,1372,42780,3578754464,3578754464,0
2,1372,42781,3578754464,3578754464,0
2,1372,42782,3578754464,3578754464,0
2,1372,42783,3578754464,3578754464,0
2,1372,42784,3578754464,3578754465,1
2,1372,42785,3578754464,3578754465,1
2,1372,42786,3578754464,3578754468,4
2,1372,42787,3578754464,3578754468,4
2,1372,42788,3578754464,3578754469,5
2,1372,42789,3578754464,3578754470,6
2,1372,42790,3578754464,3578754477,13
2,1372,42791,3578754464,3578754480,16
2,1372,42792,3578754464,3578754481,17
2,1372,42793,3578754464,3578754481,17
2,1372,42794,3578754464,3578754483,19
2,1372,42795,3578754464,3578754483,19
2,1372,42796,3578754464,3578754484,20
2,1372,42797,3578754464,3578754484,20
2,1372,42798,3578754464,3578754486,22
2,1372,42799,3578754464,3578754488,24
2,1372,42800,3578754464,3578754488,24
2,1372,42801,3578754464,3578754488,24
2,1372,42802,3578754464,3578754490,26
2,1372,42803,3578754464,3578754490,26
2,1372,42804,3578754464,3578754491,27
2,1372,42805,3578754464,3578754492,28
2,1372,42806,3578754464,3578754493,29
2,1372,42807,3578754464,3578754494,30
2,1372,42808,3578754464,3578754494,30
2,1372,42809,3578754464,3578754494,30
2,1372,42810,3578754464,3578754495,31
2,1372,42811,3578754464,3578754496,32
2,1372,42812,3578754464,3578754497,33
2,1372,42813,3578754464,3578754497,33
2,1372,42814,3578754464,3578754498,34
2,1372,42815,3578754464,3578754498,34
2,1372,42816,3578754464,3578754499,35
2,1372,42817,3578754464,3578754501,37
2,1372,42818,3578754464,3578754502,38
2,1372,42819,3578754464,3578754502,38
2,1372,42820,3578754464,3578754503,39
2,1372,42821,3578754464,3578754504,40
2,1372,42822,3578754464,3578754504,40
2,1372,42823,3578754464,3578754504,40
2,1372,42824,3578754464,3578754505,41
2,1372,42825,3578754464,3578754506,42
2,1372,42826,3578754464,3578754508,44
2,1372,42827,3578754464,3578754509,45
2,1372,42828,3578754464,3578754510,46
2,1372,42829,3578754464,3578754511,47
2,1372,42830,3578754464,3578754511,47
2,1372,42831,3578754464,3578754511,47
2,1372,42832,3578754464,3578754512,48
2,1372,42833,3578754464,3578754512,48
2,1372,42834,3578754464,3578754513,49
2,1372,42835,3578754464,3578754513,49
2,1373,42836,3578754528,3578754528,0
2,1373,42837,3578754528,3578754528,0
2,1373,42838,3578754528,3578754528,0
2,1373,42839,3578754528,3578754528,0
2,1373,42840,3578754528,3578754528,0
2,1373,42841,3578754528,3578754528,0
2,1373,42842,3578754528,3578754528,0
2,1373,42843,3578754528,3578754528,0
2,1373,42844,3578754528,3578754528,0
2,1373,42845,3578754528,3578754528,0
2,1373,42846,3578754528,3578754528,0
2,1373,42847,3578754528,3578754528,0
2,1373,42848,3578754528,3578754528,0
2,1373,42849,3578754528,3578754528,0
2,1373,42850,3578754528,3578754528,0
2,1373,42851,3578754528,3578754528,0
2,1373,42852,3578754528,3578754528,0
2,1373,42853,3578754528,3578754528,0
2,1373,42854,3578754528,3578754528,0
2,1373,42855,3578754528,3578754528,0
2,1373,42856,3578754528,3578754528,0
2,1373,42857,3578754528,3578754528,0
2,1373,42858,3578754528,3578754528,0
2,1373,42859,3578754528,3578754528,0
2,1373,42860,3578754528,3578754528,0
2,1373,42861,3578754528,3578754528,0
2,1373,42862,3578754528,3578754528,0
2,1373,42863,3578754528,3578754528,0
2,1373,42864,3578754528,3578754529,1
2,1373,42865,3578754528,3578754531,3
2,1373,42866,3578754528,3578754532,4
2,1373,42867,3578754528,3578754532,4
2,1373,42868,3578754528,3578754534,6
2,1373,42869,3578754528,3578754535,7
2,1373,42870,3578754528,3578754535,7
2,1373,42871,3578754528,3578754535,7
2,1373,42872,3578754528,3578754536,8
2,1373,42873,3578754528,3578754537,9
2,1373,42874,3578754528,3578754537,9
2,1373,42875,3578754528,3578754537,9
2,1373,42876,3578754528,3578754537,9
2,1373,42877,3578754528,3578754538,10
2,1373,42878,3578754528,3578754539,11
2,1373,42879,3578754528,3578754539,11
2,1373,42880,3578754528,3578754541,13
2,1373,42881,3578754528,3578754543,15
2,1373,42882,3578754528,3578754544,16
2,1373,42883,3578754528,3578754545,17
2,1373,42884,3578754528,3578754545,17
2,1373,42885,3578754528,3578754548,20
2,1373,42886,3578754528,3578754549,21
2,1373,42887,3578754528,3578754549,21
2,1373,42888,3578754528,3578754549,21
2,1373,42889,3578754528,3578754550,22
2,1373,42890,3578754528,3578754551,23
2,1373,42891,3578754528,3578754552,24
2,1373,42892,3578754528,3578754553,25
2,1373,42893,3578754528,3578754553,25
2,1373,42894,3578754528,3578754553,25
2,1373,42895,3578754528,3578754554,26
2,1373,42896,3578754528,3578754554,26
2,1373,42897,3578754528,3578754554,26
2,1373,42898,3578754528,3578754555,27
2,1373,42899,3578754528,3578754555,27
2,1373,42900,3578754528,3578754556,28
2,1373,42901,3578754528,3578754557,29
2,1373,42902,3578754528,3578754557,29
2,1373,42903,3578754528,3578754558,30
2,1373,42904,3578754528,3578754561,33
2,1373,42905,3578754528,3578754562,34
2,1373,42906,3578754528,3578754565,37
2,1373,42907,3578754528,3578754566,38
2,1373,42908,3578754528,3578754567,39
2,1373,42909,3578754528,3578754568,40
2,1373,42910,3578754528,3578754569,41
2,1373,42911,3578754528,3578754570,42
2,1373,42912,3578754528,3578754570,42
2,1373,42913,3578754528,3578754571,43
2,1373,42914,3578754528,3578754572,44
2,1373,42915,3578754528,3578754573,45
2,1373,42916,3578754528,3578754573,45
2,1373,42917,3578754528,3578754574,46
2,1373,42918,3578754528,3578754574,46
2,1373,42919,3578754528,3578754574,46
2,1373,42920,3578754528,3578754575,47
2,1373,42921,3578754528,3578754575,47
2,1373,42922,3578754528,3578754576,48
2,1373,42923,3578754528,3578754577,49
2,1374,42924,3578754592,3578754592,0
2,1374,42925,3578754592,3578754592,0
2,1374,42926,3578754592,3578754592,0
2,1374,42927,3578754592,3578754592,0
2,1374,42928,3578754592,3578754592,0
2,1374,42929,3578754592,3578754592,0
2,1374,42930,3578754592,3578754592,0
2,1374,42931,3578754592,3578754592,0
2,1374,42932,3578754592,3578754592,0
2,1374,42933,3578754592,3578754592,0
2,1374,42934,3578754592,3578754592,0
2,1374,42935,3578754592,3578754592,0
2,1374,42936,3578754592,3578754593,1
2,1374,42937,3578754592,3578754593,1
2,1374,42938,3578754592,3578754593,1
2,1374,42939,3578754592,3578754593,1
2,1374,42940,3578754592,3578754593,1
2,1374,42941,3578754592,3578754594,2
2,1374,42942,3578754592,3578754596,4
2,1374,42943,3578754592,3578754598,6
2,1374,42944,3578754592,3578754599,7
2,1374,42945,3578754592,3578754600,8
2,1374,42946,3578754592,3578754600,8
2,1374,42947,3578754592,3578754601,9
2,1374,42948,3578754592,3578754604,12
2,1374,42949,3578754592,3578754604,12
2,1374,42950,3578754592,3578754605,13
2,1374,42951,3578754592,3578754605,13
2,1374,42952,3578754592,3578754605,13
2,1374,42953,3578754592,3578754606,14
2,1374,42954,3578754592,3578754607,15
2,1374,42955,3578754592,3578754611,19
2,1374,42956,3578754592,3578754612,20
2,1374,42957,3578754592,3578754613,21
2,1374,42958,3578754592,3578754613,21
2,1374,42959,3578754592,3578754614,22
2,1374,42960,3578754592,3578754615,23
2,1374,42961,3578754592,3578754616,24
2,1374,42962,3578754592,3578754616,24
2,1374,42963,3578754592,3578754619,27
2,1374,42964,3578754592,3578754619,27
2,1374,42965,3578754592,3578754621,29
2,1374,42966,3578754592,3578754622,30
2,1374,42967,3578754592,3578754623,31
2,1374,42968,3578754592,3578754624,32
2,1374,42969,3578754592,3578754626,34
2,1374,42970,3578754592,3578754627,35
2,1374,42971,3578754592,3578754628,36
2,1374,42972,3578754592,3578754628,36
2,1374,42973,3578754592,3578754628,36
2,1374,42974,3578754592,3578754628,36
2,1374,42975,3578754592,3578754629,37
2,1374,42976,3578754592,3578754631,39
2,1374,42977,3578754592,3578754632,40
2,1374,42978,3578754592,3578754632,40
2,1374,42979,3578754592,3578754633,41
2,1374,42980,3578754592,3578754635,43
2,1374,42981,3578754592,3578754636,44
2,1374,42982,3578754592,3578754636,44
2,1374,42983,3578754592,3578754636,44
2,1374,42984,3578754592,3578754637,45
2,1374,42985,3578754592,3578754637,45
2,1374,42986,3578754592,3578754638,46
2,1374,42987,3578754592,3578754638,46
2,1374,42988,3578754592,3578754638,46
2,1374,42989,3578754592,3578754640,48
2,1374,42990,3578754592,3578754641,49
2,1374,42991,3578754592,3578754641,49
2,1374,42992,3578754592,3578754642,50
2,1375,42993,3578754655,3578754655,0
2,1375,42994,3578754655,3578754655,0
2,1375,42995,3578754655,3578754655,0
2,1375,42996,3578754655,3578754655,0
2,1375,42997,3578754655,3578754655,0
2,1375,42998,3578754655,3578754655,0
2,1375,42999,3578754655,3578754655,0
2,1375,43000,3578754655,3578754655,0
2,1375,43001,3578754655,3578754655,0
2,1375,43002,3578754655,3578754655,0
2,1375,43003,3578754655,3578754655,0
2,1375,43004,3578754655,3578754655,0
2,1375,43005,3578754655,3578754656,1
2,1375,43006,3578754655,3578754657,2
2,1375,43007,3578754655,3578754657,2
2,1375,43008,3578754655,3578754657,2
2,1375,43009,3578754655,3578754657,2
2,1375,43010,3578754655,3578754658,3
2,1375,43011,3578754655,3578754658,3
2,1375,43012,3578754655,3578754659,4
2,1375,43013,3578754655,3578754660,5
2,1375,43014,3578754655,3578754664,9
2,1375,43015,3578754655,3578754665,10
2,1375,43016,3578754655,3578754667,12
2,1375,43017,3578754655,3578754667,12
2,1375,43018,3578754655,3578754668,13
2,1375,43019,3578754655,3578754669,14
2,1375,43020,3578754655,3578754676,21
2,1375,43021,3578754655,3578754678,23
2,1375,43022,3578754655,3578754680,25
2,1375,43023,3578754655,3578754680,25
2,1375,43024,3578754655,3578754681,26
2,1375,43025,3578754655,3578754683,28
2,1375,43026,3578754655,3578754684,29
2,1375,43027,3578754655,3578754684,29
2,1375,43028,3578754655,3578754684,29
2,1375,43029,3578754655,3578754686,31
2,1375,43030,3578754655,3578754687,32
2,1375,43031,3578754655,3578754688,33
2,1375,43032,3578754655,3578754688,33
2,1375,43033,3578754655,3578754691,36
2,1375,43034,3578754655,3578754691,36
2,1375,43035,3578754655,3578754691,36
2,1375,43036,3578754655,3578754692,37
2,1375,43037,3578754655,3578754693,38
2,1375,43038,3578754655,3578754694,39
2,1375,43039,3578754655,3578754694,39
2,1375,43040,3578754655,3578754694,39
2,1375,43041,3578754655,3578754695,40
2,1375,43042,3578754655,3578754697,42
2,1375,43043,3578754655,3578754697,42
2,1375,43044,3578754655,3578754698,43
2,1375,43045,3578754655,3578754698,43
2,1375,43046,3578754655,3578754698,43
2,1375,43047,3578754655,3578754699,44
2,1375,43048,3578754655,3578754701,46
2,1375,43049,3578754655,3578754702,47
2,1375,43050,3578754655,3578754702,47
2,1375,43051,3578754655,3578754703,48
2,1375,43052,3578754655,3578754704,49
2,1375,43053,3578754655,3578754704,49
2,1375,43054,3578754655,3578754704,49
2,1375,43055,3578754655,3578754704,49
2,1375,43056,3578754655,3578754705,50
2,1376,43057,3578754717,3578754717,0
2,1376,43058,3578754717,3578754717,0
2,1376,43059,3578754717,3578754717,0
2,1376,43060,3578754717,3578754717,0
2,1376,43061,3578754717,3578754717,0
2,1376,43062,3578754717,3578754717,0
2,1376,43063,3578754717,3578754717,0
2,1376,43064,3578754717,3578754717,0
2,1376,43065,3578754717,3578754717,0
2,1376,43066,3578754717,3578754717,0
2,1376,43067,3578754717,3578754717,0
2,1376,43068,3578754717,3578754717,0
2,1376,43069,3578754717,3578754717,0
2,1376,43070,3578754717,3578754717,0
2,1376,43071,3578754717,3578754717,0
2,1376,43072,3578754717,3578754717,0
2,1376,43073,3578754717,3578754717,0
2,1376,43074,3578754717,3578754717,0
2,1376,43075,3578754717,3578754717,0
2,1376,43076,3578754717,3578754717,0
2,1376,43077,3578754717,3578754717,0
2,1376,43078,3578754717,3578754718,1
2,1376,43079,3578754717,3578754719,2
2,1376,43080,3578754717,3578754720,3
2,1376,43081,3578754717,3578754721,4
2,1376,43082,3578754717,3578754722,5
2,1376,43083,3578754717,3578754722,5
2,1376,43084,3578754717,3578754722,5
2,1376,43085,3578754717,3578754722,5
2,1376,43086,3578754717,3578754722,5
2,1376,43087,3578754717,3578754723,6
2,1376,43088,3578754717,3578754723,6
2,1376,43089,3578754717,3578754724,7
2,1376,43090,3578754717,3578754724,7
2,1376,43091,3578754717,3578754726,9
2,1376,43092,3578754717,3578754727,10
2,1376,43093,3578754717,3578754727,10
2,1376,43094,3578754717,3578754728,11
2,1376,43095,3578754717,3578754729,12
2,1376,43096,3578754717,3578754732,15
2,1376,43097,3578754717,3578754732,15
2,1376,43098,3578754717,3578754733,16
2,1376,43099,3578754717,3578754734,17
2,1376,43100,3578754717,3578754735,18
2,1376,43101,3578754717,3578754735,18
2,1376,43102,3578754717,3578754736,19
2,1376,43103,3578754717,3578754736,19
2,1376,43104,3578754717,3578754737,20
2,1376,43105,3578754717,3578754737,20
2,1376,43106,3578754717,3578754737,20
2,1376,43107,3578754717,3578754738,21
2,1376,43108,3578754717,3578754738,21
2,1376,43109,3578754717,3578754739,22
2,1376,43110,3578754717,3578754739,22
2,1376,43111,3578754717,3578754739,22
2,1376,43112,3578754717,3578754740,23
2,1376,43113,3578754717,3578754743,26
2,1376,43114,3578754717,3578754744,27
2,1376,43115,3578754717,3578754745,28
2,1376,43116,3578754717,3578754745,28
2,1376,43117,3578754717,3578754749,32
2,1376,43118,3578754717,3578754749,32
2,1376,43119,3578754717,3578754749,32
2,1376,43120,3578754717,3578754750,33
2,1376,43121,3578754717,3578754751,34
2,1376,43122,3578754717,3578754752,35
2,1376,43123,3578754717,3578754753,36
2,1376,43124,3578754717,3578754754,37
2,1376,43125,3578754717,3578754754,37
2,1376,43126,3578754717,3578754754,37
2,1376,43127,3578754717,3578754755,38
2,1376,43128,3578754717,3578754755,38
2,1376,43129,3578754717,3578754755,38
2,1376,43130,3578754717,3578754757,40
2,1376,43131,3578754717,3578754757,40
2,1376,43132,3578754717,3578754757,40
2,1376,43133,3578754717,3578754758,41
2,1376,43134,3578754717,3578754761,44
2,1376,43135,3578754717,3578754764,47
2,1376,43136,3578754717,3578754765,48
2,1376,43137,3578754717,3578754765,48
2,1376,43138,3578754717,3578754766,49
2,1376,43139,3578754717,3578754767,50
2,1377,43140,3578754780,3578754780,0
2,1377,43141,3578754780,3578754780,0
2,1377,43142,3578754780,3578754780,0
2,1377,43143,3578754780,3578754780,0
2,1377,43144,3578754780,3578754780,0
2,1377,43145,3578754780,3578754780,0
2,1377,43146,3578754780,3578754780,0
2,1377,43147,3578754780,3578754780,0
2,1377,43148,3578754780,3578754780,0
2,1377,43149,3578754780,3578754780,0
2,1377,43150,3578754780,3578754780,0
2,1377,43151,3578754780,3578754780,0
2,1377,43152,3578754780,3578754780,0
2,1377,43153,3578754780,3578754780,0
2,1377,43154,3578754780,3578754780,0
2,1377,43155,3578754780,3578754782,2
2,1377,43156,3578754780,3578754783,3
2,1377,43157,3578754780,3578754785,5
2,1377,43158,3578754780,3578754785,5
2,1377,43159,3578754780,3578754788,8
2,1377,43160,3578754780,3578754788,8
2,1377,43161,3578754780,3578754789,9
2,1377,43162,3578754780,3578754790,10
2,1377,43163,3578754780,3578754790,10
2,1377,43164,3578754780,3578754791,11
2,1377,43165,3578754780,3578754791,11
2,1377,43166,3578754780,3578754793,13
2,1377,43167,3578754780,3578754793,13
2,1377,43168,3578754780,3578754793,13
2,1377,43169,3578754780,3578754793,13
2,1377,43170,3578754780,3578754794,14
2,1377,43171,3578754780,3578754795,15
2,1377,43172,3578754780,3578754797,17
2,1377,43173,3578754780,3578754798,18
2,1377,43174,3578754780,3578754798,18
2,1377,43175,3578754780,3578754800,20
2,1377,43176,3578754780,3578754800,20
2,1377,43177,3578754780,3578754800,20
2,1377,43178,3578754780,3578754804,24
2,1377,43179,3578754780,3578754804,24
2,1377,43180,3578754780,3578754805,25
2,1377,43181,3578754780,3578754805,25
2,1377,43182,3578754780,3578754806,26
2,1377,43183,3578754780,3578754807,27
2,1377,43184,3578754780,3578754811,31
2,1377,43185,3578754780,3578754812,32
2,1377,43186,3578754780,3578754813,33
2,1377,43187,3578754780,3578754813,33
2,1377,43188,3578754780,3578754814,34
2,1377,43189,3578754780,3578754815,35
2,1377,43190,3578754780,3578754815,35
2,1377,43191,3578754780,3578754816,36
2,1377,43192,3578754780,3578754818,38
2,1377,43193,3578754780,3578754818,38
2,1377,43194,3578754780,3578754821,41
2,1377,43195,3578754780,3578754823,43
2,1377,43196,3578754780,3578754823,43
2,1377,43197,3578754780,3578754826,46
2,1377,43198,3578754780,3578754828,48
2,1377,43199,3578754780,3578754828,48
2,1377,43200,3578754780,3578754828,48
2,1377,43201,3578754780,3578754829,49
2,1377,43202,3578754780,3578754829,49
2,1378,43203,3578754842,3578754843,1
2,1378,43204,3578754842,3578754843,1
2,1378,43205,3578754842,3578754843,1
2,1378,43206,3578754842,3578754843,1
2,1378,43207,3578754842,3578754843,1
2,1378,43208,3578754842,3578754843,1
2,1378,43209,3578754842,3578754843,1
2,1378,43210,3578754842,3578754843,1
2,1378,43211,3578754842,3578754843,1
2,1378,43212,3578754842,3578754843,1
2,1378,43213,3578754842,3578754843,1
2,1378,43214,3578754842,3578754843,1
2,1378,43215,3578754842,3578754843,1
2,1378,43216,3578754842,3578754843,1
2,1378,43217,3578754842,3578754843,1
2,1378,43218,3578754842,3578754843,1
2,1378,43219,3578754842,3578754844,2
2,1378,43220,3578754842,3578754845,3
2,1378,43221,3578754842,3578754846,4
2,1378,43222,3578754842,3578754846,4
2,1378,43223,3578754842,3578754850,8
2,1378,43224,3578754842,3578754850,8
2,1378,43225,3578754842,3578754852,10
2,1378,43226,3578754842,3578754852,10
2,1378,43227,3578754842,3578754853,11
2,1378,43228,3578754842,3578754854,12
2,1378,43229,3578754842,3578754854,12
2,1378,43230,3578754842,3578754854,12
2,1378,43231,3578754842,3578754855,13
2,1378,43232,3578754842,3578754856,14
2,1378,43233,3578754842,3578754856,14
2,1378,43234,3578754842,3578754857,15
2,1378,43235,3578754842,3578754857,15
2,1378,43236,3578754842,3578754858,16
2,1378,43237,3578754842,3578754859,17
2,1378,43238,3578754842,3578754859,17
2,1378,43239,3578754842,3578754860,18
2,1378,43240,3578754842,3578754861,19
2,1378,43241,3578754842,3578754865,23
2,1378,43242,3578754842,3578754865,23
2,1378,43243,3578754842,3578754868,26
2,1378,43244,3578754842,3578754868,26
2,1378,43245,3578754842,3578754868,26
2,1378,43246,3578754842,3578754870,28
2,1378,43247,3578754842,3578754877,35
2,1378,43248,3578754842,3578754880,38
2,1378,43249,3578754842,3578754880,38
2,1378,43250,3578754842,3578754881,39
2,1378,43251,3578754842,3578754883,41
2,1378,43252,3578754842,3578754884,42
2,1378,43253,3578754842,3578754884,42
2,1378,43254,3578754842,3578754884,42
2,1378,43255,3578754842,3578754886,44
2,1378,43256,3578754842,3578754888,46
2,1378,43257,3578754842,3578754888,46
2,1378,43258,3578754842,3578754888,46
2,1378,43259,3578754842,3578754890,48
2,1378,43260,3578754842,3578754891,49
2,1378,43261,3578754842,3578754891,49
2,1378,43262,3578754842,3578754892,50
2,1379,43263,3578754903,3578754904,1
2,1379,43264,3578754903,3578754904,1
2,1379,43265,3578754903,3578754904,1
2,1379,43266,3578754903,3578754904,1
2,1379,43267,3578754903,3578754904,1
2,1379,43268,3578754903,3578754904,1
2,1379,43269,3578754903,3578754904,1
2,1379,43270,3578754903,3578754904,1
2,1379,43271,3578754903,3578754904,1
2,1379,43272,3578754903,3578754904,1
2,1379,43273,3578754903,3578754904,1
2,1379,43274,3578754903,3578754904,1
2,1379,43275,3578754903,3578754904,1
2,1379,43276,3578754903,3578754904,1
2,1379,43277,3578754903,3578754904,1
2,1379,43278,3578754903,3578754904,1
2,1379,43279,3578754903,3578754904,1
2,1379,43280,3578754903,3578754904,1
2,1379,43281,3578754903,3578754905,2
2,1379,43282,3578754903,3578754907,4
2,1379,43283,3578754903,3578754908,5
2,1379,43284,3578754903,3578754909,6
2,1379,43285,3578754903,3578754911,8
2,1379,43286,3578754903,3578754911,8
2,1379,43287,3578754903,3578754912,9
2,1379,43288,3578754903,3578754912,9
2,1379,43289,3578754903,3578754913,10
2,1379,43290,3578754903,3578754913,10
2,1379,43291,3578754903,3578754915,12
2,1379,43292,3578754903,3578754915,12
2,1379,43293,3578754903,3578754915,12
2,1379,43294,3578754903,3578754916,13
2,1379,43295,3578754903,3578754916,13
2,1379,43296,3578754903,3578754916,13
2,1379,43297,3578754903,3578754916,13
2,1379,43298,3578754903,3578754916,13
2,1379,43299,3578754903,3578754916,13
2,1379,43300,3578754903,3578754916,13
2,1379,43301,3578754903,3578754917,14
2,1379,43302,3578754903,3578754917,14
2,1379,43303,3578754903,3578754917,14
2,1379,43304,3578754903,3578754919,16
2,1379,43305,3578754903,3578754919,16
2,1379,43306,3578754903,3578754920,17
2,1379,43307,3578754903,3578754921,18
2,1379,43308,3578754903,3578754922,19
2,1379,43309,3578754903,3578754922,19
2,1379,43310,3578754903,3578754922,19
2,1379,43311,3578754903,3578754922,19
2,1379,43312,3578754903,3578754922,19
2,1379,43313,3578754903,3578754923,20
2,1379,43314,3578754903,3578754923,20
2,1379,43315,3578754903,3578754924,21
2,1379,43316,3578754903,3578754926,23
2,1379,43317,3578754903,3578754926,23
2,1379,43318,3578754903,3578754927,24
2,1379,43319,3578754903,3578754927,24
2,1379,43320,3578754903,3578754927,24
2,1379,43321,3578754903,3578754931,28
2,1379,43322,3578754903,3578754932,29
2,1379,43323,3578754903,3578754933,30
2,1379,43324,3578754903,3578754934,31
2,1379,43325,3578754903,3578754934,31
2,1379,43326,3578754903,3578754935,32
2,1379,43327,3578754903,3578754935,32
2,1379,43328,3578754903,3578754936,33
2,1379,43329,3578754903,3578754937,34
2,1379,43330,3578754903,3578754937,34
2,1379,43331,3578754903,3578754937,34
2,1379,43332,3578754903,3578754938,35
2,1379,43333,3578754903,3578754938,35
2,1379,43334,3578754903,3578754938,35
2,1379,43335,3578754903,3578754939,36
2,1379,43336,3578754903,3578754939,36
2,1379,43337,3578754903,3578754940,37
2,1379,43338,3578754903,3578754943,40
2,1379,43339,3578754903,3578754944,41
2,1379,43340,3578754903,3578754945,42
2,1379,43341,3578754903,3578754945,42
2,1379,43342,3578754903,3578754948,45
2,1379,43343,3578754903,3578754950,47
2,1379,43344,3578754903,3578754950,47
2,1379,43345,3578754903,3578754950,47
2,1379,43346,3578754903,3578754951,48
2,1379,43347,3578754903,3578754951,48
2,1379,43348,3578754903,3578754951,48
2,1379,43349,3578754903,3578754953,50
2,1380,43350,3578754965,3578754965,0
2,1380,43351,3578754965,3578754965,0
2,1380,43352,3578754965,3578754965,0
2,1380,43353,3578754965,3578754965,0
2,1380,43354,3578754965,3578754965,0
2,1380,43355,3578754965,3578754965,0
2,1380,43356,3578754965,3578754965,0
2,1380,43357,3578754965,3578754965,0
2,1380,43358,3578754965,3578754965,0
2,1380,43359,3578754965,3578754965,0
2,1380,43360,3578754965,3578754965,0
2,1380,43361,3578754965,3578754965,0
2,1380,43362,3578754965,3578754965,0
2,1380,43363,3578754965,3578754965,0
2,1380,43364,3578754965,3578754965,0
2,1380,43365,3578754965,3578754966,1
2,1380,43366,3578754965,3578754968,3
2,1380,43367,3578754965,3578754970,5
2,1380,43368,3578754965,3578754970,5
2,1380,43369,3578754965,3578754971,6
2,1380,43370,3578754965,3578754973,8
2,1380,43371,3578754965,3578754973,8
2,1380,43372,3578754965,3578754973,8
2,1380,43373,3578754965,3578754974,9
2,1380,43374,3578754965,3578754974,9
2,1380,43375,3578754965,3578754975,10
2,1380,43376,3578754965,3578754975,10
2,1380,43377,3578754965,3578754975,10
2,1380,43378,3578754965,3578754976,11
2,1380,43379,3578754965,3578754977,12
2,1380,43380,3578754965,3578754978,13
2,1380,43381,3578754965,3578754979,14
2,1380,43382,3578754965,3578754982,17
2,1380,43383,3578754965,3578754983,18
2,1380,43384,3578754965,3578754984,19
2,1380,43385,3578754965,3578754985,20
2,1380,43386,3578754965,3578754988,23
2,1380,43387,3578754965,3578754989,24
2,1380,43388,3578754965,3578754990,25
2,1380,43389,3578754965,3578754990,25
2,1380,43390,3578754965,3578754992,27
2,1380,43391,3578754965,3578754993,28
2,1380,43392,3578754965,3578754993,28
2,1380,43393,3578754965,3578754993,28
2,1380,43394,3578754965,3578754993,28
2,1380,43395,3578754965,3578754994,29
2,1380,43396,3578754965,3578754994,29
2,1380,43397,3578754965,3578754997,32
2,1380,43398,3578754965,3578754998,33
2,1380,43399,3578754965,3578754999,34
2,1380,43400,3578754965,3578755000,35
2,1380,43401,3578754965,3578755001,36
2,1380,43402,3578754965,3578755004,39
2,1380,43403,3578754965,3578755004,39
2,1380,43404,3578754965,3578755005,40
2,1380,43405,3578754965,3578755005,40
2,1380,43406,3578754965,3578755005,40
2,1380,43407,3578754965,3578755006,41
2,1380,43408,3578754965,3578755011,46
2,1380,43409,3578754965,3578755013,48
2,1380,43410,3578754965,3578755013,48
2,1380,43411,3578754965,3578755013,48
2,1380,43412,3578754965,3578755014,49
2,1380,43413,3578754965,3578755015,50
2,1381,43414,3578755028,3578755028,0
2,1381,43415,3578755028,3578755028,0
2,1381,43416,3578755028,3578755028,0
2,1381,43417,3578755028,3578755028,0
2,1381,43418,3578755028,3578755028,0
2,1381,43419,3578755028,3578755028,0
2,1381,43420,3578755028,3578755028,0
2,1381,43421,3578755028,3578755028,0
2,1381,43422,3578755028,3578755028,0
2,1381,43423,3578755028,3578755028,0
2,1381,43424,3578755028,3578755028,0
2,1381,43425,3578755028,3578755028,0
2,1381,43426,3578755028,3578755029,1
2,1381,43427,3578755028,3578755030,2
2,1381,43428,3578755028,3578755030,2
2,1381,43429,3578755028,3578755031,3
2,1381,43430,3578755028,3578755032,4
2,1381,43431,3578755028,3578755033,5
2,1381,43432,3578755028,3578755033,5
2,1381,43433,3578755028,3578755033,5
2,1381,43434,3578755028,3578755035,7
2,1381,43435,3578755028,3578755036,8
2,1381,43436,3578755028,3578755037,9
2,1381,43437,3578755028,3578755037,9
2,1381,43438,3578755028,3578755037,9
2,1381,43439,3578755028,3578755038,10
2,1381,43440,3578755028,3578755038,10
2,1381,43441,3578755028,3578755038,10
2,1381,43442,3578755028,3578755039,11
2,1381,43443,3578755028,3578755041,13
2,1381,43444,3578755028,3578755042,14
2,1381,43445,3578755028,3578755042,14
2,1381,43446,3578755028,3578755042,14
2,1381,43447,3578755028,3578755042,14
2,1381,43448,3578755028,3578755044,16
2,1381,43449,3578755028,3578755045,17
2,1381,43450,3578755028,3578755046,18
2,1381,43451,3578755028,3578755046,18
2,1381,43452,3578755028,3578755050,22
2,1381,43453,3578755028,3578755050,22
2,1381,43454,3578755028,3578755052,24
2,1381,43455,3578755028,3578755052,24
2,1381,43456,3578755028,3578755053,25
2,1381,43457,3578755028,3578755054,26
2,1381,43458,3578755028,3578755054,26
2,1381,43459,3578755028,3578755055,27
2,1381,43460,3578755028,3578755055,27
2,1381,43461,3578755028,3578755056,28
2,1381,43462,3578755028,3578755057,29
2,1381,43463,3578755028,3578755057,29
2,1381,43464,3578755028,3578755058,30
2,1381,43465,3578755028,3578755058,30
2,1381,43466,3578755028,3578755059,31
2,1381,43467,3578755028,3578755059,31
2,1381,43468,3578755028,3578755060,32
2,1381,43469,3578755028,3578755060,32
2,1381,43470,3578755028,3578755061,33
2,1381,43471,3578755028,3578755065,37
2,1381,43472,3578755028,3578755065,37
2,1381,43473,3578755028,3578755067,39
2,1381,43474,3578755028,3578755068,40
2,1381,43475,3578755028,3578755077,49
2,1382,43476,3578755091,3578755091,0
2,1382,43477,3578755091,3578755091,0
2,1382,43478,3578755091,3578755091,0
2,1382,43479,3578755091,3578755091,0
2,1382,43480,3578755091,3578755091,0
2,1382,43481,3578755091,3578755091,0
2,1382,43482,3578755091,3578755091,0
2,1382,43483,3578755091,3578755091,0
2,1382,43484,3578755091,3578755091,0
2,1382,43485,3578755091,3578755091,0
2,1382,43486,3578755091,3578755091,0
2,1382,43487,3578755091,3578755091,0
2,1382,43488,3578755091,3578755091,0
2,1382,43489,3578755091,3578755091,0
2,1382,43490,3578755091,3578755091,0
2,1382,43491,3578755091,3578755091,0
2,1382,43492,3578755091,3578755091,0
2,1382,43493,3578755091,3578755092,1
2,1382,43494,3578755091,3578755094,3
2,1382,43495,3578755091,3578755094,3
2,1382,43496,3578755091,3578755095,4
2,1382,43497,3578755091,3578755095,4
2,1382,43498,3578755091,3578755096,5
2,1382,43499,3578755091,3578755097,6
2,1382,43500,3578755091,3578755098,7
2,1382,43501,3578755091,3578755098,7
2,1382,43502,3578755091,3578755099,8
2,1382,43503,3578755091,3578755102,11
2,1382,43504,3578755091,3578755103,12
2,1382,43505,3578755091,3578755103,12
2,1382,43506,3578755091,3578755103,12
2,1382,43507,3578755091,3578755104,13
2,1382,43508,3578755091,3578755104,13
2,1382,43509,3578755091,3578755104,13
2,1382,43510,3578755091,3578755105,14
2,1382,43511,3578755091,3578755106,15
2,1382,43512,3578755091,3578755108,17
2,1382,43513,3578755091,3578755109,18
2,1382,43514,3578755091,3578755110,19
2,1382,43515,3578755091,3578755111,20
2,1382,43516,3578755091,3578755112,21
2,1382,43517,3578755091,3578755112,21
2,1382,43518,3578755091,3578755112,21
2,1382,43519,3578755091,3578755113,22
2,1382,43520,3578755091,3578755115,24
2,1382,43521,3578755091,3578755115,24
2,1382,43522,3578755091,3578755116,25
2,1382,43523,3578755091,3578755116,25
2,1382,43524,3578755091,3578755116,25
2,1382,43525,3578755091,3578755116,25
2,1382,43526,3578755091,3578755116,25
2,1382,43527,3578755091,3578755117,26
2,1382,43528,3578755091,3578755117,26
2,1382,43529,3578755091,3578755117,26
2,1382,43530,3578755091,3578755117,26
2,1382,43531,3578755091,3578755118,27
2,1382,43532,3578755091,3578755119,28
2,1382,43533,3578755091,3578755119,28
2,1382,43534,3578755091,3578755121,30
2,1382,43535,3578755091,3578755122,31
2,1382,43536,3578755091,3578755122,31
2,1382,43537,3578755091,3578755122,31
2,1382,43538,3578755091,3578755122,31
2,1382,43539,3578755091,3578755122,31
2,1382,43540,3578755091,3578755123,32
2,1382,43541,3578755091,3578755123,32
2,1382,43542,3578755091,3578755123,32
2,1382,43543,3578755091,3578755125,34
2,1382,43544,3578755091,3578755125,34
2,1382,43545,3578755091,3578755126,35
2,1382,43546,3578755091,3578755127,36
2,1382,43547,3578755091,3578755127,36
2,1382,43548,3578755091,3578755128,37
2,1382,43549,3578755091,3578755130,39
2,1382,43550,3578755091,3578755133,42
2,1382,43551,3578755091,3578755133,42
2,1382,43552,3578755091,3578755134,43
2,1382,43553,3578755091,3578755135,44
2,1382,43554,3578755091,3578755135,44
2,1382,43555,3578755091,3578755136,45
2,1382,43556,3578755091,3578755137,46
2,1382,43557,3578755091,3578755137,46
2,1382,43558,3578755091,3578755138,47
2,1382,43559,3578755091,3578755138,47
2,1382,43560,3578755091,3578755138,47
2,1382,43561,3578755091,3578755139,48
2,1382,43562,3578755091,3578755139,48
2,1382,43563,3578755091,3578755139,48
2,1382,43564,3578755091,3578755139,48
2,1383,43565,3578755154,3578755154,0
2,1383,43566,3578755154,3578755154,0
2,1383,43567,3578755154,3578755154,0
2,1383,43568,3578755154,3578755154,0
2,1383,43569,3578755154,3578755154,0
2,1383,43570,3578755154,3578755154,0
2,1383,43571,3578755154,3578755154,0
2,1383,43572,3578755154,3578755154,0
2,1383,43573,3578755154,3578755154,0
2,1383,43574,3578755154,3578755154,0
2,1383,43575,3578755154,3578755154,0
2,1383,43576,3578755154,3578755154,0
2,1383,43577,3578755154,3578755154,0
2,1383,43578,3578755154,3578755154,0
2,1383,43579,3578755154,3578755154,0
2,1383,43580,3578755154,3578755154,0
2,1383,43581,3578755154,3578755155,1
2,1383,43582,3578755154,3578755155,1
2,1383,43583,3578755154,3578755156,2
2,1383,43584,3578755154,3578755157,3
2,1383,43585,3578755154,3578755157,3
2,1383,43586,3578755154,3578755157,3
2,1383,43587,3578755154,3578755158,4
2,1383,43588,3578755154,3578755162,8
2,1383,43589,3578755154,3578755165,11
2,1383,43590,3578755154,3578755165,11
2,1383,43591,3578755154,3578755167,13
2,1383,43592,3578755154,3578755168,14
2,1383,43593,3578755154,3578755168,14
2,1383,43594,3578755154,3578755169,15
2,1383,43595,3578755154,3578755169,15
2,1383,43596,3578755154,3578755170,16
2,1383,43597,3578755154,3578755173,19
2,1383,43598,3578755154,3578755173,19
2,1383,43599,3578755154,3578755174,20
2,1383,43600,3578755154,3578755174,20
2,1383,43601,3578755154,3578755174,20
2,1383,43602,3578755154,3578755175,21
2,1383,43603,3578755154,3578755175,21
2,1383,43604,3578755154,3578755176,22
2,1383,43605,3578755154,3578755176,22
2,1383,43606,3578755154,3578755177,23
2,1383,43607,3578755154,3578755179,25
2,1383,43608,3578755154,3578755180,26
2,1383,43609,3578755154,3578755182,28
2,1383,43610,3578755154,3578755183,29
2,1383,43611,3578755154,3578755185,31
2,1383,43612,3578755154,3578755185,31
2,1383,43613,3578755154,3578755188,34
2,1383,43614,3578755154,3578755189,35
2,1383,43615,3578755154,3578755189,35
2,1383,43616,3578755154,3578755191,37
2,1383,43617,3578755154,3578755191,37
2,1383,43618,3578755154,3578755191,37
2,1383,43619,3578755154,3578755193,39
2,1383,43620,3578755154,3578755193,39
2,1383,43621,3578755154,3578755194,40
2,1383,43622,3578755154,3578755194,40
2,1383,43623,3578755154,3578755194,40
2,1383,43624,3578755154,3578755194,40
2,1383,43625,3578755154,3578755197,43
2,1383,43626,3578755154,3578755198,44
2,1383,43627,3578755154,3578755200,46
2,1383,43628,3578755154,3578755200,46
2,1383,43629,3578755154,3578755201,47
2,1383,43630,3578755154,3578755204,50
2,1384,43631,3578755216,3578755216,0
2,1384,43632,3578755216,3578755216,0
2,1384,43633,3578755216,3578755216,0
2,1384,43634,3578755216,3578755216,0
2,1384,43635,3578755216,3578755216,0
2,1384,43636,3578755216,3578755216,0
2,1384,43637,3578755216,3578755216,0
2,1384,43638,3578755216,3578755216,0
2,1384,43639,3578755216,3578755216,0
2,1384,43640,3578755216,3578755216,0
2,1384,43641,3578755216,3578755216,0
2,1384,43642,3578755216,3578755216,0
2,1384,43643,3578755216,3578755216,0
2,1384,43644,3578755216,3578755216,0
2,1384,43645,3578755216,3578755216,0
2,1384,43646,3578755216,3578755217,1
2,1384,43647,3578755216,3578755219,3
2,1384,43648,3578755216,3578755219,3
2,1384,43649,3578755216,3578755221,5
2,1384,43650,3578755216,3578755224,8
2,1384,43651,3578755216,3578755224,8
2,1384,43652,3578755216,3578755225,9
2,1384,43653,3578755216,3578755227,11
2,1384,43654,3578755216,3578755227,11
2,1384,43655,3578755216,3578755228,12
2,1384,43656,3578755216,3578755228,12
2,1384,43657,3578755216,3578755229,13
2,1384,43658,3578755216,3578755229,13
2,1384,43659,3578755216,3578755230,14
2,1384,43660,3578755216,3578755231,15
2,1384,43661,3578755216,3578755231,15
2,1384,43662,3578755216,3578755232,16
2,1384,43663,3578755216,3578755232,16
2,1384,43664,3578755216,3578755233,17
2,1384,43665,3578755216,3578755233,17
2,1384,43666,3578755216,3578755236,20
2,1384,43667,3578755216,3578755236,20
2,1384,43668,3578755216,3578755236,20
2,1384,43669,3578755216,3578755237,21
2,1384,43670,3578755216,3578755237,21
2,1384,43671,3578755216,3578755238,22
2,1384,43672,3578755216,3578755239,23
2,1384,43673,3578755216,3578755239,23
2,1384,43674,3578755216,3578755239,23
2,1384,43675,3578755216,3578755241,25
2,1384,43676,3578755216,3578755242,26
2,1384,43677,3578755216,3578755242,26
2,1384,43678,3578755216,3578755244,28
2,1384,43679,3578755216,3578755245,29
2,1384,43680,3578755216,3578755246,30
2,1384,43681,3578755216,3578755246,30
2,1384,43682,3578755216,3578755249,33
2,1384,43683,3578755216,3578755249,33
2,1384,43684,3578755216,3578755251,35
2,1384,43685,3578755216,3578755252,36
2,1384,43686,3578755216,3578755253,37
2,1384,43687,3578755216,3578755254,38
2,1384,43688,3578755216,3578755254,38
2,1384,43689,3578755216,3578755255,39
2,1384,43690,3578755216,3578755255,39
2,1384,43691,3578755216,3578755255,39
2,1384,43692,3578755216,3578755256,40
2,1384,43693,3578755216,3578755256,40
2,1384,43694,3578755216,3578755257,41
2,1384,43695,3578755216,3578755258,42
2,1384,43696,3578755216,3578755258,42
2,1384,43697,3578755216,3578755259,43
2,1384,43698,3578755216,3578755259,43
2,1384,43699,3578755216,3578755259,43
2,1384,43700,3578755216,3578755261,45
2,1384,43701,3578755216,3578755261,45
2,1384,43702,3578755216,3578755264,48
2,1385,43703,3578755279,3578755279,0
2,1385,43704,3578755279,3578755279,0
2,1385,43705,3578755279,3578755279,0
2,1385,43706,3578755279,3578755279,0
2,1385,43707,3578755279,3578755279,0
2,1385,43708,3578755279,3578755279,0
2,1385,43709,3578755279,3578755280,1
2,1385,43710,3578755279,3578755281,2
2,1385,43711,3578755279,3578755281,2
2,1385,43712,3578755279,3578755281,2
2,1385,43713,3578755279,3578755283,4
2,1385,43714,3578755279,3578755283,4
2,1385,43715,3578755279,3578755284,5
2,1385,43716,3578755279,3578755284,5
2,1385,43717,3578755279,3578755284,5
2,1385,43718,3578755279,3578755286,7
2,1385,43719,3578755279,3578755287,8
2,1385,43720,3578755279,3578755288,9
2,1385,43721,3578755279,3578755289,10
2,1385,43722,3578755279,3578755290,11
2,1385,43723,3578755279,3578755290,11
2,1385,43724,3578755279,3578755292,13
2,1385,43725,3578755279,3578755292,13
2,1385,43726,3578755279,3578755293,14
2,1385,43727,3578755279,3578755294,15
2,1385,43728,3578755279,3578755295,16
2,1385,43729,3578755279,3578755295,16
2,1385,43730,3578755279,3578755296,17
2,1385,43731,3578755279,3578755297,18
2,1385,43732,3578755279,3578755297,18
2,1385,43733,3578755279,3578755298,19
2,1385,43734,3578755279,3578755298,19
2,1385,43735,3578755279,3578755299,20
2,1385,43736,3578755279,3578755299,20
2,1385,43737,3578755279,3578755302,23
2,1385,43738,3578755279,3578755303,24
2,1385,43739,3578755279,3578755303,24
2,1385,43740,3578755279,3578755304,25
2,1385,43741,3578755279,3578755304,25
2,1385,43742,3578755279,3578755304,25
2,1385,43743,3578755279,3578755304,25
2,1385,43744,3578755279,3578755305,26
2,1385,43745,3578755279,3578755307,28
2,1385,43746,3578755279,3578755308,29
2,1385,43747,3578755279,3578755309,30
2,1385,43748,3578755279,3578755311,32
2,1385,43749,3578755279,3578755311,32
2,1385,43750,3578755279,3578755312,33
2,1385,43751,3578755279,3578755312,33
2,1385,43752,3578755279,3578755313,34
2,1385,43753,3578755279,3578755313,34
2,1385,43754,3578755279,3578755315,36
2,1385,43755,3578755279,3578755315,36
2,1385,43756,3578755279,3578755315,36
2,1385,43757,3578755279,3578755316,37
2,1385,43758,3578755279,3578755316,37
2,1385,43759,3578755279,3578755316,37
2,1385,43760,3578755279,3578755316,37
2,1385,43761,3578755279,3578755316,37
2,1385,43762,3578755279,3578755317,38
2,1385,43763,3578755279,3578755318,39
2,1385,43764,3578755279,3578755318,39
2,1385,43765,3578755279,3578755319,40
2,1385,43766,3578755279,3578755321,42
2,1385,43767,3578755279,3578755321,42
2,1385,43768,3578755279,3578755322,43
2,1385,43769,3578755279,3578755322,43
2,1385,43770,3578755279,3578755322,43
2,1385,43771,3578755279,3578755322,43
2,1385,43772,3578755279,3578755323,44
2,1385,43773,3578755279,3578755323,44
2,1385,43774,3578755279,3578755323,44
2,1385,43775,3578755279,3578755324,45
2,1385,43776,3578755279,3578755325,46
2,1385,43777,3578755279,3578755326,47
2,1385,43778,3578755279,3578755327,48
2,1385,43779,3578755279,3578755327,48
2,1385,43780,3578755279,3578755328,49
2,1385,43781,3578755279,3578755329,50
2,1386,43782,3578755342,3578755342,0
2,1386,43783,3578755342,3578755342,0
2,1386,43784,3578755342,3578755342,0
2,1386,43785,3578755342,3578755342,0
2,1386,43786,3578755342,3578755342,0
2,1386,43787,3578755342,3578755342,0
2,1386,43788,3578755342,3578755342,0
2,1386,43789,3578755342,3578755342,0
2,1386,43790,3578755342,3578755342,0
2,1386,43791,3578755342,3578755342,0
2,1386,43792,3578755342,3578755342,0
2,1386,43793,3578755342,3578755342,0
2,1386,43794,3578755342,3578755342,0
2,1386,43795,3578755342,3578755342,0
2,1386,43796,3578755342,3578755342,0
2,1386,43797,3578755342,3578755342,0
2,1386,43798,3578755342,3578755343,1
2,1386,43799,3578755342,3578755343,1
2,1386,43800,3578755342,3578755344,2
2,1386,43801,3578755342,3578755345,3
2,1386,43802,3578755342,3578755345,3
2,1386,43803,3578755342,3578755349,7
2,1386,43804,3578755342,3578755350,8
2,1386,43805,3578755342,3578755350,8
2,1386,43806,3578755342,3578755350,8
2,1386,43807,3578755342,3578755350,8
2,1386,43808,3578755342,3578755351,9
2,1386,43809,3578755342,3578755352,10
2,1386,43810,3578755342,3578755353,11
2,1386,43811,3578755342,3578755354,12
2,1386,43812,3578755342,3578755354,12
2,1386,43813,3578755342,3578755354,12
2,1386,43814,3578755342,3578755354,12
2,1386,43815,3578755342,3578755355,13
2,1386,43816,3578755342,3578755356,14
2,1386,43817,3578755342,3578755357,15
2,1386,43818,3578755342,3578755358,16
2,1386,43819,3578755342,3578755358,16
2,1386,43820,3578755342,3578755362,20
2,1386,43821,3578755342,3578755364,22
2,1386,43822,3578755342,3578755366,24
2,1386,43823,3578755342,3578755367,25
2,1386,43824,3578755342,3578755368,26
2,1386,43825,3578755342,3578755368,26
2,1386,43826,3578755342,3578755369,27
2,1386,43827,3578755342,3578755370,28
2,1386,43828,3578755342,3578755370,28
2,1386,43829,3578755342,3578755372,30
2,1386,43830,3578755342,3578755373,31
2,1386,43831,3578755342,3578755373,31
2,1386,43832,3578755342,3578755374,32
2,1386,43833,3578755342,3578755374,32
2,1386,43834,3578755342,3578755375,33
2,1386,43835,3578755342,3578755375,33
2,1386,43836,3578755342,3578755376,34
2,1386,43837,3578755342,3578755376,34
2,1386,43838,3578755342,3578755377,35
2,1386,43839,3578755342,3578755378,36
2,1386,43840,3578755342,3578755379,37
2,1386,43841,3578755342,3578755380,38
2,1386,43842,3578755342,3578755384,42
2,1386,43843,3578755342,3578755385,43
2,1386,43844,3578755342,3578755385,43
2,1386,43845,3578755342,3578755389,47
2,1386,43846,3578755342,3578755389,47
2,1386,43847,3578755342,3578755390,48
2,1386,43848,3578755342,3578755391,49
2,1386,43849,3578755342,3578755392,50
2,1387,43850,3578755404,3578755404,0
2,1387,43851,3578755404,3578755404,0
2,1387,43852,3578755404,3578755404,0
2,1387,43853,3578755404,3578755404,0
2,1387,43854,3578755404,3578755404,0
2,1387,43855,3578755404,3578755404,0
2,1387,43856,3578755404,3578755404,0
2,1387,43857,3578755404,3578755404,0
2,1387,43858,3578755404,3578755404,0
2,1387,43859,3578755404,3578755404,0
2,1387,43860,3578755404,3578755404,0
2,1387,43861,3578755404,3578755404,0
2,1387,43862,3578755404,3578755404,0
2,1387,43863,3578755404,3578755404,0
2,1387,43864,3578755404,3578755405,1
2,1387,43865,3578755404,3578755405,1
2,1387,43866,3578755404,3578755405,1
2,1387,43867,3578755404,3578755405,1
2,1387,43868,3578755404,3578755407,3
2,1387,43869,3578755404,3578755407,3
2,1387,43870,3578755404,3578755411,7
2,1387,43871,3578755404,3578755414,10
2,1387,43872,3578755404,3578755414,10
2,1387,43873,3578755404,3578755415,11
2,1387,43874,3578755404,3578755415,11
2,1387,43875,3578755404,3578755416,12
2,1387,43876,3578755404,3578755416,12
2,1387,43877,3578755404,3578755417,13
2,1387,43878,3578755404,3578755419,15
2,1387,43879,3578755404,3578755420,16
2,1387,43880,3578755404,3578755421,17
2,1387,43881,3578755404,3578755424,20
2,1387,43882,3578755404,3578755424,20
2,1387,43883,3578755404,3578755425,21
2,1387,43884,3578755404,3578755425,21
2,1387,43885,3578755404,3578755427,23
2,1387,43886,3578755404,3578755428,24
2,1387,43887,3578755404,3578755428,24
2,1387,43888,3578755404,3578755428,24
2,1387,43889,3578755404,3578755429,25
2,1387,43890,3578755404,3578755430,26
2,1387,43891,3578755404,3578755431,27
2,1387,43892,3578755404,3578755432,28
2,1387,43893,3578755404,3578755433,29
2,1387,43894,3578755404,3578755433,29
2,1387,43895,3578755404,3578755433,29
2,1387,43896,3578755404,3578755434,30
2,1387,43897,3578755404,3578755435,31
2,1387,43898,3578755404,3578755436,32
2,1387,43899,3578755404,3578755437,33
2,1387,43900,3578755404,3578755437,33
2,1387,43901,3578755404,3578755438,34
2,1387,43902,3578755404,3578755438,34
2,1387,43903,3578755404,3578755439,35
2,1387,43904,3578755404,3578755440,36
2,1387,43905,3578755404,3578755441,37
2,1387,43906,3578755404,3578755442,38
2,1387,43907,3578755404,3578755442,38
2,1387,43908,3578755404,3578755442,38
2,1387,43909,3578755404,3578755445,41
2,1387,43910,3578755404,3578755445,41
2,1387,43911,3578755404,3578755446,42
2,1387,43912,3578755404,3578755448,44
2,1387,43913,3578755404,3578755449,45
2,1387,43914,3578755404,3578755449,45
2,1387,43915,3578755404,3578755451,47
2,1387,43916,3578755404,3578755452,48
2,1387,43917,3578755404,3578755452,48
2,1387,43918,3578755404,3578755453,49
2,1388,43919,3578755468,3578755468,0
2,1388,43920,3578755468,3578755468,0
2,1388,43921,3578755468,3578755468,0
2,1388,43922,3578755468,3578755468,0
2,1388,43923,3578755468,3578755468,0
2,1388,43924,3578755468,3578755468,0
2,1388,43925,3578755468,3578755468,0
2,1388,43926,3578755468,3578755468,0
2,1388,43927,3578755468,3578755468,0
2,1388,43928,3578755468,3578755468,0
2,1388,43929,3578755468,3578755468,0
2,1388,43930,3578755468,3578755468,0
2,1388,43931,3578755468,3578755468,0
2,1388,43932,3578755468,3578755468,0
2,1388,43933,3578755468,3578755468,0
2,1388,43934,3578755468,3578755468,0
2,1388,43935,3578755468,3578755468,0
2,1388,43936,3578755468,3578755468,0
2,1388,43937,3578755468,3578755470,2
2,1388,43938,3578755468,3578755477,9
2,1388,43939,3578755468,3578755481,13
2,1388,43940,3578755468,3578755481,13
2,1388,43941,3578755468,3578755481,13
2,1388,43942,3578755468,3578755481,13
2,1388,43943,3578755468,3578755483,15
2,1388,43944,3578755468,3578755484,16
2,1388,43945,3578755468,3578755484,16
2,1388,43946,3578755468,3578755484,16
2,1388,43947,3578755468,3578755486,18
2,1388,43948,3578755468,3578755488,20
2,1388,43949,3578755468,3578755488,20
2,1388,43950,3578755468,3578755489,21
2,1388,43951,3578755468,3578755491,23
2,1388,43952,3578755468,3578755491,23
2,1388,43953,3578755468,3578755493,25
2,1388,43954,3578755468,3578755494,26
2,1388,43955,3578755468,3578755495,27
2,1388,43956,3578755468,3578755496,28
2,1388,43957,3578755468,3578755497,29
2,1388,43958,3578755468,3578755497,29
2,1388,43959,3578755468,3578755497,29
2,1388,43960,3578755468,3578755499,31
2,1388,43961,3578755468,3578755499,31
2,1388,43962,3578755468,3578755500,32
2,1388,43963,3578755468,3578755502,34
2,1388,43964,3578755468,3578755503,35
2,1388,43965,3578755468,3578755503,35
2,1388,43966,3578755468,3578755503,35
2,1388,43967,3578755468,3578755504,36
2,1388,43968,3578755468,3578755504,36
2,1388,43969,3578755468,3578755504,36
2,1388,43970,3578755468,3578755504,36
2,1388,43971,3578755468,3578755505,37
2,1388,43972,3578755468,3578755507,39
2,1388,43973,3578755468,3578755508,40
2,1388,43974,3578755468,3578755509,41
2,1388,43975,3578755468,3578755510,42
2,1388,43976,3578755468,3578755511,43
2,1388,43977,3578755468,3578755512,44
2,1388,43978,3578755468,3578755512,44
2,1388,43979,3578755468,3578755513,45
2,1388,43980,3578755468,3578755514,46
2,1388,43981,3578755468,3578755515,47
2,1388,43982,3578755468,3578755515,47
2,1388,43983,3578755468,3578755516,48
2,1388,43984,3578755468,3578755516,48
2,1388,43985,3578755468,3578755516,48
2,1388,43986,3578755468,3578755516,48
2,1388,43987,3578755468,3578755516,48
2,1388,43988,3578755468,3578755517,49
2,1388,43989,3578755468,3578755517,49
2,1389,43990,3578755532,3578755532,0
2,1389,43991,3578755532,3578755532,0
2,1389,43992,3578755532,3578755532,0
2,1389,43993,3578755532,3578755532,0
2,1389,43994,3578755532,3578755532,0
2,1389,43995,3578755532,3578755532,0
2,1389,43996,3578755532,3578755532,0
2,1389,43997,3578755532,3578755532,0
2,1389,43998,3578755532,3578755532,0
2,1389,43999,3578755532,3578755532,0
2,1389,44000,3578755532,3578755532,0
2,1389,44001,3578755532,3578755532,0
2,1389,44002,3578755532,3578755532,0
2,1389,44003,3578755532,3578755532,0
2,1389,44004,3578755532,3578755532,0
2,1389,44005,3578755532,3578755532,0
2,1389,44006,3578755532,3578755532,0
2,1389,44007,3578755532,3578755533,1
2,1389,44008,3578755532,3578755534,2
2,1389,44009,3578755532,3578755534,2
2,1389,44010,3578755532,3578755535,3
2,1389,44011,3578755532,3578755535,3
2,1389,44012,3578755532,3578755536,4
2,1389,44013,3578755532,3578755536,4
2,1389,44014,3578755532,3578755537,5
2,1389,44015,3578755532,3578755537,5
2,1389,44016,3578755532,3578755538,6
2,1389,44017,3578755532,3578755538,6
2,1389,44018,3578755532,3578755539,7
2,1389,44019,3578755532,3578755539,7
2,1389,44020,3578755532,3578755540,8
2,1389,44021,3578755532,3578755542,10
2,1389,44022,3578755532,3578755543,11
2,1389,44023,3578755532,3578755544,12
2,1389,44024,3578755532,3578755544,12
2,1389,44025,3578755532,3578755544,12
2,1389,44026,3578755532,3578755548,16
2,1389,44027,3578755532,3578755549,17
2,1389,44028,3578755532,3578755549,17
2,1389,44029,3578755532,3578755549,17
2,1389,44030,3578755532,3578755550,18
2,1389,44031,3578755532,3578755550,18
2,1389,44032,3578755532,3578755551,19
2,1389,44033,3578755532,3578755553,21
2,1389,44034,3578755532,3578755553,21
2,1389,44035,3578755532,3578755553,21
2,1389,44036,3578755532,3578755554,22
2,1389,44037,3578755532,3578755554,22
2,1389,44038,3578755532,3578755555,23
2,1389,44039,3578755532,3578755556,24
2,1389,44040,3578755532,3578755556,24
2,1389,44041,3578755532,3578755557,25
2,1389,44042,3578755532,3578755561,29
2,1389,44043,3578755532,3578755564,32
2,1389,44044,3578755532,3578755565,33
2,1389,44045,3578755532,3578755565,33
2,1389,44046,3578755532,3578755566,34
2,1389,44047,3578755532,3578755567,35
2,1389,44048,3578755532,3578755568,36
2,1389,44049,3578755532,3578755569,37
2,1389,44050,3578755532,3578755570,38
2,1389,44051,3578755532,3578755570,38
2,1389,44052,3578755532,3578755571,39
2,1389,44053,3578755532,3578755572,40
2,1389,44054,3578755532,3578755572,40
2,1389,44055,3578755532,3578755572,40
2,1389,44056,3578755532,3578755573,41
2,1389,44057,3578755532,3578755573,41
2,1389,44058,3578755532,3578755574,42
2,1389,44059,3578755532,3578755575,43
2,1389,44060,3578755532,3578755575,43
2,1389,44061,3578755532,3578755575,43
2,1389,44062,3578755532,3578755577,45
2,1389,44063,3578755532,3578755577,45
2,1389,44064,3578755532,3578755579,47
2,1390,44065,3578755596,3578755596,0
2,1390,44066,3578755596,3578755596,0
2,1390,44067,3578755596,3578755596,0
2,1390,44068,3578755596,3578755596,0
2,1390,44069,3578755596,3578755596,0
2,1390,44070,3578755596,3578755597,1
2,1390,44071,3578755596,3578755597,1
2,1390,44072,3578755596,3578755597,1
2,1390,44073,3578755596,3578755597,1
2,1390,44074,3578755596,3578755597,1
2,1390,44075,3578755596,3578755597,1
2,1390,44076,3578755596,3578755597,1
2,1390,44077,3578755596,3578755597,1
2,1390,44078,3578755596,3578755597,1
2,1390,44079,3578755596,3578755597,1
2,1390,44080,3578755596,3578755597,1
2,1390,44081,3578755596,3578755597,1
2,1390,44082,3578755596,3578755598,2
2,1390,44083,3578755596,3578755599,3
2,1390,44084,3578755596,3578755601,5
2,1390,44085,3578755596,3578755601,5
2,1390,44086,3578755596,3578755603,7
2,1390,44087,3578755596,3578755603,7
2,1390,44088,3578755596,3578755603,7
2,1390,44089,3578755596,3578755603,7
2,1390,44090,3578755596,3578755604,8
2,1390,44091,3578755596,3578755606,10
2,1390,44092,3578755596,3578755606,10
2,1390,44093,3578755596,3578755610,14
2,1390,44094,3578755596,3578755612,16
2,1390,44095,3578755596,3578755614,18
2,1390,44096,3578755596,3578755614,18
2,1390,44097,3578755596,3578755615,19
2,1390,44098,3578755596,3578755616,20
2,1390,44099,3578755596,3578755616,20
2,1390,44100,3578755596,3578755616,20
2,1390,44101,3578755596,3578755618,22
2,1390,44102,3578755596,3578755619,23
2,1390,44103,3578755596,3578755620,24
2,1390,44104,3578755596,3578755623,27
2,1390,44105,3578755596,3578755623,27
2,1390,44106,3578755596,3578755624,28
2,1390,44107,3578755596,3578755624,28
2,1390,44108,3578755596,3578755626,30
2,1390,44109,3578755596,3578755627,31
2,1390,44110,3578755596,3578755628,32
2,1390,44111,3578755596,3578755628,32
2,1390,44112,3578755596,3578755628,32
2,1390,44113,3578755596,3578755629,33
2,1390,44114,3578755596,3578755631,35
2,1390,44115,3578755596,3578755632,36
2,1390,44116,3578755596,3578755632,36
2,1390,44117,3578755596,3578755633,37
2,1390,44118,3578755596,3578755635,39
2,1390,44119,3578755596,3578755635,39
2,1390,44120,3578755596,3578755636,40
2,1390,44121,3578755596,3578755636,40
2,1390,44122,3578755596,3578755636,40
2,1390,44123,3578755596,3578755637,41
2,1390,44124,3578755596,3578755638,42
2,1390,44125,3578755596,3578755638,42
2,1390,44126,3578755596,3578755639,43
2,1390,44127,3578755596,3578755640,44
2,1390,44128,3578755596,3578755641,45
2,1390,44129,3578755596,3578755641,45
2,1390,44130,3578755596,3578755641,45
2,1390,44131,3578755596,3578755642,46
2,1390,44132,3578755596,3578755644,48
2,1391,44133,3578755659,3578755659,0
2,1391,44134,3578755659,3578755659,0
2,1391,44135,3578755659,3578755659,0
2,1391,44136,3578755659,3578755659,0
2,1391,44137,3578755659,3578755659,0
2,1391,44138,3578755659,3578755659,0
2,1391,44139,3578755659,3578755659,0
2,1391,44140,3578755659,3578755659,0
2,1391,44141,3578755659,3578755659,0
2,1391,44142,3578755659,3578755659,0
2,1391,44143,3578755659,3578755659,0
2,1391,44144,3578755659,3578755659,0
2,1391,44145,3578755659,3578755659,0
2,1391,44146,3578755659,3578755659,0
2,1391,44147,3578755659,3578755659,0
2,1391,44148,3578755659,3578755659,0
2,1391,44149,3578755659,3578755659,0
2,1391,44150,3578755659,3578755659,0
2,1391,44151,3578755659,3578755659,0
2,1391,44152,3578755659,3578755659,0
2,1391,44153,3578755659,3578755661,2
2,1391,44154,3578755659,3578755664,5
2,1391,44155,3578755659,3578755665,6
2,1391,44156,3578755659,3578755665,6
2,1391,44157,3578755659,3578755667,8
2,1391,44158,3578755659,3578755667,8
2,1391,44159,3578755659,3578755668,9
2,1391,44160,3578755659,3578755670,11
2,1391,44161,3578755659,3578755677,18
2,1391,44162,3578755659,3578755678,19
2,1391,44163,3578755659,3578755680,21
2,1391,44164,3578755659,3578755681,22
2,1391,44165,3578755659,3578755681,22
2,1391,44166,3578755659,3578755681,22
2,1391,44167,3578755659,3578755683,24
2,1391,44168,3578755659,3578755683,24
2,1391,44169,3578755659,3578755683,24
2,1391,44170,3578755659,3578755684,25
2,1391,44171,3578755659,3578755684,25
2,1391,44172,3578755659,3578755686,27
2,1391,44173,3578755659,3578755688,29
2,1391,44174,3578755659,3578755689,30
2,1391,44175,3578755659,3578755689,30
2,1391,44176,3578755659,3578755690,31
2,1391,44177,3578755659,3578755691,32
2,1391,44178,3578755659,3578755692,33
2,1391,44179,3578755659,3578755693,34
2,1391,44180,3578755659,3578755694,35
2,1391,44181,3578755659,3578755695,36
2,1391,44182,3578755659,3578755696,37
2,1391,44183,3578755659,3578755696,37
2,1391,44184,3578755659,3578755697,38
2,1391,44185,3578755659,3578755697,38
2,1391,44186,3578755659,3578755698,39
2,1391,44187,3578755659,3578755698,39
2,1391,44188,3578755659,3578755698,39
2,1391,44189,3578755659,3578755699,40
2,1391,44190,3578755659,3578755702,43
2,1391,44191,3578755659,3578755703,44
2,1391,44192,3578755659,3578755703,44
2,1391,44193,3578755659,3578755703,44
2,1391,44194,3578755659,3578755703,44
2,1391,44195,3578755659,3578755704,45
2,1391,44196,3578755659,3578755704,45
2,1391,44197,3578755659,3578755705,46
2,1391,44198,3578755659,3578755707,48
2,1391,44199,3578755659,3578755708,49
2,1392,44200,3578755723,3578755723,0
2,1392,44201,3578755723,3578755723,0
2,1392,44202,3578755723,3578755723,0
2,1392,44203,3578755723,3578755723,0
2,1392,44204,3578755723,3578755723,0
2,1392,44205,3578755723,3578755723,0
2,1392,44206,3578755723,3578755724,1
2,1392,44207,3578755723,3578755724,1
2,1392,44208,3578755723,3578755724,1
2,1392,44209,3578755723,3578755724,1
2,1392,44210,3578755723,3578755724,1
2,1392,44211,3578755723,3578755724,1
2,1392,44212,3578755723,3578755724,1
2,1392,44213,3578755723,3578755724,1
2,1392,44214,3578755723,3578755724,1
2,1392,44215,3578755723,3578755724,1
2,1392,44216,3578755723,3578755724,1
2,1392,44217,3578755723,3578755724,1
2,1392,44218,3578755723,3578755724,1
2,1392,44219,3578755723,3578755724,1
2,1392,44220,3578755723,3578755724,1
2,1392,44221,3578755723,3578755724,1
2,1392,44222,3578755723,3578755724,1
2,1392,44223,3578755723,3578755724,1
2,1392,44224,3578755723,3578755724,1
2,1392,44225,3578755723,3578755724,1
2,1392,44226,3578755723,3578755724,1
2,1392,44227,3578755723,3578755724,1
2,1392,44228,3578755723,3578755724,1
2,1392,44229,3578755723,3578755725,2
2,1392,44230,3578755723,3578755726,3
2,1392,44231,3578755723,3578755726,3
2,1392,44232,3578755723,3578755727,4
2,1392,44233,3578755723,3578755728,5
2,1392,44234,3578755723,3578755729,6
2,1392,44235,3578755723,3578755730,7
2,1392,44236,3578755723,3578755733,10
2,1392,44237,3578755723,3578755733,10
2,1392,44238,3578755723,3578755733,10
2,1392,44239,3578755723,3578755735,12
2,1392,44240,3578755723,3578755735,12
2,1392,44241,3578755723,3578755735,12
2,1392,44242,3578755723,3578755735,12
2,1392,44243,3578755723,3578755735,12
2,1392,44244,3578755723,3578755736,13
2,1392,44245,3578755723,3578755737,14
2,1392,44246,3578755723,3578755737,14
2,1392,44247,3578755723,3578755737,14
2,1392,44248,3578755723,3578755738,15
2,1392,44249,3578755723,3578755739,16
2,1392,44250,3578755723,3578755739,16
2,1392,44251,3578755723,3578755739,16
2,1392,44252,3578755723,3578755740,17
2,1392,44253,3578755723,3578755742,19
2,1392,44254,3578755723,3578755743,20
2,1392,44255,3578755723,3578755744,21
2,1392,44256,3578755723,3578755745,22
2,1392,44257,3578755723,3578755748,25
2,1392,44258,3578755723,3578755749,26
2,1392,44259,3578755723,3578755749,26
2,1392,44260,3578755723,3578755749,26
2,1392,44261,3578755723,3578755750,27
2,1392,44262,3578755723,3578755750,27
2,1392,44263,3578755723,3578755751,28
2,1392,44264,3578755723,3578755752,29
2,1392,44265,3578755723,3578755753,30
2,1392,44266,3578755723,3578755753,30
2,1392,44267,3578755723,3578755754,31
2,1392,44268,3578755723,3578755754,31
2,1392,44269,3578755723,3578755754,31
2,1392,44270,3578755723,3578755755,32
2,1392,44271,3578755723,3578755755,32
2,1392,44272,3578755723,3578755756,33
2,1392,44273,3578755723,3578755758,35
2,1392,44274,3578755723,3578755761,38
2,1392,44275,3578755723,3578755763,40
2,1392,44276,3578755723,3578755765,42
2,1392,44277,3578755723,3578755765,42
2,1392,44278,3578755723,3578755766,43
2,1392,44279,3578755723,3578755766,43
2,1392,44280,3578755723,3578755767,44
2,1392,44281,3578755723,3578755768,45
2,1392,44282,3578755723,3578755769,46
2,1392,44283,3578755723,3578755769,46
2,1392,44284,3578755723,3578755771,48
2,1392,44285,3578755723,3578755771,48
2,1392,44286,3578755723,3578755772,49
2,1392,44287,3578755723,3578755772,49
2,1392,44288,3578755723,3578755773,50
2,1393,44289,3578755785,3578755785,0
2,1393,44290,3578755785,3578755785,0
2,1393,44291,3578755785,3578755785,0
2,1393,44292,3578755785,3578755785,0
2,1393,44293,3578755785,3578755785,0
2,1393,44294,3578755785,3578755785,0
2,1393,44295,3578755785,3578755785,0
2,1393,44296,3578755785,3578755786,1
2,1393,44297,3578755785,3578755786,1
2,1393,44298,3578755785,3578755786,1
2,1393,44299,3578755785,3578755786,1
2,1393,44300,3578755785,3578755790,5
2,1393,44301,3578755785,3578755790,5
2,1393,44302,3578755785,3578755790,5
2,1393,44303,3578755785,3578755791,6
2,1393,44304,3578755785,3578755792,7
2,1393,44305,3578755785,3578755792,7
2,1393,44306,3578755785,3578755793,8
2,1393,44307,3578755785,3578755793,8
2,1393,44308,3578755785,3578755794,9
2,1393,44309,3578755785,3578755794,9
2,1393,44310,3578755785,3578755797,12
2,1393,44311,3578755785,3578755798,13
2,1393,44312,3578755785,3578755798,13
2,1393,44313,3578755785,3578755799,14
2,1393,44314,3578755785,3578755801,16
2,1393,44315,3578755785,3578755801,16
2,1393,44316,3578755785,3578755804,19
2,1393,44317,3578755785,3578755804,19
2,1393,44318,3578755785,3578755804,19
2,1393,44319,3578755785,3578755804,19
2,1393,44320,3578755785,3578755804,19
2,1393,44321,3578755785,3578755804,19
2,1393,44322,3578755785,3578755806,21
2,1393,44323,3578755785,3578755806,21
2,1393,44324,3578755785,3578755811,26
2,1393,44325,3578755785,3578755813,28
2,1393,44326,3578755785,3578755813,28
2,1393,44327,3578755785,3578755814,29
2,1393,44328,3578755785,3578755815,30
2,1393,44329,3578755785,3578755816,31
2,1393,44330,3578755785,3578755816,31
2,1393,44331,3578755785,3578755816,31
2,1393,44332,3578755785,3578755818,33
2,1393,44333,3578755785,3578755819,34
2,1393,44334,3578755785,3578755820,35
2,1393,44335,3578755785,3578755823,38
2,1393,44336,3578755785,3578755824,39
2,1393,44337,3578755785,3578755824,39
2,1393,44338,3578755785,3578755826,41
2,1393,44339,3578755785,3578755827,42
2,1393,44340,3578755785,3578755827,42
2,1393,44341,3578755785,3578755828,43
2,1393,44342,3578755785,3578755829,44
2,1393,44343,3578755785,3578755829,44
2,1393,44344,3578755785,3578755832,47
2,1393,44345,3578755785,3578755832,47
2,1393,44346,3578755785,3578755832,47
2,1393,44347,3578755785,3578755833,48
2,1393,44348,3578755785,3578755835,50
2,1394,44349,3578755847,3578755847,0
2,1394,44350,3578755847,3578755847,0
2,1394,44351,3578755847,3578755847,0
2,1394,44352,3578755847,3578755847,0
2,1394,44353,3578755847,3578755847,0
2,1394,44354,3578755847,3578755847,0
2,1394,44355,3578755847,3578755847,0
2,1394,44356,3578755847,3578755847,0
2,1394,44357,3578755847,3578755847,0
2,1394,44358,3578755847,3578755847,0
2,1394,44359,3578755847,3578755847,0
2,1394,44360,3578755847,3578755847,0
2,1394,44361,3578755847,3578755847,0
2,1394,44362,3578755847,3578755847,0
2,1394,44363,3578755847,3578755847,0
2,1394,44364,3578755847,3578755847,0
2,1394,44365,3578755847,3578755850,3
2,1394,44366,3578755847,3578755852,5
2,1394,44367,3578755847,3578755852,5
2,1394,44368,3578755847,3578755853,6
2,1394,44369,3578755847,3578755854,7
2,1394,44370,3578755847,3578755854,7
2,1394,44371,3578755847,3578755855,8
2,1394,44372,3578755847,3578755855,8
2,1394,44373,3578755847,3578755855,8
2,1394,44374,3578755847,3578755857,10
2,1394,44375,3578755847,3578755857,10
2,1394,44376,3578755847,3578755857,10
2,1394,44377,3578755847,3578755857,10
2,1394,44378,3578755847,3578755858,11
2,1394,44379,3578755847,3578755859,12
2,1394,44380,3578755847,3578755860,13
2,1394,44381,3578755847,3578755861,14
2,1394,44382,3578755847,3578755864,17
2,1394,44383,3578755847,3578755866,19
2,1394,44384,3578755847,3578755866,19
2,1394,44385,3578755847,3578755867,20
2,1394,44386,3578755847,3578755868,21
2,1394,44387,3578755847,3578755869,22
2,1394,44388,3578755847,3578755877,30
2,1394,44389,3578755847,3578755878,31
2,1394,44390,3578755847,3578755881,34
2,1394,44391,3578755847,3578755881,34
2,1394,44392,3578755847,3578755882,35
2,1394,44393,3578755847,3578755883,36
2,1394,44394,3578755847,3578755884,37
2,1394,44395,3578755847,3578755884,37
2,1394,44396,3578755847,3578755884,37
2,1394,44397,3578755847,3578755887,40
2,1394,44398,3578755847,3578755887,40
2,1394,44399,3578755847,3578755889,42
2,1394,44400,3578755847,3578755889,42
2,1394,44401,3578755847,3578755891,44
2,1394,44402,3578755847,3578755891,44
2,1394,44403,3578755847,3578755892,45
2,1394,44404,3578755847,3578755893,46
2,1394,44405,3578755847,3578755895,48
2,1394,44406,3578755847,3578755895,48
2,1394,44407,3578755847,3578755896,49
2,1394,44408,3578755847,3578755897,50
2,1395,44409,3578755908,3578755908,0
2,1395,44410,3578755908,3578755908,0
2,1395,44411,3578755908,3578755908,0
2,1395,44412,3578755908,3578755908,0
2,1395,44413,3578755908,3578755908,0
2,1395,44414,3578755908,3578755908,0
2,1395,44415,3578755908,3578755908,0
2,1395,44416,3578755908,3578755908,0
2,1395,44417,3578755908,3578755908,0
2,1395,44418,3578755908,3578755908,0
2,1395,44419,3578755908,3578755908,0
2,1395,44420,3578755908,3578755908,0
2,1395,44421,3578755908,3578755908,0
2,1395,44422,3578755908,3578755908,0
2,1395,44423,3578755908,3578755908,0
2,1395,44424,3578755908,3578755908,0
2,1395,44425,3578755908,3578755909,1
2,1395,44426,3578755908,3578755911,3
2,1395,44427,3578755908,3578755912,4
2,1395,44428,3578755908,3578755912,4
2,1395,44429,3578755908,3578755913,5
2,1395,44430,3578755908,3578755914,6
2,1395,44431,3578755908,3578755915,7
2,1395,44432,3578755908,3578755915,7
2,1395,44433,3578755908,3578755916,8
2,1395,44434,3578755908,3578755916,8
2,1395,44435,3578755908,3578755916,8
2,1395,44436,3578755908,3578755916,8
2,1395,44437,3578755908,3578755916,8
2,1395,44438,3578755908,3578755917,9
2,1395,44439,3578755908,3578755918,10
2,1395,44440,3578755908,3578755918,10
2,1395,44441,3578755908,3578755918,10
2,1395,44442,3578755908,3578755918,10
2,1395,44443,3578755908,3578755918,10
2,1395,44444,3578755908,3578755919,11
2,1395,44445,3578755908,3578755920,12
2,1395,44446,3578755908,3578755921,13
2,1395,44447,3578755908,3578755921,13
2,1395,44448,3578755908,3578755922,14
2,1395,44449,3578755908,3578755922,14
2,1395,44450,3578755908,3578755922,14
2,1395,44451,3578755908,3578755923,15
2,1395,44452,3578755908,3578755923,15
2,1395,44453,3578755908,3578755923,15
2,1395,44454,3578755908,3578755924,16
2,1395,44455,3578755908,3578755925,17
2,1395,44456,3578755908,3578755926,18
2,1395,44457,3578755908,3578755927,19
2,1395,44458,3578755908,3578755927,19
2,1395,44459,3578755908,3578755928,20
2,1395,44460,3578755908,3578755929,21
2,1395,44461,3578755908,3578755931,23
2,1395,44462,3578755908,3578755933,25
2,1395,44463,3578755908,3578755933,25
2,1395,44464,3578755908,3578755933,25
2,1395,44465,3578755908,3578755934,26
2,1395,44466,3578755908,3578755935,27
2,1395,44467,3578755908,3578755935,27
2,1395,44468,3578755908,3578755936,28
2,1395,44469,3578755908,3578755936,28
2,1395,44470,3578755908,3578755937,29
2,1395,44471,3578755908,3578755937,29
2,1395,44472,3578755908,3578755937,29
2,1395,44473,3578755908,3578755938,30
2,1395,44474,3578755908,3578755938,30
2,1395,44475,3578755908,3578755939,31
2,1395,44476,3578755908,3578755940,32
2,1395,44477,3578755908,3578755940,32
2,1395,44478,3578755908,3578755941,33
2,1395,44479,3578755908,3578755944,36
2,1395,44480,3578755908,3578755945,37
2,1395,44481,3578755908,3578755948,40
2,1395,44482,3578755908,3578755949,41
2,1395,44483,3578755908,3578755950,42
2,1395,44484,3578755908,3578755950,42
2,1395,44485,3578755908,3578755950,42
2,1395,44486,3578755908,3578755950,42
2,1395,44487,3578755908,3578755952,44
2,1395,44488,3578755908,3578755953,45
2,1395,44489,3578755908,3578755953,45
2,1395,44490,3578755908,3578755953,45
2,1395,44491,3578755908,3578755955,47
2,1395,44492,3578755908,3578755955,47
2,1395,44493,3578755908,3578755955,47
2,1395,44494,3578755908,3578755955,47
2,1395,44495,3578755908,3578755956,48
2,1395,44496,3578755908,3578755956,48
2,1395,44497,3578755908,3578755957,49
2,1395,44498,3578755908,3578755957,49
2,1396,44499,3578755971,3578755971,0
2,1396,44500,3578755971,3578755971,0
2,1396,44501,3578755971,3578755971,0
2,1396,44502,3578755971,3578755971,0
2,1396,44503,3578755971,3578755971,0
2,1396,44504,3578755971,3578755971,0
2,1396,44505,3578755971,3578755971,0
2,1396,44506,3578755971,3578755971,0
2,1396,44507,3578755971,3578755971,0
2,1396,44508,3578755971,3578755972,1
2,1396,44509,3578755971,3578755972,1
2,1396,44510,3578755971,3578755972,1
2,1396,44511,3578755971,3578755973,2
2,1396,44512,3578755971,3578755973,2
2,1396,44513,3578755971,3578755974,3
2,1396,44514,3578755971,3578755975,4
2,1396,44515,3578755971,3578755976,5
2,1396,44516,3578755971,3578755976,5
2,1396,44517,3578755971,3578755977,6
2,1396,44518,3578755971,3578755978,7
2,1396,44519,3578755971,3578755978,7
2,1396,44520,3578755971,3578755980,9
2,1396,44521,3578755971,3578755982,11
2,1396,44522,3578755971,3578755985,14
2,1396,44523,3578755971,3578755985,14
2,1396,44524,3578755971,3578755989,18
2,1396,44525,3578755971,3578755990,19
2,1396,44526,3578755971,3578755990,19
2,1396,44527,3578755971,3578755991,20
2,1396,44528,3578755971,3578755991,20
2,1396,44529,3578755971,3578755992,21
2,1396,44530,3578755971,3578755993,22
2,1396,44531,3578755971,3578755993,22
2,1396,44532,3578755971,3578755994,23
2,1396,44533,3578755971,3578755994,23
2,1396,44534,3578755971,3578755994,23
2,1396,44535,3578755971,3578755997,26
2,1396,44536,3578755971,3578755998,27
2,1396,44537,3578755971,3578755999,28
2,1396,44538,3578755971,3578756000,29
2,1396,44539,3578755971,3578756001,30
2,1396,44540,3578755971,3578756001,30
2,1396,44541,3578755971,3578756003,32
2,1396,44542,3578755971,3578756004,33
2,1396,44543,3578755971,3578756004,33
2,1396,44544,3578755971,3578756004,33
2,1396,44545,3578755971,3578756004,33
2,1396,44546,3578755971,3578756004,33
2,1396,44547,3578755971,3578756006,35
2,1396,44548,3578755971,3578756007,36
2,1396,44549,3578755971,3578756013,42
2,1396,44550,3578755971,3578756013,42
2,1396,44551,3578755971,3578756014,43
2,1396,44552,3578755971,3578756015,44
2,1396,44553,3578755971,3578756015,44
2,1396,44554,3578755971,3578756016,45
2,1396,44555,3578755971,3578756019,48
2,1396,44556,3578755971,3578756019,48
2,1396,44557,3578755971,3578756020,49
2,1397,44558,3578756035,3578756035,0
2,1397,44559,3578756035,3578756035,0
2,1397,44560,3578756035,3578756035,0
2,1397,44561,3578756035,3578756035,0
2,1397,44562,3578756035,3578756035,0
2,1397,44563,3578756035,3578756035,0
2,1397,44564,3578756035,3578756035,0
2,1397,44565,3578756035,3578756035,0
2,1397,44566,3578756035,3578756035,0
2,1397,44567,3578756035,3578756035,0
2,1397,44568,3578756035,3578756035,0
2,1397,44569,3578756035,3578756035,0
2,1397,44570,3578756035,3578756035,0
2,1397,44571,3578756035,3578756035,0
2,1397,44572,3578756035,3578756035,0
2,1397,44573,3578756035,3578756036,1
2,1397,44574,3578756035,3578756036,1
2,1397,44575,3578756035,3578756037,2
2,1397,44576,3578756035,3578756037,2
2,1397,44577,3578756035,3578756038,3
2,1397,44578,3578756035,3578756038,3
2,1397,44579,3578756035,3578756040,5
2,1397,44580,3578756035,3578756040,5
2,1397,44581,3578756035,3578756041,6
2,1397,44582,3578756035,3578756041,6
2,1397,44583,3578756035,3578756041,6
2,1397,44584,3578756035,3578756042,7
2,1397,44585,3578756035,3578756042,7
2,1397,44586,3578756035,3578756046,11
2,1397,44587,3578756035,3578756046,11
2,1397,44588,3578756035,3578756046,11
2,1397,44589,3578756035,3578756047,12
2,1397,44590,3578756035,3578756050,15
2,1397,44591,3578756035,3578756052,17
2,1397,44592,3578756035,3578756052,17
2,1397,44593,3578756035,3578756053,18
2,1397,44594,3578756035,3578756054,19
2,1397,44595,3578756035,3578756054,19
2,1397,44596,3578756035,3578756054,19
2,1397,44597,3578756035,3578756055,20
2,1397,44598,3578756035,3578756055,20
2,1397,44599,3578756035,3578756057,22
2,1397,44600,3578756035,3578756057,22
2,1397,44601,3578756035,3578756057,22
2,1397,44602,3578756035,3578756057,22
2,1397,44603,3578756035,3578756058,23
2,1397,44604,3578756035,3578756059,24
2,1397,44605,3578756035,3578756060,25
2,1397,44606,3578756035,3578756061,26
2,1397,44607,3578756035,3578756065,30
2,1397,44608,3578756035,3578756065,30
2,1397,44609,3578756035,3578756067,32
2,1397,44610,3578756035,3578756067,32
2,1397,44611,3578756035,3578756068,33
2,1397,44612,3578756035,3578756070,35
2,1397,44613,3578756035,3578756077,42
2,1397,44614,3578756035,3578756081,46
2,1397,44615,3578756035,3578756081,46
2,1397,44616,3578756035,3578756082,47
2,1397,44617,3578756035,3578756084,49
2,1397,44618,3578756035,3578756084,49
2,1397,44619,3578756035,3578756084,49
2,1397,44620,3578756035,3578756084,49
2,1398,44621,3578756100,3578756100,0
2,1398,44622,3578756100,3578756100,0
2,1398,44623,3578756100,3578756100,0
2,1398,44624,3578756100,3578756100,0
2,1398,44625,3578756100,3578756100,0
2,1398,44626,3578756100,3578756100,0
2,1398,44627,3578756100,3578756100,0
2,1398,44628,3578756100,3578756100,0
2,1398,44629,3578756100,3578756100,0
2,1398,44630,3578756100,3578756100,0
2,1398,44631,3578756100,3578756100,0
2,1398,44632,3578756100,3578756100,0
2,1398,44633,3578756100,3578756100,0
2,1398,44634,3578756100,3578756100,0
2,1398,44635,3578756100,3578756100,0
2,1398,44636,3578756100,3578756100,0
2,1398,44637,3578756100,3578756100,0
2,1398,44638,3578756100,3578756101,1
2,1398,44639,3578756100,3578756102,2
2,1398,44640,3578756100,3578756103,3
2,1398,44641,3578756100,3578756103,3
2,1398,44642,3578756100,3578756104,4
2,1398,44643,3578756100,3578756104,4
2,1398,44644,3578756100,3578756104,4
2,1398,44645,3578756100,3578756105,5
2,1398,44646,3578756100,3578756105,5
2,1398,44647,3578756100,3578756107,7
2,1398,44648,3578756100,3578756108,8
2,1398,44649,3578756100,3578756109,9
2,1398,44650,3578756100,3578756111,11
2,1398,44651,3578756100,3578756111,11
2,1398,44652,3578756100,3578756112,12
2,1398,44653,3578756100,3578756112,12
2,1398,44654,3578756100,3578756114,14
2,1398,44655,3578756100,3578756116,16
2,1398,44656,3578756100,3578756116,16
2,1398,44657,3578756100,3578756116,16
2,1398,44658,3578756100,3578756116,16
2,1398,44659,3578756100,3578756117,17
2,1398,44660,3578756100,3578756117,17
2,1398,44661,3578756100,3578756117,17
2,1398,44662,3578756100,3578756117,17
2,1398,44663,3578756100,3578756118,18
2,1398,44664,3578756100,3578756118,18
2,1398,44665,3578756100,3578756118,18
2,1398,44666,3578756100,3578756118,18
2,1398,44667,3578756100,3578756120,20
2,1398,44668,3578756100,3578756120,20
2,1398,44669,3578756100,3578756121,21
2,1398,44670,3578756100,3578756121,21
2,1398,44671,3578756100,3578756122,22
2,1398,44672,3578756100,3578756122,22
2,1398,44673,3578756100,3578756122,22
2,1398,44674,3578756100,3578756123,23
2,1398,44675,3578756100,3578756123,23
2,1398,44676,3578756100,3578756124,24
2,1398,44677,3578756100,3578756124,24
2,1398,44678,3578756100,3578756126,26
2,1398,44679,3578756100,3578756127,27
2,1398,44680,3578756100,3578756127,27
2,1398,44681,3578756100,3578756129,29
2,1398,44682,3578756100,3578756129,29
2,1398,44683,3578756100,3578756131,31
2,1398,44684,3578756100,3578756132,32
2,1398,44685,3578756100,3578756133,33
2,1398,44686,3578756100,3578756133,33
2,1398,44687,3578756100,3578756135,35
2,1398,44688,3578756100,3578756135,35
2,1398,44689,3578756100,3578756135,35
2,1398,44690,3578756100,3578756135,35
2,1398,44691,3578756100,3578756137,37
2,1398,44692,3578756100,3578756137,37
2,1398,44693,3578756100,3578756138,38
2,1398,44694,3578756100,3578756138,38
2,1398,44695,3578756100,3578756138,38
2,1398,44696,3578756100,3578756138,38
2,1398,44697,3578756100,3578756139,39
2,1398,44698,3578756100,3578756139,39
2,1398,44699,3578756100,3578756140,40
2,1398,44700,3578756100,3578756142,42
2,1398,44701,3578756100,3578756143,43
2,1398,44702,3578756100,3578756144,44
2,1398,44703,3578756100,3578756145,45
2,1398,44704,3578756100,3578756148,48
2,1398,44705,3578756100,3578756149,49
2,1399,44706,3578756163,3578756163,0
2,1399,44707,3578756163,3578756163,0
2,1399,44708,3578756163,3578756163,0
2,1399,44709,3578756163,3578756163,0
2,1399,44710,3578756163,3578756163,0
2,1399,44711,3578756163,3578756163,0
2,1399,44712,3578756163,3578756164,1
2,1399,44713,3578756163,3578756164,1
2,1399,44714,3578756163,3578756164,1
2,1399,44715,3578756163,3578756164,1
2,1399,44716,3578756163,3578756164,1
2,1399,44717,3578756163,3578756164,1
2,1399,44718,3578756163,3578756164,1
2,1399,44719,3578756163,3578756164,1
2,1399,44720,3578756163,3578756164,1
2,1399,44721,3578756163,3578756164,1
2,1399,44722,3578756163,3578756164,1
2,1399,44723,3578756163,3578756164,1
2,1399,44724,3578756163,3578756164,1
2,1399,44725,3578756163,3578756166,3
2,1399,44726,3578756163,3578756166,3
2,1399,44727,3578756163,3578756167,4
2,1399,44728,3578756163,3578756168,5
2,1399,44729,3578756163,3578756168,5
2,1399,44730,3578756163,3578756169,6
2,1399,44731,3578756163,3578756170,7
2,1399,44732,3578756163,3578756171,8
2,1399,44733,3578756163,3578756172,9
2,1399,44734,3578756163,3578756172,9
2,1399,44735,3578756163,3578756172,9
2,1399,44736,3578756163,3578756173,10
2,1399,44737,3578756163,3578756173,10
2,1399,44738,3578756163,3578756174,11
2,1399,44739,3578756163,3578756174,11
2,1399,44740,3578756163,3578756176,13
2,1399,44741,3578756163,3578756177,14
2,1399,44742,3578756163,3578756178,15
2,1399,44743,3578756163,3578756178,15
2,1399,44744,3578756163,3578756183,20
2,1399,44745,3578756163,3578756185,22
2,1399,44746,3578756163,3578756185,22
2,1399,44747,3578756163,3578756189,26
2,1399,44748,3578756163,3578756190,27
2,1399,44749,3578756163,3578756190,27
2,1399,44750,3578756163,3578756191,28
2,1399,44751,3578756163,3578756192,29
2,1399,44752,3578756163,3578756192,29
2,1399,44753,3578756163,3578756192,29
2,1399,44754,3578756163,3578756193,30
2,1399,44755,3578756163,3578756194,31
2,1399,44756,3578756163,3578756194,31
2,1399,44757,3578756163,3578756194,31
2,1399,44758,3578756163,3578756197,34
2,1399,44759,3578756163,3578756198,35
2,1399,44760,3578756163,3578756199,36
2,1399,44761,3578756163,3578756200,37
2,1399,44762,3578756163,3578756201,38
2,1399,44763,3578756163,3578756203,40
2,1399,44764,3578756163,3578756203,40
2,1399,44765,3578756163,3578756203,40
2,1399,44766,3578756163,3578756204,41
2,1399,44767,3578756163,3578756204,41
2,1399,44768,3578756163,3578756205,42
2,1399,44769,3578756163,3578756206,43
2,1399,44770,3578756163,3578756207,44
2,1399,44771,3578756163,3578756213,50
2,1400,44772,3578756226,3578756226,0
2,1400,44773,3578756226,3578756226,0
2,1400,44774,3578756226,3578756226,0
2,1400,44775,3578756226,3578756226,0
2,1400,44776,3578756226,3578756226,0
2,1400,44777,3578756226,3578756226,0
2,1400,44778,3578756226,3578756226,0
2,1400,44779,3578756226,3578756226,0
2,1400,44780,3578756226,3578756226,0
2,1400,44781,3578756226,3578756226,0
2,1400,44782,3578756226,3578756226,0
2,1400,44783,3578756226,3578756226,0
2,1400,44784,3578756226,3578756226,0
2,1400,44785,3578756226,3578756227,1
2,1400,44786,3578756226,3578756227,1
2,1400,44787,3578756226,3578756228,2
2,1400,44788,3578756226,3578756229,3
2,1400,44789,3578756226,3578756229,3
2,1400,44790,3578756226,3578756229,3
2,1400,44791,3578756226,3578756231,5
2,1400,44792,3578756226,3578756231,5
2,1400,44793,3578756226,3578756232,6
2,1400,44794,3578756226,3578756232,6
2,1400,44795,3578756226,3578756233,7
2,1400,44796,3578756226,3578756233,7
2,1400,44797,3578756226,3578756235,9
2,1400,44798,3578756226,3578756236,10
2,1400,44799,3578756226,3578756238,12
2,1400,44800,3578756226,3578756238,12
2,1400,44801,3578756226,3578756238,12
2,1400,44802,3578756226,3578756238,12
2,1400,44803,3578756226,3578756239,13
2,1400,44804,3578756226,3578756240,14
2,1400,44805,3578756226,3578756240,14
2,1400,44806,3578756226,3578756241,15
2,1400,44807,3578756226,3578756241,15
2,1400,44808,3578756226,3578756242,16
2,1400,44809,3578756226,3578756242,16
2,1400,44810,3578756226,3578756243,17
2,1400,44811,3578756226,3578756246,20
2,1400,44812,3578756226,3578756246,20
2,1400,44813,3578756226,3578756248,22
2,1400,44814,3578756226,3578756250,24
2,1400,44815,3578756226,3578756251,25
2,1400,44816,3578756226,3578756252,26
2,1400,44817,3578756226,3578756253,27
2,1400,44818,3578756226,3578756254,28
2,1400,44819,3578756226,3578756255,29
2,1400,44820,3578756226,3578756255,29
2,1400,44821,3578756226,3578756255,29
2,1400,44822,3578756226,3578756255,29
2,1400,44823,3578756226,3578756255,29
2,1400,44824,3578756226,3578756256,30
2,1400,44825,3578756226,3578756257,31
2,1400,44826,3578756226,3578756257,31
2,1400,44827,3578756226,3578756258,32
2,1400,44828,3578756226,3578756259,33
2,1400,44829,3578756226,3578756261,35
2,1400,44830,3578756226,3578756261,35
2,1400,44831,3578756226,3578756265,39
2,1400,44832,3578756226,3578756265,39
2,1400,44833,3578756226,3578756267,41
2,1400,44834,3578756226,3578756268,42
2,1400,44835,3578756226,3578756269,43
2,1400,44836,3578756226,3578756271,45
2,1401,44837,3578756289,3578756289,0
2,1401,44838,3578756289,3578756289,0
2,1401,44839,3578756289,3578756289,0
2,1401,44840,3578756289,3578756289,0
2,1401,44841,3578756289,3578756289,0
2,1401,44842,3578756289,3578756289,0
2,1401,44843,3578756289,3578756289,0
2,1401,44844,3578756289,3578756289,0
2,1401,44845,3578756289,3578756289,0
2,1401,44846,3578756289,3578756289,0
2,1401,44847,3578756289,3578756289,0
2,1401,44848,3578756289,3578756289,0
2,1401,44849,3578756289,3578756289,0
2,1401,44850,3578756289,3578756291,2
2,1401,44851,3578756289,3578756292,3
2,1401,44852,3578756289,3578756293,4
2,1401,44853,3578756289,3578756294,5
2,1401,44854,3578756289,3578756294,5
2,1401,44855,3578756289,3578756295,6
2,1401,44856,3578756289,3578756297,8
2,1401,44857,3578756289,3578756297,8
2,1401,44858,3578756289,3578756298,9
2,1401,44859,3578756289,3578756298,9
2,1401,44860,3578756289,3578756298,9
2,1401,44861,3578756289,3578756299,10
2,1401,44862,3578756289,3578756299,10
2,1401,44863,3578756289,3578756301,12
2,1401,44864,3578756289,3578756302,13
2,1401,44865,3578756289,3578756303,14
2,1401,44866,3578756289,3578756303,14
2,1401,44867,3578756289,3578756304,15
2,1401,44868,3578756289,3578756304,15
2,1401,44869,3578756289,3578756305,16
2,1401,44870,3578756289,3578756305,16
2,1401,44871,3578756289,3578756305,16
2,1401,44872,3578756289,3578756307,18
2,1401,44873,3578756289,3578756308,19
2,1401,44874,3578756289,3578756309,20
2,1401,44875,3578756289,3578756311,22
2,1401,44876,3578756289,3578756311,22
2,1401,44877,3578756289,3578756312,23
2,1401,44878,3578756289,3578756312,23
2,1401,44879,3578756289,3578756313,24
2,1401,44880,3578756289,3578756314,25
2,1401,44881,3578756289,3578756316,27
2,1401,44882,3578756289,3578756316,27
2,1401,44883,3578756289,3578756316,27
2,1401,44884,3578756289,3578756316,27
2,1401,44885,3578756289,3578756316,27
2,1401,44886,3578756289,3578756317,28
2,1401,44887,3578756289,3578756317,28
2,1401,44888,3578756289,3578756317,28
2,1401,44889,3578756289,3578756317,28
2,1401,44890,3578756289,3578756317,28
2,1401,44891,3578756289,3578756318,29
2,1401,44892,3578756289,3578756318,29
2,1401,44893,3578756289,3578756319,30
2,1401,44894,3578756289,3578756320,31
2,1401,44895,3578756289,3578756321,32
2,1401,44896,3578756289,3578756321,32
2,1401,44897,3578756289,3578756322,33
2,1401,44898,3578756289,3578756322,33
2,1401,44899,3578756289,3578756323,34
2,1401,44900,3578756289,3578756323,34
2,1401,44901,3578756289,3578756324,35
2,1401,44902,3578756289,3578756325,36
2,1401,44903,3578756289,3578756325,36
2,1401,44904,3578756289,3578756326,37
2,1401,44905,3578756289,3578756327,38
2,1401,44906,3578756289,3578756329,40
2,1401,44907,3578756289,3578756329,40
2,1401,44908,3578756289,3578756332,43
2,1401,44909,3578756289,3578756333,44
2,1401,44910,3578756289,3578756333,44
2,1401,44911,3578756289,3578756333,44
2,1401,44912,3578756289,3578756335,46
2,1401,44913,3578756289,3578756335,46
2,1401,44914,3578756289,3578756336,47
2,1401,44915,3578756289,3578756338,49
2,1401,44916,3578756289,3578756338,49
2,1401,44917,3578756289,3578756338,49
2,1401,44918,3578756289,3578756339,50
2,1402,44919,3578756350,3578756350,0
2,1402,44920,3578756350,3578756350,0
2,1402,44921,3578756350,3578756350,0
2,1402,44922,3578756350,3578756350,0
2,1402,44923,3578756350,3578756350,0
2,1402,44924,3578756350,3578756350,0
2,1402,44925,3578756350,3578756350,0
2,1402,44926,3578756350,3578756350,0
2,1402,44927,3578756350,3578756350,0
2,1402,44928,3578756350,3578756350,0
2,1402,44929,3578756350,3578756350,0
2,1402,44930,3578756350,3578756350,0
2,1402,44931,3578756350,3578756351,1
2,1402,44932,3578756350,3578756351,1
2,1402,44933,3578756350,3578756353,3
2,1402,44934,3578756350,3578756353,3
2,1402,44935,3578756350,3578756354,4
2,1402,44936,3578756350,3578756354,4
2,1402,44937,3578756350,3578756355,5
2,1402,44938,3578756350,3578756356,6
2,1402,44939,3578756350,3578756357,7
2,1402,44940,3578756350,3578756357,7
2,1402,44941,3578756350,3578756357,7
2,1402,44942,3578756350,3578756358,8
2,1402,44943,3578756350,3578756358,8
2,1402,44944,3578756350,3578756362,12
2,1402,44945,3578756350,3578756363,13
2,1402,44946,3578756350,3578756366,16
2,1402,44947,3578756350,3578756366,16
2,1402,44948,3578756350,3578756367,17
2,1402,44949,3578756350,3578756367,17
2,1402,44950,3578756350,3578756368,18
2,1402,44951,3578756350,3578756369,19
2,1402,44952,3578756350,3578756370,20
2,1402,44953,3578756350,3578756370,20
2,1402,44954,3578756350,3578756371,21
2,1402,44955,3578756350,3578756372,22
2,1402,44956,3578756350,3578756373,23
2,1402,44957,3578756350,3578756373,23
2,1402,44958,3578756350,3578756374,24
2,1402,44959,3578756350,3578756374,24
2,1402,44960,3578756350,3578756375,25
2,1402,44961,3578756350,3578756376,26
2,1402,44962,3578756350,3578756376,26
2,1402,44963,3578756350,3578756377,27
2,1402,44964,3578756350,3578756380,30
2,1402,44965,3578756350,3578756383,33
2,1402,44966,3578756350,3578756385,35
2,1402,44967,3578756350,3578756386,36
2,1402,44968,3578756350,3578756389,39
2,1402,44969,3578756350,3578756390,40
2,1402,44970,3578756350,3578756391,41
2,1402,44971,3578756350,3578756391,41
2,1402,44972,3578756350,3578756391,41
2,1402,44973,3578756350,3578756392,42
2,1402,44974,3578756350,3578756392,42
2,1402,44975,3578756350,3578756394,44
2,1402,44976,3578756350,3578756394,44
2,1402,44977,3578756350,3578756394,44
2,1402,44978,3578756350,3578756394,44
2,1402,44979,3578756350,3578756397,47
2,1402,44980,3578756350,3578756398,48
2,1402,44981,3578756350,3578756399,49
2,1402,44982,3578756350,3578756399,49
2,1403,44983,3578756413,3578756413,0
2,1403,44984,3578756413,3578756413,0
2,1403,44985,3578756413,3578756413,0
2,1403,44986,3578756413,3578756413,0
2,1403,44987,3578756413,3578756413,0
2,1403,44988,3578756413,3578756413,0
2,1403,44989,3578756413,3578756413,0
2,1403,44990,3578756413,3578756413,0
2,1403,44991,3578756413,3578756413,0
2,1403,44992,3578756413,3578756413,0
2,1403,44993,3578756413,3578756414,1
2,1403,44994,3578756413,3578756414,1
2,1403,44995,3578756413,3578756416,3
2,1403,44996,3578756413,3578756417,4
2,1403,44997,3578756413,3578756417,4
2,1403,44998,3578756413,3578756418,5
2,1403,44999,3578756413,3578756420,7
2,1403,45000,3578756413,3578756421,8
2,1403,45001,3578756413,3578756424,11
2,1403,45002,3578756413,3578756424,11
2,1403,45003,3578756413,3578756424,11
2,1403,45004,3578756413,3578756425,12
2,1403,45005,3578756413,3578756427,14
2,1403,45006,3578756413,3578756427,14
2,1403,45007,3578756413,3578756428,15
2,1403,45008,3578756413,3578756428,15
2,1403,45009,3578756413,3578756429,16
2,1403,45010,3578756413,3578756430,17
2,1403,45011,3578756413,3578756430,17
2,1403,45012,3578756413,3578756431,18
2,1403,45013,3578756413,3578756432,19
2,1403,45014,3578756413,3578756432,19
2,1403,45015,3578756413,3578756433,20
2,1403,45016,3578756413,3578756434,21
2,1403,45017,3578756413,3578756436,23
2,1403,45018,3578756413,3578756436,23
2,1403,45019,3578756413,3578756438,25
2,1403,45020,3578756413,3578756438,25
2,1403,45021,3578756413,3578756438,25
2,1403,45022,3578756413,3578756439,26
2,1403,45023,3578756413,3578756439,26
2,1403,45024,3578756413,3578756439,26
2,1403,45025,3578756413,3578756440,27
2,1403,45026,3578756413,3578756441,28
2,1403,45027,3578756413,3578756441,28
2,1403,45028,3578756413,3578756442,29
2,1403,45029,3578756413,3578756442,29
2,1403,45030,3578756413,3578756442,29
2,1403,45031,3578756413,3578756446,33
2,1403,45032,3578756413,3578756447,34
2,1403,45033,3578756413,3578756447,34
2,1403,45034,3578756413,3578756448,35
2,1403,45035,3578756413,3578756448,35
2,1403,45036,3578756413,3578756450,37
2,1403,45037,3578756413,3578756451,38
2,1403,45038,3578756413,3578756452,39
2,1403,45039,3578756413,3578756453,40
2,1403,45040,3578756413,3578756455,42
2,1403,45041,3578756413,3578756455,42
2,1403,45042,3578756413,3578756455,42
2,1403,45043,3578756413,3578756455,42
2,1403,45044,3578756413,3578756455,42
2,1403,45045,3578756413,3578756455,42
2,1403,45046,3578756413,3578756457,44
2,1403,45047,3578756413,3578756457,44
2,1403,45048,3578756413,3578756457,44
2,1403,45049,3578756413,3578756458,45
2,1403,45050,3578756413,3578756458,45
2,1403,45051,3578756413,3578756460,47
2,1403,45052,3578756413,3578756460,47
2,1403,45053,3578756413,3578756461,48
2,1404,45054,3578756475,3578756475,0
2,1404,45055,3578756475,3578756475,0
2,1404,45056,3578756475,3578756476,1
2,1404,45057,3578756475,3578756476,1
2,1404,45058,3578756475,3578756476,1
2,1404,45059,3578756475,3578756476,1
2,1404,45060,3578756475,3578756476,1
2,1404,45061,3578756475,3578756476,1
2,1404,45062,3578756475,3578756479,4
2,1404,45063,3578756475,3578756481,6
2,1404,45064,3578756475,3578756482,7
2,1404,45065,3578756475,3578756482,7
2,1404,45066,3578756475,3578756484,9
2,1404,45067,3578756475,3578756484,9
2,1404,45068,3578756475,3578756484,9
2,1404,45069,3578756475,3578756484,9
2,1404,45070,3578756475,3578756488,13
2,1404,45071,3578756475,3578756488,13
2,1404,45072,3578756475,3578756488,13
2,1404,45073,3578756475,3578756489,14
2,1404,45074,3578756475,3578756489,14
2,1404,45075,3578756475,3578756491,16
2,1404,45076,3578756475,3578756492,17
2,1404,45077,3578756475,3578756492,17
2,1404,45078,3578756475,3578756493,18
2,1404,45079,3578756475,3578756494,19
2,1404,45080,3578756475,3578756494,19
2,1404,45081,3578756475,3578756495,20
2,1404,45082,3578756475,3578756497,22
2,1404,45083,3578756475,3578756498,23
2,1404,45084,3578756475,3578756498,23
2,1404,45085,3578756475,3578756498,23
2,1404,45086,3578756475,3578756499,24
2,1404,45087,3578756475,3578756499,24
2,1404,45088,3578756475,3578756501,26
2,1404,45089,3578756475,3578756502,27
2,1404,45090,3578756475,3578756503,28
2,1404,45091,3578756475,3578756503,28
2,1404,45092,3578756475,3578756504,29
2,1404,45093,3578756475,3578756505,30
2,1404,45094,3578756475,3578756505,30
2,1404,45095,3578756475,3578756505,30
2,1404,45096,3578756475,3578756506,31
2,1404,45097,3578756475,3578756508,33
2,1404,45098,3578756475,3578756509,34
2,1404,45099,3578756475,3578756511,36
2,1404,45100,3578756475,3578756511,36
2,1404,45101,3578756475,3578756512,37
2,1404,45102,3578756475,3578756512,37
2,1404,45103,3578756475,3578756513,38
2,1404,45104,3578756475,3578756514,39
2,1404,45105,3578756475,3578756515,40
2,1404,45106,3578756475,3578756516,41
2,1404,45107,3578756475,3578756516,41
2,1404,45108,3578756475,3578756516,41
2,1404,45109,3578756475,3578756517,42
2,1404,45110,3578756475,3578756517,42
2,1404,45111,3578756475,3578756518,43
2,1404,45112,3578756475,3578756518,43
2,1404,45113,3578756475,3578756518,43
2,1404,45114,3578756475,3578756518,43
2,1404,45115,3578756475,3578756519,44
2,1404,45116,3578756475,3578756519,44
2,1404,45117,3578756475,3578756520,45
2,1404,45118,3578756475,3578756521,46
2,1404,45119,3578756475,3578756521,46
2,1404,45120,3578756475,3578756522,47
2,1404,45121,3578756475,3578756522,47
2,1404,45122,3578756475,3578756523,48
2,1404,45123,3578756475,3578756523,48
2,1404,45124,3578756475,3578756524,49
2,1404,45125,3578756475,3578756525,50
2,1405,45126,3578756539,3578756539,0
2,1405,45127,3578756539,3578756539,0
2,1405,45128,3578756539,3578756539,0
2,1405,45129,3578756539,3578756539,0
2,1405,45130,3578756539,3578756539,0
2,1405,45131,3578756539,3578756539,0
2,1405,45132,3578756539,3578756539,0
2,1405,45133,3578756539,3578756539,0
2,1405,45134,3578756539,3578756539,0
2,1405,45135,3578756539,3578756539,0
2,1405,45136,3578756539,3578756539,0
2,1405,45137,3578756539,3578756539,0
2,1405,45138,3578756539,3578756539,0
2,1405,45139,3578756539,3578756539,0
2,1405,45140,3578756539,3578756539,0
2,1405,45141,3578756539,3578756539,0
2,1405,45142,3578756539,3578756539,0
2,1405,45143,3578756539,3578756539,0
2,1405,45144,3578756539,3578756539,0
2,1405,45145,3578756539,3578756539,0
2,1405,45146,3578756539,3578756539,0
2,1405,45147,3578756539,3578756539,0
2,1405,45148,3578756539,3578756542,3
2,1405,45149,3578756539,3578756542,3
2,1405,45150,3578756539,3578756543,4
2,1405,45151,3578756539,3578756544,5
2,1405,45152,3578756539,3578756545,6
2,1405,45153,3578756539,3578756548,9
2,1405,45154,3578756539,3578756549,10
2,1405,45155,3578756539,3578756549,10
2,1405,45156,3578756539,3578756550,11
2,1405,45157,3578756539,3578756550,11
2,1405,45158,3578756539,3578756552,13
2,1405,45159,3578756539,3578756553,14
2,1405,45160,3578756539,3578756553,14
2,1405,45161,3578756539,3578756553,14
2,1405,45162,3578756539,3578756553,14
2,1405,45163,3578756539,3578756555,16
2,1405,45164,3578756539,3578756556,17
2,1405,45165,3578756539,3578756556,17
2,1405,45166,3578756539,3578756557,18
2,1405,45167,3578756539,3578756557,18
2,1405,45168,3578756539,3578756557,18
2,1405,45169,3578756539,3578756562,23
2,1405,45170,3578756539,3578756563,24
2,1405,45171,3578756539,3578756564,25
2,1405,45172,3578756539,3578756565,26
2,1405,45173,3578756539,3578756565,26
2,1405,45174,3578756539,3578756566,27
2,1405,45175,3578756539,3578756567,28
2,1405,45176,3578756539,3578756568,29
2,1405,45177,3578756539,3578756569,30
2,1405,45178,3578756539,3578756569,30
2,1405,45179,3578756539,3578756571,32
2,1405,45180,3578756539,3578756571,32
2,1405,45181,3578756539,3578756571,32
2,1405,45182,3578756539,3578756573,34
2,1405,45183,3578756539,3578756574,35
2,1405,45184,3578756539,3578756575,36
2,1405,45185,3578756539,3578756575,36
2,1405,45186,3578756539,3578756575,36
2,1405,45187,3578756539,3578756576,37
2,1405,45188,3578756539,3578756578,39
2,1405,45189,3578756539,3578756579,40
2,1405,45190,3578756539,3578756582,43
2,1405,45191,3578756539,3578756584,45
2,1405,45192,3578756539,3578756585,46
2,1405,45193,3578756539,3578756588,49
2,1405,45194,3578756539,3578756589,50
2,1406,45195,3578756601,3578756601,0
2,1406,45196,3578756601,3578756601,0
2,1406,45197,3578756601,3578756601,0
2,1406,45198,3578756601,3578756601,0
2,1406,45199,3578756601,3578756601,0
2,1406,45200,3578756601,3578756601,0
2,1406,45201,3578756601,3578756601,0
2,1406,45202,3578756601,3578756601,0
2,1406,45203,3578756601,3578756601,0
2,1406,45204,3578756601,3578756601,0
2,1406,45205,3578756601,3578756601,0
2,1406,45206,3578756601,3578756601,0
2,1406,45207,3578756601,3578756602,1
2,1406,45208,3578756601,3578756603,2
2,1406,45209,3578756601,3578756603,2
2,1406,45210,3578756601,3578756603,2
2,1406,45211,3578756601,3578756604,3
2,1406,45212,3578756601,3578756605,4
2,1406,45213,3578756601,3578756606,5
2,1406,45214,3578756601,3578756607,6
2,1406,45215,3578756601,3578756610,9
2,1406,45216,3578756601,3578756613,12
2,1406,45217,3578756601,3578756613,12
2,1406,45218,3578756601,3578756615,14
2,1406,45219,3578756601,3578756615,14
2,1406,45220,3578756601,3578756616,15
2,1406,45221,3578756601,3578756617,16
2,1406,45222,3578756601,3578756617,16
2,1406,45223,3578756601,3578756619,18
2,1406,45224,3578756601,3578756621,20
2,1406,45225,3578756601,3578756623,22
2,1406,45226,3578756601,3578756623,22
2,1406,45227,3578756601,3578756623,22
2,1406,45228,3578756601,3578756623,22
2,1406,45229,3578756601,3578756626,25
2,1406,45230,3578756601,3578756627,26
2,1406,45231,3578756601,3578756627,26
2,1406,45232,3578756601,3578756628,27
2,1406,45233,3578756601,3578756628,27
2,1406,45234,3578756601,3578756628,27
2,1406,45235,3578756601,3578756631,30
2,1406,45236,3578756601,3578756631,30
2,1406,45237,3578756601,3578756631,30
2,1406,45238,3578756601,3578756632,31
2,1406,45239,3578756601,3578756632,31
2,1406,45240,3578756601,3578756633,32
2,1406,45241,3578756601,3578756635,34
2,1406,45242,3578756601,3578756636,35
2,1406,45243,3578756601,3578756637,36
2,1406,45244,3578756601,3578756637,36
2,1406,45245,3578756601,3578756638,37
2,1406,45246,3578756601,3578756638,37
2,1406,45247,3578756601,3578756638,37
2,1406,45248,3578756601,3578756638,37
2,1406,45249,3578756601,3578756639,38
2,1406,45250,3578756601,3578756640,39
2,1406,45251,3578756601,3578756640,39
2,1406,45252,3578756601,3578756640,39
2,1406,45253,3578756601,3578756640,39
2,1406,45254,3578756601,3578756641,40
2,1406,45255,3578756601,3578756641,40
2,1406,45256,3578756601,3578756645,44
2,1406,45257,3578756601,3578756647,46
2,1406,45258,3578756601,3578756647,46
2,1406,45259,3578756601,3578756647,46
2,1406,45260,3578756601,3578756647,46
2,1406,45261,3578756601,3578756650,49
2,1406,45262,3578756601,3578756650,49
2,1406,45263,3578756601,3578756651,50
2,1407,45264,3578756663,3578756663,0
2,1407,45265,3578756663,3578756663,0
2,1407,45266,3578756663,3578756663,0
2,1407,45267,3578756663,3578756663,0
2,1407,45268,3578756663,3578756663,0
2,1407,45269,3578756663,3578756663,0
2,1407,45270,3578756663,3578756663,0
2,1407,45271,3578756663,3578756663,0
2,1407,45272,3578756663,3578756663,0
2,1407,45273,3578756663,3578756663,0
2,1407,45274,3578756663,3578756663,0
2,1407,45275,3578756663,3578756663,0
2,1407,45276,3578756663,3578756663,0
2,1407,45277,3578756663,3578756663,0
2,1407,45278,3578756663,3578756663,0
2,1407,45279,3578756663,3578756664,1
2,1407,45280,3578756663,3578756666,3
2,1407,45281,3578756663,3578756666,3
2,1407,45282,3578756663,3578756666,3
2,1407,45283,3578756663,3578756667,4
2,1407,45284,3578756663,3578756668,5
2,1407,45285,3578756663,3578756669,6
2,1407,45286,3578756663,3578756676,13
2,1407,45287,3578756663,3578756681,18
2,1407,45288,3578756663,3578756682,19
2,1407,45289,3578756663,3578756682,19
2,1407,45290,3578756663,3578756683,20
2,1407,45291,3578756663,3578756684,21
2,1407,45292,3578756663,3578756684,21
2,1407,45293,3578756663,3578756685,22
2,1407,45294,3578756663,3578756687,24
2,1407,45295,3578756663,3578756688,25
2,1407,45296,3578756663,3578756688,25
2,1407,45297,3578756663,3578756689,26
2,1407,45298,3578756663,3578756690,27
2,1407,45299,3578756663,3578756691,28
2,1407,45300,3578756663,3578756693,30
2,1407,45301,3578756663,3578756693,30
2,1407,45302,3578756663,3578756694,31
2,1407,45303,3578756663,3578756694,31
2,1407,45304,3578756663,3578756698,35
2,1407,45305,3578756663,3578756698,35
2,1407,45306,3578756663,3578756698,35
2,1407,45307,3578756663,3578756698,35
2,1407,45308,3578756663,3578756699,36
2,1407,45309,3578756663,3578756699,36
2,1407,45310,3578756663,3578756700,37
2,1407,45311,3578756663,3578756700,37
2,1407,45312,3578756663,3578756701,38
2,1407,45313,3578756663,3578756703,40
2,1407,45314,3578756663,3578756703,40
2,1407,45315,3578756663,3578756704,41
2,1407,45316,3578756663,3578756705,42
2,1407,45317,3578756663,3578756705,42
2,1407,45318,3578756663,3578756705,42
2,1407,45319,3578756663,3578756705,42
2,1407,45320,3578756663,3578756706,43
2,1407,45321,3578756663,3578756708,45
2,1407,45322,3578756663,3578756709,46
2,1407,45323,3578756663,3578756711,48
2,1407,45324,3578756663,3578756712,49
2,1407,45325,3578756663,3578756712,49
2,1407,45326,3578756663,3578756712,49
2,1408,45327,3578756726,3578756726,0
2,1408,45328,3578756726,3578756726,0
2,1408,45329,3578756726,3578756726,0
2,1408,45330,3578756726,3578756726,0
2,1408,45331,3578756726,3578756726,0
2,1408,45332,3578756726,3578756726,0
2,1408,45333,3578756726,3578756726,0
2,1408,45334,3578756726,3578756726,0
2,1408,45335,3578756726,3578756726,0
2,1408,45336,3578756726,3578756726,0
2,1408,45337,3578756726,3578756726,0
2,1408,45338,3578756726,3578756726,0
2,1408,45339,3578756726,3578756726,0
2,1408,45340,3578756726,3578756726,0
2,1408,45341,3578756726,3578756726,0
2,1408,45342,3578756726,3578756726,0
2,1408,45343,3578756726,3578756726,0
2,1408,45344,3578756726,3578756726,0
2,1408,45345,3578756726,3578756726,0
2,1408,45346,3578756726,3578756726,0
2,1408,45347,3578756726,3578756726,0
2,1408,45348,3578756726,3578756726,0
2,1408,45349,3578756726,3578756726,0
2,1408,45350,3578756726,3578756726,0
2,1408,45351,3578756726,3578756726,0
2,1408,45352,3578756726,3578756727,1
2,1408,45353,3578756726,3578756727,1
2,1408,45354,3578756726,3578756728,2
2,1408,45355,3578756726,3578756728,2
2,1408,45356,3578756726,3578756731,5
2,1408,45357,3578756726,3578756732,6
2,1408,45358,3578756726,3578756733,7
2,1408,45359,3578756726,3578756733,7
2,1408,45360,3578756726,3578756734,8
2,1408,45361,3578756726,3578756735,9
2,1408,45362,3578756726,3578756736,10
2,1408,45363,3578756726,3578756736,10
2,1408,45364,3578756726,3578756737,11
2,1408,45365,3578756726,3578756737,11
2,1408,45366,3578756726,3578756737,11
2,1408,45367,3578756726,3578756738,12
2,1408,45368,3578756726,3578756738,12
2,1408,45369,3578756726,3578756738,12
2,1408,45370,3578756726,3578756739,13
2,1408,45371,3578756726,3578756740,14
2,1408,45372,3578756726,3578756740,14
2,1408,45373,3578756726,3578756741,15
2,1408,45374,3578756726,3578756743,17
2,1408,45375,3578756726,3578756743,17
2,1408,45376,3578756726,3578756744,18
2,1408,45377,3578756726,3578756745,19
2,1408,45378,3578756726,3578756748,22
2,1408,45379,3578756726,3578756749,23
2,1408,45380,3578756726,3578756749,23
2,1408,45381,3578756726,3578756750,24
2,1408,45382,3578756726,3578756751,25
2,1408,45383,3578756726,3578756752,26
2,1408,45384,3578756726,3578756753,27
2,1408,45385,3578756726,3578756753,27
2,1408,45386,3578756726,3578756754,28
2,1408,45387,3578756726,3578756756,30
2,1408,45388,3578756726,3578756756,30
2,1408,45389,3578756726,3578756757,31
2,1408,45390,3578756726,3578756757,31
2,1408,45391,3578756726,3578756757,31
2,1408,45392,3578756726,3578756762,36
2,1408,45393,3578756726,3578756764,38
2,1408,45394,3578756726,3578756766,40
2,1408,45395,3578756726,3578756766,40
2,1408,45396,3578756726,3578756766,40
2,1408,45397,3578756726,3578756767,41
2,1408,45398,3578756726,3578756767,41
2,1408,45399,3578756726,3578756768,42
2,1408,45400,3578756726,3578756769,43
2,1408,45401,3578756726,3578756771,45
2,1408,45402,3578756726,3578756771,45
2,1408,45403,3578756726,3578756771,45
2,1408,45404,3578756726,3578756772,46
2,1408,45405,3578756726,3578756773,47
2,1408,45406,3578756726,3578756774,48
2,1408,45407,3578756726,3578756774,48
2,1408,45408,3578756726,3578756775,49
2,1409,45409,3578756790,3578756790,0
2,1409,45410,3578756790,3578756790,0
2,1409,45411,3578756790,3578756790,0
2,1409,45412,3578756790,3578756790,0
2,1409,45413,3578756790,3578756790,0
2,1409,45414,3578756790,3578756790,0
2,1409,45415,3578756790,3578756790,0
2,1409,45416,3578756790,3578756790,0
2,1409,45417,3578756790,3578756790,0
2,1409,45418,3578756790,3578756790,0
2,1409,45419,3578756790,3578756790,0
2,1409,45420,3578756790,3578756790,0
2,1409,45421,3578756790,3578756790,0
2,1409,45422,3578756790,3578756790,0
2,1409,45423,3578756790,3578756791,1
2,1409,45424,3578756790,3578756793,3
2,1409,45425,3578756790,3578756793,3
2,1409,45426,3578756790,3578756793,3
2,1409,45427,3578756790,3578756793,3
2,1409,45428,3578756790,3578756794,4
2,1409,45429,3578756790,3578756797,7
2,1409,45430,3578756790,3578756798,8
2,1409,45431,3578756790,3578756800,10
2,1409,45432,3578756790,3578756802,12
2,1409,45433,3578756790,3578756803,13
2,1409,45434,3578756790,3578756803,13
2,1409,45435,3578756790,3578756803,13
2,1409,45436,3578756790,3578756807,17
2,1409,45437,3578756790,3578756811,21
2,1409,45438,3578756790,3578756812,22
2,1409,45439,3578756790,3578756813,23
2,1409,45440,3578756790,3578756814,24
2,1409,45441,3578756790,3578756815,25
2,1409,45442,3578756790,3578756816,26
2,1409,45443,3578756790,3578756816,26
2,1409,45444,3578756790,3578756817,27
2,1409,45445,3578756790,3578756818,28
2,1409,45446,3578756790,3578756819,29
2,1409,45447,3578756790,3578756820,30
2,1409,45448,3578756790,3578756823,33
2,1409,45449,3578756790,3578756823,33
2,1409,45450,3578756790,3578756824,34
2,1409,45451,3578756790,3578756824,34
2,1409,45452,3578756790,3578756826,36
2,1409,45453,3578756790,3578756827,37
2,1409,45454,3578756790,3578756828,38
2,1409,45455,3578756790,3578756828,38
2,1409,45456,3578756790,3578756828,38
2,1409,45457,3578756790,3578756829,39
2,1409,45458,3578756790,3578756831,41
2,1409,45459,3578756790,3578756831,41
2,1409,45460,3578756790,3578756832,42
2,1409,45461,3578756790,3578756833,43
2,1409,45462,3578756790,3578756833,43
2,1409,45463,3578756790,3578756836,46
2,1409,45464,3578756790,3578756836,46
2,1409,45465,3578756790,3578756837,47
2,1409,45466,3578756790,3578756837,47
2,1409,45467,3578756790,3578756837,47
2,1409,45468,3578756790,3578756838,48
2,1409,45469,3578756790,3578756839,49
2,1409,45470,3578756790,3578756840,50
2,1410,45471,3578756853,3578756853,0
2,1410,45472,3578756853,3578756853,0
2,1410,45473,3578756853,3578756853,0
2,1410,45474,3578756853,3578756853,0
2,1410,45475,3578756853,3578756853,0
2,1410,45476,3578756853,3578756853,0
2,1410,45477,3578756853,3578756853,0
2,1410,45478,3578756853,3578756853,0
2,1410,45479,3578756853,3578756853,0
2,1410,45480,3578756853,3578756853,0
2,1410,45481,3578756853,3578756853,0
2,1410,45482,3578756853,3578756853,0
2,1410,45483,3578756853,3578756853,0
2,1410,45484,3578756853,3578756853,0
2,1410,45485,3578756853,3578756853,0
2,1410,45486,3578756853,3578756853,0
2,1410,45487,3578756853,3578756854,1
2,1410,45488,3578756853,3578756854,1
2,1410,45489,3578756853,3578756855,2
2,1410,45490,3578756853,3578756855,2
2,1410,45491,3578756853,3578756856,3
2,1410,45492,3578756853,3578756857,4
2,1410,45493,3578756853,3578756857,4
2,1410,45494,3578756853,3578756858,5
2,1410,45495,3578756853,3578756858,5
2,1410,45496,3578756853,3578756859,6
2,1410,45497,3578756853,3578756860,7
2,1410,45498,3578756853,3578756861,8
2,1410,45499,3578756853,3578756864,11
2,1410,45500,3578756853,3578756865,12
2,1410,45501,3578756853,3578756866,13
2,1410,45502,3578756853,3578756867,14
2,1410,45503,3578756853,3578756867,14
2,1410,45504,3578756853,3578756868,15
2,1410,45505,3578756853,3578756869,16
2,1410,45506,3578756853,3578756876,23
2,1410,45507,3578756853,3578756879,26
2,1410,45508,3578756853,3578756881,28
2,1410,45509,3578756853,3578756881,28
2,1410,45510,3578756853,3578756882,29
2,1410,45511,3578756853,3578756883,30
2,1410,45512,3578756853,3578756884,31
2,1410,45513,3578756853,3578756885,32
2,1410,45514,3578756853,3578756888,35
2,1410,45515,3578756853,3578756888,35
2,1410,45516,3578756853,3578756888,35
2,1410,45517,3578756853,3578756889,36
2,1410,45518,3578756853,3578756890,37
2,1410,45519,3578756853,3578756891,38
2,1410,45520,3578756853,3578756893,40
2,1410,45521,3578756853,3578756893,40
2,1410,45522,3578756853,3578756893,40
2,1410,45523,3578756853,3578756893,40
2,1410,45524,3578756853,3578756893,40
2,1410,45525,3578756853,3578756898,45
2,1410,45526,3578756853,3578756898,45
2,1410,45527,3578756853,3578756899,46
2,1410,45528,3578756853,3578756899,46
2,1410,45529,3578756853,3578756899,46
2,1410,45530,3578756853,3578756901,48
2,1410,45531,3578756853,3578756902,49
2,1411,45532,3578756916,3578756916,0
2,1411,45533,3578756916,3578756916,0
2,1411,45534,3578756916,3578756916,0
2,1411,45535,3578756916,3578756916,0
2,1411,45536,3578756916,3578756916,0
2,1411,45537,3578756916,3578756916,0
2,1411,45538,3578756916,3578756916,0
2,1411,45539,3578756916,3578756916,0
2,1411,45540,3578756916,3578756916,0
2,1411,45541,3578756916,3578756916,0
2,1411,45542,3578756916,3578756916,0
2,1411,45543,3578756916,3578756916,0
2,1411,45544,3578756916,3578756916,0
2,1411,45545,3578756916,3578756916,0
2,1411,45546,3578756916,3578756916,0
2,1411,45547,3578756916,3578756916,0
2,1411,45548,3578756916,3578756916,0
2,1411,45549,3578756916,3578756916,0
2,1411,45550,3578756916,3578756916,0
2,1411,45551,3578756916,3578756916,0
2,1411,45552,3578756916,3578756917,1
2,1411,45553,3578756916,3578756917,1
2,1411,45554,3578756916,3578756918,2
2,1411,45555,3578756916,3578756918,2
2,1411,45556,3578756916,3578756918,2
2,1411,45557,3578756916,3578756918,2
2,1411,45558,3578756916,3578756919,3
2,1411,45559,3578756916,3578756920,4
2,1411,45560,3578756916,3578756920,4
2,1411,45561,3578756916,3578756920,4
2,1411,45562,3578756916,3578756922,6
2,1411,45563,3578756916,3578756922,6
2,1411,45564,3578756916,3578756923,7
2,1411,45565,3578756916,3578756923,7
2,1411,45566,3578756916,3578756923,7
2,1411,45567,3578756916,3578756924,8
2,1411,45568,3578756916,3578756924,8
2,1411,45569,3578756916,3578756924,8
2,1411,45570,3578756916,3578756925,9
2,1411,45571,3578756916,3578756927,11
2,1411,45572,3578756916,3578756927,11
2,1411,45573,3578756916,3578756927,11
2,1411,45574,3578756916,3578756927,11
2,1411,45575,3578756916,3578756931,15
2,1411,45576,3578756916,3578756933,17
2,1411,45577,3578756916,3578756933,17
2,1411,45578,3578756916,3578756935,19
2,1411,45579,3578756916,3578756935,19
2,1411,45580,3578756916,3578756936,20
2,1411,45581,3578756916,3578756936,20
2,1411,45582,3578756916,3578756937,21
2,1411,45583,3578756916,3578756937,21
2,1411,45584,3578756916,3578756938,22
2,1411,45585,3578756916,3578756938,22
2,1411,45586,3578756916,3578756938,22
2,1411,45587,3578756916,3578756939,23
2,1411,45588,3578756916,3578756939,23
2,1411,45589,3578756916,3578756939,23
2,1411,45590,3578756916,3578756939,23
2,1411,45591,3578756916,3578756942,26
2,1411,45592,3578756916,3578756943,27
2,1411,45593,3578756916,3578756943,27
2,1411,45594,3578756916,3578756944,28
2,1411,45595,3578756916,3578756945,29
2,1411,45596,3578756916,3578756947,31
2,1411,45597,3578756916,3578756950,34
2,1411,45598,3578756916,3578756950,34
2,1411,45599,3578756916,3578756950,34
2,1411,45600,3578756916,3578756950,34
2,1411,45601,3578756916,3578756952,36
2,1411,45602,3578756916,3578756953,37
2,1411,45603,3578756916,3578756954,38
2,1411,45604,3578756916,3578756955,39
2,1411,45605,3578756916,3578756955,39
2,1411,45606,3578756916,3578756956,40
2,1411,45607,3578756916,3578756957,41
2,1411,45608,3578756916,3578756957,41
2,1411,45609,3578756916,3578756957,41
2,1411,45610,3578756916,3578756957,41
2,1411,45611,3578756916,3578756961,45
2,1411,45612,3578756916,3578756964,48
2,1411,45613,3578756916,3578756964,48
2,1411,45614,3578756916,3578756965,49
2,1411,45615,3578756916,3578756965,49
2,1412,45616,3578756979,3578756979,0
2,1412,45617,3578756979,3578756979,0
2,1412,45618,3578756979,3578756979,0
2,1412,45619,3578756979,3578756979,0
2,1412,45620,3578756979,3578756979,0
2,1412,45621,3578756979,3578756979,0
2,1412,45622,3578756979,3578756979,0
2,1412,45623,3578756979,3578756979,0
2,1412,45624,3578756979,3578756979,0
2,1412,45625,3578756979,3578756979,0
2,1412,45626,3578756979,3578756979,0
2,1412,45627,3578756979,3578756979,0
2,1412,45628,3578756979,3578756979,0
2,1412,45629,3578756979,3578756979,0
2,1412,45630,3578756979,3578756979,0
2,1412,45631,3578756979,3578756979,0
2,1412,45632,3578756979,3578756980,1
2,1412,45633,3578756979,3578756982,3
2,1412,45634,3578756979,3578756985,6
2,1412,45635,3578756979,3578756985,6
2,1412,45636,3578756979,3578756988,9
2,1412,45637,3578756979,3578756989,10
2,1412,45638,3578756979,3578756989,10
2,1412,45639,3578756979,3578756990,11
2,1412,45640,3578756979,3578756991,12
2,1412,45641,3578756979,3578756991,12
2,1412,45642,3578756979,3578756992,13
2,1412,45643,3578756979,3578756993,14
2,1412,45644,3578756979,3578756993,14
2,1412,45645,3578756979,3578756994,15
2,1412,45646,3578756979,3578756994,15
2,1412,45647,3578756979,3578756994,15
2,1412,45648,3578756979,3578756997,18
2,1412,45649,3578756979,3578756998,19
2,1412,45650,3578756979,3578756999,20
2,1412,45651,3578756979,3578757000,21
2,1412,45652,3578756979,3578757001,22
2,1412,45653,3578756979,3578757002,23
2,1412,45654,3578756979,3578757002,23
2,1412,45655,3578756979,3578757003,24
2,1412,45656,3578756979,3578757004,25
2,1412,45657,3578756979,3578757005,26
2,1412,45658,3578756979,3578757007,28
2,1412,45659,3578756979,3578757011,32
2,1412,45660,3578756979,3578757013,34
2,1412,45661,3578756979,3578757014,35
2,1412,45662,3578756979,3578757014,35
2,1412,45663,3578756979,3578757015,36
2,1412,45664,3578756979,3578757015,36
2,1412,45665,3578756979,3578757016,37
2,1412,45666,3578756979,3578757017,38
2,1412,45667,3578756979,3578757017,38
2,1412,45668,3578756979,3578757018,39
2,1412,45669,3578756979,3578757020,41
2,1412,45670,3578756979,3578757023,44
2,1412,45671,3578756979,3578757024,45
2,1412,45672,3578756979,3578757024,45
2,1412,45673,3578756979,3578757025,46
2,1412,45674,3578756979,3578757026,47
2,1412,45675,3578756979,3578757027,48
2,1412,45676,3578756979,3578757028,49
2,1412,45677,3578756979,3578757029,50
2,1413,45678,3578757043,3578757043,0
2,1413,45679,3578757043,3578757043,0
2,1413,45680,3578757043,3578757043,0
2,1413,45681,3578757043,3578757043,0
2,1413,45682,3578757043,3578757043,0
2,1413,45683,3578757043,3578757043,0
2,1413,45684,3578757043,3578757043,0
2,1413,45685,3578757043,3578757043,0
2,1413,45686,3578757043,3578757043,0
2,1413,45687,3578757043,3578757043,0
2,1413,45688,3578757043,3578757043,0
2,1413,45689,3578757043,3578757043,0
2,1413,45690,3578757043,3578757043,0
2,1413,45691,3578757043,3578757043,0
2,1413,45692,3578757043,3578757043,0
2,1413,45693,3578757043,3578757043,0
2,1413,45694,3578757043,3578757043,0
2,1413,45695,3578757043,3578757043,0
2,1413,45696,3578757043,3578757043,0
2,1413,45697,3578757043,3578757043,0
2,1413,45698,3578757043,3578757045,2
2,1413,45699,3578757043,3578757046,3
2,1413,45700,3578757043,3578757046,3
2,1413,45701,3578757043,3578757047,4
2,1413,45702,3578757043,3578757049,6
2,1413,45703,3578757043,3578757049,6
2,1413,45704,3578757043,3578757051,8
2,1413,45705,3578757043,3578757052,9
2,1413,45706,3578757043,3578757053,10
2,1413,45707,3578757043,3578757054,11
2,1413,45708,3578757043,3578757054,11
2,1413,45709,3578757043,3578757054,11
2,1413,45710,3578757043,3578757055,12
2,1413,45711,3578757043,3578757055,12
2,1413,45712,3578757043,3578757056,13
2,1413,45713,3578757043,3578757057,14
2,1413,45714,3578757043,3578757057,14
2,1413,45715,3578757043,3578757058,15
2,1413,45716,3578757043,3578757058,15
2,1413,45717,3578757043,3578757058,15
2,1413,45718,3578757043,3578757060,17
2,1413,45719,3578757043,3578757060,17
2,1413,45720,3578757043,3578757065,22
2,1413,45721,3578757043,3578757066,23
2,1413,45722,3578757043,3578757067,24
2,1413,45723,3578757043,3578757067,24
2,1413,45724,3578757043,3578757067,24
2,1413,45725,3578757043,3578757068,25
2,1413,45726,3578757043,3578757069,26
2,1413,45727,3578757043,3578757076,33
2,1413,45728,3578757043,3578757079,36
2,1413,45729,3578757043,3578757082,39
2,1413,45730,3578757043,3578757082,39
2,1413,45731,3578757043,3578757082,39
2,1413,45732,3578757043,3578757084,41
2,1413,45733,3578757043,3578757085,42
2,1413,45734,3578757043,3578757087,44
2,1413,45735,3578757043,3578757088,45
2,1413,45736,3578757043,3578757089,46
2,1413,45737,3578757043,3578757089,46
2,1413,45738,3578757043,3578757090,47
2,1413,45739,3578757043,3578757092,49
2,1413,45740,3578757043,3578757093,50
2,1413,45741,3578757043,3578757093,50
2,1414,45742,3578757104,3578757104,0
2,1414,45743,3578757104,3578757104,0
2,1414,45744,3578757104,3578757104,0
2,1414,45745,3578757104,3578757104,0
2,1414,45746,3578757104,3578757104,0
2,1414,45747,3578757104,3578757104,0
2,1414,45748,3578757104,3578757104,0
2,1414,45749,3578757104,3578757104,0
2,1414,45750,3578757104,3578757104,0
2,1414,45751,3578757104,3578757104,0
2,1414,45752,3578757104,3578757104,0
2,1414,45753,3578757104,3578757104,0
2,1414,45754,3578757104,3578757104,0
2,1414,45755,3578757104,3578757104,0
2,1414,45756,3578757104,3578757105,1
2,1414,45757,3578757104,3578757105,1
2,1414,45758,3578757104,3578757107,3
2,1414,45759,3578757104,3578757108,4
2,1414,45760,3578757104,3578757108,4
2,1414,45761,3578757104,3578757109,5
2,1414,45762,3578757104,3578757112,8
2,1414,45763,3578757104,3578757112,8
2,1414,45764,3578757104,3578757112,8
2,1414,45765,3578757104,3578757113,9
2,1414,45766,3578757104,3578757113,9
2,1414,45767,3578757104,3578757116,12
2,1414,45768,3578757104,3578757116,12
2,1414,45769,3578757104,3578757116,12
2,1414,45770,3578757104,3578757116,12
2,1414,45771,3578757104,3578757117,13
2,1414,45772,3578757104,3578757117,13
2,1414,45773,3578757104,3578757117,13
2,1414,45774,3578757104,3578757118,14
2,1414,45775,3578757104,3578757118,14
2,1414,45776,3578757104,3578757119,15
2,1414,45777,3578757104,3578757119,15
2,1414,45778,3578757104,3578757119,15
2,1414,45779,3578757104,3578757119,15
2,1414,45780,3578757104,3578757120,16
2,1414,45781,3578757104,3578757120,16
2,1414,45782,3578757104,3578757121,17
2,1414,45783,3578757104,3578757122,18
2,1414,45784,3578757104,3578757122,18
2,1414,45785,3578757104,3578757123,19
2,1414,45786,3578757104,3578757123,19
2,1414,45787,3578757104,3578757124,20
2,1414,45788,3578757104,3578757125,21
2,1414,45789,3578757104,3578757125,21
2,1414,45790,3578757104,3578757126,22
2,1414,45791,3578757104,3578757128,24
2,1414,45792,3578757104,3578757128,24
2,1414,45793,3578757104,3578757131,27
2,1414,45794,3578757104,3578757133,29
2,1414,45795,3578757104,3578757133,29
2,1414,45796,3578757104,3578757133,29
2,1414,45797,3578757104,3578757134,30
2,1414,45798,3578757104,3578757135,31
2,1414,45799,3578757104,3578757136,32
2,1414,45800,3578757104,3578757136,32
2,1414,45801,3578757104,3578757136,32
2,1414,45802,3578757104,3578757137,33
2,1414,45803,3578757104,3578757137,33
2,1414,45804,3578757104,3578757138,34
2,1414,45805,3578757104,3578757138,34
2,1414,45806,3578757104,3578757139,35
2,1414,45807,3578757104,3578757139,35
2,1414,45808,3578757104,3578757139,35
2,1414,45809,3578757104,3578757139,35
2,1414,45810,3578757104,3578757140,36
2,1414,45811,3578757104,3578757143,39
2,1414,45812,3578757104,3578757143,39
2,1414,45813,3578757104,3578757143,39
2,1414,45814,3578757104,3578757144,40
2,1414,45815,3578757104,3578757145,41
2,1414,45816,3578757104,3578757148,44
2,1414,45817,3578757104,3578757149,45
2,1414,45818,3578757104,3578757150,46
2,1414,45819,3578757104,3578757150,46
2,1414,45820,3578757104,3578757150,46
2,1414,45821,3578757104,3578757151,47
2,1414,45822,3578757104,3578757152,48
2,1414,45823,3578757104,3578757153,49
2,1414,45824,3578757104,3578757153,49
2,1415,45825,3578757168,3578757168,0
2,1415,45826,3578757168,3578757168,0
2,1415,45827,3578757168,3578757168,0
2,1415,45828,3578757168,3578757168,0
2,1415,45829,3578757168,3578757168,0
2,1415,45830,3578757168,3578757168,0
2,1415,45831,3578757168,3578757168,0
2,1415,45832,3578757168,3578757168,0
2,1415,45833,3578757168,3578757168,0
2,1415,45834,3578757168,3578757168,0
2,1415,45835,3578757168,3578757168,0
2,1415,45836,3578757168,3578757168,0
2,1415,45837,3578757168,3578757168,0
2,1415,45838,3578757168,3578757168,0
2,1415,45839,3578757168,3578757169,1
2,1415,45840,3578757168,3578757169,1
2,1415,45841,3578757168,3578757170,2
2,1415,45842,3578757168,3578757171,3
2,1415,45843,3578757168,3578757171,3
2,1415,45844,3578757168,3578757172,4
2,1415,45845,3578757168,3578757173,5
2,1415,45846,3578757168,3578757174,6
2,1415,45847,3578757168,3578757175,7
2,1415,45848,3578757168,3578757175,7
2,1415,45849,3578757168,3578757177,9
2,1415,45850,3578757168,3578757177,9
2,1415,45851,3578757168,3578757177,9
2,1415,45852,3578757168,3578757178,10
2,1415,45853,3578757168,3578757178,10
2,1415,45854,3578757168,3578757180,12
2,1415,45855,3578757168,3578757183,15
2,1415,45856,3578757168,3578757184,16
2,1415,45857,3578757168,3578757185,17
2,1415,45858,3578757168,3578757188,20
2,1415,45859,3578757168,3578757188,20
2,1415,45860,3578757168,3578757189,21
2,1415,45861,3578757168,3578757190,22
2,1415,45862,3578757168,3578757191,23
2,1415,45863,3578757168,3578757191,23
2,1415,45864,3578757168,3578757192,24
2,1415,45865,3578757168,3578757193,25
2,1415,45866,3578757168,3578757193,25
2,1415,45867,3578757168,3578757194,26
2,1415,45868,3578757168,3578757194,26
2,1415,45869,3578757168,3578757194,26
2,1415,45870,3578757168,3578757194,26
2,1415,45871,3578757168,3578757197,29
2,1415,45872,3578757168,3578757198,30
2,1415,45873,3578757168,3578757200,32
2,1415,45874,3578757168,3578757200,32
2,1415,45875,3578757168,3578757201,33
2,1415,45876,3578757168,3578757203,35
2,1415,45877,3578757168,3578757203,35
2,1415,45878,3578757168,3578757203,35
2,1415,45879,3578757168,3578757204,36
2,1415,45880,3578757168,3578757205,37
2,1415,45881,3578757168,3578757207,39
2,1415,45882,3578757168,3578757211,43
2,1415,45883,3578757168,3578757213,45
2,1415,45884,3578757168,3578757215,47
2,1415,45885,3578757168,3578757216,48
2,1415,45886,3578757168,3578757216,48
2,1415,45887,3578757168,3578757217,49
2,1415,45888,3578757168,3578757217,49
2,1415,45889,3578757168,3578757218,50
2,1416,45890,3578757231,3578757231,0
2,1416,45891,3578757231,3578757231,0
2,1416,45892,3578757231,3578757231,0
2,1416,45893,3578757231,3578757231,0
2,1416,45894,3578757231,3578757231,0
2,1416,45895,3578757231,3578757231,0
2,1416,45896,3578757231,3578757231,0
2,1416,45897,3578757231,3578757231,0
2,1416,45898,3578757231,3578757231,0
2,1416,45899,3578757231,3578757231,0
2,1416,45900,3578757231,3578757233,2
2,1416,45901,3578757231,3578757233,2
2,1416,45902,3578757231,3578757236,5
2,1416,45903,3578757231,3578757236,5
2,1416,45904,3578757231,3578757237,6
2,1416,45905,3578757231,3578757237,6
2,1416,45906,3578757231,3578757237,6
2,1416,45907,3578757231,3578757237,6
2,1416,45908,3578757231,3578757239,8
2,1416,45909,3578757231,3578757240,9
2,1416,45910,3578757231,3578757240,9
2,1416,45911,3578757231,3578757240,9
2,1416,45912,3578757231,3578757241,10
2,1416,45913,3578757231,3578757241,10
2,1416,45914,3578757231,3578757242,11
2,1416,45915,3578757231,3578757242,11
2,1416,45916,3578757231,3578757245,14
2,1416,45917,3578757231,3578757246,15
2,1416,45918,3578757231,3578757246,15
2,1416,45919,3578757231,3578757247,16
2,1416,45920,3578757231,3578757250,19
2,1416,45921,3578757231,3578757250,19
2,1416,45922,3578757231,3578757251,20
2,1416,45923,3578757231,3578757252,21
2,1416,45924,3578757231,3578757252,21
2,1416,45925,3578757231,3578757254,23
2,1416,45926,3578757231,3578757254,23
2,1416,45927,3578757231,3578757254,23
2,1416,45928,3578757231,3578757254,23
2,1416,45929,3578757231,3578757255,24
2,1416,45930,3578757231,3578757255,24
2,1416,45931,3578757231,3578757256,25
2,1416,45932,3578757231,3578757257,26
2,1416,45933,3578757231,3578757257,26
2,1416,45934,3578757231,3578757258,27
2,1416,45935,3578757231,3578757258,27
2,1416,45936,3578757231,3578757259,28
2,1416,45937,3578757231,3578757260,29
2,1416,45938,3578757231,3578757265,34
2,1416,45939,3578757231,3578757265,34
2,1416,45940,3578757231,3578757268,37
2,1416,45941,3578757231,3578757268,37
2,1416,45942,3578757231,3578757269,38
2,1416,45943,3578757231,3578757270,39
2,1416,45944,3578757231,3578757277,46
2,1416,45945,3578757231,3578757279,48
2,1417,45946,3578757294,3578757294,0
2,1417,45947,3578757294,3578757294,0
2,1417,45948,3578757294,3578757294,0
2,1417,45949,3578757294,3578757294,0
2,1417,45950,3578757294,3578757294,0
2,1417,45951,3578757294,3578757294,0
2,1417,45952,3578757294,3578757294,0
2,1417,45953,3578757294,3578757294,0
2,1417,45954,3578757294,3578757294,0
2,1417,45955,3578757294,3578757294,0
2,1417,45956,3578757294,3578757294,0
2,1417,45957,3578757294,3578757294,0
2,1417,45958,3578757294,3578757294,0
2,1417,45959,3578757294,3578757294,0
2,1417,45960,3578757294,3578757294,0
2,1417,45961,3578757294,3578757294,0
2,1417,45962,3578757294,3578757294,0
2,1417,45963,3578757294,3578757295,1
2,1417,45964,3578757294,3578757298,4
2,1417,45965,3578757294,3578757298,4
2,1417,45966,3578757294,3578757299,5
2,1417,45967,3578757294,3578757299,5
2,1417,45968,3578757294,3578757300,6
2,1417,45969,3578757294,3578757301,7
2,1417,45970,3578757294,3578757303,9
2,1417,45971,3578757294,3578757304,10
2,1417,45972,3578757294,3578757305,11
2,1417,45973,3578757294,3578757305,11
2,1417,45974,3578757294,3578757306,12
2,1417,45975,3578757294,3578757307,13
2,1417,45976,3578757294,3578757307,13
2,1417,45977,3578757294,3578757308,14
2,1417,45978,3578757294,3578757309,15
2,1417,45979,3578757294,3578757312,18
2,1417,45980,3578757294,3578757312,18
2,1417,45981,3578757294,3578757312,18
2,1417,45982,3578757294,3578757313,19
2,1417,45983,3578757294,3578757313,19
2,1417,45984,3578757294,3578757316,22
2,1417,45985,3578757294,3578757316,22
2,1417,45986,3578757294,3578757316,22
2,1417,45987,3578757294,3578757316,22
2,1417,45988,3578757294,3578757316,22
2,1417,45989,3578757294,3578757317,23
2,1417,45990,3578757294,3578757317,23
2,1417,45991,3578757294,3578757317,23
2,1417,45992,3578757294,3578757318,24
2,1417,45993,3578757294,3578757318,24
2,1417,45994,3578757294,3578757319,25
2,1417,45995,3578757294,3578757319,25
2,1417,45996,3578757294,3578757319,25
2,1417,45997,3578757294,3578757319,25
2,1417,45998,3578757294,3578757320,26
2,1417,45999,3578757294,3578757320,26
2,1417,46000,3578757294,3578757321,27
2,1417,46001,3578757294,3578757322,28
2,1417,46002,3578757294,3578757323,29
2,1417,46003,3578757294,3578757323,29
2,1417,46004,3578757294,3578757323,29
2,1417,46005,3578757294,3578757324,30
2,1417,46006,3578757294,3578757324,30
2,1417,46007,3578757294,3578757324,30
2,1417,46008,3578757294,3578757325,31
2,1417,46009,3578757294,3578757327,33
2,1417,46010,3578757294,3578757327,33
2,1417,46011,3578757294,3578757328,34
2,1417,46012,3578757294,3578757332,38
2,1417,46013,3578757294,3578757333,39
2,1417,46014,3578757294,3578757333,39
2,1417,46015,3578757294,3578757333,39
2,1417,46016,3578757294,3578757333,39
2,1417,46017,3578757294,3578757336,42
2,1417,46018,3578757294,3578757336,42
2,1417,46019,3578757294,3578757336,42
2,1417,46020,3578757294,3578757337,43
2,1417,46021,3578757294,3578757337,43
2,1417,46022,3578757294,3578757338,44
2,1417,46023,3578757294,3578757338,44
2,1417,46024,3578757294,3578757338,44
2,1417,46025,3578757294,3578757339,45
2,1417,46026,3578757294,3578757339,45
2,1417,46027,3578757294,3578757340,46
2,1417,46028,3578757294,3578757340,46
2,1417,46029,3578757294,3578757343,49
2,1417,46030,3578757294,3578757344,50
2,1418,46031,3578757357,3578757357,0
2,1418,46032,3578757357,3578757357,0
2,1418,46033,3578757357,3578757357,0
2,1418,46034,3578757357,3578757357,0
2,1418,46035,3578757357,3578757357,0
2,1418,46036,3578757357,3578757357,0
2,1418,46037,3578757357,3578757357,0
2,1418,46038,3578757357,3578757357,0
2,1418,46039,3578757357,3578757357,0
2,1418,46040,3578757357,3578757357,0
2,1418,46041,3578757357,3578757357,0
2,1418,46042,3578757357,3578757357,0
2,1418,46043,3578757357,3578757362,5
2,1418,46044,3578757357,3578757363,6
2,1418,46045,3578757357,3578757364,7
2,1418,46046,3578757357,3578757365,8
2,1418,46047,3578757357,3578757366,9
2,1418,46048,3578757357,3578757366,9
2,1418,46049,3578757357,3578757366,9
2,1418,46050,3578757357,3578757368,11
2,1418,46051,3578757357,3578757368,11
2,1418,46052,3578757357,3578757370,13
2,1418,46053,3578757357,3578757370,13
2,1418,46054,3578757357,3578757371,14
2,1418,46055,3578757357,3578757371,14
2,1418,46056,3578757357,3578757371,14
2,1418,46057,3578757357,3578757373,16
2,1418,46058,3578757357,3578757374,17
2,1418,46059,3578757357,3578757375,18
2,1418,46060,3578757357,3578757375,18
2,1418,46061,3578757357,3578757377,20
2,1418,46062,3578757357,3578757377,20
2,1418,46063,3578757357,3578757378,21
2,1418,46064,3578757357,3578757378,21
2,1418,46065,3578757357,3578757379,22
2,1418,46066,3578757357,3578757379,22
2,1418,46067,3578757357,3578757383,26
2,1418,46068,3578757357,3578757384,27
2,1418,46069,3578757357,3578757385,28
2,1418,46070,3578757357,3578757388,31
2,1418,46071,3578757357,3578757389,32
2,1418,46072,3578757357,3578757390,33
2,1418,46073,3578757357,3578757390,33
2,1418,46074,3578757357,3578757391,34
2,1418,46075,3578757357,3578757392,35
2,1418,46076,3578757357,3578757393,36
2,1418,46077,3578757357,3578757393,36
2,1418,46078,3578757357,3578757393,36
2,1418,46079,3578757357,3578757394,37
2,1418,46080,3578757357,3578757394,37
2,1418,46081,3578757357,3578757398,41
2,1418,46082,3578757357,3578757398,41
2,1418,46083,3578757357,3578757400,43
2,1418,46084,3578757357,3578757400,43
2,1418,46085,3578757357,3578757402,45
2,1418,46086,3578757357,3578757403,46
2,1418,46087,3578757357,3578757403,46
2,1418,46088,3578757357,3578757404,47
2,1418,46089,3578757357,3578757404,47
2,1418,46090,3578757357,3578757405,48
2,1418,46091,3578757357,3578757406,49
2,1418,46092,3578757357,3578757407,50
2,1419,46093,3578757422,3578757422,0
2,1419,46094,3578757422,3578757422,0
2,1419,46095,3578757422,3578757422,0
2,1419,46096,3578757422,3578757422,0
2,1419,46097,3578757422,3578757422,0
2,1419,46098,3578757422,3578757422,0
2,1419,46099,3578757422,3578757422,0
2,1419,46100,3578757422,3578757422,0
2,1419,46101,3578757422,3578757422,0
2,1419,46102,3578757422,3578757422,0
2,1419,46103,3578757422,3578757422,0
2,1419,46104,3578757422,3578757423,1
2,1419,46105,3578757422,3578757424,2
2,1419,46106,3578757422,3578757425,3
2,1419,46107,3578757422,3578757425,3
2,1419,46108,3578757422,3578757427,5
2,1419,46109,3578757422,3578757428,6
2,1419,46110,3578757422,3578757428,6
2,1419,46111,3578757422,3578757430,8
2,1419,46112,3578757422,3578757430,8
2,1419,46113,3578757422,3578757431,9
2,1419,46114,3578757422,3578757433,11
2,1419,46115,3578757422,3578757433,11
2,1419,46116,3578757422,3578757433,11
2,1419,46117,3578757422,3578757435,13
2,1419,46118,3578757422,3578757436,14
2,1419,46119,3578757422,3578757437,15
2,1419,46120,3578757422,3578757437,15
2,1419,46121,3578757422,3578757438,16
2,1419,46122,3578757422,3578757439,17
2,1419,46123,3578757422,3578757439,17
2,1419,46124,3578757422,3578757440,18
2,1419,46125,3578757422,3578757440,18
2,1419,46126,3578757422,3578757440,18
2,1419,46127,3578757422,3578757440,18
2,1419,46128,3578757422,3578757442,20
2,1419,46129,3578757422,3578757442,20
2,1419,46130,3578757422,3578757442,20
2,1419,46131,3578757422,3578757445,23
2,1419,46132,3578757422,3578757446,24
2,1419,46133,3578757422,3578757447,25
2,1419,46134,3578757422,3578757447,25
2,1419,46135,3578757422,3578757449,27
2,1419,46136,3578757422,3578757450,28
2,1419,46137,3578757422,3578757451,29
2,1419,46138,3578757422,3578757452,30
2,1419,46139,3578757422,3578757453,31
2,1419,46140,3578757422,3578757454,32
2,1419,46141,3578757422,3578757454,32
2,1419,46142,3578757422,3578757455,33
2,1419,46143,3578757422,3578757455,33
2,1419,46144,3578757422,3578757455,33
2,1419,46145,3578757422,3578757456,34
2,1419,46146,3578757422,3578757456,34
2,1419,46147,3578757422,3578757456,34
2,1419,46148,3578757422,3578757457,35
2,1419,46149,3578757422,3578757458,36
2,1419,46150,3578757422,3578757458,36
2,1419,46151,3578757422,3578757459,37
2,1419,46152,3578757422,3578757460,38
2,1419,46153,3578757422,3578757461,39
2,1419,46154,3578757422,3578757465,43
2,1419,46155,3578757422,3578757465,43
2,1419,46156,3578757422,3578757467,45
2,1419,46157,3578757422,3578757467,45
2,1419,46158,3578757422,3578757469,47
2,1419,46159,3578757422,3578757470,48
2,1420,46160,3578757487,3578757487,0
2,1420,46161,3578757487,3578757487,0
2,1420,46162,3578757487,3578757487,0
2,1420,46163,3578757487,3578757487,0
2,1420,46164,3578757487,3578757487,0
2,1420,46165,3578757487,3578757487,0
2,1420,46166,3578757487,3578757487,0
2,1420,46167,3578757487,3578757488,1
2,1420,46168,3578757487,3578757488,1
2,1420,46169,3578757487,3578757489,2
2,1420,46170,3578757487,3578757489,2
2,1420,46171,3578757487,3578757490,3
2,1420,46172,3578757487,3578757491,4
2,1420,46173,3578757487,3578757492,5
2,1420,46174,3578757487,3578757493,6
2,1420,46175,3578757487,3578757493,6
2,1420,46176,3578757487,3578757494,7
2,1420,46177,3578757487,3578757497,10
2,1420,46178,3578757487,3578757497,10
2,1420,46179,3578757487,3578757497,10
2,1420,46180,3578757487,3578757499,12
2,1420,46181,3578757487,3578757499,12
2,1420,46182,3578757487,3578757499,12
2,1420,46183,3578757487,3578757500,13
2,1420,46184,3578757487,3578757500,13
2,1420,46185,3578757487,3578757502,15
2,1420,46186,3578757487,3578757503,16
2,1420,46187,3578757487,3578757504,17
2,1420,46188,3578757487,3578757505,18
2,1420,46189,3578757487,3578757506,19
2,1420,46190,3578757487,3578757507,20
2,1420,46191,3578757487,3578757507,20
2,1420,46192,3578757487,3578757508,21
2,1420,46193,3578757487,3578757511,24
2,1420,46194,3578757487,3578757511,24
2,1420,46195,3578757487,3578757512,25
2,1420,46196,3578757487,3578757512,25
2,1420,46197,3578757487,3578757515,28
2,1420,46198,3578757487,3578757515,28
2,1420,46199,3578757487,3578757515,28
2,1420,46200,3578757487,3578757515,28
2,1420,46201,3578757487,3578757516,29
2,1420,46202,3578757487,3578757516,29
2,1420,46203,3578757487,3578757516,29
2,1420,46204,3578757487,3578757517,30
2,1420,46205,3578757487,3578757517,30
2,1420,46206,3578757487,3578757518,31
2,1420,46207,3578757487,3578757518,31
2,1420,46208,3578757487,3578757518,31
2,1420,46209,3578757487,3578757518,31
2,1420,46210,3578757487,3578757519,32
2,1420,46211,3578757487,3578757519,32
2,1420,46212,3578757487,3578757521,34
2,1420,46213,3578757487,3578757522,35
2,1420,46214,3578757487,3578757522,35
2,1420,46215,3578757487,3578757522,35
2,1420,46216,3578757487,3578757522,35
2,1420,46217,3578757487,3578757522,35
2,1420,46218,3578757487,3578757523,36
2,1420,46219,3578757487,3578757524,37
2,1420,46220,3578757487,3578757525,38
2,1420,46221,3578757487,3578757526,39
2,1420,46222,3578757487,3578757526,39
2,1420,46223,3578757487,3578757527,40
2,1420,46224,3578757487,3578757530,43
2,1420,46225,3578757487,3578757532,45
2,1420,46226,3578757487,3578757532,45
2,1420,46227,3578757487,3578757532,45
2,1420,46228,3578757487,3578757533,46
2,1420,46229,3578757487,3578757535,48
2,1420,46230,3578757487,3578757535,48
2,1420,46231,3578757487,3578757535,48
2,1420,46232,3578757487,3578757536,49
2,1420,46233,3578757487,3578757536,49
2,1420,46234,3578757487,3578757537,50
2,1421,46235,3578757551,3578757551,0
2,1421,46236,3578757551,3578757551,0
2,1421,46237,3578757551,3578757551,0
2,1421,46238,3578757551,3578757551,0
2,1421,46239,3578757551,3578757551,0
2,1421,46240,3578757551,3578757551,0
2,1421,46241,3578757551,3578757551,0
2,1421,46242,3578757551,3578757551,0
2,1421,46243,3578757551,3578757551,0
2,1421,46244,3578757551,3578757551,0
2,1421,46245,3578757551,3578757551,0
2,1421,46246,3578757551,3578757551,0
2,1421,46247,3578757551,3578757551,0
2,1421,46248,3578757551,3578757551,0
2,1421,46249,3578757551,3578757551,0
2,1421,46250,3578757551,3578757551,0
2,1421,46251,3578757551,3578757551,0
2,1421,46252,3578757551,3578757552,1
2,1421,46253,3578757551,3578757553,2
2,1421,46254,3578757551,3578757553,2
2,1421,46255,3578757551,3578757553,2
2,1421,46256,3578757551,3578757555,4
2,1421,46257,3578757551,3578757556,5
2,1421,46258,3578757551,3578757557,6
2,1421,46259,3578757551,3578757557,6
2,1421,46260,3578757551,3578757560,9
2,1421,46261,3578757551,3578757563,12
2,1421,46262,3578757551,3578757563,12
2,1421,46263,3578757551,3578757564,13
2,1421,46264,3578757551,3578757565,14
2,1421,46265,3578757551,3578757565,14
2,1421,46266,3578757551,3578757565,14
2,1421,46267,3578757551,3578757568,17
2,1421,46268,3578757551,3578757568,17
2,1421,46269,3578757551,3578757569,18
2,1421,46270,3578757551,3578757569,18
2,1421,46271,3578757551,3578757570,19
2,1421,46272,3578757551,3578757570,19
2,1421,46273,3578757551,3578757571,20
2,1421,46274,3578757551,3578757571,20
2,1421,46275,3578757551,3578757571,20
2,1421,46276,3578757551,3578757573,22
2,1421,46277,3578757551,3578757574,23
2,1421,46278,3578757551,3578757574,23
2,1421,46279,3578757551,3578757576,25
2,1421,46280,3578757551,3578757576,25
2,1421,46281,3578757551,3578757576,25
2,1421,46282,3578757551,3578757577,26
2,1421,46283,3578757551,3578757578,27
2,1421,46284,3578757551,3578757579,28
2,1421,46285,3578757551,3578757583,32
2,1421,46286,3578757551,3578757584,33
2,1421,46287,3578757551,3578757584,33
2,1421,46288,3578757551,3578757587,36
2,1421,46289,3578757551,3578757588,37
2,1421,46290,3578757551,3578757589,38
2,1421,46291,3578757551,3578757590,39
2,1421,46292,3578757551,3578757591,40
2,1421,46293,3578757551,3578757591,40
2,1421,46294,3578757551,3578757592,41
2,1421,46295,3578757551,3578757593,42
2,1421,46296,3578757551,3578757593,42
2,1421,46297,3578757551,3578757594,43
2,1421,46298,3578757551,3578757597,46
2,1421,46299,3578757551,3578757598,47
2,1421,46300,3578757551,3578757598,47
2,1421,46301,3578757551,3578757599,48
2,1421,46302,3578757551,3578757600,49
2,1422,46303,3578757615,3578757615,0
2,1422,46304,3578757615,3578757615,0
2,1422,46305,3578757615,3578757615,0
2,1422,46306,3578757615,3578757616,1
2,1422,46307,3578757615,3578757616,1
2,1422,46308,3578757615,3578757616,1
2,1422,46309,3578757615,3578757616,1
2,1422,46310,3578757615,3578757616,1
2,1422,46311,3578757615,3578757616,1
2,1422,46312,3578757615,3578757616,1
2,1422,46313,3578757615,3578757616,1
2,1422,46314,3578757615,3578757616,1
2,1422,46315,3578757615,3578757616,1
2,1422,46316,3578757615,3578757617,2
2,1422,46317,3578757615,3578757617,2
2,1422,46318,3578757615,3578757618,3
2,1422,46319,3578757615,3578757620,5
2,1422,46320,3578757615,3578757622,7
2,1422,46321,3578757615,3578757623,8
2,1422,46322,3578757615,3578757624,9
2,1422,46323,3578757615,3578757626,11
2,1422,46324,3578757615,3578757628,13
2,1422,46325,3578757615,3578757629,14
2,1422,46326,3578757615,3578757629,14
2,1422,46327,3578757615,3578757631,16
2,1422,46328,3578757615,3578757632,17
2,1422,46329,3578757615,3578757632,17
2,1422,46330,3578757615,3578757632,17
2,1422,46331,3578757615,3578757634,19
2,1422,46332,3578757615,3578757635,20
2,1422,46333,3578757615,3578757635,20
2,1422,46334,3578757615,3578757636,21
2,1422,46335,3578757615,3578757636,21
2,1422,46336,3578757615,3578757636,21
2,1422,46337,3578757615,3578757637,22
2,1422,46338,3578757615,3578757638,23
2,1422,46339,3578757615,3578757638,23
2,1422,46340,3578757615,3578757638,23
2,1422,46341,3578757615,3578757639,24
2,1422,46342,3578757615,3578757639,24
2,1422,46343,3578757615,3578757640,25
2,1422,46344,3578757615,3578757640,25
2,1422,46345,3578757615,3578757642,27
2,1422,46346,3578757615,3578757644,29
2,1422,46347,3578757615,3578757646,31
2,1422,46348,3578757615,3578757646,31
2,1422,46349,3578757615,3578757647,32
2,1422,46350,3578757615,3578757649,34
2,1422,46351,3578757615,3578757650,35
2,1422,46352,3578757615,3578757650,35
2,1422,46353,3578757615,3578757652,37
2,1422,46354,3578757615,3578757652,37
2,1422,46355,3578757615,3578757653,38
2,1422,46356,3578757615,3578757653,38
2,1422,46357,3578757615,3578757654,39
2,1422,46358,3578757615,3578757654,39
2,1422,46359,3578757615,3578757654,39
2,1422,46360,3578757615,3578757655,40
2,1422,46361,3578757615,3578757655,40
2,1422,46362,3578757615,3578757655,40
2,1422,46363,3578757615,3578757656,41
2,1422,46364,3578757615,3578757657,42
2,1422,46365,3578757615,3578757657,42
2,1422,46366,3578757615,3578757657,42
2,1422,46367,3578757615,3578757658,43
2,1422,46368,3578757615,3578757659,44
2,1422,46369,3578757615,3578757660,45
2,1422,46370,3578757615,3578757664,49
2,1422,46371,3578757615,3578757665,50
2,1423,46372,3578757679,3578757679,0
2,1423,46373,3578757679,3578757679,0
2,1423,46374,3578757679,3578757679,0
2,1423,46375,3578757679,3578757679,0
2,1423,46376,3578757679,3578757679,0
2,1423,46377,3578757679,3578757679,0
2,1423,46378,3578757679,3578757680,1
2,1423,46379,3578757679,3578757682,3
2,1423,46380,3578757679,3578757682,3
2,1423,46381,3578757679,3578757682,3
2,1423,46382,3578757679,3578757683,4
2,1423,46383,3578757679,3578757687,8
2,1423,46384,3578757679,3578757688,9
2,1423,46385,3578757679,3578757689,10
2,1423,46386,3578757679,3578757689,10
2,1423,46387,3578757679,3578757689,10
2,1423,46388,3578757679,3578757691,12
2,1423,46389,3578757679,3578757692,13
2,1423,46390,3578757679,3578757692,13
2,1423,46391,3578757679,3578757693,14
2,1423,46392,3578757679,3578757693,14
2,1423,46393,3578757679,3578757693,14
2,1423,46394,3578757679,3578757697,18
2,1423,46395,3578757679,3578757697,18
2,1423,46396,3578757679,3578757698,19
2,1423,46397,3578757679,3578757698,19
2,1423,46398,3578757679,3578757699,20
2,1423,46399,3578757679,3578757699,20
2,1423,46400,3578757679,3578757699,20
2,1423,46401,3578757679,3578757700,21
2,1423,46402,3578757679,3578757704,25
2,1423,46403,3578757679,3578757704,25
2,1423,46404,3578757679,3578757705,26
2,1423,46405,3578757679,3578757706,27
2,1423,46406,3578757679,3578757706,27
2,1423,46407,3578757679,3578757707,28
2,1423,46408,3578757679,3578757709,30
2,1423,46409,3578757679,3578757711,32
2,1423,46410,3578757679,3578757712,33
2,1423,46411,3578757679,3578757712,33
2,1423,46412,3578757679,3578757712,33
2,1423,46413,3578757679,3578757715,36
2,1423,46414,3578757679,3578757715,36
2,1423,46415,3578757679,3578757715,36
2,1423,46416,3578757679,3578757715,36
2,1423,46417,3578757679,3578757715,36
2,1423,46418,3578757679,3578757716,37
2,1423,46419,3578757679,3578757716,37
2,1423,46420,3578757679,3578757716,37
2,1423,46421,3578757679,3578757717,38
2,1423,46422,3578757679,3578757717,38
2,1423,46423,3578757679,3578757718,39
2,1423,46424,3578757679,3578757718,39
2,1423,46425,3578757679,3578757718,39
2,1423,46426,3578757679,3578757718,39
2,1423,46427,3578757679,3578757719,40
2,1423,46428,3578757679,3578757721,42
2,1423,46429,3578757679,3578757721,42
2,1423,46430,3578757679,3578757722,43
2,1423,46431,3578757679,3578757722,43
2,1423,46432,3578757679,3578757723,44
2,1423,46433,3578757679,3578757723,44
2,1423,46434,3578757679,3578757723,44
2,1423,46435,3578757679,3578757723,44
2,1423,46436,3578757679,3578757724,45
2,1423,46437,3578757679,3578757726,47
2,1423,46438,3578757679,3578757726,47
2,1423,46439,3578757679,3578757727,48
2,1423,46440,3578757679,3578757727,48
2,1424,46441,3578757743,3578757743,0
2,1424,46442,3578757743,3578757743,0
2,1424,46443,3578757743,3578757743,0
2,1424,46444,3578757743,3578757743,0
2,1424,46445,3578757743,3578757743,0
2,1424,46446,3578757743,3578757743,0
2,1424,46447,3578757743,3578757743,0
2,1424,46448,3578757743,3578757743,0
2,1424,46449,3578757743,3578757743,0
2,1424,46450,3578757743,3578757743,0
2,1424,46451,3578757743,3578757743,0
2,1424,46452,3578757743,3578757743,0
2,1424,46453,3578757743,3578757743,0
2,1424,46454,3578757743,3578757743,0
2,1424,46455,3578757743,3578757743,0
2,1424,46456,3578757743,3578757743,0
2,1424,46457,3578757743,3578757743,0
2,1424,46458,3578757743,3578757743,0
2,1424,46459,3578757743,3578757743,0
2,1424,46460,3578757743,3578757744,1
2,1424,46461,3578757743,3578757745,2
2,1424,46462,3578757743,3578757748,5
2,1424,46463,3578757743,3578757749,6
2,1424,46464,3578757743,3578757750,7
2,1424,46465,3578757743,3578757750,7
2,1424,46466,3578757743,3578757750,7
2,1424,46467,3578757743,3578757751,8
2,1424,46468,3578757743,3578757752,9
2,1424,46469,3578757743,3578757753,10
2,1424,46470,3578757743,3578757754,11
2,1424,46471,3578757743,3578757756,13
2,1424,46472,3578757743,3578757757,14
2,1424,46473,3578757743,3578757758,15
2,1424,46474,3578757743,3578757761,18
2,1424,46475,3578757743,3578757763,20
2,1424,46476,3578757743,3578757764,21
2,1424,46477,3578757743,3578757765,22
2,1424,46478,3578757743,3578757765,22
2,1424,46479,3578757743,3578757767,24
2,1424,46480,3578757743,3578757769,26
2,1424,46481,3578757743,3578757769,26
2,1424,46482,3578757743,3578757771,28
2,1424,46483,3578757743,3578757771,28
2,1424,46484,3578757743,3578757772,29
2,1424,46485,3578757743,3578757772,29
2,1424,46486,3578757743,3578757772,29
2,1424,46487,3578757743,3578757774,31
2,1424,46488,3578757743,3578757774,31
2,1424,46489,3578757743,3578757776,33
2,1424,46490,3578757743,3578757776,33
2,1424,46491,3578757743,3578757776,33
2,1424,46492,3578757743,3578757777,34
2,1424,46493,3578757743,3578757778,35
2,1424,46494,3578757743,3578757779,36
2,1424,46495,3578757743,3578757782,39
2,1424,46496,3578757743,3578757785,42
2,1424,46497,3578757743,3578757788,45
2,1424,46498,3578757743,3578757788,45
2,1424,46499,3578757743,3578757789,46
2,1424,46500,3578757743,3578757790,47
2,1424,46501,3578757743,3578757790,47
2,1424,46502,3578757743,3578757790,47
2,1424,46503,3578757743,3578757792,49
2,1424,46504,3578757743,3578757792,49
2,1424,46505,3578757743,3578757792,49
2,1424,46506,3578757743,3578757793,50
2,1425,46507,3578757805,3578757805,0
2,1425,46508,3578757805,3578757805,0
2,1425,46509,3578757805,3578757805,0
2,1425,46510,3578757805,3578757805,0
2,1425,46511,3578757805,3578757805,0
2,1425,46512,3578757805,3578757805,0
2,1425,46513,3578757805,3578757805,0
2,1425,46514,3578757805,3578757805,0
2,1425,46515,3578757805,3578757805,0
2,1425,46516,3578757805,3578757805,0
2,1425,46517,3578757805,3578757806,1
2,1425,46518,3578757805,3578757806,1
2,1425,46519,3578757805,3578757811,6
2,1425,46520,3578757805,3578757814,9
2,1425,46521,3578757805,3578757814,9
2,1425,46522,3578757805,3578757815,10
2,1425,46523,3578757805,3578757816,11
2,1425,46524,3578757805,3578757817,12
2,1425,46525,3578757805,3578757817,12
2,1425,46526,3578757805,3578757818,13
2,1425,46527,3578757805,3578757819,14
2,1425,46528,3578757805,3578757820,15
2,1425,46529,3578757805,3578757821,16
2,1425,46530,3578757805,3578757823,18
2,1425,46531,3578757805,3578757824,19
2,1425,46532,3578757805,3578757825,20
2,1425,46533,3578757805,3578757826,21
2,1425,46534,3578757805,3578757827,22
2,1425,46535,3578757805,3578757827,22
2,1425,46536,3578757805,3578757828,23
2,1425,46537,3578757805,3578757829,24
2,1425,46538,3578757805,3578757831,26
2,1425,46539,3578757805,3578757832,27
2,1425,46540,3578757805,3578757833,28
2,1425,46541,3578757805,3578757833,28
2,1425,46542,3578757805,3578757834,29
2,1425,46543,3578757805,3578757835,30
2,1425,46544,3578757805,3578757835,30
2,1425,46545,3578757805,3578757836,31
2,1425,46546,3578757805,3578757837,32
2,1425,46547,3578757805,3578757837,32
2,1425,46548,3578757805,3578757838,33
2,1425,46549,3578757805,3578757839,34
2,1425,46550,3578757805,3578757839,34
2,1425,46551,3578757805,3578757839,34
2,1425,46552,3578757805,3578757839,34
2,1425,46553,3578757805,3578757839,34
2,1425,46554,3578757805,3578757840,35
2,1425,46555,3578757805,3578757841,36
2,1425,46556,3578757805,3578757841,36
2,1425,46557,3578757805,3578757841,36
2,1425,46558,3578757805,3578757844,39
2,1425,46559,3578757805,3578757846,41
2,1425,46560,3578757805,3578757847,42
2,1425,46561,3578757805,3578757847,42
2,1425,46562,3578757805,3578757848,43
2,1425,46563,3578757805,3578757849,44
2,1425,46564,3578757805,3578757850,45
2,1425,46565,3578757805,3578757852,47
2,1425,46566,3578757805,3578757853,48
2,1425,46567,3578757805,3578757853,48
2,1425,46568,3578757805,3578757854,49
2,1425,46569,3578757805,3578757854,49
2,1425,46570,3578757805,3578757854,49
2,1425,46571,3578757805,3578757855,50
2,1426,46572,3578757868,3578757868,0
2,1426,46573,3578757868,3578757868,0
2,1426,46574,3578757868,3578757868,0
2,1426,46575,3578757868,3578757868,0
2,1426,46576,3578757868,3578757868,0
2,1426,46577,3578757868,3578757868,0
2,1426,46578,3578757868,3578757868,0
2,1426,46579,3578757868,3578757868,0
2,1426,46580,3578757868,3578757868,0
2,1426,46581,3578757868,3578757868,0
2,1426,46582,3578757868,3578757868,0
2,1426,46583,3578757868,3578757868,0
2,1426,46584,3578757868,3578757868,0
2,1426,46585,3578757868,3578757868,0
2,1426,46586,3578757868,3578757868,0
2,1426,46587,3578757868,3578757869,1
2,1426,46588,3578757868,3578757877,9
2,1426,46589,3578757868,3578757880,12
2,1426,46590,3578757868,3578757882,14
2,1426,46591,3578757868,3578757882,14
2,1426,46592,3578757868,3578757882,14
2,1426,46593,3578757868,3578757883,15
2,1426,46594,3578757868,3578757885,17
2,1426,46595,3578757868,3578757888,20
2,1426,46596,3578757868,3578757889,21
2,1426,46597,3578757868,3578757889,21
2,1426,46598,3578757868,3578757889,21
2,1426,46599,3578757868,3578757889,21
2,1426,46600,3578757868,3578757890,22
2,1426,46601,3578757868,3578757891,23
2,1426,46602,3578757868,3578757892,24
2,1426,46603,3578757868,3578757893,25
2,1426,46604,3578757868,3578757893,25
2,1426,46605,3578757868,3578757894,26
2,1426,46606,3578757868,3578757897,29
2,1426,46607,3578757868,3578757897,29
2,1426,46608,3578757868,3578757897,29
2,1426,46609,3578757868,3578757898,30
2,1426,46610,3578757868,3578757898,30
2,1426,46611,3578757868,3578757899,31
2,1426,46612,3578757868,3578757900,32
2,1426,46613,3578757868,3578757900,32
2,1426,46614,3578757868,3578757901,33
2,1426,46615,3578757868,3578757902,34
2,1426,46616,3578757868,3578757903,35
2,1426,46617,3578757868,3578757904,36
2,1426,46618,3578757868,3578757904,36
2,1426,46619,3578757868,3578757905,37
2,1426,46620,3578757868,3578757906,38
2,1426,46621,3578757868,3578757907,39
2,1426,46622,3578757868,3578757909,41
2,1426,46623,3578757868,3578757911,43
2,1426,46624,3578757868,3578757912,44
2,1426,46625,3578757868,3578757912,44
2,1426,46626,3578757868,3578757912,44
2,1426,46627,3578757868,3578757913,45
2,1426,46628,3578757868,3578757915,47
2,1426,46629,3578757868,3578757915,47
2,1426,46630,3578757868,3578757915,47
2,1426,46631,3578757868,3578757915,47
2,1426,46632,3578757868,3578757915,47
2,1426,46633,3578757868,3578757916,48
2,1426,46634,3578757868,3578757916,48
2,1426,46635,3578757868,3578757917,49
2,1426,46636,3578757868,3578757917,49
2,1426,46637,3578757868,3578757917,49
2,1426,46638,3578757868,3578757917,49
2,1426,46639,3578757868,3578757918,50
2,1427,46640,3578757931,3578757931,0
2,1427,46641,3578757931,3578757931,0
2,1427,46642,3578757931,3578757931,0
2,1427,46643,3578757931,3578757931,0
2,1427,46644,3578757931,3578757931,0
2,1427,46645,3578757931,3578757931,0
2,1427,46646,3578757931,3578757931,0
2,1427,46647,3578757931,3578757931,0
2,1427,46648,3578757931,3578757931,0
2,1427,46649,3578757931,3578757931,0
2,1427,46650,3578757931,3578757931,0
2,1427,46651,3578757931,3578757931,0
2,1427,46652,3578757931,3578757931,0
2,1427,46653,3578757931,3578757931,0
2,1427,46654,3578757931,3578757931,0
2,1427,46655,3578757931,3578757931,0
2,1427,46656,3578757931,3578757931,0
2,1427,46657,3578757931,3578757931,0
2,1427,46658,3578757931,3578757932,1
2,1427,46659,3578757931,3578757933,2
2,1427,46660,3578757931,3578757933,2
2,1427,46661,3578757931,3578757934,3
2,1427,46662,3578757931,3578757935,4
2,1427,46663,3578757931,3578757936,5
2,1427,46664,3578757931,3578757936,5
2,1427,46665,3578757931,3578757936,5
2,1427,46666,3578757931,3578757937,6
2,1427,46667,3578757931,3578757937,6
2,1427,46668,3578757931,3578757938,7
2,1427,46669,3578757931,3578757938,7
2,1427,46670,3578757931,3578757938,7
2,1427,46671,3578757931,3578757939,8
2,1427,46672,3578757931,3578757939,8
2,1427,46673,3578757931,3578757939,8
2,1427,46674,3578757931,3578757939,8
2,1427,46675,3578757931,3578757941,10
2,1427,46676,3578757931,3578757942,11
2,1427,46677,3578757931,3578757943,12
2,1427,46678,3578757931,3578757944,13
2,1427,46679,3578757931,3578757945,14
2,1427,46680,3578757931,3578757948,17
2,1427,46681,3578757931,3578757950,19
2,1427,46682,3578757931,3578757950,19
2,1427,46683,3578757931,3578757950,19
2,1427,46684,3578757931,3578757950,19
2,1427,46685,3578757931,3578757951,20
2,1427,46686,3578757931,3578757952,21
2,1427,46687,3578757931,3578757953,22
2,1427,46688,3578757931,3578757953,22
2,1427,46689,3578757931,3578757955,24
2,1427,46690,3578757931,3578757956,25
2,1427,46691,3578757931,3578757956,25
2,1427,46692,3578757931,3578757957,26
2,1427,46693,3578757931,3578757958,27
2,1427,46694,3578757931,3578757961,30
2,1427,46695,3578757931,3578757964,33
2,1427,46696,3578757931,3578757964,33
2,1427,46697,3578757931,3578757964,33
2,1427,46698,3578757931,3578757965,34
2,1427,46699,3578757931,3578757966,35
2,1427,46700,3578757931,3578757966,35
2,1427,46701,3578757931,3578757967,36
2,1427,46702,3578757931,3578757969,38
2,1427,46703,3578757931,3578757969,38
2,1427,46704,3578757931,3578757970,39
2,1427,46705,3578757931,3578757972,41
2,1427,46706,3578757931,3578757972,41
2,1427,46707,3578757931,3578757973,42
2,1427,46708,3578757931,3578757974,43
2,1427,46709,3578757931,3578757974,43
2,1427,46710,3578757931,3578757976,45
2,1427,46711,3578757931,3578757976,45
2,1427,46712,3578757931,3578757976,45
2,1427,46713,3578757931,3578757977,46
2,1427,46714,3578757931,3578757980,49
2,1428,46715,3578757995,3578757995,0
2,1428,46716,3578757995,3578757995,0
2,1428,46717,3578757995,3578757995,0
2,1428,46718,3578757995,3578757995,0
2,1428,46719,3578757995,3578757995,0
2,1428,46720,3578757995,3578757995,0
2,1428,46721,3578757995,3578757995,0
2,1428,46722,3578757995,3578757995,0
2,1428,46723,3578757995,3578757995,0
2,1428,46724,3578757995,3578757995,0
2,1428,46725,3578757995,3578757995,0
2,1428,46726,3578757995,3578757995,0
2,1428,46727,3578757995,3578757995,0
2,1428,46728,3578757995,3578757995,0
2,1428,46729,3578757995,3578757997,2
2,1428,46730,3578757995,3578757998,3
2,1428,46731,3578757995,3578757999,4
2,1428,46732,3578757995,3578758000,5
2,1428,46733,3578757995,3578758000,5
2,1428,46734,3578757995,3578758002,7
2,1428,46735,3578757995,3578758003,8
2,1428,46736,3578757995,3578758004,9
2,1428,46737,3578757995,3578758004,9
2,1428,46738,3578757995,3578758006,11
2,1428,46739,3578757995,3578758011,16
2,1428,46740,3578757995,3578758012,17
2,1428,46741,3578757995,3578758014,19
2,1428,46742,3578757995,3578758015,20
2,1428,46743,3578757995,3578758015,20
2,1428,46744,3578757995,3578758015,20
2,1428,46745,3578757995,3578758016,21
2,1428,46746,3578757995,3578758017,22
2,1428,46747,3578757995,3578758017,22
2,1428,46748,3578757995,3578758018,23
2,1428,46749,3578757995,3578758018,23
2,1428,46750,3578757995,3578758020,25
2,1428,46751,3578757995,3578758022,27
2,1428,46752,3578757995,3578758024,29
2,1428,46753,3578757995,3578758025,30
2,1428,46754,3578757995,3578758026,31
2,1428,46755,3578757995,3578758027,32
2,1428,46756,3578757995,3578758028,33
2,1428,46757,3578757995,3578758029,34
2,1428,46758,3578757995,3578758029,34
2,1428,46759,3578757995,3578758032,37
2,1428,46760,3578757995,3578758032,37
2,1428,46761,3578757995,3578758032,37
2,1428,46762,3578757995,3578758033,38
2,1428,46763,3578757995,3578758034,39
2,1428,46764,3578757995,3578758036,41
2,1428,46765,3578757995,3578758036,41
2,1428,46766,3578757995,3578758037,42
2,1428,46767,3578757995,3578758037,42
2,1428,46768,3578757995,3578758038,43
2,1428,46769,3578757995,3578758038,43
2,1428,46770,3578757995,3578758039,44
2,1428,46771,3578757995,3578758039,44
2,1428,46772,3578757995,3578758039,44
2,1428,46773,3578757995,3578758040,45
2,1428,46774,3578757995,3578758041,46
2,1428,46775,3578757995,3578758041,46
2,1428,46776,3578757995,3578758041,46
2,1428,46777,3578757995,3578758042,47
2,1428,46778,3578757995,3578758043,48
2,1428,46779,3578757995,3578758044,49
2,1429,46780,3578758059,3578758059,0
2,1429,46781,3578758059,3578758059,0
2,1429,46782,3578758059,3578758059,0
2,1429,46783,3578758059,3578758059,0
2,1429,46784,3578758059,3578758059,0
2,1429,46785,3578758059,3578758059,0
2,1429,46786,3578758059,3578758059,0
2,1429,46787,3578758059,3578758059,0
2,1429,46788,3578758059,3578758059,0
2,1429,46789,3578758059,3578758059,0
2,1429,46790,3578758059,3578758059,0
2,1429,46791,3578758059,3578758059,0
2,1429,46792,3578758059,3578758059,0
2,1429,46793,3578758059,3578758059,0
2,1429,46794,3578758059,3578758059,0
2,1429,46795,3578758059,3578758059,0
2,1429,46796,3578758059,3578758059,0
2,1429,46797,3578758059,3578758059,0
2,1429,46798,3578758059,3578758059,0
2,1429,46799,3578758059,3578758059,0
2,1429,46800,3578758059,3578758059,0
2,1429,46801,3578758059,3578758059,0
2,1429,46802,3578758059,3578758060,1
2,1429,46803,3578758059,3578758061,2
2,1429,46804,3578758059,3578758062,3
2,1429,46805,3578758059,3578758065,6
2,1429,46806,3578758059,3578758066,7
2,1429,46807,3578758059,3578758066,7
2,1429,46808,3578758059,3578758067,8
2,1429,46809,3578758059,3578758067,8
2,1429,46810,3578758059,3578758068,9
2,1429,46811,3578758059,3578758069,10
2,1429,46812,3578758059,3578758076,17
2,1429,46813,3578758059,3578758081,22
2,1429,46814,3578758059,3578758082,23
2,1429,46815,3578758059,3578758082,23
2,1429,46816,3578758059,3578758083,24
2,1429,46817,3578758059,3578758083,24
2,1429,46818,3578758059,3578758085,26
2,1429,46819,3578758059,3578758089,30
2,1429,46820,3578758059,3578758089,30
2,1429,46821,3578758059,3578758089,30
2,1429,46822,3578758059,3578758090,31
2,1429,46823,3578758059,3578758091,32
2,1429,46824,3578758059,3578758092,33
2,1429,46825,3578758059,3578758092,33
2,1429,46826,3578758059,3578758092,33
2,1429,46827,3578758059,3578758093,34
2,1429,46828,3578758059,3578758095,36
2,1429,46829,3578758059,3578758096,37
2,1429,46830,3578758059,3578758098,39
2,1429,46831,3578758059,3578758098,39
2,1429,46832,3578758059,3578758098,39
2,1429,46833,3578758059,3578758099,40
2,1429,46834,3578758059,3578758100,41
2,1429,46835,3578758059,3578758100,41
2,1429,46836,3578758059,3578758101,42
2,1429,46837,3578758059,3578758102,43
2,1429,46838,3578758059,3578758103,44
2,1429,46839,3578758059,3578758103,44
2,1429,46840,3578758059,3578758103,44
2,1429,46841,3578758059,3578758104,45
2,1429,46842,3578758059,3578758104,45
2,1429,46843,3578758059,3578758105,46
2,1429,46844,3578758059,3578758107,48
2,1430,46845,3578758123,3578758123,0
2,1430,46846,3578758123,3578758123,0
2,1430,46847,3578758123,3578758123,0
2,1430,46848,3578758123,3578758123,0
2,1430,46849,3578758123,3578758123,0
2,1430,46850,3578758123,3578758123,0
2,1430,46851,3578758123,3578758123,0
2,1430,46852,3578758123,3578758123,0
2,1430,46853,3578758123,3578758123,0
2,1430,46854,3578758123,3578758123,0
2,1430,46855,3578758123,3578758123,0
2,1430,46856,3578758123,3578758123,0
2,1430,46857,3578758123,3578758123,0
2,1430,46858,3578758123,3578758123,0
2,1430,46859,3578758123,3578758123,0
2,1430,46860,3578758123,3578758123,0
2,1430,46861,3578758123,3578758123,0
2,1430,46862,3578758123,3578758123,0
2,1430,46863,3578758123,3578758123,0
2,1430,46864,3578758123,3578758123,0
2,1430,46865,3578758123,3578758123,0
2,1430,46866,3578758123,3578758123,0
2,1430,46867,3578758123,3578758123,0
2,1430,46868,3578758123,3578758123,0
2,1430,46869,3578758123,3578758123,0
2,1430,46870,3578758123,3578758123,0
2,1430,46871,3578758123,3578758123,0
2,1430,46872,3578758123,3578758123,0
2,1430,46873,3578758123,3578758124,1
2,1430,46874,3578758123,3578758125,2
2,1430,46875,3578758123,3578758126,3
2,1430,46876,3578758123,3578758126,3
2,1430,46877,3578758123,3578758127,4
2,1430,46878,3578758123,3578758128,5
2,1430,46879,3578758123,3578758132,9
2,1430,46880,3578758123,3578758132,9
2,1430,46881,3578758123,3578758133,10
2,1430,46882,3578758123,3578758134,11
2,1430,46883,3578758123,3578758135,12
2,1430,46884,3578758123,3578758135,12
2,1430,46885,3578758123,3578758136,13
2,1430,46886,3578758123,3578758137,14
2,1430,46887,3578758123,3578758137,14
2,1430,46888,3578758123,3578758138,15
2,1430,46889,3578758123,3578758138,15
2,1430,46890,3578758123,3578758138,15
2,1430,46891,3578758123,3578758138,15
2,1430,46892,3578758123,3578758139,16
2,1430,46893,3578758123,3578758139,16
2,1430,46894,3578758123,3578758140,17
2,1430,46895,3578758123,3578758142,19
2,1430,46896,3578758123,3578758143,20
2,1430,46897,3578758123,3578758143,20
2,1430,46898,3578758123,3578758144,21
2,1430,46899,3578758123,3578758145,22
2,1430,46900,3578758123,3578758148,25
2,1430,46901,3578758123,3578758150,27
2,1430,46902,3578758123,3578758150,27
2,1430,46903,3578758123,3578758151,28
2,1430,46904,3578758123,3578758151,28
2,1430,46905,3578758123,3578758153,30
2,1430,46906,3578758123,3578758153,30
2,1430,46907,3578758123,3578758154,31
2,1430,46908,3578758123,3578758155,32
2,1430,46909,3578758123,3578758155,32
2,1430,46910,3578758123,3578758157,34
2,1430,46911,3578758123,3578758157,34
2,1430,46912,3578758123,3578758157,34
2,1430,46913,3578758123,3578758157,34
2,1430,46914,3578758123,3578758162,39
2,1430,46915,3578758123,3578758164,41
2,1430,46916,3578758123,3578758164,41
2,1430,46917,3578758123,3578758165,42
2,1430,46918,3578758123,3578758165,42
2,1430,46919,3578758123,3578758166,43
2,1430,46920,3578758123,3578758166,43
2,1430,46921,3578758123,3578758168,45
2,1430,46922,3578758123,3578758168,45
2,1430,46923,3578758123,3578758169,46
2,1430,46924,3578758123,3578758170,47
2,1430,46925,3578758123,3578758171,48
2,1430,46926,3578758123,3578758172,49
2,1430,46927,3578758123,3578758172,49
2,1430,46928,3578758123,3578758173,50
2,1431,46929,3578758185,3578758185,0
2,1431,46930,3578758185,3578758185,0
2,1431,46931,3578758185,3578758185,0
2,1431,46932,3578758185,3578758185,0
2,1431,46933,3578758185,3578758185,0
2,1431,46934,3578758185,3578758185,0
2,1431,46935,3578758185,3578758185,0
2,1431,46936,3578758185,3578758185,0
2,1431,46937,3578758185,3578758185,0
2,1431,46938,3578758185,3578758186,1
2,1431,46939,3578758185,3578758189,4
2,1431,46940,3578758185,3578758189,4
2,1431,46941,3578758185,3578758190,5
2,1431,46942,3578758185,3578758191,6
2,1431,46943,3578758185,3578758192,7
2,1431,46944,3578758185,3578758192,7
2,1431,46945,3578758185,3578758193,8
2,1431,46946,3578758185,3578758194,9
2,1431,46947,3578758185,3578758194,9
2,1431,46948,3578758185,3578758197,12
2,1431,46949,3578758185,3578758198,13
2,1431,46950,3578758185,3578758198,13
2,1431,46951,3578758185,3578758200,15
2,1431,46952,3578758185,3578758202,17
2,1431,46953,3578758185,3578758203,18
2,1431,46954,3578758185,3578758204,19
2,1431,46955,3578758185,3578758204,19
2,1431,46956,3578758185,3578758204,19
2,1431,46957,3578758185,3578758206,21
2,1431,46958,3578758185,3578758207,22
2,1431,46959,3578758185,3578758211,26
2,1431,46960,3578758185,3578758212,27
2,1431,46961,3578758185,3578758215,30
2,1431,46962,3578758185,3578758215,30
2,1431,46963,3578758185,3578758215,30
2,1431,46964,3578758185,3578758216,31
2,1431,46965,3578758185,3578758217,32
2,1431,46966,3578758185,3578758217,32
2,1431,46967,3578758185,3578758217,32
2,1431,46968,3578758185,3578758217,32
2,1431,46969,3578758185,3578758219,34
2,1431,46970,3578758185,3578758220,35
2,1431,46971,3578758185,3578758222,37
2,1431,46972,3578758185,3578758224,39
2,1431,46973,3578758185,3578758225,40
2,1431,46974,3578758185,3578758227,42
2,1431,46975,3578758185,3578758227,42
2,1431,46976,3578758185,3578758228,43
2,1431,46977,3578758185,3578758228,43
2,1431,46978,3578758185,3578758228,43
2,1431,46979,3578758185,3578758229,44
2,1431,46980,3578758185,3578758232,47
2,1431,46981,3578758185,3578758232,47
2,1431,46982,3578758185,3578758233,48
2,1431,46983,3578758185,3578758233,48
2,1431,46984,3578758185,3578758234,49
2,1432,46985,3578758248,3578758248,0
2,1432,46986,3578758248,3578758248,0
2,1432,46987,3578758248,3578758248,0
2,1432,46988,3578758248,3578758248,0
2,1432,46989,3578758248,3578758248,0
2,1432,46990,3578758248,3578758248,0
2,1432,46991,3578758248,3578758248,0
2,1432,46992,3578758248,3578758248,0
2,1432,46993,3578758248,3578758248,0
2,1432,46994,3578758248,3578758248,0
2,1432,46995,3578758248,3578758248,0
2,1432,46996,3578758248,3578758248,0
2,1432,46997,3578758248,3578758248,0
2,1432,46998,3578758248,3578758248,0
2,1432,46999,3578758248,3578758248,0
2,1432,47000,3578758248,3578758248,0
2,1432,47001,3578758248,3578758248,0
2,1432,47002,3578758248,3578758248,0
2,1432,47003,3578758248,3578758248,0
2,1432,47004,3578758248,3578758248,0
2,1432,47005,3578758248,3578758248,0
2,1432,47006,3578758248,3578758249,1
2,1432,47007,3578758248,3578758249,1
2,1432,47008,3578758248,3578758251,3
2,1432,47009,3578758248,3578758252,4
2,1432,47010,3578758248,3578758252,4
2,1432,47011,3578758248,3578758253,5
2,1432,47012,3578758248,3578758254,6
2,1432,47013,3578758248,3578758254,6
2,1432,47014,3578758248,3578758254,6
2,1432,47015,3578758248,3578758255,7
2,1432,47016,3578758248,3578758255,7
2,1432,47017,3578758248,3578758256,8
2,1432,47018,3578758248,3578758256,8
2,1432,47019,3578758248,3578758257,9
2,1432,47020,3578758248,3578758257,9
2,1432,47021,3578758248,3578758258,10
2,1432,47022,3578758248,3578758258,10
2,1432,47023,3578758248,3578758260,12
2,1432,47024,3578758248,3578758261,13
2,1432,47025,3578758248,3578758262,14
2,1432,47026,3578758248,3578758265,17
2,1432,47027,3578758248,3578758265,17
2,1432,47028,3578758248,3578758266,18
2,1432,47029,3578758248,3578758268,20
2,1432,47030,3578758248,3578758268,20
2,1432,47031,3578758248,3578758269,21
2,1432,47032,3578758248,3578758276,28
2,1432,47033,3578758248,3578758281,33
2,1432,47034,3578758248,3578758282,34
2,1432,47035,3578758248,3578758282,34
2,1432,47036,3578758248,3578758283,35
2,1432,47037,3578758248,3578758284,36
2,1432,47038,3578758248,3578758285,37
2,1432,47039,3578758248,3578758289,41
2,1432,47040,3578758248,3578758289,41
2,1432,47041,3578758248,3578758289,41
2,1432,47042,3578758248,3578758290,42
2,1432,47043,3578758248,3578758291,43
2,1432,47044,3578758248,3578758292,44
2,1432,47045,3578758248,3578758292,44
2,1432,47046,3578758248,3578758293,45
2,1432,47047,3578758248,3578758293,45
2,1432,47048,3578758248,3578758294,46
2,1432,47049,3578758248,3578758295,47
2,1432,47050,3578758248,3578758297,49
2,1432,47051,3578758248,3578758297,49
2,1432,47052,3578758248,3578758298,50
2,1433,47053,3578758311,3578758311,0
2,1433,47054,3578758311,3578758311,0
2,1433,47055,3578758311,3578758311,0
2,1433,47056,3578758311,3578758311,0
2,1433,47057,3578758311,3578758311,0
2,1433,47058,3578758311,3578758311,0
2,1433,47059,3578758311,3578758311,0
2,1433,47060,3578758311,3578758311,0
2,1433,47061,3578758311,3578758311,0
2,1433,47062,3578758311,3578758311,0
2,1433,47063,3578758311,3578758311,0
2,1433,47064,3578758311,3578758311,0
2,1433,47065,3578758311,3578758311,0
2,1433,47066,3578758311,3578758311,0
2,1433,47067,3578758311,3578758311,0
2,1433,47068,3578758311,3578758311,0
2,1433,47069,3578758311,3578758312,1
2,1433,47070,3578758311,3578758312,1
2,1433,47071,3578758311,3578758312,1
2,1433,47072,3578758311,3578758313,2
2,1433,47073,3578758311,3578758315,4
2,1433,47074,3578758311,3578758315,4
2,1433,47075,3578758311,3578758315,4
2,1433,47076,3578758311,3578758315,4
2,1433,47077,3578758311,3578758316,5
2,1433,47078,3578758311,3578758316,5
2,1433,47079,3578758311,3578758316,5
2,1433,47080,3578758311,3578758318,7
2,1433,47081,3578758311,3578758318,7
2,1433,47082,3578758311,3578758318,7
2,1433,47083,3578758311,3578758318,7
2,1433,47084,3578758311,3578758318,7
2,1433,47085,3578758311,3578758318,7
2,1433,47086,3578758311,3578758319,8
2,1433,47087,3578758311,3578758319,8
2,1433,47088,3578758311,3578758321,10
2,1433,47089,3578758311,3578758321,10
2,1433,47090,3578758311,3578758322,11
2,1433,47091,3578758311,3578758322,11
2,1433,47092,3578758311,3578758322,11
2,1433,47093,3578758311,3578758322,11
2,1433,47094,3578758311,3578758323,12
2,1433,47095,3578758311,3578758324,13
2,1433,47096,3578758311,3578758326,15
2,1433,47097,3578758311,3578758326,15
2,1433,47098,3578758311,3578758326,15
2,1433,47099,3578758311,3578758327,16
2,1433,47100,3578758311,3578758328,17
2,1433,47101,3578758311,3578758332,21
2,1433,47102,3578758311,3578758333,22
2,1433,47103,3578758311,3578758333,22
2,1433,47104,3578758311,3578758334,23
2,1433,47105,3578758311,3578758335,24
2,1433,47106,3578758311,3578758336,25
2,1433,47107,3578758311,3578758337,26
2,1433,47108,3578758311,3578758337,26
2,1433,47109,3578758311,3578758338,27
2,1433,47110,3578758311,3578758338,27
2,1433,47111,3578758311,3578758338,27
2,1433,47112,3578758311,3578758338,27
2,1433,47113,3578758311,3578758339,28
2,1433,47114,3578758311,3578758339,28
2,1433,47115,3578758311,3578758339,28
2,1433,47116,3578758311,3578758340,29
2,1433,47117,3578758311,3578758340,29
2,1433,47118,3578758311,3578758342,31
2,1433,47119,3578758311,3578758343,32
2,1433,47120,3578758311,3578758343,32
2,1433,47121,3578758311,3578758344,33
2,1433,47122,3578758311,3578758345,34
2,1433,47123,3578758311,3578758348,37
2,1433,47124,3578758311,3578758350,39
2,1433,47125,3578758311,3578758350,39
2,1433,47126,3578758311,3578758350,39
2,1433,47127,3578758311,3578758350,39
2,1433,47128,3578758311,3578758351,40
2,1433,47129,3578758311,3578758352,41
2,1433,47130,3578758311,3578758352,41
2,1433,47131,3578758311,3578758353,42
2,1433,47132,3578758311,3578758354,43
2,1433,47133,3578758311,3578758355,44
2,1433,47134,3578758311,3578758356,45
2,1433,47135,3578758311,3578758357,46
2,1433,47136,3578758311,3578758357,46
2,1433,47137,3578758311,3578758357,46
2,1433,47138,3578758311,3578758357,46
2,1433,47139,3578758311,3578758362,51
2,1434,47140,3578758375,3578758375,0
2,1434,47141,3578758375,3578758375,0
2,1434,47142,3578758375,3578758375,0
2,1434,47143,3578758375,3578758375,0
2,1434,47144,3578758375,3578758375,0
2,1434,47145,3578758375,3578758375,0
2,1434,47146,3578758375,3578758375,0
2,1434,47147,3578758375,3578758375,0
2,1434,47148,3578758375,3578758375,0
2,1434,47149,3578758375,3578758375,0
2,1434,47150,3578758375,3578758375,0
2,1434,47151,3578758375,3578758375,0
2,1434,47152,3578758375,3578758375,0
2,1434,47153,3578758375,3578758375,0
2,1434,47154,3578758375,3578758375,0
2,1434,47155,3578758375,3578758376,1
2,1434,47156,3578758375,3578758376,1
2,1434,47157,3578758375,3578758377,2
2,1434,47158,3578758375,3578758377,2
2,1434,47159,3578758375,3578758379,4
2,1434,47160,3578758375,3578758383,8
2,1434,47161,3578758375,3578758385,10
2,1434,47162,3578758375,3578758389,14
2,1434,47163,3578758375,3578758389,14
2,1434,47164,3578758375,3578758390,15
2,1434,47165,3578758375,3578758391,16
2,1434,47166,3578758375,3578758392,17
2,1434,47167,3578758375,3578758393,18
2,1434,47168,3578758375,3578758394,19
2,1434,47169,3578758375,3578758394,19
2,1434,47170,3578758375,3578758394,19
2,1434,47171,3578758375,3578758397,22
2,1434,47172,3578758375,3578758398,23
2,1434,47173,3578758375,3578758399,24
2,1434,47174,3578758375,3578758400,25
2,1434,47175,3578758375,3578758402,27
2,1434,47176,3578758375,3578758403,28
2,1434,47177,3578758375,3578758403,28
2,1434,47178,3578758375,3578758404,29
2,1434,47179,3578758375,3578758405,30
2,1434,47180,3578758375,3578758405,30
2,1434,47181,3578758375,3578758406,31
2,1434,47182,3578758375,3578758406,31
2,1434,47183,3578758375,3578758406,31
2,1434,47184,3578758375,3578758411,36
2,1434,47185,3578758375,3578758412,37
2,1434,47186,3578758375,3578758414,39
2,1434,47187,3578758375,3578758415,40
2,1434,47188,3578758375,3578758415,40
2,1434,47189,3578758375,3578758416,41
2,1434,47190,3578758375,3578758417,42
2,1434,47191,3578758375,3578758417,42
2,1434,47192,3578758375,3578758418,43
2,1434,47193,3578758375,3578758418,43
2,1434,47194,3578758375,3578758420,45
2,1434,47195,3578758375,3578758421,46
2,1434,47196,3578758375,3578758422,47
2,1434,47197,3578758375,3578758424,49
2,1434,47198,3578758375,3578758425,50
2,1435,47199,3578758437,3578758437,0
2,1435,47200,3578758437,3578758437,0
2,1435,47201,3578758437,3578758437,0
2,1435,47202,3578758437,3578758437,0
2,1435,47203,3578758437,3578758437,0
2,1435,47204,3578758437,3578758437,0
2,1435,47205,3578758437,3578758437,0
2,1435,47206,3578758437,3578758437,0
2,1435,47207,3578758437,3578758437,0
2,1435,47208,3578758437,3578758437,0
2,1435,47209,3578758437,3578758437,0
2,1435,47210,3578758437,3578758437,0
2,1435,47211,3578758437,3578758437,0
2,1435,47212,3578758437,3578758438,1
2,1435,47213,3578758437,3578758438,1
2,1435,47214,3578758437,3578758439,2
2,1435,47215,3578758437,3578758439,2
2,1435,47216,3578758437,3578758439,2
2,1435,47217,3578758437,3578758439,2
2,1435,47218,3578758437,3578758440,3
2,1435,47219,3578758437,3578758440,3
2,1435,47220,3578758437,3578758441,4
2,1435,47221,3578758437,3578758441,4
2,1435,47222,3578758437,3578758442,5
2,1435,47223,3578758437,3578758442,5
2,1435,47224,3578758437,3578758443,6
2,1435,47225,3578758437,3578758446,9
2,1435,47226,3578758437,3578758446,9
2,1435,47227,3578758437,3578758446,9
2,1435,47228,3578758437,3578758447,10
2,1435,47229,3578758437,3578758449,12
2,1435,47230,3578758437,3578758449,12
2,1435,47231,3578758437,3578758452,15
2,1435,47232,3578758437,3578758452,15
2,1435,47233,3578758437,3578758453,16
2,1435,47234,3578758437,3578758454,17
2,1435,47235,3578758437,3578758455,18
2,1435,47236,3578758437,3578758455,18
2,1435,47237,3578758437,3578758456,19
2,1435,47238,3578758437,3578758456,19
2,1435,47239,3578758437,3578758456,19
2,1435,47240,3578758437,3578758456,19
2,1435,47241,3578758437,3578758457,20
2,1435,47242,3578758437,3578758457,20
2,1435,47243,3578758437,3578758458,21
2,1435,47244,3578758437,3578758458,21
2,1435,47245,3578758437,3578758458,21
2,1435,47246,3578758437,3578758460,23
2,1435,47247,3578758437,3578758460,23
2,1435,47248,3578758437,3578758461,24
2,1435,47249,3578758437,3578758465,28
2,1435,47250,3578758437,3578758465,28
2,1435,47251,3578758437,3578758465,28
2,1435,47252,3578758437,3578758468,31
2,1435,47253,3578758437,3578758468,31
2,1435,47254,3578758437,3578758470,33
2,1435,47255,3578758437,3578758471,34
2,1435,47256,3578758437,3578758476,39
2,1435,47257,3578758437,3578758481,44
2,1435,47258,3578758437,3578758482,45
2,1435,47259,3578758437,3578758483,46
2,1435,47260,3578758437,3578758483,46
2,1435,47261,3578758437,3578758484,47
2,1435,47262,3578758437,3578758485,48
2,1436,47263,3578758500,3578758500,0
2,1436,47264,3578758500,3578758500,0
2,1436,47265,3578758500,3578758500,0
2,1436,47266,3578758500,3578758500,0
2,1436,47267,3578758500,3578758500,0
2,1436,47268,3578758500,3578758500,0
2,1436,47269,3578758500,3578758500,0
2,1436,47270,3578758500,3578758500,0
2,1436,47271,3578758500,3578758500,0
2,1436,47272,3578758500,3578758500,0
2,1436,47273,3578758500,3578758500,0
2,1436,47274,3578758500,3578758500,0
2,1436,47275,3578758500,3578758500,0
2,1436,47276,3578758500,3578758500,0
2,1436,47277,3578758500,3578758500,0
2,1436,47278,3578758500,3578758500,0
2,1436,47279,3578758500,3578758500,0
2,1436,47280,3578758500,3578758501,1
2,1436,47281,3578758500,3578758502,2
2,1436,47282,3578758500,3578758502,2
2,1436,47283,3578758500,3578758502,2
2,1436,47284,3578758500,3578758504,4
2,1436,47285,3578758500,3578758504,4
2,1436,47286,3578758500,3578758505,5
2,1436,47287,3578758500,3578758506,6
2,1436,47288,3578758500,3578758506,6
2,1436,47289,3578758500,3578758508,8
2,1436,47290,3578758500,3578758510,10
2,1436,47291,3578758500,3578758510,10
2,1436,47292,3578758500,3578758511,11
2,1436,47293,3578758500,3578758511,11
2,1436,47294,3578758500,3578758511,11
2,1436,47295,3578758500,3578758514,14
2,1436,47296,3578758500,3578758514,14
2,1436,47297,3578758500,3578758515,15
2,1436,47298,3578758500,3578758515,15
2,1436,47299,3578758500,3578758515,15
2,1436,47300,3578758500,3578758515,15
2,1436,47301,3578758500,3578758516,16
2,1436,47302,3578758500,3578758516,16
2,1436,47303,3578758500,3578758517,17
2,1436,47304,3578758500,3578758517,17
2,1436,47305,3578758500,3578758517,17
2,1436,47306,3578758500,3578758517,17
2,1436,47307,3578758500,3578758518,18
2,1436,47308,3578758500,3578758518,18
2,1436,47309,3578758500,3578758518,18
2,1436,47310,3578758500,3578758520,20
2,1436,47311,3578758500,3578758521,21
2,1436,47312,3578758500,3578758521,21
2,1436,47313,3578758500,3578758521,21
2,1436,47314,3578758500,3578758521,21
2,1436,47315,3578758500,3578758522,22
2,1436,47316,3578758500,3578758522,22
2,1436,47317,3578758500,3578758524,24
2,1436,47318,3578758500,3578758525,25
2,1436,47319,3578758500,3578758525,25
2,1436,47320,3578758500,3578758525,25
2,1436,47321,3578758500,3578758526,26
2,1436,47322,3578758500,3578758527,27
2,1436,47323,3578758500,3578758531,31
2,1436,47324,3578758500,3578758531,31
2,1436,47325,3578758500,3578758532,32
2,1436,47326,3578758500,3578758532,32
2,1436,47327,3578758500,3578758533,33
2,1436,47328,3578758500,3578758534,34
2,1436,47329,3578758500,3578758535,35
2,1436,47330,3578758500,3578758536,36
2,1436,47331,3578758500,3578758536,36
2,1436,47332,3578758500,3578758536,36
2,1436,47333,3578758500,3578758537,37
2,1436,47334,3578758500,3578758538,38
2,1436,47335,3578758500,3578758538,38
2,1436,47336,3578758500,3578758538,38
2,1436,47337,3578758500,3578758538,38
2,1436,47338,3578758500,3578758538,38
2,1436,47339,3578758500,3578758539,39
2,1436,47340,3578758500,3578758539,39
2,1436,47341,3578758500,3578758541,41
2,1436,47342,3578758500,3578758542,42
2,1436,47343,3578758500,3578758543,43
2,1436,47344,3578758500,3578758544,44
2,1436,47345,3578758500,3578758544,44
2,1436,47346,3578758500,3578758547,47
2,1436,47347,3578758500,3578758549,49
2,1436,47348,3578758500,3578758549,49
2,1436,47349,3578758500,3578758550,50
2,1437,47350,3578758565,3578758565,0
2,1437,47351,3578758565,3578758565,0
2,1437,47352,3578758565,3578758565,0
2,1437,47353,3578758565,3578758565,0
2,1437,47354,3578758565,3578758565,0
2,1437,47355,3578758565,3578758565,0
2,1437,47356,3578758565,3578758565,0
2,1437,47357,3578758565,3578758565,0
2,1437,47358,3578758565,3578758565,0
2,1437,47359,3578758565,3578758565,0
2,1437,47360,3578758565,3578758565,0
2,1437,47361,3578758565,3578758565,0
2,1437,47362,3578758565,3578758565,0
2,1437,47363,3578758565,3578758565,0
2,1437,47364,3578758565,3578758565,0
2,1437,47365,3578758565,3578758565,0
2,1437,47366,3578758565,3578758566,1
2,1437,47367,3578758565,3578758566,1
2,1437,47368,3578758565,3578758567,2
2,1437,47369,3578758565,3578758569,4
2,1437,47370,3578758565,3578758569,4
2,1437,47371,3578758565,3578758569,4
2,1437,47372,3578758565,3578758571,6
2,1437,47373,3578758565,3578758572,7
2,1437,47374,3578758565,3578758572,7
2,1437,47375,3578758565,3578758573,8
2,1437,47376,3578758565,3578758575,10
2,1437,47377,3578758565,3578758575,10
2,1437,47378,3578758565,3578758575,10
2,1437,47379,3578758565,3578758576,11
2,1437,47380,3578758565,3578758578,13
2,1437,47381,3578758565,3578758579,14
2,1437,47382,3578758565,3578758579,14
2,1437,47383,3578758565,3578758582,17
2,1437,47384,3578758565,3578758584,19
2,1437,47385,3578758565,3578758588,23
2,1437,47386,3578758565,3578758588,23
2,1437,47387,3578758565,3578758589,24
2,1437,47388,3578758565,3578758589,24
2,1437,47389,3578758565,3578758589,24
2,1437,47390,3578758565,3578758590,25
2,1437,47391,3578758565,3578758591,26
2,1437,47392,3578758565,3578758591,26
2,1437,47393,3578758565,3578758592,27
2,1437,47394,3578758565,3578758593,28
2,1437,47395,3578758565,3578758593,28
2,1437,47396,3578758565,3578758594,29
2,1437,47397,3578758565,3578758596,31
2,1437,47398,3578758565,3578758597,32
2,1437,47399,3578758565,3578758598,33
2,1437,47400,3578758565,3578758599,34
2,1437,47401,3578758565,3578758601,36
2,1437,47402,3578758565,3578758603,38
2,1437,47403,3578758565,3578758603,38
2,1437,47404,3578758565,3578758603,38
2,1437,47405,3578758565,3578758604,39
2,1437,47406,3578758565,3578758604,39
2,1437,47407,3578758565,3578758604,39
2,1437,47408,3578758565,3578758606,41
2,1437,47409,3578758565,3578758606,41
2,1437,47410,3578758565,3578758611,46
2,1437,47411,3578758565,3578758611,46
2,1437,47412,3578758565,3578758614,49
2,1437,47413,3578758565,3578758614,49
2,1437,47414,3578758565,3578758614,49
2,1438,47415,3578758629,3578758629,0
2,1438,47416,3578758629,3578758629,0
2,1438,47417,3578758629,3578758629,0
2,1438,47418,3578758629,3578758629,0
2,1438,47419,3578758629,3578758629,0
2,1438,47420,3578758629,3578758629,0
2,1438,47421,3578758629,3578758629,0
2,1438,47422,3578758629,3578758629,0
2,1438,47423,3578758629,3578758629,0
2,1438,47424,3578758629,3578758629,0
2,1438,47425,3578758629,3578758629,0
2,1438,47426,3578758629,3578758629,0
2,1438,47427,3578758629,3578758629,0
2,1438,47428,3578758629,3578758629,0
2,1438,47429,3578758629,3578758629,0
2,1438,47430,3578758629,3578758629,0
2,1438,47431,3578758629,3578758629,0
2,1438,47432,3578758629,3578758629,0
2,1438,47433,3578758629,3578758631,2
2,1438,47434,3578758629,3578758631,2
2,1438,47435,3578758629,3578758632,3
2,1438,47436,3578758629,3578758632,3
2,1438,47437,3578758629,3578758633,4
2,1438,47438,3578758629,3578758635,6
2,1438,47439,3578758629,3578758636,7
2,1438,47440,3578758629,3578758636,7
2,1438,47441,3578758629,3578758637,8
2,1438,47442,3578758629,3578758637,8
2,1438,47443,3578758629,3578758638,9
2,1438,47444,3578758629,3578758638,9
2,1438,47445,3578758629,3578758638,9
2,1438,47446,3578758629,3578758638,9
2,1438,47447,3578758629,3578758638,9
2,1438,47448,3578758629,3578758638,9
2,1438,47449,3578758629,3578758641,12
2,1438,47450,3578758629,3578758641,12
2,1438,47451,3578758629,3578758641,12
2,1438,47452,3578758629,3578758641,12
2,1438,47453,3578758629,3578758643,14
2,1438,47454,3578758629,3578758644,15
2,1438,47455,3578758629,3578758644,15
2,1438,47456,3578758629,3578758646,17
2,1438,47457,3578758629,3578758646,17
2,1438,47458,3578758629,3578758647,18
2,1438,47459,3578758629,3578758647,18
2,1438,47460,3578758629,3578758649,20
2,1438,47461,3578758629,3578758650,21
2,1438,47462,3578758629,3578758651,22
2,1438,47463,3578758629,3578758652,23
2,1438,47464,3578758629,3578758653,24
2,1438,47465,3578758629,3578758653,24
2,1438,47466,3578758629,3578758653,24
2,1438,47467,3578758629,3578758654,25
2,1438,47468,3578758629,3578758654,25
2,1438,47469,3578758629,3578758655,26
2,1438,47470,3578758629,3578758655,26
2,1438,47471,3578758629,3578758656,27
2,1438,47472,3578758629,3578758656,27
2,1438,47473,3578758629,3578758657,28
2,1438,47474,3578758629,3578758657,28
2,1438,47475,3578758629,3578758657,28
2,1438,47476,3578758629,3578758658,29
2,1438,47477,3578758629,3578758659,30
2,1438,47478,3578758629,3578758659,30
2,1438,47479,3578758629,3578758661,32
2,1438,47480,3578758629,3578758664,35
2,1438,47481,3578758629,3578758665,36
2,1438,47482,3578758629,3578758665,36
2,1438,47483,3578758629,3578758667,38
2,1438,47484,3578758629,3578758667,38
2,1438,47485,3578758629,3578758668,39
2,1438,47486,3578758629,3578758670,41
2,1438,47487,3578758629,3578758676,47
2,1439,47488,3578758693,3578758693,0
2,1439,47489,3578758693,3578758693,0
2,1439,47490,3578758693,3578758693,0
2,1439,47491,3578758693,3578758693,0
2,1439,47492,3578758693,3578758693,0
2,1439,47493,3578758693,3578758693,0
2,1439,47494,3578758693,3578758693,0
2,1439,47495,3578758693,3578758693,0
2,1439,47496,3578758693,3578758693,0
2,1439,47497,3578758693,3578758693,0
2,1439,47498,3578758693,3578758693,0
2,1439,47499,3578758693,3578758693,0
2,1439,47500,3578758693,3578758693,0
2,1439,47501,3578758693,3578758693,0
2,1439,47502,3578758693,3578758694,1
2,1439,47503,3578758693,3578758694,1
2,1439,47504,3578758693,3578758695,2
2,1439,47505,3578758693,3578758696,3
2,1439,47506,3578758693,3578758697,4
2,1439,47507,3578758693,3578758698,5
2,1439,47508,3578758693,3578758698,5
2,1439,47509,3578758693,3578758699,6
2,1439,47510,3578758693,3578758699,6
2,1439,47511,3578758693,3578758699,6
2,1439,47512,3578758693,3578758700,7
2,1439,47513,3578758693,3578758701,8
2,1439,47514,3578758693,3578758702,9
2,1439,47515,3578758693,3578758703,10
2,1439,47516,3578758693,3578758703,10
2,1439,47517,3578758693,3578758704,11
2,1439,47518,3578758693,3578758704,11
2,1439,47519,3578758693,3578758706,13
2,1439,47520,3578758693,3578758706,13
2,1439,47521,3578758693,3578758708,15
2,1439,47522,3578758693,3578758710,17
2,1439,47523,3578758693,3578758710,17
2,1439,47524,3578758693,3578758710,17
2,1439,47525,3578758693,3578758711,18
2,1439,47526,3578758693,3578758712,19
2,1439,47527,3578758693,3578758712,19
2,1439,47528,3578758693,3578758714,21
2,1439,47529,3578758693,3578758715,22
2,1439,47530,3578758693,3578758715,22
2,1439,47531,3578758693,3578758715,22
2,1439,47532,3578758693,3578758715,22
2,1439,47533,3578758693,3578758715,22
2,1439,47534,3578758693,3578758716,23
2,1439,47535,3578758693,3578758716,23
2,1439,47536,3578758693,3578758716,23
2,1439,47537,3578758693,3578758716,23
2,1439,47538,3578758693,3578758717,24
2,1439,47539,3578758693,3578758717,24
2,1439,47540,3578758693,3578758717,24
2,1439,47541,3578758693,3578758717,24
2,1439,47542,3578758693,3578758718,25
2,1439,47543,3578758693,3578758718,25
2,1439,47544,3578758693,3578758721,28
2,1439,47545,3578758693,3578758721,28
2,1439,47546,3578758693,3578758721,28
2,1439,47547,3578758693,3578758721,28
2,1439,47548,3578758693,3578758722,29
2,1439,47549,3578758693,3578758722,29
2,1439,47550,3578758693,3578758722,29
2,1439,47551,3578758693,3578758724,31
2,1439,47552,3578758693,3578758725,32
2,1439,47553,3578758693,3578758725,32
2,1439,47554,3578758693,3578758726,33
2,1439,47555,3578758693,3578758726,33
2,1439,47556,3578758693,3578758726,33
2,1439,47557,3578758693,3578758727,34
2,1439,47558,3578758693,3578758730,37
2,1439,47559,3578758693,3578758731,38
2,1439,47560,3578758693,3578758732,39
2,1439,47561,3578758693,3578758733,40
2,1439,47562,3578758693,3578758733,40
2,1439,47563,3578758693,3578758735,42
2,1439,47564,3578758693,3578758736,43
2,1439,47565,3578758693,3578758736,43
2,1439,47566,3578758693,3578758736,43
2,1439,47567,3578758693,3578758737,44
2,1439,47568,3578758693,3578758737,44
2,1439,47569,3578758693,3578758738,45
2,1439,47570,3578758693,3578758738,45
2,1439,47571,3578758693,3578758738,45
2,1439,47572,3578758693,3578758739,46
2,1439,47573,3578758693,3578758741,48
2,1439,47574,3578758693,3578758741,48
2,1440,47575,3578758758,3578758758,0
2,1440,47576,3578758758,3578758758,0
2,1440,47577,3578758758,3578758758,0
2,1440,47578,3578758758,3578758758,0
2,1440,47579,3578758758,3578758758,0
2,1440,47580,3578758758,3578758758,0
2,1440,47581,3578758758,3578758758,0
2,1440,47582,3578758758,3578758758,0
2,1440,47583,3578758758,3578758759,1
2,1440,47584,3578758758,3578758759,1
2,1440,47585,3578758758,3578758759,1
2,1440,47586,3578758758,3578758759,1
2,1440,47587,3578758758,3578758759,1
2,1440,47588,3578758758,3578758759,1
2,1440,47589,3578758758,3578758759,1
2,1440,47590,3578758758,3578758759,1
2,1440,47591,3578758758,3578758759,1
2,1440,47592,3578758758,3578758759,1
2,1440,47593,3578758758,3578758759,1
2,1440,47594,3578758758,3578758761,3
2,1440,47595,3578758758,3578758763,5
2,1440,47596,3578758758,3578758764,6
2,1440,47597,3578758758,3578758764,6
2,1440,47598,3578758758,3578758766,8
2,1440,47599,3578758758,3578758766,8
2,1440,47600,3578758758,3578758766,8
2,1440,47601,3578758758,3578758768,10
2,1440,47602,3578758758,3578758769,11
2,1440,47603,3578758758,3578758769,11
2,1440,47604,3578758758,3578758769,11
2,1440,47605,3578758758,3578758770,12
2,1440,47606,3578758758,3578758771,13
2,1440,47607,3578758758,3578758771,13
2,1440,47608,3578758758,3578758771,13
2,1440,47609,3578758758,3578758774,16
2,1440,47610,3578758758,3578758774,16
2,1440,47611,3578758758,3578758776,18
2,1440,47612,3578758758,3578758776,18
2,1440,47613,3578758758,3578758776,18
2,1440,47614,3578758758,3578758777,19
2,1440,47615,3578758758,3578758779,21
2,1440,47616,3578758758,3578758779,21
2,1440,47617,3578758758,3578758782,24
2,1440,47618,3578758758,3578758785,27
2,1440,47619,3578758758,3578758788,30
2,1440,47620,3578758758,3578758788,30
2,1440,47621,3578758758,3578758788,30
2,1440,47622,3578758758,3578758788,30
2,1440,47623,3578758758,3578758789,31
2,1440,47624,3578758758,3578758790,32
2,1440,47625,3578758758,3578758790,32
2,1440,47626,3578758758,3578758791,33
2,1440,47627,3578758758,3578758791,33
2,1440,47628,3578758758,3578758792,34
2,1440,47629,3578758758,3578758793,35
2,1440,47630,3578758758,3578758794,36
2,1440,47631,3578758758,3578758797,39
2,1440,47632,3578758758,3578758798,40
2,1440,47633,3578758758,3578758798,40
2,1440,47634,3578758758,3578758799,41
2,1440,47635,3578758758,3578758800,42
2,1440,47636,3578758758,3578758802,44
2,1440,47637,3578758758,3578758802,44
2,1440,47638,3578758758,3578758803,45
2,1440,47639,3578758758,3578758803,45
2,1440,47640,3578758758,3578758805,47
2,1440,47641,3578758758,3578758806,48
2,1440,47642,3578758758,3578758807,49
2,1441,47643,3578758821,3578758821,0
2,1441,47644,3578758821,3578758821,0
2,1441,47645,3578758821,3578758821,0
2,1441,47646,3578758821,3578758821,0
2,1441,47647,3578758821,3578758821,0
2,1441,47648,3578758821,3578758821,0
2,1441,47649,3578758821,3578758821,0
2,1441,47650,3578758821,3578758821,0
2,1441,47651,3578758821,3578758821,0
2,1441,47652,3578758821,3578758821,0
2,1441,47653,3578758821,3578758823,2
2,1441,47654,3578758821,3578758824,3
2,1441,47655,3578758821,3578758825,4
2,1441,47656,3578758821,3578758825,4
2,1441,47657,3578758821,3578758826,5
2,1441,47658,3578758821,3578758827,6
2,1441,47659,3578758821,3578758828,7
2,1441,47660,3578758821,3578758828,7
2,1441,47661,3578758821,3578758829,8
2,1441,47662,3578758821,3578758830,9
2,1441,47663,3578758821,3578758831,10
2,1441,47664,3578758821,3578758831,10
2,1441,47665,3578758821,3578758832,11
2,1441,47666,3578758821,3578758832,11
2,1441,47667,3578758821,3578758833,12
2,1441,47668,3578758821,3578758833,12
2,1441,47669,3578758821,3578758835,14
2,1441,47670,3578758821,3578758836,15
2,1441,47671,3578758821,3578758837,16
2,1441,47672,3578758821,3578758837,16
2,1441,47673,3578758821,3578758838,17
2,1441,47674,3578758821,3578758838,17
2,1441,47675,3578758821,3578758838,17
2,1441,47676,3578758821,3578758838,17
2,1441,47677,3578758821,3578758839,18
2,1441,47678,3578758821,3578758839,18
2,1441,47679,3578758821,3578758839,18
2,1441,47680,3578758821,3578758841,20
2,1441,47681,3578758821,3578758841,20
2,1441,47682,3578758821,3578758841,20
2,1441,47683,3578758821,3578758841,20
2,1441,47684,3578758821,3578758843,22
2,1441,47685,3578758821,3578758844,23
2,1441,47686,3578758821,3578758845,24
2,1441,47687,3578758821,3578758845,24
2,1441,47688,3578758821,3578758846,25
2,1441,47689,3578758821,3578758846,25
2,1441,47690,3578758821,3578758847,26
2,1441,47691,3578758821,3578758850,29
2,1441,47692,3578758821,3578758850,29
2,1441,47693,3578758821,3578758850,29
2,1441,47694,3578758821,3578758852,31
2,1441,47695,3578758821,3578758853,32
2,1441,47696,3578758821,3578758853,32
2,1441,47697,3578758821,3578758853,32
2,1441,47698,3578758821,3578758854,33
2,1441,47699,3578758821,3578758854,33
2,1441,47700,3578758821,3578758855,34
2,1441,47701,3578758821,3578758855,34
2,1441,47702,3578758821,3578758855,34
2,1441,47703,3578758821,3578758856,35
2,1441,47704,3578758821,3578758857,36
2,1441,47705,3578758821,3578758857,36
2,1441,47706,3578758821,3578758859,38
2,1441,47707,3578758821,3578758861,40
2,1441,47708,3578758821,3578758862,41
2,1441,47709,3578758821,3578758864,43
2,1441,47710,3578758821,3578758865,44
2,1441,47711,3578758821,3578758866,45
2,1441,47712,3578758821,3578758867,46
2,1441,47713,3578758821,3578758867,46
2,1441,47714,3578758821,3578758870,49
2,1442,47715,3578758885,3578758885,0
2,1442,47716,3578758885,3578758885,0
2,1442,47717,3578758885,3578758885,0
2,1442,47718,3578758885,3578758885,0
2,1442,47719,3578758885,3578758885,0
2,1442,47720,3578758885,3578758885,0
2,1442,47721,3578758885,3578758885,0
2,1442,47722,3578758885,3578758889,4
2,1442,47723,3578758885,3578758889,4
2,1442,47724,3578758885,3578758889,4
2,1442,47725,3578758885,3578758890,5
2,1442,47726,3578758885,3578758891,6
2,1442,47727,3578758885,3578758891,6
2,1442,47728,3578758885,3578758892,7
2,1442,47729,3578758885,3578758894,9
2,1442,47730,3578758885,3578758894,9
2,1442,47731,3578758885,3578758895,10
2,1442,47732,3578758885,3578758896,11
2,1442,47733,3578758885,3578758897,12
2,1442,47734,3578758885,3578758898,13
2,1442,47735,3578758885,3578758898,13
2,1442,47736,3578758885,3578758899,14
2,1442,47737,3578758885,3578758899,14
2,1442,47738,3578758885,3578758899,14
2,1442,47739,3578758885,3578758900,15
2,1442,47740,3578758885,3578758901,16
2,1442,47741,3578758885,3578758902,17
2,1442,47742,3578758885,3578758902,17
2,1442,47743,3578758885,3578758904,19
2,1442,47744,3578758885,3578758904,19
2,1442,47745,3578758885,3578758905,20
2,1442,47746,3578758885,3578758906,21
2,1442,47747,3578758885,3578758906,21
2,1442,47748,3578758885,3578758908,23
2,1442,47749,3578758885,3578758910,25
2,1442,47750,3578758885,3578758910,25
2,1442,47751,3578758885,3578758911,26
2,1442,47752,3578758885,3578758911,26
2,1442,47753,3578758885,3578758913,28
2,1442,47754,3578758885,3578758913,28
2,1442,47755,3578758885,3578758914,29
2,1442,47756,3578758885,3578758915,30
2,1442,47757,3578758885,3578758915,30
2,1442,47758,3578758885,3578758915,30
2,1442,47759,3578758885,3578758915,30
2,1442,47760,3578758885,3578758916,31
2,1442,47761,3578758885,3578758916,31
2,1442,47762,3578758885,3578758916,31
2,1442,47763,3578758885,3578758917,32
2,1442,47764,3578758885,3578758917,32
2,1442,47765,3578758885,3578758917,32
2,1442,47766,3578758885,3578758917,32
2,1442,47767,3578758885,3578758918,33
2,1442,47768,3578758885,3578758918,33
2,1442,47769,3578758885,3578758920,35
2,1442,47770,3578758885,3578758921,36
2,1442,47771,3578758885,3578758921,36
2,1442,47772,3578758885,3578758921,36
2,1442,47773,3578758885,3578758923,38
2,1442,47774,3578758885,3578758923,38
2,1442,47775,3578758885,3578758923,38
2,1442,47776,3578758885,3578758925,40
2,1442,47777,3578758885,3578758926,41
2,1442,47778,3578758885,3578758926,41
2,1442,47779,3578758885,3578758926,41
2,1442,47780,3578758885,3578758926,41
2,1442,47781,3578758885,3578758927,42
2,1442,47782,3578758885,3578758930,45
2,1442,47783,3578758885,3578758932,47
2,1442,47784,3578758885,3578758932,47
2,1442,47785,3578758885,3578758933,48
2,1442,47786,3578758885,3578758933,48
2,1442,47787,3578758885,3578758935,50
2,1443,47788,3578758948,3578758948,0
2,1443,47789,3578758948,3578758948,0
2,1443,47790,3578758948,3578758948,0
2,1443,47791,3578758948,3578758948,0
2,1443,47792,3578758948,3578758948,0
2,1443,47793,3578758948,3578758948,0
2,1443,47794,3578758948,3578758948,0
2,1443,47795,3578758948,3578758948,0
2,1443,47796,3578758948,3578758948,0
2,1443,47797,3578758948,3578758948,0
2,1443,47798,3578758948,3578758948,0
2,1443,47799,3578758948,3578758948,0
2,1443,47800,3578758948,3578758948,0
2,1443,47801,3578758948,3578758948,0
2,1443,47802,3578758948,3578758950,2
2,1443,47803,3578758948,3578758950,2
2,1443,47804,3578758948,3578758950,2
2,1443,47805,3578758948,3578758950,2
2,1443,47806,3578758948,3578758951,3
2,1443,47807,3578758948,3578758951,3
2,1443,47808,3578758948,3578758952,4
2,1443,47809,3578758948,3578758954,6
2,1443,47810,3578758948,3578758955,7
2,1443,47811,3578758948,3578758956,8
2,1443,47812,3578758948,3578758956,8
2,1443,47813,3578758948,3578758956,8
2,1443,47814,3578758948,3578758957,9
2,1443,47815,3578758948,3578758957,9
2,1443,47816,3578758948,3578758961,13
2,1443,47817,3578758948,3578758964,16
2,1443,47818,3578758948,3578758964,16
2,1443,47819,3578758948,3578758965,17
2,1443,47820,3578758948,3578758965,17
2,1443,47821,3578758948,3578758966,18
2,1443,47822,3578758948,3578758966,18
2,1443,47823,3578758948,3578758966,18
2,1443,47824,3578758948,3578758968,20
2,1443,47825,3578758948,3578758969,21
2,1443,47826,3578758948,3578758969,21
2,1443,47827,3578758948,3578758969,21
2,1443,47828,3578758948,3578758972,24
2,1443,47829,3578758948,3578758972,24
2,1443,47830,3578758948,3578758973,25
2,1443,47831,3578758948,3578758974,26
2,1443,47832,3578758948,3578758975,27
2,1443,47833,3578758948,3578758977,29
2,1443,47834,3578758948,3578758978,30
2,1443,47835,3578758948,3578758978,30
2,1443,47836,3578758948,3578758980,32
2,1443,47837,3578758948,3578758983,35
2,1443,47838,3578758948,3578758985,37
2,1443,47839,3578758948,3578758985,37
2,1443,47840,3578758948,3578758987,39
2,1443,47841,3578758948,3578758988,40
2,1443,47842,3578758948,3578758988,40
2,1443,47843,3578758948,3578758989,41
2,1443,47844,3578758948,3578758989,41
2,1443,47845,3578758948,3578758990,42
2,1443,47846,3578758948,3578758991,43
2,1443,47847,3578758948,3578758991,43
2,1443,47848,3578758948,3578758992,44
2,1443,47849,3578758948,3578758993,45
2,1443,47850,3578758948,3578758993,45
2,1443,47851,3578758948,3578758994,46
2,1443,47852,3578758948,3578758997,49
2,1443,47853,3578758948,3578758998,50
2,1444,47854,3578759012,3578759012,0
2,1444,47855,3578759012,3578759012,0
2,1444,47856,3578759012,3578759012,0
2,1444,47857,3578759012,3578759012,0
2,1444,47858,3578759012,3578759012,0
2,1444,47859,3578759012,3578759012,0
2,1444,47860,3578759012,3578759012,0
2,1444,47861,3578759012,3578759012,0
2,1444,47862,3578759012,3578759012,0
2,1444,47863,3578759012,3578759012,0
2,1444,47864,3578759012,3578759013,1
2,1444,47865,3578759012,3578759014,2
2,1444,47866,3578759012,3578759014,2
2,1444,47867,3578759012,3578759015,3
2,1444,47868,3578759012,3578759015,3
2,1444,47869,3578759012,3578759016,4
2,1444,47870,3578759012,3578759016,4
2,1444,47871,3578759012,3578759019,7
2,1444,47872,3578759012,3578759020,8
2,1444,47873,3578759012,3578759022,10
2,1444,47874,3578759012,3578759024,12
2,1444,47875,3578759012,3578759025,13
2,1444,47876,3578759012,3578759025,13
2,1444,47877,3578759012,3578759026,14
2,1444,47878,3578759012,3578759027,15
2,1444,47879,3578759012,3578759027,15
2,1444,47880,3578759012,3578759028,16
2,1444,47881,3578759012,3578759028,16
2,1444,47882,3578759012,3578759029,17
2,1444,47883,3578759012,3578759030,18
2,1444,47884,3578759012,3578759031,19
2,1444,47885,3578759012,3578759032,20
2,1444,47886,3578759012,3578759032,20
2,1444,47887,3578759012,3578759033,21
2,1444,47888,3578759012,3578759033,21
2,1444,47889,3578759012,3578759036,24
2,1444,47890,3578759012,3578759036,24
2,1444,47891,3578759012,3578759037,25
2,1444,47892,3578759012,3578759037,25
2,1444,47893,3578759012,3578759037,25
2,1444,47894,3578759012,3578759038,26
2,1444,47895,3578759012,3578759038,26
2,1444,47896,3578759012,3578759038,26
2,1444,47897,3578759012,3578759039,27
2,1444,47898,3578759012,3578759039,27
2,1444,47899,3578759012,3578759040,28
2,1444,47900,3578759012,3578759041,29
2,1444,47901,3578759012,3578759041,29
2,1444,47902,3578759012,3578759042,30
2,1444,47903,3578759012,3578759042,30
2,1444,47904,3578759012,3578759044,32
2,1444,47905,3578759012,3578759044,32
2,1444,47906,3578759012,3578759045,33
2,1444,47907,3578759012,3578759045,33
2,1444,47908,3578759012,3578759046,34
2,1444,47909,3578759012,3578759047,35
2,1444,47910,3578759012,3578759047,35
2,1444,47911,3578759012,3578759050,38
2,1444,47912,3578759012,3578759050,38
2,1444,47913,3578759012,3578759052,40
2,1444,47914,3578759012,3578759052,40
2,1444,47915,3578759012,3578759053,41
2,1444,47916,3578759012,3578759053,41
2,1444,47917,3578759012,3578759053,41
2,1444,47918,3578759012,3578759054,42
2,1444,47919,3578759012,3578759054,42
2,1444,47920,3578759012,3578759055,43
2,1444,47921,3578759012,3578759057,45
2,1444,47922,3578759012,3578759057,45
2,1444,47923,3578759012,3578759058,46
2,1444,47924,3578759012,3578759061,49
2,1444,47925,3578759012,3578759061,49
2,1444,47926,3578759012,3578759062,50
2,1445,47927,3578759074,3578759074,0
2,1445,47928,3578759074,3578759074,0
2,1445,47929,3578759074,3578759074,0
2,1445,47930,3578759074,3578759074,0
2,1445,47931,3578759074,3578759074,0
2,1445,47932,3578759074,3578759074,0
2,1445,47933,3578759074,3578759074,0
2,1445,47934,3578759074,3578759077,3
2,1445,47935,3578759074,3578759082,8
2,1445,47936,3578759074,3578759083,9
2,1445,47937,3578759074,3578759083,9
2,1445,47938,3578759074,3578759084,10
2,1445,47939,3578759074,3578759084,10
2,1445,47940,3578759074,3578759085,11
2,1445,47941,3578759074,3578759089,15
2,1445,47942,3578759074,3578759089,15
2,1445,47943,3578759074,3578759090,16
2,1445,47944,3578759074,3578759090,16
2,1445,47945,3578759074,3578759092,18
2,1445,47946,3578759074,3578759092,18
2,1445,47947,3578759074,3578759092,18
2,1445,47948,3578759074,3578759094,20
2,1445,47949,3578759074,3578759094,20
2,1445,47950,3578759074,3578759095,21
2,1445,47951,3578759074,3578759096,22
2,1445,47952,3578759074,3578759097,23
2,1445,47953,3578759074,3578759098,24
2,1445,47954,3578759074,3578759099,25
2,1445,47955,3578759074,3578759099,25
2,1445,47956,3578759074,3578759099,25
2,1445,47957,3578759074,3578759099,25
2,1445,47958,3578759074,3578759100,26
2,1445,47959,3578759074,3578759100,26
2,1445,47960,3578759074,3578759101,27
2,1445,47961,3578759074,3578759102,28
2,1445,47962,3578759074,3578759103,29
2,1445,47963,3578759074,3578759104,30
2,1445,47964,3578759074,3578759105,31
2,1445,47965,3578759074,3578759106,32
2,1445,47966,3578759074,3578759107,33
2,1445,47967,3578759074,3578759109,35
2,1445,47968,3578759074,3578759110,36
2,1445,47969,3578759074,3578759111,37
2,1445,47970,3578759074,3578759111,37
2,1445,47971,3578759074,3578759111,37
2,1445,47972,3578759074,3578759112,38
2,1445,47973,3578759074,3578759113,39
2,1445,47974,3578759074,3578759114,40
2,1445,47975,3578759074,3578759114,40
2,1445,47976,3578759074,3578759114,40
2,1445,47977,3578759074,3578759116,42
2,1445,47978,3578759074,3578759116,42
2,1445,47979,3578759074,3578759116,42
2,1445,47980,3578759074,3578759116,42
2,1445,47981,3578759074,3578759116,42
2,1445,47982,3578759074,3578759116,42
2,1445,47983,3578759074,3578759117,43
2,1445,47984,3578759074,3578759117,43
2,1445,47985,3578759074,3578759118,44
2,1445,47986,3578759074,3578759118,44
2,1445,47987,3578759074,3578759119,45
2,1445,47988,3578759074,3578759120,46
2,1445,47989,3578759074,3578759121,47
2,1445,47990,3578759074,3578759122,48
2,1445,47991,3578759074,3578759122,48
2,1445,47992,3578759074,3578759123,49
2,1446,47993,3578759137,3578759137,0
2,1446,47994,3578759137,3578759137,0
2,1446,47995,3578759137,3578759137,0
2,1446,47996,3578759137,3578759137,0
2,1446,47997,3578759137,3578759137,0
2,1446,47998,3578759137,3578759137,0
2,1446,47999,3578759137,3578759137,0
2,1446,48000,3578759137,3578759137,0
2,1446,48001,3578759137,3578759137,0
2,1446,48002,3578759137,3578759137,0
2,1446,48003,3578759137,3578759137,0
2,1446,48004,3578759137,3578759137,0
2,1446,48005,3578759137,3578759137,0
2,1446,48006,3578759137,3578759137,0
2,1446,48007,3578759137,3578759137,0
2,1446,48008,3578759137,3578759137,0
2,1446,48009,3578759137,3578759137,0
2,1446,48010,3578759137,3578759137,0
2,1446,48011,3578759137,3578759138,1
2,1446,48012,3578759137,3578759138,1
2,1446,48013,3578759137,3578759139,2
2,1446,48014,3578759137,3578759141,4
2,1446,48015,3578759137,3578759143,6
2,1446,48016,3578759137,3578759143,6
2,1446,48017,3578759137,3578759144,7
2,1446,48018,3578759137,3578759145,8
2,1446,48019,3578759137,3578759148,11
2,1446,48020,3578759137,3578759150,13
2,1446,48021,3578759137,3578759150,13
2,1446,48022,3578759137,3578759151,14
2,1446,48023,3578759137,3578759151,14
2,1446,48024,3578759137,3578759151,14
2,1446,48025,3578759137,3578759152,15
2,1446,48026,3578759137,3578759152,15
2,1446,48027,3578759137,3578759155,18
2,1446,48028,3578759137,3578759155,18
2,1446,48029,3578759137,3578759156,19
2,1446,48030,3578759137,3578759156,19
2,1446,48031,3578759137,3578759156,19
2,1446,48032,3578759137,3578759157,20
2,1446,48033,3578759137,3578759157,20
2,1446,48034,3578759137,3578759162,25
2,1446,48035,3578759137,3578759163,26
2,1446,48036,3578759137,3578759164,27
2,1446,48037,3578759137,3578759164,27
2,1446,48038,3578759137,3578759166,29
2,1446,48039,3578759137,3578759166,29
2,1446,48040,3578759137,3578759166,29
2,1446,48041,3578759137,3578759166,29
2,1446,48042,3578759137,3578759168,31
2,1446,48043,3578759137,3578759169,32
2,1446,48044,3578759137,3578759170,33
2,1446,48045,3578759137,3578759170,33
2,1446,48046,3578759137,3578759170,33
2,1446,48047,3578759137,3578759171,34
2,1446,48048,3578759137,3578759172,35
2,1446,48049,3578759137,3578759173,36
2,1446,48050,3578759137,3578759174,37
2,1446,48051,3578759137,3578759174,37
2,1446,48052,3578759137,3578759176,39
2,1446,48053,3578759137,3578759177,40
2,1446,48054,3578759137,3578759178,41
2,1446,48055,3578759137,3578759179,42
2,1446,48056,3578759137,3578759183,46
2,1446,48057,3578759137,3578759184,47
2,1446,48058,3578759137,3578759185,48
2,1447,48059,3578759199,3578759199,0
2,1447,48060,3578759199,3578759199,0
2,1447,48061,3578759199,3578759199,0
2,1447,48062,3578759199,3578759199,0
2,1447,48063,3578759199,3578759199,0
2,1447,48064,3578759199,3578759199,0
2,1447,48065,3578759199,3578759199,0
2,1447,48066,3578759199,3578759199,0
2,1447,48067,3578759199,3578759199,0
2,1447,48068,3578759199,3578759199,0
2,1447,48069,3578759199,3578759199,0
2,1447,48070,3578759199,3578759199,0
2,1447,48071,3578759199,3578759200,1
2,1447,48072,3578759199,3578759203,4
2,1447,48073,3578759199,3578759203,4
2,1447,48074,3578759199,3578759204,5
2,1447,48075,3578759199,3578759204,5
2,1447,48076,3578759199,3578759205,6
2,1447,48077,3578759199,3578759206,7
2,1447,48078,3578759199,3578759207,8
2,1447,48079,3578759199,3578759211,12
2,1447,48080,3578759199,3578759213,14
2,1447,48081,3578759199,3578759215,16
2,1447,48082,3578759199,3578759215,16
2,1447,48083,3578759199,3578759215,16
2,1447,48084,3578759199,3578759215,16
2,1447,48085,3578759199,3578759217,18
2,1447,48086,3578759199,3578759218,19
2,1447,48087,3578759199,3578759220,21
2,1447,48088,3578759199,3578759223,24
2,1447,48089,3578759199,3578759224,25
2,1447,48090,3578759199,3578759224,25
2,1447,48091,3578759199,3578759226,27
2,1447,48092,3578759199,3578759227,28
2,1447,48093,3578759199,3578759227,28
2,1447,48094,3578759199,3578759228,29
2,1447,48095,3578759199,3578759229,30
2,1447,48096,3578759199,3578759229,30
2,1447,48097,3578759199,3578759229,30
2,1447,48098,3578759199,3578759230,31
2,1447,48099,3578759199,3578759232,33
2,1447,48100,3578759199,3578759232,33
2,1447,48101,3578759199,3578759233,34
2,1447,48102,3578759199,3578759233,34
2,1447,48103,3578759199,3578759233,34
2,1447,48104,3578759199,3578759236,37
2,1447,48105,3578759199,3578759236,37
2,1447,48106,3578759199,3578759237,38
2,1447,48107,3578759199,3578759238,39
2,1447,48108,3578759199,3578759238,39
2,1447,48109,3578759199,3578759238,39
2,1447,48110,3578759199,3578759239,40
2,1447,48111,3578759199,3578759239,40
2,1447,48112,3578759199,3578759239,40
2,1447,48113,3578759199,3578759240,41
2,1447,48114,3578759199,3578759240,41
2,1447,48115,3578759199,3578759241,42
2,1447,48116,3578759199,3578759241,42
2,1447,48117,3578759199,3578759242,43
2,1447,48118,3578759199,3578759243,44
2,1447,48119,3578759199,3578759244,45
2,1447,48120,3578759199,3578759244,45
2,1447,48121,3578759199,3578759245,46
2,1447,48122,3578759199,3578759246,47
2,1447,48123,3578759199,3578759246,47
2,1447,48124,3578759199,3578759248,49
2,1448,48125,3578759262,3578759262,0
2,1448,48126,3578759262,3578759262,0
2,1448,48127,3578759262,3578759262,0
2,1448,48128,3578759262,3578759262,0
2,1448,48129,3578759262,3578759262,0
2,1448,48130,3578759262,3578759262,0
2,1448,48131,3578759262,3578759262,0
2,1448,48132,3578759262,3578759262,0
2,1448,48133,3578759262,3578759262,0
2,1448,48134,3578759262,3578759262,0
2,1448,48135,3578759262,3578759263,1
2,1448,48136,3578759262,3578759263,1
2,1448,48137,3578759262,3578759263,1
2,1448,48138,3578759262,3578759263,1
2,1448,48139,3578759262,3578759263,1
2,1448,48140,3578759262,3578759263,1
2,1448,48141,3578759262,3578759263,1
2,1448,48142,3578759262,3578759265,3
2,1448,48143,3578759262,3578759265,3
2,1448,48144,3578759262,3578759266,4
2,1448,48145,3578759262,3578759268,6
2,1448,48146,3578759262,3578759269,7
2,1448,48147,3578759262,3578759271,9
2,1448,48148,3578759262,3578759277,15
2,1448,48149,3578759262,3578759281,19
2,1448,48150,3578759262,3578759282,20
2,1448,48151,3578759262,3578759283,21
2,1448,48152,3578759262,3578759283,21
2,1448,48153,3578759262,3578759284,22
2,1448,48154,3578759262,3578759286,24
2,1448,48155,3578759262,3578759289,27
2,1448,48156,3578759262,3578759289,27
2,1448,48157,3578759262,3578759290,28
2,1448,48158,3578759262,3578759290,28
2,1448,48159,3578759262,3578759291,29
2,1448,48160,3578759262,3578759292,30
2,1448,48161,3578759262,3578759292,30
2,1448,48162,3578759262,3578759293,31
2,1448,48163,3578759262,3578759294,32
2,1448,48164,3578759262,3578759294,32
2,1448,48165,3578759262,3578759296,34
2,1448,48166,3578759262,3578759296,34
2,1448,48167,3578759262,3578759297,35
2,1448,48168,3578759262,3578759298,36
2,1448,48169,3578759262,3578759298,36
2,1448,48170,3578759262,3578759299,37
2,1448,48171,3578759262,3578759299,37
2,1448,48172,3578759262,3578759300,38
2,1448,48173,3578759262,3578759301,39
2,1448,48174,3578759262,3578759302,40
2,1448,48175,3578759262,3578759302,40
2,1448,48176,3578759262,3578759303,41
2,1448,48177,3578759262,3578759305,43
2,1448,48178,3578759262,3578759306,44
2,1448,48179,3578759262,3578759307,45
2,1448,48180,3578759262,3578759309,47
2,1448,48181,3578759262,3578759310,48
2,1448,48182,3578759262,3578759311,49
2,1448,48183,3578759262,3578759311,49
2,1449,48184,3578759326,3578759326,0
2,1449,48185,3578759326,3578759326,0
2,1449,48186,3578759326,3578759326,0
2,1449,48187,3578759326,3578759326,0
2,1449,48188,3578759326,3578759326,0
2,1449,48189,3578759326,3578759326,0
2,1449,48190,3578759326,3578759326,0
2,1449,48191,3578759326,3578759326,0
2,1449,48192,3578759326,3578759326,0
2,1449,48193,3578759326,3578759326,0
2,1449,48194,3578759326,3578759326,0
2,1449,48195,3578759326,3578759326,0
2,1449,48196,3578759326,3578759326,0
2,1449,48197,3578759326,3578759326,0
2,1449,48198,3578759326,3578759326,0
2,1449,48199,3578759326,3578759326,0
2,1449,48200,3578759326,3578759326,0
2,1449,48201,3578759326,3578759326,0
2,1449,48202,3578759326,3578759326,0
2,1449,48203,3578759326,3578759326,0
2,1449,48204,3578759326,3578759326,0
2,1449,48205,3578759326,3578759326,0
2,1449,48206,3578759326,3578759326,0
2,1449,48207,3578759326,3578759326,0
2,1449,48208,3578759326,3578759326,0
2,1449,48209,3578759326,3578759326,0
2,1449,48210,3578759326,3578759326,0
2,1449,48211,3578759326,3578759326,0
2,1449,48212,3578759326,3578759326,0
2,1449,48213,3578759326,3578759327,1
2,1449,48214,3578759326,3578759328,2
2,1449,48215,3578759326,3578759331,5
2,1449,48216,3578759326,3578759332,6
2,1449,48217,3578759326,3578759333,7
2,1449,48218,3578759326,3578759333,7
2,1449,48219,3578759326,3578759334,8
2,1449,48220,3578759326,3578759334,8
2,1449,48221,3578759326,3578759336,10
2,1449,48222,3578759326,3578759337,11
2,1449,48223,3578759326,3578759337,11
2,1449,48224,3578759326,3578759338,12
2,1449,48225,3578759326,3578759338,12
2,1449,48226,3578759326,3578759339,13
2,1449,48227,3578759326,3578759339,13
2,1449,48228,3578759326,3578759339,13
2,1449,48229,3578759326,3578759339,13
2,1449,48230,3578759326,3578759341,15
2,1449,48231,3578759326,3578759341,15
2,1449,48232,3578759326,3578759343,17
2,1449,48233,3578759326,3578759343,17
2,1449,48234,3578759326,3578759344,18
2,1449,48235,3578759326,3578759345,19
2,1449,48236,3578759326,3578759348,22
2,1449,48237,3578759326,3578759350,24
2,1449,48238,3578759326,3578759350,24
2,1449,48239,3578759326,3578759350,24
2,1449,48240,3578759326,3578759351,25
2,1449,48241,3578759326,3578759351,25
2,1449,48242,3578759326,3578759352,26
2,1449,48243,3578759326,3578759352,26
2,1449,48244,3578759326,3578759355,29
2,1449,48245,3578759326,3578759355,29
2,1449,48246,3578759326,3578759356,30
2,1449,48247,3578759326,3578759356,30
2,1449,48248,3578759326,3578759356,30
2,1449,48249,3578759326,3578759357,31
2,1449,48250,3578759326,3578759362,36
2,1449,48251,3578759326,3578759363,37
2,1449,48252,3578759326,3578759364,38
2,1449,48253,3578759326,3578759366,40
2,1449,48254,3578759326,3578759366,40
2,1449,48255,3578759326,3578759366,40
2,1449,48256,3578759326,3578759366,40
2,1449,48257,3578759326,3578759366,40
2,1449,48258,3578759326,3578759369,43
2,1449,48259,3578759326,3578759369,43
2,1449,48260,3578759326,3578759369,43
2,1449,48261,3578759326,3578759370,44
2,1449,48262,3578759326,3578759370,44
2,1449,48263,3578759326,3578759371,45
2,1449,48264,3578759326,3578759372,46
2,1449,48265,3578759326,3578759372,46
2,1449,48266,3578759326,3578759373,47
2,1449,48267,3578759326,3578759374,48
2,1449,48268,3578759326,3578759375,49
2,1449,48269,3578759326,3578759376,50
2,1450,48270,3578759389,3578759389,0
2,1450,48271,3578759389,3578759389,0
2,1450,48272,3578759389,3578759389,0
2,1450,48273,3578759389,3578759389,0
2,1450,48274,3578759389,3578759389,0
2,1450,48275,3578759389,3578759389,0
2,1450,48276,3578759389,3578759389,0
2,1450,48277,3578759389,3578759389,0
2,1450,48278,3578759389,3578759389,0
2,1450,48279,3578759389,3578759389,0
2,1450,48280,3578759389,3578759390,1
2,1450,48281,3578759389,3578759391,2
2,1450,48282,3578759389,3578759391,2
2,1450,48283,3578759389,3578759393,4
2,1450,48284,3578759389,3578759393,4
2,1450,48285,3578759389,3578759393,4
2,1450,48286,3578759389,3578759394,5
2,1450,48287,3578759389,3578759398,9
2,1450,48288,3578759389,3578759399,10
2,1450,48289,3578759389,3578759400,11
2,1450,48290,3578759389,3578759402,13
2,1450,48291,3578759389,3578759403,14
2,1450,48292,3578759389,3578759404,15
2,1450,48293,3578759389,3578759404,15
2,1450,48294,3578759389,3578759404,15
2,1450,48295,3578759389,3578759405,16
2,1450,48296,3578759389,3578759405,16
2,1450,48297,3578759389,3578759406,17
2,1450,48298,3578759389,3578759407,18
2,1450,48299,3578759389,3578759412,23
2,1450,48300,3578759389,3578759413,24
2,1450,48301,3578759389,3578759414,25
2,1450,48302,3578759389,3578759415,26
2,1450,48303,3578759389,3578759415,26
2,1450,48304,3578759389,3578759417,28
2,1450,48305,3578759389,3578759419,30
2,1450,48306,3578759389,3578759421,32
2,1450,48307,3578759389,3578759423,34
2,1450,48308,3578759389,3578759424,35
2,1450,48309,3578759389,3578759425,36
2,1450,48310,3578759389,3578759427,38
2,1450,48311,3578759389,3578759428,39
2,1450,48312,3578759389,3578759428,39
2,1450,48313,3578759389,3578759429,40
2,1450,48314,3578759389,3578759430,41
2,1450,48315,3578759389,3578759431,42
2,1450,48316,3578759389,3578759432,43
2,1450,48317,3578759389,3578759432,43
2,1450,48318,3578759389,3578759433,44
2,1450,48319,3578759389,3578759433,44
2,1450,48320,3578759389,3578759434,45
2,1450,48321,3578759389,3578759435,46
2,1450,48322,3578759389,3578759436,47
2,1450,48323,3578759389,3578759437,48
2,1450,48324,3578759389,3578759437,48
2,1450,48325,3578759389,3578759438,49
2,1450,48326,3578759389,3578759438,49
2,1450,48327,3578759389,3578759439,50
2,1451,48328,3578759452,3578759452,0
2,1451,48329,3578759452,3578759452,0
2,1451,48330,3578759452,3578759452,0
2,1451,48331,3578759452,3578759452,0
2,1451,48332,3578759452,3578759452,0
2,1451,48333,3578759452,3578759452,0
2,1451,48334,3578759452,3578759452,0
2,1451,48335,3578759452,3578759452,0
2,1451,48336,3578759452,3578759452,0
2,1451,48337,3578759452,3578759452,0
2,1451,48338,3578759452,3578759452,0
2,1451,48339,3578759452,3578759452,0
2,1451,48340,3578759452,3578759452,0
2,1451,48341,3578759452,3578759452,0
2,1451,48342,3578759452,3578759452,0
2,1451,48343,3578759452,3578759452,0
2,1451,48344,3578759452,3578759452,0
2,1451,48345,3578759452,3578759452,0
2,1451,48346,3578759452,3578759453,1
2,1451,48347,3578759452,3578759454,2
2,1451,48348,3578759452,3578759454,2
2,1451,48349,3578759452,3578759454,2
2,1451,48350,3578759452,3578759456,4
2,1451,48351,3578759452,3578759457,5
2,1451,48352,3578759452,3578759457,5
2,1451,48353,3578759452,3578759457,5
2,1451,48354,3578759452,3578759458,6
2,1451,48355,3578759452,3578759458,6
2,1451,48356,3578759452,3578759461,9
2,1451,48357,3578759452,3578759465,13
2,1451,48358,3578759452,3578759465,13
2,1451,48359,3578759452,3578759468,16
2,1451,48360,3578759452,3578759469,17
2,1451,48361,3578759452,3578759472,20
2,1451,48362,3578759452,3578759476,24
2,1451,48363,3578759452,3578759481,29
2,1451,48364,3578759452,3578759483,31
2,1451,48365,3578759452,3578759483,31
2,1451,48366,3578759452,3578759484,32
2,1451,48367,3578759452,3578759485,33
2,1451,48368,3578759452,3578759489,37
2,1451,48369,3578759452,3578759490,38
2,1451,48370,3578759452,3578759490,38
2,1451,48371,3578759452,3578759490,38
2,1451,48372,3578759452,3578759490,38
2,1451,48373,3578759452,3578759491,39
2,1451,48374,3578759452,3578759491,39
2,1451,48375,3578759452,3578759493,41
2,1451,48376,3578759452,3578759493,41
2,1451,48377,3578759452,3578759494,42
2,1451,48378,3578759452,3578759494,42
2,1451,48379,3578759452,3578759496,44
2,1451,48380,3578759452,3578759496,44
2,1451,48381,3578759452,3578759497,45
2,1451,48382,3578759452,3578759497,45
2,1451,48383,3578759452,3578759498,46
2,1451,48384,3578759452,3578759498,46
2,1451,48385,3578759452,3578759499,47
2,1451,48386,3578759452,3578759499,47
2,1451,48387,3578759452,3578759500,48
2,1451,48388,3578759452,3578759501,49
2,1452,48389,3578759515,3578759515,0
2,1452,48390,3578759515,3578759515,0
2,1452,48391,3578759515,3578759515,0
2,1452,48392,3578759515,3578759515,0
2,1452,48393,3578759515,3578759515,0
2,1452,48394,3578759515,3578759515,0
2,1452,48395,3578759515,3578759515,0
2,1452,48396,3578759515,3578759515,0
2,1452,48397,3578759515,3578759515,0
2,1452,48398,3578759515,3578759515,0
2,1452,48399,3578759515,3578759515,0
2,1452,48400,3578759515,3578759515,0
2,1452,48401,3578759515,3578759515,0
2,1452,48402,3578759515,3578759515,0
2,1452,48403,3578759515,3578759515,0
2,1452,48404,3578759515,3578759515,0
2,1452,48405,3578759515,3578759515,0
2,1452,48406,3578759515,3578759515,0
2,1452,48407,3578759515,3578759515,0
2,1452,48408,3578759515,3578759515,0
2,1452,48409,3578759515,3578759515,0
2,1452,48410,3578759515,3578759515,0
2,1452,48411,3578759515,3578759516,1
2,1452,48412,3578759515,3578759516,1
2,1452,48413,3578759515,3578759516,1
2,1452,48414,3578759515,3578759516,1
2,1452,48415,3578759515,3578759517,2
2,1452,48416,3578759515,3578759517,2
2,1452,48417,3578759515,3578759519,4
2,1452,48418,3578759515,3578759520,5
2,1452,48419,3578759515,3578759520,5
2,1452,48420,3578759515,3578759520,5
2,1452,48421,3578759515,3578759521,6
2,1452,48422,3578759515,3578759522,7
2,1452,48423,3578759515,3578759522,7
2,1452,48424,3578759515,3578759523,8
2,1452,48425,3578759515,3578759524,9
2,1452,48426,3578759515,3578759524,9
2,1452,48427,3578759515,3578759524,9
2,1452,48428,3578759515,3578759525,10
2,1452,48429,3578759515,3578759525,10
2,1452,48430,3578759515,3578759526,11
2,1452,48431,3578759515,3578759527,12
2,1452,48432,3578759515,3578759530,15
2,1452,48433,3578759515,3578759531,16
2,1452,48434,3578759515,3578759532,17
2,1452,48435,3578759515,3578759532,17
2,1452,48436,3578759515,3578759533,18
2,1452,48437,3578759515,3578759534,19
2,1452,48438,3578759515,3578759535,20
2,1452,48439,3578759515,3578759536,21
2,1452,48440,3578759515,3578759537,22
2,1452,48441,3578759515,3578759537,22
2,1452,48442,3578759515,3578759537,22
2,1452,48443,3578759515,3578759538,23
2,1452,48444,3578759515,3578759538,23
2,1452,48445,3578759515,3578759538,23
2,1452,48446,3578759515,3578759538,23
2,1452,48447,3578759515,3578759538,23
2,1452,48448,3578759515,3578759538,23
2,1452,48449,3578759515,3578759539,24
2,1452,48450,3578759515,3578759539,24
2,1452,48451,3578759515,3578759542,27
2,1452,48452,3578759515,3578759543,28
2,1452,48453,3578759515,3578759544,29
2,1452,48454,3578759515,3578759547,32
2,1452,48455,3578759515,3578759549,34
2,1452,48456,3578759515,3578759549,34
2,1452,48457,3578759515,3578759549,34
2,1452,48458,3578759515,3578759549,34
2,1452,48459,3578759515,3578759550,35
2,1452,48460,3578759515,3578759551,36
2,1452,48461,3578759515,3578759553,38
2,1452,48462,3578759515,3578759553,38
2,1452,48463,3578759515,3578759555,40
2,1452,48464,3578759515,3578759555,40
2,1452,48465,3578759515,3578759555,40
2,1452,48466,3578759515,3578759556,41
2,1452,48467,3578759515,3578759561,46
2,1452,48468,3578759515,3578759563,48
2,1452,48469,3578759515,3578759563,48
2,1452,48470,3578759515,3578759564,49
2,1452,48471,3578759515,3578759565,50
2,1453,48472,3578759577,3578759577,0
2,1453,48473,3578759577,3578759577,0
2,1453,48474,3578759577,3578759577,0
2,1453,48475,3578759577,3578759577,0
2,1453,48476,3578759577,3578759577,0
2,1453,48477,3578759577,3578759577,0
2,1453,48478,3578759577,3578759577,0
2,1453,48479,3578759577,3578759577,0
2,1453,48480,3578759577,3578759577,0
2,1453,48481,3578759577,3578759577,0
2,1453,48482,3578759577,3578759577,0
2,1453,48483,3578759577,3578759577,0
2,1453,48484,3578759577,3578759577,0
2,1453,48485,3578759577,3578759578,1
2,1453,48486,3578759577,3578759578,1
2,1453,48487,3578759577,3578759578,1
2,1453,48488,3578759577,3578759578,1
2,1453,48489,3578759577,3578759579,2
2,1453,48490,3578759577,3578759579,2
2,1453,48491,3578759577,3578759583,6
2,1453,48492,3578759577,3578759584,7
2,1453,48493,3578759577,3578759584,7
2,1453,48494,3578759577,3578759587,10
2,1453,48495,3578759577,3578759588,11
2,1453,48496,3578759577,3578759588,11
2,1453,48497,3578759577,3578759588,11
2,1453,48498,3578759577,3578759590,13
2,1453,48499,3578759577,3578759591,14
2,1453,48500,3578759577,3578759592,15
2,1453,48501,3578759577,3578759592,15
2,1453,48502,3578759577,3578759592,15
2,1453,48503,3578759577,3578759593,16
2,1453,48504,3578759577,3578759597,20
2,1453,48505,3578759577,3578759598,21
2,1453,48506,3578759577,3578759599,22
2,1453,48507,3578759577,3578759600,23
2,1453,48508,3578759577,3578759602,25
2,1453,48509,3578759577,3578759603,26
2,1453,48510,3578759577,3578759603,26
2,1453,48511,3578759577,3578759603,26
2,1453,48512,3578759577,3578759604,27
2,1453,48513,3578759577,3578759604,27
2,1453,48514,3578759577,3578759606,29
2,1453,48515,3578759577,3578759607,30
2,1453,48516,3578759577,3578759611,34
2,1453,48517,3578759577,3578759612,35
2,1453,48518,3578759577,3578759614,37
2,1453,48519,3578759577,3578759614,37
2,1453,48520,3578759577,3578759615,38
2,1453,48521,3578759577,3578759616,39
2,1453,48522,3578759577,3578759617,40
2,1453,48523,3578759577,3578759619,42
2,1453,48524,3578759577,3578759620,43
2,1453,48525,3578759577,3578759622,45
2,1453,48526,3578759577,3578759624,47
2,1453,48527,3578759577,3578759627,50
2,1454,48528,3578759642,3578759642,0
2,1454,48529,3578759642,3578759642,0
2,1454,48530,3578759642,3578759642,0
2,1454,48531,3578759642,3578759642,0
2,1454,48532,3578759642,3578759642,0
2,1454,48533,3578759642,3578759642,0
2,1454,48534,3578759642,3578759642,0
2,1454,48535,3578759642,3578759642,0
2,1454,48536,3578759642,3578759642,0
2,1454,48537,3578759642,3578759642,0
2,1454,48538,3578759642,3578759642,0
2,1454,48539,3578759642,3578759642,0
2,1454,48540,3578759642,3578759642,0
2,1454,48541,3578759642,3578759642,0
2,1454,48542,3578759642,3578759642,0
2,1454,48543,3578759642,3578759642,0
2,1454,48544,3578759642,3578759642,0
2,1454,48545,3578759642,3578759642,0
2,1454,48546,3578759642,3578759642,0
2,1454,48547,3578759642,3578759642,0
2,1454,48548,3578759642,3578759642,0
2,1454,48549,3578759642,3578759642,0
2,1454,48550,3578759642,3578759642,0
2,1454,48551,3578759642,3578759642,0
2,1454,48552,3578759642,3578759642,0
2,1454,48553,3578759642,3578759642,0
2,1454,48554,3578759642,3578759642,0
2,1454,48555,3578759642,3578759643,1
2,1454,48556,3578759642,3578759644,2
2,1454,48557,3578759642,3578759644,2
2,1454,48558,3578759642,3578759644,2
2,1454,48559,3578759642,3578759645,3
2,1454,48560,3578759642,3578759646,4
2,1454,48561,3578759642,3578759647,5
2,1454,48562,3578759642,3578759647,5
2,1454,48563,3578759642,3578759650,8
2,1454,48564,3578759642,3578759650,8
2,1454,48565,3578759642,3578759650,8
2,1454,48566,3578759642,3578759651,9
2,1454,48567,3578759642,3578759652,10
2,1454,48568,3578759642,3578759652,10
2,1454,48569,3578759642,3578759653,11
2,1454,48570,3578759642,3578759654,12
2,1454,48571,3578759642,3578759654,12
2,1454,48572,3578759642,3578759655,13
2,1454,48573,3578759642,3578759655,13
2,1454,48574,3578759642,3578759655,13
2,1454,48575,3578759642,3578759656,14
2,1454,48576,3578759642,3578759657,15
2,1454,48577,3578759642,3578759658,16
2,1454,48578,3578759642,3578759659,17
2,1454,48579,3578759642,3578759661,19
2,1454,48580,3578759642,3578759664,22
2,1454,48581,3578759642,3578759664,22
2,1454,48582,3578759642,3578759666,24
2,1454,48583,3578759642,3578759668,26
2,1454,48584,3578759642,3578759672,30
2,1454,48585,3578759642,3578759682,40
2,1454,48586,3578759642,3578759683,41
2,1454,48587,3578759642,3578759684,42
2,1454,48588,3578759642,3578759684,42
2,1454,48589,3578759642,3578759684,42
2,1454,48590,3578759642,3578759685,43
2,1454,48591,3578759642,3578759689,47
2,1454,48592,3578759642,3578759689,47
2,1454,48593,3578759642,3578759690,48
2,1454,48594,3578759642,3578759690,48
2,1454,48595,3578759642,3578759691,49
2,1454,48596,3578759642,3578759691,49
2,1454,48597,3578759642,3578759691,49
2,1454,48598,3578759642,3578759692,50
2,1455,48599,3578759706,3578759706,0
2,1455,48600,3578759706,3578759706,0
2,1455,48601,3578759706,3578759706,0
2,1455,48602,3578759706,3578759706,0
2,1455,48603,3578759706,3578759706,0
2,1455,48604,3578759706,3578759706,0
2,1455,48605,3578759706,3578759706,0
2,1455,48606,3578759706,3578759706,0
2,1455,48607,3578759706,3578759706,0
2,1455,48608,3578759706,3578759706,0
2,1455,48609,3578759706,3578759706,0
2,1455,48610,3578759706,3578759706,0
2,1455,48611,3578759706,3578759706,0
2,1455,48612,3578759706,3578759706,0
2,1455,48613,3578759706,3578759706,0
2,1455,48614,3578759706,3578759706,0
2,1455,48615,3578759706,3578759706,0
2,1455,48616,3578759706,3578759708,2
2,1455,48617,3578759706,3578759709,3
2,1455,48618,3578759706,3578759711,5
2,1455,48619,3578759706,3578759711,5
2,1455,48620,3578759706,3578759711,5
2,1455,48621,3578759706,3578759712,6
2,1455,48622,3578759706,3578759713,7
2,1455,48623,3578759706,3578759713,7
2,1455,48624,3578759706,3578759713,7
2,1455,48625,3578759706,3578759713,7
2,1455,48626,3578759706,3578759715,9
2,1455,48627,3578759706,3578759715,9
2,1455,48628,3578759706,3578759715,9
2,1455,48629,3578759706,3578759716,10
2,1455,48630,3578759706,3578759716,10
2,1455,48631,3578759706,3578759716,10
2,1455,48632,3578759706,3578759716,10
2,1455,48633,3578759706,3578759717,11
2,1455,48634,3578759706,3578759717,11
2,1455,48635,3578759706,3578759717,11
2,1455,48636,3578759706,3578759720,14
2,1455,48637,3578759706,3578759720,14
2,1455,48638,3578759706,3578759720,14
2,1455,48639,3578759706,3578759721,15
2,1455,48640,3578759706,3578759721,15
2,1455,48641,3578759706,3578759722,16
2,1455,48642,3578759706,3578759724,18
2,1455,48643,3578759706,3578759724,18
2,1455,48644,3578759706,3578759725,19
2,1455,48645,3578759706,3578759725,19
2,1455,48646,3578759706,3578759726,20
2,1455,48647,3578759706,3578759726,20
2,1455,48648,3578759706,3578759727,21
2,1455,48649,3578759706,3578759731,25
2,1455,48650,3578759706,3578759731,25
2,1455,48651,3578759706,3578759732,26
2,1455,48652,3578759706,3578759733,27
2,1455,48653,3578759706,3578759733,27
2,1455,48654,3578759706,3578759735,29
2,1455,48655,3578759706,3578759736,30
2,1455,48656,3578759706,3578759737,31
2,1455,48657,3578759706,3578759737,31
2,1455,48658,3578759706,3578759737,31
2,1455,48659,3578759706,3578759738,32
2,1455,48660,3578759706,3578759738,32
2,1455,48661,3578759706,3578759738,32
2,1455,48662,3578759706,3578759738,32
2,1455,48663,3578759706,3578759739,33
2,1455,48664,3578759706,3578759740,34
2,1455,48665,3578759706,3578759740,34
2,1455,48666,3578759706,3578759742,36
2,1455,48667,3578759706,3578759744,38
2,1455,48668,3578759706,3578759744,38
2,1455,48669,3578759706,3578759745,39
2,1455,48670,3578759706,3578759747,41
2,1455,48671,3578759706,3578759749,43
2,1455,48672,3578759706,3578759750,44
2,1455,48673,3578759706,3578759750,44
2,1455,48674,3578759706,3578759750,44
2,1455,48675,3578759706,3578759751,45
2,1455,48676,3578759706,3578759751,45
2,1455,48677,3578759706,3578759752,46
2,1455,48678,3578759706,3578759754,48
2,1455,48679,3578759706,3578759754,48
2,1455,48680,3578759706,3578759756,50
2,1455,48681,3578759706,3578759756,50
2,1455,48682,3578759706,3578759756,50
2,1456,48683,3578759770,3578759770,0
2,1456,48684,3578759770,3578759770,0
2,1456,48685,3578759770,3578759770,0
2,1456,48686,3578759770,3578759770,0
2,1456,48687,3578759770,3578759770,0
2,1456,48688,3578759770,3578759770,0
2,1456,48689,3578759770,3578759770,0
2,1456,48690,3578759770,3578759770,0
2,1456,48691,3578759770,3578759770,0
2,1456,48692,3578759770,3578759770,0
2,1456,48693,3578759770,3578759770,0
2,1456,48694,3578759770,3578759770,0
2,1456,48695,3578759770,3578759770,0
2,1456,48696,3578759770,3578759770,0
2,1456,48697,3578759770,3578759770,0
2,1456,48698,3578759770,3578759771,1
2,1456,48699,3578759770,3578759771,1
2,1456,48700,3578759770,3578759771,1
2,1456,48701,3578759770,3578759772,2
2,1456,48702,3578759770,3578759774,4
2,1456,48703,3578759770,3578759774,4
2,1456,48704,3578759770,3578759774,4
2,1456,48705,3578759770,3578759775,5
2,1456,48706,3578759770,3578759777,7
2,1456,48707,3578759770,3578759777,7
2,1456,48708,3578759770,3578759779,9
2,1456,48709,3578759770,3578759779,9
2,1456,48710,3578759770,3578759780,10
2,1456,48711,3578759770,3578759784,14
2,1456,48712,3578759770,3578759785,15
2,1456,48713,3578759770,3578759785,15
2,1456,48714,3578759770,3578759788,18
2,1456,48715,3578759770,3578759788,18
2,1456,48716,3578759770,3578759788,18
2,1456,48717,3578759770,3578759788,18
2,1456,48718,3578759770,3578759789,19
2,1456,48719,3578759770,3578759789,19
2,1456,48720,3578759770,3578759790,20
2,1456,48721,3578759770,3578759793,23
2,1456,48722,3578759770,3578759793,23
2,1456,48723,3578759770,3578759793,23
2,1456,48724,3578759770,3578759797,27
2,1456,48725,3578759770,3578759798,28
2,1456,48726,3578759770,3578759798,28
2,1456,48727,3578759770,3578759801,31
2,1456,48728,3578759770,3578759803,33
2,1456,48729,3578759770,3578759803,33
2,1456,48730,3578759770,3578759803,33
2,1456,48731,3578759770,3578759804,34
2,1456,48732,3578759770,3578759804,34
2,1456,48733,3578759770,3578759805,35
2,1456,48734,3578759770,3578759806,36
2,1456,48735,3578759770,3578759806,36
2,1456,48736,3578759770,3578759811,41
2,1456,48737,3578759770,3578759812,42
2,1456,48738,3578759770,3578759812,42
2,1456,48739,3578759770,3578759813,43
2,1456,48740,3578759770,3578759814,44
2,1456,48741,3578759770,3578759815,45
2,1456,48742,3578759770,3578759815,45
2,1456,48743,3578759770,3578759815,45
2,1456,48744,3578759770,3578759816,46
2,1456,48745,3578759770,3578759817,47
2,1456,48746,3578759770,3578759819,49
2,1457,48747,3578759833,3578759833,0
2,1457,48748,3578759833,3578759833,0
2,1457,48749,3578759833,3578759833,0
2,1457,48750,3578759833,3578759833,0
2,1457,48751,3578759833,3578759833,0
2,1457,48752,3578759833,3578759833,0
2,1457,48753,3578759833,3578759833,0
2,1457,48754,3578759833,3578759833,0
2,1457,48755,3578759833,3578759833,0
2,1457,48756,3578759833,3578759833,0
2,1457,48757,3578759833,3578759833,0
2,1457,48758,3578759833,3578759833,0
2,1457,48759,3578759833,3578759833,0
2,1457,48760,3578759833,3578759833,0
2,1457,48761,3578759833,3578759833,0
2,1457,48762,3578759833,3578759833,0
2,1457,48763,3578759833,3578759833,0
2,1457,48764,3578759833,3578759833,0
2,1457,48765,3578759833,3578759833,0
2,1457,48766,3578759833,3578759833,0
2,1457,48767,3578759833,3578759835,2
2,1457,48768,3578759833,3578759836,3
2,1457,48769,3578759833,3578759836,3
2,1457,48770,3578759833,3578759837,4
2,1457,48771,3578759833,3578759837,4
2,1457,48772,3578759833,3578759837,4
2,1457,48773,3578759833,3578759838,5
2,1457,48774,3578759833,3578759839,6
2,1457,48775,3578759833,3578759839,6
2,1457,48776,3578759833,3578759839,6
2,1457,48777,3578759833,3578759840,7
2,1457,48778,3578759833,3578759840,7
2,1457,48779,3578759833,3578759841,8
2,1457,48780,3578759833,3578759841,8
2,1457,48781,3578759833,3578759842,9
2,1457,48782,3578759833,3578759843,10
2,1457,48783,3578759833,3578759843,10
2,1457,48784,3578759833,3578759844,11
2,1457,48785,3578759833,3578759845,12
2,1457,48786,3578759833,3578759846,13
2,1457,48787,3578759833,3578759847,14
2,1457,48788,3578759833,3578759847,14
2,1457,48789,3578759833,3578759849,16
2,1457,48790,3578759833,3578759850,17
2,1457,48791,3578759833,3578759851,18
2,1457,48792,3578759833,3578759853,20
2,1457,48793,3578759833,3578759853,20
2,1457,48794,3578759833,3578759854,21
2,1457,48795,3578759833,3578759854,21
2,1457,48796,3578759833,3578759855,22
2,1457,48797,3578759833,3578759855,22
2,1457,48798,3578759833,3578759856,23
2,1457,48799,3578759833,3578759856,23
2,1457,48800,3578759833,3578759857,24
2,1457,48801,3578759833,3578759857,24
2,1457,48802,3578759833,3578759858,25
2,1457,48803,3578759833,3578759859,26
2,1457,48804,3578759833,3578759861,28
2,1457,48805,3578759833,3578759861,28
2,1457,48806,3578759833,3578759864,31
2,1457,48807,3578759833,3578759866,33
2,1457,48808,3578759833,3578759866,33
2,1457,48809,3578759833,3578759867,34
2,1457,48810,3578759833,3578759867,34
2,1457,48811,3578759833,3578759868,35
2,1457,48812,3578759833,3578759872,39
2,1457,48813,3578759833,3578759881,48
2,1457,48814,3578759833,3578759882,49
2,1457,48815,3578759833,3578759883,50
2,1457,48816,3578759833,3578759883,50
2,1458,48817,3578759897,3578759897,0
2,1458,48818,3578759897,3578759897,0
2,1458,48819,3578759897,3578759897,0
2,1458,48820,3578759897,3578759897,0
2,1458,48821,3578759897,3578759897,0
2,1458,48822,3578759897,3578759897,0
2,1458,48823,3578759897,3578759897,0
2,1458,48824,3578759897,3578759897,0
2,1458,48825,3578759897,3578759897,0
2,1458,48826,3578759897,3578759897,0
2,1458,48827,3578759897,3578759897,0
2,1458,48828,3578759897,3578759897,0
2,1458,48829,3578759897,3578759897,0
2,1458,48830,3578759897,3578759897,0
2,1458,48831,3578759897,3578759898,1
2,1458,48832,3578759897,3578759898,1
2,1458,48833,3578759897,3578759899,2
2,1458,48834,3578759897,3578759899,2
2,1458,48835,3578759897,3578759899,2
2,1458,48836,3578759897,3578759900,3
2,1458,48837,3578759897,3578759901,4
2,1458,48838,3578759897,3578759902,5
2,1458,48839,3578759897,3578759902,5
2,1458,48840,3578759897,3578759902,5
2,1458,48841,3578759897,3578759903,6
2,1458,48842,3578759897,3578759903,6
2,1458,48843,3578759897,3578759906,9
2,1458,48844,3578759897,3578759907,10
2,1458,48845,3578759897,3578759910,13
2,1458,48846,3578759897,3578759910,13
2,1458,48847,3578759897,3578759911,14
2,1458,48848,3578759897,3578759911,14
2,1458,48849,3578759897,3578759912,15
2,1458,48850,3578759897,3578759913,16
2,1458,48851,3578759897,3578759914,17
2,1458,48852,3578759897,3578759914,17
2,1458,48853,3578759897,3578759914,17
2,1458,48854,3578759897,3578759914,17
2,1458,48855,3578759897,3578759915,18
2,1458,48856,3578759897,3578759915,18
2,1458,48857,3578759897,3578759916,19
2,1458,48858,3578759897,3578759916,19
2,1458,48859,3578759897,3578759917,20
2,1458,48860,3578759897,3578759917,20
2,1458,48861,3578759897,3578759917,20
2,1458,48862,3578759897,3578759917,20
2,1458,48863,3578759897,3578759918,21
2,1458,48864,3578759897,3578759920,23
2,1458,48865,3578759897,3578759921,24
2,1458,48866,3578759897,3578759921,24
2,1458,48867,3578759897,3578759921,24
2,1458,48868,3578759897,3578759922,25
2,1458,48869,3578759897,3578759922,25
2,1458,48870,3578759897,3578759923,26
2,1458,48871,3578759897,3578759924,27
2,1458,48872,3578759897,3578759925,28
2,1458,48873,3578759897,3578759925,28
2,1458,48874,3578759897,3578759926,29
2,1458,48875,3578759897,3578759926,29
2,1458,48876,3578759897,3578759926,29
2,1458,48877,3578759897,3578759931,34
2,1458,48878,3578759897,3578759931,34
2,1458,48879,3578759897,3578759933,36
2,1458,48880,3578759897,3578759933,36
2,1458,48881,3578759897,3578759933,36
2,1458,48882,3578759897,3578759935,38
2,1458,48883,3578759897,3578759935,38
2,1458,48884,3578759897,3578759936,39
2,1458,48885,3578759897,3578759937,40
2,1458,48886,3578759897,3578759937,40
2,1458,48887,3578759897,3578759939,42
2,1458,48888,3578759897,3578759939,42
2,1458,48889,3578759897,3578759939,42
2,1458,48890,3578759897,3578759939,42
2,1458,48891,3578759897,3578759939,42
2,1458,48892,3578759897,3578759939,42
2,1458,48893,3578759897,3578759940,43
2,1458,48894,3578759897,3578759943,46
2,1458,48895,3578759897,3578759943,46
2,1458,48896,3578759897,3578759944,47
2,1458,48897,3578759897,3578759945,48
2,1459,48898,3578759960,3578759960,0
2,1459,48899,3578759960,3578759960,0
2,1459,48900,3578759960,3578759960,0
2,1459,48901,3578759960,3578759960,0
2,1459,48902,3578759960,3578759960,0
2,1459,48903,3578759960,3578759960,0
2,1459,48904,3578759960,3578759960,0
2,1459,48905,3578759960,3578759960,0
2,1459,48906,3578759960,3578759960,0
2,1459,48907,3578759960,3578759960,0
2,1459,48908,3578759960,3578759960,0
2,1459,48909,3578759960,3578759960,0
2,1459,48910,3578759960,3578759960,0
2,1459,48911,3578759960,3578759960,0
2,1459,48912,3578759960,3578759960,0
2,1459,48913,3578759960,3578759960,0
2,1459,48914,3578759960,3578759960,0
2,1459,48915,3578759960,3578759961,1
2,1459,48916,3578759960,3578759964,4
2,1459,48917,3578759960,3578759964,4
2,1459,48918,3578759960,3578759964,4
2,1459,48919,3578759960,3578759965,5
2,1459,48920,3578759960,3578759965,5
2,1459,48921,3578759960,3578759966,6
2,1459,48922,3578759960,3578759967,7
2,1459,48923,3578759960,3578759968,8
2,1459,48924,3578759960,3578759969,9
2,1459,48925,3578759960,3578759970,10
2,1459,48926,3578759960,3578759970,10
2,1459,48927,3578759960,3578759971,11
2,1459,48928,3578759960,3578759972,12
2,1459,48929,3578759960,3578759974,14
2,1459,48930,3578759960,3578759974,14
2,1459,48931,3578759960,3578759975,15
2,1459,48932,3578759960,3578759976,16
2,1459,48933,3578759960,3578759977,17
2,1459,48934,3578759960,3578759979,19
2,1459,48935,3578759960,3578759979,19
2,1459,48936,3578759960,3578759979,19
2,1459,48937,3578759960,3578759983,23
2,1459,48938,3578759960,3578759985,25
2,1459,48939,3578759960,3578759985,25
2,1459,48940,3578759960,3578759988,28
2,1459,48941,3578759960,3578759988,28
2,1459,48942,3578759960,3578759988,28
2,1459,48943,3578759960,3578759989,29
2,1459,48944,3578759960,3578759990,30
2,1459,48945,3578759960,3578759990,30
2,1459,48946,3578759960,3578759990,30
2,1459,48947,3578759960,3578759993,33
2,1459,48948,3578759960,3578759993,33
2,1459,48949,3578759960,3578759993,33
2,1459,48950,3578759960,3578759999,39
2,1459,48951,3578759960,3578759999,39
2,1459,48952,3578759960,3578760000,40
2,1459,48953,3578759960,3578760001,41
2,1459,48954,3578759960,3578760001,41
2,1459,48955,3578759960,3578760003,43
2,1459,48956,3578759960,3578760003,43
2,1459,48957,3578759960,3578760003,43
2,1459,48958,3578759960,3578760004,44
2,1459,48959,3578759960,3578760004,44
2,1459,48960,3578759960,3578760004,44
2,1459,48961,3578759960,3578760006,46
2,1459,48962,3578759960,3578760006,46
2,1460,48963,3578760026,3578760026,0
2,1460,48964,3578760026,3578760026,0
2,1460,48965,3578760026,3578760026,0
2,1460,48966,3578760026,3578760026,0
2,1460,48967,3578760026,3578760026,0
2,1460,48968,3578760026,3578760026,0
2,1460,48969,3578760026,3578760026,0
2,1460,48970,3578760026,3578760026,0
2,1460,48971,3578760026,3578760026,0
2,1460,48972,3578760026,3578760026,0
2,1460,48973,3578760026,3578760026,0
2,1460,48974,3578760026,3578760026,0
2,1460,48975,3578760026,3578760026,0
2,1460,48976,3578760026,3578760026,0
2,1460,48977,3578760026,3578760026,0
2,1460,48978,3578760026,3578760026,0
2,1460,48979,3578760026,3578760026,0
2,1460,48980,3578760026,3578760026,0
2,1460,48981,3578760026,3578760026,0
2,1460,48982,3578760026,3578760027,1
2,1460,48983,3578760026,3578760027,1
2,1460,48984,3578760026,3578760027,1
2,1460,48985,3578760026,3578760028,2
2,1460,48986,3578760026,3578760029,3
2,1460,48987,3578760026,3578760030,4
2,1460,48988,3578760026,3578760031,5
2,1460,48989,3578760026,3578760032,6
2,1460,48990,3578760026,3578760032,6
2,1460,48991,3578760026,3578760033,7
2,1460,48992,3578760026,3578760033,7
2,1460,48993,3578760026,3578760036,10
2,1460,48994,3578760026,3578760036,10
2,1460,48995,3578760026,3578760036,10
2,1460,48996,3578760026,3578760037,11
2,1460,48997,3578760026,3578760037,11
2,1460,48998,3578760026,3578760037,11
2,1460,48999,3578760026,3578760038,12
2,1460,49000,3578760026,3578760039,13
2,1460,49001,3578760026,3578760039,13
2,1460,49002,3578760026,3578760040,14
2,1460,49003,3578760026,3578760040,14
2,1460,49004,3578760026,3578760041,15
2,1460,49005,3578760026,3578760041,15
2,1460,49006,3578760026,3578760041,15
2,1460,49007,3578760026,3578760042,16
2,1460,49008,3578760026,3578760043,17
2,1460,49009,3578760026,3578760044,18
2,1460,49010,3578760026,3578760044,18
2,1460,49011,3578760026,3578760045,19
2,1460,49012,3578760026,3578760045,19
2,1460,49013,3578760026,3578760046,20
2,1460,49014,3578760026,3578760047,21
2,1460,49015,3578760026,3578760048,22
2,1460,49016,3578760026,3578760050,24
2,1460,49017,3578760026,3578760050,24
2,1460,49018,3578760026,3578760052,26
2,1460,49019,3578760026,3578760052,26
2,1460,49020,3578760026,3578760053,27
2,1460,49021,3578760026,3578760054,28
2,1460,49022,3578760026,3578760054,28
2,1460,49023,3578760026,3578760055,29
2,1460,49024,3578760026,3578760055,29
2,1460,49025,3578760026,3578760056,30
2,1460,49026,3578760026,3578760057,31
2,1460,49027,3578760026,3578760057,31
2,1460,49028,3578760026,3578760058,32
2,1460,49029,3578760026,3578760061,35
2,1460,49030,3578760026,3578760061,35
2,1460,49031,3578760026,3578760062,36
2,1460,49032,3578760026,3578760065,39
2,1460,49033,3578760026,3578760066,40
2,1460,49034,3578760026,3578760066,40
2,1460,49035,3578760026,3578760066,40
2,1460,49036,3578760026,3578760067,41
2,1460,49037,3578760026,3578760068,42
2,1460,49038,3578760026,3578760071,45
2,1461,49039,3578760089,3578760089,0
2,1461,49040,3578760089,3578760089,0
2,1461,49041,3578760089,3578760089,0
2,1461,49042,3578760089,3578760089,0
2,1461,49043,3578760089,3578760089,0
2,1461,49044,3578760089,3578760089,0
2,1461,49045,3578760089,3578760090,1
2,1461,49046,3578760089,3578760090,1
2,1461,49047,3578760089,3578760090,1
2,1461,49048,3578760089,3578760091,2
2,1461,49049,3578760089,3578760091,2
2,1461,49050,3578760089,3578760091,2
2,1461,49051,3578760089,3578760092,3
2,1461,49052,3578760089,3578760092,3
2,1461,49053,3578760089,3578760093,4
2,1461,49054,3578760089,3578760095,6
2,1461,49055,3578760089,3578760096,7
2,1461,49056,3578760089,3578760097,8
2,1461,49057,3578760089,3578760098,9
2,1461,49058,3578760089,3578760098,9
2,1461,49059,3578760089,3578760099,10
2,1461,49060,3578760089,3578760099,10
2,1461,49061,3578760089,3578760099,10
2,1461,49062,3578760089,3578760099,10
2,1461,49063,3578760089,3578760100,11
2,1461,49064,3578760089,3578760101,12
2,1461,49065,3578760089,3578760102,13
2,1461,49066,3578760089,3578760102,13
2,1461,49067,3578760089,3578760102,13
2,1461,49068,3578760089,3578760103,14
2,1461,49069,3578760089,3578760103,14
2,1461,49070,3578760089,3578760103,14
2,1461,49071,3578760089,3578760104,15
2,1461,49072,3578760089,3578760105,16
2,1461,49073,3578760089,3578760107,18
2,1461,49074,3578760089,3578760110,21
2,1461,49075,3578760089,3578760111,22
2,1461,49076,3578760089,3578760111,22
2,1461,49077,3578760089,3578760111,22
2,1461,49078,3578760089,3578760112,23
2,1461,49079,3578760089,3578760113,24
2,1461,49080,3578760089,3578760113,24
2,1461,49081,3578760089,3578760113,24
2,1461,49082,3578760089,3578760114,25
2,1461,49083,3578760089,3578760114,25
2,1461,49084,3578760089,3578760115,26
2,1461,49085,3578760089,3578760116,27
2,1461,49086,3578760089,3578760116,27
2,1461,49087,3578760089,3578760116,27
2,1461,49088,3578760089,3578760117,28
2,1461,49089,3578760089,3578760117,28
2,1461,49090,3578760089,3578760118,29
2,1461,49091,3578760089,3578760120,31
2,1461,49092,3578760089,3578760121,32
2,1461,49093,3578760089,3578760121,32
2,1461,49094,3578760089,3578760121,32
2,1461,49095,3578760089,3578760122,33
2,1461,49096,3578760089,3578760123,34
2,1461,49097,3578760089,3578760123,34
2,1461,49098,3578760089,3578760123,34
2,1461,49099,3578760089,3578760124,35
2,1461,49100,3578760089,3578760125,36
2,1461,49101,3578760089,3578760125,36
2,1461,49102,3578760089,3578760126,37
2,1461,49103,3578760089,3578760126,37
2,1461,49104,3578760089,3578760127,38
2,1461,49105,3578760089,3578760131,42
2,1461,49106,3578760089,3578760131,42
2,1461,49107,3578760089,3578760132,43
2,1461,49108,3578760089,3578760133,44
2,1461,49109,3578760089,3578760133,44
2,1461,49110,3578760089,3578760134,45
2,1461,49111,3578760089,3578760135,46
2,1461,49112,3578760089,3578760136,47
2,1461,49113,3578760089,3578760137,48
2,1461,49114,3578760089,3578760138,49
2,1461,49115,3578760089,3578760139,50
2,1461,49116,3578760089,3578760139,50
2,1461,49117,3578760089,3578760139,50
2,1461,49118,3578760089,3578760139,50
2,1462,49119,3578760153,3578760153,0
2,1462,49120,3578760153,3578760153,0
2,1462,49121,3578760153,3578760153,0
2,1462,49122,3578760153,3578760153,0
2,1462,49123,3578760153,3578760153,0
2,1462,49124,3578760153,3578760153,0
2,1462,49125,3578760153,3578760153,0
2,1462,49126,3578760153,3578760153,0
2,1462,49127,3578760153,3578760153,0
2,1462,49128,3578760153,3578760153,0
2,1462,49129,3578760153,3578760153,0
2,1462,49130,3578760153,3578760153,0
2,1462,49131,3578760153,3578760153,0
2,1462,49132,3578760153,3578760153,0
2,1462,49133,3578760153,3578760153,0
2,1462,49134,3578760153,3578760153,0
2,1462,49135,3578760153,3578760154,1
2,1462,49136,3578760153,3578760155,2
2,1462,49137,3578760153,3578760155,2
2,1462,49138,3578760153,3578760155,2
2,1462,49139,3578760153,3578760157,4
2,1462,49140,3578760153,3578760160,7
2,1462,49141,3578760153,3578760162,9
2,1462,49142,3578760153,3578760163,10
2,1462,49143,3578760153,3578760164,11
2,1462,49144,3578760153,3578760165,12
2,1462,49145,3578760153,3578760165,12
2,1462,49146,3578760153,3578760166,13
2,1462,49147,3578760153,3578760166,13
2,1462,49148,3578760153,3578760167,14
2,1462,49149,3578760153,3578760168,15
2,1462,49150,3578760153,3578760169,16
2,1462,49151,3578760153,3578760171,18
2,1462,49152,3578760153,3578760171,18
2,1462,49153,3578760153,3578760174,21
2,1462,49154,3578760153,3578760174,21
2,1462,49155,3578760153,3578760174,21
2,1462,49156,3578760153,3578760176,23
2,1462,49157,3578760153,3578760179,26
2,1462,49158,3578760153,3578760179,26
2,1462,49159,3578760153,3578760180,27
2,1462,49160,3578760153,3578760183,30
2,1462,49161,3578760153,3578760184,31
2,1462,49162,3578760153,3578760184,31
2,1462,49163,3578760153,3578760185,32
2,1462,49164,3578760153,3578760188,35
2,1462,49165,3578760153,3578760188,35
2,1462,49166,3578760153,3578760188,35
2,1462,49167,3578760153,3578760189,36
2,1462,49168,3578760153,3578760190,37
2,1462,49169,3578760153,3578760190,37
2,1462,49170,3578760153,3578760190,37
2,1462,49171,3578760153,3578760192,39
2,1462,49172,3578760153,3578760193,40
2,1462,49173,3578760153,3578760193,40
2,1462,49174,3578760153,3578760194,41
2,1462,49175,3578760153,3578760199,46
2,1462,49176,3578760153,3578760199,46
2,1462,49177,3578760153,3578760200,47
2,1462,49178,3578760153,3578760201,48
2,1462,49179,3578760153,3578760202,49
2,1463,49180,3578760216,3578760216,0
2,1463,49181,3578760216,3578760216,0
2,1463,49182,3578760216,3578760216,0
2,1463,49183,3578760216,3578760216,0
2,1463,49184,3578760216,3578760216,0
2,1463,49185,3578760216,3578760216,0
2,1463,49186,3578760216,3578760216,0
2,1463,49187,3578760216,3578760216,0
2,1463,49188,3578760216,3578760216,0
2,1463,49189,3578760216,3578760216,0
2,1463,49190,3578760216,3578760216,0
2,1463,49191,3578760216,3578760216,0
2,1463,49192,3578760216,3578760216,0
2,1463,49193,3578760216,3578760216,0
2,1463,49194,3578760216,3578760217,1
2,1463,49195,3578760216,3578760217,1
2,1463,49196,3578760216,3578760218,2
2,1463,49197,3578760216,3578760219,3
2,1463,49198,3578760216,3578760220,4
2,1463,49199,3578760216,3578760223,7
2,1463,49200,3578760216,3578760224,8
2,1463,49201,3578760216,3578760224,8
2,1463,49202,3578760216,3578760224,8
2,1463,49203,3578760216,3578760225,9
2,1463,49204,3578760216,3578760225,9
2,1463,49205,3578760216,3578760227,11
2,1463,49206,3578760216,3578760227,11
2,1463,49207,3578760216,3578760227,11
2,1463,49208,3578760216,3578760228,12
2,1463,49209,3578760216,3578760229,13
2,1463,49210,3578760216,3578760231,15
2,1463,49211,3578760216,3578760231,15
2,1463,49212,3578760216,3578760232,16
2,1463,49213,3578760216,3578760232,16
2,1463,49214,3578760216,3578760233,17
2,1463,49215,3578760216,3578760233,17
2,1463,49216,3578760216,3578760235,19
2,1463,49217,3578760216,3578760236,20
2,1463,49218,3578760216,3578760237,21
2,1463,49219,3578760216,3578760237,21
2,1463,49220,3578760216,3578760237,21
2,1463,49221,3578760216,3578760237,21
2,1463,49222,3578760216,3578760239,23
2,1463,49223,3578760216,3578760239,23
2,1463,49224,3578760216,3578760240,24
2,1463,49225,3578760216,3578760240,24
2,1463,49226,3578760216,3578760240,24
2,1463,49227,3578760216,3578760241,25
2,1463,49228,3578760216,3578760242,26
2,1463,49229,3578760216,3578760242,26
2,1463,49230,3578760216,3578760242,26
2,1463,49231,3578760216,3578760244,28
2,1463,49232,3578760216,3578760244,28
2,1463,49233,3578760216,3578760245,29
2,1463,49234,3578760216,3578760245,29
2,1463,49235,3578760216,3578760246,30
2,1463,49236,3578760216,3578760246,30
2,1463,49237,3578760216,3578760246,30
2,1463,49238,3578760216,3578760250,34
2,1463,49239,3578760216,3578760251,35
2,1463,49240,3578760216,3578760252,36
2,1463,49241,3578760216,3578760253,37
2,1463,49242,3578760216,3578760253,37
2,1463,49243,3578760216,3578760253,37
2,1463,49244,3578760216,3578760255,39
2,1463,49245,3578760216,3578760255,39
2,1463,49246,3578760216,3578760256,40
2,1463,49247,3578760216,3578760256,40
2,1463,49248,3578760216,3578760256,40
2,1463,49249,3578760216,3578760258,42
2,1463,49250,3578760216,3578760258,42
2,1463,49251,3578760216,3578760261,45
2,1463,49252,3578760216,3578760261,45
2,1463,49253,3578760216,3578760261,45
2,1463,49254,3578760216,3578760266,50
2,1463,49255,3578760216,3578760266,50
2,1464,49256,3578760281,3578760281,0
2,1464,49257,3578760281,3578760281,0
2,1464,49258,3578760281,3578760281,0
2,1464,49259,3578760281,3578760281,0
2,1464,49260,3578760281,3578760281,0
2,1464,49261,3578760281,3578760282,1
2,1464,49262,3578760281,3578760283,2
2,1464,49263,3578760281,3578760283,2
2,1464,49264,3578760281,3578760284,3
2,1464,49265,3578760281,3578760285,4
2,1464,49266,3578760281,3578760290,9
2,1464,49267,3578760281,3578760290,9
2,1464,49268,3578760281,3578760290,9
2,1464,49269,3578760281,3578760290,9
2,1464,49270,3578760281,3578760291,10
2,1464,49271,3578760281,3578760291,10
2,1464,49272,3578760281,3578760291,10
2,1464,49273,3578760281,3578760293,12
2,1464,49274,3578760281,3578760293,12
2,1464,49275,3578760281,3578760294,13
2,1464,49276,3578760281,3578760295,14
2,1464,49277,3578760281,3578760296,15
2,1464,49278,3578760281,3578760297,16
2,1464,49279,3578760281,3578760297,16
2,1464,49280,3578760281,3578760298,17
2,1464,49281,3578760281,3578760298,17
2,1464,49282,3578760281,3578760299,18
2,1464,49283,3578760281,3578760299,18
2,1464,49284,3578760281,3578760300,19
2,1464,49285,3578760281,3578760300,19
2,1464,49286,3578760281,3578760300,19
2,1464,49287,3578760281,3578760300,19
2,1464,49288,3578760281,3578760301,20
2,1464,49289,3578760281,3578760302,21
2,1464,49290,3578760281,3578760302,21
2,1464,49291,3578760281,3578760302,21
2,1464,49292,3578760281,3578760303,22
2,1464,49293,3578760281,3578760303,22
2,1464,49294,3578760281,3578760305,24
2,1464,49295,3578760281,3578760306,25
2,1464,49296,3578760281,3578760308,27
2,1464,49297,3578760281,3578760310,29
2,1464,49298,3578760281,3578760310,29
2,1464,49299,3578760281,3578760311,30
2,1464,49300,3578760281,3578760312,31
2,1464,49301,3578760281,3578760312,31
2,1464,49302,3578760281,3578760313,32
2,1464,49303,3578760281,3578760313,32
2,1464,49304,3578760281,3578760313,32
2,1464,49305,3578760281,3578760314,33
2,1464,49306,3578760281,3578760315,34
2,1464,49307,3578760281,3578760315,34
2,1464,49308,3578760281,3578760316,35
2,1464,49309,3578760281,3578760316,35
2,1464,49310,3578760281,3578760316,35
2,1464,49311,3578760281,3578760317,36
2,1464,49312,3578760281,3578760317,36
2,1464,49313,3578760281,3578760318,37
2,1464,49314,3578760281,3578760319,38
2,1464,49315,3578760281,3578760320,39
2,1464,49316,3578760281,3578760321,40
2,1464,49317,3578760281,3578760321,40
2,1464,49318,3578760281,3578760322,41
2,1464,49319,3578760281,3578760323,42
2,1464,49320,3578760281,3578760323,42
2,1464,49321,3578760281,3578760325,44
2,1464,49322,3578760281,3578760326,45
2,1464,49323,3578760281,3578760326,45
2,1464,49324,3578760281,3578760326,45
2,1464,49325,3578760281,3578760326,45
2,1464,49326,3578760281,3578760330,49
2,1465,49327,3578760345,3578760345,0
2,1465,49328,3578760345,3578760345,0
2,1465,49329,3578760345,3578760345,0
2,1465,49330,3578760345,3578760345,0
2,1465,49331,3578760345,3578760345,0
2,1465,49332,3578760345,3578760345,0
2,1465,49333,3578760345,3578760345,0
2,1465,49334,3578760345,3578760345,0
2,1465,49335,3578760345,3578760345,0
2,1465,49336,3578760345,3578760345,0
2,1465,49337,3578760345,3578760345,0
2,1465,49338,3578760345,3578760345,0
2,1465,49339,3578760345,3578760345,0
2,1465,49340,3578760345,3578760345,0
2,1465,49341,3578760345,3578760345,0
2,1465,49342,3578760345,3578760345,0
2,1465,49343,3578760345,3578760345,0
2,1465,49344,3578760345,3578760345,0
2,1465,49345,3578760345,3578760345,0
2,1465,49346,3578760345,3578760348,3
2,1465,49347,3578760345,3578760348,3
2,1465,49348,3578760345,3578760350,5
2,1465,49349,3578760345,3578760350,5
2,1465,49350,3578760345,3578760351,6
2,1465,49351,3578760345,3578760351,6
2,1465,49352,3578760345,3578760351,6
2,1465,49353,3578760345,3578760352,7
2,1465,49354,3578760345,3578760352,7
2,1465,49355,3578760345,3578760354,9
2,1465,49356,3578760345,3578760354,9
2,1465,49357,3578760345,3578760356,11
2,1465,49358,3578760345,3578760356,11
2,1465,49359,3578760345,3578760357,12
2,1465,49360,3578760345,3578760357,12
2,1465,49361,3578760345,3578760360,15
2,1465,49362,3578760345,3578760362,17
2,1465,49363,3578760345,3578760363,18
2,1465,49364,3578760345,3578760364,19
2,1465,49365,3578760345,3578760366,21
2,1465,49366,3578760345,3578760366,21
2,1465,49367,3578760345,3578760366,21
2,1465,49368,3578760345,3578760366,21
2,1465,49369,3578760345,3578760366,21
2,1465,49370,3578760345,3578760369,24
2,1465,49371,3578760345,3578760369,24
2,1465,49372,3578760345,3578760370,25
2,1465,49373,3578760345,3578760370,25
2,1465,49374,3578760345,3578760370,25
2,1465,49375,3578760345,3578760372,27
2,1465,49376,3578760345,3578760372,27
2,1465,49377,3578760345,3578760374,29
2,1465,49378,3578760345,3578760374,29
2,1465,49379,3578760345,3578760375,30
2,1465,49380,3578760345,3578760377,32
2,1465,49381,3578760345,3578760378,33
2,1465,49382,3578760345,3578760379,34
2,1465,49383,3578760345,3578760380,35
2,1465,49384,3578760345,3578760383,38
2,1465,49385,3578760345,3578760384,39
2,1465,49386,3578760345,3578760385,40
2,1465,49387,3578760345,3578760385,40
2,1465,49388,3578760345,3578760385,40
2,1465,49389,3578760345,3578760388,43
2,1465,49390,3578760345,3578760389,44
2,1465,49391,3578760345,3578760389,44
2,1465,49392,3578760345,3578760389,44
2,1465,49393,3578760345,3578760389,44
2,1465,49394,3578760345,3578760390,45
2,1465,49395,3578760345,3578760391,46
2,1465,49396,3578760345,3578760392,47
2,1465,49397,3578760345,3578760393,48
2,1465,49398,3578760345,3578760393,48
2,1465,49399,3578760345,3578760394,49
2,1465,49400,3578760345,3578760394,49
2,1466,49401,3578760409,3578760409,0
2,1466,49402,3578760409,3578760409,0
2,1466,49403,3578760409,3578760409,0
2,1466,49404,3578760409,3578760409,0
2,1466,49405,3578760409,3578760409,0
2,1466,49406,3578760409,3578760409,0
2,1466,49407,3578760409,3578760409,0
2,1466,49408,3578760409,3578760409,0
2,1466,49409,3578760409,3578760409,0
2,1466,49410,3578760409,3578760409,0
2,1466,49411,3578760409,3578760409,0
2,1466,49412,3578760409,3578760409,0
2,1466,49413,3578760409,3578760409,0
2,1466,49414,3578760409,3578760409,0
2,1466,49415,3578760409,3578760411,2
2,1466,49416,3578760409,3578760412,3
2,1466,49417,3578760409,3578760413,4
2,1466,49418,3578760409,3578760414,5
2,1466,49419,3578760409,3578760414,5
2,1466,49420,3578760409,3578760415,6
2,1466,49421,3578760409,3578760417,8
2,1466,49422,3578760409,3578760417,8
2,1466,49423,3578760409,3578760418,9
2,1466,49424,3578760409,3578760419,10
2,1466,49425,3578760409,3578760421,12
2,1466,49426,3578760409,3578760423,14
2,1466,49427,3578760409,3578760425,16
2,1466,49428,3578760409,3578760425,16
2,1466,49429,3578760409,3578760425,16
2,1466,49430,3578760409,3578760425,16
2,1466,49431,3578760409,3578760426,17
2,1466,49432,3578760409,3578760426,17
2,1466,49433,3578760409,3578760427,18
2,1466,49434,3578760409,3578760428,19
2,1466,49435,3578760409,3578760428,19
2,1466,49436,3578760409,3578760429,20
2,1466,49437,3578760409,3578760431,22
2,1466,49438,3578760409,3578760432,23
2,1466,49439,3578760409,3578760432,23
2,1466,49440,3578760409,3578760433,24
2,1466,49441,3578760409,3578760434,25
2,1466,49442,3578760409,3578760435,26
2,1466,49443,3578760409,3578760436,27
2,1466,49444,3578760409,3578760437,28
2,1466,49445,3578760409,3578760437,28
2,1466,49446,3578760409,3578760437,28
2,1466,49447,3578760409,3578760437,28
2,1466,49448,3578760409,3578760438,29
2,1466,49449,3578760409,3578760439,30
2,1466,49450,3578760409,3578760439,30
2,1466,49451,3578760409,3578760440,31
2,1466,49452,3578760409,3578760440,31
2,1466,49453,3578760409,3578760440,31
2,1466,49454,3578760409,3578760441,32
2,1466,49455,3578760409,3578760441,32
2,1466,49456,3578760409,3578760442,33
2,1466,49457,3578760409,3578760443,34
2,1466,49458,3578760409,3578760444,35
2,1466,49459,3578760409,3578760445,36
2,1466,49460,3578760409,3578760445,36
2,1466,49461,3578760409,3578760445,36
2,1466,49462,3578760409,3578760445,36
2,1466,49463,3578760409,3578760446,37
2,1466,49464,3578760409,3578760446,37
2,1466,49465,3578760409,3578760447,38
2,1466,49466,3578760409,3578760448,39
2,1466,49467,3578760409,3578760449,40
2,1466,49468,3578760409,3578760450,41
2,1466,49469,3578760409,3578760451,42
2,1466,49470,3578760409,3578760451,42
2,1466,49471,3578760409,3578760452,43
2,1466,49472,3578760409,3578760452,43
2,1466,49473,3578760409,3578760453,44
2,1466,49474,3578760409,3578760453,44
2,1466,49475,3578760409,3578760454,45
2,1466,49476,3578760409,3578760454,45
2,1466,49477,3578760409,3578760455,46
2,1466,49478,3578760409,3578760456,47
2,1466,49479,3578760409,3578760456,47
2,1466,49480,3578760409,3578760457,48
2,1466,49481,3578760409,3578760458,49
2,1466,49482,3578760409,3578760458,49
2,1467,49483,3578760473,3578760473,0
2,1467,49484,3578760473,3578760473,0
2,1467,49485,3578760473,3578760473,0
2,1467,49486,3578760473,3578760473,0
2,1467,49487,3578760473,3578760473,0
2,1467,49488,3578760473,3578760473,0
2,1467,49489,3578760473,3578760473,0
2,1467,49490,3578760473,3578760473,0
2,1467,49491,3578760473,3578760473,0
2,1467,49492,3578760473,3578760473,0
2,1467,49493,3578760473,3578760477,4
2,1467,49494,3578760473,3578760478,5
2,1467,49495,3578760473,3578760481,8
2,1467,49496,3578760473,3578760483,10
2,1467,49497,3578760473,3578760483,10
2,1467,49498,3578760473,3578760483,10
2,1467,49499,3578760473,3578760484,11
2,1467,49500,3578760473,3578760490,17
2,1467,49501,3578760473,3578760490,17
2,1467,49502,3578760473,3578760491,18
2,1467,49503,3578760473,3578760491,18
2,1467,49504,3578760473,3578760491,18
2,1467,49505,3578760473,3578760492,19
2,1467,49506,3578760473,3578760492,19
2,1467,49507,3578760473,3578760493,20
2,1467,49508,3578760473,3578760493,20
2,1467,49509,3578760473,3578760493,20
2,1467,49510,3578760473,3578760494,21
2,1467,49511,3578760473,3578760496,23
2,1467,49512,3578760473,3578760497,24
2,1467,49513,3578760473,3578760498,25
2,1467,49514,3578760473,3578760498,25
2,1467,49515,3578760473,3578760499,26
2,1467,49516,3578760473,3578760499,26
2,1467,49517,3578760473,3578760500,27
2,1467,49518,3578760473,3578760500,27
2,1467,49519,3578760473,3578760500,27
2,1467,49520,3578760473,3578760500,27
2,1467,49521,3578760473,3578760500,27
2,1467,49522,3578760473,3578760500,27
2,1467,49523,3578760473,3578760501,28
2,1467,49524,3578760473,3578760502,29
2,1467,49525,3578760473,3578760502,29
2,1467,49526,3578760473,3578760503,30
2,1467,49527,3578760473,3578760503,30
2,1467,49528,3578760473,3578760504,31
2,1467,49529,3578760473,3578760505,32
2,1467,49530,3578760473,3578760506,33
2,1467,49531,3578760473,3578760507,34
2,1467,49532,3578760473,3578760510,37
2,1467,49533,3578760473,3578760510,37
2,1467,49534,3578760473,3578760511,38
2,1467,49535,3578760473,3578760511,38
2,1467,49536,3578760473,3578760512,39
2,1467,49537,3578760473,3578760512,39
2,1467,49538,3578760473,3578760512,39
2,1467,49539,3578760473,3578760513,40
2,1467,49540,3578760473,3578760514,41
2,1467,49541,3578760473,3578760515,42
2,1467,49542,3578760473,3578760515,42
2,1467,49543,3578760473,3578760515,42
2,1467,49544,3578760473,3578760516,43
2,1467,49545,3578760473,3578760517,44
2,1467,49546,3578760473,3578760517,44
2,1467,49547,3578760473,3578760518,45
2,1467,49548,3578760473,3578760518,45
2,1467,49549,3578760473,3578760519,46
2,1467,49550,3578760473,3578760520,47
2,1467,49551,3578760473,3578760521,48
2,1467,49552,3578760473,3578760523,50
2,1468,49553,3578760536,3578760536,0
2,1468,49554,3578760536,3578760536,0
2,1468,49555,3578760536,3578760536,0
2,1468,49556,3578760536,3578760536,0
2,1468,49557,3578760536,3578760536,0
2,1468,49558,3578760536,3578760536,0
2,1468,49559,3578760536,3578760536,0
2,1468,49560,3578760536,3578760536,0
2,1468,49561,3578760536,3578760536,0
2,1468,49562,3578760536,3578760536,0
2,1468,49563,3578760536,3578760536,0
2,1468,49564,3578760536,3578760536,0
2,1468,49565,3578760536,3578760536,0
2,1468,49566,3578760536,3578760536,0
2,1468,49567,3578760536,3578760536,0
2,1468,49568,3578760536,3578760536,0
2,1468,49569,3578760536,3578760536,0
2,1468,49570,3578760536,3578760537,1
2,1468,49571,3578760536,3578760537,1
2,1468,49572,3578760536,3578760537,1
2,1468,49573,3578760536,3578760538,2
2,1468,49574,3578760536,3578760538,2
2,1468,49575,3578760536,3578760538,2
2,1468,49576,3578760536,3578760538,2
2,1468,49577,3578760536,3578760540,4
2,1468,49578,3578760536,3578760542,6
2,1468,49579,3578760536,3578760543,7
2,1468,49580,3578760536,3578760544,8
2,1468,49581,3578760536,3578760544,8
2,1468,49582,3578760536,3578760547,11
2,1468,49583,3578760536,3578760548,12
2,1468,49584,3578760536,3578760549,13
2,1468,49585,3578760536,3578760550,14
2,1468,49586,3578760536,3578760550,14
2,1468,49587,3578760536,3578760550,14
2,1468,49588,3578760536,3578760550,14
2,1468,49589,3578760536,3578760551,15
2,1468,49590,3578760536,3578760552,16
2,1468,49591,3578760536,3578760554,18
2,1468,49592,3578760536,3578760554,18
2,1468,49593,3578760536,3578760554,18
2,1468,49594,3578760536,3578760555,19
2,1468,49595,3578760536,3578760555,19
2,1468,49596,3578760536,3578760556,20
2,1468,49597,3578760536,3578760559,23
2,1468,49598,3578760536,3578760561,25
2,1468,49599,3578760536,3578760563,27
2,1468,49600,3578760536,3578760563,27
2,1468,49601,3578760536,3578760565,29
2,1468,49602,3578760536,3578760565,29
2,1468,49603,3578760536,3578760565,29
2,1468,49604,3578760536,3578760566,30
2,1468,49605,3578760536,3578760568,32
2,1468,49606,3578760536,3578760568,32
2,1468,49607,3578760536,3578760569,33
2,1468,49608,3578760536,3578760569,33
2,1468,49609,3578760536,3578760570,34
2,1468,49610,3578760536,3578760570,34
2,1468,49611,3578760536,3578760572,36
2,1468,49612,3578760536,3578760573,37
2,1468,49613,3578760536,3578760573,37
2,1468,49614,3578760536,3578760573,37
2,1468,49615,3578760536,3578760575,39
2,1468,49616,3578760536,3578760576,40
2,1468,49617,3578760536,3578760578,42
2,1468,49618,3578760536,3578760579,43
2,1468,49619,3578760536,3578760582,46
2,1468,49620,3578760536,3578760583,47
2,1468,49621,3578760536,3578760584,48
2,1468,49622,3578760536,3578760584,48
2,1468,49623,3578760536,3578760584,48
2,1468,49624,3578760536,3578760585,49
2,1469,49625,3578760598,3578760598,0
2,1469,49626,3578760598,3578760598,0
2,1469,49627,3578760598,3578760598,0
2,1469,49628,3578760598,3578760598,0
2,1469,49629,3578760598,3578760598,0
2,1469,49630,3578760598,3578760598,0
2,1469,49631,3578760598,3578760598,0
2,1469,49632,3578760598,3578760598,0
2,1469,49633,3578760598,3578760598,0
2,1469,49634,3578760598,3578760598,0
2,1469,49635,3578760598,3578760598,0
2,1469,49636,3578760598,3578760598,0
2,1469,49637,3578760598,3578760600,2
2,1469,49638,3578760598,3578760601,3
2,1469,49639,3578760598,3578760601,3
2,1469,49640,3578760598,3578760602,4
2,1469,49641,3578760598,3578760603,5
2,1469,49642,3578760598,3578760604,6
2,1469,49643,3578760598,3578760604,6
2,1469,49644,3578760598,3578760604,6
2,1469,49645,3578760598,3578760605,7
2,1469,49646,3578760598,3578760605,7
2,1469,49647,3578760598,3578760607,9
2,1469,49648,3578760598,3578760607,9
2,1469,49649,3578760598,3578760611,13
2,1469,49650,3578760598,3578760611,13
2,1469,49651,3578760598,3578760612,14
2,1469,49652,3578760598,3578760613,15
2,1469,49653,3578760598,3578760613,15
2,1469,49654,3578760598,3578760616,18
2,1469,49655,3578760598,3578760616,18
2,1469,49656,3578760598,3578760617,19
2,1469,49657,3578760598,3578760619,21
2,1469,49658,3578760598,3578760620,22
2,1469,49659,3578760598,3578760622,24
2,1469,49660,3578760598,3578760624,26
2,1469,49661,3578760598,3578760624,26
2,1469,49662,3578760598,3578760624,26
2,1469,49663,3578760598,3578760625,27
2,1469,49664,3578760598,3578760625,27
2,1469,49665,3578760598,3578760625,27
2,1469,49666,3578760598,3578760626,28
2,1469,49667,3578760598,3578760627,29
2,1469,49668,3578760598,3578760628,30
2,1469,49669,3578760598,3578760628,30
2,1469,49670,3578760598,3578760628,30
2,1469,49671,3578760598,3578760631,33
2,1469,49672,3578760598,3578760631,33
2,1469,49673,3578760598,3578760631,33
2,1469,49674,3578760598,3578760631,33
2,1469,49675,3578760598,3578760632,34
2,1469,49676,3578760598,3578760632,34
2,1469,49677,3578760598,3578760635,37
2,1469,49678,3578760598,3578760635,37
2,1469,49679,3578760598,3578760635,37
2,1469,49680,3578760598,3578760636,38
2,1469,49681,3578760598,3578760636,38
2,1469,49682,3578760598,3578760636,38
2,1469,49683,3578760598,3578760636,38
2,1469,49684,3578760598,3578760637,39
2,1469,49685,3578760598,3578760638,40
2,1469,49686,3578760598,3578760638,40
2,1469,49687,3578760598,3578760638,40
2,1469,49688,3578760598,3578760639,41
2,1469,49689,3578760598,3578760640,42
2,1469,49690,3578760598,3578760641,43
2,1469,49691,3578760598,3578760641,43
2,1469,49692,3578760598,3578760641,43
2,1469,49693,3578760598,3578760643,45
2,1469,49694,3578760598,3578760644,46
2,1469,49695,3578760598,3578760644,46
2,1469,49696,3578760598,3578760644,46
2,1469,49697,3578760598,3578760644,46
2,1469,49698,3578760598,3578760644,46
2,1469,49699,3578760598,3578760645,47
2,1469,49700,3578760598,3578760646,48
2,1469,49701,3578760598,3578760646,48
2,1469,49702,3578760598,3578760647,49
2,1470,49703,3578760663,3578760663,0
2,1470,49704,3578760663,3578760663,0
2,1470,49705,3578760663,3578760663,0
2,1470,49706,3578760663,3578760663,0
2,1470,49707,3578760663,3578760663,0
2,1470,49708,3578760663,3578760663,0
2,1470,49709,3578760663,3578760663,0
2,1470,49710,3578760663,3578760663,0
2,1470,49711,3578760663,3578760663,0
2,1470,49712,3578760663,3578760663,0
2,1470,49713,3578760663,3578760663,0
2,1470,49714,3578760663,3578760663,0
2,1470,49715,3578760663,3578760663,0
2,1470,49716,3578760663,3578760663,0
2,1470,49717,3578760663,3578760663,0
2,1470,49718,3578760663,3578760663,0
2,1470,49719,3578760663,3578760663,0
2,1470,49720,3578760663,3578760663,0
2,1470,49721,3578760663,3578760663,0
2,1470,49722,3578760663,3578760664,1
2,1470,49723,3578760663,3578760665,2
2,1470,49724,3578760663,3578760666,3
2,1470,49725,3578760663,3578760667,4
2,1470,49726,3578760663,3578760668,5
2,1470,49727,3578760663,3578760670,7
2,1470,49728,3578760663,3578760677,14
2,1470,49729,3578760663,3578760681,18
2,1470,49730,3578760663,3578760683,20
2,1470,49731,3578760663,3578760683,20
2,1470,49732,3578760663,3578760683,20
2,1470,49733,3578760663,3578760684,21
2,1470,49734,3578760663,3578760685,22
2,1470,49735,3578760663,3578760690,27
2,1470,49736,3578760663,3578760691,28
2,1470,49737,3578760663,3578760691,28
2,1470,49738,3578760663,3578760691,28
2,1470,49739,3578760663,3578760691,28
2,1470,49740,3578760663,3578760692,29
2,1470,49741,3578760663,3578760692,29
2,1470,49742,3578760663,3578760692,29
2,1470,49743,3578760663,3578760693,30
2,1470,49744,3578760663,3578760695,32
2,1470,49745,3578760663,3578760696,33
2,1470,49746,3578760663,3578760697,34
2,1470,49747,3578760663,3578760698,35
2,1470,49748,3578760663,3578760698,35
2,1470,49749,3578760663,3578760698,35
2,1470,49750,3578760663,3578760699,36
2,1470,49751,3578760663,3578760699,36
2,1470,49752,3578760663,3578760699,36
2,1470,49753,3578760663,3578760700,37
2,1470,49754,3578760663,3578760700,37
2,1470,49755,3578760663,3578760700,37
2,1470,49756,3578760663,3578760701,38
2,1470,49757,3578760663,3578760701,38
2,1470,49758,3578760663,3578760702,39
2,1470,49759,3578760663,3578760702,39
2,1470,49760,3578760663,3578760702,39
2,1470,49761,3578760663,3578760703,40
2,1470,49762,3578760663,3578760703,40
2,1470,49763,3578760663,3578760704,41
2,1470,49764,3578760663,3578760705,42
2,1470,49765,3578760663,3578760706,43
2,1470,49766,3578760663,3578760707,44
2,1470,49767,3578760663,3578760710,47
2,1470,49768,3578760663,3578760711,48
2,1470,49769,3578760663,3578760711,48
2,1470,49770,3578760663,3578760712,49
2,1470,49771,3578760663,3578760712,49
2,1470,49772,3578760663,3578760712,49
2,1470,49773,3578760663,3578760713,50
2,1471,49774,3578760729,3578760729,0
2,1471,49775,3578760729,3578760729,0
2,1471,49776,3578760729,3578760729,0
2,1471,49777,3578760729,3578760729,0
2,1471,49778,3578760729,3578760729,0
2,1471,49779,3578760729,3578760729,0
2,1471,49780,3578760729,3578760729,0
2,1471,49781,3578760729,3578760729,0
2,1471,49782,3578760729,3578760729,0
2,1471,49783,3578760729,3578760729,0
2,1471,49784,3578760729,3578760729,0
2,1471,49785,3578760729,3578760729,0
2,1471,49786,3578760729,3578760729,0
2,1471,49787,3578760729,3578760729,0
2,1471,49788,3578760729,3578760729,0
2,1471,49789,3578760729,3578760729,0
2,1471,49790,3578760729,3578760729,0
2,1471,49791,3578760729,3578760729,0
2,1471,49792,3578760729,3578760729,0
2,1471,49793,3578760729,3578760729,0
2,1471,49794,3578760729,3578760729,0
2,1471,49795,3578760729,3578760729,0
2,1471,49796,3578760729,3578760729,0
2,1471,49797,3578760729,3578760730,1
2,1471,49798,3578760729,3578760731,2
2,1471,49799,3578760729,3578760731,2
2,1471,49800,3578760729,3578760732,3
2,1471,49801,3578760729,3578760733,4
2,1471,49802,3578760729,3578760735,6
2,1471,49803,3578760729,3578760735,6
2,1471,49804,3578760729,3578760736,7
2,1471,49805,3578760729,3578760737,8
2,1471,49806,3578760729,3578760737,8
2,1471,49807,3578760729,3578760738,9
2,1471,49808,3578760729,3578760738,9
2,1471,49809,3578760729,3578760738,9
2,1471,49810,3578760729,3578760739,10
2,1471,49811,3578760729,3578760740,11
2,1471,49812,3578760729,3578760740,11
2,1471,49813,3578760729,3578760742,13
2,1471,49814,3578760729,3578760744,15
2,1471,49815,3578760729,3578760744,15
2,1471,49816,3578760729,3578760745,16
2,1471,49817,3578760729,3578760747,18
2,1471,49818,3578760729,3578760748,19
2,1471,49819,3578760729,3578760750,21
2,1471,49820,3578760729,3578760750,21
2,1471,49821,3578760729,3578760750,21
2,1471,49822,3578760729,3578760750,21
2,1471,49823,3578760729,3578760751,22
2,1471,49824,3578760729,3578760751,22
2,1471,49825,3578760729,3578760752,23
2,1471,49826,3578760729,3578760753,24
2,1471,49827,3578760729,3578760754,25
2,1471,49828,3578760729,3578760754,25
2,1471,49829,3578760729,3578760755,26
2,1471,49830,3578760729,3578760756,27
2,1471,49831,3578760729,3578760756,27
2,1471,49832,3578760729,3578760756,27
2,1471,49833,3578760729,3578760759,30
2,1471,49834,3578760729,3578760760,31
2,1471,49835,3578760729,3578760762,33
2,1471,49836,3578760729,3578760765,36
2,1471,49837,3578760729,3578760765,36
2,1471,49838,3578760729,3578760765,36
2,1471,49839,3578760729,3578760766,37
2,1471,49840,3578760729,3578760766,37
2,1471,49841,3578760729,3578760768,39
2,1471,49842,3578760729,3578760769,40
2,1471,49843,3578760729,3578760769,40
2,1471,49844,3578760729,3578760769,40
2,1471,49845,3578760729,3578760770,41
2,1471,49846,3578760729,3578760771,42
2,1471,49847,3578760729,3578760771,42
2,1471,49848,3578760729,3578760772,43
2,1471,49849,3578760729,3578760773,44
2,1471,49850,3578760729,3578760774,45
2,1471,49851,3578760729,3578760774,45
2,1471,49852,3578760729,3578760774,45
2,1471,49853,3578760729,3578760776,47
2,1471,49854,3578760729,3578760779,50
2,1472,49855,3578760792,3578760792,0
2,1472,49856,3578760792,3578760792,0
2,1472,49857,3578760792,3578760792,0
2,1472,49858,3578760792,3578760792,0
2,1472,49859,3578760792,3578760792,0
2,1472,49860,3578760792,3578760792,0
2,1472,49861,3578760792,3578760792,0
2,1472,49862,3578760792,3578760792,0
2,1472,49863,3578760792,3578760792,0
2,1472,49864,3578760792,3578760792,0
2,1472,49865,3578760792,3578760792,0
2,1472,49866,3578760792,3578760792,0
2,1472,49867,3578760792,3578760792,0
2,1472,49868,3578760792,3578760792,0
2,1472,49869,3578760792,3578760792,0
2,1472,49870,3578760792,3578760792,0
2,1472,49871,3578760792,3578760793,1
2,1472,49872,3578760792,3578760794,2
2,1472,49873,3578760792,3578760797,5
2,1472,49874,3578760792,3578760798,6
2,1472,49875,3578760792,3578760799,7
2,1472,49876,3578760792,3578760800,8
2,1472,49877,3578760792,3578760800,8
2,1472,49878,3578760792,3578760801,9
2,1472,49879,3578760792,3578760802,10
2,1472,49880,3578760792,3578760803,11
2,1472,49881,3578760792,3578760804,12
2,1472,49882,3578760792,3578760804,12
2,1472,49883,3578760792,3578760804,12
2,1472,49884,3578760792,3578760805,13
2,1472,49885,3578760792,3578760807,15
2,1472,49886,3578760792,3578760808,16
2,1472,49887,3578760792,3578760811,19
2,1472,49888,3578760792,3578760811,19
2,1472,49889,3578760792,3578760812,20
2,1472,49890,3578760792,3578760813,21
2,1472,49891,3578760792,3578760814,22
2,1472,49892,3578760792,3578760816,24
2,1472,49893,3578760792,3578760816,24
2,1472,49894,3578760792,3578760816,24
2,1472,49895,3578760792,3578760819,27
2,1472,49896,3578760792,3578760822,30
2,1472,49897,3578760792,3578760823,31
2,1472,49898,3578760792,3578760824,32
2,1472,49899,3578760792,3578760825,33
2,1472,49900,3578760792,3578760825,33
2,1472,49901,3578760792,3578760826,34
2,1472,49902,3578760792,3578760827,35
2,1472,49903,3578760792,3578760828,36
2,1472,49904,3578760792,3578760829,37
2,1472,49905,3578760792,3578760830,38
2,1472,49906,3578760792,3578760831,39
2,1472,49907,3578760792,3578760831,39
2,1472,49908,3578760792,3578760832,40
2,1472,49909,3578760792,3578760833,41
2,1472,49910,3578760792,3578760833,41
2,1472,49911,3578760792,3578760834,42
2,1472,49912,3578760792,3578760835,43
2,1472,49913,3578760792,3578760835,43
2,1472,49914,3578760792,3578760837,45
2,1472,49915,3578760792,3578760837,45
2,1472,49916,3578760792,3578760838,46
2,1472,49917,3578760792,3578760838,46
2,1472,49918,3578760792,3578760838,46
2,1472,49919,3578760792,3578760839,47
2,1472,49920,3578760792,3578760839,47
2,1472,49921,3578760792,3578760841,49
2,1472,49922,3578760792,3578760841,49
2,1472,49923,3578760792,3578760841,49
2,1473,49924,3578760855,3578760855,0
2,1473,49925,3578760855,3578760855,0
2,1473,49926,3578760855,3578760855,0
2,1473,49927,3578760855,3578760855,0
2,1473,49928,3578760855,3578760855,0
2,1473,49929,3578760855,3578760855,0
2,1473,49930,3578760855,3578760855,0
2,1473,49931,3578760855,3578760855,0
2,1473,49932,3578760855,3578760855,0
2,1473,49933,3578760855,3578760855,0
2,1473,49934,3578760855,3578760855,0
2,1473,49935,3578760855,3578760855,0
2,1473,49936,3578760855,3578760855,0
2,1473,49937,3578760855,3578760855,0
2,1473,49938,3578760855,3578760855,0
2,1473,49939,3578760855,3578760855,0
2,1473,49940,3578760855,3578760855,0
2,1473,49941,3578760855,3578760855,0
2,1473,49942,3578760855,3578760855,0
2,1473,49943,3578760855,3578760855,0
2,1473,49944,3578760855,3578760855,0
2,1473,49945,3578760855,3578760856,1
2,1473,49946,3578760855,3578760857,2
2,1473,49947,3578760855,3578760860,5
2,1473,49948,3578760855,3578760861,6
2,1473,49949,3578760855,3578760862,7
2,1473,49950,3578760855,3578760863,8
2,1473,49951,3578760855,3578760864,9
2,1473,49952,3578760855,3578760866,11
2,1473,49953,3578760855,3578760866,11
2,1473,49954,3578760855,3578760867,12
2,1473,49955,3578760855,3578760868,13
2,1473,49956,3578760855,3578760871,16
2,1473,49957,3578760855,3578760877,22
2,1473,49958,3578760855,3578760879,24
2,1473,49959,3578760855,3578760881,26
2,1473,49960,3578760855,3578760883,28
2,1473,49961,3578760855,3578760883,28
2,1473,49962,3578760855,3578760883,28
2,1473,49963,3578760855,3578760884,29
2,1473,49964,3578760855,3578760886,31
2,1473,49965,3578760855,3578760890,35
2,1473,49966,3578760855,3578760890,35
2,1473,49967,3578760855,3578760891,36
2,1473,49968,3578760855,3578760891,36
2,1473,49969,3578760855,3578760892,37
2,1473,49970,3578760855,3578760892,37
2,1473,49971,3578760855,3578760892,37
2,1473,49972,3578760855,3578760892,37
2,1473,49973,3578760855,3578760892,37
2,1473,49974,3578760855,3578760893,38
2,1473,49975,3578760855,3578760895,40
2,1473,49976,3578760855,3578760896,41
2,1473,49977,3578760855,3578760897,42
2,1473,49978,3578760855,3578760897,42
2,1473,49979,3578760855,3578760898,43
2,1473,49980,3578760855,3578760899,44
2,1473,49981,3578760855,3578760900,45
2,1473,49982,3578760855,3578760900,45
2,1473,49983,3578760855,3578760900,45
2,1473,49984,3578760855,3578760901,46
2,1473,49985,3578760855,3578760901,46
2,1473,49986,3578760855,3578760901,46
2,1473,49987,3578760855,3578760902,47
2,1473,49988,3578760855,3578760902,47
2,1473,49989,3578760855,3578760902,47
2,1473,49990,3578760855,3578760903,48
2,1473,49991,3578760855,3578760903,48
2,1473,49992,3578760855,3578760904,49
2,1474,49993,3578760919,3578760919,0
2,1474,49994,3578760919,3578760919,0
2,1474,49995,3578760919,3578760919,0
2,1474,49996,3578760919,3578760919,0
2,1474,49997,3578760919,3578760919,0
2,1474,49998,3578760919,3578760919,0
2,1474,49999,3578760919,3578760919,0
2,1474,50000,3578760919,3578760919,0
2,1474,50001,3578760919,3578760919,0
2,1474,50002,3578760919,3578760919,0
2,1474,50003,3578760919,3578760919,0
2,1474,50004,3578760919,3578760919,0
2,1474,50005,3578760919,3578760919,0
2,1474,50006,3578760919,3578760919,0
2,1474,50007,3578760919,3578760919,0
2,1474,50008,3578760919,3578760919,0
2,1474,50009,3578760919,3578760919,0
2,1474,50010,3578760919,3578760919,0
2,1474,50011,3578760919,3578760919,0
2,1474,50012,3578760919,3578760919,0
2,1474,50013,3578760919,3578760919,0
2,1474,50014,3578760919,3578760921,2
2,1474,50015,3578760919,3578760922,3
2,1474,50016,3578760919,3578760922,3
2,1474,50017,3578760919,3578760923,4
2,1474,50018,3578760919,3578760923,4
2,1474,50019,3578760919,3578760923,4
2,1474,50020,3578760919,3578760923,4
2,1474,50021,3578760919,3578760924,5
2,1474,50022,3578760919,3578760924,5
2,1474,50023,3578760919,3578760926,7
2,1474,50024,3578760919,3578760926,7
2,1474,50025,3578760919,3578760927,8
2,1474,50026,3578760919,3578760927,8
2,1474,50027,3578760919,3578760928,9
2,1474,50028,3578760919,3578760928,9
2,1474,50029,3578760919,3578760930,11
2,1474,50030,3578760919,3578760931,12
2,1474,50031,3578760919,3578760931,12
2,1474,50032,3578760919,3578760933,14
2,1474,50033,3578760919,3578760934,15
2,1474,50034,3578760919,3578760935,16
2,1474,50035,3578760919,3578760936,17
2,1474,50036,3578760919,3578760937,18
2,1474,50037,3578760919,3578760938,19
2,1474,50038,3578760919,3578760939,20
2,1474,50039,3578760919,3578760939,20
2,1474,50040,3578760919,3578760939,20
2,1474,50041,3578760919,3578760939,20
2,1474,50042,3578760919,3578760939,20
2,1474,50043,3578760919,3578760940,21
2,1474,50044,3578760919,3578760940,21
2,1474,50045,3578760919,3578760941,22
2,1474,50046,3578760919,3578760944,25
2,1474,50047,3578760919,3578760945,26
2,1474,50048,3578760919,3578760945,26
2,1474,50049,3578760919,3578760947,28
2,1474,50050,3578760919,3578760947,28
2,1474,50051,3578760919,3578760950,31
2,1474,50052,3578760919,3578760950,31
2,1474,50053,3578760919,3578760950,31
2,1474,50054,3578760919,3578760951,32
2,1474,50055,3578760919,3578760951,32
2,1474,50056,3578760919,3578760951,32
2,1474,50057,3578760919,3578760953,34
2,1474,50058,3578760919,3578760955,36
2,1474,50059,3578760919,3578760955,36
2,1474,50060,3578760919,3578760955,36
2,1474,50061,3578760919,3578760956,37
2,1474,50062,3578760919,3578760957,38
2,1474,50063,3578760919,3578760957,38
2,1474,50064,3578760919,3578760959,40
2,1474,50065,3578760919,3578760961,42
2,1474,50066,3578760919,3578760964,45
2,1474,50067,3578760919,3578760965,46
2,1474,50068,3578760919,3578760966,47
2,1474,50069,3578760919,3578760966,47
2,1474,50070,3578760919,3578760966,47
2,1474,50071,3578760919,3578760966,47
2,1474,50072,3578760919,3578760968,49
2,1474,50073,3578760919,3578760969,50
2,1474,50074,3578760919,3578760969,50
2,1475,50075,3578760982,3578760982,0
2,1475,50076,3578760982,3578760982,0
2,1475,50077,3578760982,3578760982,0
2,1475,50078,3578760982,3578760982,0
2,1475,50079,3578760982,3578760982,0
2,1475,50080,3578760982,3578760982,0
2,1475,50081,3578760982,3578760982,0
2,1475,50082,3578760982,3578760982,0
2,1475,50083,3578760982,3578760982,0
2,1475,50084,3578760982,3578760982,0
2,1475,50085,3578760982,3578760982,0
2,1475,50086,3578760982,3578760982,0
2,1475,50087,3578760982,3578760982,0
2,1475,50088,3578760982,3578760984,2
2,1475,50089,3578760982,3578760984,2
2,1475,50090,3578760982,3578760985,3
2,1475,50091,3578760982,3578760985,3
2,1475,50092,3578760982,3578760985,3
2,1475,50093,3578760982,3578760987,5
2,1475,50094,3578760982,3578760988,6
2,1475,50095,3578760982,3578760989,7
2,1475,50096,3578760982,3578760989,7
2,1475,50097,3578760982,3578760990,8
2,1475,50098,3578760982,3578760990,8
2,1475,50099,3578760982,3578760991,9
2,1475,50100,3578760982,3578760991,9
2,1475,50101,3578760982,3578760992,10
2,1475,50102,3578760982,3578760994,12
2,1475,50103,3578760982,3578760994,12
2,1475,50104,3578760982,3578760998,16
2,1475,50105,3578760982,3578760998,16
2,1475,50106,3578760982,3578760999,17
2,1475,50107,3578760982,3578761000,18
2,1475,50108,3578760982,3578761000,18
2,1475,50109,3578760982,3578761003,21
2,1475,50110,3578760982,3578761003,21
2,1475,50111,3578760982,3578761003,21
2,1475,50112,3578760982,3578761005,23
2,1475,50113,3578760982,3578761006,24
2,1475,50114,3578760982,3578761007,25
2,1475,50115,3578760982,3578761008,26
2,1475,50116,3578760982,3578761011,29
2,1475,50117,3578760982,3578761012,30
2,1475,50118,3578760982,3578761012,30
2,1475,50119,3578760982,3578761012,30
2,1475,50120,3578760982,3578761014,32
2,1475,50121,3578760982,3578761016,34
2,1475,50122,3578760982,3578761016,34
2,1475,50123,3578760982,3578761016,34
2,1475,50124,3578760982,3578761016,34
2,1475,50125,3578760982,3578761019,37
2,1475,50126,3578760982,3578761022,40
2,1475,50127,3578760982,3578761024,42
2,1475,50128,3578760982,3578761024,42
2,1475,50129,3578760982,3578761025,43
2,1475,50130,3578760982,3578761025,43
2,1475,50131,3578760982,3578761026,44
2,1475,50132,3578760982,3578761027,45
2,1475,50133,3578760982,3578761028,46
2,1475,50134,3578760982,3578761029,47
2,1475,50135,3578760982,3578761031,49
2,1476,50136,3578761046,3578761046,0
2,1476,50137,3578761046,3578761046,0
2,1476,50138,3578761046,3578761046,0
2,1476,50139,3578761046,3578761046,0
2,1476,50140,3578761046,3578761046,0
2,1476,50141,3578761046,3578761046,0
2,1476,50142,3578761046,3578761046,0
2,1476,50143,3578761046,3578761046,0
2,1476,50144,3578761046,3578761046,0
2,1476,50145,3578761046,3578761046,0
2,1476,50146,3578761046,3578761046,0
2,1476,50147,3578761046,3578761047,1
2,1476,50148,3578761046,3578761047,1
2,1476,50149,3578761046,3578761047,1
2,1476,50150,3578761046,3578761047,1
2,1476,50151,3578761046,3578761047,1
2,1476,50152,3578761046,3578761047,1
2,1476,50153,3578761046,3578761047,1
2,1476,50154,3578761046,3578761047,1
2,1476,50155,3578761046,3578761047,1
2,1476,50156,3578761046,3578761047,1
2,1476,50157,3578761046,3578761047,1
2,1476,50158,3578761046,3578761047,1
2,1476,50159,3578761046,3578761047,1
2,1476,50160,3578761046,3578761047,1
2,1476,50161,3578761046,3578761047,1
2,1476,50162,3578761046,3578761047,1
2,1476,50163,3578761046,3578761047,1
2,1476,50164,3578761046,3578761049,3
2,1476,50165,3578761046,3578761050,4
2,1476,50166,3578761046,3578761050,4
2,1476,50167,3578761046,3578761051,5
2,1476,50168,3578761046,3578761052,6
2,1476,50169,3578761046,3578761053,7
2,1476,50170,3578761046,3578761053,7
2,1476,50171,3578761046,3578761053,7
2,1476,50172,3578761046,3578761054,8
2,1476,50173,3578761046,3578761055,9
2,1476,50174,3578761046,3578761056,10
2,1476,50175,3578761046,3578761057,11
2,1476,50176,3578761046,3578761058,12
2,1476,50177,3578761046,3578761060,14
2,1476,50178,3578761046,3578761061,15
2,1476,50179,3578761046,3578761062,16
2,1476,50180,3578761046,3578761065,19
2,1476,50181,3578761046,3578761065,19
2,1476,50182,3578761046,3578761066,20
2,1476,50183,3578761046,3578761066,20
2,1476,50184,3578761046,3578761067,21
2,1476,50185,3578761046,3578761067,21
2,1476,50186,3578761046,3578761068,22
2,1476,50187,3578761046,3578761070,24
2,1476,50188,3578761046,3578761077,31
2,1476,50189,3578761046,3578761079,33
2,1476,50190,3578761046,3578761081,35
2,1476,50191,3578761046,3578761083,37
2,1476,50192,3578761046,3578761084,38
2,1476,50193,3578761046,3578761084,38
2,1476,50194,3578761046,3578761084,38
2,1476,50195,3578761046,3578761086,40
2,1476,50196,3578761046,3578761091,45
2,1476,50197,3578761046,3578761091,45
2,1476,50198,3578761046,3578761091,45
2,1476,50199,3578761046,3578761091,45
2,1476,50200,3578761046,3578761091,45
2,1476,50201,3578761046,3578761091,45
2,1476,50202,3578761046,3578761091,45
2,1476,50203,3578761046,3578761093,47
2,1476,50204,3578761046,3578761093,47
2,1476,50205,3578761046,3578761093,47
2,1476,50206,3578761046,3578761095,49
2,1476,50207,3578761046,3578761096,50
2,1477,50208,3578761111,3578761111,0
2,1477,50209,3578761111,3578761111,0
2,1477,50210,3578761111,3578761111,0
2,1477,50211,3578761111,3578761111,0
2,1477,50212,3578761111,3578761111,0
2,1477,50213,3578761111,3578761111,0
2,1477,50214,3578761111,3578761111,0
2,1477,50215,3578761111,3578761111,0
2,1477,50216,3578761111,3578761111,0
2,1477,50217,3578761111,3578761111,0
2,1477,50218,3578761111,3578761111,0
2,1477,50219,3578761111,3578761111,0
2,1477,50220,3578761111,3578761111,0
2,1477,50221,3578761111,3578761111,0
2,1477,50222,3578761111,3578761111,0
2,1477,50223,3578761111,3578761111,0
2,1477,50224,3578761111,3578761111,0
2,1477,50225,3578761111,3578761111,0
2,1477,50226,3578761111,3578761111,0
2,1477,50227,3578761111,3578761111,0
2,1477,50228,3578761111,3578761111,0
2,1477,50229,3578761111,3578761111,0
2,1477,50230,3578761111,3578761112,1
2,1477,50231,3578761111,3578761113,2
2,1477,50232,3578761111,3578761113,2
2,1477,50233,3578761111,3578761113,2
2,1477,50234,3578761111,3578761114,3
2,1477,50235,3578761111,3578761115,4
2,1477,50236,3578761111,3578761116,5
2,1477,50237,3578761111,3578761116,5
2,1477,50238,3578761111,3578761117,6
2,1477,50239,3578761111,3578761117,6
2,1477,50240,3578761111,3578761117,6
2,1477,50241,3578761111,3578761118,7
2,1477,50242,3578761111,3578761118,7
2,1477,50243,3578761111,3578761118,7
2,1477,50244,3578761111,3578761119,8
2,1477,50245,3578761111,3578761120,9
2,1477,50246,3578761111,3578761121,10
2,1477,50247,3578761111,3578761122,11
2,1477,50248,3578761111,3578761123,12
2,1477,50249,3578761111,3578761123,12
2,1477,50250,3578761111,3578761124,13
2,1477,50251,3578761111,3578761124,13
2,1477,50252,3578761111,3578761125,14
2,1477,50253,3578761111,3578761125,14
2,1477,50254,3578761111,3578761125,14
2,1477,50255,3578761111,3578761127,16
2,1477,50256,3578761111,3578761127,16
2,1477,50257,3578761111,3578761127,16
2,1477,50258,3578761111,3578761128,17
2,1477,50259,3578761111,3578761130,19
2,1477,50260,3578761111,3578761131,20
2,1477,50261,3578761111,3578761132,21
2,1477,50262,3578761111,3578761133,22
2,1477,50263,3578761111,3578761134,23
2,1477,50264,3578761111,3578761135,24
2,1477,50265,3578761111,3578761136,25
2,1477,50266,3578761111,3578761138,27
2,1477,50267,3578761111,3578761138,27
2,1477,50268,3578761111,3578761139,28
2,1477,50269,3578761111,3578761139,28
2,1477,50270,3578761111,3578761139,28
2,1477,50271,3578761111,3578761139,28
2,1477,50272,3578761111,3578761139,28
2,1477,50273,3578761111,3578761140,29
2,1477,50274,3578761111,3578761141,30
2,1477,50275,3578761111,3578761142,31
2,1477,50276,3578761111,3578761144,33
2,1477,50277,3578761111,3578761144,33
2,1477,50278,3578761111,3578761145,34
2,1477,50279,3578761111,3578761147,36
2,1477,50280,3578761111,3578761148,37
2,1477,50281,3578761111,3578761150,39
2,1477,50282,3578761111,3578761151,40
2,1477,50283,3578761111,3578761151,40
2,1477,50284,3578761111,3578761151,40
2,1477,50285,3578761111,3578761153,42
2,1477,50286,3578761111,3578761155,44
2,1477,50287,3578761111,3578761155,44
2,1477,50288,3578761111,3578761155,44
2,1477,50289,3578761111,3578761156,45
2,1477,50290,3578761111,3578761158,47
2,1477,50291,3578761111,3578761159,48
2,1478,50292,3578761176,3578761176,0
2,1478,50293,3578761176,3578761176,0
2,1478,50294,3578761176,3578761176,0
2,1478,50295,3578761176,3578761176,0
2,1478,50296,3578761176,3578761176,0
2,1478,50297,3578761176,3578761176,0
2,1478,50298,3578761176,3578761176,0
2,1478,50299,3578761176,3578761176,0
2,1478,50300,3578761176,3578761176,0
2,1478,50301,3578761176,3578761176,0
2,1478,50302,3578761176,3578761176,0
2,1478,50303,3578761176,3578761176,0
2,1478,50304,3578761176,3578761176,0
2,1478,50305,3578761176,3578761176,0
2,1478,50306,3578761176,3578761176,0
2,1478,50307,3578761176,3578761176,0
2,1478,50308,3578761176,3578761176,0
2,1478,50309,3578761176,3578761176,0
2,1478,50310,3578761176,3578761176,0
2,1478,50311,3578761176,3578761176,0
2,1478,50312,3578761176,3578761178,2
2,1478,50313,3578761176,3578761179,3
2,1478,50314,3578761176,3578761180,4
2,1478,50315,3578761176,3578761183,7
2,1478,50316,3578761176,3578761184,8
2,1478,50317,3578761176,3578761184,8
2,1478,50318,3578761176,3578761185,9
2,1478,50319,3578761176,3578761185,9
2,1478,50320,3578761176,3578761187,11
2,1478,50321,3578761176,3578761188,12
2,1478,50322,3578761176,3578761188,12
2,1478,50323,3578761176,3578761189,13
2,1478,50324,3578761176,3578761189,13
2,1478,50325,3578761176,3578761189,13
2,1478,50326,3578761176,3578761189,13
2,1478,50327,3578761176,3578761191,15
2,1478,50328,3578761176,3578761191,15
2,1478,50329,3578761176,3578761192,16
2,1478,50330,3578761176,3578761193,17
2,1478,50331,3578761176,3578761194,18
2,1478,50332,3578761176,3578761194,18
2,1478,50333,3578761176,3578761198,22
2,1478,50334,3578761176,3578761199,23
2,1478,50335,3578761176,3578761200,24
2,1478,50336,3578761176,3578761201,25
2,1478,50337,3578761176,3578761201,25
2,1478,50338,3578761176,3578761203,27
2,1478,50339,3578761176,3578761203,27
2,1478,50340,3578761176,3578761203,27
2,1478,50341,3578761176,3578761204,28
2,1478,50342,3578761176,3578761204,28
2,1478,50343,3578761176,3578761206,30
2,1478,50344,3578761176,3578761207,31
2,1478,50345,3578761176,3578761207,31
2,1478,50346,3578761176,3578761211,35
2,1478,50347,3578761176,3578761211,35
2,1478,50348,3578761176,3578761213,37
2,1478,50349,3578761176,3578761213,37
2,1478,50350,3578761176,3578761214,38
2,1478,50351,3578761176,3578761216,40
2,1478,50352,3578761176,3578761216,40
2,1478,50353,3578761176,3578761216,40
2,1478,50354,3578761176,3578761218,42
2,1478,50355,3578761176,3578761219,43
2,1478,50356,3578761176,3578761222,46
2,1478,50357,3578761176,3578761224,48
2,1478,50358,3578761176,3578761224,48
2,1478,50359,3578761176,3578761224,48
2,1478,50360,3578761176,3578761226,50
2,1479,50361,3578761240,3578761240,0
2,1479,50362,3578761240,3578761240,0
2,1479,50363,3578761240,3578761240,0
2,1479,50364,3578761240,3578761240,0
2,1479,50365,3578761240,3578761240,0
2,1479,50366,3578761240,3578761240,0
2,1479,50367,3578761240,3578761240,0
2,1479,50368,3578761240,3578761240,0
2,1479,50369,3578761240,3578761240,0
2,1479,50370,3578761240,3578761240,0
2,1479,50371,3578761240,3578761240,0
2,1479,50372,3578761240,3578761240,0
2,1479,50373,3578761240,3578761240,0
2,1479,50374,3578761240,3578761240,0
2,1479,50375,3578761240,3578761240,0
2,1479,50376,3578761240,3578761240,0
2,1479,50377,3578761240,3578761240,0
2,1479,50378,3578761240,3578761241,1
2,1479,50379,3578761240,3578761241,1
2,1479,50380,3578761240,3578761241,1
2,1479,50381,3578761240,3578761242,2
2,1479,50382,3578761240,3578761243,3
2,1479,50383,3578761240,3578761243,3
2,1479,50384,3578761240,3578761244,4
2,1479,50385,3578761240,3578761245,5
2,1479,50386,3578761240,3578761245,5
2,1479,50387,3578761240,3578761245,5
2,1479,50388,3578761240,3578761246,6
2,1479,50389,3578761240,3578761246,6
2,1479,50390,3578761240,3578761247,7
2,1479,50391,3578761240,3578761247,7
2,1479,50392,3578761240,3578761250,10
2,1479,50393,3578761240,3578761251,11
2,1479,50394,3578761240,3578761252,12
2,1479,50395,3578761240,3578761253,13
2,1479,50396,3578761240,3578761253,13
2,1479,50397,3578761240,3578761255,15
2,1479,50398,3578761240,3578761255,15
2,1479,50399,3578761240,3578761255,15
2,1479,50400,3578761240,3578761255,15
2,1479,50401,3578761240,3578761256,16
2,1479,50402,3578761240,3578761257,17
2,1479,50403,3578761240,3578761258,18
2,1479,50404,3578761240,3578761260,20
2,1479,50405,3578761240,3578761261,21
2,1479,50406,3578761240,3578761262,22
2,1479,50407,3578761240,3578761264,24
2,1479,50408,3578761240,3578761265,25
2,1479,50409,3578761240,3578761265,25
2,1479,50410,3578761240,3578761266,26
2,1479,50411,3578761240,3578761268,28
2,1479,50412,3578761240,3578761268,28
2,1479,50413,3578761240,3578761270,30
2,1479,50414,3578761240,3578761270,30
2,1479,50415,3578761240,3578761277,37
2,1479,50416,3578761240,3578761279,39
2,1479,50417,3578761240,3578761283,43
2,1479,50418,3578761240,3578761283,43
2,1479,50419,3578761240,3578761284,44
2,1479,50420,3578761240,3578761286,46
2,1480,50421,3578761303,3578761303,0
2,1480,50422,3578761303,3578761303,0
2,1480,50423,3578761303,3578761303,0
2,1480,50424,3578761303,3578761303,0
2,1480,50425,3578761303,3578761303,0
2,1480,50426,3578761303,3578761303,0
2,1480,50427,3578761303,3578761303,0
2,1480,50428,3578761303,3578761303,0
2,1480,50429,3578761303,3578761303,0
2,1480,50430,3578761303,3578761303,0
2,1480,50431,3578761303,3578761303,0
2,1480,50432,3578761303,3578761303,0
2,1480,50433,3578761303,3578761303,0
2,1480,50434,3578761303,3578761303,0
2,1480,50435,3578761303,3578761303,0
2,1480,50436,3578761303,3578761303,0
2,1480,50437,3578761303,3578761303,0
2,1480,50438,3578761303,3578761303,0
2,1480,50439,3578761303,3578761303,0
2,1480,50440,3578761303,3578761303,0
2,1480,50441,3578761303,3578761303,0
2,1480,50442,3578761303,3578761303,0
2,1480,50443,3578761303,3578761303,0
2,1480,50444,3578761303,3578761303,0
2,1480,50445,3578761303,3578761303,0
2,1480,50446,3578761303,3578761303,0
2,1480,50447,3578761303,3578761303,0
2,1480,50448,3578761303,3578761304,1
2,1480,50449,3578761303,3578761305,2
2,1480,50450,3578761303,3578761307,4
2,1480,50451,3578761303,3578761307,4
2,1480,50452,3578761303,3578761308,5
2,1480,50453,3578761303,3578761310,7
2,1480,50454,3578761303,3578761311,8
2,1480,50455,3578761303,3578761312,9
2,1480,50456,3578761303,3578761312,9
2,1480,50457,3578761303,3578761313,10
2,1480,50458,3578761303,3578761313,10
2,1480,50459,3578761303,3578761314,11
2,1480,50460,3578761303,3578761315,12
2,1480,50461,3578761303,3578761315,12
2,1480,50462,3578761303,3578761316,13
2,1480,50463,3578761303,3578761316,13
2,1480,50464,3578761303,3578761317,14
2,1480,50465,3578761303,3578761317,14
2,1480,50466,3578761303,3578761318,15
2,1480,50467,3578761303,3578761319,16
2,1480,50468,3578761303,3578761319,16
2,1480,50469,3578761303,3578761320,17
2,1480,50470,3578761303,3578761322,19
2,1480,50471,3578761303,3578761322,19
2,1480,50472,3578761303,3578761322,19
2,1480,50473,3578761303,3578761323,20
2,1480,50474,3578761303,3578761323,20
2,1480,50475,3578761303,3578761324,21
2,1480,50476,3578761303,3578761324,21
2,1480,50477,3578761303,3578761325,22
2,1480,50478,3578761303,3578761325,22
2,1480,50479,3578761303,3578761326,23
2,1480,50480,3578761303,3578761327,24
2,1480,50481,3578761303,3578761327,24
2,1480,50482,3578761303,3578761328,25
2,1480,50483,3578761303,3578761328,25
2,1480,50484,3578761303,3578761330,27
2,1480,50485,3578761303,3578761332,29
2,1480,50486,3578761303,3578761332,29
2,1480,50487,3578761303,3578761333,30
2,1480,50488,3578761303,3578761334,31
2,1480,50489,3578761303,3578761335,32
2,1480,50490,3578761303,3578761336,33
2,1480,50491,3578761303,3578761338,35
2,1480,50492,3578761303,3578761338,35
2,1480,50493,3578761303,3578761339,36
2,1480,50494,3578761303,3578761339,36
2,1480,50495,3578761303,3578761339,36
2,1480,50496,3578761303,3578761340,37
2,1480,50497,3578761303,3578761340,37
2,1480,50498,3578761303,3578761341,38
2,1480,50499,3578761303,3578761341,38
2,1480,50500,3578761303,3578761342,39
2,1480,50501,3578761303,3578761344,41
2,1480,50502,3578761303,3578761344,41
2,1480,50503,3578761303,3578761345,42
2,1480,50504,3578761303,3578761347,44
2,1480,50505,3578761303,3578761348,45
2,1480,50506,3578761303,3578761350,47
2,1480,50507,3578761303,3578761351,48
2,1480,50508,3578761303,3578761351,48
2,1480,50509,3578761303,3578761351,48
2,1481,50510,3578761368,3578761368,0
2,1481,50511,3578761368,3578761368,0
2,1481,50512,3578761368,3578761368,0
2,1481,50513,3578761368,3578761368,0
2,1481,50514,3578761368,3578761368,0
2,1481,50515,3578761368,3578761368,0
2,1481,50516,3578761368,3578761368,0
2,1481,50517,3578761368,3578761368,0
2,1481,50518,3578761368,3578761368,0
2,1481,50519,3578761368,3578761368,0
2,1481,50520,3578761368,3578761368,0
2,1481,50521,3578761368,3578761368,0
2,1481,50522,3578761368,3578761368,0
2,1481,50523,3578761368,3578761368,0
2,1481,50524,3578761368,3578761368,0
2,1481,50525,3578761368,3578761368,0
2,1481,50526,3578761368,3578761368,0
2,1481,50527,3578761368,3578761368,0
2,1481,50528,3578761368,3578761368,0
2,1481,50529,3578761368,3578761369,1
2,1481,50530,3578761368,3578761369,1
2,1481,50531,3578761368,3578761369,1
2,1481,50532,3578761368,3578761370,2
2,1481,50533,3578761368,3578761371,3
2,1481,50534,3578761368,3578761371,3
2,1481,50535,3578761368,3578761373,5
2,1481,50536,3578761368,3578761373,5
2,1481,50537,3578761368,3578761374,6
2,1481,50538,3578761368,3578761375,7
2,1481,50539,3578761368,3578761375,7
2,1481,50540,3578761368,3578761376,8
2,1481,50541,3578761368,3578761378,10
2,1481,50542,3578761368,3578761379,11
2,1481,50543,3578761368,3578761380,12
2,1481,50544,3578761368,3578761384,16
2,1481,50545,3578761368,3578761384,16
2,1481,50546,3578761368,3578761384,16
2,1481,50547,3578761368,3578761385,17
2,1481,50548,3578761368,3578761386,18
2,1481,50549,3578761368,3578761388,20
2,1481,50550,3578761368,3578761388,20
2,1481,50551,3578761368,3578761388,20
2,1481,50552,3578761368,3578761389,21
2,1481,50553,3578761368,3578761390,22
2,1481,50554,3578761368,3578761390,22
2,1481,50555,3578761368,3578761391,23
2,1481,50556,3578761368,3578761391,23
2,1481,50557,3578761368,3578761391,23
2,1481,50558,3578761368,3578761392,24
2,1481,50559,3578761368,3578761392,24
2,1481,50560,3578761368,3578761393,25
2,1481,50561,3578761368,3578761394,26
2,1481,50562,3578761368,3578761398,30
2,1481,50563,3578761368,3578761399,31
2,1481,50564,3578761368,3578761400,32
2,1481,50565,3578761368,3578761402,34
2,1481,50566,3578761368,3578761402,34
2,1481,50567,3578761368,3578761403,35
2,1481,50568,3578761368,3578761403,35
2,1481,50569,3578761368,3578761404,36
2,1481,50570,3578761368,3578761406,38
2,1481,50571,3578761368,3578761406,38
2,1481,50572,3578761368,3578761406,38
2,1481,50573,3578761368,3578761407,39
2,1481,50574,3578761368,3578761407,39
2,1481,50575,3578761368,3578761411,43
2,1481,50576,3578761368,3578761413,45
2,1481,50577,3578761368,3578761413,45
2,1481,50578,3578761368,3578761414,46
2,1481,50579,3578761368,3578761416,48
2,1481,50580,3578761368,3578761417,49
2,1481,50581,3578761368,3578761417,49
2,1481,50582,3578761368,3578761418,50
2,1482,50583,3578761432,3578761432,0
2,1482,50584,3578761432,3578761433,1
2,1482,50585,3578761432,3578761433,1
2,1482,50586,3578761432,3578761433,1
2,1482,50587,3578761432,3578761433,1
2,1482,50588,3578761432,3578761433,1
2,1482,50589,3578761432,3578761433,1
2,1482,50590,3578761432,3578761433,1
2,1482,50591,3578761432,3578761433,1
2,1482,50592,3578761432,3578761433,1
2,1482,50593,3578761432,3578761433,1
2,1482,50594,3578761432,3578761433,1
2,1482,50595,3578761432,3578761433,1
2,1482,50596,3578761432,3578761433,1
2,1482,50597,3578761432,3578761433,1
2,1482,50598,3578761432,3578761433,1
2,1482,50599,3578761432,3578761433,1
2,1482,50600,3578761432,3578761434,2
2,1482,50601,3578761432,3578761436,4
2,1482,50602,3578761432,3578761437,5
2,1482,50603,3578761432,3578761437,5
2,1482,50604,3578761432,3578761437,5
2,1482,50605,3578761432,3578761438,6
2,1482,50606,3578761432,3578761438,6
2,1482,50607,3578761432,3578761439,7
2,1482,50608,3578761432,3578761439,7
2,1482,50609,3578761432,3578761440,8
2,1482,50610,3578761432,3578761441,9
2,1482,50611,3578761432,3578761441,9
2,1482,50612,3578761432,3578761441,9
2,1482,50613,3578761432,3578761441,9
2,1482,50614,3578761432,3578761441,9
2,1482,50615,3578761432,3578761443,11
2,1482,50616,3578761432,3578761444,12
2,1482,50617,3578761432,3578761444,12
2,1482,50618,3578761432,3578761445,13
2,1482,50619,3578761432,3578761445,13
2,1482,50620,3578761432,3578761445,13
2,1482,50621,3578761432,3578761446,14
2,1482,50622,3578761432,3578761447,15
2,1482,50623,3578761432,3578761448,16
2,1482,50624,3578761432,3578761449,17
2,1482,50625,3578761432,3578761450,18
2,1482,50626,3578761432,3578761451,19
2,1482,50627,3578761432,3578761452,20
2,1482,50628,3578761432,3578761453,21
2,1482,50629,3578761432,3578761453,21
2,1482,50630,3578761432,3578761453,21
2,1482,50631,3578761432,3578761454,22
2,1482,50632,3578761432,3578761454,22
2,1482,50633,3578761432,3578761455,23
2,1482,50634,3578761432,3578761455,23
2,1482,50635,3578761432,3578761456,24
2,1482,50636,3578761432,3578761458,26
2,1482,50637,3578761432,3578761458,26
2,1482,50638,3578761432,3578761460,28
2,1482,50639,3578761432,3578761461,29
2,1482,50640,3578761432,3578761461,29
2,1482,50641,3578761432,3578761464,32
2,1482,50642,3578761432,3578761465,33
2,1482,50643,3578761432,3578761466,34
2,1482,50644,3578761432,3578761467,35
2,1482,50645,3578761432,3578761467,35
2,1482,50646,3578761432,3578761468,36
2,1482,50647,3578761432,3578761469,37
2,1482,50648,3578761432,3578761478,46
2,1482,50649,3578761432,3578761478,46
2,1483,50650,3578761496,3578761496,0
2,1483,50651,3578761496,3578761496,0
2,1483,50652,3578761496,3578761496,0
2,1483,50653,3578761496,3578761496,0
2,1483,50654,3578761496,3578761496,0
2,1483,50655,3578761496,3578761496,0
2,1483,50656,3578761496,3578761496,0
2,1483,50657,3578761496,3578761496,0
2,1483,50658,3578761496,3578761496,0
2,1483,50659,3578761496,3578761496,0
2,1483,50660,3578761496,3578761496,0
2,1483,50661,3578761496,3578761496,0
2,1483,50662,3578761496,3578761496,0
2,1483,50663,3578761496,3578761496,0
2,1483,50664,3578761496,3578761496,0
2,1483,50665,3578761496,3578761497,1
2,1483,50666,3578761496,3578761497,1
2,1483,50667,3578761496,3578761497,1
2,1483,50668,3578761496,3578761497,1
2,1483,50669,3578761496,3578761497,1
2,1483,50670,3578761496,3578761497,1
2,1483,50671,3578761496,3578761497,1
2,1483,50672,3578761496,3578761499,3
2,1483,50673,3578761496,3578761499,3
2,1483,50674,3578761496,3578761499,3
2,1483,50675,3578761496,3578761499,3
2,1483,50676,3578761496,3578761500,4
2,1483,50677,3578761496,3578761500,4
2,1483,50678,3578761496,3578761501,5
2,1483,50679,3578761496,3578761501,5
2,1483,50680,3578761496,3578761501,5
2,1483,50681,3578761496,3578761502,6
2,1483,50682,3578761496,3578761502,6
2,1483,50683,3578761496,3578761502,6
2,1483,50684,3578761496,3578761503,7
2,1483,50685,3578761496,3578761504,8
2,1483,50686,3578761496,3578761505,9
2,1483,50687,3578761496,3578761506,10
2,1483,50688,3578761496,3578761508,12
2,1483,50689,3578761496,3578761509,13
2,1483,50690,3578761496,3578761509,13
2,1483,50691,3578761496,3578761511,15
2,1483,50692,3578761496,3578761511,15
2,1483,50693,3578761496,3578761512,16
2,1483,50694,3578761496,3578761513,17
2,1483,50695,3578761496,3578761514,18
2,1483,50696,3578761496,3578761515,19
2,1483,50697,3578761496,3578761516,20
2,1483,50698,3578761496,3578761516,20
2,1483,50699,3578761496,3578761517,21
2,1483,50700,3578761496,3578761517,21
2,1483,50701,3578761496,3578761518,22
2,1483,50702,3578761496,3578761519,23
2,1483,50703,3578761496,3578761520,24
2,1483,50704,3578761496,3578761521,25
2,1483,50705,3578761496,3578761522,26
2,1483,50706,3578761496,3578761522,26
2,1483,50707,3578761496,3578761523,27
2,1483,50708,3578761496,3578761523,27
2,1483,50709,3578761496,3578761523,27
2,1483,50710,3578761496,3578761524,28
2,1483,50711,3578761496,3578761524,28
2,1483,50712,3578761496,3578761524,28
2,1483,50713,3578761496,3578761526,30
2,1483,50714,3578761496,3578761526,30
2,1483,50715,3578761496,3578761527,31
2,1483,50716,3578761496,3578761527,31
2,1483,50717,3578761496,3578761529,33
2,1483,50718,3578761496,3578761530,34
2,1483,50719,3578761496,3578761531,35
2,1483,50720,3578761496,3578761532,36
2,1483,50721,3578761496,3578761533,37
2,1483,50722,3578761496,3578761534,38
2,1483,50723,3578761496,3578761534,38
2,1483,50724,3578761496,3578761535,39
2,1483,50725,3578761496,3578761536,40
2,1483,50726,3578761496,3578761537,41
2,1483,50727,3578761496,3578761537,41
2,1483,50728,3578761496,3578761538,42
2,1483,50729,3578761496,3578761538,42
2,1483,50730,3578761496,3578761539,43
2,1483,50731,3578761496,3578761539,43
2,1483,50732,3578761496,3578761539,43
2,1483,50733,3578761496,3578761540,44
2,1483,50734,3578761496,3578761543,47
2,1483,50735,3578761496,3578761543,47
2,1483,50736,3578761496,3578761544,48
2,1484,50737,3578761560,3578761560,0
2,1484,50738,3578761560,3578761560,0
2,1484,50739,3578761560,3578761560,0
2,1484,50740,3578761560,3578761560,0
2,1484,50741,3578761560,3578761560,0
2,1484,50742,3578761560,3578761560,0
2,1484,50743,3578761560,3578761560,0
2,1484,50744,3578761560,3578761560,0
2,1484,50745,3578761560,3578761560,0
2,1484,50746,3578761560,3578761560,0
2,1484,50747,3578761560,3578761560,0
2,1484,50748,3578761560,3578761560,0
2,1484,50749,3578761560,3578761560,0
2,1484,50750,3578761560,3578761561,1
2,1484,50751,3578761560,3578761561,1
2,1484,50752,3578761560,3578761561,1
2,1484,50753,3578761560,3578761561,1
2,1484,50754,3578761560,3578761562,2
2,1484,50755,3578761560,3578761562,2
2,1484,50756,3578761560,3578761563,3
2,1484,50757,3578761560,3578761565,5
2,1484,50758,3578761560,3578761565,5
2,1484,50759,3578761560,3578761565,5
2,1484,50760,3578761560,3578761565,5
2,1484,50761,3578761560,3578761565,5
2,1484,50762,3578761560,3578761567,7
2,1484,50763,3578761560,3578761567,7
2,1484,50764,3578761560,3578761569,9
2,1484,50765,3578761560,3578761569,9
2,1484,50766,3578761560,3578761570,10
2,1484,50767,3578761560,3578761572,12
2,1484,50768,3578761560,3578761573,13
2,1484,50769,3578761560,3578761574,14
2,1484,50770,3578761560,3578761574,14
2,1484,50771,3578761560,3578761575,15
2,1484,50772,3578761560,3578761578,18
2,1484,50773,3578761560,3578761578,18
2,1484,50774,3578761560,3578761578,18
2,1484,50775,3578761560,3578761582,22
2,1484,50776,3578761560,3578761583,23
2,1484,50777,3578761560,3578761583,23
2,1484,50778,3578761560,3578761584,24
2,1484,50779,3578761560,3578761584,24
2,1484,50780,3578761560,3578761587,27
2,1484,50781,3578761560,3578761587,27
2,1484,50782,3578761560,3578761588,28
2,1484,50783,3578761560,3578761589,29
2,1484,50784,3578761560,3578761589,29
2,1484,50785,3578761560,3578761590,30
2,1484,50786,3578761560,3578761590,30
2,1484,50787,3578761560,3578761590,30
2,1484,50788,3578761560,3578761591,31
2,1484,50789,3578761560,3578761592,32
2,1484,50790,3578761560,3578761592,32
2,1484,50791,3578761560,3578761593,33
2,1484,50792,3578761560,3578761597,37
2,1484,50793,3578761560,3578761597,37
2,1484,50794,3578761560,3578761599,39
2,1484,50795,3578761560,3578761599,39
2,1484,50796,3578761560,3578761601,41
2,1484,50797,3578761560,3578761601,41
2,1484,50798,3578761560,3578761602,42
2,1484,50799,3578761560,3578761602,42
2,1484,50800,3578761560,3578761603,43
2,1484,50801,3578761560,3578761604,44
2,1484,50802,3578761560,3578761605,45
2,1484,50803,3578761560,3578761605,45
2,1484,50804,3578761560,3578761605,45
2,1484,50805,3578761560,3578761606,46
2,1484,50806,3578761560,3578761606,46
2,1484,50807,3578761560,3578761607,47
2,1484,50808,3578761560,3578761609,49
2,1485,50809,3578761625,3578761625,0
2,1485,50810,3578761625,3578761625,0
2,1485,50811,3578761625,3578761625,0
2,1485,50812,3578761625,3578761625,0
2,1485,50813,3578761625,3578761625,0
2,1485,50814,3578761625,3578761625,0
2,1485,50815,3578761625,3578761625,0
2,1485,50816,3578761625,3578761625,0
2,1485,50817,3578761625,3578761625,0
2,1485,50818,3578761625,3578761625,0
2,1485,50819,3578761625,3578761625,0
2,1485,50820,3578761625,3578761625,0
2,1485,50821,3578761625,3578761625,0
2,1485,50822,3578761625,3578761625,0
2,1485,50823,3578761625,3578761625,0
2,1485,50824,3578761625,3578761625,0
2,1485,50825,3578761625,3578761625,0
2,1485,50826,3578761625,3578761626,1
2,1485,50827,3578761625,3578761627,2
2,1485,50828,3578761625,3578761628,3
2,1485,50829,3578761625,3578761629,4
2,1485,50830,3578761625,3578761629,4
2,1485,50831,3578761625,3578761629,4
2,1485,50832,3578761625,3578761631,6
2,1485,50833,3578761625,3578761631,6
2,1485,50834,3578761625,3578761631,6
2,1485,50835,3578761625,3578761632,7
2,1485,50836,3578761625,3578761633,8
2,1485,50837,3578761625,3578761636,11
2,1485,50838,3578761625,3578761636,11
2,1485,50839,3578761625,3578761637,12
2,1485,50840,3578761625,3578761638,13
2,1485,50841,3578761625,3578761638,13
2,1485,50842,3578761625,3578761638,13
2,1485,50843,3578761625,3578761638,13
2,1485,50844,3578761625,3578761640,15
2,1485,50845,3578761625,3578761640,15
2,1485,50846,3578761625,3578761640,15
2,1485,50847,3578761625,3578761640,15
2,1485,50848,3578761625,3578761640,15
2,1485,50849,3578761625,3578761642,17
2,1485,50850,3578761625,3578761643,18
2,1485,50851,3578761625,3578761644,19
2,1485,50852,3578761625,3578761644,19
2,1485,50853,3578761625,3578761644,19
2,1485,50854,3578761625,3578761645,20
2,1485,50855,3578761625,3578761646,21
2,1485,50856,3578761625,3578761646,21
2,1485,50857,3578761625,3578761646,21
2,1485,50858,3578761625,3578761649,24
2,1485,50859,3578761625,3578761649,24
2,1485,50860,3578761625,3578761650,25
2,1485,50861,3578761625,3578761650,25
2,1485,50862,3578761625,3578761651,26
2,1485,50863,3578761625,3578761652,27
2,1485,50864,3578761625,3578761652,27
2,1485,50865,3578761625,3578761653,28
2,1485,50866,3578761625,3578761654,29
2,1485,50867,3578761625,3578761654,29
2,1485,50868,3578761625,3578761655,30
2,1485,50869,3578761625,3578761657,32
2,1485,50870,3578761625,3578761657,32
2,1485,50871,3578761625,3578761659,34
2,1485,50872,3578761625,3578761660,35
2,1485,50873,3578761625,3578761661,36
2,1485,50874,3578761625,3578761664,39
2,1485,50875,3578761625,3578761665,40
2,1485,50876,3578761625,3578761665,40
2,1485,50877,3578761625,3578761666,41
2,1485,50878,3578761625,3578761667,42
2,1485,50879,3578761625,3578761667,42
2,1485,50880,3578761625,3578761668,43
2,1485,50881,3578761625,3578761670,45
2,1486,50882,3578761688,3578761688,0
2,1486,50883,3578761688,3578761688,0
2,1486,50884,3578761688,3578761688,0
2,1486,50885,3578761688,3578761688,0
2,1486,50886,3578761688,3578761688,0
2,1486,50887,3578761688,3578761688,0
2,1486,50888,3578761688,3578761688,0
2,1486,50889,3578761688,3578761690,2
2,1486,50890,3578761688,3578761690,2
2,1486,50891,3578761688,3578761690,2
2,1486,50892,3578761688,3578761691,3
2,1486,50893,3578761688,3578761691,3
2,1486,50894,3578761688,3578761691,3
2,1486,50895,3578761688,3578761693,5
2,1486,50896,3578761688,3578761693,5
2,1486,50897,3578761688,3578761693,5
2,1486,50898,3578761688,3578761694,6
2,1486,50899,3578761688,3578761696,8
2,1486,50900,3578761688,3578761696,8
2,1486,50901,3578761688,3578761697,9
2,1486,50902,3578761688,3578761697,9
2,1486,50903,3578761688,3578761698,10
2,1486,50904,3578761688,3578761698,10
2,1486,50905,3578761688,3578761699,11
2,1486,50906,3578761688,3578761699,11
2,1486,50907,3578761688,3578761699,11
2,1486,50908,3578761688,3578761700,12
2,1486,50909,3578761688,3578761700,12
2,1486,50910,3578761688,3578761701,13
2,1486,50911,3578761688,3578761701,13
2,1486,50912,3578761688,3578761701,13
2,1486,50913,3578761688,3578761702,14
2,1486,50914,3578761688,3578761702,14
2,1486,50915,3578761688,3578761702,14
2,1486,50916,3578761688,3578761703,15
2,1486,50917,3578761688,3578761705,17
2,1486,50918,3578761688,3578761706,18
2,1486,50919,3578761688,3578761706,18
2,1486,50920,3578761688,3578761709,21
2,1486,50921,3578761688,3578761709,21
2,1486,50922,3578761688,3578761710,22
2,1486,50923,3578761688,3578761711,23
2,1486,50924,3578761688,3578761711,23
2,1486,50925,3578761688,3578761712,24
2,1486,50926,3578761688,3578761712,24
2,1486,50927,3578761688,3578761713,25
2,1486,50928,3578761688,3578761714,26
2,1486,50929,3578761688,3578761715,27
2,1486,50930,3578761688,3578761715,27
2,1486,50931,3578761688,3578761715,27
2,1486,50932,3578761688,3578761715,27
2,1486,50933,3578761688,3578761716,28
2,1486,50934,3578761688,3578761717,29
2,1486,50935,3578761688,3578761717,29
2,1486,50936,3578761688,3578761717,29
2,1486,50937,3578761688,3578761717,29
2,1486,50938,3578761688,3578761718,30
2,1486,50939,3578761688,3578761719,31
2,1486,50940,3578761688,3578761720,32
2,1486,50941,3578761688,3578761722,34
2,1486,50942,3578761688,3578761722,34
2,1486,50943,3578761688,3578761722,34
2,1486,50944,3578761688,3578761723,35
2,1486,50945,3578761688,3578761724,36
2,1486,50946,3578761688,3578761724,36
2,1486,50947,3578761688,3578761724,36
2,1486,50948,3578761688,3578761725,37
2,1486,50949,3578761688,3578761726,38
2,1486,50950,3578761688,3578761726,38
2,1486,50951,3578761688,3578761726,38
2,1486,50952,3578761688,3578761726,38
2,1486,50953,3578761688,3578761727,39
2,1486,50954,3578761688,3578761730,42
2,1486,50955,3578761688,3578761730,42
2,1486,50956,3578761688,3578761731,43
2,1486,50957,3578761688,3578761732,44
2,1486,50958,3578761688,3578761733,45
2,1486,50959,3578761688,3578761735,47
2,1486,50960,3578761688,3578761735,47
2,1486,50961,3578761688,3578761735,47
2,1486,50962,3578761688,3578761736,48
2,1486,50963,3578761688,3578761737,49
2,1486,50964,3578761688,3578761738,50
2,1487,50965,3578761753,3578761753,0
2,1487,50966,3578761753,3578761753,0
2,1487,50967,3578761753,3578761753,0
2,1487,50968,3578761753,3578761753,0
2,1487,50969,3578761753,3578761753,0
2,1487,50970,3578761753,3578761753,0
2,1487,50971,3578761753,3578761753,0
2,1487,50972,3578761753,3578761753,0
2,1487,50973,3578761753,3578761753,0
2,1487,50974,3578761753,3578761753,0
2,1487,50975,3578761753,3578761753,0
2,1487,50976,3578761753,3578761753,0
2,1487,50977,3578761753,3578761753,0
2,1487,50978,3578761753,3578761753,0
2,1487,50979,3578761753,3578761753,0
2,1487,50980,3578761753,3578761753,0
2,1487,50981,3578761753,3578761754,1
2,1487,50982,3578761753,3578761754,1
2,1487,50983,3578761753,3578761755,2
2,1487,50984,3578761753,3578761756,3
2,1487,50985,3578761753,3578761758,5
2,1487,50986,3578761753,3578761758,5
2,1487,50987,3578761753,3578761762,9
2,1487,50988,3578761753,3578761763,10
2,1487,50989,3578761753,3578761764,11
2,1487,50990,3578761753,3578761765,12
2,1487,50991,3578761753,3578761765,12
2,1487,50992,3578761753,3578761765,12
2,1487,50993,3578761753,3578761765,12
2,1487,50994,3578761753,3578761766,13
2,1487,50995,3578761753,3578761768,15
2,1487,50996,3578761753,3578761768,15
2,1487,50997,3578761753,3578761769,16
2,1487,50998,3578761753,3578761769,16
2,1487,50999,3578761753,3578761771,18
2,1487,51000,3578761753,3578761772,19
2,1487,51001,3578761753,3578761772,19
2,1487,51002,3578761753,3578761773,20
2,1487,51003,3578761753,3578761774,21
2,1487,51004,3578761753,3578761774,21
2,1487,51005,3578761753,3578761775,22
2,1487,51006,3578761753,3578761777,24
2,1487,51007,3578761753,3578761778,25
2,1487,51008,3578761753,3578761779,26
2,1487,51009,3578761753,3578761782,29
2,1487,51010,3578761753,3578761783,30
2,1487,51011,3578761753,3578761784,31
2,1487,51012,3578761753,3578761784,31
2,1487,51013,3578761753,3578761785,32
2,1487,51014,3578761753,3578761787,34
2,1487,51015,3578761753,3578761788,35
2,1487,51016,3578761753,3578761788,35
2,1487,51017,3578761753,3578761789,36
2,1487,51018,3578761753,3578761789,36
2,1487,51019,3578761753,3578761790,37
2,1487,51020,3578761753,3578761790,37
2,1487,51021,3578761753,3578761790,37
2,1487,51022,3578761753,3578761790,37
2,1487,51023,3578761753,3578761791,38
2,1487,51024,3578761753,3578761792,39
2,1487,51025,3578761753,3578761793,40
2,1487,51026,3578761753,3578761794,41
2,1487,51027,3578761753,3578761797,44
2,1487,51028,3578761753,3578761798,45
2,1487,51029,3578761753,3578761798,45
2,1487,51030,3578761753,3578761799,46
2,1487,51031,3578761753,3578761801,48
2,1487,51032,3578761753,3578761801,48
2,1487,51033,3578761753,3578761802,49
2,1487,51034,3578761753,3578761802,49
2,1487,51035,3578761753,3578761802,49
2,1488,51036,3578761817,3578761817,0
2,1488,51037,3578761817,3578761817,0
2,1488,51038,3578761817,3578761817,0
2,1488,51039,3578761817,3578761817,0
2,1488,51040,3578761817,3578761817,0
2,1488,51041,3578761817,3578761817,0
2,1488,51042,3578761817,3578761817,0
2,1488,51043,3578761817,3578761817,0
2,1488,51044,3578761817,3578761817,0
2,1488,51045,3578761817,3578761817,0
2,1488,51046,3578761817,3578761817,0
2,1488,51047,3578761817,3578761817,0
2,1488,51048,3578761817,3578761817,0
2,1488,51049,3578761817,3578761817,0
2,1488,51050,3578761817,3578761817,0
2,1488,51051,3578761817,3578761817,0
2,1488,51052,3578761817,3578761817,0
2,1488,51053,3578761817,3578761819,2
2,1488,51054,3578761817,3578761820,3
2,1488,51055,3578761817,3578761820,3
2,1488,51056,3578761817,3578761822,5
2,1488,51057,3578761817,3578761824,7
2,1488,51058,3578761817,3578761824,7
2,1488,51059,3578761817,3578761824,7
2,1488,51060,3578761817,3578761825,8
2,1488,51061,3578761817,3578761825,8
2,1488,51062,3578761817,3578761827,10
2,1488,51063,3578761817,3578761828,11
2,1488,51064,3578761817,3578761828,11
2,1488,51065,3578761817,3578761829,12
2,1488,51066,3578761817,3578761831,14
2,1488,51067,3578761817,3578761831,14
2,1488,51068,3578761817,3578761832,15
2,1488,51069,3578761817,3578761832,15
2,1488,51070,3578761817,3578761832,15
2,1488,51071,3578761817,3578761833,16
2,1488,51072,3578761817,3578761836,19
2,1488,51073,3578761817,3578761836,19
2,1488,51074,3578761817,3578761837,20
2,1488,51075,3578761817,3578761837,20
2,1488,51076,3578761817,3578761838,21
2,1488,51077,3578761817,3578761838,21
2,1488,51078,3578761817,3578761838,21
2,1488,51079,3578761817,3578761838,21
2,1488,51080,3578761817,3578761839,22
2,1488,51081,3578761817,3578761840,23
2,1488,51082,3578761817,3578761840,23
2,1488,51083,3578761817,3578761841,24
2,1488,51084,3578761817,3578761841,24
2,1488,51085,3578761817,3578761842,25
2,1488,51086,3578761817,3578761843,26
2,1488,51087,3578761817,3578761844,27
2,1488,51088,3578761817,3578761844,27
2,1488,51089,3578761817,3578761845,28
2,1488,51090,3578761817,3578761846,29
2,1488,51091,3578761817,3578761846,29
2,1488,51092,3578761817,3578761846,29
2,1488,51093,3578761817,3578761847,30
2,1488,51094,3578761817,3578761849,32
2,1488,51095,3578761817,3578761850,33
2,1488,51096,3578761817,3578761850,33
2,1488,51097,3578761817,3578761850,33
2,1488,51098,3578761817,3578761851,34
2,1488,51099,3578761817,3578761852,35
2,1488,51100,3578761817,3578761853,36
2,1488,51101,3578761817,3578761854,37
2,1488,51102,3578761817,3578761854,37
2,1488,51103,3578761817,3578761854,37
2,1488,51104,3578761817,3578761856,39
2,1488,51105,3578761817,3578761857,40
2,1488,51106,3578761817,3578761858,41
2,1488,51107,3578761817,3578761859,42
2,1488,51108,3578761817,3578761861,44
2,1488,51109,3578761817,3578761861,44
2,1488,51110,3578761817,3578761863,46
2,1488,51111,3578761817,3578761865,48
2,1488,51112,3578761817,3578761865,48
2,1488,51113,3578761817,3578761865,48
2,1488,51114,3578761817,3578761866,49
2,1488,51115,3578761817,3578761867,50
2,1489,51116,3578761881,3578761881,0
2,1489,51117,3578761881,3578761881,0
2,1489,51118,3578761881,3578761881,0
2,1489,51119,3578761881,3578761882,1
2,1489,51120,3578761881,3578761883,2
2,1489,51121,3578761881,3578761883,2
2,1489,51122,3578761881,3578761884,3
2,1489,51123,3578761881,3578761885,4
2,1489,51124,3578761881,3578761887,6
2,1489,51125,3578761881,3578761889,8
2,1489,51126,3578761881,3578761890,9
2,1489,51127,3578761881,3578761891,10
2,1489,51128,3578761881,3578761891,10
2,1489,51129,3578761881,3578761891,10
2,1489,51130,3578761881,3578761892,11
2,1489,51131,3578761881,3578761892,11
2,1489,51132,3578761881,3578761893,12
2,1489,51133,3578761881,3578761893,12
2,1489,51134,3578761881,3578761894,13
2,1489,51135,3578761881,3578761896,15
2,1489,51136,3578761881,3578761897,16
2,1489,51137,3578761881,3578761897,16
2,1489,51138,3578761881,3578761897,16
2,1489,51139,3578761881,3578761898,17
2,1489,51140,3578761881,3578761898,17
2,1489,51141,3578761881,3578761899,18
2,1489,51142,3578761881,3578761899,18
2,1489,51143,3578761881,3578761899,18
2,1489,51144,3578761881,3578761899,18
2,1489,51145,3578761881,3578761899,18
2,1489,51146,3578761881,3578761901,20
2,1489,51147,3578761881,3578761901,20
2,1489,51148,3578761881,3578761901,20
2,1489,51149,3578761881,3578761901,20
2,1489,51150,3578761881,3578761902,21
2,1489,51151,3578761881,3578761902,21
2,1489,51152,3578761881,3578761902,21
2,1489,51153,3578761881,3578761903,22
2,1489,51154,3578761881,3578761904,23
2,1489,51155,3578761881,3578761906,25
2,1489,51156,3578761881,3578761906,25
2,1489,51157,3578761881,3578761909,28
2,1489,51158,3578761881,3578761909,28
2,1489,51159,3578761881,3578761909,28
2,1489,51160,3578761881,3578761910,29
2,1489,51161,3578761881,3578761911,30
2,1489,51162,3578761881,3578761911,30
2,1489,51163,3578761881,3578761912,31
2,1489,51164,3578761881,3578761912,31
2,1489,51165,3578761881,3578761912,31
2,1489,51166,3578761881,3578761913,32
2,1489,51167,3578761881,3578761914,33
2,1489,51168,3578761881,3578761914,33
2,1489,51169,3578761881,3578761915,34
2,1489,51170,3578761881,3578761915,34
2,1489,51171,3578761881,3578761916,35
2,1489,51172,3578761881,3578761916,35
2,1489,51173,3578761881,3578761916,35
2,1489,51174,3578761881,3578761917,36
2,1489,51175,3578761881,3578761917,36
2,1489,51176,3578761881,3578761917,36
2,1489,51177,3578761881,3578761917,36
2,1489,51178,3578761881,3578761918,37
2,1489,51179,3578761881,3578761920,39
2,1489,51180,3578761881,3578761922,41
2,1489,51181,3578761881,3578761922,41
2,1489,51182,3578761881,3578761924,43
2,1489,51183,3578761881,3578761924,43
2,1489,51184,3578761881,3578761924,43
2,1489,51185,3578761881,3578761926,45
2,1489,51186,3578761881,3578761926,45
2,1489,51187,3578761881,3578761926,45
2,1489,51188,3578761881,3578761926,45
2,1489,51189,3578761881,3578761927,46
2,1489,51190,3578761881,3578761930,49
2,1489,51191,3578761881,3578761930,49
2,1489,51192,3578761881,3578761930,49
2,1490,51193,3578761946,3578761946,0
2,1490,51194,3578761946,3578761946,0
2,1490,51195,3578761946,3578761946,0
2,1490,51196,3578761946,3578761946,0
2,1490,51197,3578761946,3578761946,0
2,1490,51198,3578761946,3578761946,0
2,1490,51199,3578761946,3578761946,0
2,1490,51200,3578761946,3578761946,0
2,1490,51201,3578761946,3578761946,0
2,1490,51202,3578761946,3578761946,0
2,1490,51203,3578761946,3578761946,0
2,1490,51204,3578761946,3578761946,0
2,1490,51205,3578761946,3578761946,0
2,1490,51206,3578761946,3578761946,0
2,1490,51207,3578761946,3578761946,0
2,1490,51208,3578761946,3578761946,0
2,1490,51209,3578761946,3578761947,1
2,1490,51210,3578761946,3578761949,3
2,1490,51211,3578761946,3578761950,4
2,1490,51212,3578761946,3578761950,4
2,1490,51213,3578761946,3578761951,5
2,1490,51214,3578761946,3578761951,5
2,1490,51215,3578761946,3578761952,6
2,1490,51216,3578761946,3578761952,6
2,1490,51217,3578761946,3578761953,7
2,1490,51218,3578761946,3578761954,8
2,1490,51219,3578761946,3578761954,8
2,1490,51220,3578761946,3578761954,8
2,1490,51221,3578761946,3578761955,9
2,1490,51222,3578761946,3578761956,10
2,1490,51223,3578761946,3578761957,11
2,1490,51224,3578761946,3578761958,12
2,1490,51225,3578761946,3578761958,12
2,1490,51226,3578761946,3578761959,13
2,1490,51227,3578761946,3578761962,16
2,1490,51228,3578761946,3578761963,17
2,1490,51229,3578761946,3578761964,18
2,1490,51230,3578761946,3578761965,19
2,1490,51231,3578761946,3578761965,19
2,1490,51232,3578761946,3578761966,20
2,1490,51233,3578761946,3578761966,20
2,1490,51234,3578761946,3578761966,20
2,1490,51235,3578761946,3578761967,21
2,1490,51236,3578761946,3578761967,21
2,1490,51237,3578761946,3578761968,22
2,1490,51238,3578761946,3578761970,24
2,1490,51239,3578761946,3578761971,25
2,1490,51240,3578761946,3578761972,26
2,1490,51241,3578761946,3578761973,27
2,1490,51242,3578761946,3578761973,27
2,1490,51243,3578761946,3578761974,28
2,1490,51244,3578761946,3578761974,28
2,1490,51245,3578761946,3578761976,30
2,1490,51246,3578761946,3578761978,32
2,1490,51247,3578761946,3578761978,32
2,1490,51248,3578761946,3578761980,34
2,1490,51249,3578761946,3578761982,36
2,1490,51250,3578761946,3578761984,38
2,1490,51251,3578761946,3578761984,38
2,1490,51252,3578761946,3578761985,39
2,1490,51253,3578761946,3578761985,39
2,1490,51254,3578761946,3578761987,41
2,1490,51255,3578761946,3578761987,41
2,1490,51256,3578761946,3578761988,42
2,1490,51257,3578761946,3578761990,44
2,1490,51258,3578761946,3578761990,44
2,1490,51259,3578761946,3578761990,44
2,1490,51260,3578761946,3578761990,44
2,1490,51261,3578761946,3578761990,44
2,1490,51262,3578761946,3578761991,45
2,1490,51263,3578761946,3578761991,45
2,1490,51264,3578761946,3578761992,46
2,1490,51265,3578761946,3578761992,46
2,1490,51266,3578761946,3578761993,47
2,1491,51267,3578762011,3578762011,0
2,1491,51268,3578762011,3578762011,0
2,1491,51269,3578762011,3578762011,0
2,1491,51270,3578762011,3578762011,0
2,1491,51271,3578762011,3578762011,0
2,1491,51272,3578762011,3578762011,0
2,1491,51273,3578762011,3578762011,0
2,1491,51274,3578762011,3578762011,0
2,1491,51275,3578762011,3578762011,0
2,1491,51276,3578762011,3578762011,0
2,1491,51277,3578762011,3578762011,0
2,1491,51278,3578762011,3578762011,0
2,1491,51279,3578762011,3578762011,0
2,1491,51280,3578762011,3578762011,0
2,1491,51281,3578762011,3578762011,0
2,1491,51282,3578762011,3578762012,1
2,1491,51283,3578762011,3578762013,2
2,1491,51284,3578762011,3578762014,3
2,1491,51285,3578762011,3578762014,3
2,1491,51286,3578762011,3578762015,4
2,1491,51287,3578762011,3578762016,5
2,1491,51288,3578762011,3578762016,5
2,1491,51289,3578762011,3578762017,6
2,1491,51290,3578762011,3578762019,8
2,1491,51291,3578762011,3578762021,10
2,1491,51292,3578762011,3578762021,10
2,1491,51293,3578762011,3578762021,10
2,1491,51294,3578762011,3578762024,13
2,1491,51295,3578762011,3578762025,14
2,1491,51296,3578762011,3578762025,14
2,1491,51297,3578762011,3578762026,15
2,1491,51298,3578762011,3578762027,16
2,1491,51299,3578762011,3578762028,17
2,1491,51300,3578762011,3578762029,18
2,1491,51301,3578762011,3578762029,18
2,1491,51302,3578762011,3578762031,20
2,1491,51303,3578762011,3578762031,20
2,1491,51304,3578762011,3578762032,21
2,1491,51305,3578762011,3578762032,21
2,1491,51306,3578762011,3578762033,22
2,1491,51307,3578762011,3578762035,24
2,1491,51308,3578762011,3578762036,25
2,1491,51309,3578762011,3578762037,26
2,1491,51310,3578762011,3578762037,26
2,1491,51311,3578762011,3578762038,27
2,1491,51312,3578762011,3578762038,27
2,1491,51313,3578762011,3578762039,28
2,1491,51314,3578762011,3578762040,29
2,1491,51315,3578762011,3578762040,29
2,1491,51316,3578762011,3578762040,29
2,1491,51317,3578762011,3578762041,30
2,1491,51318,3578762011,3578762042,31
2,1491,51319,3578762011,3578762042,31
2,1491,51320,3578762011,3578762042,31
2,1491,51321,3578762011,3578762043,32
2,1491,51322,3578762011,3578762044,33
2,1491,51323,3578762011,3578762045,34
2,1491,51324,3578762011,3578762046,35
2,1491,51325,3578762011,3578762046,35
2,1491,51326,3578762011,3578762047,36
2,1491,51327,3578762011,3578762047,36
2,1491,51328,3578762011,3578762047,36
2,1491,51329,3578762011,3578762050,39
2,1491,51330,3578762011,3578762050,39
2,1491,51331,3578762011,3578762050,39
2,1491,51332,3578762011,3578762050,39
2,1491,51333,3578762011,3578762052,41
2,1491,51334,3578762011,3578762052,41
2,1491,51335,3578762011,3578762053,42
2,1491,51336,3578762011,3578762054,43
2,1491,51337,3578762011,3578762054,43
2,1491,51338,3578762011,3578762055,44
2,1491,51339,3578762011,3578762056,45
2,1491,51340,3578762011,3578762056,45
2,1491,51341,3578762011,3578762057,46
2,1491,51342,3578762011,3578762058,47
2,1491,51343,3578762011,3578762060,49
2,1491,51344,3578762011,3578762061,50
2,1492,51345,3578762074,3578762074,0
2,1492,51346,3578762074,3578762074,0
2,1492,51347,3578762074,3578762074,0
2,1492,51348,3578762074,3578762074,0
2,1492,51349,3578762074,3578762074,0
2,1492,51350,3578762074,3578762074,0
2,1492,51351,3578762074,3578762074,0
2,1492,51352,3578762074,3578762074,0
2,1492,51353,3578762074,3578762074,0
2,1492,51354,3578762074,3578762078,4
2,1492,51355,3578762074,3578762080,6
2,1492,51356,3578762074,3578762082,8
2,1492,51357,3578762074,3578762083,9
2,1492,51358,3578762074,3578762083,9
2,1492,51359,3578762074,3578762084,10
2,1492,51360,3578762074,3578762085,11
2,1492,51361,3578762074,3578762087,13
2,1492,51362,3578762074,3578762090,16
2,1492,51363,3578762074,3578762090,16
2,1492,51364,3578762074,3578762090,16
2,1492,51365,3578762074,3578762091,17
2,1492,51366,3578762074,3578762091,17
2,1492,51367,3578762074,3578762092,18
2,1492,51368,3578762074,3578762092,18
2,1492,51369,3578762074,3578762092,18
2,1492,51370,3578762074,3578762093,19
2,1492,51371,3578762074,3578762094,20
2,1492,51372,3578762074,3578762096,22
2,1492,51373,3578762074,3578762097,23
2,1492,51374,3578762074,3578762097,23
2,1492,51375,3578762074,3578762097,23
2,1492,51376,3578762074,3578762098,24
2,1492,51377,3578762074,3578762098,24
2,1492,51378,3578762074,3578762099,25
2,1492,51379,3578762074,3578762099,25
2,1492,51380,3578762074,3578762100,26
2,1492,51381,3578762074,3578762100,26
2,1492,51382,3578762074,3578762100,26
2,1492,51383,3578762074,3578762101,27
2,1492,51384,3578762074,3578762101,27
2,1492,51385,3578762074,3578762102,28
2,1492,51386,3578762074,3578762102,28
2,1492,51387,3578762074,3578762102,28
2,1492,51388,3578762074,3578762102,28
2,1492,51389,3578762074,3578762104,30
2,1492,51390,3578762074,3578762104,30
2,1492,51391,3578762074,3578762104,30
2,1492,51392,3578762074,3578762105,31
2,1492,51393,3578762074,3578762106,32
2,1492,51394,3578762074,3578762109,35
2,1492,51395,3578762074,3578762109,35
2,1492,51396,3578762074,3578762109,35
2,1492,51397,3578762074,3578762110,36
2,1492,51398,3578762074,3578762111,37
2,1492,51399,3578762074,3578762111,37
2,1492,51400,3578762074,3578762112,38
2,1492,51401,3578762074,3578762112,38
2,1492,51402,3578762074,3578762112,38
2,1492,51403,3578762074,3578762113,39
2,1492,51404,3578762074,3578762114,40
2,1492,51405,3578762074,3578762114,40
2,1492,51406,3578762074,3578762115,41
2,1492,51407,3578762074,3578762115,41
2,1492,51408,3578762074,3578762116,42
2,1492,51409,3578762074,3578762116,42
2,1492,51410,3578762074,3578762116,42
2,1492,51411,3578762074,3578762117,43
2,1492,51412,3578762074,3578762117,43
2,1492,51413,3578762074,3578762117,43
2,1492,51414,3578762074,3578762117,43
2,1492,51415,3578762074,3578762118,44
2,1492,51416,3578762074,3578762119,45
2,1492,51417,3578762074,3578762120,46
2,1492,51418,3578762074,3578762122,48
2,1492,51419,3578762074,3578762122,48
2,1492,51420,3578762074,3578762124,50
2,1493,51421,3578762137,3578762137,0
2,1493,51422,3578762137,3578762137,0
2,1493,51423,3578762137,3578762137,0
2,1493,51424,3578762137,3578762137,0
2,1493,51425,3578762137,3578762137,0
2,1493,51426,3578762137,3578762137,0
2,1493,51427,3578762137,3578762137,0
2,1493,51428,3578762137,3578762137,0
2,1493,51429,3578762137,3578762137,0
2,1493,51430,3578762137,3578762137,0
2,1493,51431,3578762137,3578762137,0
2,1493,51432,3578762137,3578762138,1
2,1493,51433,3578762137,3578762138,1
2,1493,51434,3578762137,3578762139,2
2,1493,51435,3578762137,3578762139,2
2,1493,51436,3578762137,3578762139,2
2,1493,51437,3578762137,3578762139,2
2,1493,51438,3578762137,3578762140,3
2,1493,51439,3578762137,3578762140,3
2,1493,51440,3578762137,3578762142,5
2,1493,51441,3578762137,3578762143,6
2,1493,51442,3578762137,3578762144,7
2,1493,51443,3578762137,3578762146,9
2,1493,51444,3578762137,3578762147,10
2,1493,51445,3578762137,3578762149,12
2,1493,51446,3578762137,3578762150,13
2,1493,51447,3578762137,3578762150,13
2,1493,51448,3578762137,3578762151,14
2,1493,51449,3578762137,3578762151,14
2,1493,51450,3578762137,3578762152,15
2,1493,51451,3578762137,3578762152,15
2,1493,51452,3578762137,3578762153,16
2,1493,51453,3578762137,3578762153,16
2,1493,51454,3578762137,3578762154,17
2,1493,51455,3578762137,3578762154,17
2,1493,51456,3578762137,3578762154,17
2,1493,51457,3578762137,3578762154,17
2,1493,51458,3578762137,3578762156,19
2,1493,51459,3578762137,3578762157,20
2,1493,51460,3578762137,3578762158,21
2,1493,51461,3578762137,3578762158,21
2,1493,51462,3578762137,3578762159,22
2,1493,51463,3578762137,3578762162,25
2,1493,51464,3578762137,3578762163,26
2,1493,51465,3578762137,3578762165,28
2,1493,51466,3578762137,3578762165,28
2,1493,51467,3578762137,3578762166,29
2,1493,51468,3578762137,3578762166,29
2,1493,51469,3578762137,3578762166,29
2,1493,51470,3578762137,3578762168,31
2,1493,51471,3578762137,3578762169,32
2,1493,51472,3578762137,3578762169,32
2,1493,51473,3578762137,3578762170,33
2,1493,51474,3578762137,3578762170,33
2,1493,51475,3578762137,3578762171,34
2,1493,51476,3578762137,3578762172,35
2,1493,51477,3578762137,3578762172,35
2,1493,51478,3578762137,3578762174,37
2,1493,51479,3578762137,3578762174,37
2,1493,51480,3578762137,3578762175,38
2,1493,51481,3578762137,3578762176,39
2,1493,51482,3578762137,3578762178,41
2,1493,51483,3578762137,3578762178,41
2,1493,51484,3578762137,3578762180,43
2,1493,51485,3578762137,3578762183,46
2,1493,51486,3578762137,3578762184,47
2,1493,51487,3578762137,3578762184,47
2,1493,51488,3578762137,3578762185,48
2,1493,51489,3578762137,3578762185,48
2,1494,51490,3578762200,3578762200,0
2,1494,51491,3578762200,3578762200,0
2,1494,51492,3578762200,3578762200,0
2,1494,51493,3578762200,3578762200,0
2,1494,51494,3578762200,3578762200,0
2,1494,51495,3578762200,3578762200,0
2,1494,51496,3578762200,3578762200,0
2,1494,51497,3578762200,3578762200,0
2,1494,51498,3578762200,3578762200,0
2,1494,51499,3578762200,3578762200,0
2,1494,51500,3578762200,3578762200,0
2,1494,51501,3578762200,3578762200,0
2,1494,51502,3578762200,3578762200,0
2,1494,51503,3578762200,3578762200,0
2,1494,51504,3578762200,3578762200,0
2,1494,51505,3578762200,3578762200,0
2,1494,51506,3578762200,3578762201,1
2,1494,51507,3578762200,3578762202,2
2,1494,51508,3578762200,3578762203,3
2,1494,51509,3578762200,3578762203,3
2,1494,51510,3578762200,3578762204,4
2,1494,51511,3578762200,3578762204,4
2,1494,51512,3578762200,3578762205,5
2,1494,51513,3578762200,3578762206,6
2,1494,51514,3578762200,3578762206,6
2,1494,51515,3578762200,3578762206,6
2,1494,51516,3578762200,3578762207,7
2,1494,51517,3578762200,3578762208,8
2,1494,51518,3578762200,3578762211,11
2,1494,51519,3578762200,3578762212,12
2,1494,51520,3578762200,3578762213,13
2,1494,51521,3578762200,3578762214,14
2,1494,51522,3578762200,3578762214,14
2,1494,51523,3578762200,3578762215,15
2,1494,51524,3578762200,3578762216,16
2,1494,51525,3578762200,3578762216,16
2,1494,51526,3578762200,3578762218,18
2,1494,51527,3578762200,3578762219,19
2,1494,51528,3578762200,3578762221,21
2,1494,51529,3578762200,3578762221,21
2,1494,51530,3578762200,3578762222,22
2,1494,51531,3578762200,3578762224,24
2,1494,51532,3578762200,3578762225,25
2,1494,51533,3578762200,3578762226,26
2,1494,51534,3578762200,3578762226,26
2,1494,51535,3578762200,3578762227,27
2,1494,51536,3578762200,3578762228,28
2,1494,51537,3578762200,3578762228,28
2,1494,51538,3578762200,3578762229,29
2,1494,51539,3578762200,3578762231,31
2,1494,51540,3578762200,3578762232,32
2,1494,51541,3578762200,3578762232,32
2,1494,51542,3578762200,3578762232,32
2,1494,51543,3578762200,3578762233,33
2,1494,51544,3578762200,3578762234,34
2,1494,51545,3578762200,3578762235,35
2,1494,51546,3578762200,3578762236,36
2,1494,51547,3578762200,3578762236,36
2,1494,51548,3578762200,3578762237,37
2,1494,51549,3578762200,3578762237,37
2,1494,51550,3578762200,3578762237,37
2,1494,51551,3578762200,3578762239,39
2,1494,51552,3578762200,3578762239,39
2,1494,51553,3578762200,3578762240,40
2,1494,51554,3578762200,3578762240,40
2,1494,51555,3578762200,3578762242,42
2,1494,51556,3578762200,3578762242,42
2,1494,51557,3578762200,3578762242,42
2,1494,51558,3578762200,3578762243,43
2,1494,51559,3578762200,3578762243,43
2,1494,51560,3578762200,3578762244,44
2,1494,51561,3578762200,3578762245,45
2,1494,51562,3578762200,3578762246,46
2,1494,51563,3578762200,3578762246,46
2,1494,51564,3578762200,3578762246,46
2,1494,51565,3578762200,3578762246,46
2,1494,51566,3578762200,3578762246,46
2,1494,51567,3578762200,3578762247,47
2,1494,51568,3578762200,3578762249,49
2,1495,51569,3578762263,3578762263,0
2,1495,51570,3578762263,3578762263,0
2,1495,51571,3578762263,3578762263,0
2,1495,51572,3578762263,3578762263,0
2,1495,51573,3578762263,3578762263,0
2,1495,51574,3578762263,3578762263,0
2,1495,51575,3578762263,3578762263,0
2,1495,51576,3578762263,3578762263,0
2,1495,51577,3578762263,3578762263,0
2,1495,51578,3578762263,3578762263,0
2,1495,51579,3578762263,3578762263,0
2,1495,51580,3578762263,3578762263,0
2,1495,51581,3578762263,3578762263,0
2,1495,51582,3578762263,3578762263,0
2,1495,51583,3578762263,3578762263,0
2,1495,51584,3578762263,3578762263,0
2,1495,51585,3578762263,3578762263,0
2,1495,51586,3578762263,3578762263,0
2,1495,51587,3578762263,3578762265,2
2,1495,51588,3578762263,3578762265,2
2,1495,51589,3578762263,3578762265,2
2,1495,51590,3578762263,3578762265,2
2,1495,51591,3578762263,3578762268,5
2,1495,51592,3578762263,3578762270,7
2,1495,51593,3578762263,3578762271,8
2,1495,51594,3578762263,3578762278,15
2,1495,51595,3578762263,3578762280,17
2,1495,51596,3578762263,3578762282,19
2,1495,51597,3578762263,3578762283,20
2,1495,51598,3578762263,3578762283,20
2,1495,51599,3578762263,3578762284,21
2,1495,51600,3578762263,3578762285,22
2,1495,51601,3578762263,3578762287,24
2,1495,51602,3578762263,3578762289,26
2,1495,51603,3578762263,3578762291,28
2,1495,51604,3578762263,3578762291,28
2,1495,51605,3578762263,3578762292,29
2,1495,51606,3578762263,3578762292,29
2,1495,51607,3578762263,3578762292,29
2,1495,51608,3578762263,3578762293,30
2,1495,51609,3578762263,3578762294,31
2,1495,51610,3578762263,3578762295,32
2,1495,51611,3578762263,3578762296,33
2,1495,51612,3578762263,3578762297,34
2,1495,51613,3578762263,3578762297,34
2,1495,51614,3578762263,3578762297,34
2,1495,51615,3578762263,3578762298,35
2,1495,51616,3578762263,3578762298,35
2,1495,51617,3578762263,3578762298,35
2,1495,51618,3578762263,3578762299,36
2,1495,51619,3578762263,3578762299,36
2,1495,51620,3578762263,3578762299,36
2,1495,51621,3578762263,3578762300,37
2,1495,51622,3578762263,3578762301,38
2,1495,51623,3578762263,3578762301,38
2,1495,51624,3578762263,3578762302,39
2,1495,51625,3578762263,3578762302,39
2,1495,51626,3578762263,3578762302,39
2,1495,51627,3578762263,3578762302,39
2,1495,51628,3578762263,3578762304,41
2,1495,51629,3578762263,3578762304,41
2,1495,51630,3578762263,3578762305,42
2,1495,51631,3578762263,3578762306,43
2,1495,51632,3578762263,3578762306,43
2,1495,51633,3578762263,3578762309,46
2,1495,51634,3578762263,3578762310,47
2,1495,51635,3578762263,3578762310,47
2,1495,51636,3578762263,3578762311,48
2,1495,51637,3578762263,3578762311,48
2,1495,51638,3578762263,3578762312,49
2,1495,51639,3578762263,3578762312,49
2,1495,51640,3578762263,3578762312,49
2,1495,51641,3578762263,3578762313,50
2,1496,51642,3578762326,3578762326,0
2,1496,51643,3578762326,3578762326,0
2,1496,51644,3578762326,3578762326,0
2,1496,51645,3578762326,3578762326,0
2,1496,51646,3578762326,3578762326,0
2,1496,51647,3578762326,3578762326,0
2,1496,51648,3578762326,3578762326,0
2,1496,51649,3578762326,3578762326,0
2,1496,51650,3578762326,3578762326,0
2,1496,51651,3578762326,3578762326,0
2,1496,51652,3578762326,3578762326,0
2,1496,51653,3578762326,3578762326,0
2,1496,51654,3578762326,3578762326,0
2,1496,51655,3578762326,3578762326,0
2,1496,51656,3578762326,3578762326,0
2,1496,51657,3578762326,3578762326,0
2,1496,51658,3578762326,3578762326,0
2,1496,51659,3578762326,3578762326,0
2,1496,51660,3578762326,3578762326,0
2,1496,51661,3578762326,3578762326,0
2,1496,51662,3578762326,3578762327,1
2,1496,51663,3578762326,3578762330,4
2,1496,51664,3578762326,3578762332,6
2,1496,51665,3578762326,3578762332,6
2,1496,51666,3578762326,3578762332,6
2,1496,51667,3578762326,3578762333,7
2,1496,51668,3578762326,3578762334,8
2,1496,51669,3578762326,3578762336,10
2,1496,51670,3578762326,3578762336,10
2,1496,51671,3578762326,3578762338,12
2,1496,51672,3578762326,3578762339,13
2,1496,51673,3578762326,3578762339,13
2,1496,51674,3578762326,3578762339,13
2,1496,51675,3578762326,3578762339,13
2,1496,51676,3578762326,3578762340,14
2,1496,51677,3578762326,3578762341,15
2,1496,51678,3578762326,3578762341,15
2,1496,51679,3578762326,3578762342,16
2,1496,51680,3578762326,3578762344,18
2,1496,51681,3578762326,3578762345,19
2,1496,51682,3578762326,3578762346,20
2,1496,51683,3578762326,3578762348,22
2,1496,51684,3578762326,3578762348,22
2,1496,51685,3578762326,3578762349,23
2,1496,51686,3578762326,3578762350,24
2,1496,51687,3578762326,3578762350,24
2,1496,51688,3578762326,3578762351,25
2,1496,51689,3578762326,3578762352,26
2,1496,51690,3578762326,3578762352,26
2,1496,51691,3578762326,3578762352,26
2,1496,51692,3578762326,3578762353,27
2,1496,51693,3578762326,3578762354,28
2,1496,51694,3578762326,3578762354,28
2,1496,51695,3578762326,3578762355,29
2,1496,51696,3578762326,3578762355,29
2,1496,51697,3578762326,3578762355,29
2,1496,51698,3578762326,3578762356,30
2,1496,51699,3578762326,3578762357,31
2,1496,51700,3578762326,3578762358,32
2,1496,51701,3578762326,3578762358,32
2,1496,51702,3578762326,3578762358,32
2,1496,51703,3578762326,3578762362,36
2,1496,51704,3578762326,3578762364,38
2,1496,51705,3578762326,3578762365,39
2,1496,51706,3578762326,3578762366,40
2,1496,51707,3578762326,3578762366,40
2,1496,51708,3578762326,3578762366,40
2,1496,51709,3578762326,3578762366,40
2,1496,51710,3578762326,3578762366,40
2,1496,51711,3578762326,3578762368,42
2,1496,51712,3578762326,3578762369,43
2,1496,51713,3578762326,3578762369,43
2,1496,51714,3578762326,3578762370,44
2,1496,51715,3578762326,3578762370,44
2,1496,51716,3578762326,3578762373,47
2,1496,51717,3578762326,3578762374,48
2,1496,51718,3578762326,3578762374,48
2,1496,51719,3578762326,3578762376,50
2,1497,51720,3578762390,3578762390,0
2,1497,51721,3578762390,3578762390,0
2,1497,51722,3578762390,3578762390,0
2,1497,51723,3578762390,3578762390,0
2,1497,51724,3578762390,3578762390,0
2,1497,51725,3578762390,3578762390,0
2,1497,51726,3578762390,3578762390,0
2,1497,51727,3578762390,3578762390,0
2,1497,51728,3578762390,3578762390,0
2,1497,51729,3578762390,3578762390,0
2,1497,51730,3578762390,3578762390,0
2,1497,51731,3578762390,3578762390,0
2,1497,51732,3578762390,3578762390,0
2,1497,51733,3578762390,3578762390,0
2,1497,51734,3578762390,3578762390,0
2,1497,51735,3578762390,3578762390,0
2,1497,51736,3578762390,3578762391,1
2,1497,51737,3578762390,3578762391,1
2,1497,51738,3578762390,3578762391,1
2,1497,51739,3578762390,3578762392,2
2,1497,51740,3578762390,3578762392,2
2,1497,51741,3578762390,3578762393,3
2,1497,51742,3578762390,3578762394,4
2,1497,51743,3578762390,3578762398,8
2,1497,51744,3578762390,3578762400,10
2,1497,51745,3578762390,3578762401,11
2,1497,51746,3578762390,3578762401,11
2,1497,51747,3578762390,3578762402,12
2,1497,51748,3578762390,3578762403,13
2,1497,51749,3578762390,3578762403,13
2,1497,51750,3578762390,3578762404,14
2,1497,51751,3578762390,3578762404,14
2,1497,51752,3578762390,3578762406,16
2,1497,51753,3578762390,3578762406,16
2,1497,51754,3578762390,3578762406,16
2,1497,51755,3578762390,3578762408,18
2,1497,51756,3578762390,3578762409,19
2,1497,51757,3578762390,3578762411,21
2,1497,51758,3578762390,3578762412,22
2,1497,51759,3578762390,3578762413,23
2,1497,51760,3578762390,3578762413,23
2,1497,51761,3578762390,3578762414,24
2,1497,51762,3578762390,3578762415,25
2,1497,51763,3578762390,3578762416,26
2,1497,51764,3578762390,3578762417,27
2,1497,51765,3578762390,3578762419,29
2,1497,51766,3578762390,3578762421,31
2,1497,51767,3578762390,3578762421,31
2,1497,51768,3578762390,3578762422,32
2,1497,51769,3578762390,3578762424,34
2,1497,51770,3578762390,3578762425,35
2,1497,51771,3578762390,3578762427,37
2,1497,51772,3578762390,3578762428,38
2,1497,51773,3578762390,3578762428,38
2,1497,51774,3578762390,3578762429,39
2,1497,51775,3578762390,3578762430,40
2,1497,51776,3578762390,3578762431,41
2,1497,51777,3578762390,3578762432,42
2,1497,51778,3578762390,3578762432,42
2,1497,51779,3578762390,3578762432,42
2,1497,51780,3578762390,3578762433,43
2,1497,51781,3578762390,3578762434,44
2,1497,51782,3578762390,3578762435,45
2,1497,51783,3578762390,3578762436,46
2,1497,51784,3578762390,3578762438,48
2,1497,51785,3578762390,3578762438,48
2,1497,51786,3578762390,3578762438,48
2,1497,51787,3578762390,3578762438,48
2,1497,51788,3578762390,3578762439,49
2,1497,51789,3578762390,3578762439,49
2,1497,51790,3578762390,3578762440,50
2,1498,51791,3578762455,3578762455,0
2,1498,51792,3578762455,3578762455,0
2,1498,51793,3578762455,3578762455,0
2,1498,51794,3578762455,3578762455,0
2,1498,51795,3578762455,3578762455,0
2,1498,51796,3578762455,3578762455,0
2,1498,51797,3578762455,3578762455,0
2,1498,51798,3578762455,3578762455,0
2,1498,51799,3578762455,3578762455,0
2,1498,51800,3578762455,3578762455,0
2,1498,51801,3578762455,3578762455,0
2,1498,51802,3578762455,3578762455,0
2,1498,51803,3578762455,3578762455,0
2,1498,51804,3578762455,3578762455,0
2,1498,51805,3578762455,3578762455,0
2,1498,51806,3578762455,3578762455,0
2,1498,51807,3578762455,3578762455,0
2,1498,51808,3578762455,3578762455,0
2,1498,51809,3578762455,3578762455,0
2,1498,51810,3578762455,3578762455,0
2,1498,51811,3578762455,3578762455,0
2,1498,51812,3578762455,3578762455,0
2,1498,51813,3578762455,3578762455,0
2,1498,51814,3578762455,3578762455,0
2,1498,51815,3578762455,3578762455,0
2,1498,51816,3578762455,3578762455,0
2,1498,51817,3578762455,3578762456,1
2,1498,51818,3578762455,3578762456,1
2,1498,51819,3578762455,3578762456,1
2,1498,51820,3578762455,3578762456,1
2,1498,51821,3578762455,3578762458,3
2,1498,51822,3578762455,3578762458,3
2,1498,51823,3578762455,3578762460,5
2,1498,51824,3578762455,3578762461,6
2,1498,51825,3578762455,3578762462,7
2,1498,51826,3578762455,3578762464,9
2,1498,51827,3578762455,3578762464,9
2,1498,51828,3578762455,3578762465,10
2,1498,51829,3578762455,3578762466,11
2,1498,51830,3578762455,3578762466,11
2,1498,51831,3578762455,3578762467,12
2,1498,51832,3578762455,3578762468,13
2,1498,51833,3578762455,3578762470,15
2,1498,51834,3578762455,3578762470,15
2,1498,51835,3578762455,3578762478,23
2,1498,51836,3578762455,3578762480,25
2,1498,51837,3578762455,3578762482,27
2,1498,51838,3578762455,3578762483,28
2,1498,51839,3578762455,3578762484,29
2,1498,51840,3578762455,3578762484,29
2,1498,51841,3578762455,3578762485,30
2,1498,51842,3578762455,3578762487,32
2,1498,51843,3578762455,3578762490,35
2,1498,51844,3578762455,3578762490,35
2,1498,51845,3578762455,3578762491,36
2,1498,51846,3578762455,3578762491,36
2,1498,51847,3578762455,3578762491,36
2,1498,51848,3578762455,3578762492,37
2,1498,51849,3578762455,3578762492,37
2,1498,51850,3578762455,3578762494,39
2,1498,51851,3578762455,3578762495,40
2,1498,51852,3578762455,3578762495,40
2,1498,51853,3578762455,3578762496,41
2,1498,51854,3578762455,3578762496,41
2,1498,51855,3578762455,3578762497,42
2,1498,51856,3578762455,3578762497,42
2,1498,51857,3578762455,3578762498,43
2,1498,51858,3578762455,3578762498,43
2,1498,51859,3578762455,3578762498,43
2,1498,51860,3578762455,3578762500,45
2,1498,51861,3578762455,3578762500,45
2,1498,51862,3578762455,3578762500,45
2,1498,51863,3578762455,3578762500,45
2,1498,51864,3578762455,3578762501,46
2,1498,51865,3578762455,3578762501,46
2,1498,51866,3578762455,3578762502,47
2,1498,51867,3578762455,3578762502,47
2,1498,51868,3578762455,3578762502,47
2,1498,51869,3578762455,3578762502,47
2,1498,51870,3578762455,3578762503,48
2,1498,51871,3578762455,3578762504,49
2,1498,51872,3578762455,3578762505,50
2,1499,51873,3578762519,3578762519,0
2,1499,51874,3578762519,3578762519,0
2,1499,51875,3578762519,3578762519,0
2,1499,51876,3578762519,3578762519,0
2,1499,51877,3578762519,3578762519,0
2,1499,51878,3578762519,3578762519,0
2,1499,51879,3578762519,3578762519,0
2,1499,51880,3578762519,3578762519,0
2,1499,51881,3578762519,3578762519,0
2,1499,51882,3578762519,3578762519,0
2,1499,51883,3578762519,3578762519,0
2,1499,51884,3578762519,3578762519,0
2,1499,51885,3578762519,3578762519,0
2,1499,51886,3578762519,3578762519,0
2,1499,51887,3578762519,3578762519,0
2,1499,51888,3578762519,3578762519,0
2,1499,51889,3578762519,3578762519,0
2,1499,51890,3578762519,3578762519,0
2,1499,51891,3578762519,3578762519,0
2,1499,51892,3578762519,3578762519,0
2,1499,51893,3578762519,3578762519,0
2,1499,51894,3578762519,3578762519,0
2,1499,51895,3578762519,3578762519,0
2,1499,51896,3578762519,3578762519,0
2,1499,51897,3578762519,3578762520,1
2,1499,51898,3578762519,3578762522,3
2,1499,51899,3578762519,3578762522,3
2,1499,51900,3578762519,3578762523,4
2,1499,51901,3578762519,3578762523,4
2,1499,51902,3578762519,3578762524,5
2,1499,51903,3578762519,3578762525,6
2,1499,51904,3578762519,3578762525,6
2,1499,51905,3578762519,3578762526,7
2,1499,51906,3578762519,3578762527,8
2,1499,51907,3578762519,3578762528,9
2,1499,51908,3578762519,3578762531,12
2,1499,51909,3578762519,3578762531,12
2,1499,51910,3578762519,3578762532,13
2,1499,51911,3578762519,3578762534,15
2,1499,51912,3578762519,3578762534,15
2,1499,51913,3578762519,3578762535,16
2,1499,51914,3578762519,3578762537,18
2,1499,51915,3578762519,3578762537,18
2,1499,51916,3578762519,3578762538,19
2,1499,51917,3578762519,3578762538,19
2,1499,51918,3578762519,3578762538,19
2,1499,51919,3578762519,3578762538,19
2,1499,51920,3578762519,3578762539,20
2,1499,51921,3578762519,3578762539,20
2,1499,51922,3578762519,3578762540,21
2,1499,51923,3578762519,3578762541,22
2,1499,51924,3578762519,3578762543,24
2,1499,51925,3578762519,3578762544,25
2,1499,51926,3578762519,3578762545,26
2,1499,51927,3578762519,3578762547,28
2,1499,51928,3578762519,3578762549,30
2,1499,51929,3578762519,3578762549,30
2,1499,51930,3578762519,3578762550,31
2,1499,51931,3578762519,3578762550,31
2,1499,51932,3578762519,3578762551,32
2,1499,51933,3578762519,3578762552,33
2,1499,51934,3578762519,3578762552,33
2,1499,51935,3578762519,3578762553,34
2,1499,51936,3578762519,3578762553,34
2,1499,51937,3578762519,3578762553,34
2,1499,51938,3578762519,3578762554,35
2,1499,51939,3578762519,3578762554,35
2,1499,51940,3578762519,3578762555,36
2,1499,51941,3578762519,3578762556,37
2,1499,51942,3578762519,3578762557,38
2,1499,51943,3578762519,3578762557,38
2,1499,51944,3578762519,3578762561,42
2,1499,51945,3578762519,3578762563,44
2,1499,51946,3578762519,3578762564,45
2,1499,51947,3578762519,3578762564,45
2,1499,51948,3578762519,3578762565,46
2,1499,51949,3578762519,3578762565,46
2,1499,51950,3578762519,3578762565,46
2,1499,51951,3578762519,3578762566,47
2,1499,51952,3578762519,3578762567,48
2,1499,51953,3578762519,3578762568,49
2,1499,51954,3578762519,3578762569,50
2,1500,51955,3578762583,3578762583,0
2,1500,51956,3578762583,3578762583,0
2,1500,51957,3578762583,3578762583,0
2,1500,51958,3578762583,3578762583,0
2,1500,51959,3578762583,3578762583,0
2,1500,51960,3578762583,3578762583,0
2,1500,51961,3578762583,3578762583,0
2,1500,51962,3578762583,3578762583,0
2,1500,51963,3578762583,3578762583,0
2,1500,51964,3578762583,3578762583,0
2,1500,51965,3578762583,3578762583,0
2,1500,51966,3578762583,3578762583,0
2,1500,51967,3578762583,3578762584,1
2,1500,51968,3578762583,3578762585,2
2,1500,51969,3578762583,3578762586,3
2,1500,51970,3578762583,3578762587,4
2,1500,51971,3578762583,3578762588,5
2,1500,51972,3578762583,3578762588,5
2,1500,51973,3578762583,3578762588,5
2,1500,51974,3578762583,3578762589,6
2,1500,51975,3578762583,3578762590,7
2,1500,51976,3578762583,3578762590,7
2,1500,51977,3578762583,3578762590,7
2,1500,51978,3578762583,3578762591,8
2,1500,51979,3578762583,3578762591,8
2,1500,51980,3578762583,3578762593,10
2,1500,51981,3578762583,3578762594,11
2,1500,51982,3578762583,3578762596,13
2,1500,51983,3578762583,3578762597,14
2,1500,51984,3578762583,3578762600,17
2,1500,51985,3578762583,3578762600,17
2,1500,51986,3578762583,3578762601,18
2,1500,51987,3578762583,3578762602,19
2,1500,51988,3578762583,3578762603,20
2,1500,51989,3578762583,3578762603,20
2,1500,51990,3578762583,3578762605,22
2,1500,51991,3578762583,3578762605,22
2,1500,51992,3578762583,3578762606,23
2,1500,51993,3578762583,3578762606,23
2,1500,51994,3578762583,3578762608,25
2,1500,51995,3578762583,3578762608,25
2,1500,51996,3578762583,3578762610,27
2,1500,51997,3578762583,3578762610,27
2,1500,51998,3578762583,3578762612,29
2,1500,51999,3578762583,3578762612,29
2,1500,52000,3578762583,3578762613,30
2,1500,52001,3578762583,3578762613,30
2,1500,52002,3578762583,3578762615,32
2,1500,52003,3578762583,3578762616,33
2,1500,52004,3578762583,3578762617,34
2,1500,52005,3578762583,3578762619,36
2,1500,52006,3578762583,3578762620,37
2,1500,52007,3578762583,3578762621,38
2,1500,52008,3578762583,3578762621,38
2,1500,52009,3578762583,3578762623,40
2,1500,52010,3578762583,3578762623,40
2,1500,52011,3578762583,3578762624,41
2,1500,52012,3578762583,3578762625,42
2,1500,52013,3578762583,3578762626,43
2,1500,52014,3578762583,3578762627,44
2,1500,52015,3578762583,3578762628,45
2,1500,52016,3578762583,3578762628,45
2,1500,52017,3578762583,3578762629,46
2,1500,52018,3578762583,3578762631,48
2,1500,52019,3578762583,3578762631,48
2,1500,52020,3578762583,3578762631,48
2,1500,52021,3578762583,3578762631,48
2,1500,52022,3578762583,3578762632,49
2,1501,52023,3578762649,3578762649,0
2,1501,52024,3578762649,3578762649,0
2,1501,52025,3578762649,3578762649,0
2,1501,52026,3578762649,3578762649,0
2,1501,52027,3578762649,3578762649,0
2,1501,52028,3578762649,3578762649,0
2,1501,52029,3578762649,3578762649,0
2,1501,52030,3578762649,3578762649,0
2,1501,52031,3578762649,3578762649,0
2,1501,52032,3578762649,3578762649,0
2,1501,52033,3578762649,3578762649,0
2,1501,52034,3578762649,3578762649,0
2,1501,52035,3578762649,3578762649,0
2,1501,52036,3578762649,3578762649,0
2,1501,52037,3578762649,3578762649,0
2,1501,52038,3578762649,3578762649,0
2,1501,52039,3578762649,3578762649,0
2,1501,52040,3578762649,3578762649,0
2,1501,52041,3578762649,3578762649,0
2,1501,52042,3578762649,3578762649,0
2,1501,52043,3578762649,3578762649,0
2,1501,52044,3578762649,3578762649,0
2,1501,52045,3578762649,3578762649,0
2,1501,52046,3578762649,3578762649,0
2,1501,52047,3578762649,3578762649,0
2,1501,52048,3578762649,3578762649,0
2,1501,52049,3578762649,3578762649,0
2,1501,52050,3578762649,3578762649,0
2,1501,52051,3578762649,3578762650,1
2,1501,52052,3578762649,3578762650,1
2,1501,52053,3578762649,3578762651,2
2,1501,52054,3578762649,3578762652,3
2,1501,52055,3578762649,3578762653,4
2,1501,52056,3578762649,3578762653,4
2,1501,52057,3578762649,3578762653,4
2,1501,52058,3578762649,3578762653,4
2,1501,52059,3578762649,3578762654,5
2,1501,52060,3578762649,3578762655,6
2,1501,52061,3578762649,3578762655,6
2,1501,52062,3578762649,3578762655,6
2,1501,52063,3578762649,3578762656,7
2,1501,52064,3578762649,3578762657,8
2,1501,52065,3578762649,3578762657,8
2,1501,52066,3578762649,3578762659,10
2,1501,52067,3578762649,3578762659,10
2,1501,52068,3578762649,3578762660,11
2,1501,52069,3578762649,3578762664,15
2,1501,52070,3578762649,3578762664,15
2,1501,52071,3578762649,3578762665,16
2,1501,52072,3578762649,3578762665,16
2,1501,52073,3578762649,3578762665,16
2,1501,52074,3578762649,3578762666,17
2,1501,52075,3578762649,3578762666,17
2,1501,52076,3578762649,3578762669,20
2,1501,52077,3578762649,3578762670,21
2,1501,52078,3578762649,3578762678,29
2,1501,52079,3578762649,3578762680,31
2,1501,52080,3578762649,3578762682,33
2,1501,52081,3578762649,3578762684,35
2,1501,52082,3578762649,3578762684,35
2,1501,52083,3578762649,3578762690,41
2,1501,52084,3578762649,3578762691,42
2,1501,52085,3578762649,3578762691,42
2,1501,52086,3578762649,3578762692,43
2,1501,52087,3578762649,3578762692,43
2,1501,52088,3578762649,3578762692,43
2,1501,52089,3578762649,3578762692,43
2,1501,52090,3578762649,3578762694,45
2,1501,52091,3578762649,3578762695,46
2,1501,52092,3578762649,3578762695,46
2,1501,52093,3578762649,3578762696,47
2,1501,52094,3578762649,3578762697,48
2,1501,52095,3578762649,3578762697,48
2,1501,52096,3578762649,3578762697,48
2,1501,52097,3578762649,3578762698,49
2,1501,52098,3578762649,3578762698,49
2,1501,52099,3578762649,3578762699,50
2,1502,52100,3578762714,3578762714,0
2,1502,52101,3578762714,3578762714,0
2,1502,52102,3578762714,3578762714,0
2,1502,52103,3578762714,3578762714,0
2,1502,52104,3578762714,3578762714,0
2,1502,52105,3578762714,3578762714,0
2,1502,52106,3578762714,3578762714,0
2,1502,52107,3578762714,3578762714,0
2,1502,52108,3578762714,3578762714,0
2,1502,52109,3578762714,3578762714,0
2,1502,52110,3578762714,3578762714,0
2,1502,52111,3578762714,3578762714,0
2,1502,52112,3578762714,3578762714,0
2,1502,52113,3578762714,3578762714,0
2,1502,52114,3578762714,3578762714,0
2,1502,52115,3578762714,3578762714,0
2,1502,52116,3578762714,3578762714,0
2,1502,52117,3578762714,3578762714,0
2,1502,52118,3578762714,3578762714,0
2,1502,52119,3578762714,3578762714,0
2,1502,52120,3578762714,3578762714,0
2,1502,52121,3578762714,3578762714,0
2,1502,52122,3578762714,3578762714,0
2,1502,52123,3578762714,3578762715,1
2,1502,52124,3578762714,3578762715,1
2,1502,52125,3578762714,3578762715,1
2,1502,52126,3578762714,3578762716,2
2,1502,52127,3578762714,3578762716,2
2,1502,52128,3578762714,3578762716,2
2,1502,52129,3578762714,3578762717,3
2,1502,52130,3578762714,3578762717,3
2,1502,52131,3578762714,3578762717,3
2,1502,52132,3578762714,3578762718,4
2,1502,52133,3578762714,3578762718,4
2,1502,52134,3578762714,3578762721,7
2,1502,52135,3578762714,3578762723,9
2,1502,52136,3578762714,3578762723,9
2,1502,52137,3578762714,3578762723,9
2,1502,52138,3578762714,3578762723,9
2,1502,52139,3578762714,3578762724,10
2,1502,52140,3578762714,3578762724,10
2,1502,52141,3578762714,3578762725,11
2,1502,52142,3578762714,3578762725,11
2,1502,52143,3578762714,3578762726,12
2,1502,52144,3578762714,3578762726,12
2,1502,52145,3578762714,3578762727,13
2,1502,52146,3578762714,3578762729,15
2,1502,52147,3578762714,3578762731,17
2,1502,52148,3578762714,3578762731,17
2,1502,52149,3578762714,3578762732,18
2,1502,52150,3578762714,3578762733,19
2,1502,52151,3578762714,3578762734,20
2,1502,52152,3578762714,3578762734,20
2,1502,52153,3578762714,3578762735,21
2,1502,52154,3578762714,3578762738,24
2,1502,52155,3578762714,3578762738,24
2,1502,52156,3578762714,3578762738,24
2,1502,52157,3578762714,3578762739,25
2,1502,52158,3578762714,3578762739,25
2,1502,52159,3578762714,3578762739,25
2,1502,52160,3578762714,3578762739,25
2,1502,52161,3578762714,3578762740,26
2,1502,52162,3578762714,3578762741,27
2,1502,52163,3578762714,3578762743,29
2,1502,52164,3578762714,3578762744,30
2,1502,52165,3578762714,3578762745,31
2,1502,52166,3578762714,3578762747,33
2,1502,52167,3578762714,3578762749,35
2,1502,52168,3578762714,3578762749,35
2,1502,52169,3578762714,3578762751,37
2,1502,52170,3578762714,3578762751,37
2,1502,52171,3578762714,3578762752,38
2,1502,52172,3578762714,3578762752,38
2,1502,52173,3578762714,3578762753,39
2,1502,52174,3578762714,3578762753,39
2,1502,52175,3578762714,3578762753,39
2,1502,52176,3578762714,3578762754,40
2,1502,52177,3578762714,3578762754,40
2,1502,52178,3578762714,3578762757,43
2,1502,52179,3578762714,3578762758,44
2,1502,52180,3578762714,3578762761,47
2,1502,52181,3578762714,3578762764,50
2,1503,52182,3578762778,3578762778,0
2,1503,52183,3578762778,3578762778,0
2,1503,52184,3578762778,3578762778,0
2,1503,52185,3578762778,3578762778,0
2,1503,52186,3578762778,3578762778,0
2,1503,52187,3578762778,3578762778,0
2,1503,52188,3578762778,3578762778,0
2,1503,52189,3578762778,3578762778,0
2,1503,52190,3578762778,3578762778,0
2,1503,52191,3578762778,3578762778,0
2,1503,52192,3578762778,3578762778,0
2,1503,52193,3578762778,3578762778,0
2,1503,52194,3578762778,3578762778,0
2,1503,52195,3578762778,3578762778,0
2,1503,52196,3578762778,3578762778,0
2,1503,52197,3578762778,3578762778,0
2,1503,52198,3578762778,3578762778,0
2,1503,52199,3578762778,3578762779,1
2,1503,52200,3578762778,3578762782,4
2,1503,52201,3578762778,3578762783,5
2,1503,52202,3578762778,3578762784,6
2,1503,52203,3578762778,3578762785,7
2,1503,52204,3578762778,3578762785,7
2,1503,52205,3578762778,3578762787,9
2,1503,52206,3578762778,3578762787,9
2,1503,52207,3578762778,3578762788,10
2,1503,52208,3578762778,3578762788,10
2,1503,52209,3578762778,3578762788,10
2,1503,52210,3578762778,3578762789,11
2,1503,52211,3578762778,3578762790,12
2,1503,52212,3578762778,3578762790,12
2,1503,52213,3578762778,3578762790,12
2,1503,52214,3578762778,3578762790,12
2,1503,52215,3578762778,3578762791,13
2,1503,52216,3578762778,3578762791,13
2,1503,52217,3578762778,3578762792,14
2,1503,52218,3578762778,3578762793,15
2,1503,52219,3578762778,3578762794,16
2,1503,52220,3578762778,3578762797,19
2,1503,52221,3578762778,3578762800,22
2,1503,52222,3578762778,3578762801,23
2,1503,52223,3578762778,3578762801,23
2,1503,52224,3578762778,3578762802,24
2,1503,52225,3578762778,3578762802,24
2,1503,52226,3578762778,3578762803,25
2,1503,52227,3578762778,3578762804,26
2,1503,52228,3578762778,3578762804,26
2,1503,52229,3578762778,3578762806,28
2,1503,52230,3578762778,3578762806,28
2,1503,52231,3578762778,3578762807,29
2,1503,52232,3578762778,3578762808,30
2,1503,52233,3578762778,3578762811,33
2,1503,52234,3578762778,3578762811,33
2,1503,52235,3578762778,3578762812,34
2,1503,52236,3578762778,3578762813,35
2,1503,52237,3578762778,3578762813,35
2,1503,52238,3578762778,3578762813,35
2,1503,52239,3578762778,3578762815,37
2,1503,52240,3578762778,3578762816,38
2,1503,52241,3578762778,3578762816,38
2,1503,52242,3578762778,3578762817,39
2,1503,52243,3578762778,3578762819,41
2,1503,52244,3578762778,3578762820,42
2,1503,52245,3578762778,3578762820,42
2,1503,52246,3578762778,3578762822,44
2,1503,52247,3578762778,3578762823,45
2,1503,52248,3578762778,3578762824,46
2,1503,52249,3578762778,3578762824,46
2,1503,52250,3578762778,3578762825,47
2,1503,52251,3578762778,3578762826,48
2,1503,52252,3578762778,3578762827,49
2,1504,52253,3578762844,3578762845,1
2,1504,52254,3578762844,3578762845,1
2,1504,52255,3578762844,3578762845,1
2,1504,52256,3578762844,3578762845,1
2,1504,52257,3578762844,3578762845,1
2,1504,52258,3578762844,3578762845,1
2,1504,52259,3578762844,3578762845,1
2,1504,52260,3578762844,3578762845,1
2,1504,52261,3578762844,3578762845,1
2,1504,52262,3578762844,3578762845,1
2,1504,52263,3578762844,3578762845,1
2,1504,52264,3578762844,3578762845,1
2,1504,52265,3578762844,3578762845,1
2,1504,52266,3578762844,3578762845,1
2,1504,52267,3578762844,3578762845,1
2,1504,52268,3578762844,3578762845,1
2,1504,52269,3578762844,3578762845,1
2,1504,52270,3578762844,3578762845,1
2,1504,52271,3578762844,3578762845,1
2,1504,52272,3578762844,3578762845,1
2,1504,52273,3578762844,3578762845,1
2,1504,52274,3578762844,3578762845,1
2,1504,52275,3578762844,3578762845,1
2,1504,52276,3578762844,3578762845,1
2,1504,52277,3578762844,3578762845,1
2,1504,52278,3578762844,3578762845,1
2,1504,52279,3578762844,3578762845,1
2,1504,52280,3578762844,3578762845,1
2,1504,52281,3578762844,3578762846,2
2,1504,52282,3578762844,3578762846,2
2,1504,52283,3578762844,3578762846,2
2,1504,52284,3578762844,3578762846,2
2,1504,52285,3578762844,3578762847,3
2,1504,52286,3578762844,3578762849,5
2,1504,52287,3578762844,3578762849,5
2,1504,52288,3578762844,3578762850,6
2,1504,52289,3578762844,3578762850,6
2,1504,52290,3578762844,3578762851,7
2,1504,52291,3578762844,3578762851,7
2,1504,52292,3578762844,3578762852,8
2,1504,52293,3578762844,3578762853,9
2,1504,52294,3578762844,3578762853,9
2,1504,52295,3578762844,3578762853,9
2,1504,52296,3578762844,3578762854,10
2,1504,52297,3578762844,3578762854,10
2,1504,52298,3578762844,3578762855,11
2,1504,52299,3578762844,3578762855,11
2,1504,52300,3578762844,3578762855,11
2,1504,52301,3578762844,3578762855,11
2,1504,52302,3578762844,3578762857,13
2,1504,52303,3578762844,3578762858,14
2,1504,52304,3578762844,3578762859,15
2,1504,52305,3578762844,3578762861,17
2,1504,52306,3578762844,3578762862,18
2,1504,52307,3578762844,3578762864,20
2,1504,52308,3578762844,3578762865,21
2,1504,52309,3578762844,3578762865,21
2,1504,52310,3578762844,3578762866,22
2,1504,52311,3578762844,3578762867,23
2,1504,52312,3578762844,3578762867,23
2,1504,52313,3578762844,3578762869,25
2,1504,52314,3578762844,3578762870,26
2,1504,52315,3578762844,3578762877,33
2,1504,52316,3578762844,3578762882,38
2,1504,52317,3578762844,3578762884,40
2,1504,52318,3578762844,3578762884,40
2,1504,52319,3578762844,3578762888,44
2,1504,52320,3578762844,3578762890,46
2,1504,52321,3578762844,3578762890,46
2,1504,52322,3578762844,3578762891,47
2,1504,52323,3578762844,3578762891,47
2,1504,52324,3578762844,3578762891,47
2,1504,52325,3578762844,3578762892,48
2,1504,52326,3578762844,3578762892,48
2,1504,52327,3578762844,3578762892,48
2,1504,52328,3578762844,3578762893,49
2,1504,52329,3578762844,3578762893,49
2,1505,52330,3578762909,3578762909,0
2,1505,52331,3578762909,3578762909,0
2,1505,52332,3578762909,3578762909,0
2,1505,52333,3578762909,3578762909,0
2,1505,52334,3578762909,3578762909,0
2,1505,52335,3578762909,3578762909,0
2,1505,52336,3578762909,3578762909,0
2,1505,52337,3578762909,3578762909,0
2,1505,52338,3578762909,3578762909,0
2,1505,52339,3578762909,3578762909,0
2,1505,52340,3578762909,3578762909,0
2,1505,52341,3578762909,3578762909,0
2,1505,52342,3578762909,3578762909,0
2,1505,52343,3578762909,3578762909,0
2,1505,52344,3578762909,3578762909,0
2,1505,52345,3578762909,3578762909,0
2,1505,52346,3578762909,3578762909,0
2,1505,52347,3578762909,3578762909,0
2,1505,52348,3578762909,3578762909,0
2,1505,52349,3578762909,3578762909,0
2,1505,52350,3578762909,3578762909,0
2,1505,52351,3578762909,3578762909,0
2,1505,52352,3578762909,3578762909,0
2,1505,52353,3578762909,3578762909,0
2,1505,52354,3578762909,3578762909,0
2,1505,52355,3578762909,3578762910,1
2,1505,52356,3578762909,3578762911,2
2,1505,52357,3578762909,3578762911,2
2,1505,52358,3578762909,3578762911,2
2,1505,52359,3578762909,3578762912,3
2,1505,52360,3578762909,3578762912,3
2,1505,52361,3578762909,3578762913,4
2,1505,52362,3578762909,3578762914,5
2,1505,52363,3578762909,3578762914,5
2,1505,52364,3578762909,3578762915,6
2,1505,52365,3578762909,3578762916,7
2,1505,52366,3578762909,3578762916,7
2,1505,52367,3578762909,3578762916,7
2,1505,52368,3578762909,3578762916,7
2,1505,52369,3578762909,3578762916,7
2,1505,52370,3578762909,3578762916,7
2,1505,52371,3578762909,3578762917,8
2,1505,52372,3578762909,3578762917,8
2,1505,52373,3578762909,3578762918,9
2,1505,52374,3578762909,3578762918,9
2,1505,52375,3578762909,3578762918,9
2,1505,52376,3578762909,3578762920,11
2,1505,52377,3578762909,3578762922,13
2,1505,52378,3578762909,3578762922,13
2,1505,52379,3578762909,3578762924,15
2,1505,52380,3578762909,3578762924,15
2,1505,52381,3578762909,3578762924,15
2,1505,52382,3578762909,3578762925,16
2,1505,52383,3578762909,3578762925,16
2,1505,52384,3578762909,3578762925,16
2,1505,52385,3578762909,3578762926,17
2,1505,52386,3578762909,3578762928,19
2,1505,52387,3578762909,3578762930,21
2,1505,52388,3578762909,3578762931,22
2,1505,52389,3578762909,3578762933,24
2,1505,52390,3578762909,3578762933,24
2,1505,52391,3578762909,3578762935,26
2,1505,52392,3578762909,3578762936,27
2,1505,52393,3578762909,3578762937,28
2,1505,52394,3578762909,3578762938,29
2,1505,52395,3578762909,3578762938,29
2,1505,52396,3578762909,3578762938,29
2,1505,52397,3578762909,3578762938,29
2,1505,52398,3578762909,3578762939,30
2,1505,52399,3578762909,3578762940,31
2,1505,52400,3578762909,3578762940,31
2,1505,52401,3578762909,3578762942,33
2,1505,52402,3578762909,3578762943,34
2,1505,52403,3578762909,3578762944,35
2,1505,52404,3578762909,3578762945,36
2,1505,52405,3578762909,3578762948,39
2,1505,52406,3578762909,3578762949,40
2,1505,52407,3578762909,3578762950,41
2,1505,52408,3578762909,3578762950,41
2,1505,52409,3578762909,3578762951,42
2,1505,52410,3578762909,3578762951,42
2,1505,52411,3578762909,3578762952,43
2,1505,52412,3578762909,3578762953,44
2,1505,52413,3578762909,3578762953,44
2,1505,52414,3578762909,3578762953,44
2,1505,52415,3578762909,3578762954,45
2,1505,52416,3578762909,3578762954,45
2,1505,52417,3578762909,3578762957,48
2,1505,52418,3578762909,3578762958,49
2,1506,52419,3578762974,3578762974,0
2,1506,52420,3578762974,3578762974,0
2,1506,52421,3578762974,3578762974,0
2,1506,52422,3578762974,3578762974,0
2,1506,52423,3578762974,3578762974,0
2,1506,52424,3578762974,3578762974,0
2,1506,52425,3578762974,3578762974,0
2,1506,52426,3578762974,3578762974,0
2,1506,52427,3578762974,3578762974,0
2,1506,52428,3578762974,3578762974,0
2,1506,52429,3578762974,3578762974,0
2,1506,52430,3578762974,3578762974,0
2,1506,52431,3578762974,3578762974,0
2,1506,52432,3578762974,3578762974,0
2,1506,52433,3578762974,3578762974,0
2,1506,52434,3578762974,3578762974,0
2,1506,52435,3578762974,3578762974,0
2,1506,52436,3578762974,3578762974,0
2,1506,52437,3578762974,3578762974,0
2,1506,52438,3578762974,3578762975,1
2,1506,52439,3578762974,3578762976,2
2,1506,52440,3578762974,3578762977,3
2,1506,52441,3578762974,3578762978,4
2,1506,52442,3578762974,3578762983,9
2,1506,52443,3578762974,3578762984,10
2,1506,52444,3578762974,3578762984,10
2,1506,52445,3578762974,3578762985,11
2,1506,52446,3578762974,3578762985,11
2,1506,52447,3578762974,3578762986,12
2,1506,52448,3578762974,3578762987,13
2,1506,52449,3578762974,3578762987,13
2,1506,52450,3578762974,3578762988,14
2,1506,52451,3578762974,3578762988,14
2,1506,52452,3578762974,3578762988,14
2,1506,52453,3578762974,3578762988,14
2,1506,52454,3578762974,3578762990,16
2,1506,52455,3578762974,3578762990,16
2,1506,52456,3578762974,3578762990,16
2,1506,52457,3578762974,3578762991,17
2,1506,52458,3578762974,3578762991,17
2,1506,52459,3578762974,3578762992,18
2,1506,52460,3578762974,3578762994,20
2,1506,52461,3578762974,3578763000,26
2,1506,52462,3578762974,3578763000,26
2,1506,52463,3578762974,3578763001,27
2,1506,52464,3578762974,3578763002,28
2,1506,52465,3578762974,3578763003,29
2,1506,52466,3578762974,3578763004,30
2,1506,52467,3578762974,3578763005,31
2,1506,52468,3578762974,3578763006,32
2,1506,52469,3578762974,3578763006,32
2,1506,52470,3578762974,3578763009,35
2,1506,52471,3578762974,3578763011,37
2,1506,52472,3578762974,3578763012,38
2,1506,52473,3578762974,3578763013,39
2,1506,52474,3578762974,3578763013,39
2,1506,52475,3578762974,3578763014,40
2,1506,52476,3578762974,3578763015,41
2,1506,52477,3578762974,3578763015,41
2,1506,52478,3578762974,3578763016,42
2,1506,52479,3578762974,3578763016,42
2,1506,52480,3578762974,3578763020,46
2,1506,52481,3578762974,3578763021,47
2,1506,52482,3578762974,3578763021,47
2,1506,52483,3578762974,3578763022,48
2,1506,52484,3578762974,3578763024,50
2,1507,52485,3578763038,3578763038,0
2,1507,52486,3578763038,3578763038,0
2,1507,52487,3578763038,3578763038,0
2,1507,52488,3578763038,3578763038,0
2,1507,52489,3578763038,3578763038,0
2,1507,52490,3578763038,3578763038,0
2,1507,52491,3578763038,3578763038,0
2,1507,52492,3578763038,3578763038,0
2,1507,52493,3578763038,3578763038,0
2,1507,52494,3578763038,3578763038,0
2,1507,52495,3578763038,3578763038,0
2,1507,52496,3578763038,3578763038,0
2,1507,52497,3578763038,3578763038,0
2,1507,52498,3578763038,3578763038,0
2,1507,52499,3578763038,3578763038,0
2,1507,52500,3578763038,3578763038,0
2,1507,52501,3578763038,3578763038,0
2,1507,52502,3578763038,3578763038,0
2,1507,52503,3578763038,3578763038,0
2,1507,52504,3578763038,3578763038,0
2,1507,52505,3578763038,3578763039,1
2,1507,52506,3578763038,3578763040,2
2,1507,52507,3578763038,3578763041,3
2,1507,52508,3578763038,3578763041,3
2,1507,52509,3578763038,3578763042,4
2,1507,52510,3578763038,3578763042,4
2,1507,52511,3578763038,3578763042,4
2,1507,52512,3578763038,3578763042,4
2,1507,52513,3578763038,3578763043,5
2,1507,52514,3578763038,3578763044,6
2,1507,52515,3578763038,3578763045,7
2,1507,52516,3578763038,3578763045,7
2,1507,52517,3578763038,3578763046,8
2,1507,52518,3578763038,3578763046,8
2,1507,52519,3578763038,3578763046,8
2,1507,52520,3578763038,3578763046,8
2,1507,52521,3578763038,3578763049,11
2,1507,52522,3578763038,3578763049,11
2,1507,52523,3578763038,3578763050,12
2,1507,52524,3578763038,3578763050,12
2,1507,52525,3578763038,3578763051,13
2,1507,52526,3578763038,3578763053,15
2,1507,52527,3578763038,3578763053,15
2,1507,52528,3578763038,3578763053,15
2,1507,52529,3578763038,3578763054,16
2,1507,52530,3578763038,3578763054,16
2,1507,52531,3578763038,3578763055,17
2,1507,52532,3578763038,3578763055,17
2,1507,52533,3578763038,3578763055,17
2,1507,52534,3578763038,3578763055,17
2,1507,52535,3578763038,3578763057,19
2,1507,52536,3578763038,3578763058,20
2,1507,52537,3578763038,3578763061,23
2,1507,52538,3578763038,3578763061,23
2,1507,52539,3578763038,3578763062,24
2,1507,52540,3578763038,3578763065,27
2,1507,52541,3578763038,3578763065,27
2,1507,52542,3578763038,3578763066,28
2,1507,52543,3578763038,3578763066,28
2,1507,52544,3578763038,3578763067,29
2,1507,52545,3578763038,3578763069,31
2,1507,52546,3578763038,3578763070,32
2,1507,52547,3578763038,3578763080,42
2,1507,52548,3578763038,3578763084,46
2,1507,52549,3578763038,3578763085,47
2,1508,52550,3578763103,3578763103,0
2,1508,52551,3578763103,3578763103,0
2,1508,52552,3578763103,3578763103,0
2,1508,52553,3578763103,3578763103,0
2,1508,52554,3578763103,3578763103,0
2,1508,52555,3578763103,3578763103,0
2,1508,52556,3578763103,3578763103,0
2,1508,52557,3578763103,3578763103,0
2,1508,52558,3578763103,3578763103,0
2,1508,52559,3578763103,3578763103,0
2,1508,52560,3578763103,3578763103,0
2,1508,52561,3578763103,3578763103,0
2,1508,52562,3578763103,3578763103,0
2,1508,52563,3578763103,3578763103,0
2,1508,52564,3578763103,3578763103,0
2,1508,52565,3578763103,3578763103,0
2,1508,52566,3578763103,3578763103,0
2,1508,52567,3578763103,3578763103,0
2,1508,52568,3578763103,3578763103,0
2,1508,52569,3578763103,3578763103,0
2,1508,52570,3578763103,3578763103,0
2,1508,52571,3578763103,3578763103,0
2,1508,52572,3578763103,3578763103,0
2,1508,52573,3578763103,3578763103,0
2,1508,52574,3578763103,3578763103,0
2,1508,52575,3578763103,3578763103,0
2,1508,52576,3578763103,3578763103,0
2,1508,52577,3578763103,3578763103,0
2,1508,52578,3578763103,3578763103,0
2,1508,52579,3578763103,3578763104,1
2,1508,52580,3578763103,3578763105,2
2,1508,52581,3578763103,3578763105,2
2,1508,52582,3578763103,3578763106,3
2,1508,52583,3578763103,3578763107,4
2,1508,52584,3578763103,3578763108,5
2,1508,52585,3578763103,3578763109,6
2,1508,52586,3578763103,3578763110,7
2,1508,52587,3578763103,3578763111,8
2,1508,52588,3578763103,3578763111,8
2,1508,52589,3578763103,3578763111,8
2,1508,52590,3578763103,3578763112,9
2,1508,52591,3578763103,3578763112,9
2,1508,52592,3578763103,3578763113,10
2,1508,52593,3578763103,3578763114,11
2,1508,52594,3578763103,3578763115,12
2,1508,52595,3578763103,3578763115,12
2,1508,52596,3578763103,3578763115,12
2,1508,52597,3578763103,3578763115,12
2,1508,52598,3578763103,3578763116,13
2,1508,52599,3578763103,3578763116,13
2,1508,52600,3578763103,3578763117,14
2,1508,52601,3578763103,3578763117,14
2,1508,52602,3578763103,3578763117,14
2,1508,52603,3578763103,3578763117,14
2,1508,52604,3578763103,3578763118,15
2,1508,52605,3578763103,3578763119,16
2,1508,52606,3578763103,3578763121,18
2,1508,52607,3578763103,3578763122,19
2,1508,52608,3578763103,3578763122,19
2,1508,52609,3578763103,3578763124,21
2,1508,52610,3578763103,3578763124,21
2,1508,52611,3578763103,3578763124,21
2,1508,52612,3578763103,3578763125,22
2,1508,52613,3578763103,3578763126,23
2,1508,52614,3578763103,3578763126,23
2,1508,52615,3578763103,3578763126,23
2,1508,52616,3578763103,3578763127,24
2,1508,52617,3578763103,3578763131,28
2,1508,52618,3578763103,3578763131,28
2,1508,52619,3578763103,3578763131,28
2,1508,52620,3578763103,3578763132,29
2,1508,52621,3578763103,3578763133,30
2,1508,52622,3578763103,3578763136,33
2,1508,52623,3578763103,3578763136,33
2,1508,52624,3578763103,3578763137,34
2,1508,52625,3578763103,3578763138,35
2,1508,52626,3578763103,3578763138,35
2,1508,52627,3578763103,3578763138,35
2,1508,52628,3578763103,3578763139,36
2,1508,52629,3578763103,3578763140,37
2,1508,52630,3578763103,3578763140,37
2,1508,52631,3578763103,3578763140,37
2,1508,52632,3578763103,3578763143,40
2,1508,52633,3578763103,3578763143,40
2,1508,52634,3578763103,3578763144,41
2,1508,52635,3578763103,3578763148,45
2,1508,52636,3578763103,3578763148,45
2,1508,52637,3578763103,3578763150,47
2,1508,52638,3578763103,3578763150,47
2,1508,52639,3578763103,3578763150,47
2,1508,52640,3578763103,3578763151,48
2,1508,52641,3578763103,3578763152,49
2,1508,52642,3578763103,3578763152,49
2,1508,52643,3578763103,3578763152,49
2,1508,52644,3578763103,3578763153,50
2,1509,52645,3578763168,3578763168,0
2,1509,52646,3578763168,3578763168,0
2,1509,52647,3578763168,3578763168,0
2,1509,52648,3578763168,3578763168,0
2,1509,52649,3578763168,3578763168,0
2,1509,52650,3578763168,3578763168,0
2,1509,52651,3578763168,3578763168,0
2,1509,52652,3578763168,3578763168,0
2,1509,52653,3578763168,3578763168,0
2,1509,52654,3578763168,3578763168,0
2,1509,52655,3578763168,3578763168,0
2,1509,52656,3578763168,3578763168,0
2,1509,52657,3578763168,3578763168,0
2,1509,52658,3578763168,3578763168,0
2,1509,52659,3578763168,3578763170,2
2,1509,52660,3578763168,3578763170,2
2,1509,52661,3578763168,3578763171,3
2,1509,52662,3578763168,3578763172,4
2,1509,52663,3578763168,3578763172,4
2,1509,52664,3578763168,3578763173,5
2,1509,52665,3578763168,3578763174,6
2,1509,52666,3578763168,3578763175,7
2,1509,52667,3578763168,3578763176,8
2,1509,52668,3578763168,3578763178,10
2,1509,52669,3578763168,3578763178,10
2,1509,52670,3578763168,3578763180,12
2,1509,52671,3578763168,3578763183,15
2,1509,52672,3578763168,3578763184,16
2,1509,52673,3578763168,3578763184,16
2,1509,52674,3578763168,3578763185,17
2,1509,52675,3578763168,3578763185,17
2,1509,52676,3578763168,3578763185,17
2,1509,52677,3578763168,3578763187,19
2,1509,52678,3578763168,3578763188,20
2,1509,52679,3578763168,3578763188,20
2,1509,52680,3578763168,3578763188,20
2,1509,52681,3578763168,3578763189,21
2,1509,52682,3578763168,3578763189,21
2,1509,52683,3578763168,3578763190,22
2,1509,52684,3578763168,3578763190,22
2,1509,52685,3578763168,3578763190,22
2,1509,52686,3578763168,3578763191,23
2,1509,52687,3578763168,3578763191,23
2,1509,52688,3578763168,3578763191,23
2,1509,52689,3578763168,3578763192,24
2,1509,52690,3578763168,3578763194,26
2,1509,52691,3578763168,3578763198,30
2,1509,52692,3578763168,3578763200,32
2,1509,52693,3578763168,3578763201,33
2,1509,52694,3578763168,3578763202,34
2,1509,52695,3578763168,3578763203,35
2,1509,52696,3578763168,3578763203,35
2,1509,52697,3578763168,3578763203,35
2,1509,52698,3578763168,3578763204,36
2,1509,52699,3578763168,3578763205,37
2,1509,52700,3578763168,3578763206,38
2,1509,52701,3578763168,3578763211,43
2,1509,52702,3578763168,3578763212,44
2,1509,52703,3578763168,3578763213,45
2,1509,52704,3578763168,3578763213,45
2,1509,52705,3578763168,3578763214,46
2,1509,52706,3578763168,3578763215,47
2,1509,52707,3578763168,3578763215,47
2,1509,52708,3578763168,3578763216,48
2,1509,52709,3578763168,3578763216,48
2,1509,52710,3578763168,3578763217,49
2,1510,52711,3578763234,3578763234,0
2,1510,52712,3578763234,3578763234,0
2,1510,52713,3578763234,3578763234,0
2,1510,52714,3578763234,3578763234,0
2,1510,52715,3578763234,3578763234,0
2,1510,52716,3578763234,3578763234,0
2,1510,52717,3578763234,3578763234,0
2,1510,52718,3578763234,3578763234,0
2,1510,52719,3578763234,3578763234,0
2,1510,52720,3578763234,3578763234,0
2,1510,52721,3578763234,3578763234,0
2,1510,52722,3578763234,3578763234,0
2,1510,52723,3578763234,3578763234,0
2,1510,52724,3578763234,3578763234,0
2,1510,52725,3578763234,3578763234,0
2,1510,52726,3578763234,3578763234,0
2,1510,52727,3578763234,3578763236,2
2,1510,52728,3578763234,3578763237,3
2,1510,52729,3578763234,3578763237,3
2,1510,52730,3578763234,3578763237,3
2,1510,52731,3578763234,3578763238,4
2,1510,52732,3578763234,3578763238,4
2,1510,52733,3578763234,3578763239,5
2,1510,52734,3578763234,3578763240,6
2,1510,52735,3578763234,3578763241,7
2,1510,52736,3578763234,3578763241,7
2,1510,52737,3578763234,3578763241,7
2,1510,52738,3578763234,3578763242,8
2,1510,52739,3578763234,3578763243,9
2,1510,52740,3578763234,3578763245,11
2,1510,52741,3578763234,3578763245,11
2,1510,52742,3578763234,3578763246,12
2,1510,52743,3578763234,3578763246,12
2,1510,52744,3578763234,3578763246,12
2,1510,52745,3578763234,3578763246,12
2,1510,52746,3578763234,3578763246,12
2,1510,52747,3578763234,3578763248,14
2,1510,52748,3578763234,3578763249,15
2,1510,52749,3578763234,3578763250,16
2,1510,52750,3578763234,3578763251,17
2,1510,52751,3578763234,3578763251,17
2,1510,52752,3578763234,3578763251,17
2,1510,52753,3578763234,3578763252,18
2,1510,52754,3578763234,3578763253,19
2,1510,52755,3578763234,3578763254,20
2,1510,52756,3578763234,3578763254,20
2,1510,52757,3578763234,3578763255,21
2,1510,52758,3578763234,3578763255,21
2,1510,52759,3578763234,3578763256,22
2,1510,52760,3578763234,3578763257,23
2,1510,52761,3578763234,3578763258,24
2,1510,52762,3578763234,3578763260,26
2,1510,52763,3578763234,3578763261,27
2,1510,52764,3578763234,3578763263,29
2,1510,52765,3578763234,3578763264,30
2,1510,52766,3578763234,3578763265,31
2,1510,52767,3578763234,3578763266,32
2,1510,52768,3578763234,3578763268,34
2,1510,52769,3578763234,3578763268,34
2,1510,52770,3578763234,3578763270,36
2,1510,52771,3578763234,3578763271,37
2,1510,52772,3578763234,3578763280,46
2,1511,52773,3578763298,3578763298,0
2,1511,52774,3578763298,3578763298,0
2,1511,52775,3578763298,3578763298,0
2,1511,52776,3578763298,3578763298,0
2,1511,52777,3578763298,3578763298,0
2,1511,52778,3578763298,3578763298,0
2,1511,52779,3578763298,3578763298,0
2,1511,52780,3578763298,3578763298,0
2,1511,52781,3578763298,3578763298,0
2,1511,52782,3578763298,3578763298,0
2,1511,52783,3578763298,3578763298,0
2,1511,52784,3578763298,3578763298,0
2,1511,52785,3578763298,3578763298,0
2,1511,52786,3578763298,3578763298,0
2,1511,52787,3578763298,3578763298,0
2,1511,52788,3578763298,3578763298,0
2,1511,52789,3578763298,3578763298,0
2,1511,52790,3578763298,3578763298,0
2,1511,52791,3578763298,3578763298,0
2,1511,52792,3578763298,3578763298,0
2,1511,52793,3578763298,3578763299,1
2,1511,52794,3578763298,3578763299,1
2,1511,52795,3578763298,3578763300,2
2,1511,52796,3578763298,3578763300,2
2,1511,52797,3578763298,3578763300,2
2,1511,52798,3578763298,3578763301,3
2,1511,52799,3578763298,3578763301,3
2,1511,52800,3578763298,3578763302,4
2,1511,52801,3578763298,3578763302,4
2,1511,52802,3578763298,3578763302,4
2,1511,52803,3578763298,3578763303,5
2,1511,52804,3578763298,3578763303,5
2,1511,52805,3578763298,3578763305,7
2,1511,52806,3578763298,3578763306,8
2,1511,52807,3578763298,3578763306,8
2,1511,52808,3578763298,3578763307,9
2,1511,52809,3578763298,3578763309,11
2,1511,52810,3578763298,3578763309,11
2,1511,52811,3578763298,3578763310,12
2,1511,52812,3578763298,3578763311,13
2,1511,52813,3578763298,3578763311,13
2,1511,52814,3578763298,3578763312,14
2,1511,52815,3578763298,3578763312,14
2,1511,52816,3578763298,3578763313,15
2,1511,52817,3578763298,3578763314,16
2,1511,52818,3578763298,3578763314,16
2,1511,52819,3578763298,3578763315,17
2,1511,52820,3578763298,3578763315,17
2,1511,52821,3578763298,3578763316,18
2,1511,52822,3578763298,3578763316,18
2,1511,52823,3578763298,3578763316,18
2,1511,52824,3578763298,3578763316,18
2,1511,52825,3578763298,3578763316,18
2,1511,52826,3578763298,3578763316,18
2,1511,52827,3578763298,3578763317,19
2,1511,52828,3578763298,3578763318,20
2,1511,52829,3578763298,3578763318,20
2,1511,52830,3578763298,3578763318,20
2,1511,52831,3578763298,3578763319,21
2,1511,52832,3578763298,3578763320,22
2,1511,52833,3578763298,3578763322,24
2,1511,52834,3578763298,3578763322,24
2,1511,52835,3578763298,3578763323,25
2,1511,52836,3578763298,3578763323,25
2,1511,52837,3578763298,3578763323,25
2,1511,52838,3578763298,3578763325,27
2,1511,52839,3578763298,3578763326,28
2,1511,52840,3578763298,3578763326,28
2,1511,52841,3578763298,3578763327,29
2,1511,52842,3578763298,3578763327,29
2,1511,52843,3578763298,3578763328,30
2,1511,52844,3578763298,3578763331,33
2,1511,52845,3578763298,3578763331,33
2,1511,52846,3578763298,3578763331,33
2,1511,52847,3578763298,3578763333,35
2,1511,52848,3578763298,3578763333,35
2,1511,52849,3578763298,3578763335,37
2,1511,52850,3578763298,3578763335,37
2,1511,52851,3578763298,3578763335,37
2,1511,52852,3578763298,3578763337,39
2,1511,52853,3578763298,3578763337,39
2,1511,52854,3578763298,3578763338,40
2,1511,52855,3578763298,3578763338,40
2,1511,52856,3578763298,3578763339,41
2,1511,52857,3578763298,3578763339,41
2,1511,52858,3578763298,3578763340,42
2,1511,52859,3578763298,3578763341,43
2,1511,52860,3578763298,3578763343,45
2,1511,52861,3578763298,3578763343,45
2,1511,52862,3578763298,3578763346,48
2,1511,52863,3578763298,3578763347,49
2,1511,52864,3578763298,3578763348,50
2,1512,52865,3578763362,3578763362,0
2,1512,52866,3578763362,3578763362,0
2,1512,52867,3578763362,3578763362,0
2,1512,52868,3578763362,3578763362,0
2,1512,52869,3578763362,3578763362,0
2,1512,52870,3578763362,3578763362,0
2,1512,52871,3578763362,3578763362,0
2,1512,52872,3578763362,3578763362,0
2,1512,52873,3578763362,3578763362,0
2,1512,52874,3578763362,3578763362,0
2,1512,52875,3578763362,3578763362,0
2,1512,52876,3578763362,3578763362,0
2,1512,52877,3578763362,3578763362,0
2,1512,52878,3578763362,3578763362,0
2,1512,52879,3578763362,3578763362,0
2,1512,52880,3578763362,3578763363,1
2,1512,52881,3578763362,3578763364,2
2,1512,52882,3578763362,3578763364,2
2,1512,52883,3578763362,3578763364,2
2,1512,52884,3578763362,3578763365,3
2,1512,52885,3578763362,3578763365,3
2,1512,52886,3578763362,3578763366,4
2,1512,52887,3578763362,3578763366,4
2,1512,52888,3578763362,3578763366,4
2,1512,52889,3578763362,3578763370,8
2,1512,52890,3578763362,3578763370,8
2,1512,52891,3578763362,3578763371,9
2,1512,52892,3578763362,3578763371,9
2,1512,52893,3578763362,3578763372,10
2,1512,52894,3578763362,3578763372,10
2,1512,52895,3578763362,3578763374,12
2,1512,52896,3578763362,3578763374,12
2,1512,52897,3578763362,3578763376,14
2,1512,52898,3578763362,3578763376,14
2,1512,52899,3578763362,3578763378,16
2,1512,52900,3578763362,3578763379,17
2,1512,52901,3578763362,3578763381,19
2,1512,52902,3578763362,3578763384,22
2,1512,52903,3578763362,3578763384,22
2,1512,52904,3578763362,3578763384,22
2,1512,52905,3578763362,3578763385,23
2,1512,52906,3578763362,3578763385,23
2,1512,52907,3578763362,3578763387,25
2,1512,52908,3578763362,3578763388,26
2,1512,52909,3578763362,3578763389,27
2,1512,52910,3578763362,3578763389,27
2,1512,52911,3578763362,3578763389,27
2,1512,52912,3578763362,3578763390,28
2,1512,52913,3578763362,3578763390,28
2,1512,52914,3578763362,3578763391,29
2,1512,52915,3578763362,3578763391,29
2,1512,52916,3578763362,3578763391,29
2,1512,52917,3578763362,3578763391,29
2,1512,52918,3578763362,3578763393,31
2,1512,52919,3578763362,3578763394,32
2,1512,52920,3578763362,3578763398,36
2,1512,52921,3578763362,3578763398,36
2,1512,52922,3578763362,3578763400,38
2,1512,52923,3578763362,3578763401,39
2,1512,52924,3578763362,3578763402,40
2,1512,52925,3578763362,3578763402,40
2,1512,52926,3578763362,3578763403,41
2,1512,52927,3578763362,3578763404,42
2,1512,52928,3578763362,3578763405,43
2,1512,52929,3578763362,3578763405,43
2,1512,52930,3578763362,3578763405,43
2,1512,52931,3578763362,3578763406,44
2,1512,52932,3578763362,3578763407,45
2,1512,52933,3578763362,3578763409,47
2,1512,52934,3578763362,3578763411,49
2,1512,52935,3578763362,3578763412,50
2,1513,52936,3578763425,3578763425,0
2,1513,52937,3578763425,3578763425,0
2,1513,52938,3578763425,3578763425,0
2,1513,52939,3578763425,3578763426,1
2,1513,52940,3578763425,3578763426,1
2,1513,52941,3578763425,3578763426,1
2,1513,52942,3578763425,3578763426,1
2,1513,52943,3578763425,3578763426,1
2,1513,52944,3578763425,3578763426,1
2,1513,52945,3578763425,3578763426,1
2,1513,52946,3578763425,3578763426,1
2,1513,52947,3578763425,3578763426,1
2,1513,52948,3578763425,3578763426,1
2,1513,52949,3578763425,3578763426,1
2,1513,52950,3578763425,3578763426,1
2,1513,52951,3578763425,3578763426,1
2,1513,52952,3578763425,3578763426,1
2,1513,52953,3578763425,3578763429,4
2,1513,52954,3578763425,3578763429,4
2,1513,52955,3578763425,3578763429,4
2,1513,52956,3578763425,3578763430,5
2,1513,52957,3578763425,3578763430,5
2,1513,52958,3578763425,3578763432,7
2,1513,52959,3578763425,3578763432,7
2,1513,52960,3578763425,3578763433,8
2,1513,52961,3578763425,3578763434,9
2,1513,52962,3578763425,3578763434,9
2,1513,52963,3578763425,3578763436,11
2,1513,52964,3578763425,3578763437,12
2,1513,52965,3578763425,3578763437,12
2,1513,52966,3578763425,3578763438,13
2,1513,52967,3578763425,3578763438,13
2,1513,52968,3578763425,3578763438,13
2,1513,52969,3578763425,3578763439,14
2,1513,52970,3578763425,3578763439,14
2,1513,52971,3578763425,3578763440,15
2,1513,52972,3578763425,3578763440,15
2,1513,52973,3578763425,3578763441,16
2,1513,52974,3578763425,3578763441,16
2,1513,52975,3578763425,3578763442,17
2,1513,52976,3578763425,3578763442,17
2,1513,52977,3578763425,3578763442,17
2,1513,52978,3578763425,3578763443,18
2,1513,52979,3578763425,3578763443,18
2,1513,52980,3578763425,3578763445,20
2,1513,52981,3578763425,3578763445,20
2,1513,52982,3578763425,3578763446,21
2,1513,52983,3578763425,3578763446,21
2,1513,52984,3578763425,3578763446,21
2,1513,52985,3578763425,3578763447,22
2,1513,52986,3578763425,3578763447,22
2,1513,52987,3578763425,3578763448,23
2,1513,52988,3578763425,3578763449,24
2,1513,52989,3578763425,3578763449,24
2,1513,52990,3578763425,3578763451,26
2,1513,52991,3578763425,3578763451,26
2,1513,52992,3578763425,3578763451,26
2,1513,52993,3578763425,3578763452,27
2,1513,52994,3578763425,3578763453,28
2,1513,52995,3578763425,3578763453,28
2,1513,52996,3578763425,3578763453,28
2,1513,52997,3578763425,3578763454,29
2,1513,52998,3578763425,3578763455,30
2,1513,52999,3578763425,3578763455,30
2,1513,53000,3578763425,3578763456,31
2,1513,53001,3578763425,3578763458,33
2,1513,53002,3578763425,3578763458,33
2,1513,53003,3578763425,3578763460,35
2,1513,53004,3578763425,3578763460,35
2,1513,53005,3578763425,3578763463,38
2,1513,53006,3578763425,3578763464,39
2,1513,53007,3578763425,3578763465,40
2,1513,53008,3578763425,3578763465,40
2,1513,53009,3578763425,3578763466,41
2,1513,53010,3578763425,3578763467,42
2,1513,53011,3578763425,3578763470,45
2,1513,53012,3578763425,3578763471,46
2,1514,53013,3578763490,3578763490,0
2,1514,53014,3578763490,3578763490,0
2,1514,53015,3578763490,3578763490,0
2,1514,53016,3578763490,3578763490,0
2,1514,53017,3578763490,3578763490,0
2,1514,53018,3578763490,3578763490,0
2,1514,53019,3578763490,3578763490,0
2,1514,53020,3578763490,3578763490,0
2,1514,53021,3578763490,3578763490,0
2,1514,53022,3578763490,3578763492,2
2,1514,53023,3578763490,3578763493,3
2,1514,53024,3578763490,3578763493,3
2,1514,53025,3578763490,3578763494,4
2,1514,53026,3578763490,3578763494,4
2,1514,53027,3578763490,3578763495,5
2,1514,53028,3578763490,3578763496,6
2,1514,53029,3578763490,3578763497,7
2,1514,53030,3578763490,3578763497,7
2,1514,53031,3578763490,3578763498,8
2,1514,53032,3578763490,3578763499,9
2,1514,53033,3578763490,3578763499,9
2,1514,53034,3578763490,3578763499,9
2,1514,53035,3578763490,3578763500,10
2,1514,53036,3578763490,3578763500,10
2,1514,53037,3578763490,3578763500,10
2,1514,53038,3578763490,3578763501,11
2,1514,53039,3578763490,3578763501,11
2,1514,53040,3578763490,3578763501,11
2,1514,53041,3578763490,3578763501,11
2,1514,53042,3578763490,3578763502,12
2,1514,53043,3578763490,3578763502,12
2,1514,53044,3578763490,3578763505,15
2,1514,53045,3578763490,3578763505,15
2,1514,53046,3578763490,3578763505,15
2,1514,53047,3578763490,3578763507,17
2,1514,53048,3578763490,3578763508,18
2,1514,53049,3578763490,3578763509,19
2,1514,53050,3578763490,3578763509,19
2,1514,53051,3578763490,3578763510,20
2,1514,53052,3578763490,3578763510,20
2,1514,53053,3578763490,3578763511,21
2,1514,53054,3578763490,3578763512,22
2,1514,53055,3578763490,3578763512,22
2,1514,53056,3578763490,3578763513,23
2,1514,53057,3578763490,3578763513,23
2,1514,53058,3578763490,3578763515,25
2,1514,53059,3578763490,3578763515,25
2,1514,53060,3578763490,3578763515,25
2,1514,53061,3578763490,3578763515,25
2,1514,53062,3578763490,3578763516,26
2,1514,53063,3578763490,3578763517,27
2,1514,53064,3578763490,3578763517,27
2,1514,53065,3578763490,3578763517,27
2,1514,53066,3578763490,3578763518,28
2,1514,53067,3578763490,3578763518,28
2,1514,53068,3578763490,3578763520,30
2,1514,53069,3578763490,3578763521,31
2,1514,53070,3578763490,3578763522,32
2,1514,53071,3578763490,3578763522,32
2,1514,53072,3578763490,3578763523,33
2,1514,53073,3578763490,3578763523,33
2,1514,53074,3578763490,3578763524,34
2,1514,53075,3578763490,3578763525,35
2,1514,53076,3578763490,3578763525,35
2,1514,53077,3578763490,3578763526,36
2,1514,53078,3578763490,3578763527,37
2,1514,53079,3578763490,3578763529,39
2,1514,53080,3578763490,3578763531,41
2,1514,53081,3578763490,3578763532,42
2,1514,53082,3578763490,3578763532,42
2,1514,53083,3578763490,3578763534,44
2,1514,53084,3578763490,3578763534,44
2,1514,53085,3578763490,3578763535,45
2,1514,53086,3578763490,3578763537,47
2,1514,53087,3578763490,3578763537,47
2,1514,53088,3578763490,3578763537,47
2,1514,53089,3578763490,3578763538,48
2,1514,53090,3578763490,3578763539,49
2,1514,53091,3578763490,3578763539,49
2,1514,53092,3578763490,3578763540,50
2,1515,53093,3578763555,3578763555,0
2,1515,53094,3578763555,3578763555,0
2,1515,53095,3578763555,3578763555,0
2,1515,53096,3578763555,3578763555,0
2,1515,53097,3578763555,3578763555,0
2,1515,53098,3578763555,3578763555,0
2,1515,53099,3578763555,3578763555,0
2,1515,53100,3578763555,3578763555,0
2,1515,53101,3578763555,3578763555,0
2,1515,53102,3578763555,3578763555,0
2,1515,53103,3578763555,3578763555,0
2,1515,53104,3578763555,3578763555,0
2,1515,53105,3578763555,3578763555,0
2,1515,53106,3578763555,3578763555,0
2,1515,53107,3578763555,3578763557,2
2,1515,53108,3578763555,3578763557,2
2,1515,53109,3578763555,3578763558,3
2,1515,53110,3578763555,3578763562,7
2,1515,53111,3578763555,3578763562,7
2,1515,53112,3578763555,3578763563,8
2,1515,53113,3578763555,3578763564,9
2,1515,53114,3578763555,3578763564,9
2,1515,53115,3578763555,3578763564,9
2,1515,53116,3578763555,3578763565,10
2,1515,53117,3578763555,3578763565,10
2,1515,53118,3578763555,3578763565,10
2,1515,53119,3578763555,3578763569,14
2,1515,53120,3578763555,3578763569,14
2,1515,53121,3578763555,3578763569,14
2,1515,53122,3578763555,3578763570,15
2,1515,53123,3578763555,3578763572,17
2,1515,53124,3578763555,3578763573,18
2,1515,53125,3578763555,3578763575,20
2,1515,53126,3578763555,3578763575,20
2,1515,53127,3578763555,3578763578,23
2,1515,53128,3578763555,3578763578,23
2,1515,53129,3578763555,3578763580,25
2,1515,53130,3578763555,3578763583,28
2,1515,53131,3578763555,3578763583,28
2,1515,53132,3578763555,3578763584,29
2,1515,53133,3578763555,3578763585,30
2,1515,53134,3578763555,3578763587,32
2,1515,53135,3578763555,3578763587,32
2,1515,53136,3578763555,3578763587,32
2,1515,53137,3578763555,3578763588,33
2,1515,53138,3578763555,3578763589,34
2,1515,53139,3578763555,3578763589,34
2,1515,53140,3578763555,3578763589,34
2,1515,53141,3578763555,3578763590,35
2,1515,53142,3578763555,3578763590,35
2,1515,53143,3578763555,3578763590,35
2,1515,53144,3578763555,3578763590,35
2,1515,53145,3578763555,3578763593,38
2,1515,53146,3578763555,3578763594,39
2,1515,53147,3578763555,3578763597,42
2,1515,53148,3578763555,3578763597,42
2,1515,53149,3578763555,3578763599,44
2,1515,53150,3578763555,3578763600,45
2,1515,53151,3578763555,3578763601,46
2,1515,53152,3578763555,3578763602,47
2,1515,53153,3578763555,3578763603,48
2,1515,53154,3578763555,3578763604,49
2,1515,53155,3578763555,3578763604,49
2,1515,53156,3578763555,3578763604,49
2,1515,53157,3578763555,3578763604,49
2,1516,53158,3578763619,3578763619,0
2,1516,53159,3578763619,3578763619,0
2,1516,53160,3578763619,3578763619,0
2,1516,53161,3578763619,3578763619,0
2,1516,53162,3578763619,3578763619,0
2,1516,53163,3578763619,3578763619,0
2,1516,53164,3578763619,3578763619,0
2,1516,53165,3578763619,3578763619,0
2,1516,53166,3578763619,3578763619,0
2,1516,53167,3578763619,3578763619,0
2,1516,53168,3578763619,3578763619,0
2,1516,53169,3578763619,3578763619,0
2,1516,53170,3578763619,3578763619,0
2,1516,53171,3578763619,3578763619,0
2,1516,53172,3578763619,3578763620,1
2,1516,53173,3578763619,3578763620,1
2,1516,53174,3578763619,3578763620,1
2,1516,53175,3578763619,3578763621,2
2,1516,53176,3578763619,3578763621,2
2,1516,53177,3578763619,3578763623,4
2,1516,53178,3578763619,3578763624,5
2,1516,53179,3578763619,3578763624,5
2,1516,53180,3578763619,3578763626,7
2,1516,53181,3578763619,3578763628,9
2,1516,53182,3578763619,3578763629,10
2,1516,53183,3578763619,3578763629,10
2,1516,53184,3578763619,3578763629,10
2,1516,53185,3578763619,3578763630,11
2,1516,53186,3578763619,3578763631,12
2,1516,53187,3578763619,3578763631,12
2,1516,53188,3578763619,3578763633,14
2,1516,53189,3578763619,3578763633,14
2,1516,53190,3578763619,3578763633,14
2,1516,53191,3578763619,3578763634,15
2,1516,53192,3578763619,3578763635,16
2,1516,53193,3578763619,3578763636,17
2,1516,53194,3578763619,3578763636,17
2,1516,53195,3578763619,3578763637,18
2,1516,53196,3578763619,3578763637,18
2,1516,53197,3578763619,3578763638,19
2,1516,53198,3578763619,3578763638,19
2,1516,53199,3578763619,3578763638,19
2,1516,53200,3578763619,3578763638,19
2,1516,53201,3578763619,3578763639,20
2,1516,53202,3578763619,3578763640,21
2,1516,53203,3578763619,3578763640,21
2,1516,53204,3578763619,3578763641,22
2,1516,53205,3578763619,3578763641,22
2,1516,53206,3578763619,3578763642,23
2,1516,53207,3578763619,3578763642,23
2,1516,53208,3578763619,3578763643,24
2,1516,53209,3578763619,3578763643,24
2,1516,53210,3578763619,3578763644,25
2,1516,53211,3578763619,3578763645,26
2,1516,53212,3578763619,3578763645,26
2,1516,53213,3578763619,3578763646,27
2,1516,53214,3578763619,3578763646,27
2,1516,53215,3578763619,3578763646,27
2,1516,53216,3578763619,3578763647,28
2,1516,53217,3578763619,3578763648,29
2,1516,53218,3578763619,3578763649,30
2,1516,53219,3578763619,3578763650,31
2,1516,53220,3578763619,3578763650,31
2,1516,53221,3578763619,3578763650,31
2,1516,53222,3578763619,3578763651,32
2,1516,53223,3578763619,3578763652,33
2,1516,53224,3578763619,3578763652,33
2,1516,53225,3578763619,3578763653,34
2,1516,53226,3578763619,3578763653,34
2,1516,53227,3578763619,3578763654,35
2,1516,53228,3578763619,3578763655,36
2,1516,53229,3578763619,3578763655,36
2,1516,53230,3578763619,3578763656,37
2,1516,53231,3578763619,3578763657,38
2,1516,53232,3578763619,3578763659,40
2,1516,53233,3578763619,3578763660,41
2,1516,53234,3578763619,3578763662,43
2,1516,53235,3578763619,3578763663,44
2,1516,53236,3578763619,3578763664,45
2,1516,53237,3578763619,3578763664,45
2,1516,53238,3578763619,3578763665,46
2,1516,53239,3578763619,3578763665,46
2,1516,53240,3578763619,3578763667,48
2,1516,53241,3578763619,3578763667,48
2,1516,53242,3578763619,3578763669,50
2,1517,53243,3578763683,3578763683,0
2,1517,53244,3578763683,3578763683,0
2,1517,53245,3578763683,3578763684,1
2,1517,53246,3578763683,3578763685,2
2,1517,53247,3578763683,3578763688,5
2,1517,53248,3578763683,3578763690,7
2,1517,53249,3578763683,3578763690,7
2,1517,53250,3578763683,3578763690,7
2,1517,53251,3578763683,3578763692,9
2,1517,53252,3578763683,3578763693,10
2,1517,53253,3578763683,3578763694,11
2,1517,53254,3578763683,3578763694,11
2,1517,53255,3578763683,3578763695,12
2,1517,53256,3578763683,3578763696,13
2,1517,53257,3578763683,3578763697,14
2,1517,53258,3578763683,3578763698,15
2,1517,53259,3578763683,3578763698,15
2,1517,53260,3578763683,3578763699,16
2,1517,53261,3578763683,3578763699,16
2,1517,53262,3578763683,3578763699,16
2,1517,53263,3578763683,3578763700,17
2,1517,53264,3578763683,3578763701,18
2,1517,53265,3578763683,3578763701,18
2,1517,53266,3578763683,3578763701,18
2,1517,53267,3578763683,3578763701,18
2,1517,53268,3578763683,3578763701,18
2,1517,53269,3578763683,3578763702,19
2,1517,53270,3578763683,3578763705,22
2,1517,53271,3578763683,3578763706,23
2,1517,53272,3578763683,3578763706,23
2,1517,53273,3578763683,3578763707,24
2,1517,53274,3578763683,3578763708,25
2,1517,53275,3578763683,3578763709,26
2,1517,53276,3578763683,3578763710,27
2,1517,53277,3578763683,3578763710,27
2,1517,53278,3578763683,3578763711,28
2,1517,53279,3578763683,3578763712,29
2,1517,53280,3578763683,3578763712,29
2,1517,53281,3578763683,3578763713,30
2,1517,53282,3578763683,3578763713,30
2,1517,53283,3578763683,3578763714,31
2,1517,53284,3578763683,3578763715,32
2,1517,53285,3578763683,3578763715,32
2,1517,53286,3578763683,3578763715,32
2,1517,53287,3578763683,3578763716,33
2,1517,53288,3578763683,3578763716,33
2,1517,53289,3578763683,3578763716,33
2,1517,53290,3578763683,3578763716,33
2,1517,53291,3578763683,3578763717,34
2,1517,53292,3578763683,3578763718,35
2,1517,53293,3578763683,3578763718,35
2,1517,53294,3578763683,3578763720,37
2,1517,53295,3578763683,3578763721,38
2,1517,53296,3578763683,3578763722,39
2,1517,53297,3578763683,3578763722,39
2,1517,53298,3578763683,3578763723,40
2,1517,53299,3578763683,3578763723,40
2,1517,53300,3578763683,3578763725,42
2,1517,53301,3578763683,3578763725,42
2,1517,53302,3578763683,3578763726,43
2,1517,53303,3578763683,3578763726,43
2,1517,53304,3578763683,3578763727,44
2,1517,53305,3578763683,3578763730,47
2,1517,53306,3578763683,3578763731,48
2,1517,53307,3578763683,3578763733,50
2,1518,53308,3578763747,3578763747,0
2,1518,53309,3578763747,3578763747,0
2,1518,53310,3578763747,3578763747,0
2,1518,53311,3578763747,3578763747,0
2,1518,53312,3578763747,3578763747,0
2,1518,53313,3578763747,3578763747,0
2,1518,53314,3578763747,3578763747,0
2,1518,53315,3578763747,3578763747,0
2,1518,53316,3578763747,3578763747,0
2,1518,53317,3578763747,3578763747,0
2,1518,53318,3578763747,3578763747,0
2,1518,53319,3578763747,3578763747,0
2,1518,53320,3578763747,3578763747,0
2,1518,53321,3578763747,3578763747,0
2,1518,53322,3578763747,3578763748,1
2,1518,53323,3578763747,3578763748,1
2,1518,53324,3578763747,3578763749,2
2,1518,53325,3578763747,3578763750,3
2,1518,53326,3578763747,3578763750,3
2,1518,53327,3578763747,3578763751,4
2,1518,53328,3578763747,3578763753,6
2,1518,53329,3578763747,3578763753,6
2,1518,53330,3578763747,3578763754,7
2,1518,53331,3578763747,3578763755,8
2,1518,53332,3578763747,3578763757,10
2,1518,53333,3578763747,3578763757,10
2,1518,53334,3578763747,3578763757,10
2,1518,53335,3578763747,3578763762,15
2,1518,53336,3578763747,3578763763,16
2,1518,53337,3578763747,3578763763,16
2,1518,53338,3578763747,3578763764,17
2,1518,53339,3578763747,3578763764,17
2,1518,53340,3578763747,3578763764,17
2,1518,53341,3578763747,3578763765,18
2,1518,53342,3578763747,3578763765,18
2,1518,53343,3578763747,3578763770,23
2,1518,53344,3578763747,3578763770,23
2,1518,53345,3578763747,3578763770,23
2,1518,53346,3578763747,3578763770,23
2,1518,53347,3578763747,3578763771,24
2,1518,53348,3578763747,3578763772,25
2,1518,53349,3578763747,3578763773,26
2,1518,53350,3578763747,3578763774,27
2,1518,53351,3578763747,3578763776,29
2,1518,53352,3578763747,3578763778,31
2,1518,53353,3578763747,3578763780,33
2,1518,53354,3578763747,3578763783,36
2,1518,53355,3578763747,3578763784,37
2,1518,53356,3578763747,3578763784,37
2,1518,53357,3578763747,3578763785,38
2,1518,53358,3578763747,3578763786,39
2,1518,53359,3578763747,3578763787,40
2,1518,53360,3578763747,3578763787,40
2,1518,53361,3578763747,3578763787,40
2,1518,53362,3578763747,3578763788,41
2,1518,53363,3578763747,3578763788,41
2,1518,53364,3578763747,3578763788,41
2,1518,53365,3578763747,3578763788,41
2,1518,53366,3578763747,3578763789,42
2,1518,53367,3578763747,3578763790,43
2,1518,53368,3578763747,3578763790,43
2,1518,53369,3578763747,3578763790,43
2,1518,53370,3578763747,3578763791,44
2,1518,53371,3578763747,3578763791,44
2,1518,53372,3578763747,3578763793,46
2,1518,53373,3578763747,3578763794,47
2,1518,53374,3578763747,3578763797,50
2,1519,53375,3578763812,3578763812,0
2,1519,53376,3578763812,3578763812,0
2,1519,53377,3578763812,3578763812,0
2,1519,53378,3578763812,3578763812,0
2,1519,53379,3578763812,3578763812,0
2,1519,53380,3578763812,3578763812,0
2,1519,53381,3578763812,3578763812,0
2,1519,53382,3578763812,3578763812,0
2,1519,53383,3578763812,3578763812,0
2,1519,53384,3578763812,3578763812,0
2,1519,53385,3578763812,3578763812,0
2,1519,53386,3578763812,3578763812,0
2,1519,53387,3578763812,3578763812,0
2,1519,53388,3578763812,3578763812,0
2,1519,53389,3578763812,3578763812,0
2,1519,53390,3578763812,3578763812,0
2,1519,53391,3578763812,3578763813,1
2,1519,53392,3578763812,3578763813,1
2,1519,53393,3578763812,3578763815,3
2,1519,53394,3578763812,3578763815,3
2,1519,53395,3578763812,3578763816,4
2,1519,53396,3578763812,3578763816,4
2,1519,53397,3578763812,3578763817,5
2,1519,53398,3578763812,3578763820,8
2,1519,53399,3578763812,3578763820,8
2,1519,53400,3578763812,3578763820,8
2,1519,53401,3578763812,3578763821,9
2,1519,53402,3578763812,3578763822,10
2,1519,53403,3578763812,3578763823,11
2,1519,53404,3578763812,3578763823,11
2,1519,53405,3578763812,3578763826,14
2,1519,53406,3578763812,3578763829,17
2,1519,53407,3578763812,3578763829,17
2,1519,53408,3578763812,3578763830,18
2,1519,53409,3578763812,3578763830,18
2,1519,53410,3578763812,3578763831,19
2,1519,53411,3578763812,3578763832,20
2,1519,53412,3578763812,3578763832,20
2,1519,53413,3578763812,3578763833,21
2,1519,53414,3578763812,3578763834,22
2,1519,53415,3578763812,3578763836,24
2,1519,53416,3578763812,3578763836,24
2,1519,53417,3578763812,3578763837,25
2,1519,53418,3578763812,3578763837,25
2,1519,53419,3578763812,3578763838,26
2,1519,53420,3578763812,3578763838,26
2,1519,53421,3578763812,3578763838,26
2,1519,53422,3578763812,3578763839,27
2,1519,53423,3578763812,3578763839,27
2,1519,53424,3578763812,3578763840,28
2,1519,53425,3578763812,3578763840,28
2,1519,53426,3578763812,3578763841,29
2,1519,53427,3578763812,3578763842,30
2,1519,53428,3578763812,3578763842,30
2,1519,53429,3578763812,3578763843,31
2,1519,53430,3578763812,3578763843,31
2,1519,53431,3578763812,3578763843,31
2,1519,53432,3578763812,3578763844,32
2,1519,53433,3578763812,3578763845,33
2,1519,53434,3578763812,3578763845,33
2,1519,53435,3578763812,3578763846,34
2,1519,53436,3578763812,3578763846,34
2,1519,53437,3578763812,3578763847,35
2,1519,53438,3578763812,3578763848,36
2,1519,53439,3578763812,3578763848,36
2,1519,53440,3578763812,3578763849,37
2,1519,53441,3578763812,3578763849,37
2,1519,53442,3578763812,3578763850,38
2,1519,53443,3578763812,3578763850,38
2,1519,53444,3578763812,3578763851,39
2,1519,53445,3578763812,3578763853,41
2,1519,53446,3578763812,3578763853,41
2,1519,53447,3578763812,3578763853,41
2,1519,53448,3578763812,3578763854,42
2,1519,53449,3578763812,3578763854,42
2,1519,53450,3578763812,3578763854,42
2,1519,53451,3578763812,3578763855,43
2,1519,53452,3578763812,3578763855,43
2,1519,53453,3578763812,3578763859,47
2,1519,53454,3578763812,3578763859,47
2,1519,53455,3578763812,3578763861,49
2,1519,53456,3578763812,3578763861,49
2,1520,53457,3578763876,3578763876,0
2,1520,53458,3578763876,3578763876,0
2,1520,53459,3578763876,3578763876,0
2,1520,53460,3578763876,3578763876,0
2,1520,53461,3578763876,3578763876,0
2,1520,53462,3578763876,3578763876,0
2,1520,53463,3578763876,3578763876,0
2,1520,53464,3578763876,3578763876,0
2,1520,53465,3578763876,3578763877,1
2,1520,53466,3578763876,3578763885,9
2,1520,53467,3578763876,3578763886,10
2,1520,53468,3578763876,3578763888,12
2,1520,53469,3578763876,3578763889,13
2,1520,53470,3578763876,3578763890,14
2,1520,53471,3578763876,3578763890,14
2,1520,53472,3578763876,3578763891,15
2,1520,53473,3578763876,3578763892,16
2,1520,53474,3578763876,3578763893,17
2,1520,53475,3578763876,3578763894,18
2,1520,53476,3578763876,3578763894,18
2,1520,53477,3578763876,3578763894,18
2,1520,53478,3578763876,3578763896,20
2,1520,53479,3578763876,3578763897,21
2,1520,53480,3578763876,3578763897,21
2,1520,53481,3578763876,3578763898,22
2,1520,53482,3578763876,3578763899,23
2,1520,53483,3578763876,3578763899,23
2,1520,53484,3578763876,3578763899,23
2,1520,53485,3578763876,3578763899,23
2,1520,53486,3578763876,3578763900,24
2,1520,53487,3578763876,3578763900,24
2,1520,53488,3578763876,3578763902,26
2,1520,53489,3578763876,3578763902,26
2,1520,53490,3578763876,3578763902,26
2,1520,53491,3578763876,3578763903,27
2,1520,53492,3578763876,3578763905,29
2,1520,53493,3578763876,3578763906,30
2,1520,53494,3578763876,3578763907,31
2,1520,53495,3578763876,3578763909,33
2,1520,53496,3578763876,3578763910,34
2,1520,53497,3578763876,3578763910,34
2,1520,53498,3578763876,3578763911,35
2,1520,53499,3578763876,3578763912,36
2,1520,53500,3578763876,3578763913,37
2,1520,53501,3578763876,3578763913,37
2,1520,53502,3578763876,3578763914,38
2,1520,53503,3578763876,3578763915,39
2,1520,53504,3578763876,3578763915,39
2,1520,53505,3578763876,3578763915,39
2,1520,53506,3578763876,3578763916,40
2,1520,53507,3578763876,3578763916,40
2,1520,53508,3578763876,3578763917,41
2,1520,53509,3578763876,3578763917,41
2,1520,53510,3578763876,3578763917,41
2,1520,53511,3578763876,3578763917,41
2,1520,53512,3578763876,3578763918,42
2,1520,53513,3578763876,3578763920,44
2,1520,53514,3578763876,3578763921,45
2,1520,53515,3578763876,3578763922,46
2,1520,53516,3578763876,3578763922,46
2,1520,53517,3578763876,3578763923,47
2,1520,53518,3578763876,3578763925,49
2,1520,53519,3578763876,3578763925,49
2,1520,53520,3578763876,3578763926,50
2,1521,53521,3578763940,3578763940,0
2,1521,53522,3578763940,3578763940,0
2,1521,53523,3578763940,3578763940,0
2,1521,53524,3578763940,3578763940,0
2,1521,53525,3578763940,3578763940,0
2,1521,53526,3578763940,3578763940,0
2,1521,53527,3578763940,3578763940,0
2,1521,53528,3578763940,3578763940,0
2,1521,53529,3578763940,3578763940,0
2,1521,53530,3578763940,3578763940,0
2,1521,53531,3578763940,3578763940,0
2,1521,53532,3578763940,3578763940,0
2,1521,53533,3578763940,3578763940,0
2,1521,53534,3578763940,3578763940,0
2,1521,53535,3578763940,3578763940,0
2,1521,53536,3578763940,3578763942,2
2,1521,53537,3578763940,3578763943,3
2,1521,53538,3578763940,3578763944,4
2,1521,53539,3578763940,3578763945,5
2,1521,53540,3578763940,3578763948,8
2,1521,53541,3578763940,3578763949,9
2,1521,53542,3578763940,3578763949,9
2,1521,53543,3578763940,3578763950,10
2,1521,53544,3578763940,3578763950,10
2,1521,53545,3578763940,3578763951,11
2,1521,53546,3578763940,3578763951,11
2,1521,53547,3578763940,3578763952,12
2,1521,53548,3578763940,3578763953,13
2,1521,53549,3578763940,3578763953,13
2,1521,53550,3578763940,3578763954,14
2,1521,53551,3578763940,3578763955,15
2,1521,53552,3578763940,3578763957,17
2,1521,53553,3578763940,3578763957,17
2,1521,53554,3578763940,3578763958,18
2,1521,53555,3578763940,3578763962,22
2,1521,53556,3578763940,3578763964,24
2,1521,53557,3578763940,3578763964,24
2,1521,53558,3578763940,3578763964,24
2,1521,53559,3578763940,3578763964,24
2,1521,53560,3578763940,3578763965,25
2,1521,53561,3578763940,3578763965,25
2,1521,53562,3578763940,3578763965,25
2,1521,53563,3578763940,3578763966,26
2,1521,53564,3578763940,3578763966,26
2,1521,53565,3578763940,3578763970,30
2,1521,53566,3578763940,3578763970,30
2,1521,53567,3578763940,3578763970,30
2,1521,53568,3578763940,3578763970,30
2,1521,53569,3578763940,3578763973,33
2,1521,53570,3578763940,3578763974,34
2,1521,53571,3578763940,3578763974,34
2,1521,53572,3578763940,3578763977,37
2,1521,53573,3578763940,3578763978,38
2,1521,53574,3578763940,3578763978,38
2,1521,53575,3578763940,3578763980,40
2,1521,53576,3578763940,3578763984,44
2,1521,53577,3578763940,3578763984,44
2,1521,53578,3578763940,3578763985,45
2,1521,53579,3578763940,3578763986,46
2,1521,53580,3578763940,3578763986,46
2,1521,53581,3578763940,3578763987,47
2,1521,53582,3578763940,3578763987,47
2,1521,53583,3578763940,3578763987,47
2,1521,53584,3578763940,3578763988,48
2,1521,53585,3578763940,3578763989,49
2,1521,53586,3578763940,3578763989,49
2,1521,53587,3578763940,3578763990,50
2,1522,53588,3578764019,3578764019,0
2,1522,53589,3578764019,3578764019,0
2,1522,53590,3578764019,3578764019,0
2,1522,53591,3578764019,3578764019,0
2,1522,53592,3578764019,3578764019,0
2,1522,53593,3578764019,3578764019,0
2,1522,53594,3578764019,3578764019,0
2,1522,53595,3578764019,3578764019,0
2,1522,53596,3578764019,3578764019,0
2,1522,53597,3578764019,3578764019,0
2,1522,53598,3578764019,3578764019,0
2,1522,53599,3578764019,3578764019,0
2,1522,53600,3578764019,3578764019,0
2,1522,53601,3578764019,3578764019,0
2,1522,53602,3578764019,3578764019,0
2,1522,53603,3578764019,3578764019,0
2,1522,53604,3578764019,3578764019,0
2,1522,53605,3578764019,3578764019,0
2,1522,53606,3578764019,3578764019,0
2,1522,53607,3578764019,3578764019,0
2,1522,53608,3578764019,3578764019,0
2,1522,53609,3578764019,3578764019,0
2,1522,53610,3578764019,3578764019,0
2,1522,53611,3578764019,3578764019,0
2,1522,53612,3578764019,3578764019,0
2,1522,53613,3578764019,3578764019,0
2,1522,53614,3578764019,3578764019,0
2,1522,53615,3578764019,3578764019,0
2,1522,53616,3578764019,3578764019,0
2,1522,53617,3578764019,3578764019,0
2,1522,53618,3578764019,3578764020,1
2,1522,53619,3578764019,3578764021,2
2,1522,53620,3578764019,3578764021,2
2,1522,53621,3578764019,3578764022,3
2,1522,53622,3578764019,3578764024,5
2,1522,53623,3578764019,3578764024,5
2,1522,53624,3578764019,3578764027,8
2,1522,53625,3578764019,3578764028,9
2,1522,53626,3578764019,3578764029,10
2,1522,53627,3578764019,3578764029,10
2,1522,53628,3578764019,3578764031,12
2,1522,53629,3578764019,3578764032,13
2,1522,53630,3578764019,3578764033,14
2,1522,53631,3578764019,3578764033,14
2,1522,53632,3578764019,3578764033,14
2,1522,53633,3578764019,3578764035,16
2,1522,53634,3578764019,3578764036,17
2,1522,53635,3578764019,3578764036,17
2,1522,53636,3578764019,3578764037,18
2,1522,53637,3578764019,3578764038,19
2,1522,53638,3578764019,3578764038,19
2,1522,53639,3578764019,3578764039,20
2,1522,53640,3578764019,3578764039,20
2,1522,53641,3578764019,3578764040,21
2,1522,53642,3578764019,3578764040,21
2,1522,53643,3578764019,3578764041,22
2,1522,53644,3578764019,3578764041,22
2,1522,53645,3578764019,3578764041,22
2,1522,53646,3578764019,3578764042,23
2,1522,53647,3578764019,3578764042,23
2,1522,53648,3578764019,3578764042,23
2,1522,53649,3578764019,3578764044,25
2,1522,53650,3578764019,3578764045,26
2,1522,53651,3578764019,3578764045,26
2,1522,53652,3578764019,3578764045,26
2,1522,53653,3578764019,3578764046,27
2,1522,53654,3578764019,3578764046,27
2,1522,53655,3578764019,3578764047,28
2,1522,53656,3578764019,3578764048,29
2,1522,53657,3578764019,3578764048,29
2,1522,53658,3578764019,3578764050,31
2,1522,53659,3578764019,3578764050,31
2,1522,53660,3578764019,3578764050,31
2,1522,53661,3578764019,3578764050,31
2,1522,53662,3578764019,3578764052,33
2,1522,53663,3578764019,3578764053,34
2,1522,53664,3578764019,3578764054,35
2,1522,53665,3578764019,3578764054,35
2,1522,53666,3578764019,3578764054,35
2,1522,53667,3578764019,3578764054,35
2,1522,53668,3578764019,3578764055,36
2,1522,53669,3578764019,3578764055,36
2,1522,53670,3578764019,3578764056,37
2,1522,53671,3578764019,3578764058,39
2,1522,53672,3578764019,3578764060,41
2,1522,53673,3578764019,3578764062,43
2,1522,53674,3578764019,3578764062,43
2,1522,53675,3578764019,3578764064,45
2,1522,53676,3578764019,3578764065,46
2,1522,53677,3578764019,3578764065,46
2,1522,53678,3578764019,3578764065,46
2,1522,53679,3578764019,3578764066,47
2,1522,53680,3578764019,3578764066,47
2,1522,53681,3578764019,3578764067,48
2,1523,53682,3578764083,3578764083,0
2,1523,53683,3578764083,3578764083,0
2,1523,53684,3578764083,3578764083,0
2,1523,53685,3578764083,3578764084,1
2,1523,53686,3578764083,3578764086,3
2,1523,53687,3578764083,3578764088,5
2,1523,53688,3578764083,3578764089,6
2,1523,53689,3578764083,3578764090,7
2,1523,53690,3578764083,3578764090,7
2,1523,53691,3578764083,3578764091,8
2,1523,53692,3578764083,3578764091,8
2,1523,53693,3578764083,3578764093,10
2,1523,53694,3578764083,3578764093,10
2,1523,53695,3578764083,3578764094,11
2,1523,53696,3578764083,3578764094,11
2,1523,53697,3578764083,3578764094,11
2,1523,53698,3578764083,3578764095,12
2,1523,53699,3578764083,3578764095,12
2,1523,53700,3578764083,3578764096,13
2,1523,53701,3578764083,3578764097,14
2,1523,53702,3578764083,3578764097,14
2,1523,53703,3578764083,3578764097,14
2,1523,53704,3578764083,3578764098,15
2,1523,53705,3578764083,3578764098,15
2,1523,53706,3578764083,3578764100,17
2,1523,53707,3578764083,3578764100,17
2,1523,53708,3578764083,3578764100,17
2,1523,53709,3578764083,3578764100,17
2,1523,53710,3578764083,3578764101,18
2,1523,53711,3578764083,3578764102,19
2,1523,53712,3578764083,3578764102,19
2,1523,53713,3578764083,3578764103,20
2,1523,53714,3578764083,3578764103,20
2,1523,53715,3578764083,3578764105,22
2,1523,53716,3578764083,3578764106,23
2,1523,53717,3578764083,3578764106,23
2,1523,53718,3578764083,3578764106,23
2,1523,53719,3578764083,3578764108,25
2,1523,53720,3578764083,3578764109,26
2,1523,53721,3578764083,3578764110,27
2,1523,53722,3578764083,3578764110,27
2,1523,53723,3578764083,3578764111,28
2,1523,53724,3578764083,3578764112,29
2,1523,53725,3578764083,3578764112,29
2,1523,53726,3578764083,3578764114,31
2,1523,53727,3578764083,3578764114,31
2,1523,53728,3578764083,3578764114,31
2,1523,53729,3578764083,3578764114,31
2,1523,53730,3578764083,3578764115,32
2,1523,53731,3578764083,3578764115,32
2,1523,53732,3578764083,3578764115,32
2,1523,53733,3578764083,3578764116,33
2,1523,53734,3578764083,3578764116,33
2,1523,53735,3578764083,3578764117,34
2,1523,53736,3578764083,3578764117,34
2,1523,53737,3578764083,3578764117,34
2,1523,53738,3578764083,3578764117,34
2,1523,53739,3578764083,3578764119,36
2,1523,53740,3578764083,3578764122,39
2,1523,53741,3578764083,3578764122,39
2,1523,53742,3578764083,3578764122,39
2,1523,53743,3578764083,3578764123,40
2,1523,53744,3578764083,3578764125,42
2,1523,53745,3578764083,3578764125,42
2,1523,53746,3578764083,3578764126,43
2,1523,53747,3578764083,3578764127,44
2,1523,53748,3578764083,3578764127,44
2,1523,53749,3578764083,3578764131,48
2,1523,53750,3578764083,3578764131,48
2,1523,53751,3578764083,3578764131,48
2,1524,53752,3578764147,3578764147,0
2,1524,53753,3578764147,3578764147,0
2,1524,53754,3578764147,3578764147,0
2,1524,53755,3578764147,3578764147,0
2,1524,53756,3578764147,3578764147,0
2,1524,53757,3578764147,3578764147,0
2,1524,53758,3578764147,3578764147,0
2,1524,53759,3578764147,3578764147,0
2,1524,53760,3578764147,3578764147,0
2,1524,53761,3578764147,3578764147,0
2,1524,53762,3578764147,3578764147,0
2,1524,53763,3578764147,3578764147,0
2,1524,53764,3578764147,3578764147,0
2,1524,53765,3578764147,3578764147,0
2,1524,53766,3578764147,3578764147,0
2,1524,53767,3578764147,3578764147,0
2,1524,53768,3578764147,3578764147,0
2,1524,53769,3578764147,3578764147,0
2,1524,53770,3578764147,3578764147,0
2,1524,53771,3578764147,3578764148,1
2,1524,53772,3578764147,3578764149,2
2,1524,53773,3578764147,3578764150,3
2,1524,53774,3578764147,3578764150,3
2,1524,53775,3578764147,3578764150,3
2,1524,53776,3578764147,3578764151,4
2,1524,53777,3578764147,3578764152,5
2,1524,53778,3578764147,3578764152,5
2,1524,53779,3578764147,3578764153,6
2,1524,53780,3578764147,3578764153,6
2,1524,53781,3578764147,3578764154,7
2,1524,53782,3578764147,3578764155,8
2,1524,53783,3578764147,3578764155,8
2,1524,53784,3578764147,3578764156,9
2,1524,53785,3578764147,3578764157,10
2,1524,53786,3578764147,3578764158,11
2,1524,53787,3578764147,3578764158,11
2,1524,53788,3578764147,3578764162,15
2,1524,53789,3578764147,3578764163,16
2,1524,53790,3578764147,3578764163,16
2,1524,53791,3578764147,3578764164,17
2,1524,53792,3578764147,3578764164,17
2,1524,53793,3578764147,3578764165,18
2,1524,53794,3578764147,3578764166,19
2,1524,53795,3578764147,3578764166,19
2,1524,53796,3578764147,3578764166,19
2,1524,53797,3578764147,3578764167,20
2,1524,53798,3578764147,3578764169,22
2,1524,53799,3578764147,3578764170,23
2,1524,53800,3578764147,3578764171,24
2,1524,53801,3578764147,3578764172,25
2,1524,53802,3578764147,3578764173,26
2,1524,53803,3578764147,3578764173,26
2,1524,53804,3578764147,3578764174,27
2,1524,53805,3578764147,3578764174,27
2,1524,53806,3578764147,3578764175,28
2,1524,53807,3578764147,3578764177,30
2,1524,53808,3578764147,3578764178,31
2,1524,53809,3578764147,3578764178,31
2,1524,53810,3578764147,3578764179,32
2,1524,53811,3578764147,3578764184,37
2,1524,53812,3578764147,3578764184,37
2,1524,53813,3578764147,3578764185,38
2,1524,53814,3578764147,3578764185,38
2,1524,53815,3578764147,3578764185,38
2,1524,53816,3578764147,3578764186,39
2,1524,53817,3578764147,3578764187,40
2,1524,53818,3578764147,3578764188,41
2,1524,53819,3578764147,3578764188,41
2,1524,53820,3578764147,3578764188,41
2,1524,53821,3578764147,3578764188,41
2,1524,53822,3578764147,3578764189,42
2,1524,53823,3578764147,3578764189,42
2,1524,53824,3578764147,3578764191,44
2,1524,53825,3578764147,3578764191,44
2,1524,53826,3578764147,3578764191,44
2,1524,53827,3578764147,3578764192,45
2,1524,53828,3578764147,3578764193,46
2,1524,53829,3578764147,3578764194,47
2,1525,53830,3578764211,3578764211,0
2,1525,53831,3578764211,3578764211,0
2,1525,53832,3578764211,3578764212,1
2,1525,53833,3578764211,3578764212,1
2,1525,53834,3578764211,3578764212,1
2,1525,53835,3578764211,3578764212,1
2,1525,53836,3578764211,3578764212,1
2,1525,53837,3578764211,3578764212,1
2,1525,53838,3578764211,3578764212,1
2,1525,53839,3578764211,3578764212,1
2,1525,53840,3578764211,3578764212,1
2,1525,53841,3578764211,3578764212,1
2,1525,53842,3578764211,3578764212,1
2,1525,53843,3578764211,3578764212,1
2,1525,53844,3578764211,3578764213,2
2,1525,53845,3578764211,3578764214,3
2,1525,53846,3578764211,3578764215,4
2,1525,53847,3578764211,3578764215,4
2,1525,53848,3578764211,3578764216,5
2,1525,53849,3578764211,3578764217,6
2,1525,53850,3578764211,3578764221,10
2,1525,53851,3578764211,3578764221,10
2,1525,53852,3578764211,3578764222,11
2,1525,53853,3578764211,3578764224,13
2,1525,53854,3578764211,3578764224,13
2,1525,53855,3578764211,3578764226,15
2,1525,53856,3578764211,3578764227,16
2,1525,53857,3578764211,3578764229,18
2,1525,53858,3578764211,3578764229,18
2,1525,53859,3578764211,3578764229,18
2,1525,53860,3578764211,3578764231,20
2,1525,53861,3578764211,3578764231,20
2,1525,53862,3578764211,3578764232,21
2,1525,53863,3578764211,3578764232,21
2,1525,53864,3578764211,3578764233,22
2,1525,53865,3578764211,3578764233,22
2,1525,53866,3578764211,3578764234,23
2,1525,53867,3578764211,3578764236,25
2,1525,53868,3578764211,3578764236,25
2,1525,53869,3578764211,3578764237,26
2,1525,53870,3578764211,3578764238,27
2,1525,53871,3578764211,3578764239,28
2,1525,53872,3578764211,3578764239,28
2,1525,53873,3578764211,3578764240,29
2,1525,53874,3578764211,3578764240,29
2,1525,53875,3578764211,3578764240,29
2,1525,53876,3578764211,3578764241,30
2,1525,53877,3578764211,3578764241,30
2,1525,53878,3578764211,3578764242,31
2,1525,53879,3578764211,3578764242,31
2,1525,53880,3578764211,3578764243,32
2,1525,53881,3578764211,3578764244,33
2,1525,53882,3578764211,3578764245,34
2,1525,53883,3578764211,3578764246,35
2,1525,53884,3578764211,3578764246,35
2,1525,53885,3578764211,3578764246,35
2,1525,53886,3578764211,3578764247,36
2,1525,53887,3578764211,3578764247,36
2,1525,53888,3578764211,3578764249,38
2,1525,53889,3578764211,3578764249,38
2,1525,53890,3578764211,3578764250,39
2,1525,53891,3578764211,3578764251,40
2,1525,53892,3578764211,3578764251,40
2,1525,53893,3578764211,3578764252,41
2,1525,53894,3578764211,3578764253,42
2,1525,53895,3578764211,3578764253,42
2,1525,53896,3578764211,3578764254,43
2,1525,53897,3578764211,3578764254,43
2,1525,53898,3578764211,3578764254,43
2,1525,53899,3578764211,3578764254,43
2,1525,53900,3578764211,3578764255,44
2,1525,53901,3578764211,3578764255,44
2,1525,53902,3578764211,3578764256,45
2,1525,53903,3578764211,3578764258,47
2,1525,53904,3578764211,3578764260,49
2,1526,53905,3578764274,3578764274,0
2,1526,53906,3578764274,3578764274,0
2,1526,53907,3578764274,3578764274,0
2,1526,53908,3578764274,3578764274,0
2,1526,53909,3578764274,3578764274,0
2,1526,53910,3578764274,3578764274,0
2,1526,53911,3578764274,3578764274,0
2,1526,53912,3578764274,3578764274,0
2,1526,53913,3578764274,3578764274,0
2,1526,53914,3578764274,3578764274,0
2,1526,53915,3578764274,3578764277,3
2,1526,53916,3578764274,3578764281,7
2,1526,53917,3578764274,3578764284,10
2,1526,53918,3578764274,3578764285,11
2,1526,53919,3578764274,3578764289,15
2,1526,53920,3578764274,3578764290,16
2,1526,53921,3578764274,3578764290,16
2,1526,53922,3578764274,3578764290,16
2,1526,53923,3578764274,3578764291,17
2,1526,53924,3578764274,3578764291,17
2,1526,53925,3578764274,3578764293,19
2,1526,53926,3578764274,3578764293,19
2,1526,53927,3578764274,3578764294,20
2,1526,53928,3578764274,3578764295,21
2,1526,53929,3578764274,3578764295,21
2,1526,53930,3578764274,3578764296,22
2,1526,53931,3578764274,3578764296,22
2,1526,53932,3578764274,3578764297,23
2,1526,53933,3578764274,3578764297,23
2,1526,53934,3578764274,3578764299,25
2,1526,53935,3578764274,3578764299,25
2,1526,53936,3578764274,3578764299,25
2,1526,53937,3578764274,3578764299,25
2,1526,53938,3578764274,3578764300,26
2,1526,53939,3578764274,3578764300,26
2,1526,53940,3578764274,3578764301,27
2,1526,53941,3578764274,3578764302,28
2,1526,53942,3578764274,3578764302,28
2,1526,53943,3578764274,3578764302,28
2,1526,53944,3578764274,3578764304,30
2,1526,53945,3578764274,3578764305,31
2,1526,53946,3578764274,3578764305,31
2,1526,53947,3578764274,3578764306,32
2,1526,53948,3578764274,3578764306,32
2,1526,53949,3578764274,3578764308,34
2,1526,53950,3578764274,3578764309,35
2,1526,53951,3578764274,3578764310,36
2,1526,53952,3578764274,3578764310,36
2,1526,53953,3578764274,3578764310,36
2,1526,53954,3578764274,3578764310,36
2,1526,53955,3578764274,3578764312,38
2,1526,53956,3578764274,3578764314,40
2,1526,53957,3578764274,3578764314,40
2,1526,53958,3578764274,3578764314,40
2,1526,53959,3578764274,3578764314,40
2,1526,53960,3578764274,3578764316,42
2,1526,53961,3578764274,3578764316,42
2,1526,53962,3578764274,3578764316,42
2,1526,53963,3578764274,3578764316,42
2,1526,53964,3578764274,3578764317,43
2,1526,53965,3578764274,3578764317,43
2,1526,53966,3578764274,3578764318,44
2,1526,53967,3578764274,3578764318,44
2,1526,53968,3578764274,3578764319,45
2,1526,53969,3578764274,3578764321,47
2,1526,53970,3578764274,3578764322,48
2,1526,53971,3578764274,3578764322,48
2,1526,53972,3578764274,3578764323,49
2,1527,53973,3578764340,3578764340,0
2,1527,53974,3578764340,3578764340,0
2,1527,53975,3578764340,3578764340,0
2,1527,53976,3578764340,3578764340,0
2,1527,53977,3578764340,3578764340,0
2,1527,53978,3578764340,3578764340,0
2,1527,53979,3578764340,3578764340,0
2,1527,53980,3578764340,3578764340,0
2,1527,53981,3578764340,3578764340,0
2,1527,53982,3578764340,3578764340,0
2,1527,53983,3578764340,3578764340,0
2,1527,53984,3578764340,3578764340,0
2,1527,53985,3578764340,3578764340,0
2,1527,53986,3578764340,3578764340,0
2,1527,53987,3578764340,3578764340,0
2,1527,53988,3578764340,3578764340,0
2,1527,53989,3578764340,3578764340,0
2,1527,53990,3578764340,3578764340,0
2,1527,53991,3578764340,3578764340,0
2,1527,53992,3578764340,3578764340,0
2,1527,53993,3578764340,3578764341,1
2,1527,53994,3578764340,3578764343,3
2,1527,53995,3578764340,3578764343,3
2,1527,53996,3578764340,3578764344,4
2,1527,53997,3578764340,3578764345,5
2,1527,53998,3578764340,3578764348,8
2,1527,53999,3578764340,3578764350,10
2,1527,54000,3578764340,3578764350,10
2,1527,54001,3578764340,3578764350,10
2,1527,54002,3578764340,3578764350,10
2,1527,54003,3578764340,3578764351,11
2,1527,54004,3578764340,3578764352,12
2,1527,54005,3578764340,3578764353,13
2,1527,54006,3578764340,3578764353,13
2,1527,54007,3578764340,3578764354,14
2,1527,54008,3578764340,3578764355,15
2,1527,54009,3578764340,3578764355,15
2,1527,54010,3578764340,3578764356,16
2,1527,54011,3578764340,3578764357,17
2,1527,54012,3578764340,3578764358,18
2,1527,54013,3578764340,3578764359,19
2,1527,54014,3578764340,3578764362,22
2,1527,54015,3578764340,3578764363,23
2,1527,54016,3578764340,3578764364,24
2,1527,54017,3578764340,3578764365,25
2,1527,54018,3578764340,3578764366,26
2,1527,54019,3578764340,3578764366,26
2,1527,54020,3578764340,3578764366,26
2,1527,54021,3578764340,3578764366,26
2,1527,54022,3578764340,3578764367,27
2,1527,54023,3578764340,3578764370,30
2,1527,54024,3578764340,3578764371,31
2,1527,54025,3578764340,3578764371,31
2,1527,54026,3578764340,3578764371,31
2,1527,54027,3578764340,3578764373,33
2,1527,54028,3578764340,3578764374,34
2,1527,54029,3578764340,3578764374,34
2,1527,54030,3578764340,3578764374,34
2,1527,54031,3578764340,3578764376,36
2,1527,54032,3578764340,3578764377,37
2,1527,54033,3578764340,3578764377,37
2,1527,54034,3578764340,3578764379,39
2,1527,54035,3578764340,3578764380,40
2,1527,54036,3578764340,3578764384,44
2,1527,54037,3578764340,3578764384,44
2,1527,54038,3578764340,3578764384,44
2,1527,54039,3578764340,3578764385,45
2,1527,54040,3578764340,3578764385,45
2,1527,54041,3578764340,3578764386,46
2,1527,54042,3578764340,3578764388,48
2,1527,54043,3578764340,3578764388,48
2,1527,54044,3578764340,3578764388,48
2,1527,54045,3578764340,3578764389,49
2,1527,54046,3578764340,3578764389,49
2,1527,54047,3578764340,3578764390,50
2,1528,54048,3578764404,3578764404,0
2,1528,54049,3578764404,3578764404,0
2,1528,54050,3578764404,3578764404,0
2,1528,54051,3578764404,3578764404,0
2,1528,54052,3578764404,3578764404,0
2,1528,54053,3578764404,3578764405,1
2,1528,54054,3578764404,3578764405,1
2,1528,54055,3578764404,3578764405,1
2,1528,54056,3578764404,3578764405,1
2,1528,54057,3578764404,3578764405,1
2,1528,54058,3578764404,3578764405,1
2,1528,54059,3578764404,3578764405,1
2,1528,54060,3578764404,3578764405,1
2,1528,54061,3578764404,3578764405,1
2,1528,54062,3578764404,3578764405,1
2,1528,54063,3578764404,3578764405,1
2,1528,54064,3578764404,3578764405,1
2,1528,54065,3578764404,3578764406,2
2,1528,54066,3578764404,3578764407,3
2,1528,54067,3578764404,3578764407,3
2,1528,54068,3578764404,3578764409,5
2,1528,54069,3578764404,3578764411,7
2,1528,54070,3578764404,3578764412,8
2,1528,54071,3578764404,3578764413,9
2,1528,54072,3578764404,3578764413,9
2,1528,54073,3578764404,3578764415,11
2,1528,54074,3578764404,3578764415,11
2,1528,54075,3578764404,3578764417,13
2,1528,54076,3578764404,3578764417,13
2,1528,54077,3578764404,3578764420,16
2,1528,54078,3578764404,3578764421,17
2,1528,54079,3578764404,3578764422,18
2,1528,54080,3578764404,3578764422,18
2,1528,54081,3578764404,3578764424,20
2,1528,54082,3578764404,3578764425,21
2,1528,54083,3578764404,3578764425,21
2,1528,54084,3578764404,3578764426,22
2,1528,54085,3578764404,3578764428,24
2,1528,54086,3578764404,3578764428,24
2,1528,54087,3578764404,3578764430,26
2,1528,54088,3578764404,3578764430,26
2,1528,54089,3578764404,3578764431,27
2,1528,54090,3578764404,3578764432,28
2,1528,54091,3578764404,3578764433,29
2,1528,54092,3578764404,3578764433,29
2,1528,54093,3578764404,3578764433,29
2,1528,54094,3578764404,3578764434,30
2,1528,54095,3578764404,3578764435,31
2,1528,54096,3578764404,3578764435,31
2,1528,54097,3578764404,3578764436,32
2,1528,54098,3578764404,3578764437,33
2,1528,54099,3578764404,3578764438,34
2,1528,54100,3578764404,3578764439,35
2,1528,54101,3578764404,3578764439,35
2,1528,54102,3578764404,3578764439,35
2,1528,54103,3578764404,3578764440,36
2,1528,54104,3578764404,3578764441,37
2,1528,54105,3578764404,3578764441,37
2,1528,54106,3578764404,3578764442,38
2,1528,54107,3578764404,3578764442,38
2,1528,54108,3578764404,3578764443,39
2,1528,54109,3578764404,3578764443,39
2,1528,54110,3578764404,3578764445,41
2,1528,54111,3578764404,3578764445,41
2,1528,54112,3578764404,3578764446,42
2,1528,54113,3578764404,3578764446,42
2,1528,54114,3578764404,3578764446,42
2,1528,54115,3578764404,3578764447,43
2,1528,54116,3578764404,3578764447,43
2,1528,54117,3578764404,3578764448,44
2,1528,54118,3578764404,3578764449,45
2,1528,54119,3578764404,3578764449,45
2,1528,54120,3578764404,3578764450,46
2,1528,54121,3578764404,3578764450,46
2,1528,54122,3578764404,3578764451,47
2,1528,54123,3578764404,3578764452,48
2,1528,54124,3578764404,3578764452,48
2,1528,54125,3578764404,3578764453,49
2,1528,54126,3578764404,3578764453,49
2,1528,54127,3578764404,3578764454,50
2,1529,54128,3578764468,3578764468,0
2,1529,54129,3578764468,3578764468,0
2,1529,54130,3578764468,3578764468,0
2,1529,54131,3578764468,3578764468,0
2,1529,54132,3578764468,3578764468,0
2,1529,54133,3578764468,3578764468,0
2,1529,54134,3578764468,3578764468,0
2,1529,54135,3578764468,3578764468,0
2,1529,54136,3578764468,3578764468,0
2,1529,54137,3578764468,3578764468,0
2,1529,54138,3578764468,3578764468,0
2,1529,54139,3578764468,3578764468,0
2,1529,54140,3578764468,3578764468,0
2,1529,54141,3578764468,3578764468,0
2,1529,54142,3578764468,3578764468,0
2,1529,54143,3578764468,3578764468,0
2,1529,54144,3578764468,3578764478,10
2,1529,54145,3578764468,3578764480,12
2,1529,54146,3578764468,3578764485,17
2,1529,54147,3578764468,3578764485,17
2,1529,54148,3578764468,3578764488,20
2,1529,54149,3578764468,3578764489,21
2,1529,54150,3578764468,3578764490,22
2,1529,54151,3578764468,3578764490,22
2,1529,54152,3578764468,3578764490,22
2,1529,54153,3578764468,3578764491,23
2,1529,54154,3578764468,3578764492,24
2,1529,54155,3578764468,3578764493,25
2,1529,54156,3578764468,3578764493,25
2,1529,54157,3578764468,3578764494,26
2,1529,54158,3578764468,3578764495,27
2,1529,54159,3578764468,3578764496,28
2,1529,54160,3578764468,3578764496,28
2,1529,54161,3578764468,3578764497,29
2,1529,54162,3578764468,3578764497,29
2,1529,54163,3578764468,3578764498,30
2,1529,54164,3578764468,3578764499,31
2,1529,54165,3578764468,3578764499,31
2,1529,54166,3578764468,3578764500,32
2,1529,54167,3578764468,3578764500,32
2,1529,54168,3578764468,3578764501,33
2,1529,54169,3578764468,3578764501,33
2,1529,54170,3578764468,3578764501,33
2,1529,54171,3578764468,3578764502,34
2,1529,54172,3578764468,3578764502,34
2,1529,54173,3578764468,3578764502,34
2,1529,54174,3578764468,3578764504,36
2,1529,54175,3578764468,3578764505,37
2,1529,54176,3578764468,3578764506,38
2,1529,54177,3578764468,3578764506,38
2,1529,54178,3578764468,3578764507,39
2,1529,54179,3578764468,3578764508,40
2,1529,54180,3578764468,3578764509,41
2,1529,54181,3578764468,3578764510,42
2,1529,54182,3578764468,3578764511,43
2,1529,54183,3578764468,3578764511,43
2,1529,54184,3578764468,3578764512,44
2,1529,54185,3578764468,3578764514,46
2,1529,54186,3578764468,3578764514,46
2,1529,54187,3578764468,3578764515,47
2,1529,54188,3578764468,3578764515,47
2,1529,54189,3578764468,3578764515,47
2,1529,54190,3578764468,3578764516,48
2,1529,54191,3578764468,3578764516,48
2,1529,54192,3578764468,3578764516,48
2,1529,54193,3578764468,3578764517,49
2,1529,54194,3578764468,3578764517,49
2,1529,54195,3578764468,3578764518,50
2,1530,54196,3578764532,3578764532,0
2,1530,54197,3578764532,3578764532,0
2,1530,54198,3578764532,3578764532,0
2,1530,54199,3578764532,3578764532,0
2,1530,54200,3578764532,3578764532,0
2,1530,54201,3578764532,3578764532,0
2,1530,54202,3578764532,3578764532,0
2,1530,54203,3578764532,3578764532,0
2,1530,54204,3578764532,3578764532,0
2,1530,54205,3578764532,3578764532,0
2,1530,54206,3578764532,3578764532,0
2,1530,54207,3578764532,3578764532,0
2,1530,54208,3578764532,3578764532,0
2,1530,54209,3578764532,3578764532,0
2,1530,54210,3578764532,3578764532,0
2,1530,54211,3578764532,3578764534,2
2,1530,54212,3578764532,3578764534,2
2,1530,54213,3578764532,3578764535,3
2,1530,54214,3578764532,3578764536,4
2,1530,54215,3578764532,3578764537,5
2,1530,54216,3578764532,3578764537,5
2,1530,54217,3578764532,3578764538,6
2,1530,54218,3578764532,3578764538,6
2,1530,54219,3578764532,3578764539,7
2,1530,54220,3578764532,3578764540,8
2,1530,54221,3578764532,3578764543,11
2,1530,54222,3578764532,3578764544,12
2,1530,54223,3578764532,3578764544,12
2,1530,54224,3578764532,3578764548,16
2,1530,54225,3578764532,3578764549,17
2,1530,54226,3578764532,3578764549,17
2,1530,54227,3578764532,3578764549,17
2,1530,54228,3578764532,3578764551,19
2,1530,54229,3578764532,3578764551,19
2,1530,54230,3578764532,3578764552,20
2,1530,54231,3578764532,3578764552,20
2,1530,54232,3578764532,3578764553,21
2,1530,54233,3578764532,3578764553,21
2,1530,54234,3578764532,3578764554,22
2,1530,54235,3578764532,3578764556,24
2,1530,54236,3578764532,3578764557,25
2,1530,54237,3578764532,3578764557,25
2,1530,54238,3578764532,3578764557,25
2,1530,54239,3578764532,3578764560,28
2,1530,54240,3578764532,3578764562,30
2,1530,54241,3578764532,3578764563,31
2,1530,54242,3578764532,3578764564,32
2,1530,54243,3578764532,3578764565,33
2,1530,54244,3578764532,3578764565,33
2,1530,54245,3578764532,3578764566,34
2,1530,54246,3578764532,3578764567,35
2,1530,54247,3578764532,3578764570,38
2,1530,54248,3578764532,3578764570,38
2,1530,54249,3578764532,3578764570,38
2,1530,54250,3578764532,3578764572,40
2,1530,54251,3578764532,3578764573,41
2,1530,54252,3578764532,3578764573,41
2,1530,54253,3578764532,3578764574,42
2,1530,54254,3578764532,3578764575,43
2,1530,54255,3578764532,3578764576,44
2,1530,54256,3578764532,3578764578,46
2,1530,54257,3578764532,3578764578,46
2,1530,54258,3578764532,3578764579,47
2,1531,54259,3578764598,3578764598,0
2,1531,54260,3578764598,3578764598,0
2,1531,54261,3578764598,3578764598,0
2,1531,54262,3578764598,3578764598,0
2,1531,54263,3578764598,3578764598,0
2,1531,54264,3578764598,3578764598,0
2,1531,54265,3578764598,3578764598,0
2,1531,54266,3578764598,3578764598,0
2,1531,54267,3578764598,3578764598,0
2,1531,54268,3578764598,3578764598,0
2,1531,54269,3578764598,3578764598,0
2,1531,54270,3578764598,3578764598,0
2,1531,54271,3578764598,3578764598,0
2,1531,54272,3578764598,3578764598,0
2,1531,54273,3578764598,3578764598,0
2,1531,54274,3578764598,3578764598,0
2,1531,54275,3578764598,3578764598,0
2,1531,54276,3578764598,3578764598,0
2,1531,54277,3578764598,3578764598,0
2,1531,54278,3578764598,3578764598,0
2,1531,54279,3578764598,3578764598,0
2,1531,54280,3578764598,3578764598,0
2,1531,54281,3578764598,3578764599,1
2,1531,54282,3578764598,3578764600,2
2,1531,54283,3578764598,3578764601,3
2,1531,54284,3578764598,3578764602,4
2,1531,54285,3578764598,3578764603,5
2,1531,54286,3578764598,3578764603,5
2,1531,54287,3578764598,3578764604,6
2,1531,54288,3578764598,3578764604,6
2,1531,54289,3578764598,3578764604,6
2,1531,54290,3578764598,3578764605,7
2,1531,54291,3578764598,3578764606,8
2,1531,54292,3578764598,3578764606,8
2,1531,54293,3578764598,3578764609,11
2,1531,54294,3578764598,3578764610,12
2,1531,54295,3578764598,3578764612,14
2,1531,54296,3578764598,3578764612,14
2,1531,54297,3578764598,3578764612,14
2,1531,54298,3578764598,3578764613,15
2,1531,54299,3578764598,3578764614,16
2,1531,54300,3578764598,3578764615,17
2,1531,54301,3578764598,3578764615,17
2,1531,54302,3578764598,3578764616,18
2,1531,54303,3578764598,3578764619,21
2,1531,54304,3578764598,3578764621,23
2,1531,54305,3578764598,3578764621,23
2,1531,54306,3578764598,3578764621,23
2,1531,54307,3578764598,3578764624,26
2,1531,54308,3578764598,3578764624,26
2,1531,54309,3578764598,3578764626,28
2,1531,54310,3578764598,3578764627,29
2,1531,54311,3578764598,3578764629,31
2,1531,54312,3578764598,3578764629,31
2,1531,54313,3578764598,3578764631,33
2,1531,54314,3578764598,3578764632,34
2,1531,54315,3578764598,3578764633,35
2,1531,54316,3578764598,3578764633,35
2,1531,54317,3578764598,3578764634,36
2,1531,54318,3578764598,3578764635,37
2,1531,54319,3578764598,3578764636,38
2,1531,54320,3578764598,3578764636,38
2,1531,54321,3578764598,3578764637,39
2,1531,54322,3578764598,3578764638,40
2,1531,54323,3578764598,3578764638,40
2,1531,54324,3578764598,3578764638,40
2,1531,54325,3578764598,3578764639,41
2,1531,54326,3578764598,3578764639,41
2,1531,54327,3578764598,3578764641,43
2,1531,54328,3578764598,3578764641,43
2,1531,54329,3578764598,3578764641,43
2,1531,54330,3578764598,3578764641,43
2,1531,54331,3578764598,3578764642,44
2,1531,54332,3578764598,3578764643,45
2,1531,54333,3578764598,3578764644,46
2,1531,54334,3578764598,3578764645,47
2,1531,54335,3578764598,3578764645,47
2,1531,54336,3578764598,3578764646,48
2,1531,54337,3578764598,3578764646,48
2,1531,54338,3578764598,3578764646,48
2,1531,54339,3578764598,3578764647,49
2,1531,54340,3578764598,3578764648,50
2,1532,54341,3578764663,3578764663,0
2,1532,54342,3578764663,3578764663,0
2,1532,54343,3578764663,3578764663,0
2,1532,54344,3578764663,3578764663,0
2,1532,54345,3578764663,3578764663,0
2,1532,54346,3578764663,3578764663,0
2,1532,54347,3578764663,3578764663,0
2,1532,54348,3578764663,3578764663,0
2,1532,54349,3578764663,3578764663,0
2,1532,54350,3578764663,3578764663,0
2,1532,54351,3578764663,3578764663,0
2,1532,54352,3578764663,3578764663,0
2,1532,54353,3578764663,3578764663,0
2,1532,54354,3578764663,3578764664,1
2,1532,54355,3578764663,3578764664,1
2,1532,54356,3578764663,3578764664,1
2,1532,54357,3578764663,3578764664,1
2,1532,54358,3578764663,3578764664,1
2,1532,54359,3578764663,3578764664,1
2,1532,54360,3578764663,3578764666,3
2,1532,54361,3578764663,3578764667,4
2,1532,54362,3578764663,3578764667,4
2,1532,54363,3578764663,3578764681,18
2,1532,54364,3578764663,3578764684,21
2,1532,54365,3578764663,3578764685,22
2,1532,54366,3578764663,3578764690,27
2,1532,54367,3578764663,3578764690,27
2,1532,54368,3578764663,3578764690,27
2,1532,54369,3578764663,3578764690,27
2,1532,54370,3578764663,3578764691,28
2,1532,54371,3578764663,3578764692,29
2,1532,54372,3578764663,3578764692,29
2,1532,54373,3578764663,3578764693,30
2,1532,54374,3578764663,3578764694,31
2,1532,54375,3578764663,3578764695,32
2,1532,54376,3578764663,3578764695,32
2,1532,54377,3578764663,3578764696,33
2,1532,54378,3578764663,3578764697,34
2,1532,54379,3578764663,3578764699,36
2,1532,54380,3578764663,3578764699,36
2,1532,54381,3578764663,3578764700,37
2,1532,54382,3578764663,3578764700,37
2,1532,54383,3578764663,3578764701,38
2,1532,54384,3578764663,3578764701,38
2,1532,54385,3578764663,3578764702,39
2,1532,54386,3578764663,3578764702,39
2,1532,54387,3578764663,3578764702,39
2,1532,54388,3578764663,3578764702,39
2,1532,54389,3578764663,3578764704,41
2,1532,54390,3578764663,3578764705,42
2,1532,54391,3578764663,3578764706,43
2,1532,54392,3578764663,3578764706,43
2,1532,54393,3578764663,3578764708,45
2,1532,54394,3578764663,3578764709,46
2,1532,54395,3578764663,3578764711,48
2,1532,54396,3578764663,3578764711,48
2,1532,54397,3578764663,3578764713,50
2,1533,54398,3578764727,3578764727,0
2,1533,54399,3578764727,3578764727,0
2,1533,54400,3578764727,3578764727,0
2,1533,54401,3578764727,3578764727,0
2,1533,54402,3578764727,3578764727,0
2,1533,54403,3578764727,3578764727,0
2,1533,54404,3578764727,3578764727,0
2,1533,54405,3578764727,3578764727,0
2,1533,54406,3578764727,3578764727,0
2,1533,54407,3578764727,3578764727,0
2,1533,54408,3578764727,3578764727,0
2,1533,54409,3578764727,3578764727,0
2,1533,54410,3578764727,3578764727,0
2,1533,54411,3578764727,3578764727,0
2,1533,54412,3578764727,3578764727,0
2,1533,54413,3578764727,3578764727,0
2,1533,54414,3578764727,3578764727,0
2,1533,54415,3578764727,3578764727,0
2,1533,54416,3578764727,3578764727,0
2,1533,54417,3578764727,3578764727,0
2,1533,54418,3578764727,3578764727,0
2,1533,54419,3578764727,3578764727,0
2,1533,54420,3578764727,3578764727,0
2,1533,54421,3578764727,3578764731,4
2,1533,54422,3578764727,3578764732,5
2,1533,54423,3578764727,3578764733,6
2,1533,54424,3578764727,3578764734,7
2,1533,54425,3578764727,3578764735,8
2,1533,54426,3578764727,3578764735,8
2,1533,54427,3578764727,3578764737,10
2,1533,54428,3578764727,3578764737,10
2,1533,54429,3578764727,3578764738,11
2,1533,54430,3578764727,3578764738,11
2,1533,54431,3578764727,3578764738,11
2,1533,54432,3578764727,3578764738,11
2,1533,54433,3578764727,3578764740,13
2,1533,54434,3578764727,3578764743,16
2,1533,54435,3578764727,3578764744,17
2,1533,54436,3578764727,3578764745,18
2,1533,54437,3578764727,3578764745,18
2,1533,54438,3578764727,3578764747,20
2,1533,54439,3578764727,3578764749,22
2,1533,54440,3578764727,3578764749,22
2,1533,54441,3578764727,3578764750,23
2,1533,54442,3578764727,3578764750,23
2,1533,54443,3578764727,3578764751,24
2,1533,54444,3578764727,3578764751,24
2,1533,54445,3578764727,3578764752,25
2,1533,54446,3578764727,3578764753,26
2,1533,54447,3578764727,3578764753,26
2,1533,54448,3578764727,3578764754,27
2,1533,54449,3578764727,3578764756,29
2,1533,54450,3578764727,3578764757,30
2,1533,54451,3578764727,3578764757,30
2,1533,54452,3578764727,3578764757,30
2,1533,54453,3578764727,3578764760,33
2,1533,54454,3578764727,3578764763,36
2,1533,54455,3578764727,3578764764,37
2,1533,54456,3578764727,3578764764,37
2,1533,54457,3578764727,3578764765,38
2,1533,54458,3578764727,3578764766,39
2,1533,54459,3578764727,3578764767,40
2,1533,54460,3578764727,3578764769,42
2,1533,54461,3578764727,3578764769,42
2,1533,54462,3578764727,3578764770,43
2,1533,54463,3578764727,3578764771,44
2,1533,54464,3578764727,3578764771,44
2,1533,54465,3578764727,3578764772,45
2,1533,54466,3578764727,3578764774,47
2,1533,54467,3578764727,3578764774,47
2,1533,54468,3578764727,3578764775,48
2,1533,54469,3578764727,3578764776,49
2,1534,54470,3578764791,3578764791,0
2,1534,54471,3578764791,3578764791,0
2,1534,54472,3578764791,3578764791,0
2,1534,54473,3578764791,3578764791,0
2,1534,54474,3578764791,3578764791,0
2,1534,54475,3578764791,3578764791,0
2,1534,54476,3578764791,3578764791,0
2,1534,54477,3578764791,3578764791,0
2,1534,54478,3578764791,3578764791,0
2,1534,54479,3578764791,3578764791,0
2,1534,54480,3578764791,3578764791,0
2,1534,54481,3578764791,3578764791,0
2,1534,54482,3578764791,3578764791,0
2,1534,54483,3578764791,3578764791,0
2,1534,54484,3578764791,3578764791,0
2,1534,54485,3578764791,3578764791,0
2,1534,54486,3578764791,3578764791,0
2,1534,54487,3578764791,3578764791,0
2,1534,54488,3578764791,3578764791,0
2,1534,54489,3578764791,3578764791,0
2,1534,54490,3578764791,3578764793,2
2,1534,54491,3578764791,3578764794,3
2,1534,54492,3578764791,3578764798,7
2,1534,54493,3578764791,3578764798,7
2,1534,54494,3578764791,3578764799,8
2,1534,54495,3578764791,3578764800,9
2,1534,54496,3578764791,3578764802,11
2,1534,54497,3578764791,3578764803,12
2,1534,54498,3578764791,3578764804,13
2,1534,54499,3578764791,3578764804,13
2,1534,54500,3578764791,3578764804,13
2,1534,54501,3578764791,3578764805,14
2,1534,54502,3578764791,3578764805,14
2,1534,54503,3578764791,3578764805,14
2,1534,54504,3578764791,3578764806,15
2,1534,54505,3578764791,3578764808,17
2,1534,54506,3578764791,3578764809,18
2,1534,54507,3578764791,3578764811,20
2,1534,54508,3578764791,3578764812,21
2,1534,54509,3578764791,3578764812,21
2,1534,54510,3578764791,3578764812,21
2,1534,54511,3578764791,3578764814,23
2,1534,54512,3578764791,3578764814,23
2,1534,54513,3578764791,3578764815,24
2,1534,54514,3578764791,3578764816,25
2,1534,54515,3578764791,3578764816,25
2,1534,54516,3578764791,3578764816,25
2,1534,54517,3578764791,3578764821,30
2,1534,54518,3578764791,3578764821,30
2,1534,54519,3578764791,3578764821,30
2,1534,54520,3578764791,3578764824,33
2,1534,54521,3578764791,3578764824,33
2,1534,54522,3578764791,3578764826,35
2,1534,54523,3578764791,3578764827,36
2,1534,54524,3578764791,3578764828,37
2,1534,54525,3578764791,3578764829,38
2,1534,54526,3578764791,3578764831,40
2,1534,54527,3578764791,3578764833,42
2,1534,54528,3578764791,3578764833,42
2,1534,54529,3578764791,3578764834,43
2,1534,54530,3578764791,3578764836,45
2,1534,54531,3578764791,3578764836,45
2,1534,54532,3578764791,3578764837,46
2,1534,54533,3578764791,3578764837,46
2,1534,54534,3578764791,3578764838,47
2,1534,54535,3578764791,3578764838,47
2,1534,54536,3578764791,3578764838,47
2,1534,54537,3578764791,3578764838,47
2,1534,54538,3578764791,3578764839,48
2,1534,54539,3578764791,3578764840,49
2,1534,54540,3578764791,3578764841,50
2,1535,54541,3578764855,3578764855,0
2,1535,54542,3578764855,3578764855,0
2,1535,54543,3578764855,3578764855,0
2,1535,54544,3578764855,3578764855,0
2,1535,54545,3578764855,3578764855,0
2,1535,54546,3578764855,3578764855,0
2,1535,54547,3578764855,3578764855,0
2,1535,54548,3578764855,3578764855,0
2,1535,54549,3578764855,3578764855,0
2,1535,54550,3578764855,3578764855,0
2,1535,54551,3578764855,3578764855,0
2,1535,54552,3578764855,3578764855,0
2,1535,54553,3578764855,3578764855,0
2,1535,54554,3578764855,3578764855,0
2,1535,54555,3578764855,3578764855,0
2,1535,54556,3578764855,3578764855,0
2,1535,54557,3578764855,3578764855,0
2,1535,54558,3578764855,3578764855,0
2,1535,54559,3578764855,3578764855,0
2,1535,54560,3578764855,3578764855,0
2,1535,54561,3578764855,3578764855,0
2,1535,54562,3578764855,3578764855,0
2,1535,54563,3578764855,3578764855,0
2,1535,54564,3578764855,3578764855,0
2,1535,54565,3578764855,3578764856,1
2,1535,54566,3578764855,3578764859,4
2,1535,54567,3578764855,3578764859,4
2,1535,54568,3578764855,3578764862,7
2,1535,54569,3578764855,3578764864,9
2,1535,54570,3578764855,3578764864,9
2,1535,54571,3578764855,3578764864,9
2,1535,54572,3578764855,3578764867,12
2,1535,54573,3578764855,3578764867,12
2,1535,54574,3578764855,3578764879,24
2,1535,54575,3578764855,3578764884,29
2,1535,54576,3578764855,3578764885,30
2,1535,54577,3578764855,3578764885,30
2,1535,54578,3578764855,3578764887,32
2,1535,54579,3578764855,3578764888,33
2,1535,54580,3578764855,3578764890,35
2,1535,54581,3578764855,3578764890,35
2,1535,54582,3578764855,3578764890,35
2,1535,54583,3578764855,3578764891,36
2,1535,54584,3578764855,3578764893,38
2,1535,54585,3578764855,3578764893,38
2,1535,54586,3578764855,3578764895,40
2,1535,54587,3578764855,3578764895,40
2,1535,54588,3578764855,3578764895,40
2,1535,54589,3578764855,3578764897,42
2,1535,54590,3578764855,3578764897,42
2,1535,54591,3578764855,3578764899,44
2,1535,54592,3578764855,3578764899,44
2,1535,54593,3578764855,3578764899,44
2,1535,54594,3578764855,3578764900,45
2,1535,54595,3578764855,3578764900,45
2,1535,54596,3578764855,3578764901,46
2,1535,54597,3578764855,3578764901,46
2,1535,54598,3578764855,3578764901,46
2,1535,54599,3578764855,3578764902,47
2,1535,54600,3578764855,3578764902,47
2,1535,54601,3578764855,3578764902,47
2,1535,54602,3578764855,3578764902,47
2,1535,54603,3578764855,3578764904,49
2,1536,54604,3578764919,3578764919,0
2,1536,54605,3578764919,3578764919,0
2,1536,54606,3578764919,3578764919,0
2,1536,54607,3578764919,3578764919,0
2,1536,54608,3578764919,3578764919,0
2,1536,54609,3578764919,3578764919,0
2,1536,54610,3578764919,3578764919,0
2,1536,54611,3578764919,3578764919,0
2,1536,54612,3578764919,3578764919,0
2,1536,54613,3578764919,3578764919,0
2,1536,54614,3578764919,3578764919,0
2,1536,54615,3578764919,3578764919,0
2,1536,54616,3578764919,3578764919,0
2,1536,54617,3578764919,3578764919,0
2,1536,54618,3578764919,3578764919,0
2,1536,54619,3578764919,3578764919,0
2,1536,54620,3578764919,3578764919,0
2,1536,54621,3578764919,3578764919,0
2,1536,54622,3578764919,3578764919,0
2,1536,54623,3578764919,3578764919,0
2,1536,54624,3578764919,3578764919,0
2,1536,54625,3578764919,3578764919,0
2,1536,54626,3578764919,3578764919,0
2,1536,54627,3578764919,3578764919,0
2,1536,54628,3578764919,3578764919,0
2,1536,54629,3578764919,3578764921,2
2,1536,54630,3578764919,3578764921,2
2,1536,54631,3578764919,3578764922,3
2,1536,54632,3578764919,3578764922,3
2,1536,54633,3578764919,3578764923,4
2,1536,54634,3578764919,3578764923,4
2,1536,54635,3578764919,3578764925,6
2,1536,54636,3578764919,3578764926,7
2,1536,54637,3578764919,3578764926,7
2,1536,54638,3578764919,3578764927,8
2,1536,54639,3578764919,3578764927,8
2,1536,54640,3578764919,3578764931,12
2,1536,54641,3578764919,3578764931,12
2,1536,54642,3578764919,3578764933,14
2,1536,54643,3578764919,3578764933,14
2,1536,54644,3578764919,3578764935,16
2,1536,54645,3578764919,3578764935,16
2,1536,54646,3578764919,3578764936,17
2,1536,54647,3578764919,3578764937,18
2,1536,54648,3578764919,3578764938,19
2,1536,54649,3578764919,3578764938,19
2,1536,54650,3578764919,3578764938,19
2,1536,54651,3578764919,3578764939,20
2,1536,54652,3578764919,3578764939,20
2,1536,54653,3578764919,3578764940,21
2,1536,54654,3578764919,3578764940,21
2,1536,54655,3578764919,3578764943,24
2,1536,54656,3578764919,3578764944,25
2,1536,54657,3578764919,3578764945,26
2,1536,54658,3578764919,3578764945,26
2,1536,54659,3578764919,3578764947,28
2,1536,54660,3578764919,3578764948,29
2,1536,54661,3578764919,3578764949,30
2,1536,54662,3578764919,3578764950,31
2,1536,54663,3578764919,3578764950,31
2,1536,54664,3578764919,3578764950,31
2,1536,54665,3578764919,3578764950,31
2,1536,54666,3578764919,3578764951,32
2,1536,54667,3578764919,3578764952,33
2,1536,54668,3578764919,3578764953,34
2,1536,54669,3578764919,3578764954,35
2,1536,54670,3578764919,3578764955,36
2,1536,54671,3578764919,3578764955,36
2,1536,54672,3578764919,3578764957,38
2,1536,54673,3578764919,3578764958,39
2,1536,54674,3578764919,3578764958,39
2,1536,54675,3578764919,3578764961,42
2,1536,54676,3578764919,3578764964,45
2,1536,54677,3578764919,3578764964,45
2,1536,54678,3578764919,3578764964,45
2,1536,54679,3578764919,3578764965,46
2,1536,54680,3578764919,3578764966,47
2,1536,54681,3578764919,3578764967,48
2,1536,54682,3578764919,3578764969,50
2,1536,54683,3578764919,3578764969,50
2,1537,54684,3578764983,3578764983,0
2,1537,54685,3578764983,3578764983,0
2,1537,54686,3578764983,3578764983,0
2,1537,54687,3578764983,3578764983,0
2,1537,54688,3578764983,3578764983,0
2,1537,54689,3578764983,3578764983,0
2,1537,54690,3578764983,3578764983,0
2,1537,54691,3578764983,3578764983,0
2,1537,54692,3578764983,3578764983,0
2,1537,54693,3578764983,3578764983,0
2,1537,54694,3578764983,3578764984,1
2,1537,54695,3578764983,3578764984,1
2,1537,54696,3578764983,3578764985,2
2,1537,54697,3578764983,3578764985,2
2,1537,54698,3578764983,3578764985,2
2,1537,54699,3578764983,3578764986,3
2,1537,54700,3578764983,3578764987,4
2,1537,54701,3578764983,3578764988,5
2,1537,54702,3578764983,3578764988,5
2,1537,54703,3578764983,3578764989,6
2,1537,54704,3578764983,3578764989,6
2,1537,54705,3578764983,3578764990,7
2,1537,54706,3578764983,3578764990,7
2,1537,54707,3578764983,3578764990,7
2,1537,54708,3578764983,3578764991,8
2,1537,54709,3578764983,3578764991,8
2,1537,54710,3578764983,3578764992,9
2,1537,54711,3578764983,3578764993,10
2,1537,54712,3578764983,3578764998,15
2,1537,54713,3578764983,3578764998,15
2,1537,54714,3578764983,3578765000,17
2,1537,54715,3578764983,3578765000,17
2,1537,54716,3578764983,3578765001,18
2,1537,54717,3578764983,3578765003,20
2,1537,54718,3578764983,3578765003,20
2,1537,54719,3578764983,3578765004,21
2,1537,54720,3578764983,3578765004,21
2,1537,54721,3578764983,3578765006,23
2,1537,54722,3578764983,3578765007,24
2,1537,54723,3578764983,3578765009,26
2,1537,54724,3578764983,3578765011,28
2,1537,54725,3578764983,3578765012,29
2,1537,54726,3578764983,3578765012,29
2,1537,54727,3578764983,3578765013,30
2,1537,54728,3578764983,3578765014,31
2,1537,54729,3578764983,3578765014,31
2,1537,54730,3578764983,3578765015,32
2,1537,54731,3578764983,3578765016,33
2,1537,54732,3578764983,3578765016,33
2,1537,54733,3578764983,3578765016,33
2,1537,54734,3578764983,3578765020,37
2,1537,54735,3578764983,3578765021,38
2,1537,54736,3578764983,3578765021,38
2,1537,54737,3578764983,3578765021,38
2,1537,54738,3578764983,3578765027,44
2,1537,54739,3578764983,3578765027,44
2,1537,54740,3578764983,3578765028,45
2,1537,54741,3578764983,3578765029,46
2,1537,54742,3578764983,3578765031,48
2,1537,54743,3578764983,3578765031,48
2,1537,54744,3578764983,3578765032,49
2,1538,54745,3578765046,3578765046,0
2,1538,54746,3578765046,3578765046,0
2,1538,54747,3578765046,3578765046,0
2,1538,54748,3578765046,3578765046,0
2,1538,54749,3578765046,3578765046,0
2,1538,54750,3578765046,3578765046,0
2,1538,54751,3578765046,3578765046,0
2,1538,54752,3578765046,3578765047,1
2,1538,54753,3578765046,3578765047,1
2,1538,54754,3578765046,3578765047,1
2,1538,54755,3578765046,3578765047,1
2,1538,54756,3578765046,3578765047,1
2,1538,54757,3578765046,3578765047,1
2,1538,54758,3578765046,3578765047,1
2,1538,54759,3578765046,3578765047,1
2,1538,54760,3578765046,3578765047,1
2,1538,54761,3578765046,3578765047,1
2,1538,54762,3578765046,3578765047,1
2,1538,54763,3578765046,3578765047,1
2,1538,54764,3578765046,3578765047,1
2,1538,54765,3578765046,3578765047,1
2,1538,54766,3578765046,3578765047,1
2,1538,54767,3578765046,3578765047,1
2,1538,54768,3578765046,3578765047,1
2,1538,54769,3578765046,3578765048,2
2,1538,54770,3578765046,3578765049,3
2,1538,54771,3578765046,3578765049,3
2,1538,54772,3578765046,3578765049,3
2,1538,54773,3578765046,3578765050,4
2,1538,54774,3578765046,3578765050,4
2,1538,54775,3578765046,3578765052,6
2,1538,54776,3578765046,3578765053,7
2,1538,54777,3578765046,3578765053,7
2,1538,54778,3578765046,3578765053,7
2,1538,54779,3578765046,3578765054,8
2,1538,54780,3578765046,3578765054,8
2,1538,54781,3578765046,3578765054,8
2,1538,54782,3578765046,3578765055,9
2,1538,54783,3578765046,3578765056,10
2,1538,54784,3578765046,3578765059,13
2,1538,54785,3578765046,3578765060,14
2,1538,54786,3578765046,3578765062,16
2,1538,54787,3578765046,3578765062,16
2,1538,54788,3578765046,3578765064,18
2,1538,54789,3578765046,3578765064,18
2,1538,54790,3578765046,3578765065,19
2,1538,54791,3578765046,3578765065,19
2,1538,54792,3578765046,3578765066,20
2,1538,54793,3578765046,3578765066,20
2,1538,54794,3578765046,3578765067,21
2,1538,54795,3578765046,3578765079,33
2,1538,54796,3578765046,3578765084,38
2,1538,54797,3578765046,3578765085,39
2,1538,54798,3578765046,3578765085,39
2,1538,54799,3578765046,3578765087,41
2,1538,54800,3578765046,3578765088,42
2,1538,54801,3578765046,3578765089,43
2,1538,54802,3578765046,3578765090,44
2,1538,54803,3578765046,3578765090,44
2,1538,54804,3578765046,3578765091,45
2,1538,54805,3578765046,3578765092,46
2,1538,54806,3578765046,3578765092,46
2,1538,54807,3578765046,3578765093,47
2,1538,54808,3578765046,3578765093,47
2,1538,54809,3578765046,3578765095,49
2,1538,54810,3578765046,3578765095,49
2,1538,54811,3578765046,3578765095,49
2,1538,54812,3578765046,3578765096,50
2,1539,54813,3578765111,3578765111,0
2,1539,54814,3578765111,3578765111,0
2,1539,54815,3578765111,3578765111,0
2,1539,54816,3578765111,3578765111,0
2,1539,54817,3578765111,3578765111,0
2,1539,54818,3578765111,3578765111,0
2,1539,54819,3578765111,3578765111,0
2,1539,54820,3578765111,3578765111,0
2,1539,54821,3578765111,3578765111,0
2,1539,54822,3578765111,3578765111,0
2,1539,54823,3578765111,3578765111,0
2,1539,54824,3578765111,3578765111,0
2,1539,54825,3578765111,3578765111,0
2,1539,54826,3578765111,3578765111,0
2,1539,54827,3578765111,3578765111,0
2,1539,54828,3578765111,3578765111,0
2,1539,54829,3578765111,3578765111,0
2,1539,54830,3578765111,3578765111,0
2,1539,54831,3578765111,3578765111,0
2,1539,54832,3578765111,3578765111,0
2,1539,54833,3578765111,3578765111,0
2,1539,54834,3578765111,3578765112,1
2,1539,54835,3578765111,3578765113,2
2,1539,54836,3578765111,3578765113,2
2,1539,54837,3578765111,3578765113,2
2,1539,54838,3578765111,3578765115,4
2,1539,54839,3578765111,3578765115,4
2,1539,54840,3578765111,3578765116,5
2,1539,54841,3578765111,3578765116,5
2,1539,54842,3578765111,3578765116,5
2,1539,54843,3578765111,3578765117,6
2,1539,54844,3578765111,3578765117,6
2,1539,54845,3578765111,3578765117,6
2,1539,54846,3578765111,3578765118,7
2,1539,54847,3578765111,3578765119,8
2,1539,54848,3578765111,3578765119,8
2,1539,54849,3578765111,3578765119,8
2,1539,54850,3578765111,3578765121,10
2,1539,54851,3578765111,3578765122,11
2,1539,54852,3578765111,3578765122,11
2,1539,54853,3578765111,3578765123,12
2,1539,54854,3578765111,3578765123,12
2,1539,54855,3578765111,3578765123,12
2,1539,54856,3578765111,3578765125,14
2,1539,54857,3578765111,3578765126,15
2,1539,54858,3578765111,3578765126,15
2,1539,54859,3578765111,3578765126,15
2,1539,54860,3578765111,3578765127,16
2,1539,54861,3578765111,3578765127,16
2,1539,54862,3578765111,3578765131,20
2,1539,54863,3578765111,3578765131,20
2,1539,54864,3578765111,3578765133,22
2,1539,54865,3578765111,3578765133,22
2,1539,54866,3578765111,3578765135,24
2,1539,54867,3578765111,3578765136,25
2,1539,54868,3578765111,3578765136,25
2,1539,54869,3578765111,3578765138,27
2,1539,54870,3578765111,3578765138,27
2,1539,54871,3578765111,3578765139,28
2,1539,54872,3578765111,3578765139,28
2,1539,54873,3578765111,3578765139,28
2,1539,54874,3578765111,3578765140,29
2,1539,54875,3578765111,3578765143,32
2,1539,54876,3578765111,3578765143,32
2,1539,54877,3578765111,3578765145,34
2,1539,54878,3578765111,3578765145,34
2,1539,54879,3578765111,3578765146,35
2,1539,54880,3578765111,3578765148,37
2,1539,54881,3578765111,3578765148,37
2,1539,54882,3578765111,3578765150,39
2,1539,54883,3578765111,3578765150,39
2,1539,54884,3578765111,3578765150,39
2,1539,54885,3578765111,3578765150,39
2,1539,54886,3578765111,3578765151,40
2,1539,54887,3578765111,3578765151,40
2,1539,54888,3578765111,3578765152,41
2,1539,54889,3578765111,3578765153,42
2,1539,54890,3578765111,3578765154,43
2,1539,54891,3578765111,3578765154,43
2,1539,54892,3578765111,3578765155,44
2,1539,54893,3578765111,3578765156,45
2,1539,54894,3578765111,3578765157,46
2,1539,54895,3578765111,3578765157,46
2,1539,54896,3578765111,3578765158,47
2,1539,54897,3578765111,3578765161,50
2,1540,54898,3578765176,3578765176,0
2,1540,54899,3578765176,3578765176,0
2,1540,54900,3578765176,3578765176,0
2,1540,54901,3578765176,3578765176,0
2,1540,54902,3578765176,3578765176,0
2,1540,54903,3578765176,3578765176,0
2,1540,54904,3578765176,3578765176,0
2,1540,54905,3578765176,3578765176,0
2,1540,54906,3578765176,3578765176,0
2,1540,54907,3578765176,3578765176,0
2,1540,54908,3578765176,3578765176,0
2,1540,54909,3578765176,3578765176,0
2,1540,54910,3578765176,3578765176,0
2,1540,54911,3578765176,3578765176,0
2,1540,54912,3578765176,3578765176,0
2,1540,54913,3578765176,3578765177,1
2,1540,54914,3578765176,3578765177,1
2,1540,54915,3578765176,3578765179,3
2,1540,54916,3578765176,3578765180,4
2,1540,54917,3578765176,3578765184,8
2,1540,54918,3578765176,3578765184,8
2,1540,54919,3578765176,3578765184,8
2,1540,54920,3578765176,3578765184,8
2,1540,54921,3578765176,3578765184,8
2,1540,54922,3578765176,3578765185,9
2,1540,54923,3578765176,3578765186,10
2,1540,54924,3578765176,3578765188,12
2,1540,54925,3578765176,3578765188,12
2,1540,54926,3578765176,3578765188,12
2,1540,54927,3578765176,3578765189,13
2,1540,54928,3578765176,3578765189,13
2,1540,54929,3578765176,3578765189,13
2,1540,54930,3578765176,3578765190,14
2,1540,54931,3578765176,3578765191,15
2,1540,54932,3578765176,3578765191,15
2,1540,54933,3578765176,3578765191,15
2,1540,54934,3578765176,3578765192,16
2,1540,54935,3578765176,3578765193,17
2,1540,54936,3578765176,3578765198,22
2,1540,54937,3578765176,3578765198,22
2,1540,54938,3578765176,3578765198,22
2,1540,54939,3578765176,3578765200,24
2,1540,54940,3578765176,3578765202,26
2,1540,54941,3578765176,3578765202,26
2,1540,54942,3578765176,3578765203,27
2,1540,54943,3578765176,3578765203,27
2,1540,54944,3578765176,3578765204,28
2,1540,54945,3578765176,3578765204,28
2,1540,54946,3578765176,3578765205,29
2,1540,54947,3578765176,3578765206,30
2,1540,54948,3578765176,3578765207,31
2,1540,54949,3578765176,3578765209,33
2,1540,54950,3578765176,3578765211,35
2,1540,54951,3578765176,3578765212,36
2,1540,54952,3578765176,3578765213,37
2,1540,54953,3578765176,3578765214,38
2,1540,54954,3578765176,3578765214,38
2,1540,54955,3578765176,3578765215,39
2,1540,54956,3578765176,3578765215,39
2,1540,54957,3578765176,3578765216,40
2,1540,54958,3578765176,3578765218,42
2,1540,54959,3578765176,3578765221,45
2,1540,54960,3578765176,3578765221,45
2,1540,54961,3578765176,3578765221,45
2,1540,54962,3578765176,3578765222,46
2,1540,54963,3578765176,3578765225,49
2,1540,54964,3578765176,3578765225,49
2,1540,54965,3578765176,3578765226,50
2,1541,54966,3578765241,3578765241,0
2,1541,54967,3578765241,3578765241,0
2,1541,54968,3578765241,3578765241,0
2,1541,54969,3578765241,3578765241,0
2,1541,54970,3578765241,3578765241,0
2,1541,54971,3578765241,3578765241,0
2,1541,54972,3578765241,3578765241,0
2,1541,54973,3578765241,3578765241,0
2,1541,54974,3578765241,3578765241,0
2,1541,54975,3578765241,3578765241,0
2,1541,54976,3578765241,3578765241,0
2,1541,54977,3578765241,3578765241,0
2,1541,54978,3578765241,3578765241,0
2,1541,54979,3578765241,3578765241,0
2,1541,54980,3578765241,3578765242,1
2,1541,54981,3578765241,3578765242,1
2,1541,54982,3578765241,3578765242,1
2,1541,54983,3578765241,3578765242,1
2,1541,54984,3578765241,3578765242,1
2,1541,54985,3578765241,3578765242,1
2,1541,54986,3578765241,3578765242,1
2,1541,54987,3578765241,3578765242,1
2,1541,54988,3578765241,3578765242,1
2,1541,54989,3578765241,3578765242,1
2,1541,54990,3578765241,3578765242,1
2,1541,54991,3578765241,3578765243,2
2,1541,54992,3578765241,3578765243,2
2,1541,54993,3578765241,3578765244,3
2,1541,54994,3578765241,3578765246,5
2,1541,54995,3578765241,3578765246,5
2,1541,54996,3578765241,3578765246,5
2,1541,54997,3578765241,3578765246,5
2,1541,54998,3578765241,3578765248,7
2,1541,54999,3578765241,3578765248,7
2,1541,55000,3578765241,3578765249,8
2,1541,55001,3578765241,3578765249,8
2,1541,55002,3578765241,3578765250,9
2,1541,55003,3578765241,3578765251,10
2,1541,55004,3578765241,3578765252,11
2,1541,55005,3578765241,3578765253,12
2,1541,55006,3578765241,3578765254,13
2,1541,55007,3578765241,3578765255,14
2,1541,55008,3578765241,3578765255,14
2,1541,55009,3578765241,3578765255,14
2,1541,55010,3578765241,3578765257,16
2,1541,55011,3578765241,3578765259,18
2,1541,55012,3578765241,3578765260,19
2,1541,55013,3578765241,3578765261,20
2,1541,55014,3578765241,3578765262,21
2,1541,55015,3578765241,3578765264,23
2,1541,55016,3578765241,3578765265,24
2,1541,55017,3578765241,3578765265,24
2,1541,55018,3578765241,3578765265,24
2,1541,55019,3578765241,3578765265,24
2,1541,55020,3578765241,3578765267,26
2,1541,55021,3578765241,3578765268,27
2,1541,55022,3578765241,3578765278,37
2,1541,55023,3578765241,3578765284,43
2,1541,55024,3578765241,3578765285,44
2,1541,55025,3578765241,3578765285,44
2,1541,55026,3578765241,3578765288,47
2,1541,55027,3578765241,3578765289,48
2,1541,55028,3578765241,3578765290,49
2,1541,55029,3578765241,3578765290,49
2,1541,55030,3578765241,3578765291,50
2,1542,55031,3578765305,3578765305,0
2,1542,55032,3578765305,3578765305,0
2,1542,55033,3578765305,3578765306,1
2,1542,55034,3578765305,3578765306,1
2,1542,55035,3578765305,3578765306,1
2,1542,55036,3578765305,3578765306,1
2,1542,55037,3578765305,3578765306,1
2,1542,55038,3578765305,3578765306,1
2,1542,55039,3578765305,3578765306,1
2,1542,55040,3578765305,3578765306,1
2,1542,55041,3578765305,3578765306,1
2,1542,55042,3578765305,3578765306,1
2,1542,55043,3578765305,3578765306,1
2,1542,55044,3578765305,3578765306,1
2,1542,55045,3578765305,3578765306,1
2,1542,55046,3578765305,3578765306,1
2,1542,55047,3578765305,3578765306,1
2,1542,55048,3578765305,3578765306,1
2,1542,55049,3578765305,3578765306,1
2,1542,55050,3578765305,3578765306,1
2,1542,55051,3578765305,3578765306,1
2,1542,55052,3578765305,3578765306,1
2,1542,55053,3578765305,3578765306,1
2,1542,55054,3578765305,3578765306,1
2,1542,55055,3578765305,3578765306,1
2,1542,55056,3578765305,3578765307,2
2,1542,55057,3578765305,3578765308,3
2,1542,55058,3578765305,3578765309,4
2,1542,55059,3578765305,3578765310,5
2,1542,55060,3578765305,3578765311,6
2,1542,55061,3578765305,3578765311,6
2,1542,55062,3578765305,3578765314,9
2,1542,55063,3578765305,3578765314,9
2,1542,55064,3578765305,3578765315,10
2,1542,55065,3578765305,3578765316,11
2,1542,55066,3578765305,3578765316,11
2,1542,55067,3578765305,3578765316,11
2,1542,55068,3578765305,3578765317,12
2,1542,55069,3578765305,3578765317,12
2,1542,55070,3578765305,3578765317,12
2,1542,55071,3578765305,3578765318,13
2,1542,55072,3578765305,3578765318,13
2,1542,55073,3578765305,3578765319,14
2,1542,55074,3578765305,3578765322,17
2,1542,55075,3578765305,3578765322,17
2,1542,55076,3578765305,3578765322,17
2,1542,55077,3578765305,3578765323,18
2,1542,55078,3578765305,3578765323,18
2,1542,55079,3578765305,3578765323,18
2,1542,55080,3578765305,3578765326,21
2,1542,55081,3578765305,3578765326,21
2,1542,55082,3578765305,3578765326,21
2,1542,55083,3578765305,3578765326,21
2,1542,55084,3578765305,3578765327,22
2,1542,55085,3578765305,3578765327,22
2,1542,55086,3578765305,3578765331,26
2,1542,55087,3578765305,3578765331,26
2,1542,55088,3578765305,3578765332,27
2,1542,55089,3578765305,3578765333,28
2,1542,55090,3578765305,3578765334,29
2,1542,55091,3578765305,3578765335,30
2,1542,55092,3578765305,3578765336,31
2,1542,55093,3578765305,3578765337,32
2,1542,55094,3578765305,3578765338,33
2,1542,55095,3578765305,3578765338,33
2,1542,55096,3578765305,3578765338,33
2,1542,55097,3578765305,3578765339,34
2,1542,55098,3578765305,3578765340,35
2,1542,55099,3578765305,3578765341,36
2,1542,55100,3578765305,3578765343,38
2,1542,55101,3578765305,3578765343,38
2,1542,55102,3578765305,3578765345,40
2,1542,55103,3578765305,3578765345,40
2,1542,55104,3578765305,3578765345,40
2,1542,55105,3578765305,3578765347,42
2,1542,55106,3578765305,3578765348,43
2,1542,55107,3578765305,3578765350,45
2,1542,55108,3578765305,3578765350,45
2,1542,55109,3578765305,3578765350,45
2,1542,55110,3578765305,3578765351,46
2,1542,55111,3578765305,3578765352,47
2,1542,55112,3578765305,3578765354,49
2,1542,55113,3578765305,3578765354,49
2,1542,55114,3578765305,3578765354,49
2,1542,55115,3578765305,3578765355,50
2,1543,55116,3578765369,3578765369,0
2,1543,55117,3578765369,3578765369,0
2,1543,55118,3578765369,3578765369,0
2,1543,55119,3578765369,3578765369,0
2,1543,55120,3578765369,3578765369,0
2,1543,55121,3578765369,3578765369,0
2,1543,55122,3578765369,3578765369,0
2,1543,55123,3578765369,3578765369,0
2,1543,55124,3578765369,3578765369,0
2,1543,55125,3578765369,3578765369,0
2,1543,55126,3578765369,3578765369,0
2,1543,55127,3578765369,3578765369,0
2,1543,55128,3578765369,3578765369,0
2,1543,55129,3578765369,3578765370,1
2,1543,55130,3578765369,3578765371,2
2,1543,55131,3578765369,3578765372,3
2,1543,55132,3578765369,3578765374,5
2,1543,55133,3578765369,3578765374,5
2,1543,55134,3578765369,3578765375,6
2,1543,55135,3578765369,3578765377,8
2,1543,55136,3578765369,3578765377,8
2,1543,55137,3578765369,3578765377,8
2,1543,55138,3578765369,3578765380,11
2,1543,55139,3578765369,3578765383,14
2,1543,55140,3578765369,3578765384,15
2,1543,55141,3578765369,3578765384,15
2,1543,55142,3578765369,3578765384,15
2,1543,55143,3578765369,3578765385,16
2,1543,55144,3578765369,3578765385,16
2,1543,55145,3578765369,3578765385,16
2,1543,55146,3578765369,3578765387,18
2,1543,55147,3578765369,3578765388,19
2,1543,55148,3578765369,3578765388,19
2,1543,55149,3578765369,3578765389,20
2,1543,55150,3578765369,3578765389,20
2,1543,55151,3578765369,3578765390,21
2,1543,55152,3578765369,3578765390,21
2,1543,55153,3578765369,3578765391,22
2,1543,55154,3578765369,3578765391,22
2,1543,55155,3578765369,3578765392,23
2,1543,55156,3578765369,3578765392,23
2,1543,55157,3578765369,3578765394,25
2,1543,55158,3578765369,3578765398,29
2,1543,55159,3578765369,3578765399,30
2,1543,55160,3578765369,3578765401,32
2,1543,55161,3578765369,3578765402,33
2,1543,55162,3578765369,3578765403,34
2,1543,55163,3578765369,3578765403,34
2,1543,55164,3578765369,3578765404,35
2,1543,55165,3578765369,3578765404,35
2,1543,55166,3578765369,3578765405,36
2,1543,55167,3578765369,3578765405,36
2,1543,55168,3578765369,3578765406,37
2,1543,55169,3578765369,3578765407,38
2,1543,55170,3578765369,3578765411,42
2,1543,55171,3578765369,3578765412,43
2,1543,55172,3578765369,3578765413,44
2,1543,55173,3578765369,3578765415,46
2,1543,55174,3578765369,3578765417,48
2,1543,55175,3578765369,3578765417,48
2,1543,55176,3578765369,3578765417,48
2,1544,55177,3578765434,3578765434,0
2,1544,55178,3578765434,3578765434,0
2,1544,55179,3578765434,3578765434,0
2,1544,55180,3578765434,3578765434,0
2,1544,55181,3578765434,3578765434,0
2,1544,55182,3578765434,3578765434,0
2,1544,55183,3578765434,3578765434,0
2,1544,55184,3578765434,3578765434,0
2,1544,55185,3578765434,3578765434,0
2,1544,55186,3578765434,3578765434,0
2,1544,55187,3578765434,3578765434,0
2,1544,55188,3578765434,3578765434,0
2,1544,55189,3578765434,3578765434,0
2,1544,55190,3578765434,3578765434,0
2,1544,55191,3578765434,3578765434,0
2,1544,55192,3578765434,3578765434,0
2,1544,55193,3578765434,3578765434,0
2,1544,55194,3578765434,3578765434,0
2,1544,55195,3578765434,3578765434,0
2,1544,55196,3578765434,3578765436,2
2,1544,55197,3578765434,3578765437,3
2,1544,55198,3578765434,3578765438,4
2,1544,55199,3578765434,3578765438,4
2,1544,55200,3578765434,3578765439,5
2,1544,55201,3578765434,3578765439,5
2,1544,55202,3578765434,3578765440,6
2,1544,55203,3578765434,3578765440,6
2,1544,55204,3578765434,3578765441,7
2,1544,55205,3578765434,3578765442,8
2,1544,55206,3578765434,3578765442,8
2,1544,55207,3578765434,3578765442,8
2,1544,55208,3578765434,3578765443,9
2,1544,55209,3578765434,3578765443,9
2,1544,55210,3578765434,3578765445,11
2,1544,55211,3578765434,3578765446,12
2,1544,55212,3578765434,3578765447,13
2,1544,55213,3578765434,3578765448,14
2,1544,55214,3578765434,3578765449,15
2,1544,55215,3578765434,3578765449,15
2,1544,55216,3578765434,3578765450,16
2,1544,55217,3578765434,3578765450,16
2,1544,55218,3578765434,3578765451,17
2,1544,55219,3578765434,3578765451,17
2,1544,55220,3578765434,3578765452,18
2,1544,55221,3578765434,3578765453,19
2,1544,55222,3578765434,3578765454,20
2,1544,55223,3578765434,3578765454,20
2,1544,55224,3578765434,3578765455,21
2,1544,55225,3578765434,3578765455,21
2,1544,55226,3578765434,3578765456,22
2,1544,55227,3578765434,3578765460,26
2,1544,55228,3578765434,3578765460,26
2,1544,55229,3578765434,3578765462,28
2,1544,55230,3578765434,3578765463,29
2,1544,55231,3578765434,3578765464,30
2,1544,55232,3578765434,3578765465,31
2,1544,55233,3578765434,3578765466,32
2,1544,55234,3578765434,3578765466,32
2,1544,55235,3578765434,3578765468,34
2,1544,55236,3578765434,3578765468,34
2,1544,55237,3578765434,3578765479,45
2,1545,55238,3578765499,3578765499,0
2,1545,55239,3578765499,3578765499,0
2,1545,55240,3578765499,3578765499,0
2,1545,55241,3578765499,3578765499,0
2,1545,55242,3578765499,3578765499,0
2,1545,55243,3578765499,3578765499,0
2,1545,55244,3578765499,3578765499,0
2,1545,55245,3578765499,3578765499,0
2,1545,55246,3578765499,3578765499,0
2,1545,55247,3578765499,3578765499,0
2,1545,55248,3578765499,3578765499,0
2,1545,55249,3578765499,3578765499,0
2,1545,55250,3578765499,3578765499,0
2,1545,55251,3578765499,3578765499,0
2,1545,55252,3578765499,3578765499,0
2,1545,55253,3578765499,3578765499,0
2,1545,55254,3578765499,3578765499,0
2,1545,55255,3578765499,3578765499,0
2,1545,55256,3578765499,3578765499,0
2,1545,55257,3578765499,3578765499,0
2,1545,55258,3578765499,3578765499,0
2,1545,55259,3578765499,3578765499,0
2,1545,55260,3578765499,3578765500,1
2,1545,55261,3578765499,3578765501,2
2,1545,55262,3578765499,3578765501,2
2,1545,55263,3578765499,3578765501,2
2,1545,55264,3578765499,3578765501,2
2,1545,55265,3578765499,3578765502,3
2,1545,55266,3578765499,3578765502,3
2,1545,55267,3578765499,3578765504,5
2,1545,55268,3578765499,3578765505,6
2,1545,55269,3578765499,3578765505,6
2,1545,55270,3578765499,3578765505,6
2,1545,55271,3578765499,3578765505,6
2,1545,55272,3578765499,3578765507,8
2,1545,55273,3578765499,3578765508,9
2,1545,55274,3578765499,3578765509,10
2,1545,55275,3578765499,3578765510,11
2,1545,55276,3578765499,3578765511,12
2,1545,55277,3578765499,3578765512,13
2,1545,55278,3578765499,3578765513,14
2,1545,55279,3578765499,3578765514,15
2,1545,55280,3578765499,3578765515,16
2,1545,55281,3578765499,3578765515,16
2,1545,55282,3578765499,3578765515,16
2,1545,55283,3578765499,3578765516,17
2,1545,55284,3578765499,3578765516,17
2,1545,55285,3578765499,3578765516,17
2,1545,55286,3578765499,3578765517,18
2,1545,55287,3578765499,3578765517,18
2,1545,55288,3578765499,3578765517,18
2,1545,55289,3578765499,3578765518,19
2,1545,55290,3578765499,3578765520,21
2,1545,55291,3578765499,3578765520,21
2,1545,55292,3578765499,3578765521,22
2,1545,55293,3578765499,3578765521,22
2,1545,55294,3578765499,3578765522,23
2,1545,55295,3578765499,3578765524,25
2,1545,55296,3578765499,3578765525,26
2,1545,55297,3578765499,3578765526,27
2,1545,55298,3578765499,3578765526,27
2,1545,55299,3578765499,3578765526,27
2,1545,55300,3578765499,3578765527,28
2,1545,55301,3578765499,3578765530,31
2,1545,55302,3578765499,3578765530,31
2,1545,55303,3578765499,3578765530,31
2,1545,55304,3578765499,3578765532,33
2,1545,55305,3578765499,3578765532,33
2,1545,55306,3578765499,3578765534,35
2,1545,55307,3578765499,3578765535,36
2,1545,55308,3578765499,3578765535,36
2,1545,55309,3578765499,3578765536,37
2,1545,55310,3578765499,3578765537,38
2,1545,55311,3578765499,3578765537,38
2,1545,55312,3578765499,3578765537,38
2,1545,55313,3578765499,3578765538,39
2,1545,55314,3578765499,3578765539,40
2,1545,55315,3578765499,3578765540,41
2,1545,55316,3578765499,3578765543,44
2,1545,55317,3578765499,3578765544,45
2,1545,55318,3578765499,3578765544,45
2,1545,55319,3578765499,3578765545,46
2,1545,55320,3578765499,3578765546,47
2,1545,55321,3578765499,3578765547,48
2,1545,55322,3578765499,3578765549,50
2,1545,55323,3578765499,3578765549,50
2,1546,55324,3578765564,3578765564,0
2,1546,55325,3578765564,3578765564,0
2,1546,55326,3578765564,3578765564,0
2,1546,55327,3578765564,3578765564,0
2,1546,55328,3578765564,3578765564,0
2,1546,55329,3578765564,3578765564,0
2,1546,55330,3578765564,3578765564,0
2,1546,55331,3578765564,3578765564,0
2,1546,55332,3578765564,3578765564,0
2,1546,55333,3578765564,3578765564,0
2,1546,55334,3578765564,3578765564,0
2,1546,55335,3578765564,3578765564,0
2,1546,55336,3578765564,3578765564,0
2,1546,55337,3578765564,3578765564,0
2,1546,55338,3578765564,3578765564,0
2,1546,55339,3578765564,3578765564,0
2,1546,55340,3578765564,3578765564,0
2,1546,55341,3578765564,3578765565,1
2,1546,55342,3578765564,3578765565,1
2,1546,55343,3578765564,3578765566,2
2,1546,55344,3578765564,3578765567,3
2,1546,55345,3578765564,3578765569,5
2,1546,55346,3578765564,3578765569,5
2,1546,55347,3578765564,3578765569,5
2,1546,55348,3578765564,3578765571,7
2,1546,55349,3578765564,3578765572,8
2,1546,55350,3578765564,3578765573,9
2,1546,55351,3578765564,3578765573,9
2,1546,55352,3578765564,3578765574,10
2,1546,55353,3578765564,3578765575,11
2,1546,55354,3578765564,3578765576,12
2,1546,55355,3578765564,3578765578,14
2,1546,55356,3578765564,3578765579,15
2,1546,55357,3578765564,3578765582,18
2,1546,55358,3578765564,3578765583,19
2,1546,55359,3578765564,3578765583,19
2,1546,55360,3578765564,3578765584,20
2,1546,55361,3578765564,3578765584,20
2,1546,55362,3578765564,3578765584,20
2,1546,55363,3578765564,3578765585,21
2,1546,55364,3578765564,3578765587,23
2,1546,55365,3578765564,3578765587,23
2,1546,55366,3578765564,3578765587,23
2,1546,55367,3578765564,3578765588,24
2,1546,55368,3578765564,3578765588,24
2,1546,55369,3578765564,3578765588,24
2,1546,55370,3578765564,3578765588,24
2,1546,55371,3578765564,3578765588,24
2,1546,55372,3578765564,3578765588,24
2,1546,55373,3578765564,3578765589,25
2,1546,55374,3578765564,3578765589,25
2,1546,55375,3578765564,3578765590,26
2,1546,55376,3578765564,3578765591,27
2,1546,55377,3578765564,3578765591,27
2,1546,55378,3578765564,3578765593,29
2,1546,55379,3578765564,3578765597,33
2,1546,55380,3578765564,3578765597,33
2,1546,55381,3578765564,3578765600,36
2,1546,55382,3578765564,3578765602,38
2,1546,55383,3578765564,3578765602,38
2,1546,55384,3578765564,3578765602,38
2,1546,55385,3578765564,3578765602,38
2,1546,55386,3578765564,3578765603,39
2,1546,55387,3578765564,3578765604,40
2,1546,55388,3578765564,3578765604,40
2,1546,55389,3578765564,3578765605,41
2,1546,55390,3578765564,3578765606,42
2,1546,55391,3578765564,3578765606,42
2,1546,55392,3578765564,3578765610,46
2,1546,55393,3578765564,3578765611,47
2,1546,55394,3578765564,3578765613,49
2,1547,55395,3578765627,3578765627,0
2,1547,55396,3578765627,3578765627,0
2,1547,55397,3578765627,3578765627,0
2,1547,55398,3578765627,3578765627,0
2,1547,55399,3578765627,3578765627,0
2,1547,55400,3578765627,3578765627,0
2,1547,55401,3578765627,3578765627,0
2,1547,55402,3578765627,3578765627,0
2,1547,55403,3578765627,3578765627,0
2,1547,55404,3578765627,3578765627,0
2,1547,55405,3578765627,3578765627,0
2,1547,55406,3578765627,3578765627,0
2,1547,55407,3578765627,3578765628,1
2,1547,55408,3578765627,3578765628,1
2,1547,55409,3578765627,3578765628,1
2,1547,55410,3578765627,3578765631,4
2,1547,55411,3578765627,3578765631,4
2,1547,55412,3578765627,3578765632,5
2,1547,55413,3578765627,3578765632,5
2,1547,55414,3578765627,3578765632,5
2,1547,55415,3578765627,3578765633,6
2,1547,55416,3578765627,3578765633,6
2,1547,55417,3578765627,3578765633,6
2,1547,55418,3578765627,3578765633,6
2,1547,55419,3578765627,3578765636,9
2,1547,55420,3578765627,3578765637,10
2,1547,55421,3578765627,3578765637,10
2,1547,55422,3578765627,3578765638,11
2,1547,55423,3578765627,3578765638,11
2,1547,55424,3578765627,3578765639,12
2,1547,55425,3578765627,3578765639,12
2,1547,55426,3578765627,3578765640,13
2,1547,55427,3578765627,3578765640,13
2,1547,55428,3578765627,3578765641,14
2,1547,55429,3578765627,3578765641,14
2,1547,55430,3578765627,3578765642,15
2,1547,55431,3578765627,3578765643,16
2,1547,55432,3578765627,3578765644,17
2,1547,55433,3578765627,3578765644,17
2,1547,55434,3578765627,3578765645,18
2,1547,55435,3578765627,3578765646,19
2,1547,55436,3578765627,3578765647,20
2,1547,55437,3578765627,3578765648,21
2,1547,55438,3578765627,3578765649,22
2,1547,55439,3578765627,3578765649,22
2,1547,55440,3578765627,3578765649,22
2,1547,55441,3578765627,3578765650,23
2,1547,55442,3578765627,3578765651,24
2,1547,55443,3578765627,3578765651,24
2,1547,55444,3578765627,3578765652,25
2,1547,55445,3578765627,3578765654,27
2,1547,55446,3578765627,3578765654,27
2,1547,55447,3578765627,3578765654,27
2,1547,55448,3578765627,3578765655,28
2,1547,55449,3578765627,3578765656,29
2,1547,55450,3578765627,3578765658,31
2,1547,55451,3578765627,3578765659,32
2,1547,55452,3578765627,3578765661,34
2,1547,55453,3578765627,3578765661,34
2,1547,55454,3578765627,3578765663,36
2,1547,55455,3578765627,3578765664,37
2,1547,55456,3578765627,3578765665,38
2,1547,55457,3578765627,3578765665,38
2,1547,55458,3578765627,3578765666,39
2,1547,55459,3578765627,3578765667,40
2,1548,55460,3578765691,3578765691,0
2,1548,55461,3578765691,3578765691,0
2,1548,55462,3578765691,3578765691,0
2,1548,55463,3578765691,3578765691,0
2,1548,55464,3578765691,3578765691,0
2,1548,55465,3578765691,3578765691,0
2,1548,55466,3578765691,3578765691,0
2,1548,55467,3578765691,3578765691,0
2,1548,55468,3578765691,3578765692,1
2,1548,55469,3578765691,3578765692,1
2,1548,55470,3578765691,3578765692,1
2,1548,55471,3578765691,3578765694,3
2,1548,55472,3578765691,3578765695,4
2,1548,55473,3578765691,3578765695,4
2,1548,55474,3578765691,3578765698,7
2,1548,55475,3578765691,3578765698,7
2,1548,55476,3578765691,3578765698,7
2,1548,55477,3578765691,3578765698,7
2,1548,55478,3578765691,3578765698,7
2,1548,55479,3578765691,3578765699,8
2,1548,55480,3578765691,3578765700,9
2,1548,55481,3578765691,3578765700,9
2,1548,55482,3578765691,3578765701,10
2,1548,55483,3578765691,3578765701,10
2,1548,55484,3578765691,3578765701,10
2,1548,55485,3578765691,3578765702,11
2,1548,55486,3578765691,3578765702,11
2,1548,55487,3578765691,3578765704,13
2,1548,55488,3578765691,3578765704,13
2,1548,55489,3578765691,3578765705,14
2,1548,55490,3578765691,3578765705,14
2,1548,55491,3578765691,3578765705,14
2,1548,55492,3578765691,3578765707,16
2,1548,55493,3578765691,3578765708,17
2,1548,55494,3578765691,3578765709,18
2,1548,55495,3578765691,3578765709,18
2,1548,55496,3578765691,3578765710,19
2,1548,55497,3578765691,3578765712,21
2,1548,55498,3578765691,3578765713,22
2,1548,55499,3578765691,3578765714,23
2,1548,55500,3578765691,3578765715,24
2,1548,55501,3578765691,3578765715,24
2,1548,55502,3578765691,3578765715,24
2,1548,55503,3578765691,3578765715,24
2,1548,55504,3578765691,3578765716,25
2,1548,55505,3578765691,3578765716,25
2,1548,55506,3578765691,3578765717,26
2,1548,55507,3578765691,3578765718,27
2,1548,55508,3578765691,3578765719,28
2,1548,55509,3578765691,3578765720,29
2,1548,55510,3578765691,3578765721,30
2,1548,55511,3578765691,3578765722,31
2,1548,55512,3578765691,3578765722,31
2,1548,55513,3578765691,3578765725,34
2,1548,55514,3578765691,3578765725,34
2,1548,55515,3578765691,3578765726,35
2,1548,55516,3578765691,3578765727,36
2,1548,55517,3578765691,3578765727,36
2,1548,55518,3578765691,3578765727,36
2,1548,55519,3578765691,3578765729,38
2,1548,55520,3578765691,3578765730,39
2,1548,55521,3578765691,3578765733,42
2,1548,55522,3578765691,3578765733,42
2,1548,55523,3578765691,3578765734,43
2,1548,55524,3578765691,3578765736,45
2,1548,55525,3578765691,3578765736,45
2,1548,55526,3578765691,3578765737,46
2,1548,55527,3578765691,3578765737,46
2,1548,55528,3578765691,3578765738,47
2,1548,55529,3578765691,3578765738,47
2,1548,55530,3578765691,3578765739,48
2,1548,55531,3578765691,3578765740,49
2,1548,55532,3578765691,3578765740,49
2,1549,55533,3578765754,3578765754,0
2,1549,55534,3578765754,3578765754,0
2,1549,55535,3578765754,3578765754,0
2,1549,55536,3578765754,3578765754,0
2,1549,55537,3578765754,3578765754,0
2,1549,55538,3578765754,3578765754,0
2,1549,55539,3578765754,3578765754,0
2,1549,55540,3578765754,3578765754,0
2,1549,55541,3578765754,3578765755,1
2,1549,55542,3578765754,3578765755,1
2,1549,55543,3578765754,3578765755,1
2,1549,55544,3578765754,3578765755,1
2,1549,55545,3578765754,3578765755,1
2,1549,55546,3578765754,3578765755,1
2,1549,55547,3578765754,3578765755,1
2,1549,55548,3578765754,3578765756,2
2,1549,55549,3578765754,3578765756,2
2,1549,55550,3578765754,3578765757,3
2,1549,55551,3578765754,3578765757,3
2,1549,55552,3578765754,3578765758,4
2,1549,55553,3578765754,3578765762,8
2,1549,55554,3578765754,3578765762,8
2,1549,55555,3578765754,3578765763,9
2,1549,55556,3578765754,3578765763,9
2,1549,55557,3578765754,3578765765,11
2,1549,55558,3578765754,3578765765,11
2,1549,55559,3578765754,3578765766,12
2,1549,55560,3578765754,3578765768,14
2,1549,55561,3578765754,3578765769,15
2,1549,55562,3578765754,3578765770,16
2,1549,55563,3578765754,3578765770,16
2,1549,55564,3578765754,3578765770,16
2,1549,55565,3578765754,3578765773,19
2,1549,55566,3578765754,3578765774,20
2,1549,55567,3578765754,3578765774,20
2,1549,55568,3578765754,3578765774,20
2,1549,55569,3578765754,3578765776,22
2,1549,55570,3578765754,3578765776,22
2,1549,55571,3578765754,3578765778,24
2,1549,55572,3578765754,3578765779,25
2,1549,55573,3578765754,3578765782,28
2,1549,55574,3578765754,3578765783,29
2,1549,55575,3578765754,3578765784,30
2,1549,55576,3578765754,3578765784,30
2,1549,55577,3578765754,3578765784,30
2,1549,55578,3578765754,3578765785,31
2,1549,55579,3578765754,3578765785,31
2,1549,55580,3578765754,3578765787,33
2,1549,55581,3578765754,3578765787,33
2,1549,55582,3578765754,3578765788,34
2,1549,55583,3578765754,3578765788,34
2,1549,55584,3578765754,3578765788,34
2,1549,55585,3578765754,3578765788,34
2,1549,55586,3578765754,3578765789,35
2,1549,55587,3578765754,3578765789,35
2,1549,55588,3578765754,3578765789,35
2,1549,55589,3578765754,3578765790,36
2,1549,55590,3578765754,3578765790,36
2,1549,55591,3578765754,3578765790,36
2,1549,55592,3578765754,3578765791,37
2,1549,55593,3578765754,3578765791,37
2,1549,55594,3578765754,3578765792,38
2,1549,55595,3578765754,3578765793,39
2,1549,55596,3578765754,3578765797,43
2,1549,55597,3578765754,3578765797,43
2,1549,55598,3578765754,3578765801,47
2,1549,55599,3578765754,3578765802,48
2,1549,55600,3578765754,3578765802,48
2,1549,55601,3578765754,3578765802,48
2,1549,55602,3578765754,3578765802,48
2,1549,55603,3578765754,3578765803,49
2,1549,55604,3578765754,3578765804,50
2,1550,55605,3578765818,3578765819,1
2,1550,55606,3578765818,3578765819,1
2,1550,55607,3578765818,3578765819,1
2,1550,55608,3578765818,3578765819,1
2,1550,55609,3578765818,3578765819,1
2,1550,55610,3578765818,3578765819,1
2,1550,55611,3578765818,3578765819,1
2,1550,55612,3578765818,3578765819,1
2,1550,55613,3578765818,3578765819,1
2,1550,55614,3578765818,3578765819,1
2,1550,55615,3578765818,3578765819,1
2,1550,55616,3578765818,3578765819,1
2,1550,55617,3578765818,3578765820,2
2,1550,55618,3578765818,3578765820,2
2,1550,55619,3578765818,3578765820,2
2,1550,55620,3578765818,3578765822,4
2,1550,55621,3578765818,3578765824,6
2,1550,55622,3578765818,3578765825,7
2,1550,55623,3578765818,3578765826,8
2,1550,55624,3578765818,3578765828,10
2,1550,55625,3578765818,3578765828,10
2,1550,55626,3578765818,3578765828,10
2,1550,55627,3578765818,3578765829,11
2,1550,55628,3578765818,3578765831,13
2,1550,55629,3578765818,3578765831,13
2,1550,55630,3578765818,3578765831,13
2,1550,55631,3578765818,3578765832,14
2,1550,55632,3578765818,3578765833,15
2,1550,55633,3578765818,3578765833,15
2,1550,55634,3578765818,3578765834,16
2,1550,55635,3578765818,3578765836,18
2,1550,55636,3578765818,3578765836,18
2,1550,55637,3578765818,3578765836,18
2,1550,55638,3578765818,3578765838,20
2,1550,55639,3578765818,3578765838,20
2,1550,55640,3578765818,3578765839,21
2,1550,55641,3578765818,3578765839,21
2,1550,55642,3578765818,3578765840,22
2,1550,55643,3578765818,3578765841,23
2,1550,55644,3578765818,3578765841,23
2,1550,55645,3578765818,3578765841,23
2,1550,55646,3578765818,3578765842,24
2,1550,55647,3578765818,3578765843,25
2,1550,55648,3578765818,3578765843,25
2,1550,55649,3578765818,3578765844,26
2,1550,55650,3578765818,3578765844,26
2,1550,55651,3578765818,3578765845,27
2,1550,55652,3578765818,3578765846,28
2,1550,55653,3578765818,3578765846,28
2,1550,55654,3578765818,3578765847,29
2,1550,55655,3578765818,3578765849,31
2,1550,55656,3578765818,3578765849,31
2,1550,55657,3578765818,3578765850,32
2,1550,55658,3578765818,3578765850,32
2,1550,55659,3578765818,3578765850,32
2,1550,55660,3578765818,3578765851,33
2,1550,55661,3578765818,3578765851,33
2,1550,55662,3578765818,3578765853,35
2,1550,55663,3578765818,3578765853,35
2,1550,55664,3578765818,3578765853,35
2,1550,55665,3578765818,3578765854,36
2,1550,55666,3578765818,3578765854,36
2,1550,55667,3578765818,3578765855,37
2,1550,55668,3578765818,3578765855,37
2,1550,55669,3578765818,3578765858,40
2,1550,55670,3578765818,3578765859,41
2,1550,55671,3578765818,3578765861,43
2,1550,55672,3578765818,3578765862,44
2,1550,55673,3578765818,3578765863,45
2,1550,55674,3578765818,3578765863,45
2,1550,55675,3578765818,3578765865,47
2,1550,55676,3578765818,3578765865,47
2,1550,55677,3578765818,3578765867,49
2,1550,55678,3578765818,3578765867,49
2,1551,55679,3578765883,3578765885,2
2,1551,55680,3578765883,3578765885,2
2,1551,55681,3578765883,3578765889,6
2,1551,55682,3578765883,3578765891,8
2,1551,55683,3578765883,3578765891,8
2,1551,55684,3578765883,3578765891,8
2,1551,55685,3578765883,3578765892,9
2,1551,55686,3578765883,3578765894,11
2,1551,55687,3578765883,3578765895,12
2,1551,55688,3578765883,3578765897,14
2,1551,55689,3578765883,3578765898,15
2,1551,55690,3578765883,3578765898,15
2,1551,55691,3578765883,3578765898,15
2,1551,55692,3578765883,3578765898,15
2,1551,55693,3578765883,3578765899,16
2,1551,55694,3578765883,3578765900,17
2,1551,55695,3578765883,3578765900,17
2,1551,55696,3578765883,3578765900,17
2,1551,55697,3578765883,3578765901,18
2,1551,55698,3578765883,3578765901,18
2,1551,55699,3578765883,3578765901,18
2,1551,55700,3578765883,3578765902,19
2,1551,55701,3578765883,3578765902,19
2,1551,55702,3578765883,3578765904,21
2,1551,55703,3578765883,3578765904,21
2,1551,55704,3578765883,3578765905,22
2,1551,55705,3578765883,3578765905,22
2,1551,55706,3578765883,3578765905,22
2,1551,55707,3578765883,3578765905,22
2,1551,55708,3578765883,3578765907,24
2,1551,55709,3578765883,3578765908,25
2,1551,55710,3578765883,3578765909,26
2,1551,55711,3578765883,3578765909,26
2,1551,55712,3578765883,3578765910,27
2,1551,55713,3578765883,3578765912,29
2,1551,55714,3578765883,3578765913,30
2,1551,55715,3578765883,3578765913,30
2,1551,55716,3578765883,3578765913,30
2,1551,55717,3578765883,3578765914,31
2,1551,55718,3578765883,3578765915,32
2,1551,55719,3578765883,3578765915,32
2,1551,55720,3578765883,3578765915,32
2,1551,55721,3578765883,3578765916,33
2,1551,55722,3578765883,3578765916,33
2,1551,55723,3578765883,3578765917,34
2,1551,55724,3578765883,3578765917,34
2,1551,55725,3578765883,3578765918,35
2,1551,55726,3578765883,3578765919,36
2,1551,55727,3578765883,3578765919,36
2,1551,55728,3578765883,3578765920,37
2,1551,55729,3578765883,3578765922,39
2,1551,55730,3578765883,3578765922,39
2,1551,55731,3578765883,3578765924,41
2,1551,55732,3578765883,3578765925,42
2,1551,55733,3578765883,3578765925,42
2,1551,55734,3578765883,3578765927,44
2,1551,55735,3578765883,3578765927,44
2,1551,55736,3578765883,3578765929,46
2,1551,55737,3578765883,3578765930,47
2,1551,55738,3578765883,3578765931,48
2,1551,55739,3578765883,3578765933,50
2,1552,55740,3578765947,3578765947,0
2,1552,55741,3578765947,3578765947,0
2,1552,55742,3578765947,3578765947,0
2,1552,55743,3578765947,3578765947,0
2,1552,55744,3578765947,3578765947,0
2,1552,55745,3578765947,3578765947,0
2,1552,55746,3578765947,3578765947,0
2,1552,55747,3578765947,3578765947,0
2,1552,55748,3578765947,3578765947,0
2,1552,55749,3578765947,3578765947,0
2,1552,55750,3578765947,3578765947,0
2,1552,55751,3578765947,3578765947,0
2,1552,55752,3578765947,3578765947,0
2,1552,55753,3578765947,3578765947,0
2,1552,55754,3578765947,3578765947,0
2,1552,55755,3578765947,3578765949,2
2,1552,55756,3578765947,3578765950,3
2,1552,55757,3578765947,3578765950,3
2,1552,55758,3578765947,3578765951,4
2,1552,55759,3578765947,3578765951,4
2,1552,55760,3578765947,3578765952,5
2,1552,55761,3578765947,3578765952,5
2,1552,55762,3578765947,3578765953,6
2,1552,55763,3578765947,3578765953,6
2,1552,55764,3578765947,3578765954,7
2,1552,55765,3578765947,3578765956,9
2,1552,55766,3578765947,3578765956,9
2,1552,55767,3578765947,3578765957,10
2,1552,55768,3578765947,3578765958,11
2,1552,55769,3578765947,3578765959,12
2,1552,55770,3578765947,3578765962,15
2,1552,55771,3578765947,3578765964,17
2,1552,55772,3578765947,3578765964,17
2,1552,55773,3578765947,3578765964,17
2,1552,55774,3578765947,3578765965,18
2,1552,55775,3578765947,3578765965,18
2,1552,55776,3578765947,3578765965,18
2,1552,55777,3578765947,3578765966,19
2,1552,55778,3578765947,3578765967,20
2,1552,55779,3578765947,3578765970,23
2,1552,55780,3578765947,3578765971,24
2,1552,55781,3578765947,3578765971,24
2,1552,55782,3578765947,3578765973,26
2,1552,55783,3578765947,3578765974,27
2,1552,55784,3578765947,3578765974,27
2,1552,55785,3578765947,3578765975,28
2,1552,55786,3578765947,3578765976,29
2,1552,55787,3578765947,3578765977,30
2,1552,55788,3578765947,3578765977,30
2,1552,55789,3578765947,3578765979,32
2,1552,55790,3578765947,3578765980,33
2,1552,55791,3578765947,3578765983,36
2,1552,55792,3578765947,3578765984,37
2,1552,55793,3578765947,3578765984,37
2,1552,55794,3578765947,3578765984,37
2,1552,55795,3578765947,3578765985,38
2,1552,55796,3578765947,3578765986,39
2,1552,55797,3578765947,3578765987,40
2,1552,55798,3578765947,3578765987,40
2,1552,55799,3578765947,3578765988,41
2,1552,55800,3578765947,3578765988,41
2,1552,55801,3578765947,3578765989,42
2,1552,55802,3578765947,3578765989,42
2,1552,55803,3578765947,3578765989,42
2,1552,55804,3578765947,3578765989,42
2,1552,55805,3578765947,3578765990,43
2,1552,55806,3578765947,3578765990,43
2,1552,55807,3578765947,3578765990,43
2,1552,55808,3578765947,3578765990,43
2,1552,55809,3578765947,3578765991,44
2,1552,55810,3578765947,3578765991,44
2,1552,55811,3578765947,3578765992,45
2,1552,55812,3578765947,3578765992,45
2,1552,55813,3578765947,3578765997,50
2,1553,55814,3578766010,3578766010,0
2,1553,55815,3578766010,3578766011,1
2,1553,55816,3578766010,3578766011,1
2,1553,55817,3578766010,3578766011,1
2,1553,55818,3578766010,3578766011,1
2,1553,55819,3578766010,3578766011,1
2,1553,55820,3578766010,3578766011,1
2,1553,55821,3578766010,3578766011,1
2,1553,55822,3578766010,3578766011,1
2,1553,55823,3578766010,3578766011,1
2,1553,55824,3578766010,3578766011,1
2,1553,55825,3578766010,3578766011,1
2,1553,55826,3578766010,3578766011,1
2,1553,55827,3578766010,3578766011,1
2,1553,55828,3578766010,3578766011,1
2,1553,55829,3578766010,3578766011,1
2,1553,55830,3578766010,3578766012,2
2,1553,55831,3578766010,3578766013,3
2,1553,55832,3578766010,3578766014,4
2,1553,55833,3578766010,3578766014,4
2,1553,55834,3578766010,3578766015,5
2,1553,55835,3578766010,3578766016,6
2,1553,55836,3578766010,3578766016,6
2,1553,55837,3578766010,3578766017,7
2,1553,55838,3578766010,3578766019,9
2,1553,55839,3578766010,3578766020,10
2,1553,55840,3578766010,3578766021,11
2,1553,55841,3578766010,3578766022,12
2,1553,55842,3578766010,3578766024,14
2,1553,55843,3578766010,3578766026,16
2,1553,55844,3578766010,3578766028,18
2,1553,55845,3578766010,3578766028,18
2,1553,55846,3578766010,3578766029,19
2,1553,55847,3578766010,3578766029,19
2,1553,55848,3578766010,3578766031,21
2,1553,55849,3578766010,3578766032,22
2,1553,55850,3578766010,3578766032,22
2,1553,55851,3578766010,3578766033,23
2,1553,55852,3578766010,3578766033,23
2,1553,55853,3578766010,3578766033,23
2,1553,55854,3578766010,3578766034,24
2,1553,55855,3578766010,3578766036,26
2,1553,55856,3578766010,3578766037,27
2,1553,55857,3578766010,3578766037,27
2,1553,55858,3578766010,3578766037,27
2,1553,55859,3578766010,3578766038,28
2,1553,55860,3578766010,3578766038,28
2,1553,55861,3578766010,3578766039,29
2,1553,55862,3578766010,3578766040,30
2,1553,55863,3578766010,3578766040,30
2,1553,55864,3578766010,3578766040,30
2,1553,55865,3578766010,3578766041,31
2,1553,55866,3578766010,3578766041,31
2,1553,55867,3578766010,3578766042,32
2,1553,55868,3578766010,3578766042,32
2,1553,55869,3578766010,3578766043,33
2,1553,55870,3578766010,3578766043,33
2,1553,55871,3578766010,3578766044,34
2,1553,55872,3578766010,3578766045,35
2,1553,55873,3578766010,3578766045,35
2,1553,55874,3578766010,3578766046,36
2,1553,55875,3578766010,3578766046,36
2,1553,55876,3578766010,3578766047,37
2,1553,55877,3578766010,3578766049,39
2,1553,55878,3578766010,3578766049,39
2,1553,55879,3578766010,3578766050,40
2,1553,55880,3578766010,3578766050,40
2,1553,55881,3578766010,3578766050,40
2,1553,55882,3578766010,3578766051,41
2,1553,55883,3578766010,3578766053,43
2,1553,55884,3578766010,3578766053,43
2,1553,55885,3578766010,3578766053,43
2,1553,55886,3578766010,3578766054,44
2,1553,55887,3578766010,3578766054,44
2,1553,55888,3578766010,3578766055,45
2,1553,55889,3578766010,3578766055,45
2,1553,55890,3578766010,3578766056,46
2,1553,55891,3578766010,3578766060,50
2,1554,55892,3578766074,3578766074,0
2,1554,55893,3578766074,3578766074,0
2,1554,55894,3578766074,3578766074,0
2,1554,55895,3578766074,3578766074,0
2,1554,55896,3578766074,3578766074,0
2,1554,55897,3578766074,3578766074,0
2,1554,55898,3578766074,3578766074,0
2,1554,55899,3578766074,3578766085,11
2,1554,55900,3578766074,3578766086,12
2,1554,55901,3578766074,3578766087,13
2,1554,55902,3578766074,3578766089,15
2,1554,55903,3578766074,3578766089,15
2,1554,55904,3578766074,3578766091,17
2,1554,55905,3578766074,3578766091,17
2,1554,55906,3578766074,3578766091,17
2,1554,55907,3578766074,3578766091,17
2,1554,55908,3578766074,3578766092,18
2,1554,55909,3578766074,3578766094,20
2,1554,55910,3578766074,3578766095,21
2,1554,55911,3578766074,3578766096,22
2,1554,55912,3578766074,3578766096,22
2,1554,55913,3578766074,3578766098,24
2,1554,55914,3578766074,3578766098,24
2,1554,55915,3578766074,3578766098,24
2,1554,55916,3578766074,3578766099,25
2,1554,55917,3578766074,3578766100,26
2,1554,55918,3578766074,3578766101,27
2,1554,55919,3578766074,3578766101,27
2,1554,55920,3578766074,3578766101,27
2,1554,55921,3578766074,3578766102,28
2,1554,55922,3578766074,3578766102,28
2,1554,55923,3578766074,3578766102,28
2,1554,55924,3578766074,3578766104,30
2,1554,55925,3578766074,3578766104,30
2,1554,55926,3578766074,3578766105,31
2,1554,55927,3578766074,3578766105,31
2,1554,55928,3578766074,3578766105,31
2,1554,55929,3578766074,3578766106,32
2,1554,55930,3578766074,3578766107,33
2,1554,55931,3578766074,3578766108,34
2,1554,55932,3578766074,3578766109,35
2,1554,55933,3578766074,3578766109,35
2,1554,55934,3578766074,3578766111,37
2,1554,55935,3578766074,3578766112,38
2,1554,55936,3578766074,3578766112,38
2,1554,55937,3578766074,3578766112,38
2,1554,55938,3578766074,3578766113,39
2,1554,55939,3578766074,3578766114,40
2,1554,55940,3578766074,3578766115,41
2,1554,55941,3578766074,3578766115,41
2,1554,55942,3578766074,3578766115,41
2,1554,55943,3578766074,3578766115,41
2,1554,55944,3578766074,3578766116,42
2,1554,55945,3578766074,3578766117,43
2,1554,55946,3578766074,3578766118,44
2,1554,55947,3578766074,3578766118,44
2,1554,55948,3578766074,3578766118,44
2,1554,55949,3578766074,3578766119,45
2,1554,55950,3578766074,3578766120,46
2,1554,55951,3578766074,3578766122,48
2,1554,55952,3578766074,3578766122,48
2,1554,55953,3578766074,3578766122,48
2,1554,55954,3578766074,3578766123,49
2,1554,55955,3578766074,3578766123,49
2,1555,55956,3578766140,3578766140,0
2,1555,55957,3578766140,3578766140,0
2,1555,55958,3578766140,3578766140,0
2,1555,55959,3578766140,3578766140,0
2,1555,55960,3578766140,3578766140,0
2,1555,55961,3578766140,3578766140,0
2,1555,55962,3578766140,3578766140,0
2,1555,55963,3578766140,3578766140,0
2,1555,55964,3578766140,3578766140,0
2,1555,55965,3578766140,3578766140,0
2,1555,55966,3578766140,3578766140,0
2,1555,55967,3578766140,3578766140,0
2,1555,55968,3578766140,3578766140,0
2,1555,55969,3578766140,3578766140,0
2,1555,55970,3578766140,3578766140,0
2,1555,55971,3578766140,3578766140,0
2,1555,55972,3578766140,3578766140,0
2,1555,55973,3578766140,3578766140,0
2,1555,55974,3578766140,3578766140,0
2,1555,55975,3578766140,3578766141,1
2,1555,55976,3578766140,3578766141,1
2,1555,55977,3578766140,3578766141,1
2,1555,55978,3578766140,3578766142,2
2,1555,55979,3578766140,3578766145,5
2,1555,55980,3578766140,3578766145,5
2,1555,55981,3578766140,3578766145,5
2,1555,55982,3578766140,3578766147,7
2,1555,55983,3578766140,3578766148,8
2,1555,55984,3578766140,3578766150,10
2,1555,55985,3578766140,3578766150,10
2,1555,55986,3578766140,3578766150,10
2,1555,55987,3578766140,3578766150,10
2,1555,55988,3578766140,3578766152,12
2,1555,55989,3578766140,3578766152,12
2,1555,55990,3578766140,3578766153,13
2,1555,55991,3578766140,3578766153,13
2,1555,55992,3578766140,3578766154,14
2,1555,55993,3578766140,3578766155,15
2,1555,55994,3578766140,3578766156,16
2,1555,55995,3578766140,3578766157,17
2,1555,55996,3578766140,3578766158,18
2,1555,55997,3578766140,3578766159,19
2,1555,55998,3578766140,3578766162,22
2,1555,55999,3578766140,3578766163,23
2,1555,56000,3578766140,3578766163,23
2,1555,56001,3578766140,3578766164,24
2,1555,56002,3578766140,3578766164,24
2,1555,56003,3578766140,3578766165,25
2,1555,56004,3578766140,3578766166,26
2,1555,56005,3578766140,3578766166,26
2,1555,56006,3578766140,3578766166,26
2,1555,56007,3578766140,3578766168,28
2,1555,56008,3578766140,3578766170,30
2,1555,56009,3578766140,3578766170,30
2,1555,56010,3578766140,3578766172,32
2,1555,56011,3578766140,3578766173,33
2,1555,56012,3578766140,3578766174,34
2,1555,56013,3578766140,3578766174,34
2,1555,56014,3578766140,3578766175,35
2,1555,56015,3578766140,3578766176,36
2,1555,56016,3578766140,3578766176,36
2,1555,56017,3578766140,3578766178,38
2,1555,56018,3578766140,3578766179,39
2,1555,56019,3578766140,3578766179,39
2,1555,56020,3578766140,3578766183,43
2,1555,56021,3578766140,3578766184,44
2,1555,56022,3578766140,3578766184,44
2,1555,56023,3578766140,3578766184,44
2,1555,56024,3578766140,3578766185,45
2,1555,56025,3578766140,3578766185,45
2,1555,56026,3578766140,3578766185,45
2,1555,56027,3578766140,3578766188,48
2,1555,56028,3578766140,3578766188,48
2,1555,56029,3578766140,3578766188,48
2,1555,56030,3578766140,3578766188,48
2,1555,56031,3578766140,3578766188,48
2,1555,56032,3578766140,3578766188,48
2,1555,56033,3578766140,3578766189,49
2,1556,56034,3578766204,3578766204,0
2,1556,56035,3578766204,3578766204,0
2,1556,56036,3578766204,3578766204,0
2,1556,56037,3578766204,3578766204,0
2,1556,56038,3578766204,3578766204,0
2,1556,56039,3578766204,3578766204,0
2,1556,56040,3578766204,3578766204,0
2,1556,56041,3578766204,3578766204,0
2,1556,56042,3578766204,3578766204,0
2,1556,56043,3578766204,3578766204,0
2,1556,56044,3578766204,3578766204,0
2,1556,56045,3578766204,3578766204,0
2,1556,56046,3578766204,3578766204,0
2,1556,56047,3578766204,3578766204,0
2,1556,56048,3578766204,3578766204,0
2,1556,56049,3578766204,3578766204,0
2,1556,56050,3578766204,3578766204,0
2,1556,56051,3578766204,3578766205,1
2,1556,56052,3578766204,3578766206,2
2,1556,56053,3578766204,3578766206,2
2,1556,56054,3578766204,3578766207,3
2,1556,56055,3578766204,3578766207,3
2,1556,56056,3578766204,3578766212,8
2,1556,56057,3578766204,3578766213,9
2,1556,56058,3578766204,3578766213,9
2,1556,56059,3578766204,3578766214,10
2,1556,56060,3578766204,3578766214,10
2,1556,56061,3578766204,3578766215,11
2,1556,56062,3578766204,3578766216,12
2,1556,56063,3578766204,3578766216,12
2,1556,56064,3578766204,3578766217,13
2,1556,56065,3578766204,3578766219,15
2,1556,56066,3578766204,3578766220,16
2,1556,56067,3578766204,3578766221,17
2,1556,56068,3578766204,3578766222,18
2,1556,56069,3578766204,3578766224,20
2,1556,56070,3578766204,3578766226,22
2,1556,56071,3578766204,3578766227,23
2,1556,56072,3578766204,3578766228,24
2,1556,56073,3578766204,3578766228,24
2,1556,56074,3578766204,3578766229,25
2,1556,56075,3578766204,3578766231,27
2,1556,56076,3578766204,3578766232,28
2,1556,56077,3578766204,3578766232,28
2,1556,56078,3578766204,3578766233,29
2,1556,56079,3578766204,3578766233,29
2,1556,56080,3578766204,3578766234,30
2,1556,56081,3578766204,3578766236,32
2,1556,56082,3578766204,3578766236,32
2,1556,56083,3578766204,3578766237,33
2,1556,56084,3578766204,3578766237,33
2,1556,56085,3578766204,3578766238,34
2,1556,56086,3578766204,3578766239,35
2,1556,56087,3578766204,3578766239,35
2,1556,56088,3578766204,3578766239,35
2,1556,56089,3578766204,3578766240,36
2,1556,56090,3578766204,3578766241,37
2,1556,56091,3578766204,3578766241,37
2,1556,56092,3578766204,3578766241,37
2,1556,56093,3578766204,3578766242,38
2,1556,56094,3578766204,3578766243,39
2,1556,56095,3578766204,3578766244,40
2,1556,56096,3578766204,3578766244,40
2,1556,56097,3578766204,3578766245,41
2,1556,56098,3578766204,3578766246,42
2,1556,56099,3578766204,3578766247,43
2,1556,56100,3578766204,3578766247,43
2,1556,56101,3578766204,3578766247,43
2,1556,56102,3578766204,3578766250,46
2,1556,56103,3578766204,3578766250,46
2,1556,56104,3578766204,3578766250,46
2,1556,56105,3578766204,3578766251,47
2,1556,56106,3578766204,3578766251,47
2,1556,56107,3578766204,3578766252,48
2,1557,56108,3578766269,3578766269,0
2,1557,56109,3578766269,3578766269,0
2,1557,56110,3578766269,3578766269,0
2,1557,56111,3578766269,3578766269,0
2,1557,56112,3578766269,3578766269,0
2,1557,56113,3578766269,3578766269,0
2,1557,56114,3578766269,3578766269,0
2,1557,56115,3578766269,3578766269,0
2,1557,56116,3578766269,3578766269,0
2,1557,56117,3578766269,3578766269,0
2,1557,56118,3578766269,3578766269,0
2,1557,56119,3578766269,3578766269,0
2,1557,56120,3578766269,3578766280,11
2,1557,56121,3578766269,3578766282,13
2,1557,56122,3578766269,3578766285,16
2,1557,56123,3578766269,3578766286,17
2,1557,56124,3578766269,3578766287,18
2,1557,56125,3578766269,3578766288,19
2,1557,56126,3578766269,3578766289,20
2,1557,56127,3578766269,3578766290,21
2,1557,56128,3578766269,3578766291,22
2,1557,56129,3578766269,3578766291,22
2,1557,56130,3578766269,3578766294,25
2,1557,56131,3578766269,3578766295,26
2,1557,56132,3578766269,3578766295,26
2,1557,56133,3578766269,3578766296,27
2,1557,56134,3578766269,3578766296,27
2,1557,56135,3578766269,3578766298,29
2,1557,56136,3578766269,3578766298,29
2,1557,56137,3578766269,3578766298,29
2,1557,56138,3578766269,3578766299,30
2,1557,56139,3578766269,3578766300,31
2,1557,56140,3578766269,3578766300,31
2,1557,56141,3578766269,3578766301,32
2,1557,56142,3578766269,3578766301,32
2,1557,56143,3578766269,3578766301,32
2,1557,56144,3578766269,3578766302,33
2,1557,56145,3578766269,3578766303,34
2,1557,56146,3578766269,3578766304,35
2,1557,56147,3578766269,3578766305,36
2,1557,56148,3578766269,3578766305,36
2,1557,56149,3578766269,3578766306,37
2,1557,56150,3578766269,3578766306,37
2,1557,56151,3578766269,3578766306,37
2,1557,56152,3578766269,3578766308,39
2,1557,56153,3578766269,3578766309,40
2,1557,56154,3578766269,3578766309,40
2,1557,56155,3578766269,3578766310,41
2,1557,56156,3578766269,3578766311,42
2,1557,56157,3578766269,3578766312,43
2,1557,56158,3578766269,3578766313,44
2,1557,56159,3578766269,3578766313,44
2,1557,56160,3578766269,3578766313,44
2,1557,56161,3578766269,3578766314,45
2,1557,56162,3578766269,3578766315,46
2,1557,56163,3578766269,3578766315,46
2,1557,56164,3578766269,3578766315,46
2,1557,56165,3578766269,3578766316,47
2,1557,56166,3578766269,3578766318,49
2,1557,56167,3578766269,3578766318,49
2,1557,56168,3578766269,3578766318,49
2,1557,56169,3578766269,3578766318,49
2,1557,56170,3578766269,3578766319,50
2,1558,56171,3578766333,3578766333,0
2,1558,56172,3578766333,3578766333,0
2,1558,56173,3578766333,3578766333,0
2,1558,56174,3578766333,3578766333,0
2,1558,56175,3578766333,3578766333,0
2,1558,56176,3578766333,3578766333,0
2,1558,56177,3578766333,3578766333,0
2,1558,56178,3578766333,3578766333,0
2,1558,56179,3578766333,3578766333,0
2,1558,56180,3578766333,3578766333,0
2,1558,56181,3578766333,3578766333,0
2,1558,56182,3578766333,3578766333,0
2,1558,56183,3578766333,3578766333,0
2,1558,56184,3578766333,3578766334,1
2,1558,56185,3578766333,3578766334,1
2,1558,56186,3578766333,3578766335,2
2,1558,56187,3578766333,3578766336,3
2,1558,56188,3578766333,3578766336,3
2,1558,56189,3578766333,3578766338,5
2,1558,56190,3578766333,3578766338,5
2,1558,56191,3578766333,3578766338,5
2,1558,56192,3578766333,3578766338,5
2,1558,56193,3578766333,3578766338,5
2,1558,56194,3578766333,3578766339,6
2,1558,56195,3578766333,3578766340,7
2,1558,56196,3578766333,3578766341,8
2,1558,56197,3578766333,3578766342,9
2,1558,56198,3578766333,3578766344,11
2,1558,56199,3578766333,3578766344,11
2,1558,56200,3578766333,3578766345,12
2,1558,56201,3578766333,3578766346,13
2,1558,56202,3578766333,3578766347,14
2,1558,56203,3578766333,3578766350,17
2,1558,56204,3578766333,3578766351,18
2,1558,56205,3578766333,3578766351,18
2,1558,56206,3578766333,3578766351,18
2,1558,56207,3578766333,3578766352,19
2,1558,56208,3578766333,3578766353,20
2,1558,56209,3578766333,3578766353,20
2,1558,56210,3578766333,3578766354,21
2,1558,56211,3578766333,3578766355,22
2,1558,56212,3578766333,3578766356,23
2,1558,56213,3578766333,3578766357,24
2,1558,56214,3578766333,3578766358,25
2,1558,56215,3578766333,3578766359,26
2,1558,56216,3578766333,3578766362,29
2,1558,56217,3578766333,3578766364,31
2,1558,56218,3578766333,3578766364,31
2,1558,56219,3578766333,3578766364,31
2,1558,56220,3578766333,3578766366,33
2,1558,56221,3578766333,3578766366,33
2,1558,56222,3578766333,3578766366,33
2,1558,56223,3578766333,3578766366,33
2,1558,56224,3578766333,3578766367,34
2,1558,56225,3578766333,3578766368,35
2,1558,56226,3578766333,3578766370,37
2,1558,56227,3578766333,3578766371,38
2,1558,56228,3578766333,3578766371,38
2,1558,56229,3578766333,3578766371,38
2,1558,56230,3578766333,3578766374,41
2,1558,56231,3578766333,3578766374,41
2,1558,56232,3578766333,3578766374,41
2,1558,56233,3578766333,3578766375,42
2,1558,56234,3578766333,3578766376,43
2,1558,56235,3578766333,3578766378,45
2,1558,56236,3578766333,3578766379,46
2,1558,56237,3578766333,3578766379,46
2,1558,56238,3578766333,3578766380,47
2,1559,56239,3578766397,3578766397,0
2,1559,56240,3578766397,3578766397,0
2,1559,56241,3578766397,3578766397,0
2,1559,56242,3578766397,3578766398,1
2,1559,56243,3578766397,3578766398,1
2,1559,56244,3578766397,3578766398,1
2,1559,56245,3578766397,3578766398,1
2,1559,56246,3578766397,3578766398,1
2,1559,56247,3578766397,3578766398,1
2,1559,56248,3578766397,3578766398,1
2,1559,56249,3578766397,3578766398,1
2,1559,56250,3578766397,3578766398,1
2,1559,56251,3578766397,3578766398,1
2,1559,56252,3578766397,3578766398,1
2,1559,56253,3578766397,3578766398,1
2,1559,56254,3578766397,3578766398,1
2,1559,56255,3578766397,3578766398,1
2,1559,56256,3578766397,3578766398,1
2,1559,56257,3578766397,3578766398,1
2,1559,56258,3578766397,3578766398,1
2,1559,56259,3578766397,3578766398,1
2,1559,56260,3578766397,3578766399,2
2,1559,56261,3578766397,3578766400,3
2,1559,56262,3578766397,3578766402,5
2,1559,56263,3578766397,3578766402,5
2,1559,56264,3578766397,3578766403,6
2,1559,56265,3578766397,3578766403,6
2,1559,56266,3578766397,3578766404,7
2,1559,56267,3578766397,3578766404,7
2,1559,56268,3578766397,3578766405,8
2,1559,56269,3578766397,3578766405,8
2,1559,56270,3578766397,3578766406,9
2,1559,56271,3578766397,3578766406,9
2,1559,56272,3578766397,3578766406,9
2,1559,56273,3578766397,3578766407,10
2,1559,56274,3578766397,3578766412,15
2,1559,56275,3578766397,3578766413,16
2,1559,56276,3578766397,3578766413,16
2,1559,56277,3578766397,3578766414,17
2,1559,56278,3578766397,3578766414,17
2,1559,56279,3578766397,3578766415,18
2,1559,56280,3578766397,3578766417,20
2,1559,56281,3578766397,3578766417,20
2,1559,56282,3578766397,3578766417,20
2,1559,56283,3578766397,3578766420,23
2,1559,56284,3578766397,3578766422,25
2,1559,56285,3578766397,3578766422,25
2,1559,56286,3578766397,3578766422,25
2,1559,56287,3578766397,3578766424,27
2,1559,56288,3578766397,3578766426,29
2,1559,56289,3578766397,3578766426,29
2,1559,56290,3578766397,3578766427,30
2,1559,56291,3578766397,3578766428,31
2,1559,56292,3578766397,3578766429,32
2,1559,56293,3578766397,3578766429,32
2,1559,56294,3578766397,3578766432,35
2,1559,56295,3578766397,3578766433,36
2,1559,56296,3578766397,3578766433,36
2,1559,56297,3578766397,3578766433,36
2,1559,56298,3578766397,3578766434,37
2,1559,56299,3578766397,3578766434,37
2,1559,56300,3578766397,3578766436,39
2,1559,56301,3578766397,3578766436,39
2,1559,56302,3578766397,3578766437,40
2,1559,56303,3578766397,3578766438,41
2,1559,56304,3578766397,3578766438,41
2,1559,56305,3578766397,3578766439,42
2,1559,56306,3578766397,3578766439,42
2,1559,56307,3578766397,3578766440,43
2,1559,56308,3578766397,3578766440,43
2,1559,56309,3578766397,3578766441,44
2,1559,56310,3578766397,3578766442,45
2,1559,56311,3578766397,3578766442,45
2,1559,56312,3578766397,3578766442,45
2,1559,56313,3578766397,3578766442,45
2,1559,56314,3578766397,3578766443,46
2,1559,56315,3578766397,3578766443,46
2,1559,56316,3578766397,3578766445,48
2,1559,56317,3578766397,3578766445,48
2,1560,56318,3578766461,3578766461,0
2,1560,56319,3578766461,3578766461,0
2,1560,56320,3578766461,3578766461,0
2,1560,56321,3578766461,3578766461,0
2,1560,56322,3578766461,3578766461,0
2,1560,56323,3578766461,3578766461,0
2,1560,56324,3578766461,3578766461,0
2,1560,56325,3578766461,3578766461,0
2,1560,56326,3578766461,3578766461,0
2,1560,56327,3578766461,3578766461,0
2,1560,56328,3578766461,3578766461,0
2,1560,56329,3578766461,3578766461,0
2,1560,56330,3578766461,3578766461,0
2,1560,56331,3578766461,3578766461,0
2,1560,56332,3578766461,3578766461,0
2,1560,56333,3578766461,3578766461,0
2,1560,56334,3578766461,3578766461,0
2,1560,56335,3578766461,3578766462,1
2,1560,56336,3578766461,3578766464,3
2,1560,56337,3578766461,3578766465,4
2,1560,56338,3578766461,3578766466,5
2,1560,56339,3578766461,3578766468,7
2,1560,56340,3578766461,3578766481,20
2,1560,56341,3578766461,3578766483,22
2,1560,56342,3578766461,3578766485,24
2,1560,56343,3578766461,3578766485,24
2,1560,56344,3578766461,3578766487,26
2,1560,56345,3578766461,3578766488,27
2,1560,56346,3578766461,3578766489,28
2,1560,56347,3578766461,3578766489,28
2,1560,56348,3578766461,3578766490,29
2,1560,56349,3578766461,3578766491,30
2,1560,56350,3578766461,3578766492,31
2,1560,56351,3578766461,3578766492,31
2,1560,56352,3578766461,3578766492,31
2,1560,56353,3578766461,3578766494,33
2,1560,56354,3578766461,3578766495,34
2,1560,56355,3578766461,3578766495,34
2,1560,56356,3578766461,3578766495,34
2,1560,56357,3578766461,3578766496,35
2,1560,56358,3578766461,3578766498,37
2,1560,56359,3578766461,3578766498,37
2,1560,56360,3578766461,3578766499,38
2,1560,56361,3578766461,3578766499,38
2,1560,56362,3578766461,3578766500,39
2,1560,56363,3578766461,3578766501,40
2,1560,56364,3578766461,3578766501,40
2,1560,56365,3578766461,3578766502,41
2,1560,56366,3578766461,3578766502,41
2,1560,56367,3578766461,3578766503,42
2,1560,56368,3578766461,3578766503,42
2,1560,56369,3578766461,3578766504,43
2,1560,56370,3578766461,3578766505,44
2,1560,56371,3578766461,3578766505,44
2,1560,56372,3578766461,3578766505,44
2,1560,56373,3578766461,3578766505,44
2,1560,56374,3578766461,3578766506,45
2,1560,56375,3578766461,3578766508,47
2,1560,56376,3578766461,3578766509,48
2,1560,56377,3578766461,3578766509,48
2,1560,56378,3578766461,3578766509,48
2,1560,56379,3578766461,3578766511,50
2,1561,56380,3578766526,3578766526,0
2,1561,56381,3578766526,3578766526,0
2,1561,56382,3578766526,3578766526,0
2,1561,56383,3578766526,3578766526,0
2,1561,56384,3578766526,3578766526,0
2,1561,56385,3578766526,3578766526,0
2,1561,56386,3578766526,3578766526,0
2,1561,56387,3578766526,3578766526,0
2,1561,56388,3578766526,3578766526,0
2,1561,56389,3578766526,3578766526,0
2,1561,56390,3578766526,3578766526,0
2,1561,56391,3578766526,3578766526,0
2,1561,56392,3578766526,3578766526,0
2,1561,56393,3578766526,3578766526,0
2,1561,56394,3578766526,3578766526,0
2,1561,56395,3578766526,3578766526,0
2,1561,56396,3578766526,3578766526,0
2,1561,56397,3578766526,3578766527,1
2,1561,56398,3578766526,3578766527,1
2,1561,56399,3578766526,3578766527,1
2,1561,56400,3578766526,3578766527,1
2,1561,56401,3578766526,3578766527,1
2,1561,56402,3578766526,3578766527,1
2,1561,56403,3578766526,3578766527,1
2,1561,56404,3578766526,3578766530,4
2,1561,56405,3578766526,3578766531,5
2,1561,56406,3578766526,3578766532,6
2,1561,56407,3578766526,3578766532,6
2,1561,56408,3578766526,3578766534,8
2,1561,56409,3578766526,3578766534,8
2,1561,56410,3578766526,3578766534,8
2,1561,56411,3578766526,3578766537,11
2,1561,56412,3578766526,3578766537,11
2,1561,56413,3578766526,3578766537,11
2,1561,56414,3578766526,3578766537,11
2,1561,56415,3578766526,3578766538,12
2,1561,56416,3578766526,3578766538,12
2,1561,56417,3578766526,3578766538,12
2,1561,56418,3578766526,3578766538,12
2,1561,56419,3578766526,3578766538,12
2,1561,56420,3578766526,3578766540,14
2,1561,56421,3578766526,3578766540,14
2,1561,56422,3578766526,3578766541,15
2,1561,56423,3578766526,3578766543,17
2,1561,56424,3578766526,3578766544,18
2,1561,56425,3578766526,3578766544,18
2,1561,56426,3578766526,3578766545,19
2,1561,56427,3578766526,3578766546,20
2,1561,56428,3578766526,3578766549,23
2,1561,56429,3578766526,3578766549,23
2,1561,56430,3578766526,3578766549,23
2,1561,56431,3578766526,3578766551,25
2,1561,56432,3578766526,3578766551,25
2,1561,56433,3578766526,3578766552,26
2,1561,56434,3578766526,3578766552,26
2,1561,56435,3578766526,3578766553,27
2,1561,56436,3578766526,3578766554,28
2,1561,56437,3578766526,3578766555,29
2,1561,56438,3578766526,3578766555,29
2,1561,56439,3578766526,3578766558,32
2,1561,56440,3578766526,3578766558,32
2,1561,56441,3578766526,3578766558,32
2,1561,56442,3578766526,3578766560,34
2,1561,56443,3578766526,3578766562,36
2,1561,56444,3578766526,3578766563,37
2,1561,56445,3578766526,3578766563,37
2,1561,56446,3578766526,3578766564,38
2,1561,56447,3578766526,3578766565,39
2,1561,56448,3578766526,3578766565,39
2,1561,56449,3578766526,3578766565,39
2,1561,56450,3578766526,3578766565,39
2,1561,56451,3578766526,3578766567,41
2,1561,56452,3578766526,3578766569,43
2,1561,56453,3578766526,3578766569,43
2,1561,56454,3578766526,3578766570,44
2,1561,56455,3578766526,3578766572,46
2,1561,56456,3578766526,3578766573,47
2,1561,56457,3578766526,3578766575,49
2,1561,56458,3578766526,3578766576,50
2,1562,56459,3578766591,3578766591,0
2,1562,56460,3578766591,3578766591,0
2,1562,56461,3578766591,3578766591,0
2,1562,56462,3578766591,3578766591,0
2,1562,56463,3578766591,3578766591,0
2,1562,56464,3578766591,3578766591,0
2,1562,56465,3578766591,3578766591,0
2,1562,56466,3578766591,3578766591,0
2,1562,56467,3578766591,3578766591,0
2,1562,56468,3578766591,3578766591,0
2,1562,56469,3578766591,3578766591,0
2,1562,56470,3578766591,3578766591,0
2,1562,56471,3578766591,3578766591,0
2,1562,56472,3578766591,3578766591,0
2,1562,56473,3578766591,3578766591,0
2,1562,56474,3578766591,3578766591,0
2,1562,56475,3578766591,3578766591,0
2,1562,56476,3578766591,3578766591,0
2,1562,56477,3578766591,3578766591,0
2,1562,56478,3578766591,3578766591,0
2,1562,56479,3578766591,3578766591,0
2,1562,56480,3578766591,3578766591,0
2,1562,56481,3578766591,3578766591,0
2,1562,56482,3578766591,3578766591,0
2,1562,56483,3578766591,3578766593,2
2,1562,56484,3578766591,3578766598,7
2,1562,56485,3578766591,3578766598,7
2,1562,56486,3578766591,3578766599,8
2,1562,56487,3578766591,3578766600,9
2,1562,56488,3578766591,3578766601,10
2,1562,56489,3578766591,3578766602,11
2,1562,56490,3578766591,3578766603,12
2,1562,56491,3578766591,3578766603,12
2,1562,56492,3578766591,3578766603,12
2,1562,56493,3578766591,3578766603,12
2,1562,56494,3578766591,3578766604,13
2,1562,56495,3578766591,3578766604,13
2,1562,56496,3578766591,3578766606,15
2,1562,56497,3578766591,3578766606,15
2,1562,56498,3578766591,3578766606,15
2,1562,56499,3578766591,3578766611,20
2,1562,56500,3578766591,3578766612,21
2,1562,56501,3578766591,3578766612,21
2,1562,56502,3578766591,3578766613,22
2,1562,56503,3578766591,3578766613,22
2,1562,56504,3578766591,3578766615,24
2,1562,56505,3578766591,3578766616,25
2,1562,56506,3578766591,3578766616,25
2,1562,56507,3578766591,3578766617,26
2,1562,56508,3578766591,3578766619,28
2,1562,56509,3578766591,3578766621,30
2,1562,56510,3578766591,3578766621,30
2,1562,56511,3578766591,3578766622,31
2,1562,56512,3578766591,3578766623,32
2,1562,56513,3578766591,3578766625,34
2,1562,56514,3578766591,3578766626,35
2,1562,56515,3578766591,3578766626,35
2,1562,56516,3578766591,3578766627,36
2,1562,56517,3578766591,3578766628,37
2,1562,56518,3578766591,3578766628,37
2,1562,56519,3578766591,3578766632,41
2,1562,56520,3578766591,3578766632,41
2,1562,56521,3578766591,3578766632,41
2,1562,56522,3578766591,3578766632,41
2,1562,56523,3578766591,3578766634,43
2,1562,56524,3578766591,3578766635,44
2,1562,56525,3578766591,3578766636,45
2,1562,56526,3578766591,3578766637,46
2,1562,56527,3578766591,3578766637,46
2,1562,56528,3578766591,3578766638,47
2,1562,56529,3578766591,3578766638,47
2,1562,56530,3578766591,3578766638,47
2,1562,56531,3578766591,3578766639,48
2,1562,56532,3578766591,3578766640,49
2,1562,56533,3578766591,3578766640,49
2,1562,56534,3578766591,3578766641,50
2,1563,56535,3578766656,3578766656,0
2,1563,56536,3578766656,3578766656,0
2,1563,56537,3578766656,3578766656,0
2,1563,56538,3578766656,3578766656,0
2,1563,56539,3578766656,3578766656,0
2,1563,56540,3578766656,3578766656,0
2,1563,56541,3578766656,3578766656,0
2,1563,56542,3578766656,3578766656,0
2,1563,56543,3578766656,3578766656,0
2,1563,56544,3578766656,3578766656,0
2,1563,56545,3578766656,3578766656,0
2,1563,56546,3578766656,3578766656,0
2,1563,56547,3578766656,3578766656,0
2,1563,56548,3578766656,3578766656,0
2,1563,56549,3578766656,3578766656,0
2,1563,56550,3578766656,3578766656,0
2,1563,56551,3578766656,3578766656,0
2,1563,56552,3578766656,3578766656,0
2,1563,56553,3578766656,3578766656,0
2,1563,56554,3578766656,3578766658,2
2,1563,56555,3578766656,3578766659,3
2,1563,56556,3578766656,3578766662,6
2,1563,56557,3578766656,3578766663,7
2,1563,56558,3578766656,3578766664,8
2,1563,56559,3578766656,3578766665,9
2,1563,56560,3578766656,3578766665,9
2,1563,56561,3578766656,3578766667,11
2,1563,56562,3578766656,3578766680,24
2,1563,56563,3578766656,3578766682,26
2,1563,56564,3578766656,3578766686,30
2,1563,56565,3578766656,3578766688,32
2,1563,56566,3578766656,3578766688,32
2,1563,56567,3578766656,3578766689,33
2,1563,56568,3578766656,3578766689,33
2,1563,56569,3578766656,3578766691,35
2,1563,56570,3578766656,3578766691,35
2,1563,56571,3578766656,3578766691,35
2,1563,56572,3578766656,3578766692,36
2,1563,56573,3578766656,3578766692,36
2,1563,56574,3578766656,3578766694,38
2,1563,56575,3578766656,3578766695,39
2,1563,56576,3578766656,3578766696,40
2,1563,56577,3578766656,3578766696,40
2,1563,56578,3578766656,3578766697,41
2,1563,56579,3578766656,3578766698,42
2,1563,56580,3578766656,3578766698,42
2,1563,56581,3578766656,3578766699,43
2,1563,56582,3578766656,3578766699,43
2,1563,56583,3578766656,3578766700,44
2,1563,56584,3578766656,3578766700,44
2,1563,56585,3578766656,3578766701,45
2,1563,56586,3578766656,3578766702,46
2,1563,56587,3578766656,3578766702,46
2,1563,56588,3578766656,3578766703,47
2,1563,56589,3578766656,3578766703,47
2,1563,56590,3578766656,3578766703,47
2,1563,56591,3578766656,3578766705,49
2,1563,56592,3578766656,3578766705,49
2,1563,56593,3578766656,3578766705,49
2,1563,56594,3578766656,3578766706,50
2,1564,56595,3578766721,3578766721,0
2,1564,56596,3578766721,3578766721,0
2,1564,56597,3578766721,3578766721,0
2,1564,56598,3578766721,3578766722,1
2,1564,56599,3578766721,3578766722,1
2,1564,56600,3578766721,3578766722,1
2,1564,56601,3578766721,3578766722,1
2,1564,56602,3578766721,3578766722,1
2,1564,56603,3578766721,3578766722,1
2,1564,56604,3578766721,3578766722,1
2,1564,56605,3578766721,3578766722,1
2,1564,56606,3578766721,3578766722,1
2,1564,56607,3578766721,3578766722,1
2,1564,56608,3578766721,3578766722,1
2,1564,56609,3578766721,3578766722,1
2,1564,56610,3578766721,3578766722,1
2,1564,56611,3578766721,3578766722,1
2,1564,56612,3578766721,3578766722,1
2,1564,56613,3578766721,3578766722,1
2,1564,56614,3578766721,3578766722,1
2,1564,56615,3578766721,3578766722,1
2,1564,56616,3578766721,3578766722,1
2,1564,56617,3578766721,3578766722,1
2,1564,56618,3578766721,3578766722,1
2,1564,56619,3578766721,3578766722,1
2,1564,56620,3578766721,3578766725,4
2,1564,56621,3578766721,3578766725,4
2,1564,56622,3578766721,3578766725,4
2,1564,56623,3578766721,3578766726,5
2,1564,56624,3578766721,3578766727,6
2,1564,56625,3578766721,3578766727,6
2,1564,56626,3578766721,3578766730,9
2,1564,56627,3578766721,3578766730,9
2,1564,56628,3578766721,3578766731,10
2,1564,56629,3578766721,3578766732,11
2,1564,56630,3578766721,3578766733,12
2,1564,56631,3578766721,3578766734,13
2,1564,56632,3578766721,3578766735,14
2,1564,56633,3578766721,3578766735,14
2,1564,56634,3578766721,3578766736,15
2,1564,56635,3578766721,3578766736,15
2,1564,56636,3578766721,3578766737,16
2,1564,56637,3578766721,3578766737,16
2,1564,56638,3578766721,3578766737,16
2,1564,56639,3578766721,3578766738,17
2,1564,56640,3578766721,3578766739,18
2,1564,56641,3578766721,3578766739,18
2,1564,56642,3578766721,3578766739,18
2,1564,56643,3578766721,3578766740,19
2,1564,56644,3578766721,3578766741,20
2,1564,56645,3578766721,3578766743,22
2,1564,56646,3578766721,3578766743,22
2,1564,56647,3578766721,3578766744,23
2,1564,56648,3578766721,3578766745,24
2,1564,56649,3578766721,3578766747,26
2,1564,56650,3578766721,3578766749,28
2,1564,56651,3578766721,3578766749,28
2,1564,56652,3578766721,3578766749,28
2,1564,56653,3578766721,3578766750,29
2,1564,56654,3578766721,3578766750,29
2,1564,56655,3578766721,3578766751,30
2,1564,56656,3578766721,3578766752,31
2,1564,56657,3578766721,3578766753,32
2,1564,56658,3578766721,3578766753,32
2,1564,56659,3578766721,3578766755,34
2,1564,56660,3578766721,3578766756,35
2,1564,56661,3578766721,3578766758,37
2,1564,56662,3578766721,3578766758,37
2,1564,56663,3578766721,3578766760,39
2,1564,56664,3578766721,3578766762,41
2,1564,56665,3578766721,3578766763,42
2,1564,56666,3578766721,3578766763,42
2,1564,56667,3578766721,3578766765,44
2,1564,56668,3578766721,3578766765,44
2,1564,56669,3578766721,3578766765,44
2,1564,56670,3578766721,3578766765,44
2,1564,56671,3578766721,3578766768,47
2,1564,56672,3578766721,3578766769,48
2,1564,56673,3578766721,3578766769,48
2,1564,56674,3578766721,3578766770,49
2,1565,56675,3578766787,3578766787,0
2,1565,56676,3578766787,3578766787,0
2,1565,56677,3578766787,3578766787,0
2,1565,56678,3578766787,3578766787,0
2,1565,56679,3578766787,3578766787,0
2,1565,56680,3578766787,3578766787,0
2,1565,56681,3578766787,3578766787,0
2,1565,56682,3578766787,3578766787,0
2,1565,56683,3578766787,3578766787,0
2,1565,56684,3578766787,3578766787,0
2,1565,56685,3578766787,3578766787,0
2,1565,56686,3578766787,3578766787,0
2,1565,56687,3578766787,3578766787,0
2,1565,56688,3578766787,3578766787,0
2,1565,56689,3578766787,3578766787,0
2,1565,56690,3578766787,3578766787,0
2,1565,56691,3578766787,3578766787,0
2,1565,56692,3578766787,3578766787,0
2,1565,56693,3578766787,3578766788,1
2,1565,56694,3578766787,3578766788,1
2,1565,56695,3578766787,3578766788,1
2,1565,56696,3578766787,3578766788,1
2,1565,56697,3578766787,3578766788,1
2,1565,56698,3578766787,3578766788,1
2,1565,56699,3578766787,3578766789,2
2,1565,56700,3578766787,3578766789,2
2,1565,56701,3578766787,3578766790,3
2,1565,56702,3578766787,3578766790,3
2,1565,56703,3578766787,3578766791,4
2,1565,56704,3578766787,3578766791,4
2,1565,56705,3578766787,3578766791,4
2,1565,56706,3578766787,3578766793,6
2,1565,56707,3578766787,3578766797,10
2,1565,56708,3578766787,3578766798,11
2,1565,56709,3578766787,3578766798,11
2,1565,56710,3578766787,3578766799,12
2,1565,56711,3578766787,3578766801,14
2,1565,56712,3578766787,3578766801,14
2,1565,56713,3578766787,3578766802,15
2,1565,56714,3578766787,3578766803,16
2,1565,56715,3578766787,3578766803,16
2,1565,56716,3578766787,3578766803,16
2,1565,56717,3578766787,3578766804,17
2,1565,56718,3578766787,3578766805,18
2,1565,56719,3578766787,3578766806,19
2,1565,56720,3578766787,3578766806,19
2,1565,56721,3578766787,3578766811,24
2,1565,56722,3578766787,3578766812,25
2,1565,56723,3578766787,3578766812,25
2,1565,56724,3578766787,3578766813,26
2,1565,56725,3578766787,3578766813,26
2,1565,56726,3578766787,3578766815,28
2,1565,56727,3578766787,3578766816,29
2,1565,56728,3578766787,3578766817,30
2,1565,56729,3578766787,3578766820,33
2,1565,56730,3578766787,3578766821,34
2,1565,56731,3578766787,3578766821,34
2,1565,56732,3578766787,3578766823,36
2,1565,56733,3578766787,3578766825,38
2,1565,56734,3578766787,3578766826,39
2,1565,56735,3578766787,3578766826,39
2,1565,56736,3578766787,3578766827,40
2,1565,56737,3578766787,3578766827,40
2,1565,56738,3578766787,3578766828,41
2,1565,56739,3578766787,3578766829,42
2,1565,56740,3578766787,3578766831,44
2,1565,56741,3578766787,3578766832,45
2,1565,56742,3578766787,3578766833,46
2,1565,56743,3578766787,3578766833,46
2,1565,56744,3578766787,3578766833,46
2,1565,56745,3578766787,3578766834,47
2,1565,56746,3578766787,3578766835,48
2,1565,56747,3578766787,3578766836,49
2,1566,56748,3578766852,3578766852,0
2,1566,56749,3578766852,3578766852,0
2,1566,56750,3578766852,3578766852,0
2,1566,56751,3578766852,3578766852,0
2,1566,56752,3578766852,3578766852,0
2,1566,56753,3578766852,3578766852,0
2,1566,56754,3578766852,3578766852,0
2,1566,56755,3578766852,3578766852,0
2,1566,56756,3578766852,3578766852,0
2,1566,56757,3578766852,3578766852,0
2,1566,56758,3578766852,3578766852,0
2,1566,56759,3578766852,3578766852,0
2,1566,56760,3578766852,3578766852,0
2,1566,56761,3578766852,3578766852,0
2,1566,56762,3578766852,3578766852,0
2,1566,56763,3578766852,3578766852,0
2,1566,56764,3578766852,3578766852,0
2,1566,56765,3578766852,3578766852,0
2,1566,56766,3578766852,3578766852,0
2,1566,56767,3578766852,3578766852,0
2,1566,56768,3578766852,3578766852,0
2,1566,56769,3578766852,3578766852,0
2,1566,56770,3578766852,3578766852,0
2,1566,56771,3578766852,3578766853,1
2,1566,56772,3578766852,3578766853,1
2,1566,56773,3578766852,3578766853,1
2,1566,56774,3578766852,3578766854,2
2,1566,56775,3578766852,3578766855,3
2,1566,56776,3578766852,3578766855,3
2,1566,56777,3578766852,3578766858,6
2,1566,56778,3578766852,3578766860,8
2,1566,56779,3578766852,3578766861,9
2,1566,56780,3578766852,3578766862,10
2,1566,56781,3578766852,3578766862,10
2,1566,56782,3578766852,3578766864,12
2,1566,56783,3578766852,3578766866,14
2,1566,56784,3578766852,3578766866,14
2,1566,56785,3578766852,3578766867,15
2,1566,56786,3578766852,3578766867,15
2,1566,56787,3578766852,3578766880,28
2,1566,56788,3578766852,3578766882,30
2,1566,56789,3578766852,3578766885,33
2,1566,56790,3578766852,3578766886,34
2,1566,56791,3578766852,3578766888,36
2,1566,56792,3578766852,3578766889,37
2,1566,56793,3578766852,3578766889,37
2,1566,56794,3578766852,3578766891,39
2,1566,56795,3578766852,3578766891,39
2,1566,56796,3578766852,3578766891,39
2,1566,56797,3578766852,3578766892,40
2,1566,56798,3578766852,3578766892,40
2,1566,56799,3578766852,3578766892,40
2,1566,56800,3578766852,3578766894,42
2,1566,56801,3578766852,3578766895,43
2,1566,56802,3578766852,3578766896,44
2,1566,56803,3578766852,3578766896,44
2,1566,56804,3578766852,3578766896,44
2,1566,56805,3578766852,3578766897,45
2,1566,56806,3578766852,3578766898,46
2,1566,56807,3578766852,3578766899,47
2,1566,56808,3578766852,3578766899,47
2,1566,56809,3578766852,3578766900,48
2,1566,56810,3578766852,3578766900,48
2,1566,56811,3578766852,3578766901,49
2,1566,56812,3578766852,3578766901,49
2,1567,56813,3578766916,3578766916,0
2,1567,56814,3578766916,3578766916,0
2,1567,56815,3578766916,3578766916,0
2,1567,56816,3578766916,3578766916,0
2,1567,56817,3578766916,3578766916,0
2,1567,56818,3578766916,3578766916,0
2,1567,56819,3578766916,3578766916,0
2,1567,56820,3578766916,3578766916,0
2,1567,56821,3578766916,3578766916,0
2,1567,56822,3578766916,3578766916,0
2,1567,56823,3578766916,3578766916,0
2,1567,56824,3578766916,3578766916,0
2,1567,56825,3578766916,3578766916,0
2,1567,56826,3578766916,3578766916,0
2,1567,56827,3578766916,3578766916,0
2,1567,56828,3578766916,3578766916,0
2,1567,56829,3578766916,3578766916,0
2,1567,56830,3578766916,3578766916,0
2,1567,56831,3578766916,3578766916,0
2,1567,56832,3578766916,3578766916,0
2,1567,56833,3578766916,3578766916,0
2,1567,56834,3578766916,3578766916,0
2,1567,56835,3578766916,3578766916,0
2,1567,56836,3578766916,3578766916,0
2,1567,56837,3578766916,3578766917,1
2,1567,56838,3578766916,3578766917,1
2,1567,56839,3578766916,3578766917,1
2,1567,56840,3578766916,3578766917,1
2,1567,56841,3578766916,3578766918,2
2,1567,56842,3578766916,3578766921,5
2,1567,56843,3578766916,3578766921,5
2,1567,56844,3578766916,3578766921,5
2,1567,56845,3578766916,3578766921,5
2,1567,56846,3578766916,3578766922,6
2,1567,56847,3578766916,3578766922,6
2,1567,56848,3578766916,3578766925,9
2,1567,56849,3578766916,3578766925,9
2,1567,56850,3578766916,3578766926,10
2,1567,56851,3578766916,3578766927,11
2,1567,56852,3578766916,3578766929,13
2,1567,56853,3578766916,3578766930,14
2,1567,56854,3578766916,3578766931,15
2,1567,56855,3578766916,3578766933,17
2,1567,56856,3578766916,3578766934,18
2,1567,56857,3578766916,3578766934,18
2,1567,56858,3578766916,3578766935,19
2,1567,56859,3578766916,3578766936,20
2,1567,56860,3578766916,3578766936,20
2,1567,56861,3578766916,3578766937,21
2,1567,56862,3578766916,3578766937,21
2,1567,56863,3578766916,3578766937,21
2,1567,56864,3578766916,3578766938,22
2,1567,56865,3578766916,3578766938,22
2,1567,56866,3578766916,3578766939,23
2,1567,56867,3578766916,3578766940,24
2,1567,56868,3578766916,3578766940,24
2,1567,56869,3578766916,3578766942,26
2,1567,56870,3578766916,3578766943,27
2,1567,56871,3578766916,3578766943,27
2,1567,56872,3578766916,3578766944,28
2,1567,56873,3578766916,3578766945,29
2,1567,56874,3578766916,3578766947,31
2,1567,56875,3578766916,3578766948,32
2,1567,56876,3578766916,3578766950,34
2,1567,56877,3578766916,3578766950,34
2,1567,56878,3578766916,3578766950,34
2,1567,56879,3578766916,3578766951,35
2,1567,56880,3578766916,3578766951,35
2,1567,56881,3578766916,3578766952,36
2,1567,56882,3578766916,3578766952,36
2,1567,56883,3578766916,3578766953,37
2,1567,56884,3578766916,3578766953,37
2,1567,56885,3578766916,3578766955,39
2,1567,56886,3578766916,3578766956,40
2,1567,56887,3578766916,3578766957,41
2,1567,56888,3578766916,3578766961,45
2,1567,56889,3578766916,3578766963,47
2,1567,56890,3578766916,3578766964,48
2,1567,56891,3578766916,3578766965,49
2,1567,56892,3578766916,3578766966,50
2,1568,56893,3578766981,3578766981,0
2,1568,56894,3578766981,3578766981,0
2,1568,56895,3578766981,3578766981,0
2,1568,56896,3578766981,3578766981,0
2,1568,56897,3578766981,3578766981,0
2,1568,56898,3578766981,3578766981,0
2,1568,56899,3578766981,3578766981,0
2,1568,56900,3578766981,3578766981,0
2,1568,56901,3578766981,3578766981,0
2,1568,56902,3578766981,3578766981,0
2,1568,56903,3578766981,3578766981,0
2,1568,56904,3578766981,3578766983,2
2,1568,56905,3578766981,3578766984,3
2,1568,56906,3578766981,3578766984,3
2,1568,56907,3578766981,3578766984,3
2,1568,56908,3578766981,3578766985,4
2,1568,56909,3578766981,3578766985,4
2,1568,56910,3578766981,3578766987,6
2,1568,56911,3578766981,3578766987,6
2,1568,56912,3578766981,3578766988,7
2,1568,56913,3578766981,3578766988,7
2,1568,56914,3578766981,3578766988,7
2,1568,56915,3578766981,3578766988,7
2,1568,56916,3578766981,3578766988,7
2,1568,56917,3578766981,3578766989,8
2,1568,56918,3578766981,3578766989,8
2,1568,56919,3578766981,3578766990,9
2,1568,56920,3578766981,3578766990,9
2,1568,56921,3578766981,3578766991,10
2,1568,56922,3578766981,3578766992,11
2,1568,56923,3578766981,3578766992,11
2,1568,56924,3578766981,3578766993,12
2,1568,56925,3578766981,3578766998,17
2,1568,56926,3578766981,3578766999,18
2,1568,56927,3578766981,3578767000,19
2,1568,56928,3578766981,3578767002,21
2,1568,56929,3578766981,3578767003,22
2,1568,56930,3578766981,3578767004,23
2,1568,56931,3578766981,3578767004,23
2,1568,56932,3578766981,3578767004,23
2,1568,56933,3578766981,3578767004,23
2,1568,56934,3578766981,3578767006,25
2,1568,56935,3578766981,3578767006,25
2,1568,56936,3578766981,3578767011,30
2,1568,56937,3578766981,3578767012,31
2,1568,56938,3578766981,3578767014,33
2,1568,56939,3578766981,3578767015,34
2,1568,56940,3578766981,3578767016,35
2,1568,56941,3578766981,3578767016,35
2,1568,56942,3578766981,3578767017,36
2,1568,56943,3578766981,3578767019,38
2,1568,56944,3578766981,3578767021,40
2,1568,56945,3578766981,3578767022,41
2,1568,56946,3578766981,3578767022,41
2,1568,56947,3578766981,3578767024,43
2,1568,56948,3578766981,3578767025,44
2,1568,56949,3578766981,3578767026,45
2,1568,56950,3578766981,3578767027,46
2,1568,56951,3578766981,3578767028,47
2,1568,56952,3578766981,3578767028,47
2,1568,56953,3578766981,3578767029,48
2,1569,56954,3578767045,3578767045,0
2,1569,56955,3578767045,3578767045,0
2,1569,56956,3578767045,3578767045,0
2,1569,56957,3578767045,3578767045,0
2,1569,56958,3578767045,3578767045,0
2,1569,56959,3578767045,3578767045,0
2,1569,56960,3578767045,3578767045,0
2,1569,56961,3578767045,3578767045,0
2,1569,56962,3578767045,3578767045,0
2,1569,56963,3578767045,3578767045,0
2,1569,56964,3578767045,3578767045,0
2,1569,56965,3578767045,3578767045,0
2,1569,56966,3578767045,3578767045,0
2,1569,56967,3578767045,3578767045,0
2,1569,56968,3578767045,3578767045,0
2,1569,56969,3578767045,3578767045,0
2,1569,56970,3578767045,3578767045,0
2,1569,56971,3578767045,3578767045,0
2,1569,56972,3578767045,3578767045,0
2,1569,56973,3578767045,3578767045,0
2,1569,56974,3578767045,3578767045,0
2,1569,56975,3578767045,3578767045,0
2,1569,56976,3578767045,3578767045,0
2,1569,56977,3578767045,3578767046,1
2,1569,56978,3578767045,3578767047,2
2,1569,56979,3578767045,3578767049,4
2,1569,56980,3578767045,3578767050,5
2,1569,56981,3578767045,3578767050,5
2,1569,56982,3578767045,3578767050,5
2,1569,56983,3578767045,3578767050,5
2,1569,56984,3578767045,3578767052,7
2,1569,56985,3578767045,3578767052,7
2,1569,56986,3578767045,3578767053,8
2,1569,56987,3578767045,3578767053,8
2,1569,56988,3578767045,3578767054,9
2,1569,56989,3578767045,3578767055,10
2,1569,56990,3578767045,3578767056,11
2,1569,56991,3578767045,3578767058,13
2,1569,56992,3578767045,3578767061,16
2,1569,56993,3578767045,3578767061,16
2,1569,56994,3578767045,3578767062,17
2,1569,56995,3578767045,3578767065,20
2,1569,56996,3578767045,3578767066,21
2,1569,56997,3578767045,3578767067,22
2,1569,56998,3578767045,3578767067,22
2,1569,56999,3578767045,3578767080,35
2,1569,57000,3578767045,3578767082,37
2,1569,57001,3578767045,3578767086,41
2,1569,57002,3578767045,3578767087,42
2,1569,57003,3578767045,3578767088,43
2,1569,57004,3578767045,3578767089,44
2,1569,57005,3578767045,3578767089,44
2,1569,57006,3578767045,3578767091,46
2,1569,57007,3578767045,3578767091,46
2,1569,57008,3578767045,3578767091,46
2,1569,57009,3578767045,3578767091,46
2,1569,57010,3578767045,3578767092,47
2,1569,57011,3578767045,3578767095,50
2,1570,57012,3578767109,3578767109,0
2,1570,57013,3578767109,3578767109,0
2,1570,57014,3578767109,3578767109,0
2,1570,57015,3578767109,3578767109,0
2,1570,57016,3578767109,3578767109,0
2,1570,57017,3578767109,3578767109,0
2,1570,57018,3578767109,3578767109,0
2,1570,57019,3578767109,3578767109,0
2,1570,57020,3578767109,3578767109,0
2,1570,57021,3578767109,3578767109,0
2,1570,57022,3578767109,3578767109,0
2,1570,57023,3578767109,3578767109,0
2,1570,57024,3578767109,3578767109,0
2,1570,57025,3578767109,3578767109,0
2,1570,57026,3578767109,3578767109,0
2,1570,57027,3578767109,3578767109,0
2,1570,57028,3578767109,3578767109,0
2,1570,57029,3578767109,3578767109,0
2,1570,57030,3578767109,3578767109,0
2,1570,57031,3578767109,3578767109,0
2,1570,57032,3578767109,3578767109,0
2,1570,57033,3578767109,3578767109,0
2,1570,57034,3578767109,3578767109,0
2,1570,57035,3578767109,3578767109,0
2,1570,57036,3578767109,3578767112,3
2,1570,57037,3578767109,3578767112,3
2,1570,57038,3578767109,3578767112,3
2,1570,57039,3578767109,3578767113,4
2,1570,57040,3578767109,3578767113,4
2,1570,57041,3578767109,3578767114,5
2,1570,57042,3578767109,3578767115,6
2,1570,57043,3578767109,3578767116,7
2,1570,57044,3578767109,3578767116,7
2,1570,57045,3578767109,3578767117,8
2,1570,57046,3578767109,3578767118,9
2,1570,57047,3578767109,3578767118,9
2,1570,57048,3578767109,3578767119,10
2,1570,57049,3578767109,3578767120,11
2,1570,57050,3578767109,3578767122,13
2,1570,57051,3578767109,3578767122,13
2,1570,57052,3578767109,3578767122,13
2,1570,57053,3578767109,3578767122,13
2,1570,57054,3578767109,3578767123,14
2,1570,57055,3578767109,3578767125,16
2,1570,57056,3578767109,3578767126,17
2,1570,57057,3578767109,3578767126,17
2,1570,57058,3578767109,3578767128,19
2,1570,57059,3578767109,3578767130,21
2,1570,57060,3578767109,3578767130,21
2,1570,57061,3578767109,3578767132,23
2,1570,57062,3578767109,3578767133,24
2,1570,57063,3578767109,3578767133,24
2,1570,57064,3578767109,3578767135,26
2,1570,57065,3578767109,3578767135,26
2,1570,57066,3578767109,3578767136,27
2,1570,57067,3578767109,3578767137,28
2,1570,57068,3578767109,3578767138,29
2,1570,57069,3578767109,3578767138,29
2,1570,57070,3578767109,3578767138,29
2,1570,57071,3578767109,3578767138,29
2,1570,57072,3578767109,3578767138,29
2,1570,57073,3578767109,3578767139,30
2,1570,57074,3578767109,3578767139,30
2,1570,57075,3578767109,3578767140,31
2,1570,57076,3578767109,3578767143,34
2,1570,57077,3578767109,3578767143,34
2,1570,57078,3578767109,3578767144,35
2,1570,57079,3578767109,3578767144,35
2,1570,57080,3578767109,3578767145,36
2,1570,57081,3578767109,3578767148,39
2,1570,57082,3578767109,3578767150,41
2,1570,57083,3578767109,3578767150,41
2,1570,57084,3578767109,3578767150,41
2,1570,57085,3578767109,3578767150,41
2,1570,57086,3578767109,3578767151,42
2,1570,57087,3578767109,3578767152,43
2,1570,57088,3578767109,3578767152,43
2,1570,57089,3578767109,3578767152,43
2,1570,57090,3578767109,3578767152,43
2,1570,57091,3578767109,3578767153,44
2,1570,57092,3578767109,3578767154,45
2,1570,57093,3578767109,3578767155,46
2,1570,57094,3578767109,3578767156,47
2,1570,57095,3578767109,3578767157,48
2,1570,57096,3578767109,3578767158,49
2,1571,57097,3578767173,3578767173,0
2,1571,57098,3578767173,3578767173,0
2,1571,57099,3578767173,3578767173,0
2,1571,57100,3578767173,3578767173,0
2,1571,57101,3578767173,3578767173,0
2,1571,57102,3578767173,3578767173,0
2,1571,57103,3578767173,3578767173,0
2,1571,57104,3578767173,3578767173,0
2,1571,57105,3578767173,3578767173,0
2,1571,57106,3578767173,3578767173,0
2,1571,57107,3578767173,3578767173,0
2,1571,57108,3578767173,3578767173,0
2,1571,57109,3578767173,3578767173,0
2,1571,57110,3578767173,3578767174,1
2,1571,57111,3578767173,3578767174,1
2,1571,57112,3578767173,3578767176,3
2,1571,57113,3578767173,3578767176,3
2,1571,57114,3578767173,3578767177,4
2,1571,57115,3578767173,3578767178,5
2,1571,57116,3578767173,3578767181,8
2,1571,57117,3578767173,3578767183,10
2,1571,57118,3578767173,3578767183,10
2,1571,57119,3578767173,3578767184,11
2,1571,57120,3578767173,3578767184,11
2,1571,57121,3578767173,3578767184,11
2,1571,57122,3578767173,3578767185,12
2,1571,57123,3578767173,3578767185,12
2,1571,57124,3578767173,3578767187,14
2,1571,57125,3578767173,3578767188,15
2,1571,57126,3578767173,3578767188,15
2,1571,57127,3578767173,3578767188,15
2,1571,57128,3578767173,3578767189,16
2,1571,57129,3578767173,3578767189,16
2,1571,57130,3578767173,3578767189,16
2,1571,57131,3578767173,3578767189,16
2,1571,57132,3578767173,3578767189,16
2,1571,57133,3578767173,3578767190,17
2,1571,57134,3578767173,3578767191,18
2,1571,57135,3578767173,3578767191,18
2,1571,57136,3578767173,3578767192,19
2,1571,57137,3578767173,3578767192,19
2,1571,57138,3578767173,3578767192,19
2,1571,57139,3578767173,3578767194,21
2,1571,57140,3578767173,3578767198,25
2,1571,57141,3578767173,3578767199,26
2,1571,57142,3578767173,3578767200,27
2,1571,57143,3578767173,3578767202,29
2,1571,57144,3578767173,3578767202,29
2,1571,57145,3578767173,3578767203,30
2,1571,57146,3578767173,3578767203,30
2,1571,57147,3578767173,3578767205,32
2,1571,57148,3578767173,3578767205,32
2,1571,57149,3578767173,3578767205,32
2,1571,57150,3578767173,3578767206,33
2,1571,57151,3578767173,3578767211,38
2,1571,57152,3578767173,3578767213,40
2,1571,57153,3578767173,3578767216,43
2,1571,57154,3578767173,3578767216,43
2,1571,57155,3578767173,3578767219,46
2,1571,57156,3578767173,3578767221,48
2,1571,57157,3578767173,3578767221,48
2,1571,57158,3578767173,3578767223,50
2,1572,57159,3578767239,3578767239,0
2,1572,57160,3578767239,3578767239,0
2,1572,57161,3578767239,3578767239,0
2,1572,57162,3578767239,3578767239,0
2,1572,57163,3578767239,3578767239,0
2,1572,57164,3578767239,3578767239,0
2,1572,57165,3578767239,3578767239,0
2,1572,57166,3578767239,3578767239,0
2,1572,57167,3578767239,3578767239,0
2,1572,57168,3578767239,3578767239,0
2,1572,57169,3578767239,3578767239,0
2,1572,57170,3578767239,3578767239,0
2,1572,57171,3578767239,3578767239,0
2,1572,57172,3578767239,3578767239,0
2,1572,57173,3578767239,3578767239,0
2,1572,57174,3578767239,3578767239,0
2,1572,57175,3578767239,3578767239,0
2,1572,57176,3578767239,3578767239,0
2,1572,57177,3578767239,3578767239,0
2,1572,57178,3578767239,3578767239,0
2,1572,57179,3578767239,3578767239,0
2,1572,57180,3578767239,3578767240,1
2,1572,57181,3578767239,3578767241,2
2,1572,57182,3578767239,3578767241,2
2,1572,57183,3578767239,3578767242,3
2,1572,57184,3578767239,3578767242,3
2,1572,57185,3578767239,3578767242,3
2,1572,57186,3578767239,3578767243,4
2,1572,57187,3578767239,3578767244,5
2,1572,57188,3578767239,3578767245,6
2,1572,57189,3578767239,3578767246,7
2,1572,57190,3578767239,3578767247,8
2,1572,57191,3578767239,3578767249,10
2,1572,57192,3578767239,3578767250,11
2,1572,57193,3578767239,3578767250,11
2,1572,57194,3578767239,3578767250,11
2,1572,57195,3578767239,3578767251,12
2,1572,57196,3578767239,3578767251,12
2,1572,57197,3578767239,3578767252,13
2,1572,57198,3578767239,3578767253,14
2,1572,57199,3578767239,3578767254,15
2,1572,57200,3578767239,3578767254,15
2,1572,57201,3578767239,3578767254,15
2,1572,57202,3578767239,3578767255,16
2,1572,57203,3578767239,3578767255,16
2,1572,57204,3578767239,3578767258,19
2,1572,57205,3578767239,3578767261,22
2,1572,57206,3578767239,3578767261,22
2,1572,57207,3578767239,3578767262,23
2,1572,57208,3578767239,3578767264,25
2,1572,57209,3578767239,3578767265,26
2,1572,57210,3578767239,3578767266,27
2,1572,57211,3578767239,3578767267,28
2,1572,57212,3578767239,3578767267,28
2,1572,57213,3578767239,3578767268,29
2,1572,57214,3578767239,3578767281,42
2,1572,57215,3578767239,3578767282,43
2,1572,57216,3578767239,3578767286,47
2,1572,57217,3578767239,3578767286,47
2,1572,57218,3578767239,3578767288,49
2,1573,57219,3578767304,3578767304,0
2,1573,57220,3578767304,3578767304,0
2,1573,57221,3578767304,3578767304,0
2,1573,57222,3578767304,3578767304,0
2,1573,57223,3578767304,3578767304,0
2,1573,57224,3578767304,3578767304,0
2,1573,57225,3578767304,3578767304,0
2,1573,57226,3578767304,3578767304,0
2,1573,57227,3578767304,3578767304,0
2,1573,57228,3578767304,3578767304,0
2,1573,57229,3578767304,3578767304,0
2,1573,57230,3578767304,3578767304,0
2,1573,57231,3578767304,3578767304,0
2,1573,57232,3578767304,3578767304,0
2,1573,57233,3578767304,3578767304,0
2,1573,57234,3578767304,3578767304,0
2,1573,57235,3578767304,3578767304,0
2,1573,57236,3578767304,3578767304,0
2,1573,57237,3578767304,3578767304,0
2,1573,57238,3578767304,3578767304,0
2,1573,57239,3578767304,3578767304,0
2,1573,57240,3578767304,3578767304,0
2,1573,57241,3578767304,3578767305,1
2,1573,57242,3578767304,3578767305,1
2,1573,57243,3578767304,3578767305,1
2,1573,57244,3578767304,3578767306,2
2,1573,57245,3578767304,3578767306,2
2,1573,57246,3578767304,3578767309,5
2,1573,57247,3578767304,3578767309,5
2,1573,57248,3578767304,3578767309,5
2,1573,57249,3578767304,3578767312,8
2,1573,57250,3578767304,3578767312,8
2,1573,57251,3578767304,3578767312,8
2,1573,57252,3578767304,3578767313,9
2,1573,57253,3578767304,3578767314,10
2,1573,57254,3578767304,3578767314,10
2,1573,57255,3578767304,3578767316,12
2,1573,57256,3578767304,3578767316,12
2,1573,57257,3578767304,3578767316,12
2,1573,57258,3578767304,3578767316,12
2,1573,57259,3578767304,3578767318,14
2,1573,57260,3578767304,3578767318,14
2,1573,57261,3578767304,3578767319,15
2,1573,57262,3578767304,3578767320,16
2,1573,57263,3578767304,3578767321,17
2,1573,57264,3578767304,3578767322,18
2,1573,57265,3578767304,3578767322,18
2,1573,57266,3578767304,3578767322,18
2,1573,57267,3578767304,3578767323,19
2,1573,57268,3578767304,3578767325,21
2,1573,57269,3578767304,3578767326,22
2,1573,57270,3578767304,3578767326,22
2,1573,57271,3578767304,3578767327,23
2,1573,57272,3578767304,3578767329,25
2,1573,57273,3578767304,3578767330,26
2,1573,57274,3578767304,3578767333,29
2,1573,57275,3578767304,3578767333,29
2,1573,57276,3578767304,3578767333,29
2,1573,57277,3578767304,3578767335,31
2,1573,57278,3578767304,3578767335,31
2,1573,57279,3578767304,3578767336,32
2,1573,57280,3578767304,3578767337,33
2,1573,57281,3578767304,3578767338,34
2,1573,57282,3578767304,3578767338,34
2,1573,57283,3578767304,3578767338,34
2,1573,57284,3578767304,3578767338,34
2,1573,57285,3578767304,3578767338,34
2,1573,57286,3578767304,3578767339,35
2,1573,57287,3578767304,3578767340,36
2,1573,57288,3578767304,3578767341,37
2,1573,57289,3578767304,3578767343,39
2,1573,57290,3578767304,3578767343,39
2,1573,57291,3578767304,3578767344,40
2,1573,57292,3578767304,3578767344,40
2,1573,57293,3578767304,3578767345,41
2,1573,57294,3578767304,3578767348,44
2,1573,57295,3578767304,3578767350,46
2,1573,57296,3578767304,3578767350,46
2,1573,57297,3578767304,3578767350,46
2,1573,57298,3578767304,3578767350,46
2,1573,57299,3578767304,3578767352,48
2,1573,57300,3578767304,3578767352,48
2,1573,57301,3578767304,3578767352,48
2,1573,57302,3578767304,3578767353,49
2,1573,57303,3578767304,3578767353,49
2,1573,57304,3578767304,3578767354,50
2,1574,57305,3578767368,3578767369,1
2,1574,57306,3578767368,3578767369,1
2,1574,57307,3578767368,3578767369,1
2,1574,57308,3578767368,3578767369,1
2,1574,57309,3578767368,3578767369,1
2,1574,57310,3578767368,3578767369,1
2,1574,57311,3578767368,3578767369,1
2,1574,57312,3578767368,3578767369,1
2,1574,57313,3578767368,3578767369,1
2,1574,57314,3578767368,3578767369,1
2,1574,57315,3578767368,3578767369,1
2,1574,57316,3578767368,3578767370,2
2,1574,57317,3578767368,3578767371,3
2,1574,57318,3578767368,3578767371,3
2,1574,57319,3578767368,3578767371,3
2,1574,57320,3578767368,3578767373,5
2,1574,57321,3578767368,3578767375,7
2,1574,57322,3578767368,3578767376,8
2,1574,57323,3578767368,3578767376,8
2,1574,57324,3578767368,3578767379,11
2,1574,57325,3578767368,3578767379,11
2,1574,57326,3578767368,3578767381,13
2,1574,57327,3578767368,3578767383,15
2,1574,57328,3578767368,3578767383,15
2,1574,57329,3578767368,3578767384,16
2,1574,57330,3578767368,3578767384,16
2,1574,57331,3578767368,3578767384,16
2,1574,57332,3578767368,3578767385,17
2,1574,57333,3578767368,3578767385,17
2,1574,57334,3578767368,3578767387,19
2,1574,57335,3578767368,3578767388,20
2,1574,57336,3578767368,3578767388,20
2,1574,57337,3578767368,3578767389,21
2,1574,57338,3578767368,3578767389,21
2,1574,57339,3578767368,3578767389,21
2,1574,57340,3578767368,3578767390,22
2,1574,57341,3578767368,3578767391,23
2,1574,57342,3578767368,3578767391,23
2,1574,57343,3578767368,3578767391,23
2,1574,57344,3578767368,3578767392,24
2,1574,57345,3578767368,3578767392,24
2,1574,57346,3578767368,3578767392,24
2,1574,57347,3578767368,3578767394,26
2,1574,57348,3578767368,3578767399,31
2,1574,57349,3578767368,3578767400,32
2,1574,57350,3578767368,3578767402,34
2,1574,57351,3578767368,3578767403,35
2,1574,57352,3578767368,3578767404,36
2,1574,57353,3578767368,3578767404,36
2,1574,57354,3578767368,3578767405,37
2,1574,57355,3578767368,3578767405,37
2,1574,57356,3578767368,3578767405,37
2,1574,57357,3578767368,3578767405,37
2,1574,57358,3578767368,3578767406,38
2,1574,57359,3578767368,3578767406,38
2,1574,57360,3578767368,3578767406,38
2,1574,57361,3578767368,3578767407,39
2,1574,57362,3578767368,3578767411,43
2,1574,57363,3578767368,3578767412,44
2,1574,57364,3578767368,3578767413,45
2,1574,57365,3578767368,3578767414,46
2,1574,57366,3578767368,3578767416,48
2,1574,57367,3578767368,3578767417,49
2,1574,57368,3578767368,3578767418,50
2,1575,57369,3578767435,3578767435,0
2,1575,57370,3578767435,3578767435,0
2,1575,57371,3578767435,3578767435,0
2,1575,57372,3578767435,3578767435,0
2,1575,57373,3578767435,3578767435,0
2,1575,57374,3578767435,3578767435,0
2,1575,57375,3578767435,3578767435,0
2,1575,57376,3578767435,3578767435,0
2,1575,57377,3578767435,3578767435,0
2,1575,57378,3578767435,3578767435,0
2,1575,57379,3578767435,3578767435,0
2,1575,57380,3578767435,3578767435,0
2,1575,57381,3578767435,3578767435,0
2,1575,57382,3578767435,3578767435,0
2,1575,57383,3578767435,3578767435,0
2,1575,57384,3578767435,3578767435,0
2,1575,57385,3578767435,3578767435,0
2,1575,57386,3578767435,3578767437,2
2,1575,57387,3578767435,3578767437,2
2,1575,57388,3578767435,3578767438,3
2,1575,57389,3578767435,3578767438,3
2,1575,57390,3578767435,3578767439,4
2,1575,57391,3578767435,3578767439,4
2,1575,57392,3578767435,3578767440,5
2,1575,57393,3578767435,3578767440,5
2,1575,57394,3578767435,3578767441,6
2,1575,57395,3578767435,3578767442,7
2,1575,57396,3578767435,3578767442,7
2,1575,57397,3578767435,3578767442,7
2,1575,57398,3578767435,3578767442,7
2,1575,57399,3578767435,3578767443,8
2,1575,57400,3578767435,3578767443,8
2,1575,57401,3578767435,3578767444,9
2,1575,57402,3578767435,3578767445,10
2,1575,57403,3578767435,3578767446,11
2,1575,57404,3578767435,3578767447,12
2,1575,57405,3578767435,3578767447,12
2,1575,57406,3578767435,3578767449,14
2,1575,57407,3578767435,3578767451,16
2,1575,57408,3578767435,3578767451,16
2,1575,57409,3578767435,3578767451,16
2,1575,57410,3578767435,3578767451,16
2,1575,57411,3578767435,3578767452,17
2,1575,57412,3578767435,3578767453,18
2,1575,57413,3578767435,3578767453,18
2,1575,57414,3578767435,3578767454,19
2,1575,57415,3578767435,3578767454,19
2,1575,57416,3578767435,3578767455,20
2,1575,57417,3578767435,3578767458,23
2,1575,57418,3578767435,3578767460,25
2,1575,57419,3578767435,3578767461,26
2,1575,57420,3578767435,3578767462,27
2,1575,57421,3578767435,3578767464,29
2,1575,57422,3578767435,3578767466,31
2,1575,57423,3578767435,3578767466,31
2,1575,57424,3578767435,3578767467,32
2,1575,57425,3578767435,3578767468,33
2,1575,57426,3578767435,3578767468,33
2,1575,57427,3578767435,3578767481,46
2,1575,57428,3578767435,3578767483,48
2,1576,57429,3578767499,3578767499,0
2,1576,57430,3578767499,3578767499,0
2,1576,57431,3578767499,3578767499,0
2,1576,57432,3578767499,3578767499,0
2,1576,57433,3578767499,3578767499,0
2,1576,57434,3578767499,3578767499,0
2,1576,57435,3578767499,3578767499,0
2,1576,57436,3578767499,3578767499,0
2,1576,57437,3578767499,3578767499,0
2,1576,57438,3578767499,3578767499,0
2,1576,57439,3578767499,3578767499,0
2,1576,57440,3578767499,3578767499,0
2,1576,57441,3578767499,3578767499,0
2,1576,57442,3578767499,3578767499,0
2,1576,57443,3578767499,3578767499,0
2,1576,57444,3578767499,3578767499,0
2,1576,57445,3578767499,3578767499,0
2,1576,57446,3578767499,3578767499,0
2,1576,57447,3578767499,3578767499,0
2,1576,57448,3578767499,3578767499,0
2,1576,57449,3578767499,3578767499,0
2,1576,57450,3578767499,3578767499,0
2,1576,57451,3578767499,3578767500,1
2,1576,57452,3578767499,3578767500,1
2,1576,57453,3578767499,3578767501,2
2,1576,57454,3578767499,3578767501,2
2,1576,57455,3578767499,3578767502,3
2,1576,57456,3578767499,3578767502,3
2,1576,57457,3578767499,3578767502,3
2,1576,57458,3578767499,3578767504,5
2,1576,57459,3578767499,3578767504,5
2,1576,57460,3578767499,3578767504,5
2,1576,57461,3578767499,3578767504,5
2,1576,57462,3578767499,3578767505,6
2,1576,57463,3578767499,3578767506,7
2,1576,57464,3578767499,3578767508,9
2,1576,57465,3578767499,3578767508,9
2,1576,57466,3578767499,3578767510,11
2,1576,57467,3578767499,3578767511,12
2,1576,57468,3578767499,3578767511,12
2,1576,57469,3578767499,3578767511,12
2,1576,57470,3578767499,3578767513,14
2,1576,57471,3578767499,3578767513,14
2,1576,57472,3578767499,3578767513,14
2,1576,57473,3578767499,3578767514,15
2,1576,57474,3578767499,3578767515,16
2,1576,57475,3578767499,3578767515,16
2,1576,57476,3578767499,3578767515,16
2,1576,57477,3578767499,3578767517,18
2,1576,57478,3578767499,3578767517,18
2,1576,57479,3578767499,3578767517,18
2,1576,57480,3578767499,3578767518,19
2,1576,57481,3578767499,3578767519,20
2,1576,57482,3578767499,3578767521,22
2,1576,57483,3578767499,3578767521,22
2,1576,57484,3578767499,3578767522,23
2,1576,57485,3578767499,3578767522,23
2,1576,57486,3578767499,3578767522,23
2,1576,57487,3578767499,3578767524,25
2,1576,57488,3578767499,3578767525,26
2,1576,57489,3578767499,3578767525,26
2,1576,57490,3578767499,3578767525,26
2,1576,57491,3578767499,3578767526,27
2,1576,57492,3578767499,3578767527,28
2,1576,57493,3578767499,3578767529,30
2,1576,57494,3578767499,3578767529,30
2,1576,57495,3578767499,3578767532,33
2,1576,57496,3578767499,3578767532,33
2,1576,57497,3578767499,3578767532,33
2,1576,57498,3578767499,3578767534,35
2,1576,57499,3578767499,3578767534,35
2,1576,57500,3578767499,3578767534,35
2,1576,57501,3578767499,3578767536,37
2,1576,57502,3578767499,3578767537,38
2,1576,57503,3578767499,3578767537,38
2,1576,57504,3578767499,3578767537,38
2,1576,57505,3578767499,3578767537,38
2,1576,57506,3578767499,3578767538,39
2,1576,57507,3578767499,3578767538,39
2,1576,57508,3578767499,3578767538,39
2,1576,57509,3578767499,3578767539,40
2,1576,57510,3578767499,3578767539,40
2,1576,57511,3578767499,3578767540,41
2,1576,57512,3578767499,3578767542,43
2,1576,57513,3578767499,3578767542,43
2,1576,57514,3578767499,3578767544,45
2,1576,57515,3578767499,3578767544,45
2,1576,57516,3578767499,3578767544,45
2,1576,57517,3578767499,3578767549,50
2,1577,57518,3578767564,3578767564,0
2,1577,57519,3578767564,3578767564,0
2,1577,57520,3578767564,3578767564,0
2,1577,57521,3578767564,3578767564,0
2,1577,57522,3578767564,3578767564,0
2,1577,57523,3578767564,3578767564,0
2,1577,57524,3578767564,3578767564,0
2,1577,57525,3578767564,3578767564,0
2,1577,57526,3578767564,3578767564,0
2,1577,57527,3578767564,3578767564,0
2,1577,57528,3578767564,3578767564,0
2,1577,57529,3578767564,3578767564,0
2,1577,57530,3578767564,3578767564,0
2,1577,57531,3578767564,3578767564,0
2,1577,57532,3578767564,3578767564,0
2,1577,57533,3578767564,3578767564,0
2,1577,57534,3578767564,3578767564,0
2,1577,57535,3578767564,3578767565,1
2,1577,57536,3578767564,3578767566,2
2,1577,57537,3578767564,3578767568,4
2,1577,57538,3578767564,3578767569,5
2,1577,57539,3578767564,3578767569,5
2,1577,57540,3578767564,3578767571,7
2,1577,57541,3578767564,3578767571,7
2,1577,57542,3578767564,3578767572,8
2,1577,57543,3578767564,3578767574,10
2,1577,57544,3578767564,3578767575,11
2,1577,57545,3578767564,3578767575,11
2,1577,57546,3578767564,3578767575,11
2,1577,57547,3578767564,3578767578,14
2,1577,57548,3578767564,3578767578,14
2,1577,57549,3578767564,3578767578,14
2,1577,57550,3578767564,3578767579,15
2,1577,57551,3578767564,3578767582,18
2,1577,57552,3578767564,3578767583,19
2,1577,57553,3578767564,3578767583,19
2,1577,57554,3578767564,3578767584,20
2,1577,57555,3578767564,3578767584,20
2,1577,57556,3578767564,3578767584,20
2,1577,57557,3578767564,3578767585,21
2,1577,57558,3578767564,3578767585,21
2,1577,57559,3578767564,3578767587,23
2,1577,57560,3578767564,3578767587,23
2,1577,57561,3578767564,3578767587,23
2,1577,57562,3578767564,3578767588,24
2,1577,57563,3578767564,3578767588,24
2,1577,57564,3578767564,3578767588,24
2,1577,57565,3578767564,3578767589,25
2,1577,57566,3578767564,3578767590,26
2,1577,57567,3578767564,3578767590,26
2,1577,57568,3578767564,3578767590,26
2,1577,57569,3578767564,3578767590,26
2,1577,57570,3578767564,3578767591,27
2,1577,57571,3578767564,3578767592,28
2,1577,57572,3578767564,3578767594,30
2,1577,57573,3578767564,3578767597,33
2,1577,57574,3578767564,3578767598,34
2,1577,57575,3578767564,3578767599,35
2,1577,57576,3578767564,3578767600,36
2,1577,57577,3578767564,3578767601,37
2,1577,57578,3578767564,3578767602,38
2,1577,57579,3578767564,3578767602,38
2,1577,57580,3578767564,3578767604,40
2,1577,57581,3578767564,3578767604,40
2,1577,57582,3578767564,3578767605,41
2,1577,57583,3578767564,3578767605,41
2,1577,57584,3578767564,3578767606,42
2,1577,57585,3578767564,3578767606,42
2,1577,57586,3578767564,3578767606,42
2,1577,57587,3578767564,3578767610,46
2,1577,57588,3578767564,3578767611,47
2,1577,57589,3578767564,3578767612,48
2,1577,57590,3578767564,3578767613,49
2,1578,57591,3578767629,3578767629,0
2,1578,57592,3578767629,3578767629,0
2,1578,57593,3578767629,3578767629,0
2,1578,57594,3578767629,3578767629,0
2,1578,57595,3578767629,3578767629,0
2,1578,57596,3578767629,3578767629,0
2,1578,57597,3578767629,3578767629,0
2,1578,57598,3578767629,3578767629,0
2,1578,57599,3578767629,3578767629,0
2,1578,57600,3578767629,3578767629,0
2,1578,57601,3578767629,3578767629,0
2,1578,57602,3578767629,3578767629,0
2,1578,57603,3578767629,3578767629,0
2,1578,57604,3578767629,3578767629,0
2,1578,57605,3578767629,3578767631,2
2,1578,57606,3578767629,3578767631,2
2,1578,57607,3578767629,3578767631,2
2,1578,57608,3578767629,3578767632,3
2,1578,57609,3578767629,3578767632,3
2,1578,57610,3578767629,3578767634,5
2,1578,57611,3578767629,3578767635,6
2,1578,57612,3578767629,3578767635,6
2,1578,57613,3578767629,3578767636,7
2,1578,57614,3578767629,3578767637,8
2,1578,57615,3578767629,3578767638,9
2,1578,57616,3578767629,3578767638,9
2,1578,57617,3578767629,3578767639,10
2,1578,57618,3578767629,3578767639,10
2,1578,57619,3578767629,3578767640,11
2,1578,57620,3578767629,3578767640,11
2,1578,57621,3578767629,3578767641,12
2,1578,57622,3578767629,3578767641,12
2,1578,57623,3578767629,3578767641,12
2,1578,57624,3578767629,3578767641,12
2,1578,57625,3578767629,3578767641,12
2,1578,57626,3578767629,3578767642,13
2,1578,57627,3578767629,3578767643,14
2,1578,57628,3578767629,3578767644,15
2,1578,57629,3578767629,3578767645,16
2,1578,57630,3578767629,3578767646,17
2,1578,57631,3578767629,3578767648,19
2,1578,57632,3578767629,3578767649,20
2,1578,57633,3578767629,3578767649,20
2,1578,57634,3578767629,3578767650,21
2,1578,57635,3578767629,3578767650,21
2,1578,57636,3578767629,3578767650,21
2,1578,57637,3578767629,3578767651,22
2,1578,57638,3578767629,3578767652,23
2,1578,57639,3578767629,3578767653,24
2,1578,57640,3578767629,3578767653,24
2,1578,57641,3578767629,3578767653,24
2,1578,57642,3578767629,3578767654,25
2,1578,57643,3578767629,3578767654,25
2,1578,57644,3578767629,3578767657,28
2,1578,57645,3578767629,3578767659,30
2,1578,57646,3578767629,3578767660,31
2,1578,57647,3578767629,3578767661,32
2,1578,57648,3578767629,3578767663,34
2,1578,57649,3578767629,3578767664,35
2,1578,57650,3578767629,3578767664,35
2,1578,57651,3578767629,3578767666,37
2,1578,57652,3578767629,3578767667,38
2,1578,57653,3578767629,3578767667,38
2,1579,57654,3578767695,3578767695,0
2,1579,57655,3578767695,3578767695,0
2,1579,57656,3578767695,3578767695,0
2,1579,57657,3578767695,3578767695,0
2,1579,57658,3578767695,3578767695,0
2,1579,57659,3578767695,3578767695,0
2,1579,57660,3578767695,3578767695,0
2,1579,57661,3578767695,3578767695,0
2,1579,57662,3578767695,3578767695,0
2,1579,57663,3578767695,3578767695,0
2,1579,57664,3578767695,3578767695,0
2,1579,57665,3578767695,3578767695,0
2,1579,57666,3578767695,3578767695,0
2,1579,57667,3578767695,3578767695,0
2,1579,57668,3578767695,3578767695,0
2,1579,57669,3578767695,3578767695,0
2,1579,57670,3578767695,3578767695,0
2,1579,57671,3578767695,3578767695,0
2,1579,57672,3578767695,3578767696,1
2,1579,57673,3578767695,3578767696,1
2,1579,57674,3578767695,3578767699,4
2,1579,57675,3578767695,3578767699,4
2,1579,57676,3578767695,3578767699,4
2,1579,57677,3578767695,3578767700,5
2,1579,57678,3578767695,3578767700,5
2,1579,57679,3578767695,3578767701,6
2,1579,57680,3578767695,3578767702,7
2,1579,57681,3578767695,3578767702,7
2,1579,57682,3578767695,3578767702,7
2,1579,57683,3578767695,3578767703,8
2,1579,57684,3578767695,3578767704,9
2,1579,57685,3578767695,3578767704,9
2,1579,57686,3578767695,3578767705,10
2,1579,57687,3578767695,3578767708,13
2,1579,57688,3578767695,3578767708,13
2,1579,57689,3578767695,3578767708,13
2,1579,57690,3578767695,3578767710,15
2,1579,57691,3578767695,3578767710,15
2,1579,57692,3578767695,3578767711,16
2,1579,57693,3578767695,3578767711,16
2,1579,57694,3578767695,3578767712,17
2,1579,57695,3578767695,3578767713,18
2,1579,57696,3578767695,3578767713,18
2,1579,57697,3578767695,3578767715,20
2,1579,57698,3578767695,3578767715,20
2,1579,57699,3578767695,3578767716,21
2,1579,57700,3578767695,3578767717,22
2,1579,57701,3578767695,3578767717,22
2,1579,57702,3578767695,3578767717,22
2,1579,57703,3578767695,3578767717,22
2,1579,57704,3578767695,3578767718,23
2,1579,57705,3578767695,3578767719,24
2,1579,57706,3578767695,3578767721,26
2,1579,57707,3578767695,3578767721,26
2,1579,57708,3578767695,3578767722,27
2,1579,57709,3578767695,3578767722,27
2,1579,57710,3578767695,3578767722,27
2,1579,57711,3578767695,3578767722,27
2,1579,57712,3578767695,3578767725,30
2,1579,57713,3578767695,3578767725,30
2,1579,57714,3578767695,3578767725,30
2,1579,57715,3578767695,3578767726,31
2,1579,57716,3578767695,3578767726,31
2,1579,57717,3578767695,3578767727,32
2,1579,57718,3578767695,3578767728,33
2,1579,57719,3578767695,3578767730,35
2,1579,57720,3578767695,3578767732,37
2,1579,57721,3578767695,3578767734,39
2,1579,57722,3578767695,3578767734,39
2,1579,57723,3578767695,3578767735,40
2,1579,57724,3578767695,3578767737,42
2,1579,57725,3578767695,3578767737,42
2,1579,57726,3578767695,3578767737,42
2,1579,57727,3578767695,3578767737,42
2,1579,57728,3578767695,3578767738,43
2,1579,57729,3578767695,3578767738,43
2,1579,57730,3578767695,3578767738,43
2,1579,57731,3578767695,3578767739,44
2,1579,57732,3578767695,3578767739,44
2,1579,57733,3578767695,3578767740,45
2,1579,57734,3578767695,3578767743,48
2,1579,57735,3578767695,3578767744,49
2,1579,57736,3578767695,3578767744,49
2,1580,57737,3578767762,3578767762,0
2,1580,57738,3578767762,3578767762,0
2,1580,57739,3578767762,3578767762,0
2,1580,57740,3578767762,3578767762,0
2,1580,57741,3578767762,3578767762,0
2,1580,57742,3578767762,3578767762,0
2,1580,57743,3578767762,3578767762,0
2,1580,57744,3578767762,3578767762,0
2,1580,57745,3578767762,3578767762,0
2,1580,57746,3578767762,3578767762,0
2,1580,57747,3578767762,3578767762,0
2,1580,57748,3578767762,3578767762,0
2,1580,57749,3578767762,3578767762,0
2,1580,57750,3578767762,3578767762,0
2,1580,57751,3578767762,3578767762,0
2,1580,57752,3578767762,3578767762,0
2,1580,57753,3578767762,3578767762,0
2,1580,57754,3578767762,3578767762,0
2,1580,57755,3578767762,3578767762,0
2,1580,57756,3578767762,3578767763,1
2,1580,57757,3578767762,3578767764,2
2,1580,57758,3578767762,3578767765,3
2,1580,57759,3578767762,3578767766,4
2,1580,57760,3578767762,3578767768,6
2,1580,57761,3578767762,3578767769,7
2,1580,57762,3578767762,3578767770,8
2,1580,57763,3578767762,3578767771,9
2,1580,57764,3578767762,3578767772,10
2,1580,57765,3578767762,3578767775,13
2,1580,57766,3578767762,3578767775,13
2,1580,57767,3578767762,3578767775,13
2,1580,57768,3578767762,3578767775,13
2,1580,57769,3578767762,3578767777,15
2,1580,57770,3578767762,3578767778,16
2,1580,57771,3578767762,3578767779,17
2,1580,57772,3578767762,3578767780,18
2,1580,57773,3578767762,3578767782,20
2,1580,57774,3578767762,3578767783,21
2,1580,57775,3578767762,3578767783,21
2,1580,57776,3578767762,3578767784,22
2,1580,57777,3578767762,3578767784,22
2,1580,57778,3578767762,3578767785,23
2,1580,57779,3578767762,3578767785,23
2,1580,57780,3578767762,3578767786,24
2,1580,57781,3578767762,3578767787,25
2,1580,57782,3578767762,3578767787,25
2,1580,57783,3578767762,3578767788,26
2,1580,57784,3578767762,3578767788,26
2,1580,57785,3578767762,3578767788,26
2,1580,57786,3578767762,3578767789,27
2,1580,57787,3578767762,3578767789,27
2,1580,57788,3578767762,3578767790,28
2,1580,57789,3578767762,3578767790,28
2,1580,57790,3578767762,3578767790,28
2,1580,57791,3578767762,3578767790,28
2,1580,57792,3578767762,3578767791,29
2,1580,57793,3578767762,3578767792,30
2,1580,57794,3578767762,3578767794,32
2,1580,57795,3578767762,3578767798,36
2,1580,57796,3578767762,3578767799,37
2,1580,57797,3578767762,3578767800,38
2,1580,57798,3578767762,3578767801,39
2,1580,57799,3578767762,3578767802,40
2,1580,57800,3578767762,3578767802,40
2,1580,57801,3578767762,3578767804,42
2,1580,57802,3578767762,3578767804,42
2,1580,57803,3578767762,3578767804,42
2,1580,57804,3578767762,3578767805,43
2,1580,57805,3578767762,3578767805,43
2,1580,57806,3578767762,3578767806,44
2,1580,57807,3578767762,3578767808,46
2,1580,57808,3578767762,3578767811,49
2,1580,57809,3578767762,3578767811,49
2,1580,57810,3578767762,3578767812,50
2,1581,57811,3578767826,3578767826,0
2,1581,57812,3578767826,3578767826,0
2,1581,57813,3578767826,3578767826,0
2,1581,57814,3578767826,3578767826,0
2,1581,57815,3578767826,3578767826,0
2,1581,57816,3578767826,3578767826,0
2,1581,57817,3578767826,3578767826,0
2,1581,57818,3578767826,3578767826,0
2,1581,57819,3578767826,3578767826,0
2,1581,57820,3578767826,3578767826,0
2,1581,57821,3578767826,3578767827,1
2,1581,57822,3578767826,3578767827,1
2,1581,57823,3578767826,3578767828,2
2,1581,57824,3578767826,3578767828,2
2,1581,57825,3578767826,3578767829,3
2,1581,57826,3578767826,3578767831,5
2,1581,57827,3578767826,3578767831,5
2,1581,57828,3578767826,3578767831,5
2,1581,57829,3578767826,3578767833,7
2,1581,57830,3578767826,3578767833,7
2,1581,57831,3578767826,3578767834,8
2,1581,57832,3578767826,3578767835,9
2,1581,57833,3578767826,3578767836,10
2,1581,57834,3578767826,3578767836,10
2,1581,57835,3578767826,3578767837,11
2,1581,57836,3578767826,3578767837,11
2,1581,57837,3578767826,3578767838,12
2,1581,57838,3578767826,3578767838,12
2,1581,57839,3578767826,3578767839,13
2,1581,57840,3578767826,3578767840,14
2,1581,57841,3578767826,3578767840,14
2,1581,57842,3578767826,3578767841,15
2,1581,57843,3578767826,3578767841,15
2,1581,57844,3578767826,3578767842,16
2,1581,57845,3578767826,3578767842,16
2,1581,57846,3578767826,3578767843,17
2,1581,57847,3578767826,3578767844,18
2,1581,57848,3578767826,3578767844,18
2,1581,57849,3578767826,3578767845,19
2,1581,57850,3578767826,3578767847,21
2,1581,57851,3578767826,3578767847,21
2,1581,57852,3578767826,3578767848,22
2,1581,57853,3578767826,3578767849,23
2,1581,57854,3578767826,3578767849,23
2,1581,57855,3578767826,3578767850,24
2,1581,57856,3578767826,3578767850,24
2,1581,57857,3578767826,3578767850,24
2,1581,57858,3578767826,3578767851,25
2,1581,57859,3578767826,3578767852,26
2,1581,57860,3578767826,3578767853,27
2,1581,57861,3578767826,3578767854,28
2,1581,57862,3578767826,3578767854,28
2,1581,57863,3578767826,3578767854,28
2,1581,57864,3578767826,3578767855,29
2,1581,57865,3578767826,3578767858,32
2,1581,57866,3578767826,3578767859,33
2,1581,57867,3578767826,3578767861,35
2,1581,57868,3578767826,3578767862,36
2,1581,57869,3578767826,3578767863,37
2,1581,57870,3578767826,3578767866,40
2,1581,57871,3578767826,3578767867,41
2,1581,57872,3578767826,3578767867,41
2,1581,57873,3578767826,3578767867,41
2,1582,57874,3578767892,3578767892,0
2,1582,57875,3578767892,3578767892,0
2,1582,57876,3578767892,3578767892,0
2,1582,57877,3578767892,3578767892,0
2,1582,57878,3578767892,3578767892,0
2,1582,57879,3578767892,3578767892,0
2,1582,57880,3578767892,3578767892,0
2,1582,57881,3578767892,3578767892,0
2,1582,57882,3578767892,3578767892,0
2,1582,57883,3578767892,3578767892,0
2,1582,57884,3578767892,3578767892,0
2,1582,57885,3578767892,3578767892,0
2,1582,57886,3578767892,3578767893,1
2,1582,57887,3578767892,3578767894,2
2,1582,57888,3578767892,3578767895,3
2,1582,57889,3578767892,3578767895,3
2,1582,57890,3578767892,3578767895,3
2,1582,57891,3578767892,3578767895,3
2,1582,57892,3578767892,3578767895,3
2,1582,57893,3578767892,3578767895,3
2,1582,57894,3578767892,3578767896,4
2,1582,57895,3578767892,3578767898,6
2,1582,57896,3578767892,3578767898,6
2,1582,57897,3578767892,3578767899,7
2,1582,57898,3578767892,3578767900,8
2,1582,57899,3578767892,3578767900,8
2,1582,57900,3578767892,3578767900,8
2,1582,57901,3578767892,3578767902,10
2,1582,57902,3578767892,3578767902,10
2,1582,57903,3578767892,3578767902,10
2,1582,57904,3578767892,3578767903,11
2,1582,57905,3578767892,3578767904,12
2,1582,57906,3578767892,3578767904,12
2,1582,57907,3578767892,3578767905,13
2,1582,57908,3578767892,3578767908,16
2,1582,57909,3578767892,3578767908,16
2,1582,57910,3578767892,3578767910,18
2,1582,57911,3578767892,3578767911,19
2,1582,57912,3578767892,3578767911,19
2,1582,57913,3578767892,3578767912,20
2,1582,57914,3578767892,3578767913,21
2,1582,57915,3578767892,3578767913,21
2,1582,57916,3578767892,3578767915,23
2,1582,57917,3578767892,3578767916,24
2,1582,57918,3578767892,3578767916,24
2,1582,57919,3578767892,3578767916,24
2,1582,57920,3578767892,3578767917,25
2,1582,57921,3578767892,3578767917,25
2,1582,57922,3578767892,3578767917,25
2,1582,57923,3578767892,3578767918,26
2,1582,57924,3578767892,3578767919,27
2,1582,57925,3578767892,3578767921,29
2,1582,57926,3578767892,3578767922,30
2,1582,57927,3578767892,3578767922,30
2,1582,57928,3578767892,3578767922,30
2,1582,57929,3578767892,3578767922,30
2,1582,57930,3578767892,3578767923,31
2,1582,57931,3578767892,3578767925,33
2,1582,57932,3578767892,3578767925,33
2,1582,57933,3578767892,3578767925,33
2,1582,57934,3578767892,3578767926,34
2,1582,57935,3578767892,3578767927,35
2,1582,57936,3578767892,3578767928,36
2,1582,57937,3578767892,3578767928,36
2,1582,57938,3578767892,3578767930,38
2,1582,57939,3578767892,3578767932,40
2,1582,57940,3578767892,3578767933,41
2,1582,57941,3578767892,3578767934,42
2,1582,57942,3578767892,3578767935,43
2,1582,57943,3578767892,3578767936,44
2,1582,57944,3578767892,3578767936,44
2,1582,57945,3578767892,3578767937,45
2,1582,57946,3578767892,3578767937,45
2,1582,57947,3578767892,3578767938,46
2,1582,57948,3578767892,3578767938,46
2,1582,57949,3578767892,3578767938,46
2,1582,57950,3578767892,3578767939,47
2,1582,57951,3578767892,3578767939,47
2,1582,57952,3578767892,3578767940,48
2,1582,57953,3578767892,3578767942,50
2,1583,57954,3578767958,3578767958,0
2,1583,57955,3578767958,3578767958,0
2,1583,57956,3578767958,3578767958,0
2,1583,57957,3578767958,3578767958,0
2,1583,57958,3578767958,3578767958,0
2,1583,57959,3578767958,3578767958,0
2,1583,57960,3578767958,3578767958,0
2,1583,57961,3578767958,3578767958,0
2,1583,57962,3578767958,3578767958,0
2,1583,57963,3578767958,3578767958,0
2,1583,57964,3578767958,3578767958,0
2,1583,57965,3578767958,3578767958,0
2,1583,57966,3578767958,3578767958,0
2,1583,57967,3578767958,3578767958,0
2,1583,57968,3578767958,3578767958,0
2,1583,57969,3578767958,3578767958,0
2,1583,57970,3578767958,3578767958,0
2,1583,57971,3578767958,3578767958,0
2,1583,57972,3578767958,3578767958,0
2,1583,57973,3578767958,3578767958,0
2,1583,57974,3578767958,3578767959,1
2,1583,57975,3578767958,3578767961,3
2,1583,57976,3578767958,3578767963,5
2,1583,57977,3578767958,3578767964,6
2,1583,57978,3578767958,3578767965,7
2,1583,57979,3578767958,3578767965,7
2,1583,57980,3578767958,3578767965,7
2,1583,57981,3578767958,3578767966,8
2,1583,57982,3578767958,3578767968,10
2,1583,57983,3578767958,3578767969,11
2,1583,57984,3578767958,3578767970,12
2,1583,57985,3578767958,3578767971,13
2,1583,57986,3578767958,3578767972,14
2,1583,57987,3578767958,3578767974,16
2,1583,57988,3578767958,3578767975,17
2,1583,57989,3578767958,3578767975,17
2,1583,57990,3578767958,3578767975,17
2,1583,57991,3578767958,3578767976,18
2,1583,57992,3578767958,3578767978,20
2,1583,57993,3578767958,3578767978,20
2,1583,57994,3578767958,3578767979,21
2,1583,57995,3578767958,3578767980,22
2,1583,57996,3578767958,3578767983,25
2,1583,57997,3578767958,3578767983,25
2,1583,57998,3578767958,3578767984,26
2,1583,57999,3578767958,3578767984,26
2,1583,58000,3578767958,3578767984,26
2,1583,58001,3578767958,3578767985,27
2,1583,58002,3578767958,3578767985,27
2,1583,58003,3578767958,3578767987,29
2,1583,58004,3578767958,3578767987,29
2,1583,58005,3578767958,3578767987,29
2,1583,58006,3578767958,3578767988,30
2,1583,58007,3578767958,3578767988,30
2,1583,58008,3578767958,3578767988,30
2,1583,58009,3578767958,3578767990,32
2,1583,58010,3578767958,3578767990,32
2,1583,58011,3578767958,3578767990,32
2,1583,58012,3578767958,3578767990,32
2,1583,58013,3578767958,3578767991,33
2,1583,58014,3578767958,3578767991,33
2,1583,58015,3578767958,3578767993,35
2,1583,58016,3578767958,3578767997,39
2,1583,58017,3578767958,3578767998,40
2,1583,58018,3578767958,3578768001,43
2,1583,58019,3578767958,3578768001,43
2,1583,58020,3578767958,3578768002,44
2,1583,58021,3578767958,3578768003,45
2,1583,58022,3578767958,3578768004,46
2,1583,58023,3578767958,3578768004,46
2,1583,58024,3578767958,3578768004,46
2,1583,58025,3578767958,3578768005,47
2,1583,58026,3578767958,3578768006,48
2,1583,58027,3578767958,3578768006,48
2,1583,58028,3578767958,3578768008,50
2,1584,58029,3578768021,3578768021,0
2,1584,58030,3578768021,3578768021,0
2,1584,58031,3578768021,3578768021,0
2,1584,58032,3578768021,3578768021,0
2,1584,58033,3578768021,3578768021,0
2,1584,58034,3578768021,3578768021,0
2,1584,58035,3578768021,3578768021,0
2,1584,58036,3578768021,3578768021,0
2,1584,58037,3578768021,3578768021,0
2,1584,58038,3578768021,3578768022,1
2,1584,58039,3578768021,3578768024,3
2,1584,58040,3578768021,3578768025,4
2,1584,58041,3578768021,3578768027,6
2,1584,58042,3578768021,3578768027,6
2,1584,58043,3578768021,3578768027,6
2,1584,58044,3578768021,3578768028,7
2,1584,58045,3578768021,3578768029,8
2,1584,58046,3578768021,3578768031,10
2,1584,58047,3578768021,3578768032,11
2,1584,58048,3578768021,3578768032,11
2,1584,58049,3578768021,3578768032,11
2,1584,58050,3578768021,3578768033,12
2,1584,58051,3578768021,3578768034,13
2,1584,58052,3578768021,3578768035,14
2,1584,58053,3578768021,3578768036,15
2,1584,58054,3578768021,3578768036,15
2,1584,58055,3578768021,3578768037,16
2,1584,58056,3578768021,3578768037,16
2,1584,58057,3578768021,3578768038,17
2,1584,58058,3578768021,3578768038,17
2,1584,58059,3578768021,3578768040,19
2,1584,58060,3578768021,3578768040,19
2,1584,58061,3578768021,3578768041,20
2,1584,58062,3578768021,3578768042,21
2,1584,58063,3578768021,3578768042,21
2,1584,58064,3578768021,3578768042,21
2,1584,58065,3578768021,3578768043,22
2,1584,58066,3578768021,3578768044,23
2,1584,58067,3578768021,3578768044,23
2,1584,58068,3578768021,3578768044,23
2,1584,58069,3578768021,3578768044,23
2,1584,58070,3578768021,3578768047,26
2,1584,58071,3578768021,3578768048,27
2,1584,58072,3578768021,3578768048,27
2,1584,58073,3578768021,3578768049,28
2,1584,58074,3578768021,3578768050,29
2,1584,58075,3578768021,3578768051,30
2,1584,58076,3578768021,3578768051,30
2,1584,58077,3578768021,3578768051,30
2,1584,58078,3578768021,3578768052,31
2,1584,58079,3578768021,3578768053,32
2,1584,58080,3578768021,3578768053,32
2,1584,58081,3578768021,3578768054,33
2,1584,58082,3578768021,3578768054,33
2,1584,58083,3578768021,3578768055,34
2,1584,58084,3578768021,3578768060,39
2,1584,58085,3578768021,3578768062,41
2,1584,58086,3578768021,3578768064,43
2,1584,58087,3578768021,3578768066,45
2,1584,58088,3578768021,3578768066,45
2,1584,58089,3578768021,3578768066,45
2,1584,58090,3578768021,3578768067,46
2,1584,58091,3578768021,3578768067,46
2,1585,58092,3578768084,3578768084,0
2,1585,58093,3578768084,3578768084,0
2,1585,58094,3578768084,3578768085,1
2,1585,58095,3578768084,3578768087,3
2,1585,58096,3578768084,3578768088,4
2,1585,58097,3578768084,3578768089,5
2,1585,58098,3578768084,3578768090,6
2,1585,58099,3578768084,3578768091,7
2,1585,58100,3578768084,3578768091,7
2,1585,58101,3578768084,3578768091,7
2,1585,58102,3578768084,3578768093,9
2,1585,58103,3578768084,3578768093,9
2,1585,58104,3578768084,3578768095,11
2,1585,58105,3578768084,3578768095,11
2,1585,58106,3578768084,3578768095,11
2,1585,58107,3578768084,3578768096,12
2,1585,58108,3578768084,3578768096,12
2,1585,58109,3578768084,3578768096,12
2,1585,58110,3578768084,3578768096,12
2,1585,58111,3578768084,3578768098,14
2,1585,58112,3578768084,3578768098,14
2,1585,58113,3578768084,3578768099,15
2,1585,58114,3578768084,3578768099,15
2,1585,58115,3578768084,3578768100,16
2,1585,58116,3578768084,3578768100,16
2,1585,58117,3578768084,3578768102,18
2,1585,58118,3578768084,3578768103,19
2,1585,58119,3578768084,3578768105,21
2,1585,58120,3578768084,3578768105,21
2,1585,58121,3578768084,3578768105,21
2,1585,58122,3578768084,3578768108,24
2,1585,58123,3578768084,3578768108,24
2,1585,58124,3578768084,3578768108,24
2,1585,58125,3578768084,3578768109,25
2,1585,58126,3578768084,3578768111,27
2,1585,58127,3578768084,3578768111,27
2,1585,58128,3578768084,3578768113,29
2,1585,58129,3578768084,3578768113,29
2,1585,58130,3578768084,3578768113,29
2,1585,58131,3578768084,3578768116,32
2,1585,58132,3578768084,3578768116,32
2,1585,58133,3578768084,3578768117,33
2,1585,58134,3578768084,3578768117,33
2,1585,58135,3578768084,3578768117,33
2,1585,58136,3578768084,3578768118,34
2,1585,58137,3578768084,3578768119,35
2,1585,58138,3578768084,3578768120,36
2,1585,58139,3578768084,3578768121,37
2,1585,58140,3578768084,3578768122,38
2,1585,58141,3578768084,3578768122,38
2,1585,58142,3578768084,3578768122,38
2,1585,58143,3578768084,3578768123,39
2,1585,58144,3578768084,3578768123,39
2,1585,58145,3578768084,3578768125,41
2,1585,58146,3578768084,3578768126,42
2,1585,58147,3578768084,3578768126,42
2,1585,58148,3578768084,3578768126,42
2,1585,58149,3578768084,3578768127,43
2,1585,58150,3578768084,3578768127,43
2,1585,58151,3578768084,3578768129,45
2,1585,58152,3578768084,3578768129,45
2,1585,58153,3578768084,3578768132,48
2,1585,58154,3578768084,3578768132,48
2,1585,58155,3578768084,3578768133,49
2,1586,58156,3578768149,3578768149,0
2,1586,58157,3578768149,3578768149,0
2,1586,58158,3578768149,3578768149,0
2,1586,58159,3578768149,3578768149,0
2,1586,58160,3578768149,3578768149,0
2,1586,58161,3578768149,3578768149,0
2,1586,58162,3578768149,3578768149,0
2,1586,58163,3578768149,3578768149,0
2,1586,58164,3578768149,3578768149,0
2,1586,58165,3578768149,3578768149,0
2,1586,58166,3578768149,3578768149,0
2,1586,58167,3578768149,3578768149,0
2,1586,58168,3578768149,3578768149,0
2,1586,58169,3578768149,3578768149,0
2,1586,58170,3578768149,3578768149,0
2,1586,58171,3578768149,3578768149,0
2,1586,58172,3578768149,3578768149,0
2,1586,58173,3578768149,3578768149,0
2,1586,58174,3578768149,3578768149,0
2,1586,58175,3578768149,3578768150,1
2,1586,58176,3578768149,3578768151,2
2,1586,58177,3578768149,3578768151,2
2,1586,58178,3578768149,3578768151,2
2,1586,58179,3578768149,3578768151,2
2,1586,58180,3578768149,3578768152,3
2,1586,58181,3578768149,3578768153,4
2,1586,58182,3578768149,3578768153,4
2,1586,58183,3578768149,3578768153,4
2,1586,58184,3578768149,3578768153,4
2,1586,58185,3578768149,3578768155,6
2,1586,58186,3578768149,3578768156,7
2,1586,58187,3578768149,3578768157,8
2,1586,58188,3578768149,3578768159,10
2,1586,58189,3578768149,3578768162,13
2,1586,58190,3578768149,3578768163,14
2,1586,58191,3578768149,3578768165,16
2,1586,58192,3578768149,3578768165,16
2,1586,58193,3578768149,3578768166,17
2,1586,58194,3578768149,3578768166,17
2,1586,58195,3578768149,3578768166,17
2,1586,58196,3578768149,3578768170,21
2,1586,58197,3578768149,3578768170,21
2,1586,58198,3578768149,3578768173,24
2,1586,58199,3578768149,3578768174,25
2,1586,58200,3578768149,3578768174,25
2,1586,58201,3578768149,3578768175,26
2,1586,58202,3578768149,3578768175,26
2,1586,58203,3578768149,3578768176,27
2,1586,58204,3578768149,3578768178,29
2,1586,58205,3578768149,3578768178,29
2,1586,58206,3578768149,3578768180,31
2,1586,58207,3578768149,3578768180,31
2,1586,58208,3578768149,3578768183,34
2,1586,58209,3578768149,3578768184,35
2,1586,58210,3578768149,3578768184,35
2,1586,58211,3578768149,3578768184,35
2,1586,58212,3578768149,3578768185,36
2,1586,58213,3578768149,3578768185,36
2,1586,58214,3578768149,3578768185,36
2,1586,58215,3578768149,3578768186,37
2,1586,58216,3578768149,3578768187,38
2,1586,58217,3578768149,3578768188,39
2,1586,58218,3578768149,3578768188,39
2,1586,58219,3578768149,3578768188,39
2,1586,58220,3578768149,3578768188,39
2,1586,58221,3578768149,3578768189,40
2,1586,58222,3578768149,3578768190,41
2,1586,58223,3578768149,3578768190,41
2,1586,58224,3578768149,3578768191,42
2,1586,58225,3578768149,3578768191,42
2,1586,58226,3578768149,3578768191,42
2,1586,58227,3578768149,3578768194,45
2,1586,58228,3578768149,3578768197,48
2,1586,58229,3578768149,3578768197,48
2,1586,58230,3578768149,3578768198,49
2,1587,58231,3578768215,3578768215,0
2,1587,58232,3578768215,3578768215,0
2,1587,58233,3578768215,3578768215,0
2,1587,58234,3578768215,3578768215,0
2,1587,58235,3578768215,3578768215,0
2,1587,58236,3578768215,3578768215,0
2,1587,58237,3578768215,3578768215,0
2,1587,58238,3578768215,3578768215,0
2,1587,58239,3578768215,3578768215,0
2,1587,58240,3578768215,3578768215,0
2,1587,58241,3578768215,3578768215,0
2,1587,58242,3578768215,3578768215,0
2,1587,58243,3578768215,3578768215,0
2,1587,58244,3578768215,3578768215,0
2,1587,58245,3578768215,3578768215,0
2,1587,58246,3578768215,3578768215,0
2,1587,58247,3578768215,3578768217,2
2,1587,58248,3578768215,3578768218,3
2,1587,58249,3578768215,3578768218,3
2,1587,58250,3578768215,3578768222,7
2,1587,58251,3578768215,3578768222,7
2,1587,58252,3578768215,3578768222,7
2,1587,58253,3578768215,3578768225,10
2,1587,58254,3578768215,3578768227,12
2,1587,58255,3578768215,3578768227,12
2,1587,58256,3578768215,3578768228,13
2,1587,58257,3578768215,3578768230,15
2,1587,58258,3578768215,3578768231,16
2,1587,58259,3578768215,3578768232,17
2,1587,58260,3578768215,3578768232,17
2,1587,58261,3578768215,3578768233,18
2,1587,58262,3578768215,3578768233,18
2,1587,58263,3578768215,3578768234,19
2,1587,58264,3578768215,3578768235,20
2,1587,58265,3578768215,3578768236,21
2,1587,58266,3578768215,3578768237,22
2,1587,58267,3578768215,3578768237,22
2,1587,58268,3578768215,3578768238,23
2,1587,58269,3578768215,3578768239,24
2,1587,58270,3578768215,3578768239,24
2,1587,58271,3578768215,3578768240,25
2,1587,58272,3578768215,3578768240,25
2,1587,58273,3578768215,3578768241,26
2,1587,58274,3578768215,3578768242,27
2,1587,58275,3578768215,3578768242,27
2,1587,58276,3578768215,3578768242,27
2,1587,58277,3578768215,3578768243,28
2,1587,58278,3578768215,3578768244,29
2,1587,58279,3578768215,3578768244,29
2,1587,58280,3578768215,3578768246,31
2,1587,58281,3578768215,3578768246,31
2,1587,58282,3578768215,3578768247,32
2,1587,58283,3578768215,3578768248,33
2,1587,58284,3578768215,3578768249,34
2,1587,58285,3578768215,3578768250,35
2,1587,58286,3578768215,3578768250,35
2,1587,58287,3578768215,3578768251,36
2,1587,58288,3578768215,3578768251,36
2,1587,58289,3578768215,3578768252,37
2,1587,58290,3578768215,3578768253,38
2,1587,58291,3578768215,3578768253,38
2,1587,58292,3578768215,3578768253,38
2,1587,58293,3578768215,3578768254,39
2,1587,58294,3578768215,3578768254,39
2,1587,58295,3578768215,3578768254,39
2,1587,58296,3578768215,3578768260,45
2,1587,58297,3578768215,3578768262,47
2,1587,58298,3578768215,3578768262,47
2,1587,58299,3578768215,3578768264,49
2,1588,58300,3578768280,3578768280,0
2,1588,58301,3578768280,3578768280,0
2,1588,58302,3578768280,3578768280,0
2,1588,58303,3578768280,3578768280,0
2,1588,58304,3578768280,3578768280,0
2,1588,58305,3578768280,3578768283,3
2,1588,58306,3578768280,3578768286,6
2,1588,58307,3578768280,3578768288,8
2,1588,58308,3578768280,3578768288,8
2,1588,58309,3578768280,3578768289,9
2,1588,58310,3578768280,3578768290,10
2,1588,58311,3578768280,3578768291,11
2,1588,58312,3578768280,3578768291,11
2,1588,58313,3578768280,3578768291,11
2,1588,58314,3578768280,3578768292,12
2,1588,58315,3578768280,3578768292,12
2,1588,58316,3578768280,3578768293,13
2,1588,58317,3578768280,3578768294,14
2,1588,58318,3578768280,3578768295,15
2,1588,58319,3578768280,3578768295,15
2,1588,58320,3578768280,3578768295,15
2,1588,58321,3578768280,3578768295,15
2,1588,58322,3578768280,3578768296,16
2,1588,58323,3578768280,3578768296,16
2,1588,58324,3578768280,3578768296,16
2,1588,58325,3578768280,3578768298,18
2,1588,58326,3578768280,3578768298,18
2,1588,58327,3578768280,3578768299,19
2,1588,58328,3578768280,3578768300,20
2,1588,58329,3578768280,3578768300,20
2,1588,58330,3578768280,3578768300,20
2,1588,58331,3578768280,3578768300,20
2,1588,58332,3578768280,3578768302,22
2,1588,58333,3578768280,3578768302,22
2,1588,58334,3578768280,3578768304,24
2,1588,58335,3578768280,3578768304,24
2,1588,58336,3578768280,3578768305,25
2,1588,58337,3578768280,3578768305,25
2,1588,58338,3578768280,3578768305,25
2,1588,58339,3578768280,3578768308,28
2,1588,58340,3578768280,3578768308,28
2,1588,58341,3578768280,3578768309,29
2,1588,58342,3578768280,3578768309,29
2,1588,58343,3578768280,3578768311,31
2,1588,58344,3578768280,3578768311,31
2,1588,58345,3578768280,3578768312,32
2,1588,58346,3578768280,3578768313,33
2,1588,58347,3578768280,3578768313,33
2,1588,58348,3578768280,3578768313,33
2,1588,58349,3578768280,3578768315,35
2,1588,58350,3578768280,3578768315,35
2,1588,58351,3578768280,3578768316,36
2,1588,58352,3578768280,3578768316,36
2,1588,58353,3578768280,3578768317,37
2,1588,58354,3578768280,3578768318,38
2,1588,58355,3578768280,3578768318,38
2,1588,58356,3578768280,3578768319,39
2,1588,58357,3578768280,3578768320,40
2,1588,58358,3578768280,3578768321,41
2,1588,58359,3578768280,3578768322,42
2,1588,58360,3578768280,3578768322,42
2,1588,58361,3578768280,3578768322,42
2,1588,58362,3578768280,3578768323,43
2,1588,58363,3578768280,3578768325,45
2,1588,58364,3578768280,3578768326,46
2,1588,58365,3578768280,3578768326,46
2,1588,58366,3578768280,3578768327,47
2,1588,58367,3578768280,3578768327,47
2,1588,58368,3578768280,3578768327,47
2,1588,58369,3578768280,3578768329,49
2,1588,58370,3578768280,3578768329,49
2,1589,58371,3578768347,3578768347,0
2,1589,58372,3578768347,3578768347,0
2,1589,58373,3578768347,3578768347,0
2,1589,58374,3578768347,3578768347,0
2,1589,58375,3578768347,3578768347,0
2,1589,58376,3578768347,3578768347,0
2,1589,58377,3578768347,3578768347,0
2,1589,58378,3578768347,3578768347,0
2,1589,58379,3578768347,3578768347,0
2,1589,58380,3578768347,3578768347,0
2,1589,58381,3578768347,3578768347,0
2,1589,58382,3578768347,3578768347,0
2,1589,58383,3578768347,3578768347,0
2,1589,58384,3578768347,3578768347,0
2,1589,58385,3578768347,3578768347,0
2,1589,58386,3578768347,3578768347,0
2,1589,58387,3578768347,3578768347,0
2,1589,58388,3578768347,3578768347,0
2,1589,58389,3578768347,3578768347,0
2,1589,58390,3578768347,3578768347,0
2,1589,58391,3578768347,3578768347,0
2,1589,58392,3578768347,3578768347,0
2,1589,58393,3578768347,3578768348,1
2,1589,58394,3578768347,3578768350,3
2,1589,58395,3578768347,3578768351,4
2,1589,58396,3578768347,3578768352,5
2,1589,58397,3578768347,3578768352,5
2,1589,58398,3578768347,3578768352,5
2,1589,58399,3578768347,3578768353,6
2,1589,58400,3578768347,3578768353,6
2,1589,58401,3578768347,3578768353,6
2,1589,58402,3578768347,3578768354,7
2,1589,58403,3578768347,3578768354,7
2,1589,58404,3578768347,3578768355,8
2,1589,58405,3578768347,3578768357,10
2,1589,58406,3578768347,3578768357,10
2,1589,58407,3578768347,3578768357,10
2,1589,58408,3578768347,3578768359,12
2,1589,58409,3578768347,3578768362,15
2,1589,58410,3578768347,3578768363,16
2,1589,58411,3578768347,3578768364,17
2,1589,58412,3578768347,3578768366,19
2,1589,58413,3578768347,3578768366,19
2,1589,58414,3578768347,3578768366,19
2,1589,58415,3578768347,3578768366,19
2,1589,58416,3578768347,3578768370,23
2,1589,58417,3578768347,3578768371,24
2,1589,58418,3578768347,3578768372,25
2,1589,58419,3578768347,3578768372,25
2,1589,58420,3578768347,3578768374,27
2,1589,58421,3578768347,3578768375,28
2,1589,58422,3578768347,3578768375,28
2,1589,58423,3578768347,3578768376,29
2,1589,58424,3578768347,3578768379,32
2,1589,58425,3578768347,3578768379,32
2,1589,58426,3578768347,3578768380,33
2,1589,58427,3578768347,3578768380,33
2,1589,58428,3578768347,3578768383,36
2,1589,58429,3578768347,3578768383,36
2,1589,58430,3578768347,3578768384,37
2,1589,58431,3578768347,3578768384,37
2,1589,58432,3578768347,3578768385,38
2,1589,58433,3578768347,3578768386,39
2,1589,58434,3578768347,3578768386,39
2,1589,58435,3578768347,3578768387,40
2,1589,58436,3578768347,3578768388,41
2,1589,58437,3578768347,3578768388,41
2,1589,58438,3578768347,3578768388,41
2,1589,58439,3578768347,3578768389,42
2,1589,58440,3578768347,3578768389,42
2,1589,58441,3578768347,3578768390,43
2,1589,58442,3578768347,3578768390,43
2,1589,58443,3578768347,3578768391,44
2,1589,58444,3578768347,3578768391,44
2,1589,58445,3578768347,3578768391,44
2,1589,58446,3578768347,3578768391,44
2,1589,58447,3578768347,3578768394,47
2,1589,58448,3578768347,3578768397,50
2,1590,58449,3578768412,3578768412,0
2,1590,58450,3578768412,3578768412,0
2,1590,58451,3578768412,3578768412,0
2,1590,58452,3578768412,3578768412,0
2,1590,58453,3578768412,3578768412,0
2,1590,58454,3578768412,3578768412,0
2,1590,58455,3578768412,3578768412,0
2,1590,58456,3578768412,3578768412,0
2,1590,58457,3578768412,3578768412,0
2,1590,58458,3578768412,3578768412,0
2,1590,58459,3578768412,3578768412,0
2,1590,58460,3578768412,3578768412,0
2,1590,58461,3578768412,3578768412,0
2,1590,58462,3578768412,3578768412,0
2,1590,58463,3578768412,3578768412,0
2,1590,58464,3578768412,3578768413,1
2,1590,58465,3578768412,3578768414,2
2,1590,58466,3578768412,3578768414,2
2,1590,58467,3578768412,3578768415,3
2,1590,58468,3578768412,3578768417,5
2,1590,58469,3578768412,3578768417,5
2,1590,58470,3578768412,3578768420,8
2,1590,58471,3578768412,3578768421,9
2,1590,58472,3578768412,3578768422,10
2,1590,58473,3578768412,3578768424,12
2,1590,58474,3578768412,3578768424,12
2,1590,58475,3578768412,3578768427,15
2,1590,58476,3578768412,3578768427,15
2,1590,58477,3578768412,3578768428,16
2,1590,58478,3578768412,3578768428,16
2,1590,58479,3578768412,3578768428,16
2,1590,58480,3578768412,3578768429,17
2,1590,58481,3578768412,3578768431,19
2,1590,58482,3578768412,3578768432,20
2,1590,58483,3578768412,3578768432,20
2,1590,58484,3578768412,3578768432,20
2,1590,58485,3578768412,3578768433,21
2,1590,58486,3578768412,3578768433,21
2,1590,58487,3578768412,3578768434,22
2,1590,58488,3578768412,3578768435,23
2,1590,58489,3578768412,3578768436,24
2,1590,58490,3578768412,3578768437,25
2,1590,58491,3578768412,3578768437,25
2,1590,58492,3578768412,3578768438,26
2,1590,58493,3578768412,3578768440,28
2,1590,58494,3578768412,3578768440,28
2,1590,58495,3578768412,3578768441,29
2,1590,58496,3578768412,3578768441,29
2,1590,58497,3578768412,3578768441,29
2,1590,58498,3578768412,3578768442,30
2,1590,58499,3578768412,3578768442,30
2,1590,58500,3578768412,3578768442,30
2,1590,58501,3578768412,3578768443,31
2,1590,58502,3578768412,3578768443,31
2,1590,58503,3578768412,3578768444,32
2,1590,58504,3578768412,3578768447,35
2,1590,58505,3578768412,3578768447,35
2,1590,58506,3578768412,3578768448,36
2,1590,58507,3578768412,3578768448,36
2,1590,58508,3578768412,3578768449,37
2,1590,58509,3578768412,3578768451,39
2,1590,58510,3578768412,3578768451,39
2,1590,58511,3578768412,3578768451,39
2,1590,58512,3578768412,3578768452,40
2,1590,58513,3578768412,3578768452,40
2,1590,58514,3578768412,3578768453,41
2,1590,58515,3578768412,3578768454,42
2,1590,58516,3578768412,3578768454,42
2,1590,58517,3578768412,3578768455,43
2,1590,58518,3578768412,3578768455,43
2,1590,58519,3578768412,3578768460,48
2,1591,58520,3578768477,3578768477,0
2,1591,58521,3578768477,3578768477,0
2,1591,58522,3578768477,3578768477,0
2,1591,58523,3578768477,3578768477,0
2,1591,58524,3578768477,3578768477,0
2,1591,58525,3578768477,3578768477,0
2,1591,58526,3578768477,3578768477,0
2,1591,58527,3578768477,3578768483,6
2,1591,58528,3578768477,3578768486,9
2,1591,58529,3578768477,3578768487,10
2,1591,58530,3578768477,3578768489,12
2,1591,58531,3578768477,3578768489,12
2,1591,58532,3578768477,3578768490,13
2,1591,58533,3578768477,3578768491,14
2,1591,58534,3578768477,3578768491,14
2,1591,58535,3578768477,3578768491,14
2,1591,58536,3578768477,3578768492,15
2,1591,58537,3578768477,3578768492,15
2,1591,58538,3578768477,3578768492,15
2,1591,58539,3578768477,3578768493,16
2,1591,58540,3578768477,3578768494,17
2,1591,58541,3578768477,3578768495,18
2,1591,58542,3578768477,3578768495,18
2,1591,58543,3578768477,3578768495,18
2,1591,58544,3578768477,3578768495,18
2,1591,58545,3578768477,3578768496,19
2,1591,58546,3578768477,3578768496,19
2,1591,58547,3578768477,3578768496,19
2,1591,58548,3578768477,3578768498,21
2,1591,58549,3578768477,3578768499,22
2,1591,58550,3578768477,3578768499,22
2,1591,58551,3578768477,3578768499,22
2,1591,58552,3578768477,3578768500,23
2,1591,58553,3578768477,3578768500,23
2,1591,58554,3578768477,3578768500,23
2,1591,58555,3578768477,3578768502,25
2,1591,58556,3578768477,3578768502,25
2,1591,58557,3578768477,3578768504,27
2,1591,58558,3578768477,3578768504,27
2,1591,58559,3578768477,3578768505,28
2,1591,58560,3578768477,3578768505,28
2,1591,58561,3578768477,3578768506,29
2,1591,58562,3578768477,3578768508,31
2,1591,58563,3578768477,3578768508,31
2,1591,58564,3578768477,3578768508,31
2,1591,58565,3578768477,3578768509,32
2,1591,58566,3578768477,3578768511,34
2,1591,58567,3578768477,3578768511,34
2,1591,58568,3578768477,3578768511,34
2,1591,58569,3578768477,3578768513,36
2,1591,58570,3578768477,3578768513,36
2,1591,58571,3578768477,3578768513,36
2,1591,58572,3578768477,3578768514,37
2,1591,58573,3578768477,3578768515,38
2,1591,58574,3578768477,3578768516,39
2,1591,58575,3578768477,3578768516,39
2,1591,58576,3578768477,3578768517,40
2,1591,58577,3578768477,3578768519,42
2,1591,58578,3578768477,3578768519,42
2,1591,58579,3578768477,3578768519,42
2,1591,58580,3578768477,3578768521,44
2,1591,58581,3578768477,3578768522,45
2,1591,58582,3578768477,3578768522,45
2,1591,58583,3578768477,3578768522,45
2,1591,58584,3578768477,3578768523,46
2,1591,58585,3578768477,3578768526,49
2,1591,58586,3578768477,3578768527,50
2,1592,58587,3578768542,3578768542,0
2,1592,58588,3578768542,3578768542,0
2,1592,58589,3578768542,3578768542,0
2,1592,58590,3578768542,3578768542,0
2,1592,58591,3578768542,3578768542,0
2,1592,58592,3578768542,3578768542,0
2,1592,58593,3578768542,3578768542,0
2,1592,58594,3578768542,3578768542,0
2,1592,58595,3578768542,3578768542,0
2,1592,58596,3578768542,3578768542,0
2,1592,58597,3578768542,3578768542,0
2,1592,58598,3578768542,3578768542,0
2,1592,58599,3578768542,3578768542,0
2,1592,58600,3578768542,3578768542,0
2,1592,58601,3578768542,3578768542,0
2,1592,58602,3578768542,3578768542,0
2,1592,58603,3578768542,3578768542,0
2,1592,58604,3578768542,3578768542,0
2,1592,58605,3578768542,3578768542,0
2,1592,58606,3578768542,3578768542,0
2,1592,58607,3578768542,3578768542,0
2,1592,58608,3578768542,3578768542,0
2,1592,58609,3578768542,3578768544,2
2,1592,58610,3578768542,3578768544,2
2,1592,58611,3578768542,3578768544,2
2,1592,58612,3578768542,3578768545,3
2,1592,58613,3578768542,3578768548,6
2,1592,58614,3578768542,3578768549,7
2,1592,58615,3578768542,3578768550,8
2,1592,58616,3578768542,3578768550,8
2,1592,58617,3578768542,3578768550,8
2,1592,58618,3578768542,3578768551,9
2,1592,58619,3578768542,3578768551,9
2,1592,58620,3578768542,3578768551,9
2,1592,58621,3578768542,3578768552,10
2,1592,58622,3578768542,3578768552,10
2,1592,58623,3578768542,3578768553,11
2,1592,58624,3578768542,3578768554,12
2,1592,58625,3578768542,3578768554,12
2,1592,58626,3578768542,3578768555,13
2,1592,58627,3578768542,3578768557,15
2,1592,58628,3578768542,3578768557,15
2,1592,58629,3578768542,3578768558,16
2,1592,58630,3578768542,3578768562,20
2,1592,58631,3578768542,3578768563,21
2,1592,58632,3578768542,3578768564,22
2,1592,58633,3578768542,3578768565,23
2,1592,58634,3578768542,3578768565,23
2,1592,58635,3578768542,3578768565,23
2,1592,58636,3578768542,3578768569,27
2,1592,58637,3578768542,3578768569,27
2,1592,58638,3578768542,3578768570,28
2,1592,58639,3578768542,3578768570,28
2,1592,58640,3578768542,3578768573,31
2,1592,58641,3578768542,3578768574,32
2,1592,58642,3578768542,3578768574,32
2,1592,58643,3578768542,3578768575,33
2,1592,58644,3578768542,3578768577,35
2,1592,58645,3578768542,3578768578,36
2,1592,58646,3578768542,3578768579,37
2,1592,58647,3578768542,3578768582,40
2,1592,58648,3578768542,3578768582,40
2,1592,58649,3578768542,3578768583,41
2,1592,58650,3578768542,3578768583,41
2,1592,58651,3578768542,3578768583,41
2,1592,58652,3578768542,3578768584,42
2,1592,58653,3578768542,3578768586,44
2,1592,58654,3578768542,3578768586,44
2,1592,58655,3578768542,3578768588,46
2,1592,58656,3578768542,3578768588,46
2,1592,58657,3578768542,3578768588,46
2,1592,58658,3578768542,3578768588,46
2,1592,58659,3578768542,3578768588,46
2,1592,58660,3578768542,3578768590,48
2,1592,58661,3578768542,3578768590,48
2,1592,58662,3578768542,3578768590,48
2,1592,58663,3578768542,3578768590,48
2,1592,58664,3578768542,3578768591,49
2,1592,58665,3578768542,3578768591,49
2,1592,58666,3578768542,3578768592,50
2,1593,58667,3578768606,3578768606,0
2,1593,58668,3578768606,3578768606,0
2,1593,58669,3578768606,3578768606,0
2,1593,58670,3578768606,3578768606,0
2,1593,58671,3578768606,3578768606,0
2,1593,58672,3578768606,3578768606,0
2,1593,58673,3578768606,3578768606,0
2,1593,58674,3578768606,3578768606,0
2,1593,58675,3578768606,3578768606,0
2,1593,58676,3578768606,3578768606,0
2,1593,58677,3578768606,3578768606,0
2,1593,58678,3578768606,3578768606,0
2,1593,58679,3578768606,3578768606,0
2,1593,58680,3578768606,3578768608,2
2,1593,58681,3578768606,3578768612,6
2,1593,58682,3578768606,3578768613,7
2,1593,58683,3578768606,3578768613,7
2,1593,58684,3578768606,3578768614,8
2,1593,58685,3578768606,3578768616,10
2,1593,58686,3578768606,3578768616,10
2,1593,58687,3578768606,3578768618,12
2,1593,58688,3578768606,3578768622,16
2,1593,58689,3578768606,3578768622,16
2,1593,58690,3578768606,3578768623,17
2,1593,58691,3578768606,3578768623,17
2,1593,58692,3578768606,3578768626,20
2,1593,58693,3578768606,3578768626,20
2,1593,58694,3578768606,3578768627,21
2,1593,58695,3578768606,3578768627,21
2,1593,58696,3578768606,3578768628,22
2,1593,58697,3578768606,3578768631,25
2,1593,58698,3578768606,3578768631,25
2,1593,58699,3578768606,3578768631,25
2,1593,58700,3578768606,3578768631,25
2,1593,58701,3578768606,3578768633,27
2,1593,58702,3578768606,3578768634,28
2,1593,58703,3578768606,3578768635,29
2,1593,58704,3578768606,3578768635,29
2,1593,58705,3578768606,3578768636,30
2,1593,58706,3578768606,3578768636,30
2,1593,58707,3578768606,3578768637,31
2,1593,58708,3578768606,3578768639,33
2,1593,58709,3578768606,3578768639,33
2,1593,58710,3578768606,3578768639,33
2,1593,58711,3578768606,3578768639,33
2,1593,58712,3578768606,3578768640,34
2,1593,58713,3578768606,3578768641,35
2,1593,58714,3578768606,3578768641,35
2,1593,58715,3578768606,3578768641,35
2,1593,58716,3578768606,3578768642,36
2,1593,58717,3578768606,3578768642,36
2,1593,58718,3578768606,3578768643,37
2,1593,58719,3578768606,3578768644,38
2,1593,58720,3578768606,3578768646,40
2,1593,58721,3578768606,3578768646,40
2,1593,58722,3578768606,3578768647,41
2,1593,58723,3578768606,3578768648,42
2,1593,58724,3578768606,3578768649,43
2,1593,58725,3578768606,3578768650,44
2,1593,58726,3578768606,3578768651,45
2,1593,58727,3578768606,3578768651,45
2,1593,58728,3578768606,3578768651,45
2,1593,58729,3578768606,3578768651,45
2,1593,58730,3578768606,3578768652,46
2,1593,58731,3578768606,3578768653,47
2,1593,58732,3578768606,3578768653,47
2,1593,58733,3578768606,3578768654,48
2,1593,58734,3578768606,3578768655,49
2,1594,58735,3578768671,3578768671,0
2,1594,58736,3578768671,3578768671,0
2,1594,58737,3578768671,3578768671,0
2,1594,58738,3578768671,3578768671,0
2,1594,58739,3578768671,3578768671,0
2,1594,58740,3578768671,3578768671,0
2,1594,58741,3578768671,3578768671,0
2,1594,58742,3578768671,3578768671,0
2,1594,58743,3578768671,3578768671,0
2,1594,58744,3578768671,3578768684,13
2,1594,58745,3578768671,3578768686,15
2,1594,58746,3578768671,3578768687,16
2,1594,58747,3578768671,3578768689,18
2,1594,58748,3578768671,3578768689,18
2,1594,58749,3578768671,3578768690,19
2,1594,58750,3578768671,3578768691,20
2,1594,58751,3578768671,3578768691,20
2,1594,58752,3578768671,3578768692,21
2,1594,58753,3578768671,3578768692,21
2,1594,58754,3578768671,3578768692,21
2,1594,58755,3578768671,3578768692,21
2,1594,58756,3578768671,3578768694,23
2,1594,58757,3578768671,3578768694,23
2,1594,58758,3578768671,3578768695,24
2,1594,58759,3578768671,3578768695,24
2,1594,58760,3578768671,3578768695,24
2,1594,58761,3578768671,3578768696,25
2,1594,58762,3578768671,3578768696,25
2,1594,58763,3578768671,3578768698,27
2,1594,58764,3578768671,3578768699,28
2,1594,58765,3578768671,3578768699,28
2,1594,58766,3578768671,3578768699,28
2,1594,58767,3578768671,3578768700,29
2,1594,58768,3578768671,3578768701,30
2,1594,58769,3578768671,3578768701,30
2,1594,58770,3578768671,3578768702,31
2,1594,58771,3578768671,3578768704,33
2,1594,58772,3578768671,3578768704,33
2,1594,58773,3578768671,3578768705,34
2,1594,58774,3578768671,3578768705,34
2,1594,58775,3578768671,3578768706,35
2,1594,58776,3578768671,3578768708,37
2,1594,58777,3578768671,3578768708,37
2,1594,58778,3578768671,3578768709,38
2,1594,58779,3578768671,3578768710,39
2,1594,58780,3578768671,3578768711,40
2,1594,58781,3578768671,3578768711,40
2,1594,58782,3578768671,3578768712,41
2,1594,58783,3578768671,3578768713,42
2,1594,58784,3578768671,3578768713,42
2,1594,58785,3578768671,3578768713,42
2,1594,58786,3578768671,3578768716,45
2,1594,58787,3578768671,3578768716,45
2,1594,58788,3578768671,3578768716,45
2,1594,58789,3578768671,3578768716,45
2,1594,58790,3578768671,3578768717,46
2,1594,58791,3578768671,3578768718,47
2,1594,58792,3578768671,3578768719,48
2,1595,58793,3578768736,3578768736,0
2,1595,58794,3578768736,3578768736,0
2,1595,58795,3578768736,3578768736,0
2,1595,58796,3578768736,3578768736,0
2,1595,58797,3578768736,3578768736,0
2,1595,58798,3578768736,3578768736,0
2,1595,58799,3578768736,3578768736,0
2,1595,58800,3578768736,3578768736,0
2,1595,58801,3578768736,3578768736,0
2,1595,58802,3578768736,3578768736,0
2,1595,58803,3578768736,3578768736,0
2,1595,58804,3578768736,3578768736,0
2,1595,58805,3578768736,3578768736,0
2,1595,58806,3578768736,3578768736,0
2,1595,58807,3578768736,3578768736,0
2,1595,58808,3578768736,3578768736,0
2,1595,58809,3578768736,3578768736,0
2,1595,58810,3578768736,3578768736,0
2,1595,58811,3578768736,3578768737,1
2,1595,58812,3578768736,3578768737,1
2,1595,58813,3578768736,3578768738,2
2,1595,58814,3578768736,3578768738,2
2,1595,58815,3578768736,3578768738,2
2,1595,58816,3578768736,3578768738,2
2,1595,58817,3578768736,3578768739,3
2,1595,58818,3578768736,3578768740,4
2,1595,58819,3578768736,3578768741,5
2,1595,58820,3578768736,3578768742,6
2,1595,58821,3578768736,3578768743,7
2,1595,58822,3578768736,3578768744,8
2,1595,58823,3578768736,3578768745,9
2,1595,58824,3578768736,3578768747,11
2,1595,58825,3578768736,3578768747,11
2,1595,58826,3578768736,3578768749,13
2,1595,58827,3578768736,3578768749,13
2,1595,58828,3578768736,3578768749,13
2,1595,58829,3578768736,3578768750,14
2,1595,58830,3578768736,3578768751,15
2,1595,58831,3578768736,3578768751,15
2,1595,58832,3578768736,3578768752,16
2,1595,58833,3578768736,3578768752,16
2,1595,58834,3578768736,3578768752,16
2,1595,58835,3578768736,3578768753,17
2,1595,58836,3578768736,3578768753,17
2,1595,58837,3578768736,3578768754,18
2,1595,58838,3578768736,3578768756,20
2,1595,58839,3578768736,3578768757,21
2,1595,58840,3578768736,3578768758,22
2,1595,58841,3578768736,3578768758,22
2,1595,58842,3578768736,3578768761,25
2,1595,58843,3578768736,3578768762,26
2,1595,58844,3578768736,3578768764,28
2,1595,58845,3578768736,3578768764,28
2,1595,58846,3578768736,3578768765,29
2,1595,58847,3578768736,3578768769,33
2,1595,58848,3578768736,3578768769,33
2,1595,58849,3578768736,3578768770,34
2,1595,58850,3578768736,3578768771,35
2,1595,58851,3578768736,3578768771,35
2,1595,58852,3578768736,3578768773,37
2,1595,58853,3578768736,3578768774,38
2,1595,58854,3578768736,3578768775,39
2,1595,58855,3578768736,3578768775,39
2,1595,58856,3578768736,3578768777,41
2,1595,58857,3578768736,3578768777,41
2,1595,58858,3578768736,3578768779,43
2,1595,58859,3578768736,3578768782,46
2,1595,58860,3578768736,3578768783,47
2,1595,58861,3578768736,3578768783,47
2,1595,58862,3578768736,3578768783,47
2,1595,58863,3578768736,3578768785,49
2,1595,58864,3578768736,3578768786,50
2,1596,58865,3578768801,3578768801,0
2,1596,58866,3578768801,3578768801,0
2,1596,58867,3578768801,3578768801,0
2,1596,58868,3578768801,3578768801,0
2,1596,58869,3578768801,3578768801,0
2,1596,58870,3578768801,3578768801,0
2,1596,58871,3578768801,3578768801,0
2,1596,58872,3578768801,3578768801,0
2,1596,58873,3578768801,3578768801,0
2,1596,58874,3578768801,3578768801,0
2,1596,58875,3578768801,3578768801,0
2,1596,58876,3578768801,3578768801,0
2,1596,58877,3578768801,3578768801,0
2,1596,58878,3578768801,3578768801,0
2,1596,58879,3578768801,3578768802,1
2,1596,58880,3578768801,3578768803,2
2,1596,58881,3578768801,3578768803,2
2,1596,58882,3578768801,3578768803,2
2,1596,58883,3578768801,3578768804,3
2,1596,58884,3578768801,3578768805,4
2,1596,58885,3578768801,3578768806,5
2,1596,58886,3578768801,3578768807,6
2,1596,58887,3578768801,3578768807,6
2,1596,58888,3578768801,3578768811,10
2,1596,58889,3578768801,3578768812,11
2,1596,58890,3578768801,3578768812,11
2,1596,58891,3578768801,3578768813,12
2,1596,58892,3578768801,3578768814,13
2,1596,58893,3578768801,3578768815,14
2,1596,58894,3578768801,3578768816,15
2,1596,58895,3578768801,3578768819,18
2,1596,58896,3578768801,3578768822,21
2,1596,58897,3578768801,3578768823,22
2,1596,58898,3578768801,3578768823,22
2,1596,58899,3578768801,3578768824,23
2,1596,58900,3578768801,3578768824,23
2,1596,58901,3578768801,3578768827,26
2,1596,58902,3578768801,3578768827,26
2,1596,58903,3578768801,3578768827,26
2,1596,58904,3578768801,3578768828,27
2,1596,58905,3578768801,3578768829,28
2,1596,58906,3578768801,3578768831,30
2,1596,58907,3578768801,3578768831,30
2,1596,58908,3578768801,3578768831,30
2,1596,58909,3578768801,3578768832,31
2,1596,58910,3578768801,3578768833,32
2,1596,58911,3578768801,3578768834,33
2,1596,58912,3578768801,3578768835,34
2,1596,58913,3578768801,3578768836,35
2,1596,58914,3578768801,3578768836,35
2,1596,58915,3578768801,3578768837,36
2,1596,58916,3578768801,3578768839,38
2,1596,58917,3578768801,3578768839,38
2,1596,58918,3578768801,3578768839,38
2,1596,58919,3578768801,3578768839,38
2,1596,58920,3578768801,3578768841,40
2,1596,58921,3578768801,3578768841,40
2,1596,58922,3578768801,3578768841,40
2,1596,58923,3578768801,3578768841,40
2,1596,58924,3578768801,3578768842,41
2,1596,58925,3578768801,3578768842,41
2,1596,58926,3578768801,3578768842,41
2,1596,58927,3578768801,3578768844,43
2,1596,58928,3578768801,3578768846,45
2,1596,58929,3578768801,3578768846,45
2,1596,58930,3578768801,3578768847,46
2,1596,58931,3578768801,3578768847,46
2,1596,58932,3578768801,3578768849,48
2,1596,58933,3578768801,3578768850,49
2,1596,58934,3578768801,3578768850,49
2,1596,58935,3578768801,3578768850,49
2,1596,58936,3578768801,3578768851,50
2,1597,58937,3578768866,3578768866,0
2,1597,58938,3578768866,3578768866,0
2,1597,58939,3578768866,3578768866,0
2,1597,58940,3578768866,3578768866,0
2,1597,58941,3578768866,3578768866,0
2,1597,58942,3578768866,3578768866,0
2,1597,58943,3578768866,3578768866,0
2,1597,58944,3578768866,3578768866,0
2,1597,58945,3578768866,3578768866,0
2,1597,58946,3578768866,3578768866,0
2,1597,58947,3578768866,3578768866,0
2,1597,58948,3578768866,3578768866,0
2,1597,58949,3578768866,3578768867,1
2,1597,58950,3578768866,3578768867,1
2,1597,58951,3578768866,3578768883,17
2,1597,58952,3578768866,3578768883,17
2,1597,58953,3578768866,3578768886,20
2,1597,58954,3578768866,3578768887,21
2,1597,58955,3578768866,3578768890,24
2,1597,58956,3578768866,3578768890,24
2,1597,58957,3578768866,3578768891,25
2,1597,58958,3578768866,3578768891,25
2,1597,58959,3578768866,3578768891,25
2,1597,58960,3578768866,3578768892,26
2,1597,58961,3578768866,3578768892,26
2,1597,58962,3578768866,3578768893,27
2,1597,58963,3578768866,3578768895,29
2,1597,58964,3578768866,3578768895,29
2,1597,58965,3578768866,3578768895,29
2,1597,58966,3578768866,3578768895,29
2,1597,58967,3578768866,3578768895,29
2,1597,58968,3578768866,3578768896,30
2,1597,58969,3578768866,3578768896,30
2,1597,58970,3578768866,3578768898,32
2,1597,58971,3578768866,3578768899,33
2,1597,58972,3578768866,3578768899,33
2,1597,58973,3578768866,3578768900,34
2,1597,58974,3578768866,3578768900,34
2,1597,58975,3578768866,3578768901,35
2,1597,58976,3578768866,3578768901,35
2,1597,58977,3578768866,3578768902,36
2,1597,58978,3578768866,3578768904,38
2,1597,58979,3578768866,3578768904,38
2,1597,58980,3578768866,3578768905,39
2,1597,58981,3578768866,3578768905,39
2,1597,58982,3578768866,3578768906,40
2,1597,58983,3578768866,3578768908,42
2,1597,58984,3578768866,3578768908,42
2,1597,58985,3578768866,3578768908,42
2,1597,58986,3578768866,3578768909,43
2,1597,58987,3578768866,3578768911,45
2,1597,58988,3578768866,3578768911,45
2,1597,58989,3578768866,3578768912,46
2,1597,58990,3578768866,3578768913,47
2,1597,58991,3578768866,3578768913,47
2,1597,58992,3578768866,3578768913,47
2,1597,58993,3578768866,3578768915,49
2,1597,58994,3578768866,3578768915,49
2,1597,58995,3578768866,3578768916,50
2,1598,58996,3578768932,3578768932,0
2,1598,58997,3578768932,3578768932,0
2,1598,58998,3578768932,3578768932,0
2,1598,58999,3578768932,3578768932,0
2,1598,59000,3578768932,3578768932,0
2,1598,59001,3578768932,3578768932,0
2,1598,59002,3578768932,3578768932,0
2,1598,59003,3578768932,3578768932,0
2,1598,59004,3578768932,3578768932,0
2,1598,59005,3578768932,3578768932,0
2,1598,59006,3578768932,3578768932,0
2,1598,59007,3578768932,3578768932,0
2,1598,59008,3578768932,3578768932,0
2,1598,59009,3578768932,3578768932,0
2,1598,59010,3578768932,3578768932,0
2,1598,59011,3578768932,3578768932,0
2,1598,59012,3578768932,3578768932,0
2,1598,59013,3578768932,3578768932,0
2,1598,59014,3578768932,3578768933,1
2,1598,59015,3578768932,3578768934,2
2,1598,59016,3578768932,3578768935,3
2,1598,59017,3578768932,3578768936,4
2,1598,59018,3578768932,3578768936,4
2,1598,59019,3578768932,3578768937,5
2,1598,59020,3578768932,3578768938,6
2,1598,59021,3578768932,3578768938,6
2,1598,59022,3578768932,3578768938,6
2,1598,59023,3578768932,3578768938,6
2,1598,59024,3578768932,3578768939,7
2,1598,59025,3578768932,3578768939,7
2,1598,59026,3578768932,3578768940,8
2,1598,59027,3578768932,3578768941,9
2,1598,59028,3578768932,3578768941,9
2,1598,59029,3578768932,3578768944,12
2,1598,59030,3578768932,3578768944,12
2,1598,59031,3578768932,3578768946,14
2,1598,59032,3578768932,3578768947,15
2,1598,59033,3578768932,3578768947,15
2,1598,59034,3578768932,3578768950,18
2,1598,59035,3578768932,3578768950,18
2,1598,59036,3578768932,3578768950,18
2,1598,59037,3578768932,3578768951,19
2,1598,59038,3578768932,3578768951,19
2,1598,59039,3578768932,3578768951,19
2,1598,59040,3578768932,3578768952,20
2,1598,59041,3578768932,3578768953,21
2,1598,59042,3578768932,3578768953,21
2,1598,59043,3578768932,3578768953,21
2,1598,59044,3578768932,3578768955,23
2,1598,59045,3578768932,3578768956,24
2,1598,59046,3578768932,3578768958,26
2,1598,59047,3578768932,3578768958,26
2,1598,59048,3578768932,3578768962,30
2,1598,59049,3578768932,3578768963,31
2,1598,59050,3578768932,3578768965,33
2,1598,59051,3578768932,3578768965,33
2,1598,59052,3578768932,3578768966,34
2,1598,59053,3578768932,3578768968,36
2,1598,59054,3578768932,3578768969,37
2,1598,59055,3578768932,3578768969,37
2,1598,59056,3578768932,3578768970,38
2,1598,59057,3578768932,3578768971,39
2,1598,59058,3578768932,3578768974,42
2,1598,59059,3578768932,3578768974,42
2,1598,59060,3578768932,3578768974,42
2,1598,59061,3578768932,3578768976,44
2,1598,59062,3578768932,3578768977,45
2,1598,59063,3578768932,3578768978,46
2,1598,59064,3578768932,3578768979,47
2,1598,59065,3578768932,3578768982,50
2,1599,59066,3578768997,3578768997,0
2,1599,59067,3578768997,3578768997,0
2,1599,59068,3578768997,3578768997,0
2,1599,59069,3578768997,3578768997,0
2,1599,59070,3578768997,3578768997,0
2,1599,59071,3578768997,3578768997,0
2,1599,59072,3578768997,3578768997,0
2,1599,59073,3578768997,3578768997,0
2,1599,59074,3578768997,3578768997,0
2,1599,59075,3578768997,3578768997,0
2,1599,59076,3578768997,3578768997,0
2,1599,59077,3578768997,3578768997,0
2,1599,59078,3578768997,3578768997,0
2,1599,59079,3578768997,3578768997,0
2,1599,59080,3578768997,3578768997,0
2,1599,59081,3578768997,3578768997,0
2,1599,59082,3578768997,3578768997,0
2,1599,59083,3578768997,3578768997,0
2,1599,59084,3578768997,3578768997,0
2,1599,59085,3578768997,3578769000,3
2,1599,59086,3578768997,3578769002,5
2,1599,59087,3578768997,3578769003,6
2,1599,59088,3578768997,3578769003,6
2,1599,59089,3578768997,3578769003,6
2,1599,59090,3578768997,3578769003,6
2,1599,59091,3578768997,3578769004,7
2,1599,59092,3578768997,3578769006,9
2,1599,59093,3578768997,3578769006,9
2,1599,59094,3578768997,3578769007,10
2,1599,59095,3578768997,3578769012,15
2,1599,59096,3578768997,3578769013,16
2,1599,59097,3578768997,3578769014,17
2,1599,59098,3578768997,3578769014,17
2,1599,59099,3578768997,3578769015,18
2,1599,59100,3578768997,3578769017,20
2,1599,59101,3578768997,3578769019,22
2,1599,59102,3578768997,3578769021,24
2,1599,59103,3578768997,3578769022,25
2,1599,59104,3578768997,3578769023,26
2,1599,59105,3578768997,3578769024,27
2,1599,59106,3578768997,3578769025,28
2,1599,59107,3578768997,3578769026,29
2,1599,59108,3578768997,3578769026,29
2,1599,59109,3578768997,3578769027,30
2,1599,59110,3578768997,3578769028,31
2,1599,59111,3578768997,3578769029,32
2,1599,59112,3578768997,3578769031,34
2,1599,59113,3578768997,3578769031,34
2,1599,59114,3578768997,3578769032,35
2,1599,59115,3578768997,3578769032,35
2,1599,59116,3578768997,3578769033,36
2,1599,59117,3578768997,3578769035,38
2,1599,59118,3578768997,3578769035,38
2,1599,59119,3578768997,3578769035,38
2,1599,59120,3578768997,3578769036,39
2,1599,59121,3578768997,3578769037,40
2,1599,59122,3578768997,3578769038,41
2,1599,59123,3578768997,3578769039,42
2,1599,59124,3578768997,3578769039,42
2,1599,59125,3578768997,3578769039,42
2,1599,59126,3578768997,3578769040,43
2,1599,59127,3578768997,3578769040,43
2,1599,59128,3578768997,3578769041,44
2,1599,59129,3578768997,3578769042,45
2,1599,59130,3578768997,3578769042,45
2,1599,59131,3578768997,3578769042,45
2,1599,59132,3578768997,3578769043,46
2,1599,59133,3578768997,3578769044,47
2,1599,59134,3578768997,3578769046,49
2,1599,59135,3578768997,3578769046,49
2,1599,59136,3578768997,3578769047,50
2,1600,59137,3578769062,3578769062,0
2,1600,59138,3578769062,3578769062,0
2,1600,59139,3578769062,3578769062,0
2,1600,59140,3578769062,3578769062,0
2,1600,59141,3578769062,3578769062,0
2,1600,59142,3578769062,3578769062,0
2,1600,59143,3578769062,3578769062,0
2,1600,59144,3578769062,3578769062,0
2,1600,59145,3578769062,3578769062,0
2,1600,59146,3578769062,3578769062,0
2,1600,59147,3578769062,3578769062,0
2,1600,59148,3578769062,3578769062,0
2,1600,59149,3578769062,3578769062,0
2,1600,59150,3578769062,3578769062,0
2,1600,59151,3578769062,3578769062,0
2,1600,59152,3578769062,3578769065,3
2,1600,59153,3578769062,3578769066,4
2,1600,59154,3578769062,3578769066,4
2,1600,59155,3578769062,3578769067,5
2,1600,59156,3578769062,3578769067,5
2,1600,59157,3578769062,3578769082,20
2,1600,59158,3578769062,3578769083,21
2,1600,59159,3578769062,3578769086,24
2,1600,59160,3578769062,3578769087,25
2,1600,59161,3578769062,3578769090,28
2,1600,59162,3578769062,3578769091,29
2,1600,59163,3578769062,3578769091,29
2,1600,59164,3578769062,3578769091,29
2,1600,59165,3578769062,3578769093,31
2,1600,59166,3578769062,3578769094,32
2,1600,59167,3578769062,3578769095,33
2,1600,59168,3578769062,3578769095,33
2,1600,59169,3578769062,3578769095,33
2,1600,59170,3578769062,3578769095,33
2,1600,59171,3578769062,3578769095,33
2,1600,59172,3578769062,3578769096,34
2,1600,59173,3578769062,3578769096,34
2,1600,59174,3578769062,3578769098,36
2,1600,59175,3578769062,3578769099,37
2,1600,59176,3578769062,3578769100,38
2,1600,59177,3578769062,3578769100,38
2,1600,59178,3578769062,3578769100,38
2,1600,59179,3578769062,3578769101,39
2,1600,59180,3578769062,3578769101,39
2,1600,59181,3578769062,3578769104,42
2,1600,59182,3578769062,3578769105,43
2,1600,59183,3578769062,3578769105,43
2,1600,59184,3578769062,3578769106,44
2,1600,59185,3578769062,3578769108,46
2,1600,59186,3578769062,3578769109,47
2,1600,59187,3578769062,3578769109,47
2,1600,59188,3578769062,3578769110,48
2,1600,59189,3578769062,3578769111,49
2,1601,59190,3578769128,3578769128,0
2,1601,59191,3578769128,3578769128,0
2,1601,59192,3578769128,3578769128,0
2,1601,59193,3578769128,3578769128,0
2,1601,59194,3578769128,3578769128,0
2,1601,59195,3578769128,3578769128,0
2,1601,59196,3578769128,3578769128,0
2,1601,59197,3578769128,3578769128,0
2,1601,59198,3578769128,3578769128,0
2,1601,59199,3578769128,3578769128,0
2,1601,59200,3578769128,3578769128,0
2,1601,59201,3578769128,3578769128,0
2,1601,59202,3578769128,3578769128,0
2,1601,59203,3578769128,3578769128,0
2,1601,59204,3578769128,3578769128,0
2,1601,59205,3578769128,3578769128,0
2,1601,59206,3578769128,3578769128,0
2,1601,59207,3578769128,3578769128,0
2,1601,59208,3578769128,3578769128,0
2,1601,59209,3578769128,3578769128,0
2,1601,59210,3578769128,3578769128,0
2,1601,59211,3578769128,3578769128,0
2,1601,59212,3578769128,3578769128,0
2,1601,59213,3578769128,3578769128,0
2,1601,59214,3578769128,3578769128,0
2,1601,59215,3578769128,3578769130,2
2,1601,59216,3578769128,3578769130,2
2,1601,59217,3578769128,3578769133,5
2,1601,59218,3578769128,3578769134,6
2,1601,59219,3578769128,3578769135,7
2,1601,59220,3578769128,3578769136,8
2,1601,59221,3578769128,3578769137,9
2,1601,59222,3578769128,3578769137,9
2,1601,59223,3578769128,3578769138,10
2,1601,59224,3578769128,3578769138,10
2,1601,59225,3578769128,3578769139,11
2,1601,59226,3578769128,3578769139,11
2,1601,59227,3578769128,3578769139,11
2,1601,59228,3578769128,3578769140,12
2,1601,59229,3578769128,3578769140,12
2,1601,59230,3578769128,3578769141,13
2,1601,59231,3578769128,3578769142,14
2,1601,59232,3578769128,3578769144,16
2,1601,59233,3578769128,3578769146,18
2,1601,59234,3578769128,3578769147,19
2,1601,59235,3578769128,3578769147,19
2,1601,59236,3578769128,3578769150,22
2,1601,59237,3578769128,3578769150,22
2,1601,59238,3578769128,3578769150,22
2,1601,59239,3578769128,3578769151,23
2,1601,59240,3578769128,3578769151,23
2,1601,59241,3578769128,3578769152,24
2,1601,59242,3578769128,3578769152,24
2,1601,59243,3578769128,3578769153,25
2,1601,59244,3578769128,3578769153,25
2,1601,59245,3578769128,3578769154,26
2,1601,59246,3578769128,3578769155,27
2,1601,59247,3578769128,3578769156,28
2,1601,59248,3578769128,3578769158,30
2,1601,59249,3578769128,3578769158,30
2,1601,59250,3578769128,3578769162,34
2,1601,59251,3578769128,3578769163,35
2,1601,59252,3578769128,3578769164,36
2,1601,59253,3578769128,3578769165,37
2,1601,59254,3578769128,3578769166,38
2,1601,59255,3578769128,3578769167,39
2,1601,59256,3578769128,3578769169,41
2,1601,59257,3578769128,3578769169,41
2,1601,59258,3578769128,3578769170,42
2,1601,59259,3578769128,3578769170,42
2,1601,59260,3578769128,3578769171,43
2,1601,59261,3578769128,3578769174,46
2,1601,59262,3578769128,3578769174,46
2,1601,59263,3578769128,3578769175,47
2,1601,59264,3578769128,3578769176,48
2,1602,59265,3578769193,3578769193,0
2,1602,59266,3578769193,3578769193,0
2,1602,59267,3578769193,3578769193,0
2,1602,59268,3578769193,3578769193,0
2,1602,59269,3578769193,3578769193,0
2,1602,59270,3578769193,3578769193,0
2,1602,59271,3578769193,3578769193,0
2,1602,59272,3578769193,3578769193,0
2,1602,59273,3578769193,3578769193,0
2,1602,59274,3578769193,3578769193,0
2,1602,59275,3578769193,3578769193,0
2,1602,59276,3578769193,3578769193,0
2,1602,59277,3578769193,3578769193,0
2,1602,59278,3578769193,3578769193,0
2,1602,59279,3578769193,3578769193,0
2,1602,59280,3578769193,3578769193,0
2,1602,59281,3578769193,3578769193,0
2,1602,59282,3578769193,3578769193,0
2,1602,59283,3578769193,3578769193,0
2,1602,59284,3578769193,3578769193,0
2,1602,59285,3578769193,3578769193,0
2,1602,59286,3578769193,3578769195,2
2,1602,59287,3578769193,3578769197,4
2,1602,59288,3578769193,3578769199,6
2,1602,59289,3578769193,3578769201,8
2,1602,59290,3578769193,3578769203,10
2,1602,59291,3578769193,3578769203,10
2,1602,59292,3578769193,3578769203,10
2,1602,59293,3578769193,3578769203,10
2,1602,59294,3578769193,3578769204,11
2,1602,59295,3578769193,3578769205,12
2,1602,59296,3578769193,3578769206,13
2,1602,59297,3578769193,3578769207,14
2,1602,59298,3578769193,3578769207,14
2,1602,59299,3578769193,3578769213,20
2,1602,59300,3578769193,3578769213,20
2,1602,59301,3578769193,3578769214,21
2,1602,59302,3578769193,3578769215,22
2,1602,59303,3578769193,3578769216,23
2,1602,59304,3578769193,3578769221,28
2,1602,59305,3578769193,3578769222,29
2,1602,59306,3578769193,3578769224,31
2,1602,59307,3578769193,3578769225,32
2,1602,59308,3578769193,3578769225,32
2,1602,59309,3578769193,3578769226,33
2,1602,59310,3578769193,3578769226,33
2,1602,59311,3578769193,3578769226,33
2,1602,59312,3578769193,3578769227,34
2,1602,59313,3578769193,3578769227,34
2,1602,59314,3578769193,3578769229,36
2,1602,59315,3578769193,3578769231,38
2,1602,59316,3578769193,3578769231,38
2,1602,59317,3578769193,3578769231,38
2,1602,59318,3578769193,3578769232,39
2,1602,59319,3578769193,3578769233,40
2,1602,59320,3578769193,3578769233,40
2,1602,59321,3578769193,3578769234,41
2,1602,59322,3578769193,3578769235,42
2,1602,59323,3578769193,3578769235,42
2,1602,59324,3578769193,3578769236,43
2,1602,59325,3578769193,3578769236,43
2,1602,59326,3578769193,3578769238,45
2,1602,59327,3578769193,3578769239,46
2,1602,59328,3578769193,3578769239,46
2,1602,59329,3578769193,3578769239,46
2,1602,59330,3578769193,3578769241,48
2,1602,59331,3578769193,3578769241,48
2,1602,59332,3578769193,3578769241,48
2,1602,59333,3578769193,3578769242,49
2,1602,59334,3578769193,3578769242,49
2,1602,59335,3578769193,3578769242,49
2,1603,59336,3578769257,3578769257,0
2,1603,59337,3578769257,3578769257,0
2,1603,59338,3578769257,3578769257,0
2,1603,59339,3578769257,3578769257,0
2,1603,59340,3578769257,3578769257,0
2,1603,59341,3578769257,3578769258,1
2,1603,59342,3578769257,3578769258,1
2,1603,59343,3578769257,3578769258,1
2,1603,59344,3578769257,3578769258,1
2,1603,59345,3578769257,3578769258,1
2,1603,59346,3578769257,3578769258,1
2,1603,59347,3578769257,3578769258,1
2,1603,59348,3578769257,3578769258,1
2,1603,59349,3578769257,3578769258,1
2,1603,59350,3578769257,3578769258,1
2,1603,59351,3578769257,3578769258,1
2,1603,59352,3578769257,3578769258,1
2,1603,59353,3578769257,3578769261,4
2,1603,59354,3578769257,3578769261,4
2,1603,59355,3578769257,3578769262,5
2,1603,59356,3578769257,3578769264,7
2,1603,59357,3578769257,3578769266,9
2,1603,59358,3578769257,3578769267,10
2,1603,59359,3578769257,3578769268,11
2,1603,59360,3578769257,3578769283,26
2,1603,59361,3578769257,3578769283,26
2,1603,59362,3578769257,3578769286,29
2,1603,59363,3578769257,3578769288,31
2,1603,59364,3578769257,3578769289,32
2,1603,59365,3578769257,3578769290,33
2,1603,59366,3578769257,3578769291,34
2,1603,59367,3578769257,3578769291,34
2,1603,59368,3578769257,3578769292,35
2,1603,59369,3578769257,3578769292,35
2,1603,59370,3578769257,3578769293,36
2,1603,59371,3578769257,3578769293,36
2,1603,59372,3578769257,3578769295,38
2,1603,59373,3578769257,3578769295,38
2,1603,59374,3578769257,3578769296,39
2,1603,59375,3578769257,3578769296,39
2,1603,59376,3578769257,3578769296,39
2,1603,59377,3578769257,3578769296,39
2,1603,59378,3578769257,3578769296,39
2,1603,59379,3578769257,3578769299,42
2,1603,59380,3578769257,3578769300,43
2,1603,59381,3578769257,3578769300,43
2,1603,59382,3578769257,3578769300,43
2,1603,59383,3578769257,3578769301,44
2,1603,59384,3578769257,3578769302,45
2,1603,59385,3578769257,3578769304,47
2,1603,59386,3578769257,3578769304,47
2,1603,59387,3578769257,3578769305,48
2,1603,59388,3578769257,3578769305,48
2,1603,59389,3578769257,3578769306,49
2,1604,59390,3578769322,3578769322,0
2,1604,59391,3578769322,3578769322,0
2,1604,59392,3578769322,3578769322,0
2,1604,59393,3578769322,3578769322,0
2,1604,59394,3578769322,3578769322,0
2,1604,59395,3578769322,3578769322,0
2,1604,59396,3578769322,3578769322,0
2,1604,59397,3578769322,3578769322,0
2,1604,59398,3578769322,3578769322,0
2,1604,59399,3578769322,3578769322,0
2,1604,59400,3578769322,3578769322,0
2,1604,59401,3578769322,3578769322,0
2,1604,59402,3578769322,3578769322,0
2,1604,59403,3578769322,3578769322,0
2,1604,59404,3578769322,3578769322,0
2,1604,59405,3578769322,3578769322,0
2,1604,59406,3578769322,3578769322,0
2,1604,59407,3578769322,3578769322,0
2,1604,59408,3578769322,3578769322,0
2,1604,59409,3578769322,3578769322,0
2,1604,59410,3578769322,3578769322,0
2,1604,59411,3578769322,3578769323,1
2,1604,59412,3578769322,3578769323,1
2,1604,59413,3578769322,3578769324,2
2,1604,59414,3578769322,3578769326,4
2,1604,59415,3578769322,3578769326,4
2,1604,59416,3578769322,3578769327,5
2,1604,59417,3578769322,3578769327,5
2,1604,59418,3578769322,3578769328,6
2,1604,59419,3578769322,3578769328,6
2,1604,59420,3578769322,3578769328,6
2,1604,59421,3578769322,3578769329,7
2,1604,59422,3578769322,3578769331,9
2,1604,59423,3578769322,3578769335,13
2,1604,59424,3578769322,3578769335,13
2,1604,59425,3578769322,3578769335,13
2,1604,59426,3578769322,3578769336,14
2,1604,59427,3578769322,3578769336,14
2,1604,59428,3578769322,3578769338,16
2,1604,59429,3578769322,3578769338,16
2,1604,59430,3578769322,3578769338,16
2,1604,59431,3578769322,3578769339,17
2,1604,59432,3578769322,3578769339,17
2,1604,59433,3578769322,3578769339,17
2,1604,59434,3578769322,3578769341,19
2,1604,59435,3578769322,3578769341,19
2,1604,59436,3578769322,3578769341,19
2,1604,59437,3578769322,3578769342,20
2,1604,59438,3578769322,3578769343,21
2,1604,59439,3578769322,3578769344,22
2,1604,59440,3578769322,3578769346,24
2,1604,59441,3578769322,3578769346,24
2,1604,59442,3578769322,3578769347,25
2,1604,59443,3578769322,3578769350,28
2,1604,59444,3578769322,3578769350,28
2,1604,59445,3578769322,3578769350,28
2,1604,59446,3578769322,3578769351,29
2,1604,59447,3578769322,3578769352,30
2,1604,59448,3578769322,3578769352,30
2,1604,59449,3578769322,3578769352,30
2,1604,59450,3578769322,3578769352,30
2,1604,59451,3578769322,3578769354,32
2,1604,59452,3578769322,3578769354,32
2,1604,59453,3578769322,3578769354,32
2,1604,59454,3578769322,3578769357,35
2,1604,59455,3578769322,3578769358,36
2,1604,59456,3578769322,3578769358,36
2,1604,59457,3578769322,3578769359,37
2,1604,59458,3578769322,3578769362,40
2,1604,59459,3578769322,3578769363,41
2,1604,59460,3578769322,3578769366,44
2,1604,59461,3578769322,3578769366,44
2,1604,59462,3578769322,3578769366,44
2,1604,59463,3578769322,3578769367,45
2,1604,59464,3578769322,3578769368,46
2,1604,59465,3578769322,3578769370,48
2,1604,59466,3578769322,3578769370,48
2,1604,59467,3578769322,3578769370,48
2,1604,59468,3578769322,3578769371,49
2,1605,59469,3578769388,3578769388,0
2,1605,59470,3578769388,3578769388,0
2,1605,59471,3578769388,3578769388,0
2,1605,59472,3578769388,3578769388,0
2,1605,59473,3578769388,3578769388,0
2,1605,59474,3578769388,3578769388,0
2,1605,59475,3578769388,3578769388,0
2,1605,59476,3578769388,3578769388,0
2,1605,59477,3578769388,3578769388,0
2,1605,59478,3578769388,3578769388,0
2,1605,59479,3578769388,3578769388,0
2,1605,59480,3578769388,3578769388,0
2,1605,59481,3578769388,3578769388,0
2,1605,59482,3578769388,3578769388,0
2,1605,59483,3578769388,3578769388,0
2,1605,59484,3578769388,3578769388,0
2,1605,59485,3578769388,3578769388,0
2,1605,59486,3578769388,3578769388,0
2,1605,59487,3578769388,3578769388,0
2,1605,59488,3578769388,3578769389,1
2,1605,59489,3578769388,3578769391,3
2,1605,59490,3578769388,3578769391,3
2,1605,59491,3578769388,3578769391,3
2,1605,59492,3578769388,3578769391,3
2,1605,59493,3578769388,3578769396,8
2,1605,59494,3578769388,3578769397,9
2,1605,59495,3578769388,3578769399,11
2,1605,59496,3578769388,3578769402,14
2,1605,59497,3578769388,3578769404,16
2,1605,59498,3578769388,3578769404,16
2,1605,59499,3578769388,3578769405,17
2,1605,59500,3578769388,3578769405,17
2,1605,59501,3578769388,3578769405,17
2,1605,59502,3578769388,3578769406,18
2,1605,59503,3578769388,3578769407,19
2,1605,59504,3578769388,3578769408,20
2,1605,59505,3578769388,3578769413,25
2,1605,59506,3578769388,3578769414,26
2,1605,59507,3578769388,3578769415,27
2,1605,59508,3578769388,3578769417,29
2,1605,59509,3578769388,3578769418,30
2,1605,59510,3578769388,3578769420,32
2,1605,59511,3578769388,3578769422,34
2,1605,59512,3578769388,3578769423,35
2,1605,59513,3578769388,3578769424,36
2,1605,59514,3578769388,3578769424,36
2,1605,59515,3578769388,3578769426,38
2,1605,59516,3578769388,3578769426,38
2,1605,59517,3578769388,3578769426,38
2,1605,59518,3578769388,3578769426,38
2,1605,59519,3578769388,3578769427,39
2,1605,59520,3578769388,3578769428,40
2,1605,59521,3578769388,3578769429,41
2,1605,59522,3578769388,3578769431,43
2,1605,59523,3578769388,3578769431,43
2,1605,59524,3578769388,3578769432,44
2,1605,59525,3578769388,3578769432,44
2,1605,59526,3578769388,3578769433,45
2,1605,59527,3578769388,3578769435,47
2,1605,59528,3578769388,3578769435,47
2,1605,59529,3578769388,3578769435,47
2,1605,59530,3578769388,3578769435,47
2,1605,59531,3578769388,3578769436,48
2,1605,59532,3578769388,3578769436,48
2,1606,59533,3578769453,3578769453,0
2,1606,59534,3578769453,3578769453,0
2,1606,59535,3578769453,3578769453,0
2,1606,59536,3578769453,3578769453,0
2,1606,59537,3578769453,3578769453,0
2,1606,59538,3578769453,3578769453,0
2,1606,59539,3578769453,3578769453,0
2,1606,59540,3578769453,3578769453,0
2,1606,59541,3578769453,3578769453,0
2,1606,59542,3578769453,3578769453,0
2,1606,59543,3578769453,3578769453,0
2,1606,59544,3578769453,3578769453,0
2,1606,59545,3578769453,3578769453,0
2,1606,59546,3578769453,3578769453,0
2,1606,59547,3578769453,3578769453,0
2,1606,59548,3578769453,3578769453,0
2,1606,59549,3578769453,3578769453,0
2,1606,59550,3578769453,3578769453,0
2,1606,59551,3578769453,3578769453,0
2,1606,59552,3578769453,3578769453,0
2,1606,59553,3578769453,3578769453,0
2,1606,59554,3578769453,3578769454,1
2,1606,59555,3578769453,3578769454,1
2,1606,59556,3578769453,3578769454,1
2,1606,59557,3578769453,3578769455,2
2,1606,59558,3578769453,3578769455,2
2,1606,59559,3578769453,3578769460,7
2,1606,59560,3578769453,3578769462,9
2,1606,59561,3578769453,3578769462,9
2,1606,59562,3578769453,3578769464,11
2,1606,59563,3578769453,3578769465,12
2,1606,59564,3578769453,3578769466,13
2,1606,59565,3578769453,3578769467,14
2,1606,59566,3578769453,3578769468,15
2,1606,59567,3578769453,3578769483,30
2,1606,59568,3578769453,3578769483,30
2,1606,59569,3578769453,3578769485,32
2,1606,59570,3578769453,3578769487,34
2,1606,59571,3578769453,3578769490,37
2,1606,59572,3578769453,3578769490,37
2,1606,59573,3578769453,3578769491,38
2,1606,59574,3578769453,3578769492,39
2,1606,59575,3578769453,3578769492,39
2,1606,59576,3578769453,3578769492,39
2,1606,59577,3578769453,3578769492,39
2,1606,59578,3578769453,3578769494,41
2,1606,59579,3578769453,3578769495,42
2,1606,59580,3578769453,3578769495,42
2,1606,59581,3578769453,3578769495,42
2,1606,59582,3578769453,3578769496,43
2,1606,59583,3578769453,3578769497,44
2,1606,59584,3578769453,3578769499,46
2,1606,59585,3578769453,3578769499,46
2,1606,59586,3578769453,3578769500,47
2,1606,59587,3578769453,3578769501,48
2,1606,59588,3578769453,3578769501,48
2,1606,59589,3578769453,3578769502,49
2,1607,59590,3578769520,3578769520,0
2,1607,59591,3578769520,3578769520,0
2,1607,59592,3578769520,3578769520,0
2,1607,59593,3578769520,3578769520,0
2,1607,59594,3578769520,3578769520,0
2,1607,59595,3578769520,3578769520,0
2,1607,59596,3578769520,3578769520,0
2,1607,59597,3578769520,3578769520,0
2,1607,59598,3578769520,3578769520,0
2,1607,59599,3578769520,3578769520,0
2,1607,59600,3578769520,3578769520,0
2,1607,59601,3578769520,3578769520,0
2,1607,59602,3578769520,3578769520,0
2,1607,59603,3578769520,3578769521,1
2,1607,59604,3578769520,3578769521,1
2,1607,59605,3578769520,3578769521,1
2,1607,59606,3578769520,3578769521,1
2,1607,59607,3578769520,3578769521,1
2,1607,59608,3578769520,3578769521,1
2,1607,59609,3578769520,3578769521,1
2,1607,59610,3578769520,3578769521,1
2,1607,59611,3578769520,3578769521,1
2,1607,59612,3578769520,3578769521,1
2,1607,59613,3578769520,3578769521,1
2,1607,59614,3578769520,3578769522,2
2,1607,59615,3578769520,3578769522,2
2,1607,59616,3578769520,3578769523,3
2,1607,59617,3578769520,3578769523,3
2,1607,59618,3578769520,3578769524,4
2,1607,59619,3578769520,3578769525,5
2,1607,59620,3578769520,3578769526,6
2,1607,59621,3578769520,3578769526,6
2,1607,59622,3578769520,3578769527,7
2,1607,59623,3578769520,3578769527,7
2,1607,59624,3578769520,3578769529,9
2,1607,59625,3578769520,3578769529,9
2,1607,59626,3578769520,3578769530,10
2,1607,59627,3578769520,3578769532,12
2,1607,59628,3578769520,3578769534,14
2,1607,59629,3578769520,3578769534,14
2,1607,59630,3578769520,3578769535,15
2,1607,59631,3578769520,3578769535,15
2,1607,59632,3578769520,3578769537,17
2,1607,59633,3578769520,3578769537,17
2,1607,59634,3578769520,3578769537,17
2,1607,59635,3578769520,3578769538,18
2,1607,59636,3578769520,3578769538,18
2,1607,59637,3578769520,3578769538,18
2,1607,59638,3578769520,3578769538,18
2,1607,59639,3578769520,3578769538,18
2,1607,59640,3578769520,3578769540,20
2,1607,59641,3578769520,3578769540,20
2,1607,59642,3578769520,3578769540,20
2,1607,59643,3578769520,3578769542,22
2,1607,59644,3578769520,3578769543,23
2,1607,59645,3578769520,3578769544,24
2,1607,59646,3578769520,3578769545,25
2,1607,59647,3578769520,3578769546,26
2,1607,59648,3578769520,3578769549,29
2,1607,59649,3578769520,3578769549,29
2,1607,59650,3578769520,3578769550,30
2,1607,59651,3578769520,3578769551,31
2,1607,59652,3578769520,3578769551,31
2,1607,59653,3578769520,3578769551,31
2,1607,59654,3578769520,3578769553,33
2,1607,59655,3578769520,3578769553,33
2,1607,59656,3578769520,3578769553,33
2,1607,59657,3578769520,3578769557,37
2,1607,59658,3578769520,3578769558,38
2,1607,59659,3578769520,3578769558,38
2,1607,59660,3578769520,3578769562,42
2,1607,59661,3578769520,3578769563,43
2,1607,59662,3578769520,3578769564,44
2,1607,59663,3578769520,3578769565,45
2,1607,59664,3578769520,3578769565,45
2,1607,59665,3578769520,3578769565,45
2,1607,59666,3578769520,3578769569,49
2,1607,59667,3578769520,3578769570,50
2,1608,59668,3578769586,3578769586,0
2,1608,59669,3578769586,3578769586,0
2,1608,59670,3578769586,3578769586,0
2,1608,59671,3578769586,3578769586,0
2,1608,59672,3578769586,3578769586,0
2,1608,59673,3578769586,3578769586,0
2,1608,59674,3578769586,3578769586,0
2,1608,59675,3578769586,3578769586,0
2,1608,59676,3578769586,3578769586,0
2,1608,59677,3578769586,3578769586,0
2,1608,59678,3578769586,3578769586,0
2,1608,59679,3578769586,3578769586,0
2,1608,59680,3578769586,3578769586,0
2,1608,59681,3578769586,3578769586,0
2,1608,59682,3578769586,3578769586,0
2,1608,59683,3578769586,3578769586,0
2,1608,59684,3578769586,3578769586,0
2,1608,59685,3578769586,3578769586,0
2,1608,59686,3578769586,3578769586,0
2,1608,59687,3578769586,3578769587,1
2,1608,59688,3578769586,3578769587,1
2,1608,59689,3578769586,3578769587,1
2,1608,59690,3578769586,3578769587,1
2,1608,59691,3578769586,3578769588,2
2,1608,59692,3578769586,3578769588,2
2,1608,59693,3578769586,3578769588,2
2,1608,59694,3578769586,3578769590,4
2,1608,59695,3578769586,3578769590,4
2,1608,59696,3578769586,3578769590,4
2,1608,59697,3578769586,3578769595,9
2,1608,59698,3578769586,3578769596,10
2,1608,59699,3578769586,3578769598,12
2,1608,59700,3578769586,3578769600,14
2,1608,59701,3578769586,3578769601,15
2,1608,59702,3578769586,3578769602,16
2,1608,59703,3578769586,3578769603,17
2,1608,59704,3578769586,3578769604,18
2,1608,59705,3578769586,3578769604,18
2,1608,59706,3578769586,3578769606,20
2,1608,59707,3578769586,3578769606,20
2,1608,59708,3578769586,3578769608,22
2,1608,59709,3578769586,3578769610,24
2,1608,59710,3578769586,3578769612,26
2,1608,59711,3578769586,3578769613,27
2,1608,59712,3578769586,3578769615,29
2,1608,59713,3578769586,3578769616,30
2,1608,59714,3578769586,3578769617,31
2,1608,59715,3578769586,3578769618,32
2,1608,59716,3578769586,3578769621,35
2,1608,59717,3578769586,3578769622,36
2,1608,59718,3578769586,3578769622,36
2,1608,59719,3578769586,3578769623,37
2,1608,59720,3578769586,3578769623,37
2,1608,59721,3578769586,3578769624,38
2,1608,59722,3578769586,3578769625,39
2,1608,59723,3578769586,3578769625,39
2,1608,59724,3578769586,3578769626,40
2,1608,59725,3578769586,3578769627,41
2,1608,59726,3578769586,3578769628,42
2,1608,59727,3578769586,3578769628,42
2,1608,59728,3578769586,3578769631,45
2,1608,59729,3578769586,3578769631,45
2,1608,59730,3578769586,3578769631,45
2,1608,59731,3578769586,3578769632,46
2,1608,59732,3578769586,3578769634,48
2,1608,59733,3578769586,3578769634,48
2,1608,59734,3578769586,3578769634,48
2,1608,59735,3578769586,3578769635,49
2,1608,59736,3578769586,3578769635,49
2,1608,59737,3578769586,3578769636,50
2,1609,59738,3578769650,3578769650,0
2,1609,59739,3578769650,3578769650,0
2,1609,59740,3578769650,3578769650,0
2,1609,59741,3578769650,3578769650,0
2,1609,59742,3578769650,3578769650,0
2,1609,59743,3578769650,3578769650,0
2,1609,59744,3578769650,3578769650,0
2,1609,59745,3578769650,3578769650,0
2,1609,59746,3578769650,3578769650,0
2,1609,59747,3578769650,3578769650,0
2,1609,59748,3578769650,3578769650,0
2,1609,59749,3578769650,3578769650,0
2,1609,59750,3578769650,3578769650,0
2,1609,59751,3578769650,3578769650,0
2,1609,59752,3578769650,3578769650,0
2,1609,59753,3578769650,3578769650,0
2,1609,59754,3578769650,3578769650,0
2,1609,59755,3578769650,3578769650,0
2,1609,59756,3578769650,3578769650,0
2,1609,59757,3578769650,3578769651,1
2,1609,59758,3578769650,3578769651,1
2,1609,59759,3578769650,3578769651,1
2,1609,59760,3578769650,3578769653,3
2,1609,59761,3578769650,3578769653,3
2,1609,59762,3578769650,3578769653,3
2,1609,59763,3578769650,3578769654,4
2,1609,59764,3578769650,3578769655,5
2,1609,59765,3578769650,3578769658,8
2,1609,59766,3578769650,3578769659,9
2,1609,59767,3578769650,3578769661,11
2,1609,59768,3578769650,3578769662,12
2,1609,59769,3578769650,3578769662,12
2,1609,59770,3578769650,3578769664,14
2,1609,59771,3578769650,3578769665,15
2,1609,59772,3578769650,3578769667,17
2,1609,59773,3578769650,3578769667,17
2,1609,59774,3578769650,3578769682,32
2,1609,59775,3578769650,3578769683,33
2,1609,59776,3578769650,3578769686,36
2,1609,59777,3578769650,3578769687,37
2,1609,59778,3578769650,3578769690,40
2,1609,59779,3578769650,3578769690,40
2,1609,59780,3578769650,3578769691,41
2,1609,59781,3578769650,3578769692,42
2,1609,59782,3578769650,3578769692,42
2,1609,59783,3578769650,3578769692,42
2,1609,59784,3578769650,3578769692,42
2,1609,59785,3578769650,3578769693,43
2,1609,59786,3578769650,3578769694,44
2,1609,59787,3578769650,3578769695,45
2,1609,59788,3578769650,3578769695,45
2,1609,59789,3578769650,3578769696,46
2,1609,59790,3578769650,3578769696,46
2,1609,59791,3578769650,3578769697,47
2,1609,59792,3578769650,3578769700,50
2,1610,59793,3578769716,3578769716,0
2,1610,59794,3578769716,3578769716,0
2,1610,59795,3578769716,3578769716,0
2,1610,59796,3578769716,3578769716,0
2,1610,59797,3578769716,3578769716,0
2,1610,59798,3578769716,3578769716,0
2,1610,59799,3578769716,3578769716,0
2,1610,59800,3578769716,3578769716,0
2,1610,59801,3578769716,3578769716,0
2,1610,59802,3578769716,3578769716,0
2,1610,59803,3578769716,3578769716,0
2,1610,59804,3578769716,3578769716,0
2,1610,59805,3578769716,3578769716,0
2,1610,59806,3578769716,3578769716,0
2,1610,59807,3578769716,3578769716,0
2,1610,59808,3578769716,3578769716,0
2,1610,59809,3578769716,3578769716,0
2,1610,59810,3578769716,3578769716,0
2,1610,59811,3578769716,3578769716,0
2,1610,59812,3578769716,3578769716,0
2,1610,59813,3578769716,3578769716,0
2,1610,59814,3578769716,3578769716,0
2,1610,59815,3578769716,3578769716,0
2,1610,59816,3578769716,3578769716,0
2,1610,59817,3578769716,3578769716,0
2,1610,59818,3578769716,3578769717,1
2,1610,59819,3578769716,3578769718,2
2,1610,59820,3578769716,3578769719,3
2,1610,59821,3578769716,3578769721,5
2,1610,59822,3578769716,3578769721,5
2,1610,59823,3578769716,3578769721,5
2,1610,59824,3578769716,3578769723,7
2,1610,59825,3578769716,3578769723,7
2,1610,59826,3578769716,3578769724,8
2,1610,59827,3578769716,3578769725,9
2,1610,59828,3578769716,3578769725,9
2,1610,59829,3578769716,3578769727,11
2,1610,59830,3578769716,3578769729,13
2,1610,59831,3578769716,3578769729,13
2,1610,59832,3578769716,3578769730,14
2,1610,59833,3578769716,3578769733,17
2,1610,59834,3578769716,3578769735,19
2,1610,59835,3578769716,3578769735,19
2,1610,59836,3578769716,3578769735,19
2,1610,59837,3578769716,3578769736,20
2,1610,59838,3578769716,3578769737,21
2,1610,59839,3578769716,3578769737,21
2,1610,59840,3578769716,3578769737,21
2,1610,59841,3578769716,3578769738,22
2,1610,59842,3578769716,3578769738,22
2,1610,59843,3578769716,3578769738,22
2,1610,59844,3578769716,3578769738,22
2,1610,59845,3578769716,3578769739,23
2,1610,59846,3578769716,3578769739,23
2,1610,59847,3578769716,3578769740,24
2,1610,59848,3578769716,3578769740,24
2,1610,59849,3578769716,3578769742,26
2,1610,59850,3578769716,3578769743,27
2,1610,59851,3578769716,3578769744,28
2,1610,59852,3578769716,3578769746,30
2,1610,59853,3578769716,3578769746,30
2,1610,59854,3578769716,3578769748,32
2,1610,59855,3578769716,3578769749,33
2,1610,59856,3578769716,3578769750,34
2,1610,59857,3578769716,3578769751,35
2,1610,59858,3578769716,3578769752,36
2,1610,59859,3578769716,3578769753,37
2,1610,59860,3578769716,3578769753,37
2,1610,59861,3578769716,3578769754,38
2,1610,59862,3578769716,3578769757,41
2,1610,59863,3578769716,3578769758,42
2,1610,59864,3578769716,3578769758,42
2,1610,59865,3578769716,3578769762,46
2,1610,59866,3578769716,3578769763,47
2,1610,59867,3578769716,3578769764,48
2,1610,59868,3578769716,3578769765,49
2,1610,59869,3578769716,3578769765,49
2,1610,59870,3578769716,3578769765,49
2,1611,59871,3578769781,3578769781,0
2,1611,59872,3578769781,3578769781,0
2,1611,59873,3578769781,3578769781,0
2,1611,59874,3578769781,3578769781,0
2,1611,59875,3578769781,3578769781,0
2,1611,59876,3578769781,3578769781,0
2,1611,59877,3578769781,3578769781,0
2,1611,59878,3578769781,3578769781,0
2,1611,59879,3578769781,3578769781,0
2,1611,59880,3578769781,3578769781,0
2,1611,59881,3578769781,3578769781,0
2,1611,59882,3578769781,3578769781,0
2,1611,59883,3578769781,3578769781,0
2,1611,59884,3578769781,3578769782,1
2,1611,59885,3578769781,3578769783,2
2,1611,59886,3578769781,3578769783,2
2,1611,59887,3578769781,3578769784,3
2,1611,59888,3578769781,3578769784,3
2,1611,59889,3578769781,3578769785,4
2,1611,59890,3578769781,3578769785,4
2,1611,59891,3578769781,3578769786,5
2,1611,59892,3578769781,3578769787,6
2,1611,59893,3578769781,3578769787,6
2,1611,59894,3578769781,3578769787,6
2,1611,59895,3578769781,3578769788,7
2,1611,59896,3578769781,3578769788,7
2,1611,59897,3578769781,3578769789,8
2,1611,59898,3578769781,3578769790,9
2,1611,59899,3578769781,3578769790,9
2,1611,59900,3578769781,3578769790,9
2,1611,59901,3578769781,3578769793,12
2,1611,59902,3578769781,3578769797,16
2,1611,59903,3578769781,3578769798,17
2,1611,59904,3578769781,3578769800,19
2,1611,59905,3578769781,3578769801,20
2,1611,59906,3578769781,3578769803,22
2,1611,59907,3578769781,3578769803,22
2,1611,59908,3578769781,3578769804,23
2,1611,59909,3578769781,3578769806,25
2,1611,59910,3578769781,3578769807,26
2,1611,59911,3578769781,3578769807,26
2,1611,59912,3578769781,3578769808,27
2,1611,59913,3578769781,3578769812,31
2,1611,59914,3578769781,3578769813,32
2,1611,59915,3578769781,3578769813,32
2,1611,59916,3578769781,3578769815,34
2,1611,59917,3578769781,3578769816,35
2,1611,59918,3578769781,3578769817,36
2,1611,59919,3578769781,3578769819,38
2,1611,59920,3578769781,3578769822,41
2,1611,59921,3578769781,3578769822,41
2,1611,59922,3578769781,3578769823,42
2,1611,59923,3578769781,3578769823,42
2,1611,59924,3578769781,3578769824,43
2,1611,59925,3578769781,3578769824,43
2,1611,59926,3578769781,3578769826,45
2,1611,59927,3578769781,3578769826,45
2,1611,59928,3578769781,3578769826,45
2,1611,59929,3578769781,3578769827,46
2,1611,59930,3578769781,3578769828,47
2,1611,59931,3578769781,3578769829,48
2,1612,59932,3578769847,3578769847,0
2,1612,59933,3578769847,3578769847,0
2,1612,59934,3578769847,3578769848,1
2,1612,59935,3578769847,3578769848,1
2,1612,59936,3578769847,3578769848,1
2,1612,59937,3578769847,3578769848,1
2,1612,59938,3578769847,3578769848,1
2,1612,59939,3578769847,3578769848,1
2,1612,59940,3578769847,3578769848,1
2,1612,59941,3578769847,3578769848,1
2,1612,59942,3578769847,3578769848,1
2,1612,59943,3578769847,3578769848,1
2,1612,59944,3578769847,3578769848,1
2,1612,59945,3578769847,3578769848,1
2,1612,59946,3578769847,3578769848,1
2,1612,59947,3578769847,3578769848,1
2,1612,59948,3578769847,3578769848,1
2,1612,59949,3578769847,3578769848,1
2,1612,59950,3578769847,3578769848,1
2,1612,59951,3578769847,3578769848,1
2,1612,59952,3578769847,3578769848,1
2,1612,59953,3578769847,3578769848,1
2,1612,59954,3578769847,3578769848,1
2,1612,59955,3578769847,3578769848,1
2,1612,59956,3578769847,3578769849,2
2,1612,59957,3578769847,3578769850,3
2,1612,59958,3578769847,3578769850,3
2,1612,59959,3578769847,3578769850,3
2,1612,59960,3578769847,3578769851,4
2,1612,59961,3578769847,3578769851,4
2,1612,59962,3578769847,3578769853,6
2,1612,59963,3578769847,3578769854,7
2,1612,59964,3578769847,3578769854,7
2,1612,59965,3578769847,3578769854,7
2,1612,59966,3578769847,3578769855,8
2,1612,59967,3578769847,3578769858,11
2,1612,59968,3578769847,3578769859,12
2,1612,59969,3578769847,3578769862,15
2,1612,59970,3578769847,3578769862,15
2,1612,59971,3578769847,3578769863,16
2,1612,59972,3578769847,3578769863,16
2,1612,59973,3578769847,3578769866,19
2,1612,59974,3578769847,3578769866,19
2,1612,59975,3578769847,3578769867,20
2,1612,59976,3578769847,3578769882,35
2,1612,59977,3578769847,3578769884,37
2,1612,59978,3578769847,3578769886,39
2,1612,59979,3578769847,3578769888,41
2,1612,59980,3578769847,3578769890,43
2,1612,59981,3578769847,3578769891,44
2,1612,59982,3578769847,3578769892,45
2,1612,59983,3578769847,3578769892,45
2,1612,59984,3578769847,3578769893,46
2,1612,59985,3578769847,3578769893,46
2,1612,59986,3578769847,3578769894,47
2,1612,59987,3578769847,3578769895,48
2,1612,59988,3578769847,3578769895,48
2,1612,59989,3578769847,3578769895,48
2,1612,59990,3578769847,3578769896,49
2,1612,59991,3578769847,3578769896,49
2,1612,59992,3578769847,3578769897,50
2,1613,59993,3578769913,3578769913,0
2,1613,59994,3578769913,3578769913,0
2,1613,59995,3578769913,3578769913,0
2,1613,59996,3578769913,3578769913,0
2,1613,59997,3578769913,3578769913,0
2,1613,59998,3578769913,3578769913,0
2,1613,59999,3578769913,3578769913,0
2,1613,60000,3578769913,3578769913,0
2,1613,60001,3578769913,3578769913,0
2,1613,60002,3578769913,3578769913,0
2,1613,60003,3578769913,3578769913,0
2,1613,60004,3578769913,3578769913,0
2,1613,60005,3578769913,3578769913,0
2,1613,60006,3578769913,3578769913,0
2,1613,60007,3578769913,3578769913,0
2,1613,60008,3578769913,3578769913,0
2,1613,60009,3578769913,3578769913,0
2,1613,60010,3578769913,3578769913,0
2,1613,60011,3578769913,3578769913,0
2,1613,60012,3578769913,3578769913,0
2,1613,60013,3578769913,3578769913,0
2,1613,60014,3578769913,3578769913,0
2,1613,60015,3578769913,3578769914,1
2,1613,60016,3578769913,3578769914,1
2,1613,60017,3578769913,3578769915,2
2,1613,60018,3578769913,3578769916,3
2,1613,60019,3578769913,3578769917,4
2,1613,60020,3578769913,3578769918,5
2,1613,60021,3578769913,3578769919,6
2,1613,60022,3578769913,3578769919,6
2,1613,60023,3578769913,3578769920,7
2,1613,60024,3578769913,3578769921,8
2,1613,60025,3578769913,3578769922,9
2,1613,60026,3578769913,3578769923,10
2,1613,60027,3578769913,3578769923,10
2,1613,60028,3578769913,3578769924,11
2,1613,60029,3578769913,3578769925,12
2,1613,60030,3578769913,3578769926,13
2,1613,60031,3578769913,3578769927,14
2,1613,60032,3578769913,3578769928,15
2,1613,60033,3578769913,3578769929,16
2,1613,60034,3578769913,3578769931,18
2,1613,60035,3578769913,3578769933,20
2,1613,60036,3578769913,3578769935,22
2,1613,60037,3578769913,3578769935,22
2,1613,60038,3578769913,3578769935,22
2,1613,60039,3578769913,3578769936,23
2,1613,60040,3578769913,3578769937,24
2,1613,60041,3578769913,3578769937,24
2,1613,60042,3578769913,3578769937,24
2,1613,60043,3578769913,3578769937,24
2,1613,60044,3578769913,3578769938,25
2,1613,60045,3578769913,3578769938,25
2,1613,60046,3578769913,3578769939,26
2,1613,60047,3578769913,3578769939,26
2,1613,60048,3578769913,3578769940,27
2,1613,60049,3578769913,3578769941,28
2,1613,60050,3578769913,3578769942,29
2,1613,60051,3578769913,3578769943,30
2,1613,60052,3578769913,3578769944,31
2,1613,60053,3578769913,3578769946,33
2,1613,60054,3578769913,3578769947,34
2,1613,60055,3578769913,3578769948,35
2,1613,60056,3578769913,3578769949,36
2,1613,60057,3578769913,3578769950,37
2,1613,60058,3578769913,3578769950,37
2,1613,60059,3578769913,3578769951,38
2,1613,60060,3578769913,3578769951,38
2,1613,60061,3578769913,3578769952,39
2,1613,60062,3578769913,3578769953,40
2,1613,60063,3578769913,3578769954,41
2,1613,60064,3578769913,3578769957,44
2,1613,60065,3578769913,3578769957,44
2,1613,60066,3578769913,3578769958,45
2,1613,60067,3578769913,3578769961,48
2,1614,60068,3578769979,3578769979,0
2,1614,60069,3578769979,3578769979,0
2,1614,60070,3578769979,3578769979,0
2,1614,60071,3578769979,3578769979,0
2,1614,60072,3578769979,3578769979,0
2,1614,60073,3578769979,3578769979,0
2,1614,60074,3578769979,3578769979,0
2,1614,60075,3578769979,3578769979,0
2,1614,60076,3578769979,3578769979,0
2,1614,60077,3578769979,3578769979,0
2,1614,60078,3578769979,3578769979,0
2,1614,60079,3578769979,3578769979,0
2,1614,60080,3578769979,3578769979,0
2,1614,60081,3578769979,3578769979,0
2,1614,60082,3578769979,3578769979,0
2,1614,60083,3578769979,3578769979,0
2,1614,60084,3578769979,3578769980,1
2,1614,60085,3578769979,3578769982,3
2,1614,60086,3578769979,3578769983,4
2,1614,60087,3578769979,3578769984,5
2,1614,60088,3578769979,3578769984,5
2,1614,60089,3578769979,3578769985,6
2,1614,60090,3578769979,3578769985,6
2,1614,60091,3578769979,3578769987,8
2,1614,60092,3578769979,3578769987,8
2,1614,60093,3578769979,3578769987,8
2,1614,60094,3578769979,3578769987,8
2,1614,60095,3578769979,3578769987,8
2,1614,60096,3578769979,3578769988,9
2,1614,60097,3578769979,3578769988,9
2,1614,60098,3578769979,3578769989,10
2,1614,60099,3578769979,3578769990,11
2,1614,60100,3578769979,3578769991,12
2,1614,60101,3578769979,3578769991,12
2,1614,60102,3578769979,3578769992,13
2,1614,60103,3578769979,3578769993,14
2,1614,60104,3578769979,3578769997,18
2,1614,60105,3578769979,3578769998,19
2,1614,60106,3578769979,3578770001,22
2,1614,60107,3578769979,3578770001,22
2,1614,60108,3578769979,3578770002,23
2,1614,60109,3578769979,3578770002,23
2,1614,60110,3578769979,3578770003,24
2,1614,60111,3578769979,3578770003,24
2,1614,60112,3578769979,3578770004,25
2,1614,60113,3578769979,3578770004,25
2,1614,60114,3578769979,3578770004,25
2,1614,60115,3578769979,3578770006,27
2,1614,60116,3578769979,3578770006,27
2,1614,60117,3578769979,3578770007,28
2,1614,60118,3578769979,3578770008,29
2,1614,60119,3578769979,3578770012,33
2,1614,60120,3578769979,3578770013,34
2,1614,60121,3578769979,3578770014,35
2,1614,60122,3578769979,3578770014,35
2,1614,60123,3578769979,3578770015,36
2,1614,60124,3578769979,3578770015,36
2,1614,60125,3578769979,3578770019,40
2,1614,60126,3578769979,3578770022,43
2,1614,60127,3578769979,3578770022,43
2,1614,60128,3578769979,3578770022,43
2,1614,60129,3578769979,3578770024,45
2,1614,60130,3578769979,3578770024,45
2,1614,60131,3578769979,3578770025,46
2,1614,60132,3578769979,3578770026,47
2,1614,60133,3578769979,3578770026,47
2,1614,60134,3578769979,3578770026,47
2,1614,60135,3578769979,3578770027,48
2,1614,60136,3578769979,3578770027,48
2,1614,60137,3578769979,3578770029,50
2,1615,60138,3578770044,3578770044,0
2,1615,60139,3578770044,3578770044,0
2,1615,60140,3578770044,3578770044,0
2,1615,60141,3578770044,3578770044,0
2,1615,60142,3578770044,3578770044,0
2,1615,60143,3578770044,3578770044,0
2,1615,60144,3578770044,3578770044,0
2,1615,60145,3578770044,3578770044,0
2,1615,60146,3578770044,3578770044,0
2,1615,60147,3578770044,3578770044,0
2,1615,60148,3578770044,3578770044,0
2,1615,60149,3578770044,3578770044,0
2,1615,60150,3578770044,3578770044,0
2,1615,60151,3578770044,3578770044,0
2,1615,60152,3578770044,3578770044,0
2,1615,60153,3578770044,3578770044,0
2,1615,60154,3578770044,3578770044,0
2,1615,60155,3578770044,3578770044,0
2,1615,60156,3578770044,3578770044,0
2,1615,60157,3578770044,3578770044,0
2,1615,60158,3578770044,3578770044,0
2,1615,60159,3578770044,3578770044,0
2,1615,60160,3578770044,3578770046,2
2,1615,60161,3578770044,3578770047,3
2,1615,60162,3578770044,3578770048,4
2,1615,60163,3578770044,3578770048,4
2,1615,60164,3578770044,3578770049,5
2,1615,60165,3578770044,3578770050,6
2,1615,60166,3578770044,3578770050,6
2,1615,60167,3578770044,3578770051,7
2,1615,60168,3578770044,3578770051,7
2,1615,60169,3578770044,3578770052,8
2,1615,60170,3578770044,3578770054,10
2,1615,60171,3578770044,3578770055,11
2,1615,60172,3578770044,3578770055,11
2,1615,60173,3578770044,3578770055,11
2,1615,60174,3578770044,3578770058,14
2,1615,60175,3578770044,3578770060,16
2,1615,60176,3578770044,3578770061,17
2,1615,60177,3578770044,3578770062,18
2,1615,60178,3578770044,3578770064,20
2,1615,60179,3578770044,3578770065,21
2,1615,60180,3578770044,3578770067,23
2,1615,60181,3578770044,3578770083,39
2,1615,60182,3578770044,3578770086,42
2,1615,60183,3578770044,3578770089,45
2,1615,60184,3578770044,3578770089,45
2,1615,60185,3578770044,3578770090,46
2,1615,60186,3578770044,3578770091,47
2,1615,60187,3578770044,3578770091,47
2,1615,60188,3578770044,3578770092,48
2,1615,60189,3578770044,3578770093,49
2,1615,60190,3578770044,3578770093,49
2,1615,60191,3578770044,3578770093,49
2,1616,60192,3578770109,3578770109,0
2,1616,60193,3578770109,3578770109,0
2,1616,60194,3578770109,3578770109,0
2,1616,60195,3578770109,3578770109,0
2,1616,60196,3578770109,3578770109,0
2,1616,60197,3578770109,3578770109,0
2,1616,60198,3578770109,3578770109,0
2,1616,60199,3578770109,3578770109,0
2,1616,60200,3578770109,3578770109,0
2,1616,60201,3578770109,3578770109,0
2,1616,60202,3578770109,3578770109,0
2,1616,60203,3578770109,3578770109,0
2,1616,60204,3578770109,3578770109,0
2,1616,60205,3578770109,3578770109,0
2,1616,60206,3578770109,3578770109,0
2,1616,60207,3578770109,3578770109,0
2,1616,60208,3578770109,3578770109,0
2,1616,60209,3578770109,3578770109,0
2,1616,60210,3578770109,3578770109,0
2,1616,60211,3578770109,3578770109,0
2,1616,60212,3578770109,3578770110,1
2,1616,60213,3578770109,3578770110,1
2,1616,60214,3578770109,3578770110,1
2,1616,60215,3578770109,3578770110,1
2,1616,60216,3578770109,3578770110,1
2,1616,60217,3578770109,3578770111,2
2,1616,60218,3578770109,3578770112,3
2,1616,60219,3578770109,3578770112,3
2,1616,60220,3578770109,3578770114,5
2,1616,60221,3578770109,3578770114,5
2,1616,60222,3578770109,3578770114,5
2,1616,60223,3578770109,3578770114,5
2,1616,60224,3578770109,3578770115,6
2,1616,60225,3578770109,3578770117,8
2,1616,60226,3578770109,3578770117,8
2,1616,60227,3578770109,3578770119,10
2,1616,60228,3578770109,3578770119,10
2,1616,60229,3578770109,3578770120,11
2,1616,60230,3578770109,3578770121,12
2,1616,60231,3578770109,3578770122,13
2,1616,60232,3578770109,3578770123,14
2,1616,60233,3578770109,3578770123,14
2,1616,60234,3578770109,3578770123,14
2,1616,60235,3578770109,3578770124,15
2,1616,60236,3578770109,3578770125,16
2,1616,60237,3578770109,3578770127,18
2,1616,60238,3578770109,3578770128,19
2,1616,60239,3578770109,3578770129,20
2,1616,60240,3578770109,3578770132,23
2,1616,60241,3578770109,3578770133,24
2,1616,60242,3578770109,3578770136,27
2,1616,60243,3578770109,3578770136,27
2,1616,60244,3578770109,3578770136,27
2,1616,60245,3578770109,3578770137,28
2,1616,60246,3578770109,3578770138,29
2,1616,60247,3578770109,3578770138,29
2,1616,60248,3578770109,3578770138,29
2,1616,60249,3578770109,3578770138,29
2,1616,60250,3578770109,3578770138,29
2,1616,60251,3578770109,3578770140,31
2,1616,60252,3578770109,3578770140,31
2,1616,60253,3578770109,3578770140,31
2,1616,60254,3578770109,3578770143,34
2,1616,60255,3578770109,3578770143,34
2,1616,60256,3578770109,3578770144,35
2,1616,60257,3578770109,3578770146,37
2,1616,60258,3578770109,3578770146,37
2,1616,60259,3578770109,3578770148,39
2,1616,60260,3578770109,3578770150,41
2,1616,60261,3578770109,3578770150,41
2,1616,60262,3578770109,3578770151,42
2,1616,60263,3578770109,3578770151,42
2,1616,60264,3578770109,3578770152,43
2,1616,60265,3578770109,3578770152,43
2,1616,60266,3578770109,3578770152,43
2,1616,60267,3578770109,3578770152,43
2,1616,60268,3578770109,3578770153,44
2,1616,60269,3578770109,3578770153,44
2,1616,60270,3578770109,3578770154,45
2,1616,60271,3578770109,3578770157,48
2,1616,60272,3578770109,3578770158,49
2,1616,60273,3578770109,3578770158,49
2,1617,60274,3578770173,3578770173,0
2,1617,60275,3578770173,3578770173,0
2,1617,60276,3578770173,3578770173,0
2,1617,60277,3578770173,3578770173,0
2,1617,60278,3578770173,3578770173,0
2,1617,60279,3578770173,3578770173,0
2,1617,60280,3578770173,3578770174,1
2,1617,60281,3578770173,3578770174,1
2,1617,60282,3578770173,3578770174,1
2,1617,60283,3578770173,3578770174,1
2,1617,60284,3578770173,3578770174,1
2,1617,60285,3578770173,3578770174,1
2,1617,60286,3578770173,3578770174,1
2,1617,60287,3578770173,3578770176,3
2,1617,60288,3578770173,3578770177,4
2,1617,60289,3578770173,3578770178,5
2,1617,60290,3578770173,3578770180,7
2,1617,60291,3578770173,3578770181,8
2,1617,60292,3578770173,3578770183,10
2,1617,60293,3578770173,3578770183,10
2,1617,60294,3578770173,3578770184,11
2,1617,60295,3578770173,3578770184,11
2,1617,60296,3578770173,3578770185,12
2,1617,60297,3578770173,3578770186,13
2,1617,60298,3578770173,3578770187,14
2,1617,60299,3578770173,3578770187,14
2,1617,60300,3578770173,3578770188,15
2,1617,60301,3578770173,3578770188,15
2,1617,60302,3578770173,3578770189,16
2,1617,60303,3578770173,3578770190,17
2,1617,60304,3578770173,3578770190,17
2,1617,60305,3578770173,3578770191,18
2,1617,60306,3578770173,3578770192,19
2,1617,60307,3578770173,3578770192,19
2,1617,60308,3578770173,3578770193,20
2,1617,60309,3578770173,3578770197,24
2,1617,60310,3578770173,3578770198,25
2,1617,60311,3578770173,3578770202,29
2,1617,60312,3578770173,3578770202,29
2,1617,60313,3578770173,3578770203,30
2,1617,60314,3578770173,3578770203,30
2,1617,60315,3578770173,3578770203,30
2,1617,60316,3578770173,3578770204,31
2,1617,60317,3578770173,3578770204,31
2,1617,60318,3578770173,3578770204,31
2,1617,60319,3578770173,3578770204,31
2,1617,60320,3578770173,3578770206,33
2,1617,60321,3578770173,3578770206,33
2,1617,60322,3578770173,3578770208,35
2,1617,60323,3578770173,3578770208,35
2,1617,60324,3578770173,3578770213,40
2,1617,60325,3578770173,3578770213,40
2,1617,60326,3578770173,3578770213,40
2,1617,60327,3578770173,3578770215,42
2,1617,60328,3578770173,3578770215,42
2,1617,60329,3578770173,3578770216,43
2,1617,60330,3578770173,3578770219,46
2,1617,60331,3578770173,3578770221,48
2,1617,60332,3578770173,3578770222,49
2,1617,60333,3578770173,3578770222,49
2,1618,60334,3578770239,3578770239,0
2,1618,60335,3578770239,3578770239,0
2,1618,60336,3578770239,3578770239,0
2,1618,60337,3578770239,3578770239,0
2,1618,60338,3578770239,3578770239,0
2,1618,60339,3578770239,3578770239,0
2,1618,60340,3578770239,3578770239,0
2,1618,60341,3578770239,3578770239,0
2,1618,60342,3578770239,3578770239,0
2,1618,60343,3578770239,3578770239,0
2,1618,60344,3578770239,3578770239,0
2,1618,60345,3578770239,3578770239,0
2,1618,60346,3578770239,3578770239,0
2,1618,60347,3578770239,3578770239,0
2,1618,60348,3578770239,3578770239,0
2,1618,60349,3578770239,3578770239,0
2,1618,60350,3578770239,3578770239,0
2,1618,60351,3578770239,3578770239,0
2,1618,60352,3578770239,3578770239,0
2,1618,60353,3578770239,3578770239,0
2,1618,60354,3578770239,3578770239,0
2,1618,60355,3578770239,3578770240,1
2,1618,60356,3578770239,3578770240,1
2,1618,60357,3578770239,3578770241,2
2,1618,60358,3578770239,3578770241,2
2,1618,60359,3578770239,3578770242,3
2,1618,60360,3578770239,3578770242,3
2,1618,60361,3578770239,3578770242,3
2,1618,60362,3578770239,3578770243,4
2,1618,60363,3578770239,3578770245,6
2,1618,60364,3578770239,3578770246,7
2,1618,60365,3578770239,3578770247,8
2,1618,60366,3578770239,3578770248,9
2,1618,60367,3578770239,3578770248,9
2,1618,60368,3578770239,3578770250,11
2,1618,60369,3578770239,3578770250,11
2,1618,60370,3578770239,3578770251,12
2,1618,60371,3578770239,3578770251,12
2,1618,60372,3578770239,3578770252,13
2,1618,60373,3578770239,3578770252,13
2,1618,60374,3578770239,3578770254,15
2,1618,60375,3578770239,3578770254,15
2,1618,60376,3578770239,3578770255,16
2,1618,60377,3578770239,3578770255,16
2,1618,60378,3578770239,3578770258,19
2,1618,60379,3578770239,3578770261,22
2,1618,60380,3578770239,3578770262,23
2,1618,60381,3578770239,3578770264,25
2,1618,60382,3578770239,3578770266,27
2,1618,60383,3578770239,3578770268,29
2,1618,60384,3578770239,3578770283,44
2,1618,60385,3578770239,3578770286,47
2,1618,60386,3578770239,3578770289,50
2,1619,60387,3578770305,3578770305,0
2,1619,60388,3578770305,3578770305,0
2,1619,60389,3578770305,3578770305,0
2,1619,60390,3578770305,3578770305,0
2,1619,60391,3578770305,3578770305,0
2,1619,60392,3578770305,3578770305,0
2,1619,60393,3578770305,3578770305,0
2,1619,60394,3578770305,3578770305,0
2,1619,60395,3578770305,3578770305,0
2,1619,60396,3578770305,3578770305,0
2,1619,60397,3578770305,3578770305,0
2,1619,60398,3578770305,3578770305,0
2,1619,60399,3578770305,3578770305,0
2,1619,60400,3578770305,3578770305,0
2,1619,60401,3578770305,3578770305,0
2,1619,60402,3578770305,3578770305,0
2,1619,60403,3578770305,3578770305,0
2,1619,60404,3578770305,3578770305,0
2,1619,60405,3578770305,3578770305,0
2,1619,60406,3578770305,3578770305,0
2,1619,60407,3578770305,3578770305,0
2,1619,60408,3578770305,3578770305,0
2,1619,60409,3578770305,3578770305,0
2,1619,60410,3578770305,3578770305,0
2,1619,60411,3578770305,3578770305,0
2,1619,60412,3578770305,3578770305,0
2,1619,60413,3578770305,3578770306,1
2,1619,60414,3578770305,3578770306,1
2,1619,60415,3578770305,3578770308,3
2,1619,60416,3578770305,3578770308,3
2,1619,60417,3578770305,3578770309,4
2,1619,60418,3578770305,3578770309,4
2,1619,60419,3578770305,3578770310,5
2,1619,60420,3578770305,3578770311,6
2,1619,60421,3578770305,3578770311,6
2,1619,60422,3578770305,3578770313,8
2,1619,60423,3578770305,3578770313,8
2,1619,60424,3578770305,3578770314,9
2,1619,60425,3578770305,3578770315,10
2,1619,60426,3578770305,3578770315,10
2,1619,60427,3578770305,3578770315,10
2,1619,60428,3578770305,3578770316,11
2,1619,60429,3578770305,3578770317,12
2,1619,60430,3578770305,3578770319,14
2,1619,60431,3578770305,3578770320,15
2,1619,60432,3578770305,3578770320,15
2,1619,60433,3578770305,3578770323,18
2,1619,60434,3578770305,3578770323,18
2,1619,60435,3578770305,3578770324,19
2,1619,60436,3578770305,3578770324,19
2,1619,60437,3578770305,3578770326,21
2,1619,60438,3578770305,3578770326,21
2,1619,60439,3578770305,3578770326,21
2,1619,60440,3578770305,3578770327,22
2,1619,60441,3578770305,3578770328,23
2,1619,60442,3578770305,3578770328,23
2,1619,60443,3578770305,3578770329,24
2,1619,60444,3578770305,3578770331,26
2,1619,60445,3578770305,3578770333,28
2,1619,60446,3578770305,3578770335,30
2,1619,60447,3578770305,3578770336,31
2,1619,60448,3578770305,3578770336,31
2,1619,60449,3578770305,3578770336,31
2,1619,60450,3578770305,3578770337,32
2,1619,60451,3578770305,3578770338,33
2,1619,60452,3578770305,3578770338,33
2,1619,60453,3578770305,3578770338,33
2,1619,60454,3578770305,3578770338,33
2,1619,60455,3578770305,3578770338,33
2,1619,60456,3578770305,3578770340,35
2,1619,60457,3578770305,3578770340,35
2,1619,60458,3578770305,3578770341,36
2,1619,60459,3578770305,3578770342,37
2,1619,60460,3578770305,3578770343,38
2,1619,60461,3578770305,3578770344,39
2,1619,60462,3578770305,3578770346,41
2,1619,60463,3578770305,3578770346,41
2,1619,60464,3578770305,3578770348,43
2,1619,60465,3578770305,3578770350,45
2,1619,60466,3578770305,3578770350,45
2,1619,60467,3578770305,3578770351,46
2,1619,60468,3578770305,3578770351,46
2,1619,60469,3578770305,3578770352,47
2,1619,60470,3578770305,3578770352,47
2,1619,60471,3578770305,3578770352,47
2,1619,60472,3578770305,3578770352,47
2,1619,60473,3578770305,3578770354,49
2,1619,60474,3578770305,3578770355,50
2,1620,60475,3578770369,3578770369,0
2,1620,60476,3578770369,3578770369,0
2,1620,60477,3578770369,3578770369,0
2,1620,60478,3578770369,3578770369,0
2,1620,60479,3578770369,3578770369,0
2,1620,60480,3578770369,3578770369,0
2,1620,60481,3578770369,3578770369,0
2,1620,60482,3578770369,3578770369,0
2,1620,60483,3578770369,3578770369,0
2,1620,60484,3578770369,3578770371,2
2,1620,60485,3578770369,3578770371,2
2,1620,60486,3578770369,3578770373,4
2,1620,60487,3578770369,3578770374,5
2,1620,60488,3578770369,3578770374,5
2,1620,60489,3578770369,3578770374,5
2,1620,60490,3578770369,3578770376,7
2,1620,60491,3578770369,3578770380,11
2,1620,60492,3578770369,3578770381,12
2,1620,60493,3578770369,3578770383,14
2,1620,60494,3578770369,3578770383,14
2,1620,60495,3578770369,3578770384,15
2,1620,60496,3578770369,3578770384,15
2,1620,60497,3578770369,3578770385,16
2,1620,60498,3578770369,3578770385,16
2,1620,60499,3578770369,3578770385,16
2,1620,60500,3578770369,3578770387,18
2,1620,60501,3578770369,3578770387,18
2,1620,60502,3578770369,3578770388,19
2,1620,60503,3578770369,3578770388,19
2,1620,60504,3578770369,3578770389,20
2,1620,60505,3578770369,3578770389,20
2,1620,60506,3578770369,3578770391,22
2,1620,60507,3578770369,3578770391,22
2,1620,60508,3578770369,3578770392,23
2,1620,60509,3578770369,3578770392,23
2,1620,60510,3578770369,3578770394,25
2,1620,60511,3578770369,3578770395,26
2,1620,60512,3578770369,3578770398,29
2,1620,60513,3578770369,3578770401,32
2,1620,60514,3578770369,3578770403,34
2,1620,60515,3578770369,3578770403,34
2,1620,60516,3578770369,3578770404,35
2,1620,60517,3578770369,3578770404,35
2,1620,60518,3578770369,3578770404,35
2,1620,60519,3578770369,3578770405,36
2,1620,60520,3578770369,3578770405,36
2,1620,60521,3578770369,3578770406,37
2,1620,60522,3578770369,3578770407,38
2,1620,60523,3578770369,3578770408,39
2,1620,60524,3578770369,3578770411,42
2,1620,60525,3578770369,3578770413,44
2,1620,60526,3578770369,3578770413,44
2,1620,60527,3578770369,3578770413,44
2,1620,60528,3578770369,3578770414,45
2,1620,60529,3578770369,3578770415,46
2,1620,60530,3578770369,3578770416,47
2,1621,60531,3578770434,3578770434,0
2,1621,60532,3578770434,3578770434,0
2,1621,60533,3578770434,3578770434,0
2,1621,60534,3578770434,3578770434,0
2,1621,60535,3578770434,3578770434,0
2,1621,60536,3578770434,3578770434,0
2,1621,60537,3578770434,3578770434,0
2,1621,60538,3578770434,3578770434,0
2,1621,60539,3578770434,3578770434,0
2,1621,60540,3578770434,3578770434,0
2,1621,60541,3578770434,3578770434,0
2,1621,60542,3578770434,3578770434,0
2,1621,60543,3578770434,3578770434,0
2,1621,60544,3578770434,3578770434,0
2,1621,60545,3578770434,3578770434,0
2,1621,60546,3578770434,3578770434,0
2,1621,60547,3578770434,3578770434,0
2,1621,60548,3578770434,3578770434,0
2,1621,60549,3578770434,3578770435,1
2,1621,60550,3578770434,3578770437,3
2,1621,60551,3578770434,3578770438,4
2,1621,60552,3578770434,3578770438,4
2,1621,60553,3578770434,3578770439,5
2,1621,60554,3578770434,3578770439,5
2,1621,60555,3578770434,3578770439,5
2,1621,60556,3578770434,3578770440,6
2,1621,60557,3578770434,3578770440,6
2,1621,60558,3578770434,3578770441,7
2,1621,60559,3578770434,3578770441,7
2,1621,60560,3578770434,3578770442,8
2,1621,60561,3578770434,3578770442,8
2,1621,60562,3578770434,3578770443,9
2,1621,60563,3578770434,3578770443,9
2,1621,60564,3578770434,3578770443,9
2,1621,60565,3578770434,3578770445,11
2,1621,60566,3578770434,3578770448,14
2,1621,60567,3578770434,3578770448,14
2,1621,60568,3578770434,3578770448,14
2,1621,60569,3578770434,3578770450,16
2,1621,60570,3578770434,3578770450,16
2,1621,60571,3578770434,3578770451,17
2,1621,60572,3578770434,3578770451,17
2,1621,60573,3578770434,3578770452,18
2,1621,60574,3578770434,3578770452,18
2,1621,60575,3578770434,3578770454,20
2,1621,60576,3578770434,3578770454,20
2,1621,60577,3578770434,3578770455,21
2,1621,60578,3578770434,3578770456,22
2,1621,60579,3578770434,3578770460,26
2,1621,60580,3578770434,3578770461,27
2,1621,60581,3578770434,3578770462,28
2,1621,60582,3578770434,3578770464,30
2,1621,60583,3578770434,3578770466,32
2,1621,60584,3578770434,3578770469,35
2,1621,60585,3578770434,3578770483,49
2,1621,60586,3578770434,3578770484,50
2,1622,60587,3578770500,3578770500,0
2,1622,60588,3578770500,3578770500,0
2,1622,60589,3578770500,3578770500,0
2,1622,60590,3578770500,3578770500,0
2,1622,60591,3578770500,3578770500,0
2,1622,60592,3578770500,3578770500,0
2,1622,60593,3578770500,3578770500,0
2,1622,60594,3578770500,3578770500,0
2,1622,60595,3578770500,3578770500,0
2,1622,60596,3578770500,3578770500,0
2,1622,60597,3578770500,3578770500,0
2,1622,60598,3578770500,3578770500,0
2,1622,60599,3578770500,3578770500,0
2,1622,60600,3578770500,3578770500,0
2,1622,60601,3578770500,3578770500,0
2,1622,60602,3578770500,3578770500,0
2,1622,60603,3578770500,3578770500,0
2,1622,60604,3578770500,3578770500,0
2,1622,60605,3578770500,3578770500,0
2,1622,60606,3578770500,3578770501,1
2,1622,60607,3578770500,3578770501,1
2,1622,60608,3578770500,3578770501,1
2,1622,60609,3578770500,3578770504,4
2,1622,60610,3578770500,3578770504,4
2,1622,60611,3578770500,3578770504,4
2,1622,60612,3578770500,3578770504,4
2,1622,60613,3578770500,3578770505,5
2,1622,60614,3578770500,3578770506,6
2,1622,60615,3578770500,3578770508,8
2,1622,60616,3578770500,3578770508,8
2,1622,60617,3578770500,3578770509,9
2,1622,60618,3578770500,3578770509,9
2,1622,60619,3578770500,3578770510,10
2,1622,60620,3578770500,3578770510,10
2,1622,60621,3578770500,3578770511,11
2,1622,60622,3578770500,3578770512,12
2,1622,60623,3578770500,3578770512,12
2,1622,60624,3578770500,3578770513,13
2,1622,60625,3578770500,3578770513,13
2,1622,60626,3578770500,3578770513,13
2,1622,60627,3578770500,3578770514,14
2,1622,60628,3578770500,3578770515,15
2,1622,60629,3578770500,3578770516,16
2,1622,60630,3578770500,3578770518,18
2,1622,60631,3578770500,3578770519,19
2,1622,60632,3578770500,3578770521,21
2,1622,60633,3578770500,3578770522,22
2,1622,60634,3578770500,3578770522,22
2,1622,60635,3578770500,3578770522,22
2,1622,60636,3578770500,3578770522,22
2,1622,60637,3578770500,3578770524,24
2,1622,60638,3578770500,3578770525,25
2,1622,60639,3578770500,3578770525,25
2,1622,60640,3578770500,3578770526,26
2,1622,60641,3578770500,3578770526,26
2,1622,60642,3578770500,3578770526,26
2,1622,60643,3578770500,3578770528,28
2,1622,60644,3578770500,3578770528,28
2,1622,60645,3578770500,3578770531,31
2,1622,60646,3578770500,3578770532,32
2,1622,60647,3578770500,3578770534,34
2,1622,60648,3578770500,3578770535,35
2,1622,60649,3578770500,3578770536,36
2,1622,60650,3578770500,3578770537,37
2,1622,60651,3578770500,3578770537,37
2,1622,60652,3578770500,3578770537,37
2,1622,60653,3578770500,3578770537,37
2,1622,60654,3578770500,3578770537,37
2,1622,60655,3578770500,3578770538,38
2,1622,60656,3578770500,3578770539,39
2,1622,60657,3578770500,3578770539,39
2,1622,60658,3578770500,3578770540,40
2,1622,60659,3578770500,3578770542,42
2,1622,60660,3578770500,3578770543,43
2,1622,60661,3578770500,3578770545,45
2,1622,60662,3578770500,3578770547,47
2,1622,60663,3578770500,3578770549,49
2,1622,60664,3578770500,3578770550,50
2,1623,60665,3578770565,3578770565,0
2,1623,60666,3578770565,3578770565,0
2,1623,60667,3578770565,3578770565,0
2,1623,60668,3578770565,3578770565,0
2,1623,60669,3578770565,3578770565,0
2,1623,60670,3578770565,3578770565,0
2,1623,60671,3578770565,3578770565,0
2,1623,60672,3578770565,3578770565,0
2,1623,60673,3578770565,3578770565,0
2,1623,60674,3578770565,3578770565,0
2,1623,60675,3578770565,3578770565,0
2,1623,60676,3578770565,3578770565,0
2,1623,60677,3578770565,3578770565,0
2,1623,60678,3578770565,3578770565,0
2,1623,60679,3578770565,3578770565,0
2,1623,60680,3578770565,3578770569,4
2,1623,60681,3578770565,3578770570,5
2,1623,60682,3578770565,3578770571,6
2,1623,60683,3578770565,3578770572,7
2,1623,60684,3578770565,3578770573,8
2,1623,60685,3578770565,3578770573,8
2,1623,60686,3578770565,3578770574,9
2,1623,60687,3578770565,3578770577,12
2,1623,60688,3578770565,3578770579,14
2,1623,60689,3578770565,3578770580,15
2,1623,60690,3578770565,3578770583,18
2,1623,60691,3578770565,3578770583,18
2,1623,60692,3578770565,3578770583,18
2,1623,60693,3578770565,3578770583,18
2,1623,60694,3578770565,3578770584,19
2,1623,60695,3578770565,3578770585,20
2,1623,60696,3578770565,3578770586,21
2,1623,60697,3578770565,3578770587,22
2,1623,60698,3578770565,3578770587,22
2,1623,60699,3578770565,3578770588,23
2,1623,60700,3578770565,3578770589,24
2,1623,60701,3578770565,3578770590,25
2,1623,60702,3578770565,3578770590,25
2,1623,60703,3578770565,3578770590,25
2,1623,60704,3578770565,3578770591,26
2,1623,60705,3578770565,3578770594,29
2,1623,60706,3578770565,3578770596,31
2,1623,60707,3578770565,3578770600,35
2,1623,60708,3578770565,3578770602,37
2,1623,60709,3578770565,3578770602,37
2,1623,60710,3578770565,3578770603,38
2,1623,60711,3578770565,3578770603,38
2,1623,60712,3578770565,3578770603,38
2,1623,60713,3578770565,3578770606,41
2,1623,60714,3578770565,3578770606,41
2,1623,60715,3578770565,3578770608,43
2,1623,60716,3578770565,3578770610,45
2,1623,60717,3578770565,3578770612,47
2,1623,60718,3578770565,3578770613,48
2,1623,60719,3578770565,3578770613,48
2,1623,60720,3578770565,3578770615,50
2,1624,60721,3578770631,3578770631,0
2,1624,60722,3578770631,3578770631,0
2,1624,60723,3578770631,3578770631,0
2,1624,60724,3578770631,3578770631,0
2,1624,60725,3578770631,3578770631,0
2,1624,60726,3578770631,3578770631,0
2,1624,60727,3578770631,3578770631,0
2,1624,60728,3578770631,3578770631,0
2,1624,60729,3578770631,3578770631,0
2,1624,60730,3578770631,3578770631,0
2,1624,60731,3578770631,3578770631,0
2,1624,60732,3578770631,3578770631,0
2,1624,60733,3578770631,3578770631,0
2,1624,60734,3578770631,3578770631,0
2,1624,60735,3578770631,3578770631,0
2,1624,60736,3578770631,3578770631,0
2,1624,60737,3578770631,3578770631,0
2,1624,60738,3578770631,3578770632,1
2,1624,60739,3578770631,3578770633,2
2,1624,60740,3578770631,3578770633,2
2,1624,60741,3578770631,3578770634,3
2,1624,60742,3578770631,3578770635,4
2,1624,60743,3578770631,3578770636,5
2,1624,60744,3578770631,3578770637,6
2,1624,60745,3578770631,3578770637,6
2,1624,60746,3578770631,3578770638,7
2,1624,60747,3578770631,3578770638,7
2,1624,60748,3578770631,3578770639,8
2,1624,60749,3578770631,3578770640,9
2,1624,60750,3578770631,3578770640,9
2,1624,60751,3578770631,3578770640,9
2,1624,60752,3578770631,3578770641,10
2,1624,60753,3578770631,3578770641,10
2,1624,60754,3578770631,3578770641,10
2,1624,60755,3578770631,3578770643,12
2,1624,60756,3578770631,3578770643,12
2,1624,60757,3578770631,3578770643,12
2,1624,60758,3578770631,3578770646,15
2,1624,60759,3578770631,3578770647,16
2,1624,60760,3578770631,3578770647,16
2,1624,60761,3578770631,3578770648,17
2,1624,60762,3578770631,3578770649,18
2,1624,60763,3578770631,3578770649,18
2,1624,60764,3578770631,3578770650,19
2,1624,60765,3578770631,3578770650,19
2,1624,60766,3578770631,3578770651,20
2,1624,60767,3578770631,3578770654,23
2,1624,60768,3578770631,3578770654,23
2,1624,60769,3578770631,3578770655,24
2,1624,60770,3578770631,3578770655,24
2,1624,60771,3578770631,3578770659,28
2,1624,60772,3578770631,3578770660,29
2,1624,60773,3578770631,3578770661,30
2,1624,60774,3578770631,3578770662,31
2,1624,60775,3578770631,3578770663,32
2,1624,60776,3578770631,3578770664,33
2,1624,60777,3578770631,3578770666,35
2,1624,60778,3578770631,3578770668,37
2,1625,60779,3578770697,3578770697,0
2,1625,60780,3578770697,3578770697,0
2,1625,60781,3578770697,3578770697,0
2,1625,60782,3578770697,3578770697,0
2,1625,60783,3578770697,3578770697,0
2,1625,60784,3578770697,3578770697,0
2,1625,60785,3578770697,3578770697,0
2,1625,60786,3578770697,3578770697,0
2,1625,60787,3578770697,3578770697,0
2,1625,60788,3578770697,3578770697,0
2,1625,60789,3578770697,3578770697,0
2,1625,60790,3578770697,3578770697,0
2,1625,60791,3578770697,3578770697,0
2,1625,60792,3578770697,3578770697,0
2,1625,60793,3578770697,3578770697,0
2,1625,60794,3578770697,3578770699,2
2,1625,60795,3578770697,3578770699,2
2,1625,60796,3578770697,3578770699,2
2,1625,60797,3578770697,3578770700,3
2,1625,60798,3578770697,3578770700,3
2,1625,60799,3578770697,3578770701,4
2,1625,60800,3578770697,3578770701,4
2,1625,60801,3578770697,3578770703,6
2,1625,60802,3578770697,3578770703,6
2,1625,60803,3578770697,3578770704,7
2,1625,60804,3578770697,3578770705,8
2,1625,60805,3578770697,3578770706,9
2,1625,60806,3578770697,3578770707,10
2,1625,60807,3578770697,3578770707,10
2,1625,60808,3578770697,3578770708,11
2,1625,60809,3578770697,3578770709,12
2,1625,60810,3578770697,3578770709,12
2,1625,60811,3578770697,3578770710,13
2,1625,60812,3578770697,3578770710,13
2,1625,60813,3578770697,3578770712,15
2,1625,60814,3578770697,3578770713,16
2,1625,60815,3578770697,3578770713,16
2,1625,60816,3578770697,3578770714,17
2,1625,60817,3578770697,3578770715,18
2,1625,60818,3578770697,3578770715,18
2,1625,60819,3578770697,3578770715,18
2,1625,60820,3578770697,3578770717,20
2,1625,60821,3578770697,3578770718,21
2,1625,60822,3578770697,3578770720,23
2,1625,60823,3578770697,3578770721,24
2,1625,60824,3578770697,3578770723,26
2,1625,60825,3578770697,3578770723,26
2,1625,60826,3578770697,3578770724,27
2,1625,60827,3578770697,3578770725,28
2,1625,60828,3578770697,3578770726,29
2,1625,60829,3578770697,3578770726,29
2,1625,60830,3578770697,3578770727,30
2,1625,60831,3578770697,3578770727,30
2,1625,60832,3578770697,3578770728,31
2,1625,60833,3578770697,3578770728,31
2,1625,60834,3578770697,3578770731,34
2,1625,60835,3578770697,3578770732,35
2,1625,60836,3578770697,3578770735,38
2,1625,60837,3578770697,3578770735,38
2,1625,60838,3578770697,3578770737,40
2,1625,60839,3578770697,3578770737,40
2,1625,60840,3578770697,3578770737,40
2,1625,60841,3578770697,3578770737,40
2,1625,60842,3578770697,3578770737,40
2,1625,60843,3578770697,3578770738,41
2,1625,60844,3578770697,3578770738,41
2,1625,60845,3578770697,3578770739,42
2,1625,60846,3578770697,3578770739,42
2,1625,60847,3578770697,3578770739,42
2,1625,60848,3578770697,3578770740,43
2,1625,60849,3578770697,3578770740,43
2,1625,60850,3578770697,3578770742,45
2,1625,60851,3578770697,3578770743,46
2,1625,60852,3578770697,3578770744,47
2,1625,60853,3578770697,3578770745,48
2,1625,60854,3578770697,3578770746,49
2,1626,60855,3578770762,3578770762,0
2,1626,60856,3578770762,3578770762,0
2,1626,60857,3578770762,3578770762,0
2,1626,60858,3578770762,3578770762,0
2,1626,60859,3578770762,3578770762,0
2,1626,60860,3578770762,3578770762,0
2,1626,60861,3578770762,3578770762,0
2,1626,60862,3578770762,3578770762,0
2,1626,60863,3578770762,3578770762,0
2,1626,60864,3578770762,3578770762,0
2,1626,60865,3578770762,3578770762,0
2,1626,60866,3578770762,3578770762,0
2,1626,60867,3578770762,3578770762,0
2,1626,60868,3578770762,3578770762,0
2,1626,60869,3578770762,3578770762,0
2,1626,60870,3578770762,3578770764,2
2,1626,60871,3578770762,3578770764,2
2,1626,60872,3578770762,3578770765,3
2,1626,60873,3578770762,3578770771,9
2,1626,60874,3578770762,3578770772,10
2,1626,60875,3578770762,3578770773,11
2,1626,60876,3578770762,3578770774,12
2,1626,60877,3578770762,3578770775,13
2,1626,60878,3578770762,3578770778,16
2,1626,60879,3578770762,3578770779,17
2,1626,60880,3578770762,3578770780,18
2,1626,60881,3578770762,3578770782,20
2,1626,60882,3578770762,3578770782,20
2,1626,60883,3578770762,3578770783,21
2,1626,60884,3578770762,3578770785,23
2,1626,60885,3578770762,3578770785,23
2,1626,60886,3578770762,3578770786,24
2,1626,60887,3578770762,3578770786,24
2,1626,60888,3578770762,3578770786,24
2,1626,60889,3578770762,3578770787,25
2,1626,60890,3578770762,3578770788,26
2,1626,60891,3578770762,3578770788,26
2,1626,60892,3578770762,3578770788,26
2,1626,60893,3578770762,3578770789,27
2,1626,60894,3578770762,3578770790,28
2,1626,60895,3578770762,3578770790,28
2,1626,60896,3578770762,3578770790,28
2,1626,60897,3578770762,3578770794,32
2,1626,60898,3578770762,3578770797,35
2,1626,60899,3578770762,3578770800,38
2,1626,60900,3578770762,3578770801,39
2,1626,60901,3578770762,3578770802,40
2,1626,60902,3578770762,3578770803,41
2,1626,60903,3578770762,3578770803,41
2,1626,60904,3578770762,3578770804,42
2,1626,60905,3578770762,3578770804,42
2,1626,60906,3578770762,3578770806,44
2,1626,60907,3578770762,3578770808,46
2,1626,60908,3578770762,3578770808,46
2,1626,60909,3578770762,3578770811,49
2,1626,60910,3578770762,3578770811,49
2,1627,60911,3578770828,3578770828,0
2,1627,60912,3578770828,3578770828,0
2,1627,60913,3578770828,3578770828,0
2,1627,60914,3578770828,3578770828,0
2,1627,60915,3578770828,3578770828,0
2,1627,60916,3578770828,3578770828,0
2,1627,60917,3578770828,3578770828,0
2,1627,60918,3578770828,3578770828,0
2,1627,60919,3578770828,3578770828,0
2,1627,60920,3578770828,3578770828,0
2,1627,60921,3578770828,3578770828,0
2,1627,60922,3578770828,3578770828,0
2,1627,60923,3578770828,3578770828,0
2,1627,60924,3578770828,3578770828,0
2,1627,60925,3578770828,3578770828,0
2,1627,60926,3578770828,3578770828,0
2,1627,60927,3578770828,3578770829,1
2,1627,60928,3578770828,3578770831,3
2,1627,60929,3578770828,3578770831,3
2,1627,60930,3578770828,3578770831,3
2,1627,60931,3578770828,3578770832,4
2,1627,60932,3578770828,3578770833,5
2,1627,60933,3578770828,3578770833,5
2,1627,60934,3578770828,3578770834,6
2,1627,60935,3578770828,3578770835,7
2,1627,60936,3578770828,3578770836,8
2,1627,60937,3578770828,3578770837,9
2,1627,60938,3578770828,3578770838,10
2,1627,60939,3578770828,3578770838,10
2,1627,60940,3578770828,3578770839,11
2,1627,60941,3578770828,3578770839,11
2,1627,60942,3578770828,3578770840,12
2,1627,60943,3578770828,3578770841,13
2,1627,60944,3578770828,3578770841,13
2,1627,60945,3578770828,3578770842,14
2,1627,60946,3578770828,3578770843,15
2,1627,60947,3578770828,3578770843,15
2,1627,60948,3578770828,3578770844,16
2,1627,60949,3578770828,3578770846,18
2,1627,60950,3578770828,3578770847,19
2,1627,60951,3578770828,3578770848,20
2,1627,60952,3578770828,3578770849,21
2,1627,60953,3578770828,3578770850,22
2,1627,60954,3578770828,3578770850,22
2,1627,60955,3578770828,3578770850,22
2,1627,60956,3578770828,3578770851,23
2,1627,60957,3578770828,3578770851,23
2,1627,60958,3578770828,3578770853,25
2,1627,60959,3578770828,3578770854,26
2,1627,60960,3578770828,3578770855,27
2,1627,60961,3578770828,3578770855,27
2,1627,60962,3578770828,3578770859,31
2,1627,60963,3578770828,3578770861,33
2,1627,60964,3578770828,3578770862,34
2,1627,60965,3578770828,3578770862,34
2,1627,60966,3578770828,3578770863,35
2,1627,60967,3578770828,3578770865,37
2,1627,60968,3578770828,3578770867,39
2,1628,60969,3578770896,3578770896,0
2,1628,60970,3578770896,3578770896,0
2,1628,60971,3578770896,3578770896,0
2,1628,60972,3578770896,3578770896,0
2,1628,60973,3578770896,3578770896,0
2,1628,60974,3578770896,3578770896,0
2,1628,60975,3578770896,3578770896,0
2,1628,60976,3578770896,3578770896,0
2,1628,60977,3578770896,3578770896,0
2,1628,60978,3578770896,3578770896,0
2,1628,60979,3578770896,3578770896,0
2,1628,60980,3578770896,3578770899,3
2,1628,60981,3578770896,3578770899,3
2,1628,60982,3578770896,3578770899,3
2,1628,60983,3578770896,3578770901,5
2,1628,60984,3578770896,3578770901,5
2,1628,60985,3578770896,3578770901,5
2,1628,60986,3578770896,3578770902,6
2,1628,60987,3578770896,3578770904,8
2,1628,60988,3578770896,3578770904,8
2,1628,60989,3578770896,3578770904,8
2,1628,60990,3578770896,3578770906,10
2,1628,60991,3578770896,3578770907,11
2,1628,60992,3578770896,3578770908,12
2,1628,60993,3578770896,3578770908,12
2,1628,60994,3578770896,3578770910,14
2,1628,60995,3578770896,3578770910,14
2,1628,60996,3578770896,3578770911,15
2,1628,60997,3578770896,3578770911,15
2,1628,60998,3578770896,3578770912,16
2,1628,60999,3578770896,3578770912,16
2,1628,61000,3578770896,3578770913,17
2,1628,61001,3578770896,3578770914,18
2,1628,61002,3578770896,3578770916,20
2,1628,61003,3578770896,3578770917,21
2,1628,61004,3578770896,3578770918,22
2,1628,61005,3578770896,3578770918,22
2,1628,61006,3578770896,3578770920,24
2,1628,61007,3578770896,3578770923,27
2,1628,61008,3578770896,3578770926,30
2,1628,61009,3578770896,3578770926,30
2,1628,61010,3578770896,3578770926,30
2,1628,61011,3578770896,3578770927,31
2,1628,61012,3578770896,3578770928,32
2,1628,61013,3578770896,3578770928,32
2,1628,61014,3578770896,3578770931,35
2,1628,61015,3578770896,3578770933,37
2,1628,61016,3578770896,3578770935,39
2,1628,61017,3578770896,3578770935,39
2,1628,61018,3578770896,3578770937,41
2,1628,61019,3578770896,3578770937,41
2,1628,61020,3578770896,3578770937,41
2,1628,61021,3578770896,3578770937,41
2,1628,61022,3578770896,3578770938,42
2,1628,61023,3578770896,3578770938,42
2,1628,61024,3578770896,3578770938,42
2,1628,61025,3578770896,3578770939,43
2,1628,61026,3578770896,3578770939,43
2,1628,61027,3578770896,3578770939,43
2,1628,61028,3578770896,3578770940,44
2,1628,61029,3578770896,3578770940,44
2,1628,61030,3578770896,3578770941,45
2,1628,61031,3578770896,3578770944,48
2,1628,61032,3578770896,3578770944,48
2,1628,61033,3578770896,3578770945,49
2,1629,61034,3578770963,3578770963,0
2,1629,61035,3578770963,3578770963,0
2,1629,61036,3578770963,3578770963,0
2,1629,61037,3578770963,3578770963,0
2,1629,61038,3578770963,3578770963,0
2,1629,61039,3578770963,3578770963,0
2,1629,61040,3578770963,3578770963,0
2,1629,61041,3578770963,3578770963,0
2,1629,61042,3578770963,3578770963,0
2,1629,61043,3578770963,3578770963,0
2,1629,61044,3578770963,3578770963,0
2,1629,61045,3578770963,3578770963,0
2,1629,61046,3578770963,3578770963,0
2,1629,61047,3578770963,3578770963,0
2,1629,61048,3578770963,3578770963,0
2,1629,61049,3578770963,3578770963,0
2,1629,61050,3578770963,3578770964,1
2,1629,61051,3578770963,3578770965,2
2,1629,61052,3578770963,3578770965,2
2,1629,61053,3578770963,3578770966,3
2,1629,61054,3578770963,3578770968,5
2,1629,61055,3578770963,3578770972,9
2,1629,61056,3578770963,3578770972,9
2,1629,61057,3578770963,3578770974,11
2,1629,61058,3578770963,3578770974,11
2,1629,61059,3578770963,3578770976,13
2,1629,61060,3578770963,3578770977,14
2,1629,61061,3578770963,3578770977,14
2,1629,61062,3578770963,3578770980,17
2,1629,61063,3578770963,3578770980,17
2,1629,61064,3578770963,3578770982,19
2,1629,61065,3578770963,3578770983,20
2,1629,61066,3578770963,3578770984,21
2,1629,61067,3578770963,3578770984,21
2,1629,61068,3578770963,3578770985,22
2,1629,61069,3578770963,3578770986,23
2,1629,61070,3578770963,3578770986,23
2,1629,61071,3578770963,3578770987,24
2,1629,61072,3578770963,3578770987,24
2,1629,61073,3578770963,3578770987,24
2,1629,61074,3578770963,3578770988,25
2,1629,61075,3578770963,3578770988,25
2,1629,61076,3578770963,3578770989,26
2,1629,61077,3578770963,3578770989,26
2,1629,61078,3578770963,3578770990,27
2,1629,61079,3578770963,3578770991,28
2,1629,61080,3578770963,3578770991,28
2,1629,61081,3578770963,3578770995,32
2,1629,61082,3578770963,3578770997,34
2,1629,61083,3578770963,3578771001,38
2,1629,61084,3578770963,3578771002,39
2,1629,61085,3578770963,3578771003,40
2,1629,61086,3578770963,3578771004,41
2,1629,61087,3578770963,3578771005,42
2,1629,61088,3578770963,3578771006,43
2,1629,61089,3578770963,3578771008,45
2,1629,61090,3578770963,3578771009,46
2,1629,61091,3578770963,3578771011,48
2,1629,61092,3578770963,3578771013,50
2,1630,61093,3578771030,3578771030,0
2,1630,61094,3578771030,3578771030,0
2,1630,61095,3578771030,3578771030,0
2,1630,61096,3578771030,3578771030,0
2,1630,61097,3578771030,3578771030,0
2,1630,61098,3578771030,3578771030,0
2,1630,61099,3578771030,3578771030,0
2,1630,61100,3578771030,3578771030,0
2,1630,61101,3578771030,3578771030,0
2,1630,61102,3578771030,3578771030,0
2,1630,61103,3578771030,3578771030,0
2,1630,61104,3578771030,3578771030,0
2,1630,61105,3578771030,3578771030,0
2,1630,61106,3578771030,3578771030,0
2,1630,61107,3578771030,3578771030,0
2,1630,61108,3578771030,3578771030,0
2,1630,61109,3578771030,3578771031,1
2,1630,61110,3578771030,3578771031,1
2,1630,61111,3578771030,3578771032,2
2,1630,61112,3578771030,3578771032,2
2,1630,61113,3578771030,3578771032,2
2,1630,61114,3578771030,3578771033,3
2,1630,61115,3578771030,3578771033,3
2,1630,61116,3578771030,3578771035,5
2,1630,61117,3578771030,3578771036,6
2,1630,61118,3578771030,3578771037,7
2,1630,61119,3578771030,3578771038,8
2,1630,61120,3578771030,3578771038,8
2,1630,61121,3578771030,3578771039,9
2,1630,61122,3578771030,3578771040,10
2,1630,61123,3578771030,3578771040,10
2,1630,61124,3578771030,3578771040,10
2,1630,61125,3578771030,3578771041,11
2,1630,61126,3578771030,3578771041,11
2,1630,61127,3578771030,3578771042,12
2,1630,61128,3578771030,3578771043,13
2,1630,61129,3578771030,3578771043,13
2,1630,61130,3578771030,3578771044,14
2,1630,61131,3578771030,3578771046,16
2,1630,61132,3578771030,3578771047,17
2,1630,61133,3578771030,3578771047,17
2,1630,61134,3578771030,3578771048,18
2,1630,61135,3578771030,3578771049,19
2,1630,61136,3578771030,3578771050,20
2,1630,61137,3578771030,3578771050,20
2,1630,61138,3578771030,3578771051,21
2,1630,61139,3578771030,3578771052,22
2,1630,61140,3578771030,3578771052,22
2,1630,61141,3578771030,3578771053,23
2,1630,61142,3578771030,3578771054,24
2,1630,61143,3578771030,3578771054,24
2,1630,61144,3578771030,3578771054,24
2,1630,61145,3578771030,3578771056,26
2,1630,61146,3578771030,3578771058,28
2,1630,61147,3578771030,3578771061,31
2,1630,61148,3578771030,3578771061,31
2,1630,61149,3578771030,3578771061,31
2,1630,61150,3578771030,3578771062,32
2,1630,61151,3578771030,3578771063,33
2,1630,61152,3578771030,3578771066,36
2,1630,61153,3578771030,3578771068,38
2,1631,61154,3578771096,3578771096,0
2,1631,61155,3578771096,3578771096,0
2,1631,61156,3578771096,3578771096,0
2,1631,61157,3578771096,3578771096,0
2,1631,61158,3578771096,3578771096,0
2,1631,61159,3578771096,3578771096,0
2,1631,61160,3578771096,3578771096,0
2,1631,61161,3578771096,3578771096,0
2,1631,61162,3578771096,3578771096,0
2,1631,61163,3578771096,3578771096,0
2,1631,61164,3578771096,3578771096,0
2,1631,61165,3578771096,3578771096,0
2,1631,61166,3578771096,3578771096,0
2,1631,61167,3578771096,3578771098,2
2,1631,61168,3578771096,3578771099,3
2,1631,61169,3578771096,3578771100,4
2,1631,61170,3578771096,3578771100,4
2,1631,61171,3578771096,3578771100,4
2,1631,61172,3578771096,3578771101,5
2,1631,61173,3578771096,3578771101,5
2,1631,61174,3578771096,3578771102,6
2,1631,61175,3578771096,3578771104,8
2,1631,61176,3578771096,3578771104,8
2,1631,61177,3578771096,3578771104,8
2,1631,61178,3578771096,3578771105,9
2,1631,61179,3578771096,3578771107,11
2,1631,61180,3578771096,3578771108,12
2,1631,61181,3578771096,3578771108,12
2,1631,61182,3578771096,3578771110,14
2,1631,61183,3578771096,3578771110,14
2,1631,61184,3578771096,3578771110,14
2,1631,61185,3578771096,3578771111,15
2,1631,61186,3578771096,3578771112,16
2,1631,61187,3578771096,3578771112,16
2,1631,61188,3578771096,3578771113,17
2,1631,61189,3578771096,3578771114,18
2,1631,61190,3578771096,3578771114,18
2,1631,61191,3578771096,3578771116,20
2,1631,61192,3578771096,3578771116,20
2,1631,61193,3578771096,3578771118,22
2,1631,61194,3578771096,3578771118,22
2,1631,61195,3578771096,3578771120,24
2,1631,61196,3578771096,3578771121,25
2,1631,61197,3578771096,3578771123,27
2,1631,61198,3578771096,3578771123,27
2,1631,61199,3578771096,3578771123,27
2,1631,61200,3578771096,3578771124,28
2,1631,61201,3578771096,3578771126,30
2,1631,61202,3578771096,3578771126,30
2,1631,61203,3578771096,3578771127,31
2,1631,61204,3578771096,3578771128,32
2,1631,61205,3578771096,3578771129,33
2,1631,61206,3578771096,3578771130,34
2,1631,61207,3578771096,3578771133,37
2,1631,61208,3578771096,3578771135,39
2,1631,61209,3578771096,3578771136,40
2,1631,61210,3578771096,3578771137,41
2,1631,61211,3578771096,3578771137,41
2,1631,61212,3578771096,3578771137,41
2,1631,61213,3578771096,3578771138,42
2,1631,61214,3578771096,3578771138,42
2,1631,61215,3578771096,3578771138,42
2,1631,61216,3578771096,3578771139,43
2,1631,61217,3578771096,3578771139,43
2,1631,61218,3578771096,3578771139,43
2,1631,61219,3578771096,3578771139,43
2,1631,61220,3578771096,3578771139,43
2,1631,61221,3578771096,3578771140,44
2,1631,61222,3578771096,3578771144,48
2,1631,61223,3578771096,3578771144,48
2,1631,61224,3578771096,3578771145,49
2,1632,61225,3578771160,3578771160,0
2,1632,61226,3578771160,3578771160,0
2,1632,61227,3578771160,3578771160,0
2,1632,61228,3578771160,3578771160,0
2,1632,61229,3578771160,3578771160,0
2,1632,61230,3578771160,3578771160,0
2,1632,61231,3578771160,3578771160,0
2,1632,61232,3578771160,3578771160,0
2,1632,61233,3578771160,3578771160,0
2,1632,61234,3578771160,3578771160,0
2,1632,61235,3578771160,3578771160,0
2,1632,61236,3578771160,3578771160,0
2,1632,61237,3578771160,3578771160,0
2,1632,61238,3578771160,3578771161,1
2,1632,61239,3578771160,3578771163,3
2,1632,61240,3578771160,3578771164,4
2,1632,61241,3578771160,3578771164,4
2,1632,61242,3578771160,3578771166,6
2,1632,61243,3578771160,3578771167,7
2,1632,61244,3578771160,3578771169,9
2,1632,61245,3578771160,3578771171,11
2,1632,61246,3578771160,3578771171,11
2,1632,61247,3578771160,3578771172,12
2,1632,61248,3578771160,3578771174,14
2,1632,61249,3578771160,3578771174,14
2,1632,61250,3578771160,3578771176,16
2,1632,61251,3578771160,3578771178,18
2,1632,61252,3578771160,3578771178,18
2,1632,61253,3578771160,3578771180,20
2,1632,61254,3578771160,3578771180,20
2,1632,61255,3578771160,3578771183,23
2,1632,61256,3578771160,3578771183,23
2,1632,61257,3578771160,3578771184,24
2,1632,61258,3578771160,3578771184,24
2,1632,61259,3578771160,3578771185,25
2,1632,61260,3578771160,3578771185,25
2,1632,61261,3578771160,3578771186,26
2,1632,61262,3578771160,3578771187,27
2,1632,61263,3578771160,3578771187,27
2,1632,61264,3578771160,3578771188,28
2,1632,61265,3578771160,3578771188,28
2,1632,61266,3578771160,3578771189,29
2,1632,61267,3578771160,3578771189,29
2,1632,61268,3578771160,3578771189,29
2,1632,61269,3578771160,3578771189,29
2,1632,61270,3578771160,3578771191,31
2,1632,61271,3578771160,3578771191,31
2,1632,61272,3578771160,3578771191,31
2,1632,61273,3578771160,3578771194,34
2,1632,61274,3578771160,3578771200,40
2,1632,61275,3578771160,3578771201,41
2,1632,61276,3578771160,3578771203,43
2,1632,61277,3578771160,3578771204,44
2,1632,61278,3578771160,3578771205,45
2,1632,61279,3578771160,3578771205,45
2,1632,61280,3578771160,3578771205,45
2,1632,61281,3578771160,3578771206,46
2,1632,61282,3578771160,3578771208,48
2,1632,61283,3578771160,3578771209,49
2,1633,61284,3578771226,3578771226,0
2,1633,61285,3578771226,3578771226,0
2,1633,61286,3578771226,3578771226,0
2,1633,61287,3578771226,3578771226,0
2,1633,61288,3578771226,3578771226,0
2,1633,61289,3578771226,3578771226,0
2,1633,61290,3578771226,3578771226,0
2,1633,61291,3578771226,3578771226,0
2,1633,61292,3578771226,3578771226,0
2,1633,61293,3578771226,3578771226,0
2,1633,61294,3578771226,3578771226,0
2,1633,61295,3578771226,3578771226,0
2,1633,61296,3578771226,3578771226,0
2,1633,61297,3578771226,3578771226,0
2,1633,61298,3578771226,3578771227,1
2,1633,61299,3578771226,3578771227,1
2,1633,61300,3578771226,3578771228,2
2,1633,61301,3578771226,3578771231,5
2,1633,61302,3578771226,3578771231,5
2,1633,61303,3578771226,3578771231,5
2,1633,61304,3578771226,3578771231,5
2,1633,61305,3578771226,3578771232,6
2,1633,61306,3578771226,3578771232,6
2,1633,61307,3578771226,3578771233,7
2,1633,61308,3578771226,3578771234,8
2,1633,61309,3578771226,3578771235,9
2,1633,61310,3578771226,3578771236,10
2,1633,61311,3578771226,3578771237,11
2,1633,61312,3578771226,3578771239,13
2,1633,61313,3578771226,3578771239,13
2,1633,61314,3578771226,3578771240,14
2,1633,61315,3578771226,3578771240,14
2,1633,61316,3578771226,3578771241,15
2,1633,61317,3578771226,3578771241,15
2,1633,61318,3578771226,3578771241,15
2,1633,61319,3578771226,3578771242,16
2,1633,61320,3578771226,3578771243,17
2,1633,61321,3578771226,3578771243,17
2,1633,61322,3578771226,3578771244,18
2,1633,61323,3578771226,3578771246,20
2,1633,61324,3578771226,3578771247,21
2,1633,61325,3578771226,3578771247,21
2,1633,61326,3578771226,3578771248,22
2,1633,61327,3578771226,3578771249,23
2,1633,61328,3578771226,3578771249,23
2,1633,61329,3578771226,3578771250,24
2,1633,61330,3578771226,3578771251,25
2,1633,61331,3578771226,3578771252,26
2,1633,61332,3578771226,3578771253,27
2,1633,61333,3578771226,3578771253,27
2,1633,61334,3578771226,3578771254,28
2,1633,61335,3578771226,3578771254,28
2,1633,61336,3578771226,3578771255,29
2,1633,61337,3578771226,3578771256,30
2,1633,61338,3578771226,3578771258,32
2,1633,61339,3578771226,3578771262,36
2,1633,61340,3578771226,3578771262,36
2,1633,61341,3578771226,3578771262,36
2,1633,61342,3578771226,3578771264,38
2,1633,61343,3578771226,3578771266,40
2,1633,61344,3578771226,3578771266,40
2,1633,61345,3578771226,3578771267,41
2,1634,61346,3578771292,3578771292,0
2,1634,61347,3578771292,3578771292,0
2,1634,61348,3578771292,3578771292,0
2,1634,61349,3578771292,3578771292,0
2,1634,61350,3578771292,3578771292,0
2,1634,61351,3578771292,3578771293,1
2,1634,61352,3578771292,3578771294,2
2,1634,61353,3578771292,3578771294,2
2,1634,61354,3578771292,3578771294,2
2,1634,61355,3578771292,3578771295,3
2,1634,61356,3578771292,3578771295,3
2,1634,61357,3578771292,3578771295,3
2,1634,61358,3578771292,3578771295,3
2,1634,61359,3578771292,3578771296,4
2,1634,61360,3578771292,3578771296,4
2,1634,61361,3578771292,3578771297,5
2,1634,61362,3578771292,3578771297,5
2,1634,61363,3578771292,3578771299,7
2,1634,61364,3578771292,3578771299,7
2,1634,61365,3578771292,3578771300,8
2,1634,61366,3578771292,3578771300,8
2,1634,61367,3578771292,3578771301,9
2,1634,61368,3578771292,3578771301,9
2,1634,61369,3578771292,3578771302,10
2,1634,61370,3578771292,3578771302,10
2,1634,61371,3578771292,3578771303,11
2,1634,61372,3578771292,3578771304,12
2,1634,61373,3578771292,3578771305,13
2,1634,61374,3578771292,3578771305,13
2,1634,61375,3578771292,3578771308,16
2,1634,61376,3578771292,3578771308,16
2,1634,61377,3578771292,3578771308,16
2,1634,61378,3578771292,3578771309,17
2,1634,61379,3578771292,3578771310,18
2,1634,61380,3578771292,3578771311,19
2,1634,61381,3578771292,3578771311,19
2,1634,61382,3578771292,3578771313,21
2,1634,61383,3578771292,3578771313,21
2,1634,61384,3578771292,3578771313,21
2,1634,61385,3578771292,3578771314,22
2,1634,61386,3578771292,3578771315,23
2,1634,61387,3578771292,3578771316,24
2,1634,61388,3578771292,3578771317,25
2,1634,61389,3578771292,3578771318,26
2,1634,61390,3578771292,3578771319,27
2,1634,61391,3578771292,3578771320,28
2,1634,61392,3578771292,3578771321,29
2,1634,61393,3578771292,3578771322,30
2,1634,61394,3578771292,3578771323,31
2,1634,61395,3578771292,3578771323,31
2,1634,61396,3578771292,3578771323,31
2,1634,61397,3578771292,3578771324,32
2,1634,61398,3578771292,3578771325,33
2,1634,61399,3578771292,3578771327,35
2,1634,61400,3578771292,3578771327,35
2,1634,61401,3578771292,3578771328,36
2,1634,61402,3578771292,3578771329,37
2,1634,61403,3578771292,3578771332,40
2,1634,61404,3578771292,3578771336,44
2,1634,61405,3578771292,3578771336,44
2,1634,61406,3578771292,3578771336,44
2,1634,61407,3578771292,3578771337,45
2,1634,61408,3578771292,3578771338,46
2,1634,61409,3578771292,3578771338,46
2,1634,61410,3578771292,3578771338,46
2,1634,61411,3578771292,3578771339,47
2,1634,61412,3578771292,3578771341,49
2,1634,61413,3578771292,3578771341,49
2,1634,61414,3578771292,3578771342,50
2,1635,61415,3578771359,3578771359,0
2,1635,61416,3578771359,3578771359,0
2,1635,61417,3578771359,3578771359,0
2,1635,61418,3578771359,3578771359,0
2,1635,61419,3578771359,3578771359,0
2,1635,61420,3578771359,3578771359,0
2,1635,61421,3578771359,3578771359,0
2,1635,61422,3578771359,3578771359,0
2,1635,61423,3578771359,3578771359,0
2,1635,61424,3578771359,3578771359,0
2,1635,61425,3578771359,3578771359,0
2,1635,61426,3578771359,3578771359,0
2,1635,61427,3578771359,3578771359,0
2,1635,61428,3578771359,3578771359,0
2,1635,61429,3578771359,3578771359,0
2,1635,61430,3578771359,3578771359,0
2,1635,61431,3578771359,3578771359,0
2,1635,61432,3578771359,3578771359,0
2,1635,61433,3578771359,3578771362,3
2,1635,61434,3578771359,3578771364,5
2,1635,61435,3578771359,3578771364,5
2,1635,61436,3578771359,3578771365,6
2,1635,61437,3578771359,3578771365,6
2,1635,61438,3578771359,3578771368,9
2,1635,61439,3578771359,3578771369,10
2,1635,61440,3578771359,3578771370,11
2,1635,61441,3578771359,3578771371,12
2,1635,61442,3578771359,3578771372,13
2,1635,61443,3578771359,3578771374,15
2,1635,61444,3578771359,3578771374,15
2,1635,61445,3578771359,3578771374,15
2,1635,61446,3578771359,3578771377,18
2,1635,61447,3578771359,3578771378,19
2,1635,61448,3578771359,3578771378,19
2,1635,61449,3578771359,3578771380,21
2,1635,61450,3578771359,3578771381,22
2,1635,61451,3578771359,3578771383,24
2,1635,61452,3578771359,3578771384,25
2,1635,61453,3578771359,3578771384,25
2,1635,61454,3578771359,3578771385,26
2,1635,61455,3578771359,3578771385,26
2,1635,61456,3578771359,3578771386,27
2,1635,61457,3578771359,3578771386,27
2,1635,61458,3578771359,3578771387,28
2,1635,61459,3578771359,3578771388,29
2,1635,61460,3578771359,3578771389,30
2,1635,61461,3578771359,3578771389,30
2,1635,61462,3578771359,3578771389,30
2,1635,61463,3578771359,3578771389,30
2,1635,61464,3578771359,3578771389,30
2,1635,61465,3578771359,3578771391,32
2,1635,61466,3578771359,3578771391,32
2,1635,61467,3578771359,3578771391,32
2,1635,61468,3578771359,3578771392,33
2,1635,61469,3578771359,3578771395,36
2,1635,61470,3578771359,3578771400,41
2,1635,61471,3578771359,3578771402,43
2,1635,61472,3578771359,3578771402,43
2,1635,61473,3578771359,3578771403,44
2,1635,61474,3578771359,3578771404,45
2,1635,61475,3578771359,3578771405,46
2,1635,61476,3578771359,3578771405,46
2,1635,61477,3578771359,3578771406,47
2,1635,61478,3578771359,3578771406,47
2,1635,61479,3578771359,3578771407,48
2,1635,61480,3578771359,3578771409,50
2,1636,61481,3578771425,3578771425,0
2,1636,61482,3578771425,3578771425,0
2,1636,61483,3578771425,3578771425,0
2,1636,61484,3578771425,3578771425,0
2,1636,61485,3578771425,3578771425,0
2,1636,61486,3578771425,3578771425,0
2,1636,61487,3578771425,3578771425,0
2,1636,61488,3578771425,3578771425,0
2,1636,61489,3578771425,3578771425,0
2,1636,61490,3578771425,3578771425,0
2,1636,61491,3578771425,3578771425,0
2,1636,61492,3578771425,3578771426,1
2,1636,61493,3578771425,3578771426,1
2,1636,61494,3578771425,3578771426,1
2,1636,61495,3578771425,3578771428,3
2,1636,61496,3578771425,3578771428,3
2,1636,61497,3578771425,3578771431,6
2,1636,61498,3578771425,3578771431,6
2,1636,61499,3578771425,3578771432,7
2,1636,61500,3578771425,3578771432,7
2,1636,61501,3578771425,3578771432,7
2,1636,61502,3578771425,3578771433,8
2,1636,61503,3578771425,3578771434,9
2,1636,61504,3578771425,3578771435,10
2,1636,61505,3578771425,3578771437,12
2,1636,61506,3578771425,3578771438,13
2,1636,61507,3578771425,3578771438,13
2,1636,61508,3578771425,3578771439,14
2,1636,61509,3578771425,3578771439,14
2,1636,61510,3578771425,3578771440,15
2,1636,61511,3578771425,3578771441,16
2,1636,61512,3578771425,3578771442,17
2,1636,61513,3578771425,3578771442,17
2,1636,61514,3578771425,3578771442,17
2,1636,61515,3578771425,3578771443,18
2,1636,61516,3578771425,3578771443,18
2,1636,61517,3578771425,3578771443,18
2,1636,61518,3578771425,3578771445,20
2,1636,61519,3578771425,3578771447,22
2,1636,61520,3578771425,3578771448,23
2,1636,61521,3578771425,3578771448,23
2,1636,61522,3578771425,3578771449,24
2,1636,61523,3578771425,3578771449,24
2,1636,61524,3578771425,3578771449,24
2,1636,61525,3578771425,3578771451,26
2,1636,61526,3578771425,3578771451,26
2,1636,61527,3578771425,3578771452,27
2,1636,61528,3578771425,3578771454,29
2,1636,61529,3578771425,3578771454,29
2,1636,61530,3578771425,3578771455,30
2,1636,61531,3578771425,3578771459,34
2,1636,61532,3578771425,3578771461,36
2,1636,61533,3578771425,3578771462,37
2,1636,61534,3578771425,3578771462,37
2,1636,61535,3578771425,3578771464,39
2,1636,61536,3578771425,3578771466,41
2,1636,61537,3578771425,3578771467,42
2,1637,61538,3578771489,3578771489,0
2,1637,61539,3578771489,3578771490,1
2,1637,61540,3578771489,3578771490,1
2,1637,61541,3578771489,3578771490,1
2,1637,61542,3578771489,3578771490,1
2,1637,61543,3578771489,3578771490,1
2,1637,61544,3578771489,3578771492,3
2,1637,61545,3578771489,3578771492,3
2,1637,61546,3578771489,3578771492,3
2,1637,61547,3578771489,3578771493,4
2,1637,61548,3578771489,3578771493,4
2,1637,61549,3578771489,3578771494,5
2,1637,61550,3578771489,3578771494,5
2,1637,61551,3578771489,3578771495,6
2,1637,61552,3578771489,3578771495,6
2,1637,61553,3578771489,3578771495,6
2,1637,61554,3578771489,3578771496,7
2,1637,61555,3578771489,3578771496,7
2,1637,61556,3578771489,3578771496,7
2,1637,61557,3578771489,3578771496,7
2,1637,61558,3578771489,3578771498,9
2,1637,61559,3578771489,3578771499,10
2,1637,61560,3578771489,3578771499,10
2,1637,61561,3578771489,3578771500,11
2,1637,61562,3578771489,3578771500,11
2,1637,61563,3578771489,3578771500,11
2,1637,61564,3578771489,3578771500,11
2,1637,61565,3578771489,3578771501,12
2,1637,61566,3578771489,3578771501,12
2,1637,61567,3578771489,3578771503,14
2,1637,61568,3578771489,3578771504,15
2,1637,61569,3578771489,3578771505,16
2,1637,61570,3578771489,3578771507,18
2,1637,61571,3578771489,3578771507,18
2,1637,61572,3578771489,3578771509,20
2,1637,61573,3578771489,3578771509,20
2,1637,61574,3578771489,3578771510,21
2,1637,61575,3578771489,3578771510,21
2,1637,61576,3578771489,3578771511,22
2,1637,61577,3578771489,3578771512,23
2,1637,61578,3578771489,3578771512,23
2,1637,61579,3578771489,3578771513,24
2,1637,61580,3578771489,3578771513,24
2,1637,61581,3578771489,3578771513,24
2,1637,61582,3578771489,3578771516,27
2,1637,61583,3578771489,3578771516,27
2,1637,61584,3578771489,3578771517,28
2,1637,61585,3578771489,3578771517,28
2,1637,61586,3578771489,3578771519,30
2,1637,61587,3578771489,3578771520,31
2,1637,61588,3578771489,3578771521,32
2,1637,61589,3578771489,3578771521,32
2,1637,61590,3578771489,3578771521,32
2,1637,61591,3578771489,3578771522,33
2,1637,61592,3578771489,3578771522,33
2,1637,61593,3578771489,3578771524,35
2,1637,61594,3578771489,3578771524,35
2,1637,61595,3578771489,3578771525,36
2,1637,61596,3578771489,3578771525,36
2,1637,61597,3578771489,3578771526,37
2,1637,61598,3578771489,3578771527,38
2,1637,61599,3578771489,3578771528,39
2,1637,61600,3578771489,3578771531,42
2,1637,61601,3578771489,3578771531,42
2,1637,61602,3578771489,3578771535,46
2,1637,61603,3578771489,3578771535,46
2,1637,61604,3578771489,3578771537,48
2,1637,61605,3578771489,3578771537,48
2,1637,61606,3578771489,3578771537,48
2,1637,61607,3578771489,3578771537,48
2,1637,61608,3578771489,3578771538,49
2,1637,61609,3578771489,3578771539,50
2,1638,61610,3578771555,3578771556,1
2,1638,61611,3578771555,3578771556,1
2,1638,61612,3578771555,3578771556,1
2,1638,61613,3578771555,3578771556,1
2,1638,61614,3578771555,3578771556,1
2,1638,61615,3578771555,3578771556,1
2,1638,61616,3578771555,3578771556,1
2,1638,61617,3578771555,3578771556,1
2,1638,61618,3578771555,3578771556,1
2,1638,61619,3578771555,3578771556,1
2,1638,61620,3578771555,3578771556,1
2,1638,61621,3578771555,3578771556,1
2,1638,61622,3578771555,3578771556,1
2,1638,61623,3578771555,3578771556,1
2,1638,61624,3578771555,3578771556,1
2,1638,61625,3578771555,3578771556,1
2,1638,61626,3578771555,3578771556,1
2,1638,61627,3578771555,3578771556,1
2,1638,61628,3578771555,3578771556,1
2,1638,61629,3578771555,3578771556,1
2,1638,61630,3578771555,3578771557,2
2,1638,61631,3578771555,3578771557,2
2,1638,61632,3578771555,3578771558,3
2,1638,61633,3578771555,3578771561,6
2,1638,61634,3578771555,3578771563,8
2,1638,61635,3578771555,3578771563,8
2,1638,61636,3578771555,3578771565,10
2,1638,61637,3578771555,3578771565,10
2,1638,61638,3578771555,3578771566,11
2,1638,61639,3578771555,3578771569,14
2,1638,61640,3578771555,3578771570,15
2,1638,61641,3578771555,3578771570,15
2,1638,61642,3578771555,3578771570,15
2,1638,61643,3578771555,3578771573,18
2,1638,61644,3578771555,3578771573,18
2,1638,61645,3578771555,3578771574,19
2,1638,61646,3578771555,3578771576,21
2,1638,61647,3578771555,3578771577,22
2,1638,61648,3578771555,3578771579,24
2,1638,61649,3578771555,3578771580,25
2,1638,61650,3578771555,3578771583,28
2,1638,61651,3578771555,3578771583,28
2,1638,61652,3578771555,3578771583,28
2,1638,61653,3578771555,3578771584,29
2,1638,61654,3578771555,3578771584,29
2,1638,61655,3578771555,3578771585,30
2,1638,61656,3578771555,3578771586,31
2,1638,61657,3578771555,3578771587,32
2,1638,61658,3578771555,3578771587,32
2,1638,61659,3578771555,3578771587,32
2,1638,61660,3578771555,3578771587,32
2,1638,61661,3578771555,3578771588,33
2,1638,61662,3578771555,3578771588,33
2,1638,61663,3578771555,3578771588,33
2,1638,61664,3578771555,3578771589,34
2,1638,61665,3578771555,3578771591,36
2,1638,61666,3578771555,3578771591,36
2,1638,61667,3578771555,3578771592,37
2,1638,61668,3578771555,3578771593,38
2,1638,61669,3578771555,3578771594,39
2,1638,61670,3578771555,3578771601,46
2,1638,61671,3578771555,3578771601,46
2,1638,61672,3578771555,3578771602,47
2,1638,61673,3578771555,3578771602,47
2,1638,61674,3578771555,3578771603,48
2,1638,61675,3578771555,3578771604,49
2,1638,61676,3578771555,3578771604,49
2,1638,61677,3578771555,3578771604,49
2,1639,61678,3578771621,3578771621,0
2,1639,61679,3578771621,3578771621,0
2,1639,61680,3578771621,3578771621,0
2,1639,61681,3578771621,3578771621,0
2,1639,61682,3578771621,3578771621,0
2,1639,61683,3578771621,3578771621,0
2,1639,61684,3578771621,3578771621,0
2,1639,61685,3578771621,3578771621,0
2,1639,61686,3578771621,3578771621,0
2,1639,61687,3578771621,3578771621,0
2,1639,61688,3578771621,3578771621,0
2,1639,61689,3578771621,3578771621,0
2,1639,61690,3578771621,3578771624,3
2,1639,61691,3578771621,3578771624,3
2,1639,61692,3578771621,3578771625,4
2,1639,61693,3578771621,3578771625,4
2,1639,61694,3578771621,3578771627,6
2,1639,61695,3578771621,3578771627,6
2,1639,61696,3578771621,3578771627,6
2,1639,61697,3578771621,3578771630,9
2,1639,61698,3578771621,3578771630,9
2,1639,61699,3578771621,3578771631,10
2,1639,61700,3578771621,3578771632,11
2,1639,61701,3578771621,3578771632,11
2,1639,61702,3578771621,3578771633,12
2,1639,61703,3578771621,3578771633,12
2,1639,61704,3578771621,3578771635,14
2,1639,61705,3578771621,3578771635,14
2,1639,61706,3578771621,3578771636,15
2,1639,61707,3578771621,3578771638,17
2,1639,61708,3578771621,3578771638,17
2,1639,61709,3578771621,3578771638,17
2,1639,61710,3578771621,3578771639,18
2,1639,61711,3578771621,3578771641,20
2,1639,61712,3578771621,3578771641,20
2,1639,61713,3578771621,3578771641,20
2,1639,61714,3578771621,3578771641,20
2,1639,61715,3578771621,3578771642,21
2,1639,61716,3578771621,3578771642,21
2,1639,61717,3578771621,3578771643,22
2,1639,61718,3578771621,3578771643,22
2,1639,61719,3578771621,3578771646,25
2,1639,61720,3578771621,3578771646,25
2,1639,61721,3578771621,3578771647,26
2,1639,61722,3578771621,3578771648,27
2,1639,61723,3578771621,3578771649,28
2,1639,61724,3578771621,3578771650,29
2,1639,61725,3578771621,3578771650,29
2,1639,61726,3578771621,3578771653,32
2,1639,61727,3578771621,3578771653,32
2,1639,61728,3578771621,3578771655,34
2,1639,61729,3578771621,3578771655,34
2,1639,61730,3578771621,3578771657,36
2,1639,61731,3578771621,3578771660,39
2,1639,61732,3578771621,3578771661,40
2,1639,61733,3578771621,3578771661,40
2,1639,61734,3578771621,3578771661,40
2,1639,61735,3578771621,3578771663,42
2,1639,61736,3578771621,3578771665,44
2,1639,61737,3578771621,3578771667,46
2,1640,61738,3578771686,3578771686,0
2,1640,61739,3578771686,3578771687,1
2,1640,61740,3578771686,3578771688,2
2,1640,61741,3578771686,3578771688,2
2,1640,61742,3578771686,3578771690,4
2,1640,61743,3578771686,3578771691,5
2,1640,61744,3578771686,3578771692,6
2,1640,61745,3578771686,3578771692,6
2,1640,61746,3578771686,3578771692,6
2,1640,61747,3578771686,3578771693,7
2,1640,61748,3578771686,3578771694,8
2,1640,61749,3578771686,3578771694,8
2,1640,61750,3578771686,3578771695,9
2,1640,61751,3578771686,3578771695,9
2,1640,61752,3578771686,3578771695,9
2,1640,61753,3578771686,3578771695,9
2,1640,61754,3578771686,3578771696,10
2,1640,61755,3578771686,3578771696,10
2,1640,61756,3578771686,3578771697,11
2,1640,61757,3578771686,3578771698,12
2,1640,61758,3578771686,3578771699,13
2,1640,61759,3578771686,3578771699,13
2,1640,61760,3578771686,3578771700,14
2,1640,61761,3578771686,3578771700,14
2,1640,61762,3578771686,3578771700,14
2,1640,61763,3578771686,3578771700,14
2,1640,61764,3578771686,3578771703,17
2,1640,61765,3578771686,3578771703,17
2,1640,61766,3578771686,3578771704,18
2,1640,61767,3578771686,3578771705,19
2,1640,61768,3578771686,3578771707,21
2,1640,61769,3578771686,3578771708,22
2,1640,61770,3578771686,3578771708,22
2,1640,61771,3578771686,3578771710,24
2,1640,61772,3578771686,3578771710,24
2,1640,61773,3578771686,3578771711,25
2,1640,61774,3578771686,3578771711,25
2,1640,61775,3578771686,3578771713,27
2,1640,61776,3578771686,3578771713,27
2,1640,61777,3578771686,3578771714,28
2,1640,61778,3578771686,3578771715,29
2,1640,61779,3578771686,3578771717,31
2,1640,61780,3578771686,3578771717,31
2,1640,61781,3578771686,3578771719,33
2,1640,61782,3578771686,3578771720,34
2,1640,61783,3578771686,3578771721,35
2,1640,61784,3578771686,3578771722,36
2,1640,61785,3578771686,3578771722,36
2,1640,61786,3578771686,3578771722,36
2,1640,61787,3578771686,3578771723,37
2,1640,61788,3578771686,3578771723,37
2,1640,61789,3578771686,3578771725,39
2,1640,61790,3578771686,3578771725,39
2,1640,61791,3578771686,3578771726,40
2,1640,61792,3578771686,3578771727,41
2,1640,61793,3578771686,3578771728,42
2,1640,61794,3578771686,3578771729,43
2,1640,61795,3578771686,3578771731,45
2,1640,61796,3578771686,3578771732,46
2,1640,61797,3578771686,3578771735,49
2,1641,61798,3578771752,3578771752,0
2,1641,61799,3578771752,3578771752,0
2,1641,61800,3578771752,3578771752,0
2,1641,61801,3578771752,3578771752,0
2,1641,61802,3578771752,3578771752,0
2,1641,61803,3578771752,3578771752,0
2,1641,61804,3578771752,3578771752,0
2,1641,61805,3578771752,3578771752,0
2,1641,61806,3578771752,3578771752,0
2,1641,61807,3578771752,3578771752,0
2,1641,61808,3578771752,3578771752,0
2,1641,61809,3578771752,3578771752,0
2,1641,61810,3578771752,3578771752,0
2,1641,61811,3578771752,3578771752,0
2,1641,61812,3578771752,3578771752,0
2,1641,61813,3578771752,3578771752,0
2,1641,61814,3578771752,3578771752,0
2,1641,61815,3578771752,3578771752,0
2,1641,61816,3578771752,3578771752,0
2,1641,61817,3578771752,3578771752,0
2,1641,61818,3578771752,3578771752,0
2,1641,61819,3578771752,3578771752,0
2,1641,61820,3578771752,3578771753,1
2,1641,61821,3578771752,3578771754,2
2,1641,61822,3578771752,3578771755,3
2,1641,61823,3578771752,3578771757,5
2,1641,61824,3578771752,3578771757,5
2,1641,61825,3578771752,3578771758,6
2,1641,61826,3578771752,3578771762,10
2,1641,61827,3578771752,3578771762,10
2,1641,61828,3578771752,3578771763,11
2,1641,61829,3578771752,3578771765,13
2,1641,61830,3578771752,3578771766,14
2,1641,61831,3578771752,3578771768,16
2,1641,61832,3578771752,3578771769,17
2,1641,61833,3578771752,3578771770,18
2,1641,61834,3578771752,3578771771,19
2,1641,61835,3578771752,3578771772,20
2,1641,61836,3578771752,3578771774,22
2,1641,61837,3578771752,3578771774,22
2,1641,61838,3578771752,3578771776,24
2,1641,61839,3578771752,3578771777,25
2,1641,61840,3578771752,3578771779,27
2,1641,61841,3578771752,3578771780,28
2,1641,61842,3578771752,3578771783,31
2,1641,61843,3578771752,3578771783,31
2,1641,61844,3578771752,3578771783,31
2,1641,61845,3578771752,3578771784,32
2,1641,61846,3578771752,3578771785,33
2,1641,61847,3578771752,3578771785,33
2,1641,61848,3578771752,3578771786,34
2,1641,61849,3578771752,3578771786,34
2,1641,61850,3578771752,3578771787,35
2,1641,61851,3578771752,3578771788,36
2,1641,61852,3578771752,3578771788,36
2,1641,61853,3578771752,3578771788,36
2,1641,61854,3578771752,3578771789,37
2,1641,61855,3578771752,3578771790,38
2,1641,61856,3578771752,3578771790,38
2,1641,61857,3578771752,3578771792,40
2,1641,61858,3578771752,3578771794,42
2,1641,61859,3578771752,3578771794,42
2,1641,61860,3578771752,3578771797,45
2,1641,61861,3578771752,3578771801,49
2,1641,61862,3578771752,3578771801,49
2,1641,61863,3578771752,3578771802,50
2,1642,61864,3578771819,3578771820,1
2,1642,61865,3578771819,3578771820,1
2,1642,61866,3578771819,3578771820,1
2,1642,61867,3578771819,3578771820,1
2,1642,61868,3578771819,3578771820,1
2,1642,61869,3578771819,3578771820,1
2,1642,61870,3578771819,3578771820,1
2,1642,61871,3578771819,3578771820,1
2,1642,61872,3578771819,3578771820,1
2,1642,61873,3578771819,3578771820,1
2,1642,61874,3578771819,3578771820,1
2,1642,61875,3578771819,3578771820,1
2,1642,61876,3578771819,3578771820,1
2,1642,61877,3578771819,3578771820,1
2,1642,61878,3578771819,3578771820,1
2,1642,61879,3578771819,3578771820,1
2,1642,61880,3578771819,3578771822,3
2,1642,61881,3578771819,3578771824,5
2,1642,61882,3578771819,3578771824,5
2,1642,61883,3578771819,3578771824,5
2,1642,61884,3578771819,3578771826,7
2,1642,61885,3578771819,3578771826,7
2,1642,61886,3578771819,3578771827,8
2,1642,61887,3578771819,3578771827,8
2,1642,61888,3578771819,3578771830,11
2,1642,61889,3578771819,3578771830,11
2,1642,61890,3578771819,3578771831,12
2,1642,61891,3578771819,3578771831,12
2,1642,61892,3578771819,3578771832,13
2,1642,61893,3578771819,3578771833,14
2,1642,61894,3578771819,3578771834,15
2,1642,61895,3578771819,3578771836,17
2,1642,61896,3578771819,3578771836,17
2,1642,61897,3578771819,3578771837,18
2,1642,61898,3578771819,3578771838,19
2,1642,61899,3578771819,3578771838,19
2,1642,61900,3578771819,3578771838,19
2,1642,61901,3578771819,3578771839,20
2,1642,61902,3578771819,3578771839,20
2,1642,61903,3578771819,3578771841,22
2,1642,61904,3578771819,3578771841,22
2,1642,61905,3578771819,3578771841,22
2,1642,61906,3578771819,3578771842,23
2,1642,61907,3578771819,3578771842,23
2,1642,61908,3578771819,3578771843,24
2,1642,61909,3578771819,3578771843,24
2,1642,61910,3578771819,3578771843,24
2,1642,61911,3578771819,3578771846,27
2,1642,61912,3578771819,3578771847,28
2,1642,61913,3578771819,3578771847,28
2,1642,61914,3578771819,3578771847,28
2,1642,61915,3578771819,3578771848,29
2,1642,61916,3578771819,3578771850,31
2,1642,61917,3578771819,3578771850,31
2,1642,61918,3578771819,3578771850,31
2,1642,61919,3578771819,3578771853,34
2,1642,61920,3578771819,3578771854,35
2,1642,61921,3578771819,3578771854,35
2,1642,61922,3578771819,3578771854,35
2,1642,61923,3578771819,3578771859,40
2,1642,61924,3578771819,3578771860,41
2,1642,61925,3578771819,3578771861,42
2,1642,61926,3578771819,3578771861,42
2,1642,61927,3578771819,3578771862,43
2,1642,61928,3578771819,3578771863,44
2,1642,61929,3578771819,3578771864,45
2,1642,61930,3578771819,3578771866,47
2,1643,61931,3578771884,3578771885,1
2,1643,61932,3578771884,3578771887,3
2,1643,61933,3578771884,3578771888,4
2,1643,61934,3578771884,3578771888,4
2,1643,61935,3578771884,3578771888,4
2,1643,61936,3578771884,3578771889,5
2,1643,61937,3578771884,3578771891,7
2,1643,61938,3578771884,3578771892,8
2,1643,61939,3578771884,3578771893,9
2,1643,61940,3578771884,3578771893,9
2,1643,61941,3578771884,3578771894,10
2,1643,61942,3578771884,3578771894,10
2,1643,61943,3578771884,3578771894,10
2,1643,61944,3578771884,3578771895,11
2,1643,61945,3578771884,3578771895,11
2,1643,61946,3578771884,3578771895,11
2,1643,61947,3578771884,3578771895,11
2,1643,61948,3578771884,3578771896,12
2,1643,61949,3578771884,3578771896,12
2,1643,61950,3578771884,3578771897,13
2,1643,61951,3578771884,3578771897,13
2,1643,61952,3578771884,3578771898,14
2,1643,61953,3578771884,3578771898,14
2,1643,61954,3578771884,3578771899,15
2,1643,61955,3578771884,3578771899,15
2,1643,61956,3578771884,3578771900,16
2,1643,61957,3578771884,3578771900,16
2,1643,61958,3578771884,3578771900,16
2,1643,61959,3578771884,3578771901,17
2,1643,61960,3578771884,3578771902,18
2,1643,61961,3578771884,3578771903,19
2,1643,61962,3578771884,3578771904,20
2,1643,61963,3578771884,3578771906,22
2,1643,61964,3578771884,3578771907,23
2,1643,61965,3578771884,3578771907,23
2,1643,61966,3578771884,3578771910,26
2,1643,61967,3578771884,3578771910,26
2,1643,61968,3578771884,3578771910,26
2,1643,61969,3578771884,3578771911,27
2,1643,61970,3578771884,3578771912,28
2,1643,61971,3578771884,3578771913,29
2,1643,61972,3578771884,3578771913,29
2,1643,61973,3578771884,3578771914,30
2,1643,61974,3578771884,3578771914,30
2,1643,61975,3578771884,3578771915,31
2,1643,61976,3578771884,3578771917,33
2,1643,61977,3578771884,3578771917,33
2,1643,61978,3578771884,3578771919,35
2,1643,61979,3578771884,3578771920,36
2,1643,61980,3578771884,3578771922,38
2,1643,61981,3578771884,3578771922,38
2,1643,61982,3578771884,3578771922,38
2,1643,61983,3578771884,3578771922,38
2,1643,61984,3578771884,3578771925,41
2,1643,61985,3578771884,3578771926,42
2,1643,61986,3578771884,3578771926,42
2,1643,61987,3578771884,3578771928,44
2,1643,61988,3578771884,3578771928,44
2,1643,61989,3578771884,3578771929,45
2,1643,61990,3578771884,3578771930,46
2,1643,61991,3578771884,3578771932,48
2,1643,61992,3578771884,3578771933,49
2,1644,61993,3578771950,3578771950,0
2,1644,61994,3578771950,3578771950,0
2,1644,61995,3578771950,3578771950,0
2,1644,61996,3578771950,3578771950,0
2,1644,61997,3578771950,3578771950,0
2,1644,61998,3578771950,3578771950,0
2,1644,61999,3578771950,3578771950,0
2,1644,62000,3578771950,3578771950,0
2,1644,62001,3578771950,3578771950,0
2,1644,62002,3578771950,3578771950,0
2,1644,62003,3578771950,3578771950,0
2,1644,62004,3578771950,3578771950,0
2,1644,62005,3578771950,3578771950,0
2,1644,62006,3578771950,3578771950,0
2,1644,62007,3578771950,3578771950,0
2,1644,62008,3578771950,3578771950,0
2,1644,62009,3578771950,3578771950,0
2,1644,62010,3578771950,3578771950,0
2,1644,62011,3578771950,3578771950,0
2,1644,62012,3578771950,3578771950,0
2,1644,62013,3578771950,3578771950,0
2,1644,62014,3578771950,3578771951,1
2,1644,62015,3578771950,3578771951,1
2,1644,62016,3578771950,3578771951,1
2,1644,62017,3578771950,3578771951,1
2,1644,62018,3578771950,3578771953,3
2,1644,62019,3578771950,3578771954,4
2,1644,62020,3578771950,3578771956,6
2,1644,62021,3578771950,3578771957,7
2,1644,62022,3578771950,3578771957,7
2,1644,62023,3578771950,3578771958,8
2,1644,62024,3578771950,3578771962,12
2,1644,62025,3578771950,3578771963,13
2,1644,62026,3578771950,3578771964,14
2,1644,62027,3578771950,3578771966,16
2,1644,62028,3578771950,3578771970,20
2,1644,62029,3578771950,3578771970,20
2,1644,62030,3578771950,3578771972,22
2,1644,62031,3578771950,3578771974,24
2,1644,62032,3578771950,3578771974,24
2,1644,62033,3578771950,3578771974,24
2,1644,62034,3578771950,3578771976,26
2,1644,62035,3578771950,3578771977,27
2,1644,62036,3578771950,3578771979,29
2,1644,62037,3578771950,3578771980,30
2,1644,62038,3578771950,3578771983,33
2,1644,62039,3578771950,3578771983,33
2,1644,62040,3578771950,3578771984,34
2,1644,62041,3578771950,3578771984,34
2,1644,62042,3578771950,3578771984,34
2,1644,62043,3578771950,3578771985,35
2,1644,62044,3578771950,3578771985,35
2,1644,62045,3578771950,3578771986,36
2,1644,62046,3578771950,3578771986,36
2,1644,62047,3578771950,3578771987,37
2,1644,62048,3578771950,3578771988,38
2,1644,62049,3578771950,3578771988,38
2,1644,62050,3578771950,3578771988,38
2,1644,62051,3578771950,3578771989,39
2,1644,62052,3578771950,3578771991,41
2,1644,62053,3578771950,3578771991,41
2,1644,62054,3578771950,3578771991,41
2,1644,62055,3578771950,3578771992,42
2,1644,62056,3578771950,3578771993,43
2,1644,62057,3578771950,3578771995,45
2,1644,62058,3578771950,3578771997,47
2,1645,62059,3578772014,3578772014,0
2,1645,62060,3578772014,3578772014,0
2,1645,62061,3578772014,3578772014,0
2,1645,62062,3578772014,3578772014,0
2,1645,62063,3578772014,3578772014,0
2,1645,62064,3578772014,3578772014,0
2,1645,62065,3578772014,3578772014,0
2,1645,62066,3578772014,3578772015,1
2,1645,62067,3578772014,3578772015,1
2,1645,62068,3578772014,3578772015,1
2,1645,62069,3578772014,3578772015,1
2,1645,62070,3578772014,3578772015,1
2,1645,62071,3578772014,3578772015,1
2,1645,62072,3578772014,3578772015,1
2,1645,62073,3578772014,3578772015,1
2,1645,62074,3578772014,3578772016,2
2,1645,62075,3578772014,3578772016,2
2,1645,62076,3578772014,3578772020,6
2,1645,62077,3578772014,3578772020,6
2,1645,62078,3578772014,3578772021,7
2,1645,62079,3578772014,3578772022,8
2,1645,62080,3578772014,3578772024,10
2,1645,62081,3578772014,3578772024,10
2,1645,62082,3578772014,3578772025,11
2,1645,62083,3578772014,3578772026,12
2,1645,62084,3578772014,3578772026,12
2,1645,62085,3578772014,3578772028,14
2,1645,62086,3578772014,3578772030,16
2,1645,62087,3578772014,3578772031,17
2,1645,62088,3578772014,3578772032,18
2,1645,62089,3578772014,3578772033,19
2,1645,62090,3578772014,3578772033,19
2,1645,62091,3578772014,3578772034,20
2,1645,62092,3578772014,3578772035,21
2,1645,62093,3578772014,3578772037,23
2,1645,62094,3578772014,3578772038,24
2,1645,62095,3578772014,3578772038,24
2,1645,62096,3578772014,3578772038,24
2,1645,62097,3578772014,3578772039,25
2,1645,62098,3578772014,3578772039,25
2,1645,62099,3578772014,3578772041,27
2,1645,62100,3578772014,3578772041,27
2,1645,62101,3578772014,3578772041,27
2,1645,62102,3578772014,3578772041,27
2,1645,62103,3578772014,3578772042,28
2,1645,62104,3578772014,3578772042,28
2,1645,62105,3578772014,3578772043,29
2,1645,62106,3578772014,3578772043,29
2,1645,62107,3578772014,3578772044,30
2,1645,62108,3578772014,3578772046,32
2,1645,62109,3578772014,3578772046,32
2,1645,62110,3578772014,3578772047,33
2,1645,62111,3578772014,3578772048,34
2,1645,62112,3578772014,3578772048,34
2,1645,62113,3578772014,3578772049,35
2,1645,62114,3578772014,3578772050,36
2,1645,62115,3578772014,3578772051,37
2,1645,62116,3578772014,3578772052,38
2,1645,62117,3578772014,3578772053,39
2,1645,62118,3578772014,3578772053,39
2,1645,62119,3578772014,3578772054,40
2,1645,62120,3578772014,3578772055,41
2,1645,62121,3578772014,3578772058,44
2,1645,62122,3578772014,3578772061,47
2,1645,62123,3578772014,3578772061,47
2,1645,62124,3578772014,3578772061,47
2,1645,62125,3578772014,3578772064,50
2,1646,62126,3578772080,3578772080,0
2,1646,62127,3578772080,3578772080,0
2,1646,62128,3578772080,3578772080,0
2,1646,62129,3578772080,3578772085,5
2,1646,62130,3578772080,3578772088,8
2,1646,62131,3578772080,3578772088,8
2,1646,62132,3578772080,3578772088,8
2,1646,62133,3578772080,3578772089,9
2,1646,62134,3578772080,3578772090,10
2,1646,62135,3578772080,3578772091,11
2,1646,62136,3578772080,3578772092,12
2,1646,62137,3578772080,3578772093,13
2,1646,62138,3578772080,3578772093,13
2,1646,62139,3578772080,3578772094,14
2,1646,62140,3578772080,3578772095,15
2,1646,62141,3578772080,3578772095,15
2,1646,62142,3578772080,3578772095,15
2,1646,62143,3578772080,3578772096,16
2,1646,62144,3578772080,3578772096,16
2,1646,62145,3578772080,3578772098,18
2,1646,62146,3578772080,3578772098,18
2,1646,62147,3578772080,3578772099,19
2,1646,62148,3578772080,3578772100,20
2,1646,62149,3578772080,3578772100,20
2,1646,62150,3578772080,3578772100,20
2,1646,62151,3578772080,3578772100,20
2,1646,62152,3578772080,3578772101,21
2,1646,62153,3578772080,3578772102,22
2,1646,62154,3578772080,3578772103,23
2,1646,62155,3578772080,3578772103,23
2,1646,62156,3578772080,3578772103,23
2,1646,62157,3578772080,3578772105,25
2,1646,62158,3578772080,3578772107,27
2,1646,62159,3578772080,3578772107,27
2,1646,62160,3578772080,3578772108,28
2,1646,62161,3578772080,3578772110,30
2,1646,62162,3578772080,3578772111,31
2,1646,62163,3578772080,3578772111,31
2,1646,62164,3578772080,3578772111,31
2,1646,62165,3578772080,3578772112,32
2,1646,62166,3578772080,3578772113,33
2,1646,62167,3578772080,3578772113,33
2,1646,62168,3578772080,3578772114,34
2,1646,62169,3578772080,3578772114,34
2,1646,62170,3578772080,3578772115,35
2,1646,62171,3578772080,3578772116,36
2,1646,62172,3578772080,3578772117,37
2,1646,62173,3578772080,3578772120,40
2,1646,62174,3578772080,3578772120,40
2,1646,62175,3578772080,3578772122,42
2,1646,62176,3578772080,3578772122,42
2,1646,62177,3578772080,3578772122,42
2,1646,62178,3578772080,3578772123,43
2,1646,62179,3578772080,3578772125,45
2,1646,62180,3578772080,3578772126,46
2,1646,62181,3578772080,3578772126,46
2,1646,62182,3578772080,3578772127,47
2,1646,62183,3578772080,3578772127,47
2,1646,62184,3578772080,3578772128,48
2,1646,62185,3578772080,3578772128,48
2,1647,62186,3578772144,3578772144,0
2,1647,62187,3578772144,3578772144,0
2,1647,62188,3578772144,3578772144,0
2,1647,62189,3578772144,3578772144,0
2,1647,62190,3578772144,3578772144,0
2,1647,62191,3578772144,3578772144,0
2,1647,62192,3578772144,3578772144,0
2,1647,62193,3578772144,3578772144,0
2,1647,62194,3578772144,3578772144,0
2,1647,62195,3578772144,3578772144,0
2,1647,62196,3578772144,3578772144,0
2,1647,62197,3578772144,3578772144,0
2,1647,62198,3578772144,3578772144,0
2,1647,62199,3578772144,3578772144,0
2,1647,62200,3578772144,3578772144,0
2,1647,62201,3578772144,3578772144,0
2,1647,62202,3578772144,3578772144,0
2,1647,62203,3578772144,3578772144,0
2,1647,62204,3578772144,3578772144,0
2,1647,62205,3578772144,3578772145,1
2,1647,62206,3578772144,3578772146,2
2,1647,62207,3578772144,3578772147,3
2,1647,62208,3578772144,3578772150,6
2,1647,62209,3578772144,3578772151,7
2,1647,62210,3578772144,3578772151,7
2,1647,62211,3578772144,3578772151,7
2,1647,62212,3578772144,3578772152,8
2,1647,62213,3578772144,3578772153,9
2,1647,62214,3578772144,3578772154,10
2,1647,62215,3578772144,3578772156,12
2,1647,62216,3578772144,3578772156,12
2,1647,62217,3578772144,3578772157,13
2,1647,62218,3578772144,3578772158,14
2,1647,62219,3578772144,3578772158,14
2,1647,62220,3578772144,3578772163,19
2,1647,62221,3578772144,3578772163,19
2,1647,62222,3578772144,3578772164,20
2,1647,62223,3578772144,3578772164,20
2,1647,62224,3578772144,3578772166,22
2,1647,62225,3578772144,3578772170,26
2,1647,62226,3578772144,3578772170,26
2,1647,62227,3578772144,3578772173,29
2,1647,62228,3578772144,3578772174,30
2,1647,62229,3578772144,3578772174,30
2,1647,62230,3578772144,3578772176,32
2,1647,62231,3578772144,3578772179,35
2,1647,62232,3578772144,3578772179,35
2,1647,62233,3578772144,3578772180,36
2,1647,62234,3578772144,3578772183,39
2,1647,62235,3578772144,3578772183,39
2,1647,62236,3578772144,3578772184,40
2,1647,62237,3578772144,3578772184,40
2,1647,62238,3578772144,3578772185,41
2,1647,62239,3578772144,3578772185,41
2,1647,62240,3578772144,3578772185,41
2,1647,62241,3578772144,3578772186,42
2,1647,62242,3578772144,3578772187,43
2,1647,62243,3578772144,3578772187,43
2,1647,62244,3578772144,3578772187,43
2,1647,62245,3578772144,3578772188,44
2,1647,62246,3578772144,3578772188,44
2,1647,62247,3578772144,3578772189,45
2,1647,62248,3578772144,3578772191,47
2,1647,62249,3578772144,3578772191,47
2,1647,62250,3578772144,3578772191,47
2,1647,62251,3578772144,3578772194,50
2,1648,62252,3578772208,3578772208,0
2,1648,62253,3578772208,3578772208,0
2,1648,62254,3578772208,3578772208,0
2,1648,62255,3578772208,3578772208,0
2,1648,62256,3578772208,3578772208,0
2,1648,62257,3578772208,3578772208,0
2,1648,62258,3578772208,3578772208,0
2,1648,62259,3578772208,3578772208,0
2,1648,62260,3578772208,3578772208,0
2,1648,62261,3578772208,3578772208,0
2,1648,62262,3578772208,3578772208,0
2,1648,62263,3578772208,3578772208,0
2,1648,62264,3578772208,3578772208,0
2,1648,62265,3578772208,3578772208,0
2,1648,62266,3578772208,3578772209,1
2,1648,62267,3578772208,3578772211,3
2,1648,62268,3578772208,3578772213,5
2,1648,62269,3578772208,3578772213,5
2,1648,62270,3578772208,3578772213,5
2,1648,62271,3578772208,3578772214,6
2,1648,62272,3578772208,3578772215,7
2,1648,62273,3578772208,3578772215,7
2,1648,62274,3578772208,3578772217,9
2,1648,62275,3578772208,3578772219,11
2,1648,62276,3578772208,3578772220,12
2,1648,62277,3578772208,3578772221,13
2,1648,62278,3578772208,3578772221,13
2,1648,62279,3578772208,3578772224,16
2,1648,62280,3578772208,3578772224,16
2,1648,62281,3578772208,3578772225,17
2,1648,62282,3578772208,3578772226,18
2,1648,62283,3578772208,3578772226,18
2,1648,62284,3578772208,3578772228,20
2,1648,62285,3578772208,3578772231,23
2,1648,62286,3578772208,3578772231,23
2,1648,62287,3578772208,3578772232,24
2,1648,62288,3578772208,3578772232,24
2,1648,62289,3578772208,3578772232,24
2,1648,62290,3578772208,3578772233,25
2,1648,62291,3578772208,3578772234,26
2,1648,62292,3578772208,3578772235,27
2,1648,62293,3578772208,3578772237,29
2,1648,62294,3578772208,3578772238,30
2,1648,62295,3578772208,3578772239,31
2,1648,62296,3578772208,3578772239,31
2,1648,62297,3578772208,3578772240,32
2,1648,62298,3578772208,3578772240,32
2,1648,62299,3578772208,3578772241,33
2,1648,62300,3578772208,3578772241,33
2,1648,62301,3578772208,3578772242,34
2,1648,62302,3578772208,3578772242,34
2,1648,62303,3578772208,3578772243,35
2,1648,62304,3578772208,3578772245,37
2,1648,62305,3578772208,3578772246,38
2,1648,62306,3578772208,3578772247,39
2,1648,62307,3578772208,3578772247,39
2,1648,62308,3578772208,3578772247,39
2,1648,62309,3578772208,3578772249,41
2,1648,62310,3578772208,3578772250,42
2,1648,62311,3578772208,3578772251,43
2,1648,62312,3578772208,3578772251,43
2,1648,62313,3578772208,3578772253,45
2,1648,62314,3578772208,3578772254,46
2,1648,62315,3578772208,3578772254,46
2,1648,62316,3578772208,3578772258,50
2,1649,62317,3578772274,3578772274,0
2,1649,62318,3578772274,3578772274,0
2,1649,62319,3578772274,3578772274,0
2,1649,62320,3578772274,3578772274,0
2,1649,62321,3578772274,3578772274,0
2,1649,62322,3578772274,3578772274,0
2,1649,62323,3578772274,3578772274,0
2,1649,62324,3578772274,3578772286,12
2,1649,62325,3578772274,3578772287,13
2,1649,62326,3578772274,3578772288,14
2,1649,62327,3578772274,3578772289,15
2,1649,62328,3578772274,3578772292,18
2,1649,62329,3578772274,3578772292,18
2,1649,62330,3578772274,3578772293,19
2,1649,62331,3578772274,3578772294,20
2,1649,62332,3578772274,3578772294,20
2,1649,62333,3578772274,3578772294,20
2,1649,62334,3578772274,3578772294,20
2,1649,62335,3578772274,3578772295,21
2,1649,62336,3578772274,3578772296,22
2,1649,62337,3578772274,3578772296,22
2,1649,62338,3578772274,3578772296,22
2,1649,62339,3578772274,3578772297,23
2,1649,62340,3578772274,3578772298,24
2,1649,62341,3578772274,3578772298,24
2,1649,62342,3578772274,3578772300,26
2,1649,62343,3578772274,3578772300,26
2,1649,62344,3578772274,3578772300,26
2,1649,62345,3578772274,3578772301,27
2,1649,62346,3578772274,3578772301,27
2,1649,62347,3578772274,3578772301,27
2,1649,62348,3578772274,3578772302,28
2,1649,62349,3578772274,3578772302,28
2,1649,62350,3578772274,3578772303,29
2,1649,62351,3578772274,3578772304,30
2,1649,62352,3578772274,3578772306,32
2,1649,62353,3578772274,3578772307,33
2,1649,62354,3578772274,3578772307,33
2,1649,62355,3578772274,3578772307,33
2,1649,62356,3578772274,3578772311,37
2,1649,62357,3578772274,3578772311,37
2,1649,62358,3578772274,3578772312,38
2,1649,62359,3578772274,3578772312,38
2,1649,62360,3578772274,3578772313,39
2,1649,62361,3578772274,3578772313,39
2,1649,62362,3578772274,3578772314,40
2,1649,62363,3578772274,3578772315,41
2,1649,62364,3578772274,3578772316,42
2,1649,62365,3578772274,3578772317,43
2,1649,62366,3578772274,3578772318,44
2,1649,62367,3578772274,3578772319,45
2,1649,62368,3578772274,3578772320,46
2,1649,62369,3578772274,3578772322,48
2,1649,62370,3578772274,3578772322,48
2,1649,62371,3578772274,3578772322,48
2,1649,62372,3578772274,3578772323,49
2,1650,62373,3578772340,3578772340,0
2,1650,62374,3578772340,3578772340,0
2,1650,62375,3578772340,3578772340,0
2,1650,62376,3578772340,3578772340,0
2,1650,62377,3578772340,3578772340,0
2,1650,62378,3578772340,3578772340,0
2,1650,62379,3578772340,3578772340,0
2,1650,62380,3578772340,3578772340,0
2,1650,62381,3578772340,3578772340,0
2,1650,62382,3578772340,3578772340,0
2,1650,62383,3578772340,3578772340,0
2,1650,62384,3578772340,3578772340,0
2,1650,62385,3578772340,3578772340,0
2,1650,62386,3578772340,3578772340,0
2,1650,62387,3578772340,3578772340,0
2,1650,62388,3578772340,3578772340,0
2,1650,62389,3578772340,3578772340,0
2,1650,62390,3578772340,3578772340,0
2,1650,62391,3578772340,3578772340,0
2,1650,62392,3578772340,3578772340,0
2,1650,62393,3578772340,3578772340,0
2,1650,62394,3578772340,3578772341,1
2,1650,62395,3578772340,3578772341,1
2,1650,62396,3578772340,3578772344,4
2,1650,62397,3578772340,3578772344,4
2,1650,62398,3578772340,3578772346,6
2,1650,62399,3578772340,3578772347,7
2,1650,62400,3578772340,3578772350,10
2,1650,62401,3578772340,3578772350,10
2,1650,62402,3578772340,3578772351,11
2,1650,62403,3578772340,3578772351,11
2,1650,62404,3578772340,3578772352,12
2,1650,62405,3578772340,3578772353,13
2,1650,62406,3578772340,3578772354,14
2,1650,62407,3578772340,3578772356,16
2,1650,62408,3578772340,3578772356,16
2,1650,62409,3578772340,3578772357,17
2,1650,62410,3578772340,3578772357,17
2,1650,62411,3578772340,3578772358,18
2,1650,62412,3578772340,3578772363,23
2,1650,62413,3578772340,3578772364,24
2,1650,62414,3578772340,3578772364,24
2,1650,62415,3578772340,3578772366,26
2,1650,62416,3578772340,3578772366,26
2,1650,62417,3578772340,3578772366,26
2,1650,62418,3578772340,3578772368,28
2,1650,62419,3578772340,3578772371,31
2,1650,62420,3578772340,3578772374,34
2,1650,62421,3578772340,3578772374,34
2,1650,62422,3578772340,3578772374,34
2,1650,62423,3578772340,3578772376,36
2,1650,62424,3578772340,3578772379,39
2,1650,62425,3578772340,3578772380,40
2,1650,62426,3578772340,3578772383,43
2,1650,62427,3578772340,3578772383,43
2,1650,62428,3578772340,3578772384,44
2,1650,62429,3578772340,3578772384,44
2,1650,62430,3578772340,3578772385,45
2,1650,62431,3578772340,3578772385,45
2,1650,62432,3578772340,3578772386,46
2,1650,62433,3578772340,3578772387,47
2,1650,62434,3578772340,3578772387,47
2,1650,62435,3578772340,3578772387,47
2,1650,62436,3578772340,3578772388,48
2,1650,62437,3578772340,3578772389,49
2,1650,62438,3578772340,3578772389,49
2,1651,62439,3578772405,3578772405,0
2,1651,62440,3578772405,3578772405,0
2,1651,62441,3578772405,3578772405,0
2,1651,62442,3578772405,3578772405,0
2,1651,62443,3578772405,3578772405,0
2,1651,62444,3578772405,3578772405,0
2,1651,62445,3578772405,3578772405,0
2,1651,62446,3578772405,3578772405,0
2,1651,62447,3578772405,3578772405,0
2,1651,62448,3578772405,3578772405,0
2,1651,62449,3578772405,3578772405,0
2,1651,62450,3578772405,3578772405,0
2,1651,62451,3578772405,3578772405,0
2,1651,62452,3578772405,3578772405,0
2,1651,62453,3578772405,3578772405,0
2,1651,62454,3578772405,3578772406,1
2,1651,62455,3578772405,3578772406,1
2,1651,62456,3578772405,3578772408,3
2,1651,62457,3578772405,3578772409,4
2,1651,62458,3578772405,3578772410,5
2,1651,62459,3578772405,3578772412,7
2,1651,62460,3578772405,3578772413,8
2,1651,62461,3578772405,3578772414,9
2,1651,62462,3578772405,3578772414,9
2,1651,62463,3578772405,3578772416,11
2,1651,62464,3578772405,3578772418,13
2,1651,62465,3578772405,3578772420,15
2,1651,62466,3578772405,3578772421,16
2,1651,62467,3578772405,3578772421,16
2,1651,62468,3578772405,3578772422,17
2,1651,62469,3578772405,3578772424,19
2,1651,62470,3578772405,3578772424,19
2,1651,62471,3578772405,3578772425,20
2,1651,62472,3578772405,3578772425,20
2,1651,62473,3578772405,3578772426,21
2,1651,62474,3578772405,3578772428,23
2,1651,62475,3578772405,3578772430,25
2,1651,62476,3578772405,3578772432,27
2,1651,62477,3578772405,3578772432,27
2,1651,62478,3578772405,3578772433,28
2,1651,62479,3578772405,3578772433,28
2,1651,62480,3578772405,3578772434,29
2,1651,62481,3578772405,3578772434,29
2,1651,62482,3578772405,3578772435,30
2,1651,62483,3578772405,3578772437,32
2,1651,62484,3578772405,3578772437,32
2,1651,62485,3578772405,3578772438,33
2,1651,62486,3578772405,3578772439,34
2,1651,62487,3578772405,3578772439,34
2,1651,62488,3578772405,3578772439,34
2,1651,62489,3578772405,3578772440,35
2,1651,62490,3578772405,3578772441,36
2,1651,62491,3578772405,3578772441,36
2,1651,62492,3578772405,3578772441,36
2,1651,62493,3578772405,3578772442,37
2,1651,62494,3578772405,3578772442,37
2,1651,62495,3578772405,3578772443,38
2,1651,62496,3578772405,3578772444,39
2,1651,62497,3578772405,3578772446,41
2,1651,62498,3578772405,3578772447,42
2,1651,62499,3578772405,3578772447,42
2,1651,62500,3578772405,3578772448,43
2,1651,62501,3578772405,3578772448,43
2,1651,62502,3578772405,3578772450,45
2,1651,62503,3578772405,3578772450,45
2,1651,62504,3578772405,3578772452,47
2,1651,62505,3578772405,3578772453,48
2,1651,62506,3578772405,3578772454,49
2,1652,62507,3578772471,3578772471,0
2,1652,62508,3578772471,3578772471,0
2,1652,62509,3578772471,3578772471,0
2,1652,62510,3578772471,3578772471,0
2,1652,62511,3578772471,3578772471,0
2,1652,62512,3578772471,3578772471,0
2,1652,62513,3578772471,3578772471,0
2,1652,62514,3578772471,3578772471,0
2,1652,62515,3578772471,3578772471,0
2,1652,62516,3578772471,3578772488,17
2,1652,62517,3578772471,3578772489,18
2,1652,62518,3578772471,3578772489,18
2,1652,62519,3578772471,3578772489,18
2,1652,62520,3578772471,3578772492,21
2,1652,62521,3578772471,3578772493,22
2,1652,62522,3578772471,3578772493,22
2,1652,62523,3578772471,3578772494,23
2,1652,62524,3578772471,3578772494,23
2,1652,62525,3578772471,3578772495,24
2,1652,62526,3578772471,3578772495,24
2,1652,62527,3578772471,3578772495,24
2,1652,62528,3578772471,3578772495,24
2,1652,62529,3578772471,3578772495,24
2,1652,62530,3578772471,3578772495,24
2,1652,62531,3578772471,3578772496,25
2,1652,62532,3578772471,3578772498,27
2,1652,62533,3578772471,3578772498,27
2,1652,62534,3578772471,3578772499,28
2,1652,62535,3578772471,3578772499,28
2,1652,62536,3578772471,3578772500,29
2,1652,62537,3578772471,3578772500,29
2,1652,62538,3578772471,3578772501,30
2,1652,62539,3578772471,3578772501,30
2,1652,62540,3578772471,3578772501,30
2,1652,62541,3578772471,3578772502,31
2,1652,62542,3578772471,3578772503,32
2,1652,62543,3578772471,3578772504,33
2,1652,62544,3578772471,3578772504,33
2,1652,62545,3578772471,3578772506,35
2,1652,62546,3578772471,3578772507,36
2,1652,62547,3578772471,3578772507,36
2,1652,62548,3578772471,3578772508,37
2,1652,62549,3578772471,3578772511,40
2,1652,62550,3578772471,3578772511,40
2,1652,62551,3578772471,3578772512,41
2,1652,62552,3578772471,3578772513,42
2,1652,62553,3578772471,3578772513,42
2,1652,62554,3578772471,3578772513,42
2,1652,62555,3578772471,3578772513,42
2,1652,62556,3578772471,3578772514,43
2,1652,62557,3578772471,3578772515,44
2,1652,62558,3578772471,3578772517,46
2,1652,62559,3578772471,3578772517,46
2,1652,62560,3578772471,3578772519,48
2,1652,62561,3578772471,3578772519,48
2,1652,62562,3578772471,3578772520,49
2,1653,62563,3578772538,3578772538,0
2,1653,62564,3578772538,3578772538,0
2,1653,62565,3578772538,3578772538,0
2,1653,62566,3578772538,3578772538,0
2,1653,62567,3578772538,3578772538,0
2,1653,62568,3578772538,3578772538,0
2,1653,62569,3578772538,3578772538,0
2,1653,62570,3578772538,3578772538,0
2,1653,62571,3578772538,3578772538,0
2,1653,62572,3578772538,3578772538,0
2,1653,62573,3578772538,3578772538,0
2,1653,62574,3578772538,3578772538,0
2,1653,62575,3578772538,3578772538,0
2,1653,62576,3578772538,3578772538,0
2,1653,62577,3578772538,3578772538,0
2,1653,62578,3578772538,3578772538,0
2,1653,62579,3578772538,3578772538,0
2,1653,62580,3578772538,3578772538,0
2,1653,62581,3578772538,3578772538,0
2,1653,62582,3578772538,3578772538,0
2,1653,62583,3578772538,3578772538,0
2,1653,62584,3578772538,3578772538,0
2,1653,62585,3578772538,3578772538,0
2,1653,62586,3578772538,3578772539,1
2,1653,62587,3578772538,3578772539,1
2,1653,62588,3578772538,3578772540,2
2,1653,62589,3578772538,3578772540,2
2,1653,62590,3578772538,3578772544,6
2,1653,62591,3578772538,3578772544,6
2,1653,62592,3578772538,3578772545,7
2,1653,62593,3578772538,3578772546,8
2,1653,62594,3578772538,3578772549,11
2,1653,62595,3578772538,3578772549,11
2,1653,62596,3578772538,3578772550,12
2,1653,62597,3578772538,3578772550,12
2,1653,62598,3578772538,3578772551,13
2,1653,62599,3578772538,3578772552,14
2,1653,62600,3578772538,3578772552,14
2,1653,62601,3578772538,3578772553,15
2,1653,62602,3578772538,3578772554,16
2,1653,62603,3578772538,3578772555,17
2,1653,62604,3578772538,3578772557,19
2,1653,62605,3578772538,3578772557,19
2,1653,62606,3578772538,3578772558,20
2,1653,62607,3578772538,3578772561,23
2,1653,62608,3578772538,3578772562,24
2,1653,62609,3578772538,3578772563,25
2,1653,62610,3578772538,3578772565,27
2,1653,62611,3578772538,3578772565,27
2,1653,62612,3578772538,3578772565,27
2,1653,62613,3578772538,3578772569,31
2,1653,62614,3578772538,3578772569,31
2,1653,62615,3578772538,3578772570,32
2,1653,62616,3578772538,3578772573,35
2,1653,62617,3578772538,3578772574,36
2,1653,62618,3578772538,3578772575,37
2,1653,62619,3578772538,3578772578,40
2,1653,62620,3578772538,3578772578,40
2,1653,62621,3578772538,3578772582,44
2,1653,62622,3578772538,3578772582,44
2,1653,62623,3578772538,3578772583,45
2,1653,62624,3578772538,3578772583,45
2,1653,62625,3578772538,3578772584,46
2,1653,62626,3578772538,3578772584,46
2,1653,62627,3578772538,3578772585,47
2,1653,62628,3578772538,3578772586,48
2,1653,62629,3578772538,3578772587,49
2,1653,62630,3578772538,3578772587,49
2,1653,62631,3578772538,3578772587,49
2,1653,62632,3578772538,3578772588,50
2,1654,62633,3578772605,3578772605,0
2,1654,62634,3578772605,3578772605,0
2,1654,62635,3578772605,3578772605,0
2,1654,62636,3578772605,3578772605,0
2,1654,62637,3578772605,3578772605,0
2,1654,62638,3578772605,3578772605,0
2,1654,62639,3578772605,3578772605,0
2,1654,62640,3578772605,3578772605,0
2,1654,62641,3578772605,3578772605,0
2,1654,62642,3578772605,3578772605,0
2,1654,62643,3578772605,3578772605,0
2,1654,62644,3578772605,3578772605,0
2,1654,62645,3578772605,3578772605,0
2,1654,62646,3578772605,3578772605,0
2,1654,62647,3578772605,3578772605,0
2,1654,62648,3578772605,3578772605,0
2,1654,62649,3578772605,3578772605,0
2,1654,62650,3578772605,3578772605,0
2,1654,62651,3578772605,3578772605,0
2,1654,62652,3578772605,3578772606,1
2,1654,62653,3578772605,3578772607,2
2,1654,62654,3578772605,3578772609,4
2,1654,62655,3578772605,3578772612,7
2,1654,62656,3578772605,3578772612,7
2,1654,62657,3578772605,3578772613,8
2,1654,62658,3578772605,3578772613,8
2,1654,62659,3578772605,3578772616,11
2,1654,62660,3578772605,3578772617,12
2,1654,62661,3578772605,3578772619,14
2,1654,62662,3578772605,3578772620,15
2,1654,62663,3578772605,3578772620,15
2,1654,62664,3578772605,3578772622,17
2,1654,62665,3578772605,3578772623,18
2,1654,62666,3578772605,3578772624,19
2,1654,62667,3578772605,3578772624,19
2,1654,62668,3578772605,3578772625,20
2,1654,62669,3578772605,3578772626,21
2,1654,62670,3578772605,3578772627,22
2,1654,62671,3578772605,3578772628,23
2,1654,62672,3578772605,3578772629,24
2,1654,62673,3578772605,3578772629,24
2,1654,62674,3578772605,3578772631,26
2,1654,62675,3578772605,3578772632,27
2,1654,62676,3578772605,3578772632,27
2,1654,62677,3578772605,3578772633,28
2,1654,62678,3578772605,3578772635,30
2,1654,62679,3578772605,3578772637,32
2,1654,62680,3578772605,3578772637,32
2,1654,62681,3578772605,3578772637,32
2,1654,62682,3578772605,3578772638,33
2,1654,62683,3578772605,3578772639,34
2,1654,62684,3578772605,3578772640,35
2,1654,62685,3578772605,3578772641,36
2,1654,62686,3578772605,3578772641,36
2,1654,62687,3578772605,3578772641,36
2,1654,62688,3578772605,3578772641,36
2,1654,62689,3578772605,3578772641,36
2,1654,62690,3578772605,3578772643,38
2,1654,62691,3578772605,3578772643,38
2,1654,62692,3578772605,3578772644,39
2,1654,62693,3578772605,3578772645,40
2,1654,62694,3578772605,3578772646,41
2,1654,62695,3578772605,3578772646,41
2,1654,62696,3578772605,3578772647,42
2,1654,62697,3578772605,3578772647,42
2,1654,62698,3578772605,3578772650,45
2,1654,62699,3578772605,3578772650,45
2,1654,62700,3578772605,3578772650,45
2,1654,62701,3578772605,3578772652,47
2,1654,62702,3578772605,3578772653,48
2,1654,62703,3578772605,3578772654,49
2,1654,62704,3578772605,3578772655,50
2,1655,62705,3578772672,3578772672,0
2,1655,62706,3578772672,3578772672,0
2,1655,62707,3578772672,3578772672,0
2,1655,62708,3578772672,3578772672,0
2,1655,62709,3578772672,3578772672,0
2,1655,62710,3578772672,3578772672,0
2,1655,62711,3578772672,3578772672,0
2,1655,62712,3578772672,3578772672,0
2,1655,62713,3578772672,3578772672,0
2,1655,62714,3578772672,3578772688,16
2,1655,62715,3578772672,3578772688,16
2,1655,62716,3578772672,3578772689,17
2,1655,62717,3578772672,3578772689,17
2,1655,62718,3578772672,3578772693,21
2,1655,62719,3578772672,3578772693,21
2,1655,62720,3578772672,3578772693,21
2,1655,62721,3578772672,3578772694,22
2,1655,62722,3578772672,3578772694,22
2,1655,62723,3578772672,3578772694,22
2,1655,62724,3578772672,3578772695,23
2,1655,62725,3578772672,3578772695,23
2,1655,62726,3578772672,3578772695,23
2,1655,62727,3578772672,3578772696,24
2,1655,62728,3578772672,3578772696,24
2,1655,62729,3578772672,3578772696,24
2,1655,62730,3578772672,3578772698,26
2,1655,62731,3578772672,3578772698,26
2,1655,62732,3578772672,3578772698,26
2,1655,62733,3578772672,3578772698,26
2,1655,62734,3578772672,3578772700,28
2,1655,62735,3578772672,3578772700,28
2,1655,62736,3578772672,3578772701,29
2,1655,62737,3578772672,3578772701,29
2,1655,62738,3578772672,3578772701,29
2,1655,62739,3578772672,3578772702,30
2,1655,62740,3578772672,3578772704,32
2,1655,62741,3578772672,3578772705,33
2,1655,62742,3578772672,3578772705,33
2,1655,62743,3578772672,3578772707,35
2,1655,62744,3578772672,3578772707,35
2,1655,62745,3578772672,3578772708,36
2,1655,62746,3578772672,3578772710,38
2,1655,62747,3578772672,3578772711,39
2,1655,62748,3578772672,3578772712,40
2,1655,62749,3578772672,3578772713,41
2,1655,62750,3578772672,3578772713,41
2,1655,62751,3578772672,3578772714,42
2,1655,62752,3578772672,3578772714,42
2,1655,62753,3578772672,3578772714,42
2,1655,62754,3578772672,3578772716,44
2,1655,62755,3578772672,3578772717,45
2,1655,62756,3578772672,3578772718,46
2,1655,62757,3578772672,3578772720,48
2,1655,62758,3578772672,3578772721,49
2,1656,62759,3578772738,3578772738,0
2,1656,62760,3578772738,3578772738,0
2,1656,62761,3578772738,3578772738,0
2,1656,62762,3578772738,3578772738,0
2,1656,62763,3578772738,3578772738,0
2,1656,62764,3578772738,3578772738,0
2,1656,62765,3578772738,3578772738,0
2,1656,62766,3578772738,3578772738,0
2,1656,62767,3578772738,3578772738,0
2,1656,62768,3578772738,3578772738,0
2,1656,62769,3578772738,3578772738,0
2,1656,62770,3578772738,3578772738,0
2,1656,62771,3578772738,3578772738,0
2,1656,62772,3578772738,3578772738,0
2,1656,62773,3578772738,3578772738,0
2,1656,62774,3578772738,3578772738,0
2,1656,62775,3578772738,3578772738,0
2,1656,62776,3578772738,3578772738,0
2,1656,62777,3578772738,3578772738,0
2,1656,62778,3578772738,3578772738,0
2,1656,62779,3578772738,3578772739,1
2,1656,62780,3578772738,3578772739,1
2,1656,62781,3578772738,3578772739,1
2,1656,62782,3578772738,3578772739,1
2,1656,62783,3578772738,3578772740,2
2,1656,62784,3578772738,3578772742,4
2,1656,62785,3578772738,3578772743,5
2,1656,62786,3578772738,3578772744,6
2,1656,62787,3578772738,3578772745,7
2,1656,62788,3578772738,3578772746,8
2,1656,62789,3578772738,3578772749,11
2,1656,62790,3578772738,3578772749,11
2,1656,62791,3578772738,3578772750,12
2,1656,62792,3578772738,3578772750,12
2,1656,62793,3578772738,3578772751,13
2,1656,62794,3578772738,3578772752,14
2,1656,62795,3578772738,3578772753,15
2,1656,62796,3578772738,3578772753,15
2,1656,62797,3578772738,3578772753,15
2,1656,62798,3578772738,3578772755,17
2,1656,62799,3578772738,3578772757,19
2,1656,62800,3578772738,3578772757,19
2,1656,62801,3578772738,3578772757,19
2,1656,62802,3578772738,3578772761,23
2,1656,62803,3578772738,3578772762,24
2,1656,62804,3578772738,3578772763,25
2,1656,62805,3578772738,3578772764,26
2,1656,62806,3578772738,3578772765,27
2,1656,62807,3578772738,3578772765,27
2,1656,62808,3578772738,3578772769,31
2,1656,62809,3578772738,3578772769,31
2,1656,62810,3578772738,3578772769,31
2,1656,62811,3578772738,3578772771,33
2,1656,62812,3578772738,3578772771,33
2,1656,62813,3578772738,3578772773,35
2,1656,62814,3578772738,3578772774,36
2,1656,62815,3578772738,3578772774,36
2,1656,62816,3578772738,3578772775,37
2,1656,62817,3578772738,3578772778,40
2,1656,62818,3578772738,3578772779,41
2,1656,62819,3578772738,3578772782,44
2,1656,62820,3578772738,3578772783,45
2,1656,62821,3578772738,3578772783,45
2,1656,62822,3578772738,3578772783,45
2,1656,62823,3578772738,3578772785,47
2,1656,62824,3578772738,3578772786,48
2,1656,62825,3578772738,3578772786,48
2,1656,62826,3578772738,3578772787,49
2,1656,62827,3578772738,3578772787,49
2,1656,62828,3578772738,3578772787,49
2,1656,62829,3578772738,3578772787,49
2,1656,62830,3578772738,3578772788,50
2,1657,62831,3578772803,3578772803,0
2,1657,62832,3578772803,3578772803,0
2,1657,62833,3578772803,3578772803,0
2,1657,62834,3578772803,3578772803,0
2,1657,62835,3578772803,3578772803,0
2,1657,62836,3578772803,3578772803,0
2,1657,62837,3578772803,3578772803,0
2,1657,62838,3578772803,3578772803,0
2,1657,62839,3578772803,3578772803,0
2,1657,62840,3578772803,3578772803,0
2,1657,62841,3578772803,3578772803,0
2,1657,62842,3578772803,3578772803,0
2,1657,62843,3578772803,3578772803,0
2,1657,62844,3578772803,3578772803,0
2,1657,62845,3578772803,3578772803,0
2,1657,62846,3578772803,3578772804,1
2,1657,62847,3578772803,3578772804,1
2,1657,62848,3578772803,3578772806,3
2,1657,62849,3578772803,3578772807,4
2,1657,62850,3578772803,3578772808,5
2,1657,62851,3578772803,3578772809,6
2,1657,62852,3578772803,3578772812,9
2,1657,62853,3578772803,3578772812,9
2,1657,62854,3578772803,3578772813,10
2,1657,62855,3578772803,3578772813,10
2,1657,62856,3578772803,3578772816,13
2,1657,62857,3578772803,3578772817,14
2,1657,62858,3578772803,3578772820,17
2,1657,62859,3578772803,3578772820,17
2,1657,62860,3578772803,3578772821,18
2,1657,62861,3578772803,3578772823,20
2,1657,62862,3578772803,3578772823,20
2,1657,62863,3578772803,3578772823,20
2,1657,62864,3578772803,3578772826,23
2,1657,62865,3578772803,3578772826,23
2,1657,62866,3578772803,3578772827,24
2,1657,62867,3578772803,3578772827,24
2,1657,62868,3578772803,3578772829,26
2,1657,62869,3578772803,3578772829,26
2,1657,62870,3578772803,3578772831,28
2,1657,62871,3578772803,3578772831,28
2,1657,62872,3578772803,3578772832,29
2,1657,62873,3578772803,3578772832,29
2,1657,62874,3578772803,3578772833,30
2,1657,62875,3578772803,3578772835,32
2,1657,62876,3578772803,3578772836,33
2,1657,62877,3578772803,3578772837,34
2,1657,62878,3578772803,3578772837,34
2,1657,62879,3578772803,3578772838,35
2,1657,62880,3578772803,3578772839,36
2,1657,62881,3578772803,3578772840,37
2,1657,62882,3578772803,3578772840,37
2,1657,62883,3578772803,3578772840,37
2,1657,62884,3578772803,3578772841,38
2,1657,62885,3578772803,3578772841,38
2,1657,62886,3578772803,3578772841,38
2,1657,62887,3578772803,3578772842,39
2,1657,62888,3578772803,3578772843,40
2,1657,62889,3578772803,3578772843,40
2,1657,62890,3578772803,3578772844,41
2,1657,62891,3578772803,3578772845,42
2,1657,62892,3578772803,3578772847,44
2,1657,62893,3578772803,3578772847,44
2,1657,62894,3578772803,3578772847,44
2,1657,62895,3578772803,3578772850,47
2,1657,62896,3578772803,3578772850,47
2,1657,62897,3578772803,3578772850,47
2,1657,62898,3578772803,3578772852,49
2,1657,62899,3578772803,3578772853,50
2,1658,62900,3578772869,3578772869,0
2,1658,62901,3578772869,3578772869,0
2,1658,62902,3578772869,3578772869,0
2,1658,62903,3578772869,3578772869,0
2,1658,62904,3578772869,3578772869,0
2,1658,62905,3578772869,3578772869,0
2,1658,62906,3578772869,3578772869,0
2,1658,62907,3578772869,3578772869,0
2,1658,62908,3578772869,3578772869,0
2,1658,62909,3578772869,3578772869,0
2,1658,62910,3578772869,3578772869,0
2,1658,62911,3578772869,3578772887,18
2,1658,62912,3578772869,3578772888,19
2,1658,62913,3578772869,3578772888,19
2,1658,62914,3578772869,3578772889,20
2,1658,62915,3578772869,3578772889,20
2,1658,62916,3578772869,3578772890,21
2,1658,62917,3578772869,3578772892,23
2,1658,62918,3578772869,3578772892,23
2,1658,62919,3578772869,3578772893,24
2,1658,62920,3578772869,3578772893,24
2,1658,62921,3578772869,3578772894,25
2,1658,62922,3578772869,3578772895,26
2,1658,62923,3578772869,3578772895,26
2,1658,62924,3578772869,3578772895,26
2,1658,62925,3578772869,3578772895,26
2,1658,62926,3578772869,3578772895,26
2,1658,62927,3578772869,3578772895,26
2,1658,62928,3578772869,3578772895,26
2,1658,62929,3578772869,3578772896,27
2,1658,62930,3578772869,3578772897,28
2,1658,62931,3578772869,3578772898,29
2,1658,62932,3578772869,3578772898,29
2,1658,62933,3578772869,3578772899,30
2,1658,62934,3578772869,3578772900,31
2,1658,62935,3578772869,3578772900,31
2,1658,62936,3578772869,3578772900,31
2,1658,62937,3578772869,3578772902,33
2,1658,62938,3578772869,3578772902,33
2,1658,62939,3578772869,3578772903,34
2,1658,62940,3578772869,3578772903,34
2,1658,62941,3578772869,3578772904,35
2,1658,62942,3578772869,3578772905,36
2,1658,62943,3578772869,3578772905,36
2,1658,62944,3578772869,3578772908,39
2,1658,62945,3578772869,3578772908,39
2,1658,62946,3578772869,3578772908,39
2,1658,62947,3578772869,3578772911,42
2,1658,62948,3578772869,3578772911,42
2,1658,62949,3578772869,3578772913,44
2,1658,62950,3578772869,3578772913,44
2,1658,62951,3578772869,3578772913,44
2,1658,62952,3578772869,3578772913,44
2,1658,62953,3578772869,3578772914,45
2,1658,62954,3578772869,3578772914,45
2,1658,62955,3578772869,3578772915,46
2,1658,62956,3578772869,3578772917,48
2,1658,62957,3578772869,3578772917,48
2,1658,62958,3578772869,3578772918,49
2,1659,62959,3578772936,3578772936,0
2,1659,62960,3578772936,3578772936,0
2,1659,62961,3578772936,3578772936,0
2,1659,62962,3578772936,3578772936,0
2,1659,62963,3578772936,3578772936,0
2,1659,62964,3578772936,3578772936,0
2,1659,62965,3578772936,3578772936,0
2,1659,62966,3578772936,3578772936,0
2,1659,62967,3578772936,3578772936,0
2,1659,62968,3578772936,3578772936,0
2,1659,62969,3578772936,3578772936,0
2,1659,62970,3578772936,3578772936,0
2,1659,62971,3578772936,3578772936,0
2,1659,62972,3578772936,3578772936,0
2,1659,62973,3578772936,3578772936,0
2,1659,62974,3578772936,3578772936,0
2,1659,62975,3578772936,3578772936,0
2,1659,62976,3578772936,3578772936,0
2,1659,62977,3578772936,3578772936,0
2,1659,62978,3578772936,3578772936,0
2,1659,62979,3578772936,3578772937,1
2,1659,62980,3578772936,3578772938,2
2,1659,62981,3578772936,3578772939,3
2,1659,62982,3578772936,3578772939,3
2,1659,62983,3578772936,3578772939,3
2,1659,62984,3578772936,3578772939,3
2,1659,62985,3578772936,3578772940,4
2,1659,62986,3578772936,3578772940,4
2,1659,62987,3578772936,3578772941,5
2,1659,62988,3578772936,3578772942,6
2,1659,62989,3578772936,3578772944,8
2,1659,62990,3578772936,3578772944,8
2,1659,62991,3578772936,3578772945,9
2,1659,62992,3578772936,3578772946,10
2,1659,62993,3578772936,3578772949,13
2,1659,62994,3578772936,3578772950,14
2,1659,62995,3578772936,3578772950,14
2,1659,62996,3578772936,3578772951,15
2,1659,62997,3578772936,3578772953,17
2,1659,62998,3578772936,3578772953,17
2,1659,62999,3578772936,3578772953,17
2,1659,63000,3578772936,3578772954,18
2,1659,63001,3578772936,3578772955,19
2,1659,63002,3578772936,3578772957,21
2,1659,63003,3578772936,3578772957,21
2,1659,63004,3578772936,3578772958,22
2,1659,63005,3578772936,3578772961,25
2,1659,63006,3578772936,3578772964,28
2,1659,63007,3578772936,3578772965,29
2,1659,63008,3578772936,3578772966,30
2,1659,63009,3578772936,3578772966,30
2,1659,63010,3578772936,3578772969,33
2,1659,63011,3578772936,3578772969,33
2,1659,63012,3578772936,3578772971,35
2,1659,63013,3578772936,3578772971,35
2,1659,63014,3578772936,3578772972,36
2,1659,63015,3578772936,3578772973,37
2,1659,63016,3578772936,3578772974,38
2,1659,63017,3578772936,3578772974,38
2,1659,63018,3578772936,3578772976,40
2,1659,63019,3578772936,3578772979,43
2,1659,63020,3578772936,3578772980,44
2,1659,63021,3578772936,3578772982,46
2,1659,63022,3578772936,3578772983,47
2,1659,63023,3578772936,3578772985,49
2,1659,63024,3578772936,3578772985,49
2,1659,63025,3578772936,3578772986,50
2,1660,63026,3578773002,3578773002,0
2,1660,63027,3578773002,3578773002,0
2,1660,63028,3578773002,3578773002,0
2,1660,63029,3578773002,3578773002,0
2,1660,63030,3578773002,3578773002,0
2,1660,63031,3578773002,3578773002,0
2,1660,63032,3578773002,3578773002,0
2,1660,63033,3578773002,3578773002,0
2,1660,63034,3578773002,3578773002,0
2,1660,63035,3578773002,3578773002,0
2,1660,63036,3578773002,3578773002,0
2,1660,63037,3578773002,3578773002,0
2,1660,63038,3578773002,3578773002,0
2,1660,63039,3578773002,3578773002,0
2,1660,63040,3578773002,3578773003,1
2,1660,63041,3578773002,3578773003,1
2,1660,63042,3578773002,3578773003,1
2,1660,63043,3578773002,3578773004,2
2,1660,63044,3578773002,3578773004,2
2,1660,63045,3578773002,3578773006,4
2,1660,63046,3578773002,3578773008,6
2,1660,63047,3578773002,3578773009,7
2,1660,63048,3578773002,3578773009,7
2,1660,63049,3578773002,3578773011,9
2,1660,63050,3578773002,3578773011,9
2,1660,63051,3578773002,3578773013,11
2,1660,63052,3578773002,3578773013,11
2,1660,63053,3578773002,3578773014,12
2,1660,63054,3578773002,3578773016,14
2,1660,63055,3578773002,3578773016,14
2,1660,63056,3578773002,3578773017,15
2,1660,63057,3578773002,3578773019,17
2,1660,63058,3578773002,3578773020,18
2,1660,63059,3578773002,3578773021,19
2,1660,63060,3578773002,3578773021,19
2,1660,63061,3578773002,3578773024,22
2,1660,63062,3578773002,3578773024,22
2,1660,63063,3578773002,3578773025,23
2,1660,63064,3578773002,3578773026,24
2,1660,63065,3578773002,3578773026,24
2,1660,63066,3578773002,3578773027,25
2,1660,63067,3578773002,3578773027,25
2,1660,63068,3578773002,3578773031,29
2,1660,63069,3578773002,3578773032,30
2,1660,63070,3578773002,3578773032,30
2,1660,63071,3578773002,3578773033,31
2,1660,63072,3578773002,3578773035,33
2,1660,63073,3578773002,3578773036,34
2,1660,63074,3578773002,3578773036,34
2,1660,63075,3578773002,3578773037,35
2,1660,63076,3578773002,3578773039,37
2,1660,63077,3578773002,3578773039,37
2,1660,63078,3578773002,3578773039,37
2,1660,63079,3578773002,3578773040,38
2,1660,63080,3578773002,3578773041,39
2,1660,63081,3578773002,3578773041,39
2,1660,63082,3578773002,3578773041,39
2,1660,63083,3578773002,3578773042,40
2,1660,63084,3578773002,3578773043,41
2,1660,63085,3578773002,3578773043,41
2,1660,63086,3578773002,3578773044,42
2,1660,63087,3578773002,3578773045,43
2,1660,63088,3578773002,3578773046,44
2,1660,63089,3578773002,3578773047,45
2,1660,63090,3578773002,3578773047,45
2,1660,63091,3578773002,3578773050,48
2,1660,63092,3578773002,3578773050,48
2,1660,63093,3578773002,3578773050,48
2,1660,63094,3578773002,3578773052,50
2,1661,63095,3578773069,3578773069,0
2,1661,63096,3578773069,3578773069,0
2,1661,63097,3578773069,3578773069,0
2,1661,63098,3578773069,3578773069,0
2,1661,63099,3578773069,3578773069,0
2,1661,63100,3578773069,3578773069,0
2,1661,63101,3578773069,3578773069,0
2,1661,63102,3578773069,3578773069,0
2,1661,63103,3578773069,3578773069,0
2,1661,63104,3578773069,3578773069,0
2,1661,63105,3578773069,3578773069,0
2,1661,63106,3578773069,3578773069,0
2,1661,63107,3578773069,3578773085,16
2,1661,63108,3578773069,3578773088,19
2,1661,63109,3578773069,3578773088,19
2,1661,63110,3578773069,3578773088,19
2,1661,63111,3578773069,3578773089,20
2,1661,63112,3578773069,3578773089,20
2,1661,63113,3578773069,3578773090,21
2,1661,63114,3578773069,3578773092,23
2,1661,63115,3578773069,3578773093,24
2,1661,63116,3578773069,3578773093,24
2,1661,63117,3578773069,3578773093,24
2,1661,63118,3578773069,3578773094,25
2,1661,63119,3578773069,3578773094,25
2,1661,63120,3578773069,3578773095,26
2,1661,63121,3578773069,3578773095,26
2,1661,63122,3578773069,3578773095,26
2,1661,63123,3578773069,3578773095,26
2,1661,63124,3578773069,3578773095,26
2,1661,63125,3578773069,3578773096,27
2,1661,63126,3578773069,3578773096,27
2,1661,63127,3578773069,3578773098,29
2,1661,63128,3578773069,3578773098,29
2,1661,63129,3578773069,3578773099,30
2,1661,63130,3578773069,3578773099,30
2,1661,63131,3578773069,3578773100,31
2,1661,63132,3578773069,3578773100,31
2,1661,63133,3578773069,3578773100,31
2,1661,63134,3578773069,3578773101,32
2,1661,63135,3578773069,3578773102,33
2,1661,63136,3578773069,3578773102,33
2,1661,63137,3578773069,3578773103,34
2,1661,63138,3578773069,3578773103,34
2,1661,63139,3578773069,3578773104,35
2,1661,63140,3578773069,3578773105,36
2,1661,63141,3578773069,3578773106,37
2,1661,63142,3578773069,3578773107,38
2,1661,63143,3578773069,3578773108,39
2,1661,63144,3578773069,3578773109,40
2,1661,63145,3578773069,3578773111,42
2,1661,63146,3578773069,3578773113,44
2,1661,63147,3578773069,3578773113,44
2,1661,63148,3578773069,3578773113,44
2,1661,63149,3578773069,3578773114,45
2,1661,63150,3578773069,3578773114,45
2,1661,63151,3578773069,3578773114,45
2,1661,63152,3578773069,3578773115,46
2,1661,63153,3578773069,3578773118,49
2,1661,63154,3578773069,3578773118,49
2,1661,63155,3578773069,3578773118,49
2,1661,63156,3578773069,3578773120,51
2,1662,63157,3578773135,3578773135,0
2,1662,63158,3578773135,3578773135,0
2,1662,63159,3578773135,3578773135,0
2,1662,63160,3578773135,3578773135,0
2,1662,63161,3578773135,3578773135,0
2,1662,63162,3578773135,3578773135,0
2,1662,63163,3578773135,3578773135,0
2,1662,63164,3578773135,3578773135,0
2,1662,63165,3578773135,3578773135,0
2,1662,63166,3578773135,3578773135,0
2,1662,63167,3578773135,3578773135,0
2,1662,63168,3578773135,3578773135,0
2,1662,63169,3578773135,3578773135,0
2,1662,63170,3578773135,3578773135,0
2,1662,63171,3578773135,3578773135,0
2,1662,63172,3578773135,3578773135,0
2,1662,63173,3578773135,3578773137,2
2,1662,63174,3578773135,3578773138,3
2,1662,63175,3578773135,3578773139,4
2,1662,63176,3578773135,3578773139,4
2,1662,63177,3578773135,3578773139,4
2,1662,63178,3578773135,3578773139,4
2,1662,63179,3578773135,3578773139,4
2,1662,63180,3578773135,3578773140,5
2,1662,63181,3578773135,3578773140,5
2,1662,63182,3578773135,3578773143,8
2,1662,63183,3578773135,3578773143,8
2,1662,63184,3578773135,3578773144,9
2,1662,63185,3578773135,3578773145,10
2,1662,63186,3578773135,3578773147,12
2,1662,63187,3578773135,3578773150,15
2,1662,63188,3578773135,3578773150,15
2,1662,63189,3578773135,3578773151,16
2,1662,63190,3578773135,3578773152,17
2,1662,63191,3578773135,3578773153,18
2,1662,63192,3578773135,3578773153,18
2,1662,63193,3578773135,3578773154,19
2,1662,63194,3578773135,3578773154,19
2,1662,63195,3578773135,3578773157,22
2,1662,63196,3578773135,3578773158,23
2,1662,63197,3578773135,3578773158,23
2,1662,63198,3578773135,3578773162,27
2,1662,63199,3578773135,3578773164,29
2,1662,63200,3578773135,3578773165,30
2,1662,63201,3578773135,3578773166,31
2,1662,63202,3578773135,3578773166,31
2,1662,63203,3578773135,3578773169,34
2,1662,63204,3578773135,3578773171,36
2,1662,63205,3578773135,3578773171,36
2,1662,63206,3578773135,3578773173,38
2,1662,63207,3578773135,3578773174,39
2,1662,63208,3578773135,3578773174,39
2,1662,63209,3578773135,3578773174,39
2,1662,63210,3578773135,3578773176,41
2,1662,63211,3578773135,3578773180,45
2,1662,63212,3578773135,3578773180,45
2,1662,63213,3578773135,3578773183,48
2,1662,63214,3578773135,3578773183,48
2,1662,63215,3578773135,3578773185,50
2,1663,63216,3578773200,3578773200,0
2,1663,63217,3578773200,3578773200,0
2,1663,63218,3578773200,3578773200,0
2,1663,63219,3578773200,3578773200,0
2,1663,63220,3578773200,3578773200,0
2,1663,63221,3578773200,3578773200,0
2,1663,63222,3578773200,3578773200,0
2,1663,63223,3578773200,3578773200,0
2,1663,63224,3578773200,3578773200,0
2,1663,63225,3578773200,3578773200,0
2,1663,63226,3578773200,3578773200,0
2,1663,63227,3578773200,3578773200,0
2,1663,63228,3578773200,3578773200,0
2,1663,63229,3578773200,3578773200,0
2,1663,63230,3578773200,3578773200,0
2,1663,63231,3578773200,3578773200,0
2,1663,63232,3578773200,3578773201,1
2,1663,63233,3578773200,3578773202,2
2,1663,63234,3578773200,3578773203,3
2,1663,63235,3578773200,3578773204,4
2,1663,63236,3578773200,3578773204,4
2,1663,63237,3578773200,3578773204,4
2,1663,63238,3578773200,3578773205,5
2,1663,63239,3578773200,3578773206,6
2,1663,63240,3578773200,3578773208,8
2,1663,63241,3578773200,3578773209,9
2,1663,63242,3578773200,3578773209,9
2,1663,63243,3578773200,3578773211,11
2,1663,63244,3578773200,3578773213,13
2,1663,63245,3578773200,3578773214,14
2,1663,63246,3578773200,3578773214,14
2,1663,63247,3578773200,3578773216,16
2,1663,63248,3578773200,3578773216,16
2,1663,63249,3578773200,3578773217,17
2,1663,63250,3578773200,3578773220,20
2,1663,63251,3578773200,3578773220,20
2,1663,63252,3578773200,3578773221,21
2,1663,63253,3578773200,3578773222,22
2,1663,63254,3578773200,3578773224,24
2,1663,63255,3578773200,3578773225,25
2,1663,63256,3578773200,3578773225,25
2,1663,63257,3578773200,3578773225,25
2,1663,63258,3578773200,3578773226,26
2,1663,63259,3578773200,3578773227,27
2,1663,63260,3578773200,3578773228,28
2,1663,63261,3578773200,3578773229,29
2,1663,63262,3578773200,3578773232,32
2,1663,63263,3578773200,3578773232,32
2,1663,63264,3578773200,3578773233,33
2,1663,63265,3578773200,3578773234,34
2,1663,63266,3578773200,3578773236,36
2,1663,63267,3578773200,3578773237,37
2,1663,63268,3578773200,3578773237,37
2,1663,63269,3578773200,3578773239,39
2,1663,63270,3578773200,3578773239,39
2,1663,63271,3578773200,3578773240,40
2,1663,63272,3578773200,3578773240,40
2,1663,63273,3578773200,3578773242,42
2,1663,63274,3578773200,3578773242,42
2,1663,63275,3578773200,3578773243,43
2,1663,63276,3578773200,3578773243,43
2,1663,63277,3578773200,3578773243,43
2,1663,63278,3578773200,3578773244,44
2,1663,63279,3578773200,3578773246,46
2,1663,63280,3578773200,3578773246,46
2,1663,63281,3578773200,3578773247,47
2,1663,63282,3578773200,3578773248,48
2,1664,63283,3578773266,3578773266,0
2,1664,63284,3578773266,3578773266,0
2,1664,63285,3578773266,3578773266,0
2,1664,63286,3578773266,3578773266,0
2,1664,63287,3578773266,3578773266,0
2,1664,63288,3578773266,3578773267,1
2,1664,63289,3578773266,3578773267,1
2,1664,63290,3578773266,3578773267,1
2,1664,63291,3578773266,3578773267,1
2,1664,63292,3578773266,3578773267,1
2,1664,63293,3578773266,3578773267,1
2,1664,63294,3578773266,3578773267,1
2,1664,63295,3578773266,3578773267,1
2,1664,63296,3578773266,3578773268,2
2,1664,63297,3578773266,3578773287,21
2,1664,63298,3578773266,3578773288,22
2,1664,63299,3578773266,3578773288,22
2,1664,63300,3578773266,3578773289,23
2,1664,63301,3578773266,3578773290,24
2,1664,63302,3578773266,3578773290,24
2,1664,63303,3578773266,3578773293,27
2,1664,63304,3578773266,3578773293,27
2,1664,63305,3578773266,3578773293,27
2,1664,63306,3578773266,3578773294,28
2,1664,63307,3578773266,3578773294,28
2,1664,63308,3578773266,3578773295,29
2,1664,63309,3578773266,3578773295,29
2,1664,63310,3578773266,3578773295,29
2,1664,63311,3578773266,3578773295,29
2,1664,63312,3578773266,3578773295,29
2,1664,63313,3578773266,3578773295,29
2,1664,63314,3578773266,3578773296,30
2,1664,63315,3578773266,3578773297,31
2,1664,63316,3578773266,3578773298,32
2,1664,63317,3578773266,3578773299,33
2,1664,63318,3578773266,3578773300,34
2,1664,63319,3578773266,3578773300,34
2,1664,63320,3578773266,3578773300,34
2,1664,63321,3578773266,3578773301,35
2,1664,63322,3578773266,3578773301,35
2,1664,63323,3578773266,3578773303,37
2,1664,63324,3578773266,3578773303,37
2,1664,63325,3578773266,3578773303,37
2,1664,63326,3578773266,3578773304,38
2,1664,63327,3578773266,3578773304,38
2,1664,63328,3578773266,3578773304,38
2,1664,63329,3578773266,3578773306,40
2,1664,63330,3578773266,3578773307,41
2,1664,63331,3578773266,3578773309,43
2,1664,63332,3578773266,3578773311,45
2,1664,63333,3578773266,3578773311,45
2,1664,63334,3578773266,3578773312,46
2,1664,63335,3578773266,3578773313,47
2,1664,63336,3578773266,3578773314,48
2,1664,63337,3578773266,3578773314,48
2,1664,63338,3578773266,3578773314,48
2,1664,63339,3578773266,3578773315,49
2,1664,63340,3578773266,3578773315,49
2,1665,63341,3578773334,3578773334,0
2,1665,63342,3578773334,3578773334,0
2,1665,63343,3578773334,3578773334,0
2,1665,63344,3578773334,3578773334,0
2,1665,63345,3578773334,3578773334,0
2,1665,63346,3578773334,3578773334,0
2,1665,63347,3578773334,3578773334,0
2,1665,63348,3578773334,3578773334,0
2,1665,63349,3578773334,3578773334,0
2,1665,63350,3578773334,3578773334,0
2,1665,63351,3578773334,3578773334,0
2,1665,63352,3578773334,3578773334,0
2,1665,63353,3578773334,3578773334,0
2,1665,63354,3578773334,3578773334,0
2,1665,63355,3578773334,3578773334,0
2,1665,63356,3578773334,3578773334,0
2,1665,63357,3578773334,3578773334,0
2,1665,63358,3578773334,3578773334,0
2,1665,63359,3578773334,3578773334,0
2,1665,63360,3578773334,3578773334,0
2,1665,63361,3578773334,3578773337,3
2,1665,63362,3578773334,3578773337,3
2,1665,63363,3578773334,3578773338,4
2,1665,63364,3578773334,3578773339,5
2,1665,63365,3578773334,3578773339,5
2,1665,63366,3578773334,3578773339,5
2,1665,63367,3578773334,3578773339,5
2,1665,63368,3578773334,3578773339,5
2,1665,63369,3578773334,3578773339,5
2,1665,63370,3578773334,3578773341,7
2,1665,63371,3578773334,3578773341,7
2,1665,63372,3578773334,3578773342,8
2,1665,63373,3578773334,3578773344,10
2,1665,63374,3578773334,3578773345,11
2,1665,63375,3578773334,3578773345,11
2,1665,63376,3578773334,3578773347,13
2,1665,63377,3578773334,3578773350,16
2,1665,63378,3578773334,3578773350,16
2,1665,63379,3578773334,3578773351,17
2,1665,63380,3578773334,3578773353,19
2,1665,63381,3578773334,3578773354,20
2,1665,63382,3578773334,3578773357,23
2,1665,63383,3578773334,3578773358,24
2,1665,63384,3578773334,3578773358,24
2,1665,63385,3578773334,3578773362,28
2,1665,63386,3578773334,3578773364,30
2,1665,63387,3578773334,3578773365,31
2,1665,63388,3578773334,3578773365,31
2,1665,63389,3578773334,3578773366,32
2,1665,63390,3578773334,3578773366,32
2,1665,63391,3578773334,3578773369,35
2,1665,63392,3578773334,3578773370,36
2,1665,63393,3578773334,3578773371,37
2,1665,63394,3578773334,3578773374,40
2,1665,63395,3578773334,3578773374,40
2,1665,63396,3578773334,3578773374,40
2,1665,63397,3578773334,3578773376,42
2,1665,63398,3578773334,3578773379,45
2,1665,63399,3578773334,3578773379,45
2,1665,63400,3578773334,3578773380,46
2,1665,63401,3578773334,3578773383,49
2,1665,63402,3578773334,3578773383,49
2,1666,63403,3578773400,3578773400,0
2,1666,63404,3578773400,3578773400,0
2,1666,63405,3578773400,3578773400,0
2,1666,63406,3578773400,3578773400,0
2,1666,63407,3578773400,3578773400,0
2,1666,63408,3578773400,3578773400,0
2,1666,63409,3578773400,3578773400,0
2,1666,63410,3578773400,3578773400,0
2,1666,63411,3578773400,3578773400,0
2,1666,63412,3578773400,3578773400,0
2,1666,63413,3578773400,3578773400,0
2,1666,63414,3578773400,3578773400,0
2,1666,63415,3578773400,3578773400,0
2,1666,63416,3578773400,3578773400,0
2,1666,63417,3578773400,3578773400,0
2,1666,63418,3578773400,3578773400,0
2,1666,63419,3578773400,3578773400,0
2,1666,63420,3578773400,3578773400,0
2,1666,63421,3578773400,3578773402,2
2,1666,63422,3578773400,3578773403,3
2,1666,63423,3578773400,3578773403,3
2,1666,63424,3578773400,3578773404,4
2,1666,63425,3578773400,3578773404,4
2,1666,63426,3578773400,3578773405,5
2,1666,63427,3578773400,3578773405,5
2,1666,63428,3578773400,3578773406,6
2,1666,63429,3578773400,3578773409,9
2,1666,63430,3578773400,3578773411,11
2,1666,63431,3578773400,3578773413,13
2,1666,63432,3578773400,3578773414,14
2,1666,63433,3578773400,3578773415,15
2,1666,63434,3578773400,3578773416,16
2,1666,63435,3578773400,3578773416,16
2,1666,63436,3578773400,3578773420,20
2,1666,63437,3578773400,3578773421,21
2,1666,63438,3578773400,3578773422,22
2,1666,63439,3578773400,3578773424,24
2,1666,63440,3578773400,3578773425,25
2,1666,63441,3578773400,3578773425,25
2,1666,63442,3578773400,3578773426,26
2,1666,63443,3578773400,3578773427,27
2,1666,63444,3578773400,3578773428,28
2,1666,63445,3578773400,3578773428,28
2,1666,63446,3578773400,3578773429,29
2,1666,63447,3578773400,3578773431,31
2,1666,63448,3578773400,3578773432,32
2,1666,63449,3578773400,3578773433,33
2,1666,63450,3578773400,3578773433,33
2,1666,63451,3578773400,3578773436,36
2,1666,63452,3578773400,3578773437,37
2,1666,63453,3578773400,3578773437,37
2,1666,63454,3578773400,3578773438,38
2,1666,63455,3578773400,3578773439,39
2,1666,63456,3578773400,3578773439,39
2,1666,63457,3578773400,3578773439,39
2,1666,63458,3578773400,3578773440,40
2,1666,63459,3578773400,3578773441,41
2,1666,63460,3578773400,3578773441,41
2,1666,63461,3578773400,3578773442,42
2,1666,63462,3578773400,3578773442,42
2,1666,63463,3578773400,3578773443,43
2,1666,63464,3578773400,3578773443,43
2,1666,63465,3578773400,3578773444,44
2,1666,63466,3578773400,3578773446,46
2,1666,63467,3578773400,3578773447,47
2,1666,63468,3578773400,3578773447,47
2,1666,63469,3578773400,3578773448,48
2,1666,63470,3578773400,3578773450,50
2,1667,63471,3578773466,3578773466,0
2,1667,63472,3578773466,3578773466,0
2,1667,63473,3578773466,3578773466,0
2,1667,63474,3578773466,3578773466,0
2,1667,63475,3578773466,3578773466,0
2,1667,63476,3578773466,3578773466,0
2,1667,63477,3578773466,3578773466,0
2,1667,63478,3578773466,3578773466,0
2,1667,63479,3578773466,3578773466,0
2,1667,63480,3578773466,3578773467,1
2,1667,63481,3578773466,3578773467,1
2,1667,63482,3578773466,3578773468,2
2,1667,63483,3578773466,3578773487,21
2,1667,63484,3578773466,3578773488,22
2,1667,63485,3578773466,3578773488,22
2,1667,63486,3578773466,3578773489,23
2,1667,63487,3578773466,3578773490,24
2,1667,63488,3578773466,3578773490,24
2,1667,63489,3578773466,3578773493,27
2,1667,63490,3578773466,3578773493,27
2,1667,63491,3578773466,3578773493,27
2,1667,63492,3578773466,3578773494,28
2,1667,63493,3578773466,3578773494,28
2,1667,63494,3578773466,3578773494,28
2,1667,63495,3578773466,3578773495,29
2,1667,63496,3578773466,3578773495,29
2,1667,63497,3578773466,3578773495,29
2,1667,63498,3578773466,3578773495,29
2,1667,63499,3578773466,3578773495,29
2,1667,63500,3578773466,3578773498,32
2,1667,63501,3578773466,3578773498,32
2,1667,63502,3578773466,3578773499,33
2,1667,63503,3578773466,3578773500,34
2,1667,63504,3578773466,3578773500,34
2,1667,63505,3578773466,3578773500,34
2,1667,63506,3578773466,3578773500,34
2,1667,63507,3578773466,3578773501,35
2,1667,63508,3578773466,3578773501,35
2,1667,63509,3578773466,3578773502,36
2,1667,63510,3578773466,3578773502,36
2,1667,63511,3578773466,3578773503,37
2,1667,63512,3578773466,3578773503,37
2,1667,63513,3578773466,3578773504,38
2,1667,63514,3578773466,3578773505,39
2,1667,63515,3578773466,3578773507,41
2,1667,63516,3578773466,3578773508,42
2,1667,63517,3578773466,3578773511,45
2,1667,63518,3578773466,3578773511,45
2,1667,63519,3578773466,3578773512,46
2,1667,63520,3578773466,3578773513,47
2,1667,63521,3578773466,3578773513,47
2,1667,63522,3578773466,3578773513,47
2,1667,63523,3578773466,3578773514,48
2,1667,63524,3578773466,3578773514,48
2,1667,63525,3578773466,3578773514,48
2,1667,63526,3578773466,3578773515,49
2,1668,63527,3578773531,3578773531,0
2,1668,63528,3578773531,3578773531,0
2,1668,63529,3578773531,3578773531,0
2,1668,63530,3578773531,3578773531,0
2,1668,63531,3578773531,3578773531,0
2,1668,63532,3578773531,3578773531,0
2,1668,63533,3578773531,3578773531,0
2,1668,63534,3578773531,3578773531,0
2,1668,63535,3578773531,3578773531,0
2,1668,63536,3578773531,3578773531,0
2,1668,63537,3578773531,3578773531,0
2,1668,63538,3578773531,3578773531,0
2,1668,63539,3578773531,3578773531,0
2,1668,63540,3578773531,3578773531,0
2,1668,63541,3578773531,3578773531,0
2,1668,63542,3578773531,3578773531,0
2,1668,63543,3578773531,3578773531,0
2,1668,63544,3578773531,3578773532,1
2,1668,63545,3578773531,3578773532,1
2,1668,63546,3578773531,3578773532,1
2,1668,63547,3578773531,3578773536,5
2,1668,63548,3578773531,3578773537,6
2,1668,63549,3578773531,3578773537,6
2,1668,63550,3578773531,3578773537,6
2,1668,63551,3578773531,3578773538,7
2,1668,63552,3578773531,3578773538,7
2,1668,63553,3578773531,3578773538,7
2,1668,63554,3578773531,3578773539,8
2,1668,63555,3578773531,3578773539,8
2,1668,63556,3578773531,3578773540,9
2,1668,63557,3578773531,3578773541,10
2,1668,63558,3578773531,3578773541,10
2,1668,63559,3578773531,3578773543,12
2,1668,63560,3578773531,3578773544,13
2,1668,63561,3578773531,3578773544,13
2,1668,63562,3578773531,3578773545,14
2,1668,63563,3578773531,3578773549,18
2,1668,63564,3578773531,3578773549,18
2,1668,63565,3578773531,3578773549,18
2,1668,63566,3578773531,3578773550,19
2,1668,63567,3578773531,3578773550,19
2,1668,63568,3578773531,3578773552,21
2,1668,63569,3578773531,3578773553,22
2,1668,63570,3578773531,3578773557,26
2,1668,63571,3578773531,3578773557,26
2,1668,63572,3578773531,3578773558,27
2,1668,63573,3578773531,3578773561,30
2,1668,63574,3578773531,3578773563,32
2,1668,63575,3578773531,3578773563,32
2,1668,63576,3578773531,3578773565,34
2,1668,63577,3578773531,3578773565,34
2,1668,63578,3578773531,3578773565,34
2,1668,63579,3578773531,3578773565,34
2,1668,63580,3578773531,3578773568,37
2,1668,63581,3578773531,3578773569,38
2,1668,63582,3578773531,3578773571,40
2,1668,63583,3578773531,3578773573,42
2,1668,63584,3578773531,3578773573,42
2,1668,63585,3578773531,3578773574,43
2,1668,63586,3578773531,3578773575,44
2,1668,63587,3578773531,3578773575,44
2,1668,63588,3578773531,3578773577,46
2,1668,63589,3578773531,3578773579,48
2,1669,63590,3578773598,3578773598,0
2,1669,63591,3578773598,3578773598,0
2,1669,63592,3578773598,3578773598,0
2,1669,63593,3578773598,3578773598,0
2,1669,63594,3578773598,3578773598,0
2,1669,63595,3578773598,3578773598,0
2,1669,63596,3578773598,3578773598,0
2,1669,63597,3578773598,3578773598,0
2,1669,63598,3578773598,3578773598,0
2,1669,63599,3578773598,3578773598,0
2,1669,63600,3578773598,3578773598,0
2,1669,63601,3578773598,3578773598,0
2,1669,63602,3578773598,3578773598,0
2,1669,63603,3578773598,3578773598,0
2,1669,63604,3578773598,3578773598,0
2,1669,63605,3578773598,3578773598,0
2,1669,63606,3578773598,3578773598,0
2,1669,63607,3578773598,3578773598,0
2,1669,63608,3578773598,3578773598,0
2,1669,63609,3578773598,3578773598,0
2,1669,63610,3578773598,3578773598,0
2,1669,63611,3578773598,3578773602,4
2,1669,63612,3578773598,3578773602,4
2,1669,63613,3578773598,3578773602,4
2,1669,63614,3578773598,3578773603,5
2,1669,63615,3578773598,3578773604,6
2,1669,63616,3578773598,3578773604,6
2,1669,63617,3578773598,3578773605,7
2,1669,63618,3578773598,3578773606,8
2,1669,63619,3578773598,3578773608,10
2,1669,63620,3578773598,3578773608,10
2,1669,63621,3578773598,3578773609,11
2,1669,63622,3578773598,3578773610,12
2,1669,63623,3578773598,3578773612,14
2,1669,63624,3578773598,3578773612,14
2,1669,63625,3578773598,3578773613,15
2,1669,63626,3578773598,3578773615,17
2,1669,63627,3578773598,3578773616,18
2,1669,63628,3578773598,3578773619,21
2,1669,63629,3578773598,3578773620,22
2,1669,63630,3578773598,3578773621,23
2,1669,63631,3578773598,3578773623,25
2,1669,63632,3578773598,3578773623,25
2,1669,63633,3578773598,3578773623,25
2,1669,63634,3578773598,3578773625,27
2,1669,63635,3578773598,3578773625,27
2,1669,63636,3578773598,3578773627,29
2,1669,63637,3578773598,3578773628,30
2,1669,63638,3578773598,3578773628,30
2,1669,63639,3578773598,3578773630,32
2,1669,63640,3578773598,3578773631,33
2,1669,63641,3578773598,3578773631,33
2,1669,63642,3578773598,3578773633,35
2,1669,63643,3578773598,3578773635,37
2,1669,63644,3578773598,3578773636,38
2,1669,63645,3578773598,3578773636,38
2,1669,63646,3578773598,3578773636,38
2,1669,63647,3578773598,3578773638,40
2,1669,63648,3578773598,3578773639,41
2,1669,63649,3578773598,3578773639,41
2,1669,63650,3578773598,3578773639,41
2,1669,63651,3578773598,3578773639,41
2,1669,63652,3578773598,3578773640,42
2,1669,63653,3578773598,3578773641,43
2,1669,63654,3578773598,3578773642,44
2,1669,63655,3578773598,3578773642,44
2,1669,63656,3578773598,3578773643,45
2,1669,63657,3578773598,3578773643,45
2,1669,63658,3578773598,3578773645,47
2,1669,63659,3578773598,3578773646,48
2,1669,63660,3578773598,3578773646,48
2,1669,63661,3578773598,3578773647,49
2,1670,63662,3578773665,3578773665,0
2,1670,63663,3578773665,3578773665,0
2,1670,63664,3578773665,3578773665,0
2,1670,63665,3578773665,3578773665,0
2,1670,63666,3578773665,3578773665,0
2,1670,63667,3578773665,3578773665,0
2,1670,63668,3578773665,3578773665,0
2,1670,63669,3578773665,3578773665,0
2,1670,63670,3578773665,3578773665,0
2,1670,63671,3578773665,3578773665,0
2,1670,63672,3578773665,3578773665,0
2,1670,63673,3578773665,3578773665,0
2,1670,63674,3578773665,3578773665,0
2,1670,63675,3578773665,3578773665,0
2,1670,63676,3578773665,3578773667,2
2,1670,63677,3578773665,3578773668,3
2,1670,63678,3578773665,3578773686,21
2,1670,63679,3578773665,3578773687,22
2,1670,63680,3578773665,3578773688,23
2,1670,63681,3578773665,3578773688,23
2,1670,63682,3578773665,3578773689,24
2,1670,63683,3578773665,3578773690,25
2,1670,63684,3578773665,3578773690,25
2,1670,63685,3578773665,3578773693,28
2,1670,63686,3578773665,3578773694,29
2,1670,63687,3578773665,3578773695,30
2,1670,63688,3578773665,3578773695,30
2,1670,63689,3578773665,3578773695,30
2,1670,63690,3578773665,3578773695,30
2,1670,63691,3578773665,3578773695,30
2,1670,63692,3578773665,3578773696,31
2,1670,63693,3578773665,3578773696,31
2,1670,63694,3578773665,3578773696,31
2,1670,63695,3578773665,3578773696,31
2,1670,63696,3578773665,3578773697,32
2,1670,63697,3578773665,3578773698,33
2,1670,63698,3578773665,3578773698,33
2,1670,63699,3578773665,3578773699,34
2,1670,63700,3578773665,3578773699,34
2,1670,63701,3578773665,3578773700,35
2,1670,63702,3578773665,3578773700,35
2,1670,63703,3578773665,3578773701,36
2,1670,63704,3578773665,3578773701,36
2,1670,63705,3578773665,3578773702,37
2,1670,63706,3578773665,3578773703,38
2,1670,63707,3578773665,3578773704,39
2,1670,63708,3578773665,3578773704,39
2,1670,63709,3578773665,3578773706,41
2,1670,63710,3578773665,3578773707,42
2,1670,63711,3578773665,3578773707,42
2,1670,63712,3578773665,3578773709,44
2,1670,63713,3578773665,3578773711,46
2,1670,63714,3578773665,3578773711,46
2,1670,63715,3578773665,3578773713,48
2,1670,63716,3578773665,3578773713,48
2,1670,63717,3578773665,3578773713,48
2,1670,63718,3578773665,3578773714,49
2,1670,63719,3578773665,3578773714,49
2,1670,63720,3578773665,3578773715,50
2,1671,63721,3578773731,3578773731,0
2,1671,63722,3578773731,3578773731,0
2,1671,63723,3578773731,3578773731,0
2,1671,63724,3578773731,3578773731,0
2,1671,63725,3578773731,3578773731,0
2,1671,63726,3578773731,3578773731,0
2,1671,63727,3578773731,3578773731,0
2,1671,63728,3578773731,3578773731,0
2,1671,63729,3578773731,3578773731,0
2,1671,63730,3578773731,3578773731,0
2,1671,63731,3578773731,3578773731,0
2,1671,63732,3578773731,3578773731,0
2,1671,63733,3578773731,3578773731,0
2,1671,63734,3578773731,3578773731,0
2,1671,63735,3578773731,3578773731,0
2,1671,63736,3578773731,3578773732,1
2,1671,63737,3578773731,3578773733,2
2,1671,63738,3578773731,3578773733,2
2,1671,63739,3578773731,3578773736,5
2,1671,63740,3578773731,3578773737,6
2,1671,63741,3578773731,3578773737,6
2,1671,63742,3578773731,3578773737,6
2,1671,63743,3578773731,3578773738,7
2,1671,63744,3578773731,3578773738,7
2,1671,63745,3578773731,3578773738,7
2,1671,63746,3578773731,3578773738,7
2,1671,63747,3578773731,3578773738,7
2,1671,63748,3578773731,3578773738,7
2,1671,63749,3578773731,3578773740,9
2,1671,63750,3578773731,3578773742,11
2,1671,63751,3578773731,3578773742,11
2,1671,63752,3578773731,3578773743,12
2,1671,63753,3578773731,3578773744,13
2,1671,63754,3578773731,3578773745,14
2,1671,63755,3578773731,3578773747,16
2,1671,63756,3578773731,3578773748,17
2,1671,63757,3578773731,3578773749,18
2,1671,63758,3578773731,3578773749,18
2,1671,63759,3578773731,3578773750,19
2,1671,63760,3578773731,3578773751,20
2,1671,63761,3578773731,3578773752,21
2,1671,63762,3578773731,3578773753,22
2,1671,63763,3578773731,3578773755,24
2,1671,63764,3578773731,3578773757,26
2,1671,63765,3578773731,3578773757,26
2,1671,63766,3578773731,3578773757,26
2,1671,63767,3578773731,3578773762,31
2,1671,63768,3578773731,3578773762,31
2,1671,63769,3578773731,3578773762,31
2,1671,63770,3578773731,3578773764,33
2,1671,63771,3578773731,3578773765,34
2,1671,63772,3578773731,3578773766,35
2,1671,63773,3578773731,3578773766,35
2,1671,63774,3578773731,3578773768,37
2,1671,63775,3578773731,3578773769,38
2,1671,63776,3578773731,3578773770,39
2,1671,63777,3578773731,3578773771,40
2,1671,63778,3578773731,3578773773,42
2,1671,63779,3578773731,3578773774,43
2,1671,63780,3578773731,3578773774,43
2,1671,63781,3578773731,3578773775,44
2,1671,63782,3578773731,3578773775,44
2,1671,63783,3578773731,3578773778,47
2,1671,63784,3578773731,3578773779,48
2,1672,63785,3578773798,3578773798,0
2,1672,63786,3578773798,3578773798,0
2,1672,63787,3578773798,3578773798,0
2,1672,63788,3578773798,3578773798,0
2,1672,63789,3578773798,3578773798,0
2,1672,63790,3578773798,3578773798,0
2,1672,63791,3578773798,3578773798,0
2,1672,63792,3578773798,3578773798,0
2,1672,63793,3578773798,3578773798,0
2,1672,63794,3578773798,3578773798,0
2,1672,63795,3578773798,3578773798,0
2,1672,63796,3578773798,3578773798,0
2,1672,63797,3578773798,3578773798,0
2,1672,63798,3578773798,3578773798,0
2,1672,63799,3578773798,3578773798,0
2,1672,63800,3578773798,3578773798,0
2,1672,63801,3578773798,3578773798,0
2,1672,63802,3578773798,3578773798,0
2,1672,63803,3578773798,3578773798,0
2,1672,63804,3578773798,3578773798,0
2,1672,63805,3578773798,3578773798,0
2,1672,63806,3578773798,3578773798,0
2,1672,63807,3578773798,3578773798,0
2,1672,63808,3578773798,3578773798,0
2,1672,63809,3578773798,3578773802,4
2,1672,63810,3578773798,3578773802,4
2,1672,63811,3578773798,3578773803,5
2,1672,63812,3578773798,3578773804,6
2,1672,63813,3578773798,3578773804,6
2,1672,63814,3578773798,3578773805,7
2,1672,63815,3578773798,3578773806,8
2,1672,63816,3578773798,3578773808,10
2,1672,63817,3578773798,3578773808,10
2,1672,63818,3578773798,3578773809,11
2,1672,63819,3578773798,3578773811,13
2,1672,63820,3578773798,3578773811,13
2,1672,63821,3578773798,3578773812,14
2,1672,63822,3578773798,3578773812,14
2,1672,63823,3578773798,3578773813,15
2,1672,63824,3578773798,3578773815,17
2,1672,63825,3578773798,3578773819,21
2,1672,63826,3578773798,3578773820,22
2,1672,63827,3578773798,3578773821,23
2,1672,63828,3578773798,3578773823,25
2,1672,63829,3578773798,3578773823,25
2,1672,63830,3578773798,3578773824,26
2,1672,63831,3578773798,3578773826,28
2,1672,63832,3578773798,3578773826,28
2,1672,63833,3578773798,3578773827,29
2,1672,63834,3578773798,3578773828,30
2,1672,63835,3578773798,3578773829,31
2,1672,63836,3578773798,3578773831,33
2,1672,63837,3578773798,3578773831,33
2,1672,63838,3578773798,3578773832,34
2,1672,63839,3578773798,3578773833,35
2,1672,63840,3578773798,3578773835,37
2,1672,63841,3578773798,3578773836,38
2,1672,63842,3578773798,3578773836,38
2,1672,63843,3578773798,3578773836,38
2,1672,63844,3578773798,3578773838,40
2,1672,63845,3578773798,3578773838,40
2,1672,63846,3578773798,3578773838