t_id, iteration_count, request_count, request_start_time, request_end_time, request_processing_time
2,122,1,3575832123,3575832168,45
2,124,2,3575832224,3575832270,46
2,126,3,3575832325,3575832368,43
2,126,4,3575832325,3575832371,46
2,127,5,3575832375,3575832421,46
2,128,6,3575832425,3575832469,44
2,130,7,3575832527,3575832567,40
2,130,8,3575832527,3575832570,43
2,131,9,3575832577,3575832620,43
2,131,10,3575832577,3575832623,46
2,132,11,3575832628,3575832669,41
2,132,12,3575832628,3575832675,47
2,134,13,3575832729,3575832767,38
2,134,14,3575832729,3575832769,40
2,135,15,3575832780,3575832821,41
2,135,16,3575832780,3575832823,43
2,136,17,3575832830,3575832869,39
2,136,18,3575832830,3575832875,45
2,137,19,3575832881,3575832929,48
2,138,20,3575832931,3575832968,37
2,138,21,3575832931,3575832970,39
2,139,22,3575832981,3575833020,39
2,139,23,3575832981,3575833023,42
2,140,24,3575833032,3575833069,37
2,140,25,3575833032,3575833076,44
2,141,26,3575833082,3575833129,47
2,142,27,3575833133,3575833168,35
2,142,28,3575833133,3575833170,37
2,143,29,3575833184,3575833220,36
2,143,30,3575833184,3575833223,39
2,144,31,3575833235,3575833269,34
2,144,32,3575833235,3575833276,41
2,145,33,3575833285,3575833329,44
2,145,34,3575833285,3575833333,48
2,146,35,3575833336,3575833368,32
2,146,36,3575833336,3575833370,34
2,146,37,3575833336,3575833384,48
2,147,38,3575833386,3575833420,34
2,147,39,3575833386,3575833423,37
2,148,40,3575833437,3575833469,32
2,148,41,3575833437,3575833476,39
2,149,42,3575833487,3575833528,41
2,149,43,3575833487,3575833532,45
2,149,44,3575833487,3575833535,48
2,150,45,3575833538,3575833567,29
2,150,46,3575833538,3575833569,31
2,150,47,3575833538,3575833584,46
2,150,48,3575833538,3575833586,48
2,151,49,3575833588,3575833619,31
2,151,50,3575833588,3575833622,34
2,152,51,3575833639,3575833668,29
2,152,52,3575833639,3575833676,37
2,152,53,3575833639,3575833688,49
2,153,54,3575833689,3575833728,39
2,153,55,3575833689,3575833732,43
2,153,56,3575833689,3575833735,46
2,154,57,3575833740,3575833767,27
2,154,58,3575833740,3575833769,29
2,154,59,3575833740,3575833785,45
2,154,60,3575833740,3575833786,46
2,155,61,3575833791,3575833820,29
2,155,62,3575833791,3575833822,31
2,156,63,3575833842,3575833868,26
2,156,64,3575833842,3575833876,34
2,156,65,3575833842,3575833888,46
2,157,66,3575833893,3575833928,35
2,157,67,3575833893,3575833932,39
2,157,68,3575833893,3575833935,42
2,158,69,3575833943,3575833966,23
2,158,70,3575833943,3575833968,25
2,158,71,3575833943,3575833984,41
2,158,72,3575833943,3575833987,44
2,158,73,3575833943,3575833992,49
2,159,74,3575833994,3575834020,26
2,159,75,3575833994,3575834022,28
2,160,76,3575834044,3575834068,24
2,160,77,3575834044,3575834075,31
2,160,78,3575834044,3575834088,44
2,160,79,3575834044,3575834093,49
2,161,80,3575834095,3575834128,33
2,161,81,3575834095,3575834132,37
2,161,82,3575834095,3575834135,40
2,162,83,3575834145,3575834167,22
2,162,84,3575834145,3575834169,24
2,162,85,3575834145,3575834185,40
2,162,86,3575834145,3575834187,42
2,162,87,3575834145,3575834192,47
2,162,88,3575834145,3575834194,49
2,163,89,3575834196,3575834221,25
2,163,90,3575834196,3575834222,26
2,163,91,3575834196,3575834246,50
2,164,92,3575834246,3575834269,23
2,164,93,3575834246,3575834276,30
2,164,94,3575834246,3575834288,42
2,164,95,3575834246,3575834293,47
2,165,96,3575834297,3575834328,31
2,165,97,3575834297,3575834333,36
2,165,98,3575834297,3575834335,38
2,166,99,3575834347,3575834367,20
2,166,100,3575834347,3575834370,23
2,166,101,3575834347,3575834384,37
2,166,102,3575834347,3575834387,40
2,166,103,3575834347,3575834393,46
2,166,104,3575834347,3575834395,48
2,167,105,3575834398,3575834420,22
2,167,106,3575834398,3575834424,26
2,167,107,3575834398,3575834445,47
2,168,108,3575834449,3575834470,21
2,168,109,3575834449,3575834477,28
2,168,110,3575834449,3575834488,39
2,168,111,3575834449,3575834493,44
2,168,112,3575834449,3575834499,50
2,169,113,3575834500,3575834527,27
2,169,114,3575834500,3575834532,32
2,169,115,3575834500,3575834534,34
2,170,116,3575834551,3575834566,15
2,170,117,3575834551,3575834569,18
2,170,118,3575834551,3575834583,32
2,170,119,3575834551,3575834586,35
2,170,120,3575834551,3575834592,41
2,170,121,3575834551,3575834594,43
2,171,122,3575834602,3575834620,18
2,171,123,3575834602,3575834623,21
2,171,124,3575834602,3575834644,42
2,172,125,3575834653,3575834669,16
2,172,126,3575834653,3575834677,24
2,172,127,3575834653,3575834688,35
2,172,128,3575834653,3575834693,40
2,172,129,3575834653,3575834699,46
2,173,130,3575834704,3575834727,23
2,173,131,3575834704,3575834731,27
2,173,132,3575834704,3575834733,29
2,174,133,3575834755,3575834766,11
2,174,134,3575834755,3575834769,14
2,174,135,3575834755,3575834783,28
2,174,136,3575834755,3575834786,31
2,174,137,3575834755,3575834792,37
2,174,138,3575834755,3575834795,40
2,175,139,3575834805,3575834819,14
2,175,140,3575834805,3575834824,19
2,175,141,3575834805,3575834844,39
2,175,142,3575834805,3575834854,49
2,176,143,3575834856,3575834869,13
2,176,144,3575834856,3575834877,21
2,176,145,3575834856,3575834888,32
2,176,146,3575834856,3575834893,37
2,176,147,3575834856,3575834899,43
2,177,148,3575834906,3575834927,21
2,177,149,3575834906,3575834931,25
2,177,150,3575834906,3575834933,27
2,178,151,3575834957,3575834967,10
2,178,152,3575834957,3575834969,12
2,178,153,3575834957,3575834983,26
2,178,154,3575834957,3575834986,29
2,178,155,3575834957,3575834992,35
2,178,156,3575834957,3575834995,38
2,179,157,3575835008,3575835020,12
2,179,158,3575835008,3575835023,15
2,179,159,3575835008,3575835044,36
2,179,160,3575835008,3575835053,45
2,179,161,3575835008,3575835056,48
2,180,162,3575835059,3575835069,10
2,180,163,3575835059,3575835077,18
2,180,164,3575835059,3575835088,29
2,180,165,3575835059,3575835093,34
2,180,166,3575835059,3575835099,40
2,181,167,3575835109,3575835127,18
2,181,168,3575835109,3575835132,23
2,181,169,3575835109,3575835134,25
2,182,170,3575835160,3575835167,7
2,182,171,3575835160,3575835170,10
2,182,172,3575835160,3575835183,23
2,182,173,3575835160,3575835186,26
2,182,174,3575835160,3575835192,32
2,182,175,3575835160,3575835195,35
2,183,176,3575835211,3575835220,9
2,183,177,3575835211,3575835223,12
2,183,178,3575835211,3575835244,33
2,183,179,3575835211,3575835254,43
2,183,180,3575835211,3575835257,46
2,184,181,3575835262,3575835269,7
2,184,182,3575835262,3575835277,15
2,184,183,3575835262,3575835288,26
2,184,184,3575835262,3575835293,31
2,184,185,3575835262,3575835298,36
2,185,186,3575835313,3575835327,14
2,185,187,3575835313,3575835333,20
2,185,188,3575835313,3575835335,22
2,186,189,3575835363,3575835367,4
2,186,190,3575835363,3575835369,6
2,186,191,3575835363,3575835383,20
2,186,192,3575835363,3575835385,22
2,186,193,3575835363,3575835391,28
2,186,194,3575835363,3575835395,32
2,187,195,3575835414,3575835420,6
2,187,196,3575835414,3575835423,9
2,187,197,3575835414,3575835445,31
2,187,198,3575835414,3575835454,40
2,187,199,3575835414,3575835457,43
2,188,200,3575835465,3575835469,4
2,188,201,3575835465,3575835476,11
2,188,202,3575835465,3575835488,23
2,188,203,3575835465,3575835493,28
2,188,204,3575835465,3575835499,34
2,189,205,3575835516,3575835527,11
2,189,206,3575835516,3575835532,16
2,189,207,3575835516,3575835534,18
2,190,208,3575835567,3575835567,0
2,190,209,3575835567,3575835568,1
2,190,210,3575835567,3575835582,15
2,190,211,3575835567,3575835585,18
2,190,212,3575835567,3575835590,23
2,190,213,3575835567,3575835594,27
2,191,214,3575835618,3575835619,1
2,191,215,3575835618,3575835622,4
2,191,216,3575835618,3575835644,26
2,191,217,3575835618,3575835653,35
2,191,218,3575835618,3575835656,38
2,191,219,3575835618,3575835668,50
2,192,220,3575835669,3575835677,8
2,192,221,3575835669,3575835688,19
2,192,222,3575835669,3575835694,25
2,192,223,3575835669,3575835699,30
2,193,224,3575835719,3575835727,8
2,193,225,3575835719,3575835732,13
2,193,226,3575835719,3575835734,15
2,193,227,3575835719,3575835767,48
2,193,228,3575835719,3575835769,50
2,194,229,3575835770,3575835782,12
2,194,230,3575835770,3575835786,16
2,194,231,3575835770,3575835791,21
2,194,232,3575835770,3575835795,25
2,194,233,3575835770,3575835817,47
2,194,234,3575835770,3575835820,50
2,195,235,3575835821,3575835822,1
2,195,236,3575835821,3575835844,23
2,195,237,3575835821,3575835854,33
2,195,238,3575835821,3575835858,37
2,195,239,3575835821,3575835868,47
2,196,240,3575835872,3575835877,5
2,196,241,3575835872,3575835888,16
2,196,242,3575835872,3575835893,21
2,196,243,3575835872,3575835899,27
2,196,244,3575835872,3575835913,41
2,197,245,3575835922,3575835928,6
2,197,246,3575835922,3575835933,11
2,197,247,3575835922,3575835933,11
2,197,248,3575835922,3575835967,45
2,197,249,3575835922,3575835970,48
2,198,250,3575835973,3575835983,10
2,198,251,3575835973,3575835986,13
2,198,252,3575835973,3575835991,18
2,198,253,3575835973,3575835995,22
2,198,254,3575835973,3575836018,45
2,198,255,3575835973,3575836019,46
2,198,256,3575835973,3575836020,47
2,198,257,3575835973,3575836022,49
2,199,258,3575836024,3575836044,20
2,199,259,3575836024,3575836054,30
2,199,260,3575836024,3575836058,34
2,199,261,3575836024,3575836069,45
2,200,262,3575836075,3575836077,2
2,200,263,3575836075,3575836088,13
2,200,264,3575836075,3575836093,18
2,200,265,3575836075,3575836099,24
2,200,266,3575836075,3575836113,38
2,201,267,3575836126,3575836128,2
2,201,268,3575836126,3575836132,6
2,201,269,3575836126,3575836134,8
2,201,270,3575836126,3575836167,41
2,201,271,3575836126,3575836170,44
2,202,272,3575836177,3575836183,6
2,202,273,3575836177,3575836186,9
2,202,274,3575836177,3575836191,14
2,202,275,3575836177,3575836195,18
2,202,276,3575836177,3575836218,41
2,202,277,3575836177,3575836219,42
2,202,278,3575836177,3575836220,43
2,202,279,3575836177,3575836222,45
2,202,280,3575836177,3575836222,45
2,203,281,3575836228,3575836245,17
2,203,282,3575836228,3575836254,26
2,203,283,3575836228,3575836258,30
2,203,284,3575836228,3575836269,41
2,203,285,3575836228,3575836272,44
2,203,286,3575836228,3575836277,49
2,204,287,3575836279,3575836288,9
2,204,288,3575836279,3575836293,14
2,204,289,3575836279,3575836299,20
2,204,290,3575836279,3575836313,34
2,204,291,3575836279,3575836328,49
2,205,292,3575836330,3575836332,2
2,205,293,3575836330,3575836335,5
2,205,294,3575836330,3575836367,37
2,205,295,3575836330,3575836370,40
2,206,296,3575836381,3575836383,2
2,206,297,3575836381,3575836386,5
2,206,298,3575836381,3575836391,10
2,206,299,3575836381,3575836394,13
2,206,300,3575836381,3575836417,36
2,206,301,3575836381,3575836418,37
2,206,302,3575836381,3575836421,40
2,206,303,3575836381,3575836421,40
2,206,304,3575836381,3575836424,43
2,207,305,3575836432,3575836445,13
2,207,306,3575836432,3575836454,22
2,207,307,3575836432,3575836458,26
2,207,308,3575836432,3575836469,37
2,207,309,3575836432,3575836472,40
2,207,310,3575836432,3575836477,45
2,208,311,3575836483,3575836487,4
2,208,312,3575836483,3575836493,10
2,208,313,3575836483,3575836498,15
2,208,314,3575836483,3575836511,28
2,208,315,3575836483,3575836528,45
2,208,316,3575836483,3575836532,49
2,209,317,3575836534,3575836534,0
2,209,318,3575836534,3575836566,32
2,209,319,3575836534,3575836569,35
2,209,320,3575836534,3575836582,48
2,210,321,3575836585,3575836585,0
2,210,322,3575836585,3575836590,5
2,210,323,3575836585,3575836594,9
2,210,324,3575836585,3575836617,32
2,210,325,3575836585,3575836618,33
2,210,326,3575836585,3575836619,34
2,210,327,3575836585,3575836621,36
2,210,328,3575836585,3575836623,38
2,211,329,3575836636,3575836644,8
2,211,330,3575836636,3575836653,17
2,211,331,3575836636,3575836657,21
2,211,332,3575836636,3575836668,32
2,211,333,3575836636,3575836672,36
2,211,334,3575836636,3575836677,41
2,212,335,3575836687,3575836687,0
2,212,336,3575836687,3575836693,6
2,212,337,3575836687,3575836697,10
2,212,338,3575836687,3575836711,24
2,212,339,3575836687,3575836728,41
2,212,340,3575836687,3575836732,45
2,212,341,3575836687,3575836734,47
2,213,342,3575836738,3575836766,28
2,213,343,3575836738,3575836769,31
2,213,344,3575836738,3575836782,44
2,213,345,3575836738,3575836785,47
2,214,346,3575836789,3575836791,2
2,214,347,3575836789,3575836794,5
2,214,348,3575836789,3575836817,28
2,214,349,3575836789,3575836818,29
2,214,350,3575836789,3575836820,31
2,214,351,3575836789,3575836821,32
2,214,352,3575836789,3575836823,34
2,215,353,3575836840,3575836843,3
2,215,354,3575836840,3575836853,13
2,215,355,3575836840,3575836857,17
2,215,356,3575836840,3575836868,28
2,215,357,3575836840,3575836872,32
2,215,358,3575836840,3575836877,37
2,215,359,3575836840,3575836880,40
2,215,360,3575836840,3575836887,47
2,216,361,3575836891,3575836893,2
2,216,362,3575836891,3575836898,7
2,216,363,3575836891,3575836912,21
2,216,364,3575836891,3575836928,37
2,216,365,3575836891,3575836932,41
2,216,366,3575836891,3575836934,43
2,217,367,3575836942,3575836967,25
2,217,368,3575836942,3575836969,27
2,217,369,3575836942,3575836982,40
2,217,370,3575836942,3575836985,43
2,217,371,3575836942,3575836991,49
2,218,372,3575836993,3575836993,0
2,218,373,3575836993,3575837017,24
2,218,374,3575836993,3575837018,25
2,218,375,3575836993,3575837019,26
2,218,376,3575836993,3575837021,28
2,218,377,3575836993,3575837023,30
2,219,378,3575837044,3575837045,1
2,219,379,3575837044,3575837053,9
2,219,380,3575837044,3575837057,13
2,219,381,3575837044,3575837069,25
2,219,382,3575837044,3575837072,28
2,219,383,3575837044,3575837077,33
2,219,384,3575837044,3575837080,36
2,219,385,3575837044,3575837087,43
2,219,386,3575837044,3575837093,49
2,220,387,3575837095,3575837097,2
2,220,388,3575837095,3575837111,16
2,220,389,3575837095,3575837129,34
2,220,390,3575837095,3575837133,38
2,220,391,3575837095,3575837135,40
2,221,392,3575837146,3575837167,21
2,221,393,3575837146,3575837170,24
2,221,394,3575837146,3575837183,37
2,221,395,3575837146,3575837185,39
2,221,396,3575837146,3575837191,45
2,221,397,3575837146,3575837194,48
2,222,398,3575837197,3575837216,19
2,222,399,3575837197,3575837218,21
2,222,400,3575837197,3575837221,24
2,222,401,3575837197,3575837221,24
2,222,402,3575837197,3575837223,26
2,222,403,3575837197,3575837244,47
2,223,404,3575837248,3575837252,4
2,223,405,3575837248,3575837256,8
2,223,406,3575837248,3575837269,21
2,223,407,3575837248,3575837272,24
2,223,408,3575837248,3575837276,28
2,223,409,3575837248,3575837280,32
2,223,410,3575837248,3575837287,39
2,223,411,3575837248,3575837293,45
2,223,412,3575837248,3575837298,50
2,224,413,3575837299,3575837312,13
2,224,414,3575837299,3575837329,30
2,224,415,3575837299,3575837332,33
2,224,416,3575837299,3575837334,35
2,225,417,3575837350,3575837367,17
2,225,418,3575837350,3575837370,20
2,225,419,3575837350,3575837383,33
2,225,420,3575837350,3575837386,36
2,225,421,3575837350,3575837386,36
2,225,422,3575837350,3575837391,41
2,225,423,3575837350,3575837393,43
2,226,424,3575837401,3575837417,16
2,226,425,3575837401,3575837418,17
2,226,426,3575837401,3575837420,19
2,226,427,3575837401,3575837421,20
2,226,428,3575837401,3575837423,22
2,226,429,3575837401,3575837444,43
2,227,430,3575837452,3575837453,1
2,227,431,3575837452,3575837457,5
2,227,432,3575837452,3575837469,17
2,227,433,3575837452,3575837472,20
2,227,434,3575837452,3575837477,25
2,227,435,3575837452,3575837480,28
2,227,436,3575837452,3575837487,35
2,227,437,3575837452,3575837493,41
2,227,438,3575837452,3575837498,46
2,228,439,3575837503,3575837511,8
2,228,440,3575837503,3575837528,25
2,228,441,3575837503,3575837532,29
2,228,442,3575837503,3575837534,31
2,229,443,3575837554,3575837566,12
2,229,444,3575837554,3575837568,14
2,229,445,3575837554,3575837583,29
2,229,446,3575837554,3575837585,31
2,229,447,3575837554,3575837585,31
2,229,448,3575837554,3575837590,36
2,229,449,3575837554,3575837593,39
2,230,450,3575837605,3575837615,10
2,230,451,3575837605,3575837616,11
2,230,452,3575837605,3575837619,14
2,230,453,3575837605,3575837619,14
2,230,454,3575837605,3575837622,17
2,230,455,3575837605,3575837643,38
2,230,456,3575837605,3575837652,47
2,231,457,3575837656,3575837656,0
2,231,458,3575837656,3575837668,12
2,231,459,3575837656,3575837672,16
2,231,460,3575837656,3575837677,21
2,231,461,3575837656,3575837680,24
2,231,462,3575837656,3575837687,31
2,231,463,3575837656,3575837693,37
2,231,464,3575837656,3575837697,41
2,232,465,3575837707,3575837712,5
2,232,466,3575837707,3575837728,21
2,232,467,3575837707,3575837733,26
2,232,468,3575837707,3575837734,27
2,232,469,3575837707,3575837740,33
2,233,470,3575837758,3575837766,8
2,233,471,3575837758,3575837769,11
2,233,472,3575837758,3575837782,24
2,233,473,3575837758,3575837785,27
2,233,474,3575837758,3575837785,27
2,233,475,3575837758,3575837791,33
2,233,476,3575837758,3575837793,35
2,234,477,3575837809,3575837816,7
2,234,478,3575837809,3575837818,9
2,234,479,3575837809,3575837819,10
2,234,480,3575837809,3575837820,11
2,234,481,3575837809,3575837822,13
2,234,482,3575837809,3575837843,34
2,234,483,3575837809,3575837853,44
2,234,484,3575837809,3575837856,47
2,235,485,3575837860,3575837868,8
2,235,486,3575837860,3575837872,12
2,235,487,3575837860,3575837876,16
2,235,488,3575837860,3575837880,20
2,235,489,3575837860,3575837887,27
2,235,490,3575837860,3575837893,33
2,235,491,3575837860,3575837898,38
2,236,492,3575837911,3575837911,0
2,236,493,3575837911,3575837929,18
2,236,494,3575837911,3575837933,22
2,236,495,3575837911,3575837933,22
2,236,496,3575837911,3575837940,29
2,237,497,3575837962,3575837967,5
2,237,498,3575837962,3575837969,7
2,237,499,3575837962,3575837982,20
2,237,500,3575837962,3575837985,23
2,237,501,3575837962,3575837985,23
2,237,502,3575837962,3575837991,29
2,237,503,3575837962,3575837994,32
2,238,504,3575838013,3575838016,3
2,238,505,3575838013,3575838017,4
2,238,506,3575838013,3575838019,6
2,238,507,3575838013,3575838021,8
2,238,508,3575838013,3575838022,9
2,238,509,3575838013,3575838044,31
2,238,510,3575838013,3575838052,39
2,238,511,3575838013,3575838056,43
2,239,512,3575838064,3575838069,5
2,239,513,3575838064,3575838072,8
2,239,514,3575838064,3575838077,13
2,239,515,3575838064,3575838080,16
2,239,516,3575838064,3575838087,23
2,239,517,3575838064,3575838093,29
2,239,518,3575838064,3575838098,34
2,239,519,3575838064,3575838112,48
2,240,520,3575838115,3575838128,13
2,240,521,3575838115,3575838133,18
2,240,522,3575838115,3575838134,19
2,240,523,3575838115,3575838140,25
2,241,524,3575838166,3575838167,1
2,241,525,3575838166,3575838170,4
2,241,526,3575838166,3575838183,17
2,241,527,3575838166,3575838185,19
2,241,528,3575838166,3575838185,19
2,241,529,3575838166,3575838190,24
2,241,530,3575838166,3575838191,25
2,241,531,3575838166,3575838194,28
2,241,532,3575838166,3575838215,49
2,242,533,3575838217,3575838218,1
2,242,534,3575838217,3575838221,4
2,242,535,3575838217,3575838221,4
2,242,536,3575838217,3575838222,5
2,242,537,3575838217,3575838244,27
2,242,538,3575838217,3575838253,36
2,242,539,3575838217,3575838256,39
2,243,540,3575838268,3575838269,1
2,243,541,3575838268,3575838272,4
2,243,542,3575838268,3575838278,10
2,243,543,3575838268,3575838280,12
2,243,544,3575838268,3575838287,19
2,243,545,3575838268,3575838294,26
2,243,546,3575838268,3575838298,30
2,243,547,3575838268,3575838311,43
2,244,548,3575838319,3575838328,9
2,244,549,3575838319,3575838333,14
2,244,550,3575838319,3575838335,16
2,244,551,3575838319,3575838339,20
2,244,552,3575838319,3575838347,28
2,244,553,3575838319,3575838367,48
2,245,554,3575838370,3575838370,0
2,245,555,3575838370,3575838383,13
2,245,556,3575838370,3575838385,15
2,245,557,3575838370,3575838386,16
2,245,558,3575838370,3575838390,20
2,245,559,3575838370,3575838391,21
2,245,560,3575838370,3575838394,24
2,245,561,3575838370,3575838398,28
2,245,562,3575838370,3575838415,45
2,245,563,3575838370,3575838417,47
2,246,564,3575838421,3575838421,0
2,246,565,3575838421,3575838421,0
2,246,566,3575838421,3575838423,2
2,246,567,3575838421,3575838444,23
2,246,568,3575838421,3575838448,27
2,246,569,3575838421,3575838453,32
2,246,570,3575838421,3575838456,35
2,246,571,3575838421,3575838469,48
2,247,572,3575838472,3575838472,0
2,247,573,3575838472,3575838477,5
2,247,574,3575838472,3575838480,8
2,247,575,3575838472,3575838488,16
2,247,576,3575838472,3575838494,22
2,247,577,3575838472,3575838497,25
2,247,578,3575838472,3575838512,40
2,248,579,3575838523,3575838527,4
2,248,580,3575838523,3575838533,10
2,248,581,3575838523,3575838534,11
2,248,582,3575838523,3575838539,16
2,248,583,3575838523,3575838546,23
2,248,584,3575838523,3575838566,43
2,248,585,3575838523,3575838569,46
2,249,586,3575838574,3575838582,8
2,249,587,3575838574,3575838583,9
2,249,588,3575838574,3575838585,11
2,249,589,3575838574,3575838589,15
2,249,590,3575838574,3575838590,16
2,249,591,3575838574,3575838593,19
2,249,592,3575838574,3575838598,24
2,249,593,3575838574,3575838615,41
2,249,594,3575838574,3575838617,43
2,249,595,3575838574,3575838619,45
2,249,596,3575838574,3575838620,46
2,249,597,3575838574,3575838622,48
2,250,598,3575838625,3575838644,19
2,250,599,3575838625,3575838648,23
2,250,600,3575838625,3575838651,26
2,250,601,3575838625,3575838654,29
2,250,602,3575838625,3575838667,42
2,250,603,3575838625,3575838671,46
2,251,604,3575838677,3575838677,0
2,251,605,3575838677,3575838680,3
2,251,606,3575838677,3575838688,11
2,251,607,3575838677,3575838694,17
2,251,608,3575838677,3575838698,21
2,251,609,3575838677,3575838712,35
2,252,610,3575838729,3575838729,0
2,252,611,3575838729,3575838732,3
2,252,612,3575838729,3575838734,5
2,252,613,3575838729,3575838739,10
2,252,614,3575838729,3575838746,17
2,252,615,3575838729,3575838766,37
2,252,616,3575838729,3575838769,40
2,253,617,3575838780,3575838782,2
2,253,618,3575838780,3575838783,3
2,253,619,3575838780,3575838785,5
2,253,620,3575838780,3575838790,10
2,253,621,3575838780,3575838790,10
2,253,622,3575838780,3575838794,14
2,253,623,3575838780,3575838798,18
2,253,624,3575838780,3575838815,35
2,253,625,3575838780,3575838818,38
2,253,626,3575838780,3575838819,39
2,253,627,3575838780,3575838820,40
2,253,628,3575838780,3575838822,42
2,254,629,3575838831,3575838843,12
2,254,630,3575838831,3575838848,17
2,254,631,3575838831,3575838851,20
2,254,632,3575838831,3575838856,25
2,254,633,3575838831,3575838868,37
2,254,634,3575838831,3575838872,41
2,254,635,3575838831,3575838877,46
2,254,636,3575838831,3575838880,49
2,255,637,3575838882,3575838888,6
2,255,638,3575838882,3575838894,12
2,255,639,3575838882,3575838897,15
2,255,640,3575838882,3575838912,30
2,255,641,3575838882,3575838927,45
2,256,642,3575838933,3575838933,0
2,256,643,3575838933,3575838934,1
2,256,644,3575838933,3575838939,6
2,256,645,3575838933,3575838946,13
2,256,646,3575838933,3575838967,34
2,256,647,3575838933,3575838969,36
2,256,648,3575838933,3575838982,49
2,257,649,3575838984,3575838984,0
2,257,650,3575838984,3575838986,2
2,257,651,3575838984,3575838990,6
2,257,652,3575838984,3575838990,6
2,257,653,3575838984,3575838994,10
2,257,654,3575838984,3575838997,13
2,257,655,3575838984,3575839015,31
2,257,656,3575838984,3575839018,34
2,257,657,3575838984,3575839020,36
2,257,658,3575838984,3575839021,37
2,257,659,3575838984,3575839022,38
2,258,660,3575839035,3575839044,9
2,258,661,3575839035,3575839048,13
2,258,662,3575839035,3575839051,16
2,258,663,3575839035,3575839056,21
2,258,664,3575839035,3575839068,33
2,258,665,3575839035,3575839072,37
2,258,666,3575839035,3575839077,42
2,258,667,3575839035,3575839080,45
2,259,668,3575839087,3575839088,1
2,259,669,3575839087,3575839094,7
2,259,670,3575839087,3575839098,11
2,259,671,3575839087,3575839112,25
2,259,672,3575839087,3575839127,40
2,259,673,3575839087,3575839132,45
2,259,674,3575839087,3575839134,47
2,260,675,3575839138,3575839138,0
2,260,676,3575839138,3575839146,8
2,260,677,3575839138,3575839167,29
2,260,678,3575839138,3575839170,32
2,260,679,3575839138,3575839184,46
2,260,680,3575839138,3575839185,47
2,260,681,3575839138,3575839187,49
2,261,682,3575839190,3575839190,0
2,261,683,3575839190,3575839190,0
2,261,684,3575839190,3575839194,4
2,261,685,3575839190,3575839198,8
2,261,686,3575839190,3575839214,24
2,261,687,3575839190,3575839217,27
2,261,688,3575839190,3575839220,30
2,261,689,3575839190,3575839221,31
2,261,690,3575839190,3575839222,32
2,262,691,3575839241,3575839245,4
2,262,692,3575839241,3575839248,7
2,262,693,3575839241,3575839252,11
2,262,694,3575839241,3575839256,15
2,262,695,3575839241,3575839269,28
2,262,696,3575839241,3575839272,31
2,262,697,3575839241,3575839277,36
2,262,698,3575839241,3575839280,39
2,262,699,3575839241,3575839288,47
2,263,700,3575839292,3575839294,2
2,263,701,3575839292,3575839298,6
2,263,702,3575839292,3575839308,16
2,263,703,3575839292,3575839312,20
2,263,704,3575839292,3575839327,35
2,263,705,3575839292,3575839332,40
2,263,706,3575839292,3575839334,42
2,263,707,3575839292,3575839339,47
2,264,708,3575839343,3575839346,3
2,264,709,3575839343,3575839358,15
2,264,710,3575839343,3575839367,24
2,264,711,3575839343,3575839369,26
2,264,712,3575839343,3575839384,41
2,264,713,3575839343,3575839385,42
2,264,714,3575839343,3575839387,44
2,264,715,3575839343,3575839390,47
2,264,716,3575839343,3575839391,48
2,265,717,3575839394,3575839394,0
2,265,718,3575839394,3575839398,4
2,265,719,3575839394,3575839415,21
2,265,720,3575839394,3575839417,23
2,265,721,3575839394,3575839421,27
2,265,722,3575839394,3575839421,27
2,265,723,3575839394,3575839423,29
2,266,724,3575839445,3575839445,0
2,266,725,3575839445,3575839448,3
2,266,726,3575839445,3575839451,6
2,266,727,3575839445,3575839456,11
2,266,728,3575839445,3575839468,23
2,266,729,3575839445,3575839472,27
2,266,730,3575839445,3575839477,32
2,266,731,3575839445,3575839480,35
2,266,732,3575839445,3575839488,43
2,266,733,3575839445,3575839495,50
2,267,734,3575839496,3575839497,1
2,267,735,3575839496,3575839508,12
2,267,736,3575839496,3575839511,15
2,267,737,3575839496,3575839526,30
2,267,738,3575839496,3575839532,36
2,267,739,3575839496,3575839534,38
2,267,740,3575839496,3575839538,42
2,267,741,3575839496,3575839545,49
2,268,742,3575839547,3575839558,11
2,268,743,3575839547,3575839566,19
2,268,744,3575839547,3575839568,21
2,268,745,3575839547,3575839583,36
2,268,746,3575839547,3575839584,37
2,268,747,3575839547,3575839586,39
2,268,748,3575839547,3575839589,42
2,268,749,3575839547,3575839590,43
2,268,750,3575839547,3575839592,45
2,268,751,3575839547,3575839597,50
2,269,752,3575839598,3575839614,16
2,269,753,3575839598,3575839616,18
2,269,754,3575839598,3575839620,22
2,269,755,3575839598,3575839620,22
2,269,756,3575839598,3575839622,24
2,269,757,3575839598,3575839644,46
2,269,758,3575839598,3575839647,49
2,270,759,3575839649,3575839651,2
2,270,760,3575839649,3575839655,6
2,270,761,3575839649,3575839667,18
2,270,762,3575839649,3575839677,28
2,270,763,3575839649,3575839680,31
2,270,764,3575839649,3575839688,39
2,270,765,3575839649,3575839695,46
2,270,766,3575839649,3575839696,47
2,271,767,3575839701,3575839708,7
2,271,768,3575839701,3575839711,10
2,271,769,3575839701,3575839728,27
2,271,770,3575839701,3575839731,30
2,271,771,3575839701,3575839734,33
2,271,772,3575839701,3575839738,37
2,271,773,3575839701,3575839745,44
2,272,774,3575839753,3575839758,5
2,272,775,3575839753,3575839764,11
2,272,776,3575839753,3575839765,12
2,272,777,3575839753,3575839768,15
2,272,778,3575839753,3575839784,31
2,272,779,3575839753,3575839784,31
2,272,780,3575839753,3575839786,33
2,272,781,3575839753,3575839790,37
2,272,782,3575839753,3575839791,38
2,272,783,3575839753,3575839793,40
2,272,784,3575839753,3575839797,44
2,273,785,3575839804,3575839814,10
2,273,786,3575839804,3575839817,13
2,273,787,3575839804,3575839820,16
2,273,788,3575839804,3575839820,16
2,273,789,3575839804,3575839822,18
2,273,790,3575839804,3575839845,41
2,273,791,3575839804,3575839847,43
2,273,792,3575839804,3575839852,48
2,274,793,3575839855,3575839856,1
2,274,794,3575839855,3575839867,12
2,274,795,3575839855,3575839876,21
2,274,796,3575839855,3575839880,25
2,274,797,3575839855,3575839889,34
2,274,798,3575839855,3575839894,39
2,274,799,3575839855,3575839896,41
2,275,800,3575839906,3575839908,2
2,275,801,3575839906,3575839910,4
2,275,802,3575839906,3575839917,11
2,275,803,3575839906,3575839927,21
2,275,804,3575839906,3575839931,25
2,275,805,3575839906,3575839934,28
2,275,806,3575839906,3575839938,32
2,275,807,3575839906,3575839945,39
2,276,808,3575839957,3575839958,1
2,276,809,3575839957,3575839964,7
2,276,810,3575839957,3575839966,9
2,276,811,3575839957,3575839967,10
2,276,812,3575839957,3575839969,12
2,276,813,3575839957,3575839983,26
2,276,814,3575839957,3575839984,27
2,276,815,3575839957,3575839987,30
2,276,816,3575839957,3575839990,33
2,276,817,3575839957,3575839991,34
2,276,818,3575839957,3575839993,36
2,276,819,3575839957,3575839996,39
2,277,820,3575840009,3575840014,5
2,277,821,3575840009,3575840018,9
2,277,822,3575840009,3575840019,10
2,277,823,3575840009,3575840021,12
2,277,824,3575840009,3575840022,13
2,277,825,3575840009,3575840045,36
2,277,826,3575840009,3575840047,38
2,277,827,3575840009,3575840051,42
2,277,828,3575840009,3575840056,47
2,278,829,3575840061,3575840069,8
2,278,830,3575840061,3575840077,16
2,278,831,3575840061,3575840080,19
2,278,832,3575840061,3575840089,28
2,278,833,3575840061,3575840094,33
2,278,834,3575840061,3575840097,36
2,278,835,3575840061,3575840108,47
2,278,836,3575840061,3575840111,50
2,279,837,3575840112,3575840116,4
2,279,838,3575840112,3575840127,15
2,279,839,3575840112,3575840133,21
2,279,840,3575840112,3575840134,22
2,279,841,3575840112,3575840138,26
2,279,842,3575840112,3575840146,34
2,279,843,3575840112,3575840158,46
2,280,844,3575840163,3575840164,1
2,280,845,3575840163,3575840166,3
2,280,846,3575840163,3575840167,4
2,280,847,3575840163,3575840169,6
2,280,848,3575840163,3575840170,7
2,280,849,3575840163,3575840183,20
2,280,850,3575840163,3575840184,21
2,280,851,3575840163,3575840186,23
2,280,852,3575840163,3575840190,27
2,280,853,3575840163,3575840191,28
2,280,854,3575840163,3575840194,31
2,280,855,3575840163,3575840196,33
2,281,856,3575840215,3575840215,0
2,281,857,3575840215,3575840218,3
2,281,858,3575840215,3575840221,6
2,281,859,3575840215,3575840221,6
2,281,860,3575840215,3575840222,7
2,281,861,3575840215,3575840244,29
2,281,862,3575840215,3575840247,32
2,281,863,3575840215,3575840252,37
2,281,864,3575840215,3575840256,41
2,281,865,3575840215,3575840265,50
2,282,866,3575840266,3575840268,2
2,282,867,3575840266,3575840277,11
2,282,868,3575840266,3575840280,14
2,282,869,3575840266,3575840289,23
2,282,870,3575840266,3575840295,29
2,282,871,3575840266,3575840297,31
2,282,872,3575840266,3575840309,43
2,282,873,3575840266,3575840312,46
2,283,874,3575840317,3575840317,0
2,283,875,3575840317,3575840327,10
2,283,876,3575840317,3575840332,15
2,283,877,3575840317,3575840335,18
2,283,878,3575840317,3575840338,21
2,283,879,3575840317,3575840346,29
2,283,880,3575840317,3575840358,41
2,283,881,3575840317,3575840364,47
2,283,882,3575840317,3575840366,49
2,283,883,3575840317,3575840367,50
2,284,884,3575840368,3575840369,1
2,284,885,3575840368,3575840369,1
2,284,886,3575840368,3575840383,15
2,284,887,3575840368,3575840384,16
2,284,888,3575840368,3575840387,19
2,284,889,3575840368,3575840390,22
2,284,890,3575840368,3575840392,24
2,284,891,3575840368,3575840394,26
2,284,892,3575840368,3575840396,28
2,284,893,3575840368,3575840415,47
2,284,894,3575840368,3575840418,50
2,285,895,3575840420,3575840421,1
2,285,896,3575840420,3575840421,1
2,285,897,3575840420,3575840423,3
2,285,898,3575840420,3575840444,24
2,285,899,3575840420,3575840447,27
2,285,900,3575840420,3575840452,32
2,285,901,3575840420,3575840456,36
2,285,902,3575840420,3575840465,45
2,285,903,3575840420,3575840469,49
2,286,904,3575840471,3575840477,6
2,286,905,3575840471,3575840480,9
2,286,906,3575840471,3575840489,18
2,286,907,3575840471,3575840494,23
2,286,908,3575840471,3575840498,27
2,286,909,3575840471,3575840509,38
2,286,910,3575840471,3575840511,40
2,286,911,3575840471,3575840516,45
2,287,912,3575840522,3575840526,4
2,287,913,3575840522,3575840532,10
2,287,914,3575840522,3575840534,12
2,287,915,3575840522,3575840538,16
2,287,916,3575840522,3575840545,23
2,287,917,3575840522,3575840557,35
2,287,918,3575840522,3575840564,42
2,287,919,3575840522,3575840565,43
2,287,920,3575840522,3575840566,44
2,287,921,3575840522,3575840568,46
2,287,922,3575840522,3575840569,47
2,288,923,3575840573,3575840582,9
2,288,924,3575840573,3575840584,11
2,288,925,3575840573,3575840586,13
2,288,926,3575840573,3575840589,16
2,288,927,3575840573,3575840591,18
2,288,928,3575840573,3575840593,20
2,288,929,3575840573,3575840597,24
2,288,930,3575840573,3575840614,41
2,288,931,3575840573,3575840617,44
2,288,932,3575840573,3575840620,47
2,288,933,3575840573,3575840620,47
2,288,934,3575840573,3575840622,49
2,289,935,3575840625,3575840625,0
2,289,936,3575840625,3575840643,18
2,289,937,3575840625,3575840646,21
2,289,938,3575840625,3575840652,27
2,289,939,3575840625,3575840654,29
2,289,940,3575840625,3575840664,39
2,289,941,3575840625,3575840667,42
2,290,942,3575840677,3575840677,0
2,290,943,3575840677,3575840681,4
2,290,944,3575840677,3575840689,12
2,290,945,3575840677,3575840695,18
2,290,946,3575840677,3575840698,21
2,290,947,3575840677,3575840708,31
2,290,948,3575840677,3575840712,35
2,290,949,3575840677,3575840716,39
2,290,950,3575840677,3575840725,48
2,290,951,3575840677,3575840727,50
2,291,952,3575840729,3575840732,3
2,291,953,3575840729,3575840734,5
2,291,954,3575840729,3575840737,8
2,291,955,3575840729,3575840757,28
2,291,956,3575840729,3575840764,35
2,291,957,3575840729,3575840765,36
2,291,958,3575840729,3575840766,37
2,291,959,3575840729,3575840768,39
2,291,960,3575840729,3575840769,40
2,292,961,3575840781,3575840782,1
2,292,962,3575840781,3575840784,3
2,292,963,3575840781,3575840786,5
2,292,964,3575840781,3575840789,8
2,292,965,3575840781,3575840790,9
2,292,966,3575840781,3575840793,12
2,292,967,3575840781,3575840796,15
2,292,968,3575840781,3575840814,33
2,292,969,3575840781,3575840818,37
2,292,970,3575840781,3575840820,39
2,292,971,3575840781,3575840820,39
2,292,972,3575840781,3575840822,41
2,292,973,3575840781,3575840823,42
2,293,974,3575840832,3575840843,11
2,293,975,3575840832,3575840846,14
2,293,976,3575840832,3575840852,20
2,293,977,3575840832,3575840856,24
2,293,978,3575840832,3575840864,32
2,293,979,3575840832,3575840868,36
2,293,980,3575840832,3575840877,45
2,293,981,3575840832,3575840877,45
2,293,982,3575840832,3575840880,48
2,294,983,3575840883,3575840889,6
2,294,984,3575840883,3575840894,11
2,294,985,3575840883,3575840898,15
2,294,986,3575840883,3575840908,25
2,294,987,3575840883,3575840912,29
2,294,988,3575840883,3575840916,33
2,294,989,3575840883,3575840926,43
2,294,990,3575840883,3575840927,44
2,294,991,3575840883,3575840931,48
2,295,992,3575840935,3575840935,0
2,295,993,3575840935,3575840938,3
2,295,994,3575840935,3575840957,22
2,295,995,3575840935,3575840964,29
2,295,996,3575840935,3575840966,31
2,295,997,3575840935,3575840967,32
2,295,998,3575840935,3575840968,33
2,295,999,3575840935,3575840969,34
2,295,1000,3575840935,3575840978,43
2,295,1001,3575840935,3575840982,47
2,295,1002,3575840935,3575840984,49
2,296,1003,3575840987,3575840987,0
2,296,1004,3575840987,3575840989,2
2,296,1005,3575840987,3575840990,3
2,296,1006,3575840987,3575840994,7
2,296,1007,3575840987,3575840997,10
2,296,1008,3575840987,3575841015,28
2,296,1009,3575840987,3575841017,30
2,296,1010,3575840987,3575841019,32
2,296,1011,3575840987,3575841021,34
2,296,1012,3575840987,3575841022,35
2,296,1013,3575840987,3575841024,37
2,296,1014,3575840987,3575841030,43
2,297,1015,3575841039,3575841044,5
2,297,1016,3575841039,3575841046,7
2,297,1017,3575841039,3575841051,12
2,297,1018,3575841039,3575841055,16
2,297,1019,3575841039,3575841064,25
2,297,1020,3575841039,3575841069,30
2,297,1021,3575841039,3575841076,37
2,297,1022,3575841039,3575841078,39
2,297,1023,3575841039,3575841080,41
2,297,1024,3575841039,3575841089,50
2,298,1025,3575841090,3575841094,4
2,298,1026,3575841090,3575841098,8
2,298,1027,3575841090,3575841109,19
2,298,1028,3575841090,3575841112,22
2,298,1029,3575841090,3575841116,26
2,298,1030,3575841090,3575841126,36
2,298,1031,3575841090,3575841127,37
2,298,1032,3575841090,3575841128,38
2,298,1033,3575841090,3575841133,43
2,298,1034,3575841090,3575841135,45
2,298,1035,3575841090,3575841137,47
2,299,1036,3575841142,3575841158,16
2,299,1037,3575841142,3575841164,22
2,299,1038,3575841142,3575841166,24
2,299,1039,3575841142,3575841167,25
2,299,1040,3575841142,3575841167,25
2,299,1041,3575841142,3575841170,28
2,299,1042,3575841142,3575841184,42
2,299,1043,3575841142,3575841185,43
2,299,1044,3575841142,3575841186,44
2,299,1045,3575841142,3575841189,47
2,299,1046,3575841142,3575841191,49
2,300,1047,3575841194,3575841194,0
2,300,1048,3575841194,3575841214,20
2,300,1049,3575841194,3575841218,24
2,300,1050,3575841194,3575841220,26
2,300,1051,3575841194,3575841220,26
2,300,1052,3575841194,3575841222,28
2,300,1053,3575841194,3575841223,29
2,300,1054,3575841194,3575841229,35
2,301,1055,3575841246,3575841246,0
2,301,1056,3575841246,3575841247,1
2,301,1057,3575841246,3575841251,5
2,301,1058,3575841246,3575841255,9
2,301,1059,3575841246,3575841264,18
2,301,1060,3575841246,3575841269,23
2,301,1061,3575841246,3575841277,31
2,301,1062,3575841246,3575841278,32
2,301,1063,3575841246,3575841280,34
2,301,1064,3575841246,3575841284,38
2,301,1065,3575841246,3575841289,43
2,301,1066,3575841246,3575841294,48
2,302,1067,3575841298,3575841298,0
2,302,1068,3575841298,3575841308,10
2,302,1069,3575841298,3575841313,15
2,302,1070,3575841298,3575841317,19
2,302,1071,3575841298,3575841326,28
2,302,1072,3575841298,3575841327,29
2,302,1073,3575841298,3575841328,30
2,302,1074,3575841298,3575841332,34
2,302,1075,3575841298,3575841335,37
2,302,1076,3575841298,3575841338,40
2,303,1077,3575841350,3575841358,8
2,303,1078,3575841350,3575841364,14
2,303,1079,3575841350,3575841366,16
2,303,1080,3575841350,3575841367,17
2,303,1081,3575841350,3575841368,18
2,303,1082,3575841350,3575841370,20
2,303,1083,3575841350,3575841384,34
2,303,1084,3575841350,3575841385,35
2,303,1085,3575841350,3575841386,36
2,303,1086,3575841350,3575841389,39
2,303,1087,3575841350,3575841391,41
2,303,1088,3575841350,3575841394,44
2,304,1089,3575841402,3575841415,13
2,304,1090,3575841402,3575841417,15
2,304,1091,3575841402,3575841421,19
2,304,1092,3575841402,3575841421,19
2,304,1093,3575841402,3575841423,21
2,304,1094,3575841402,3575841424,22
2,304,1095,3575841402,3575841430,28
2,304,1096,3575841402,3575841446,44
2,304,1097,3575841402,3575841447,45
2,304,1098,3575841402,3575841451,49
2,305,1099,3575841454,3575841456,2
2,305,1100,3575841454,3575841464,10
2,305,1101,3575841454,3575841468,14
2,305,1102,3575841454,3575841476,22
2,305,1103,3575841454,3575841478,24
2,305,1104,3575841454,3575841480,26
2,305,1105,3575841454,3575841484,30
2,305,1106,3575841454,3575841489,35
2,305,1107,3575841454,3575841494,40
2,305,1108,3575841454,3575841498,44
2,306,1109,3575841506,3575841507,1
2,306,1110,3575841506,3575841512,6
2,306,1111,3575841506,3575841516,10
2,306,1112,3575841506,3575841526,20
2,306,1113,3575841506,3575841526,20
2,306,1114,3575841506,3575841527,21
2,306,1115,3575841506,3575841531,25
2,306,1116,3575841506,3575841534,28
2,306,1117,3575841506,3575841538,32
2,307,1118,3575841558,3575841558,0
2,307,1119,3575841558,3575841563,5
2,307,1120,3575841558,3575841564,6
2,307,1121,3575841558,3575841566,8
2,307,1122,3575841558,3575841568,10
2,307,1123,3575841558,3575841569,11
2,307,1124,3575841558,3575841582,24
2,307,1125,3575841558,3575841584,26
2,307,1126,3575841558,3575841585,27
2,307,1127,3575841558,3575841588,30
2,307,1128,3575841558,3575841590,32
2,307,1129,3575841558,3575841593,35
2,308,1130,3575841611,3575841614,3
2,308,1131,3575841611,3575841616,5
2,308,1132,3575841611,3575841619,8
2,308,1133,3575841611,3575841621,10
2,308,1134,3575841611,3575841622,11
2,308,1135,3575841611,3575841622,11
2,308,1136,3575841611,3575841628,17
2,308,1137,3575841611,3575841644,33
2,308,1138,3575841611,3575841646,35
2,308,1139,3575841611,3575841651,40
2,308,1140,3575841611,3575841656,45
2,309,1141,3575841663,3575841663,0
2,309,1142,3575841663,3575841668,5
2,309,1143,3575841663,3575841678,15
2,309,1144,3575841663,3575841680,17
2,309,1145,3575841663,3575841684,21
2,309,1146,3575841663,3575841689,26
2,309,1147,3575841663,3575841694,31
2,309,1148,3575841663,3575841698,35
2,309,1149,3575841663,3575841707,44
2,309,1150,3575841663,3575841712,49
2,310,1151,3575841715,3575841716,1
2,310,1152,3575841715,3575841726,11
2,310,1153,3575841715,3575841727,12
2,310,1154,3575841715,3575841727,12
2,310,1155,3575841715,3575841731,16
2,310,1156,3575841715,3575841734,19
2,310,1157,3575841715,3575841738,23
2,310,1158,3575841715,3575841757,42
2,310,1159,3575841715,3575841764,49
2,311,1160,3575841767,3575841767,0
2,311,1161,3575841767,3575841767,0
2,311,1162,3575841767,3575841768,1
2,311,1163,3575841767,3575841769,2
2,311,1164,3575841767,3575841782,15
2,311,1165,3575841767,3575841784,17
2,311,1166,3575841767,3575841785,18
2,311,1167,3575841767,3575841788,21
2,311,1168,3575841767,3575841791,24
2,311,1169,3575841767,3575841793,26
2,311,1170,3575841767,3575841814,47
2,312,1171,3575841819,3575841819,0
2,312,1172,3575841819,3575841820,1
2,312,1173,3575841819,3575841821,2
2,312,1174,3575841819,3575841822,3
2,312,1175,3575841819,3575841822,3
2,312,1176,3575841819,3575841829,10
2,312,1177,3575841819,3575841840,21
2,312,1178,3575841819,3575841844,25
2,312,1179,3575841819,3575841846,27
2,312,1180,3575841819,3575841852,33
2,312,1181,3575841819,3575841857,38
2,312,1182,3575841819,3575841863,44
2,312,1183,3575841819,3575841868,49
2,313,1184,3575841871,3575841877,6
2,313,1185,3575841871,3575841880,9
2,313,1186,3575841871,3575841884,13
2,313,1187,3575841871,3575841889,18
2,313,1188,3575841871,3575841894,23
2,313,1189,3575841871,3575841898,27
2,313,1190,3575841871,3575841907,36
2,313,1191,3575841871,3575841912,41
2,313,1192,3575841871,3575841917,46
2,314,1193,3575841922,3575841926,4
2,314,1194,3575841922,3575841927,5
2,314,1195,3575841922,3575841927,5
2,314,1196,3575841922,3575841931,9
2,314,1197,3575841922,3575841934,12
2,314,1198,3575841922,3575841939,17
2,314,1199,3575841922,3575841957,35
2,314,1200,3575841922,3575841964,42
2,314,1201,3575841922,3575841966,44
2,314,1202,3575841922,3575841967,45
2,314,1203,3575841922,3575841967,45
2,314,1204,3575841922,3575841969,47
2,315,1205,3575841974,3575841982,8
2,315,1206,3575841974,3575841983,9
2,315,1207,3575841974,3575841984,10
2,315,1208,3575841974,3575841988,14
2,315,1209,3575841974,3575841990,16
2,315,1210,3575841974,3575841992,18
2,315,1211,3575841974,3575841994,20
2,315,1212,3575841974,3575842014,40
2,315,1213,3575841974,3575842017,43
2,315,1214,3575841974,3575842020,46
2,315,1215,3575841974,3575842021,47
2,315,1216,3575841974,3575842022,48
2,315,1217,3575841974,3575842022,48
2,316,1218,3575842026,3575842029,3
2,316,1219,3575842026,3575842040,14
2,316,1220,3575842026,3575842046,20
2,316,1221,3575842026,3575842052,26
2,316,1222,3575842026,3575842057,31
2,316,1223,3575842026,3575842063,37
2,316,1224,3575842026,3575842069,43
2,317,1225,3575842077,3575842077,0
2,317,1226,3575842077,3575842080,3
2,317,1227,3575842077,3575842084,7
2,317,1228,3575842077,3575842089,12
2,317,1229,3575842077,3575842093,16
2,317,1230,3575842077,3575842095,18
2,317,1231,3575842077,3575842097,20
2,317,1232,3575842077,3575842107,30
2,317,1233,3575842077,3575842112,35
2,317,1234,3575842077,3575842116,39
2,317,1235,3575842077,3575842126,49
2,318,1236,3575842129,3575842129,0
2,318,1237,3575842129,3575842129,0
2,318,1238,3575842129,3575842132,3
2,318,1239,3575842129,3575842139,10
2,318,1240,3575842129,3575842158,29
2,318,1241,3575842129,3575842164,35
2,318,1242,3575842129,3575842165,36
2,318,1243,3575842129,3575842167,38
2,318,1244,3575842129,3575842168,39
2,318,1245,3575842129,3575842170,41
2,319,1246,3575842180,3575842184,4
2,319,1247,3575842180,3575842185,5
2,319,1248,3575842180,3575842185,5
2,319,1249,3575842180,3575842189,9
2,319,1250,3575842180,3575842191,11
2,319,1251,3575842180,3575842191,11
2,319,1252,3575842180,3575842194,14
2,319,1253,3575842180,3575842215,35
2,319,1254,3575842180,3575842218,38
2,319,1255,3575842180,3575842220,40
2,319,1256,3575842180,3575842222,42
2,319,1257,3575842180,3575842222,42
2,319,1258,3575842180,3575842223,43
2,319,1259,3575842180,3575842229,49
2,320,1260,3575842231,3575842239,8
2,320,1261,3575842231,3575842247,16
2,320,1262,3575842231,3575842252,21
2,320,1263,3575842231,3575842257,26
2,320,1264,3575842231,3575842263,32
2,320,1265,3575842231,3575842268,37
2,320,1266,3575842231,3575842277,46
2,320,1267,3575842231,3575842281,50
2,321,1268,3575842283,3575842284,1
2,321,1269,3575842283,3575842289,6
2,321,1270,3575842283,3575842293,10
2,321,1271,3575842283,3575842294,11
2,321,1272,3575842283,3575842295,12
2,321,1273,3575842283,3575842298,15
2,321,1274,3575842283,3575842307,24
2,321,1275,3575842283,3575842313,30
2,321,1276,3575842283,3575842316,33
2,321,1277,3575842283,3575842327,44
2,321,1278,3575842283,3575842328,45
2,321,1279,3575842283,3575842328,45
2,321,1280,3575842283,3575842332,49
2,322,1281,3575842334,3575842338,4
2,322,1282,3575842334,3575842358,24
2,322,1283,3575842334,3575842364,30
2,322,1284,3575842334,3575842365,31
2,322,1285,3575842334,3575842367,33
2,322,1286,3575842334,3575842368,34
2,322,1287,3575842334,3575842369,35
2,322,1288,3575842334,3575842384,50
2,323,1289,3575842386,3575842386,0
2,323,1290,3575842386,3575842386,0
2,323,1291,3575842386,3575842388,2
2,323,1292,3575842386,3575842390,4
2,323,1293,3575842386,3575842391,5
2,323,1294,3575842386,3575842395,9
2,323,1295,3575842386,3575842397,11
2,323,1296,3575842386,3575842414,28
2,323,1297,3575842386,3575842417,31
2,323,1298,3575842386,3575842420,34
2,323,1299,3575842386,3575842421,35
2,323,1300,3575842386,3575842423,37
2,323,1301,3575842386,3575842428,42
2,324,1302,3575842438,3575842440,2
2,324,1303,3575842438,3575842445,7
2,324,1304,3575842438,3575842447,9
2,324,1305,3575842438,3575842452,14
2,324,1306,3575842438,3575842457,19
2,324,1307,3575842438,3575842463,25
2,324,1308,3575842438,3575842469,31
2,324,1309,3575842438,3575842477,39
2,324,1310,3575842438,3575842480,42
2,324,1311,3575842438,3575842484,46
2,325,1312,3575842489,3575842489,0
2,325,1313,3575842489,3575842491,2
2,325,1314,3575842489,3575842493,4
2,325,1315,3575842489,3575842497,8
2,325,1316,3575842489,3575842506,17
2,325,1317,3575842489,3575842511,22
2,325,1318,3575842489,3575842515,26
2,325,1319,3575842489,3575842525,36
2,325,1320,3575842489,3575842527,38
2,325,1321,3575842489,3575842527,38
2,325,1322,3575842489,3575842532,43
2,325,1323,3575842489,3575842534,45
2,325,1324,3575842489,3575842538,49
2,326,1325,3575842541,3575842557,16
2,326,1326,3575842541,3575842563,22
2,326,1327,3575842541,3575842565,24
2,326,1328,3575842541,3575842566,25
2,326,1329,3575842541,3575842567,26
2,326,1330,3575842541,3575842569,28
2,326,1331,3575842541,3575842584,43
2,326,1332,3575842541,3575842585,44
2,326,1333,3575842541,3575842585,44
2,326,1334,3575842541,3575842588,47
2,326,1335,3575842541,3575842590,49
2,326,1336,3575842541,3575842590,49
2,327,1337,3575842593,3575842594,1
2,327,1338,3575842593,3575842596,3
2,327,1339,3575842593,3575842614,21
2,327,1340,3575842593,3575842617,24
2,327,1341,3575842593,3575842620,27
2,327,1342,3575842593,3575842620,27
2,327,1343,3575842593,3575842622,29
2,327,1344,3575842593,3575842627,34
2,327,1345,3575842593,3575842639,46
2,328,1346,3575842645,3575842645,0
2,328,1347,3575842645,3575842646,1
2,328,1348,3575842645,3575842651,6
2,328,1349,3575842645,3575842651,6
2,328,1350,3575842645,3575842655,10
2,328,1351,3575842645,3575842663,18
2,328,1352,3575842645,3575842668,23
2,328,1353,3575842645,3575842677,32
2,328,1354,3575842645,3575842680,35
2,328,1355,3575842645,3575842684,39
2,328,1356,3575842645,3575842689,44
2,328,1357,3575842645,3575842691,46
2,328,1358,3575842645,3575842693,48
2,329,1359,3575842697,3575842697,0
2,329,1360,3575842697,3575842701,4
2,329,1361,3575842697,3575842706,9
2,329,1362,3575842697,3575842712,15
2,329,1363,3575842697,3575842715,18
2,329,1364,3575842697,3575842726,29
2,329,1365,3575842697,3575842727,30
2,329,1366,3575842697,3575842727,30
2,329,1367,3575842697,3575842732,35
2,329,1368,3575842697,3575842734,37
2,329,1369,3575842697,3575842738,41
2,330,1370,3575842749,3575842756,7
2,330,1371,3575842749,3575842763,14
2,330,1372,3575842749,3575842765,16
2,330,1373,3575842749,3575842766,17
2,330,1374,3575842749,3575842767,18
2,330,1375,3575842749,3575842769,20
2,330,1376,3575842749,3575842783,34
2,330,1377,3575842749,3575842785,36
2,330,1378,3575842749,3575842785,36
2,330,1379,3575842749,3575842788,39
2,330,1380,3575842749,3575842791,42
2,330,1381,3575842749,3575842791,42
2,330,1382,3575842749,3575842794,45
2,330,1383,3575842749,3575842795,46
2,331,1384,3575842802,3575842814,12
2,331,1385,3575842802,3575842817,15
2,331,1386,3575842802,3575842819,17
2,331,1387,3575842802,3575842821,19
2,331,1388,3575842802,3575842822,20
2,331,1389,3575842802,3575842829,27
2,331,1390,3575842802,3575842838,36
2,331,1391,3575842802,3575842844,42
2,331,1392,3575842802,3575842847,45
2,331,1393,3575842802,3575842851,49
2,331,1394,3575842802,3575842851,49
2,332,1395,3575842854,3575842855,1
2,332,1396,3575842854,3575842863,9
2,332,1397,3575842854,3575842868,14
2,332,1398,3575842854,3575842878,24
2,332,1399,3575842854,3575842880,26
2,332,1400,3575842854,3575842884,30
2,332,1401,3575842854,3575842889,35
2,332,1402,3575842854,3575842892,38
2,332,1403,3575842854,3575842893,39
2,332,1404,3575842854,3575842897,43
2,332,1405,3575842854,3575842901,47
2,332,1406,3575842854,3575842902,48
2,333,1407,3575842906,3575842907,1
2,333,1408,3575842906,3575842911,5
2,333,1409,3575842906,3575842915,9
2,333,1410,3575842906,3575842926,20
2,333,1411,3575842906,3575842926,20
2,333,1412,3575842906,3575842928,22
2,333,1413,3575842906,3575842932,26
2,333,1414,3575842906,3575842934,28
2,333,1415,3575842906,3575842938,32
2,334,1416,3575842958,3575842958,0
2,334,1417,3575842958,3575842963,5
2,334,1418,3575842958,3575842966,8
2,334,1419,3575842958,3575842967,9
2,334,1420,3575842958,3575842967,9
2,334,1421,3575842958,3575842969,11
2,334,1422,3575842958,3575842984,26
2,334,1423,3575842958,3575842984,26
2,334,1424,3575842958,3575842985,27
2,334,1425,3575842958,3575842988,30
2,334,1426,3575842958,3575842990,32
2,334,1427,3575842958,3575842990,32
2,334,1428,3575842958,3575842994,36
2,334,1429,3575842958,3575842995,37
2,335,1430,3575843011,3575843014,3
2,335,1431,3575843011,3575843017,6
2,335,1432,3575843011,3575843020,9
2,335,1433,3575843011,3575843021,10
2,335,1434,3575843011,3575843022,11
2,335,1435,3575843011,3575843029,18
2,335,1436,3575843011,3575843039,28
2,335,1437,3575843011,3575843044,33
2,335,1438,3575843011,3575843048,37
2,335,1439,3575843011,3575843051,40
2,335,1440,3575843011,3575843051,40
2,335,1441,3575843011,3575843056,45
2,336,1442,3575843063,3575843063,0
2,336,1443,3575843063,3575843069,6
2,336,1444,3575843063,3575843077,14
2,336,1445,3575843063,3575843080,17
2,336,1446,3575843063,3575843084,21
2,336,1447,3575843063,3575843089,26
2,336,1448,3575843063,3575843092,29
2,336,1449,3575843063,3575843093,30
2,336,1450,3575843063,3575843097,34
2,336,1451,3575843063,3575843101,38
2,336,1452,3575843063,3575843103,40
2,336,1453,3575843063,3575843107,44
2,336,1454,3575843063,3575843112,49
2,337,1455,3575843115,3575843115,0
2,337,1456,3575843115,3575843125,10
2,337,1457,3575843115,3575843127,12
2,337,1458,3575843115,3575843127,12
2,337,1459,3575843115,3575843132,17
2,337,1460,3575843115,3575843134,19
2,337,1461,3575843115,3575843138,23
2,337,1462,3575843115,3575843146,31
2,337,1463,3575843115,3575843158,43
2,337,1464,3575843115,3575843163,48
2,338,1465,3575843167,3575843167,0
2,338,1466,3575843167,3575843167,0
2,338,1467,3575843167,3575843170,3
2,338,1468,3575843167,3575843183,16
2,338,1469,3575843167,3575843185,18
2,338,1470,3575843167,3575843185,18
2,338,1471,3575843167,3575843189,22
2,338,1472,3575843167,3575843190,23
2,338,1473,3575843167,3575843191,24
2,338,1474,3575843167,3575843194,27
2,338,1475,3575843167,3575843195,28
2,338,1476,3575843167,3575843215,48
2,339,1477,3575843219,3575843219,0
2,339,1478,3575843219,3575843221,2
2,339,1479,3575843219,3575843222,3
2,339,1480,3575843219,3575843229,10
2,339,1481,3575843219,3575843239,20
2,339,1482,3575843219,3575843245,26
2,339,1483,3575843219,3575843248,29
2,339,1484,3575843219,3575843251,32
2,339,1485,3575843219,3575843252,33
2,339,1486,3575843219,3575843255,36
2,339,1487,3575843219,3575843263,44
2,340,1488,3575843271,3575843271,0
2,340,1489,3575843271,3575843277,6
2,340,1490,3575843271,3575843281,10
2,340,1491,3575843271,3575843284,13
2,340,1492,3575843271,3575843289,18
2,340,1493,3575843271,3575843291,20
2,340,1494,3575843271,3575843293,22
2,340,1495,3575843271,3575843298,27
2,340,1496,3575843271,3575843302,31
2,340,1497,3575843271,3575843303,32
2,340,1498,3575843271,3575843307,36
2,340,1499,3575843271,3575843311,40
2,340,1500,3575843271,3575843315,44
2,341,1501,3575843323,3575843326,3
2,341,1502,3575843323,3575843327,4
2,341,1503,3575843323,3575843327,4
2,341,1504,3575843323,3575843333,10
2,341,1505,3575843323,3575843335,12
2,341,1506,3575843323,3575843338,15
2,341,1507,3575843323,3575843346,23
2,341,1508,3575843323,3575843358,35
2,341,1509,3575843323,3575843363,40
2,341,1510,3575843323,3575843366,43
2,341,1511,3575843323,3575843367,44
2,341,1512,3575843323,3575843367,44
2,341,1513,3575843323,3575843370,47
2,342,1514,3575843375,3575843377,2
2,342,1515,3575843375,3575843384,9
2,342,1516,3575843375,3575843385,10
2,342,1517,3575843375,3575843386,11
2,342,1518,3575843375,3575843389,14
2,342,1519,3575843375,3575843390,15
2,342,1520,3575843375,3575843391,16
2,342,1521,3575843375,3575843395,20
2,342,1522,3575843375,3575843396,21
2,342,1523,3575843375,3575843414,39
2,342,1524,3575843375,3575843415,40
2,342,1525,3575843375,3575843419,44
2,342,1526,3575843375,3575843421,46
2,342,1527,3575843375,3575843422,47
2,342,1528,3575843375,3575843423,48
2,343,1529,3575843428,3575843429,1
2,343,1530,3575843428,3575843438,10
2,343,1531,3575843428,3575843445,17
2,343,1532,3575843428,3575843448,20
2,343,1533,3575843428,3575843450,22
2,343,1534,3575843428,3575843453,25
2,343,1535,3575843428,3575843456,28
2,343,1536,3575843428,3575843463,35
2,343,1537,3575843428,3575843468,40
2,343,1538,3575843428,3575843477,49
2,344,1539,3575843481,3575843481,0
2,344,1540,3575843481,3575843483,2
2,344,1541,3575843481,3575843488,7
2,344,1542,3575843481,3575843491,10
2,344,1543,3575843481,3575843492,11
2,344,1544,3575843481,3575843497,16
2,344,1545,3575843481,3575843500,19
2,344,1546,3575843481,3575843501,20
2,344,1547,3575843481,3575843506,25
2,344,1548,3575843481,3575843511,30
2,344,1549,3575843481,3575843514,33
2,344,1550,3575843481,3575843525,44
2,344,1551,3575843481,3575843526,45
2,344,1552,3575843481,3575843526,45
2,345,1553,3575843533,3575843533,0
2,345,1554,3575843533,3575843533,0
2,345,1555,3575843533,3575843538,5
2,345,1556,3575843533,3575843545,12
2,345,1557,3575843533,3575843556,23
2,345,1558,3575843533,3575843561,28
2,345,1559,3575843533,3575843566,33
2,345,1560,3575843533,3575843567,34
2,345,1561,3575843533,3575843569,36
2,345,1562,3575843533,3575843576,43
2,345,1563,3575843533,3575843582,49
2,346,1564,3575843585,3575843585,0
2,346,1565,3575843585,3575843585,0
2,346,1566,3575843585,3575843588,3
2,346,1567,3575843585,3575843590,5
2,346,1568,3575843585,3575843594,9
2,346,1569,3575843585,3575843596,11
2,346,1570,3575843585,3575843613,28
2,346,1571,3575843585,3575843614,29
2,346,1572,3575843585,3575843617,32
2,346,1573,3575843585,3575843619,34
2,346,1574,3575843585,3575843621,36
2,346,1575,3575843585,3575843622,37
2,346,1576,3575843585,3575843627,42
2,347,1577,3575843637,3575843638,1
2,347,1578,3575843637,3575843644,7
2,347,1579,3575843637,3575843647,10
2,347,1580,3575843637,3575843650,13
2,347,1581,3575843637,3575843651,14
2,347,1582,3575843637,3575843654,17
2,347,1583,3575843637,3575843663,26
2,347,1584,3575843637,3575843667,30
2,347,1585,3575843637,3575843678,41
2,347,1586,3575843637,3575843680,43
2,347,1587,3575843637,3575843682,45
2,348,1588,3575843689,3575843689,0
2,348,1589,3575843689,3575843691,2
2,348,1590,3575843689,3575843697,8
2,348,1591,3575843689,3575843700,11
2,348,1592,3575843689,3575843701,12
2,348,1593,3575843689,3575843706,17
2,348,1594,3575843689,3575843712,23
2,348,1595,3575843689,3575843716,27
2,348,1596,3575843689,3575843716,27
2,348,1597,3575843689,3575843725,36
2,348,1598,3575843689,3575843727,38
2,348,1599,3575843689,3575843727,38
2,348,1600,3575843689,3575843731,42
2,348,1601,3575843689,3575843733,44
2,348,1602,3575843689,3575843733,44
2,348,1603,3575843689,3575843738,49
2,349,1604,3575843741,3575843745,4
2,349,1605,3575843741,3575843757,16
2,349,1606,3575843741,3575843762,21
2,349,1607,3575843741,3575843766,25
2,349,1608,3575843741,3575843766,25
2,349,1609,3575843741,3575843767,26
2,349,1610,3575843741,3575843769,28
2,349,1611,3575843741,3575843778,37
2,349,1612,3575843741,3575843782,41
2,349,1613,3575843741,3575843785,44
2,349,1614,3575843741,3575843785,44
2,349,1615,3575843741,3575843788,47
2,350,1616,3575843793,3575843793,0
2,350,1617,3575843793,3575843793,0
2,350,1618,3575843793,3575843795,2
2,350,1619,3575843793,3575843813,20
2,350,1620,3575843793,3575843815,22
2,350,1621,3575843793,3575843818,25
2,350,1622,3575843793,3575843820,27
2,350,1623,3575843793,3575843820,27
2,350,1624,3575843793,3575843822,29
2,350,1625,3575843793,3575843824,31
2,350,1626,3575843793,3575843829,36
2,350,1627,3575843793,3575843837,44
2,351,1628,3575843845,3575843845,0
2,351,1629,3575843845,3575843847,2
2,351,1630,3575843845,3575843850,5
2,351,1631,3575843845,3575843851,6
2,351,1632,3575843845,3575843855,10
2,351,1633,3575843845,3575843863,18
2,351,1634,3575843845,3575843868,23
2,351,1635,3575843845,3575843877,32
2,351,1636,3575843845,3575843880,35
2,351,1637,3575843845,3575843883,38
2,351,1638,3575843845,3575843888,43
2,351,1639,3575843845,3575843892,47
2,352,1640,3575843897,3575843897,0
2,352,1641,3575843897,3575843900,3
2,352,1642,3575843897,3575843902,5
2,352,1643,3575843897,3575843907,10
2,352,1644,3575843897,3575843912,15
2,352,1645,3575843897,3575843915,18
2,352,1646,3575843897,3575843916,19
2,352,1647,3575843897,3575843924,27
2,352,1648,3575843897,3575843926,29
2,352,1649,3575843897,3575843928,31
2,352,1650,3575843897,3575843931,34
2,352,1651,3575843897,3575843932,35
2,352,1652,3575843897,3575843934,37
2,352,1653,3575843897,3575843938,41
2,352,1654,3575843897,3575843945,48
2,353,1655,3575843949,3575843957,8
2,353,1656,3575843949,3575843961,12
2,353,1657,3575843949,3575843966,17
2,353,1658,3575843949,3575843967,18
2,353,1659,3575843949,3575843968,19
2,353,1660,3575843949,3575843970,21
2,353,1661,3575843949,3575843977,28
2,353,1662,3575843949,3575843982,33
2,353,1663,3575843949,3575843985,36
2,353,1664,3575843949,3575843988,39
2,353,1665,3575843949,3575843992,43
2,353,1666,3575843949,3575843994,45
2,353,1667,3575843949,3575843996,47
2,354,1668,3575844001,3575844012,11
2,354,1669,3575844001,3575844014,13
2,354,1670,3575844001,3575844017,16
2,354,1671,3575844001,3575844020,19
2,354,1672,3575844001,3575844021,20
2,354,1673,3575844001,3575844022,21
2,354,1674,3575844001,3575844023,22
2,354,1675,3575844001,3575844029,28
2,354,1676,3575844001,3575844038,37
2,354,1677,3575844001,3575844045,44
2,354,1678,3575844001,3575844047,46
2,354,1679,3575844001,3575844050,49
2,355,1680,3575844054,3575844054,0
2,355,1681,3575844054,3575844056,2
2,355,1682,3575844054,3575844063,9
2,355,1683,3575844054,3575844069,15
2,355,1684,3575844054,3575844077,23
2,355,1685,3575844054,3575844081,27
2,355,1686,3575844054,3575844083,29
2,355,1687,3575844054,3575844088,34
2,355,1688,3575844054,3575844092,38
2,355,1689,3575844054,3575844097,43
2,355,1690,3575844054,3575844100,46
2,355,1691,3575844054,3575844102,48
2,356,1692,3575844106,3575844113,7
2,356,1693,3575844106,3575844115,9
2,356,1694,3575844106,3575844116,10
2,356,1695,3575844106,3575844121,15
2,356,1696,3575844106,3575844125,19
2,356,1697,3575844106,3575844127,21
2,356,1698,3575844106,3575844128,22
2,356,1699,3575844106,3575844132,26
2,356,1700,3575844106,3575844133,27
2,356,1701,3575844106,3575844134,28
2,356,1702,3575844106,3575844138,32
2,356,1703,3575844106,3575844145,39
2,357,1704,3575844158,3575844158,0
2,357,1705,3575844158,3575844162,4
2,357,1706,3575844158,3575844165,7
2,357,1707,3575844158,3575844167,9
2,357,1708,3575844158,3575844168,10
2,357,1709,3575844158,3575844170,12
2,357,1710,3575844158,3575844178,20
2,357,1711,3575844158,3575844184,26
2,357,1712,3575844158,3575844185,27
2,357,1713,3575844158,3575844185,27
2,357,1714,3575844158,3575844188,30
2,357,1715,3575844158,3575844190,32
2,357,1716,3575844158,3575844192,34
2,357,1717,3575844158,3575844194,36
2,357,1718,3575844158,3575844197,39
2,358,1719,3575844210,3575844213,3
2,358,1720,3575844210,3575844214,4
2,358,1721,3575844210,3575844218,8
2,358,1722,3575844210,3575844220,10
2,358,1723,3575844210,3575844220,10
2,358,1724,3575844210,3575844222,12
2,358,1725,3575844210,3575844223,13
2,358,1726,3575844210,3575844228,18
2,358,1727,3575844210,3575844237,27
2,358,1728,3575844210,3575844244,34
2,358,1729,3575844210,3575844247,37
2,358,1730,3575844210,3575844250,40
2,358,1731,3575844210,3575844251,41
2,358,1732,3575844210,3575844256,46
2,359,1733,3575844262,3575844263,1
2,359,1734,3575844262,3575844269,7
2,359,1735,3575844262,3575844273,11
2,359,1736,3575844262,3575844277,15
2,359,1737,3575844262,3575844282,20
2,359,1738,3575844262,3575844284,22
2,359,1739,3575844262,3575844289,27
2,359,1740,3575844262,3575844292,30
2,359,1741,3575844262,3575844297,35
2,359,1742,3575844262,3575844300,38
2,359,1743,3575844262,3575844302,40
2,360,1744,3575844314,3575844314,0
2,360,1745,3575844314,3575844315,1
2,360,1746,3575844314,3575844316,2
2,360,1747,3575844314,3575844322,8
2,360,1748,3575844314,3575844325,11
2,360,1749,3575844314,3575844327,13
2,360,1750,3575844314,3575844328,14
2,360,1751,3575844314,3575844331,17
2,360,1752,3575844314,3575844332,18
2,360,1753,3575844314,3575844335,21
2,360,1754,3575844314,3575844337,23
2,360,1755,3575844314,3575844346,32
2,360,1756,3575844314,3575844357,43
2,360,1757,3575844314,3575844362,48
2,361,1758,3575844366,3575844366,0
2,361,1759,3575844366,3575844367,1
2,361,1760,3575844366,3575844369,3
2,361,1761,3575844366,3575844370,4
2,361,1762,3575844366,3575844375,9
2,361,1763,3575844366,3575844378,12
2,361,1764,3575844366,3575844383,17
2,361,1765,3575844366,3575844386,20
2,361,1766,3575844366,3575844386,20
2,361,1767,3575844366,3575844388,22
2,361,1768,3575844366,3575844390,24
2,361,1769,3575844366,3575844392,26
2,361,1770,3575844366,3575844394,28
2,361,1771,3575844366,3575844397,31
2,361,1772,3575844366,3575844412,46
2,361,1773,3575844366,3575844414,48
2,362,1774,3575844418,3575844418,0
2,362,1775,3575844418,3575844421,3
2,362,1776,3575844418,3575844423,5
2,362,1777,3575844418,3575844423,5
2,362,1778,3575844418,3575844429,11
2,362,1779,3575844418,3575844438,20
2,362,1780,3575844418,3575844445,27
2,362,1781,3575844418,3575844447,29
2,362,1782,3575844418,3575844450,32
2,362,1783,3575844418,3575844451,33
2,362,1784,3575844418,3575844455,37
2,362,1785,3575844418,3575844463,45
2,363,1786,3575844470,3575844470,0
2,363,1787,3575844470,3575844473,3
2,363,1788,3575844470,3575844478,8
2,363,1789,3575844470,3575844481,11
2,363,1790,3575844470,3575844484,14
2,363,1791,3575844470,3575844489,19
2,363,1792,3575844470,3575844492,22
2,363,1793,3575844470,3575844498,28
2,363,1794,3575844470,3575844500,30
2,363,1795,3575844470,3575844502,32
2,363,1796,3575844470,3575844507,37
2,363,1797,3575844470,3575844513,43
2,363,1798,3575844470,3575844516,46
2,363,1799,3575844470,3575844516,46
2,364,1800,3575844522,3575844522,0
2,364,1801,3575844522,3575844523,1
2,364,1802,3575844522,3575844526,4
2,364,1803,3575844522,3575844527,5
2,364,1804,3575844522,3575844530,8
2,364,1805,3575844522,3575844532,10
2,364,1806,3575844522,3575844534,12
2,364,1807,3575844522,3575844537,15
2,364,1808,3575844522,3575844545,23
2,364,1809,3575844522,3575844557,35
2,364,1810,3575844522,3575844562,40
2,364,1811,3575844522,3575844564,42
2,364,1812,3575844522,3575844566,44
2,364,1813,3575844522,3575844568,46
2,364,1814,3575844522,3575844569,47
2,365,1815,3575844574,3575844574,0
2,365,1816,3575844574,3575844576,2
2,365,1817,3575844574,3575844582,8
2,365,1818,3575844574,3575844585,11
2,365,1819,3575844574,3575844585,11
2,365,1820,3575844574,3575844587,13
2,365,1821,3575844574,3575844588,14
2,365,1822,3575844574,3575844591,17
2,365,1823,3575844574,3575844593,19
2,365,1824,3575844574,3575844596,22
2,365,1825,3575844574,3575844612,38
2,365,1826,3575844574,3575844615,41
2,365,1827,3575844574,3575844617,43
2,365,1828,3575844574,3575844620,46
2,365,1829,3575844574,3575844622,48
2,365,1830,3575844574,3575844623,49
2,366,1831,3575844626,3575844627,1
2,366,1832,3575844626,3575844638,12
2,366,1833,3575844626,3575844644,18
2,366,1834,3575844626,3575844646,20
2,366,1835,3575844626,3575844649,23
2,366,1836,3575844626,3575844651,25
2,366,1837,3575844626,3575844655,29
2,366,1838,3575844626,3575844663,37
2,366,1839,3575844626,3575844668,42
2,366,1840,3575844626,3575844674,48
2,367,1841,3575844678,3575844678,0
2,367,1842,3575844678,3575844679,1
2,367,1843,3575844678,3575844681,3
2,367,1844,3575844678,3575844684,6
2,367,1845,3575844678,3575844689,11
2,367,1846,3575844678,3575844693,15
2,367,1847,3575844678,3575844697,19
2,367,1848,3575844678,3575844700,22
2,367,1849,3575844678,3575844703,25
2,367,1850,3575844678,3575844707,29
2,367,1851,3575844678,3575844712,34
2,367,1852,3575844678,3575844715,37
2,367,1853,3575844678,3575844717,39
2,367,1854,3575844678,3575844721,43
2,367,1855,3575844678,3575844723,45
2,367,1856,3575844678,3575844727,49
2,367,1857,3575844678,3575844727,49
2,368,1858,3575844730,3575844731,1
2,368,1859,3575844730,3575844731,1
2,368,1860,3575844730,3575844734,4
2,368,1861,3575844730,3575844738,8
2,368,1862,3575844730,3575844739,9
2,368,1863,3575844730,3575844744,14
2,368,1864,3575844730,3575844757,27
2,368,1865,3575844730,3575844761,31
2,368,1866,3575844730,3575844765,35
2,368,1867,3575844730,3575844767,37
2,368,1868,3575844730,3575844768,38
2,368,1869,3575844730,3575844769,39
2,368,1870,3575844730,3575844773,43
2,368,1871,3575844730,3575844777,47
2,369,1872,3575844782,3575844783,1
2,369,1873,3575844782,3575844784,2
2,369,1874,3575844782,3575844785,3
2,369,1875,3575844782,3575844788,6
2,369,1876,3575844782,3575844788,6
2,369,1877,3575844782,3575844790,8
2,369,1878,3575844782,3575844791,9
2,369,1879,3575844782,3575844793,11
2,369,1880,3575844782,3575844796,14
2,369,1881,3575844782,3575844811,29
2,369,1882,3575844782,3575844815,33
2,369,1883,3575844782,3575844817,35
2,369,1884,3575844782,3575844823,41
2,369,1885,3575844782,3575844823,41
2,369,1886,3575844782,3575844829,47
2,370,1887,3575844835,3575844838,3
2,370,1888,3575844835,3575844846,11
2,370,1889,3575844835,3575844849,14
2,370,1890,3575844835,3575844851,16
2,370,1891,3575844835,3575844856,21
2,370,1892,3575844835,3575844863,28
2,370,1893,3575844835,3575844868,33
2,370,1894,3575844835,3575844874,39
2,370,1895,3575844835,3575844878,43
2,370,1896,3575844835,3575844878,43
2,370,1897,3575844835,3575844881,46
2,370,1898,3575844835,3575844881,46
2,370,1899,3575844835,3575844884,49
2,371,1900,3575844888,3575844889,1
2,371,1901,3575844888,3575844892,4
2,371,1902,3575844888,3575844897,9
2,371,1903,3575844888,3575844900,12
2,371,1904,3575844888,3575844903,15
2,371,1905,3575844888,3575844907,19
2,371,1906,3575844888,3575844912,24
2,371,1907,3575844888,3575844915,27
2,371,1908,3575844888,3575844916,28
2,371,1909,3575844888,3575844920,32
2,371,1910,3575844888,3575844923,35
2,371,1911,3575844888,3575844927,39
2,371,1912,3575844888,3575844928,40
2,371,1913,3575844888,3575844931,43
2,371,1914,3575844888,3575844931,43
2,371,1915,3575844888,3575844935,47
2,372,1916,3575844941,3575844941,0
2,372,1917,3575844941,3575844941,0
2,372,1918,3575844941,3575844945,4
2,372,1919,3575844941,3575844957,16
2,372,1920,3575844941,3575844962,21
2,372,1921,3575844941,3575844965,24
2,372,1922,3575844941,3575844967,26
2,372,1923,3575844941,3575844968,27
2,372,1924,3575844941,3575844969,28
2,372,1925,3575844941,3575844974,33
2,372,1926,3575844941,3575844977,36
2,372,1927,3575844941,3575844982,41
2,372,1928,3575844941,3575844985,44
2,372,1929,3575844941,3575844985,44
2,372,1930,3575844941,3575844987,46
2,372,1931,3575844941,3575844988,47
2,372,1932,3575844941,3575844991,50
2,373,1933,3575844993,3575844993,0
2,373,1934,3575844993,3575844997,4
2,373,1935,3575844993,3575845012,19
2,373,1936,3575844993,3575845015,22
2,373,1937,3575844993,3575845018,25
2,373,1938,3575844993,3575845022,29
2,373,1939,3575844993,3575845023,30
2,373,1940,3575844993,3575845028,35
2,373,1941,3575844993,3575845038,45
2,374,1942,3575845045,3575845045,0
2,374,1943,3575845045,3575845046,1
2,374,1944,3575845045,3575845049,4
2,374,1945,3575845045,3575845052,7
2,374,1946,3575845045,3575845056,11
2,374,1947,3575845045,3575845064,19
2,374,1948,3575845045,3575845069,24
2,374,1949,3575845045,3575845074,29
2,374,1950,3575845045,3575845077,32
2,374,1951,3575845045,3575845079,34
2,374,1952,3575845045,3575845081,36
2,374,1953,3575845045,3575845082,37
2,374,1954,3575845045,3575845084,39
2,374,1955,3575845045,3575845089,44
2,374,1956,3575845045,3575845093,48
2,375,1957,3575845098,3575845098,0
2,375,1958,3575845098,3575845100,2
2,375,1959,3575845098,3575845103,5
2,375,1960,3575845098,3575845108,10
2,375,1961,3575845098,3575845112,14
2,375,1962,3575845098,3575845115,17
2,375,1963,3575845098,3575845116,18
2,375,1964,3575845098,3575845120,22
2,375,1965,3575845098,3575845124,26
2,375,1966,3575845098,3575845126,28
2,375,1967,3575845098,3575845127,29
2,375,1968,3575845098,3575845130,32
2,375,1969,3575845098,3575845132,34
2,375,1970,3575845098,3575845135,37
2,375,1971,3575845098,3575845138,40
2,375,1972,3575845098,3575845140,42
2,375,1973,3575845098,3575845146,48
2,376,1974,3575845150,3575845158,8
2,376,1975,3575845150,3575845162,12
2,376,1976,3575845150,3575845165,15
2,376,1977,3575845150,3575845168,18
2,376,1978,3575845150,3575845170,20
2,376,1979,3575845150,3575845175,25
2,376,1980,3575845150,3575845178,28
2,376,1981,3575845150,3575845183,33
2,376,1982,3575845150,3575845185,35
2,376,1983,3575845150,3575845186,36
2,376,1984,3575845150,3575845186,36
2,376,1985,3575845150,3575845188,38
2,376,1986,3575845150,3575845189,39
2,376,1987,3575845150,3575845190,40
2,376,1988,3575845150,3575845191,41
2,376,1989,3575845150,3575845194,44
2,376,1990,3575845150,3575845196,46
2,377,1991,3575845203,3575845213,10
2,377,1992,3575845203,3575845216,13
2,377,1993,3575845203,3575845218,15
2,377,1994,3575845203,3575845221,18
2,377,1995,3575845203,3575845222,19
2,377,1996,3575845203,3575845224,21
2,377,1997,3575845203,3575845228,25
2,377,1998,3575845203,3575845236,33
2,377,1999,3575845203,3575845238,35
2,377,2000,3575845203,3575845244,41
2,377,2001,3575845203,3575845247,44
2,377,2002,3575845203,3575845248,45
2,377,2003,3575845203,3575845252,49
2,378,2004,3575845255,3575845256,1
2,378,2005,3575845255,3575845264,9
2,378,2006,3575845255,3575845268,13
2,378,2007,3575845255,3575845274,19
2,378,2008,3575845255,3575845277,22
2,378,2009,3575845255,3575845277,22
2,378,2010,3575845255,3575845279,24
2,378,2011,3575845255,3575845281,26
2,378,2012,3575845255,3575845281,26
2,378,2013,3575845255,3575845284,29
2,378,2014,3575845255,3575845289,34
2,378,2015,3575845255,3575845294,39
2,378,2016,3575845255,3575845299,44
2,378,2017,3575845255,3575845301,46
2,378,2018,3575845255,3575845303,48
2,379,2019,3575845307,3575845307,0
2,379,2020,3575845307,3575845313,6
2,379,2021,3575845307,3575845316,9
2,379,2022,3575845307,3575845317,10
2,379,2023,3575845307,3575845321,14
2,379,2024,3575845307,3575845324,17
2,379,2025,3575845307,3575845327,20
2,379,2026,3575845307,3575845327,20
2,379,2027,3575845307,3575845331,24
2,379,2028,3575845307,3575845332,25
2,379,2029,3575845307,3575845335,28
2,379,2030,3575845307,3575845337,30
2,379,2031,3575845307,3575845341,34
2,379,2032,3575845307,3575845345,38
2,380,2033,3575845359,3575845359,0
2,380,2034,3575845359,3575845361,2
2,380,2035,3575845359,3575845366,7
2,380,2036,3575845359,3575845367,8
2,380,2037,3575845359,3575845369,10
2,380,2038,3575845359,3575845370,11
2,380,2039,3575845359,3575845375,16
2,380,2040,3575845359,3575845377,18
2,380,2041,3575845359,3575845384,25
2,380,2042,3575845359,3575845386,27
2,380,2043,3575845359,3575845386,27
2,380,2044,3575845359,3575845387,28
2,380,2045,3575845359,3575845387,28
2,380,2046,3575845359,3575845388,29
2,380,2047,3575845359,3575845390,31
2,380,2048,3575845359,3575845391,32
2,380,2049,3575845359,3575845394,35
2,380,2050,3575845359,3575845397,38
2,381,2051,3575845411,3575845412,1
2,381,2052,3575845411,3575845416,5
2,381,2053,3575845411,3575845418,7
2,381,2054,3575845411,3575845421,10
2,381,2055,3575845411,3575845423,12
2,381,2056,3575845411,3575845424,13
2,381,2057,3575845411,3575845428,17
2,381,2058,3575845411,3575845436,25
2,381,2059,3575845411,3575845437,26
2,381,2060,3575845411,3575845444,33
2,381,2061,3575845411,3575845447,36
2,381,2062,3575845411,3575845450,39
2,381,2063,3575845411,3575845452,41
2,381,2064,3575845411,3575845456,45
2,382,2065,3575845463,3575845464,1
2,382,2066,3575845463,3575845469,6
2,382,2067,3575845463,3575845475,12
2,382,2068,3575845463,3575845477,14
2,382,2069,3575845463,3575845478,15
2,382,2070,3575845463,3575845479,16
2,382,2071,3575845463,3575845481,18
2,382,2072,3575845463,3575845482,19
2,382,2073,3575845463,3575845484,21
2,382,2074,3575845463,3575845489,26
2,382,2075,3575845463,3575845493,30
2,382,2076,3575845463,3575845498,35
2,382,2077,3575845463,3575845501,38
2,382,2078,3575845463,3575845502,39
2,382,2079,3575845463,3575845507,44
2,382,2080,3575845463,3575845512,49
2,383,2081,3575845515,3575845515,0
2,383,2082,3575845515,3575845515,0
2,383,2083,3575845515,3575845520,5
2,383,2084,3575845515,3575845524,9
2,383,2085,3575845515,3575845526,11
2,383,2086,3575845515,3575845526,11
2,383,2087,3575845515,3575845530,15
2,383,2088,3575845515,3575845531,16
2,383,2089,3575845515,3575845534,19
2,383,2090,3575845515,3575845534,19
2,383,2091,3575845515,3575845538,23
2,383,2092,3575845515,3575845540,25
2,383,2093,3575845515,3575845544,29
2,383,2094,3575845515,3575845557,42
2,383,2095,3575845515,3575845561,46
2,383,2096,3575845515,3575845564,49
2,384,2097,3575845567,3575845567,0
2,384,2098,3575845567,3575845568,1
2,384,2099,3575845567,3575845569,2
2,384,2100,3575845567,3575845574,7
2,384,2101,3575845567,3575845577,10
2,384,2102,3575845567,3575845582,15
2,384,2103,3575845567,3575845584,17
2,384,2104,3575845567,3575845585,18
2,384,2105,3575845567,3575845585,18
2,384,2106,3575845567,3575845587,20
2,384,2107,3575845567,3575845588,21
2,384,2108,3575845567,3575845589,22
2,384,2109,3575845567,3575845590,23
2,384,2110,3575845567,3575845592,25
2,384,2111,3575845567,3575845596,29
2,384,2112,3575845567,3575845612,45
2,384,2113,3575845567,3575845615,48
2,384,2114,3575845567,3575845617,50
2,385,2115,3575845619,3575845620,1
2,385,2116,3575845619,3575845622,3
2,385,2117,3575845619,3575845623,4
2,385,2118,3575845619,3575845627,8
2,385,2119,3575845619,3575845635,16
2,385,2120,3575845619,3575845637,18
2,385,2121,3575845619,3575845640,21
2,385,2122,3575845619,3575845643,24
2,385,2123,3575845619,3575845646,27
2,385,2124,3575845619,3575845649,30
2,385,2125,3575845619,3575845651,32
2,385,2126,3575845619,3575845655,36
2,385,2127,3575845619,3575845663,44
2,385,2128,3575845619,3575845668,49
2,386,2129,3575845671,3575845676,5
2,386,2130,3575845671,3575845677,6
2,386,2131,3575845671,3575845678,7
2,386,2132,3575845671,3575845679,8
2,386,2133,3575845671,3575845681,10
2,386,2134,3575845671,3575845681,10
2,386,2135,3575845671,3575845683,12
2,386,2136,3575845671,3575845689,18
2,386,2137,3575845671,3575845694,23
2,386,2138,3575845671,3575845699,28
2,386,2139,3575845671,3575845700,29
2,386,2140,3575845671,3575845702,31
2,386,2141,3575845671,3575845707,36
2,386,2142,3575845671,3575845712,41
2,386,2143,3575845671,3575845715,44
2,386,2144,3575845671,3575845715,44
2,386,2145,3575845671,3575845721,50
2,387,2146,3575845723,3575845724,1
2,387,2147,3575845723,3575845727,4
2,387,2148,3575845723,3575845727,4
2,387,2149,3575845723,3575845730,7
2,387,2150,3575845723,3575845731,8
2,387,2151,3575845723,3575845734,11
2,387,2152,3575845723,3575845734,11
2,387,2153,3575845723,3575845738,15
2,387,2154,3575845723,3575845740,17
2,387,2155,3575845723,3575845745,22
2,387,2156,3575845723,3575845757,34
2,387,2157,3575845723,3575845762,39
2,387,2158,3575845723,3575845766,43
2,387,2159,3575845723,3575845766,43
2,387,2160,3575845723,3575845769,46
2,387,2161,3575845723,3575845769,46
2,388,2162,3575845775,3575845775,0
2,388,2163,3575845775,3575845777,2
2,388,2164,3575845775,3575845782,7
2,388,2165,3575845775,3575845785,10
2,388,2166,3575845775,3575845785,10
2,388,2167,3575845775,3575845785,10
2,388,2168,3575845775,3575845787,12
2,388,2169,3575845775,3575845791,16
2,388,2170,3575845775,3575845793,18
2,388,2171,3575845775,3575845796,21
2,388,2172,3575845775,3575845812,37
2,388,2173,3575845775,3575845815,40
2,388,2174,3575845775,3575845818,43
2,388,2175,3575845775,3575845820,45
2,388,2176,3575845775,3575845822,47
2,388,2177,3575845775,3575845823,48
2,389,2178,3575845827,3575845828,1
2,389,2179,3575845827,3575845835,8
2,389,2180,3575845827,3575845838,11
2,389,2181,3575845827,3575845839,12
2,389,2182,3575845827,3575845846,19
2,389,2183,3575845827,3575845849,22
2,389,2184,3575845827,3575845852,25
2,389,2185,3575845827,3575845856,29
2,389,2186,3575845827,3575845863,36
2,389,2187,3575845827,3575845868,41
2,389,2188,3575845827,3575845876,49
2,390,2189,3575845879,3575845879,0
2,390,2190,3575845879,3575845879,0
2,390,2191,3575845879,3575845881,2
2,390,2192,3575845879,3575845881,2
2,390,2193,3575845879,3575845884,5
2,390,2194,3575845879,3575845886,7
2,390,2195,3575845879,3575845889,10
2,390,2196,3575845879,3575845894,15
2,390,2197,3575845879,3575845899,20
2,390,2198,3575845879,3575845900,21
2,390,2199,3575845879,3575845903,24
2,390,2200,3575845879,3575845907,28
2,390,2201,3575845879,3575845913,34
2,390,2202,3575845879,3575845915,36
2,390,2203,3575845879,3575845915,36
2,390,2204,3575845879,3575845921,42
2,390,2205,3575845879,3575845924,45
2,390,2206,3575845879,3575845927,48
2,390,2207,3575845879,3575845927,48
2,391,2208,3575845931,3575845931,0
2,391,2209,3575845931,3575845931,0
2,391,2210,3575845931,3575845934,3
2,391,2211,3575845931,3575845938,7
2,391,2212,3575845931,3575845940,9
2,391,2213,3575845931,3575845945,14
2,391,2214,3575845931,3575845957,26
2,391,2215,3575845931,3575845962,31
2,391,2216,3575845931,3575845966,35
2,391,2217,3575845931,3575845967,36
2,391,2218,3575845931,3575845969,38
2,391,2219,3575845931,3575845969,38
2,391,2220,3575845931,3575845975,44
2,391,2221,3575845931,3575845978,47
2,392,2222,3575845983,3575845983,0
2,392,2223,3575845983,3575845985,2
2,392,2224,3575845983,3575845985,2
2,392,2225,3575845983,3575845985,2
2,392,2226,3575845983,3575845987,4
2,392,2227,3575845983,3575845990,7
2,392,2228,3575845983,3575845991,8
2,392,2229,3575845983,3575845994,11
2,392,2230,3575845983,3575845997,14
2,392,2231,3575845983,3575846011,28
2,392,2232,3575845983,3575846015,32
2,392,2233,3575845983,3575846017,34
2,392,2234,3575845983,3575846021,38
2,392,2235,3575845983,3575846023,40
2,392,2236,3575845983,3575846023,40
2,392,2237,3575845983,3575846029,46
2,393,2238,3575846036,3575846036,0
2,393,2239,3575846036,3575846038,2
2,393,2240,3575846036,3575846040,4
2,393,2241,3575846036,3575846045,9
2,393,2242,3575846036,3575846046,10
2,393,2243,3575846036,3575846046,10
2,393,2244,3575846036,3575846049,13
2,393,2245,3575846036,3575846052,16
2,393,2246,3575846036,3575846057,21
2,393,2247,3575846036,3575846064,28
2,393,2248,3575846036,3575846069,33
2,393,2249,3575846036,3575846076,40
2,393,2250,3575846036,3575846078,42
2,393,2251,3575846036,3575846079,43
2,393,2252,3575846036,3575846081,45
2,393,2253,3575846036,3575846082,46
2,393,2254,3575846036,3575846084,48
2,393,2255,3575846036,3575846086,50
2,394,2256,3575846088,3575846089,1
2,394,2257,3575846088,3575846094,6
2,394,2258,3575846088,3575846097,9
2,394,2259,3575846088,3575846099,11
2,394,2260,3575846088,3575846100,12
2,394,2261,3575846088,3575846102,14
2,394,2262,3575846088,3575846107,19
2,394,2263,3575846088,3575846112,24
2,394,2264,3575846088,3575846115,27
2,394,2265,3575846088,3575846122,34
2,394,2266,3575846088,3575846124,36
2,394,2267,3575846088,3575846127,39
2,394,2268,3575846088,3575846127,39
2,394,2269,3575846088,3575846131,43
2,394,2270,3575846088,3575846132,44
2,394,2271,3575846088,3575846134,46
2,394,2272,3575846088,3575846138,50
2,395,2273,3575846140,3575846140,0
2,395,2274,3575846140,3575846146,6
2,395,2275,3575846140,3575846147,7
2,395,2276,3575846140,3575846158,18
2,395,2277,3575846140,3575846162,22
2,395,2278,3575846140,3575846166,26
2,395,2279,3575846140,3575846169,29
2,395,2280,3575846140,3575846169,29
2,395,2281,3575846140,3575846175,35
2,395,2282,3575846140,3575846178,38
2,395,2283,3575846140,3575846183,43
2,395,2284,3575846140,3575846185,45
2,395,2285,3575846140,3575846185,45
2,395,2286,3575846140,3575846185,45
2,395,2287,3575846140,3575846187,47
2,395,2288,3575846140,3575846188,48
2,396,2289,3575846192,3575846192,0
2,396,2290,3575846192,3575846192,0
2,396,2291,3575846192,3575846194,2
2,396,2292,3575846192,3575846198,6
2,396,2293,3575846192,3575846212,20
2,396,2294,3575846192,3575846215,23
2,396,2295,3575846192,3575846218,26
2,396,2296,3575846192,3575846221,29
2,396,2297,3575846192,3575846223,31
2,396,2298,3575846192,3575846223,31
2,396,2299,3575846192,3575846228,36
2,396,2300,3575846192,3575846235,43
2,396,2301,3575846192,3575846237,45
2,396,2302,3575846192,3575846239,47
2,397,2303,3575846244,3575846245,1
2,397,2304,3575846244,3575846246,2
2,397,2305,3575846244,3575846247,3
2,397,2306,3575846244,3575846249,5
2,397,2307,3575846244,3575846252,8
2,397,2308,3575846244,3575846257,13
2,397,2309,3575846244,3575846264,20
2,397,2310,3575846244,3575846268,24
2,397,2311,3575846244,3575846276,32
2,397,2312,3575846244,3575846278,34
2,397,2313,3575846244,3575846278,34
2,397,2314,3575846244,3575846279,35
2,397,2315,3575846244,3575846281,37
2,397,2316,3575846244,3575846282,38
2,397,2317,3575846244,3575846284,40
2,397,2318,3575846244,3575846286,42
2,397,2319,3575846244,3575846289,45
2,397,2320,3575846244,3575846294,50
2,398,2321,3575846296,3575846298,2
2,398,2322,3575846296,3575846298,2
2,398,2323,3575846296,3575846300,4
2,398,2324,3575846296,3575846302,6
2,398,2325,3575846296,3575846308,12
2,398,2326,3575846296,3575846312,16
2,398,2327,3575846296,3575846323,27
2,398,2328,3575846296,3575846323,27
2,398,2329,3575846296,3575846327,31
2,398,2330,3575846296,3575846327,31
2,398,2331,3575846296,3575846330,34
2,398,2332,3575846296,3575846333,37
2,398,2333,3575846296,3575846334,38
2,398,2334,3575846296,3575846337,41
2,398,2335,3575846296,3575846340,44
2,398,2336,3575846296,3575846346,50
2,399,2337,3575846348,3575846349,1
2,399,2338,3575846348,3575846350,2
2,399,2339,3575846348,3575846359,11
2,399,2340,3575846348,3575846361,13
2,399,2341,3575846348,3575846367,19
2,399,2342,3575846348,3575846369,21
2,399,2343,3575846348,3575846369,21
2,399,2344,3575846348,3575846375,27
2,399,2345,3575846348,3575846377,29
2,399,2346,3575846348,3575846383,35
2,399,2347,3575846348,3575846386,38
2,399,2348,3575846348,3575846386,38
2,399,2349,3575846348,3575846386,38
2,399,2350,3575846348,3575846387,39
2,399,2351,3575846348,3575846388,40
2,399,2352,3575846348,3575846391,43
2,399,2353,3575846348,3575846392,44
2,399,2354,3575846348,3575846394,46
2,399,2355,3575846348,3575846398,50
2,400,2356,3575846400,3575846401,1
2,400,2357,3575846400,3575846412,12
2,400,2358,3575846400,3575846415,15
2,400,2359,3575846400,3575846418,18
2,400,2360,3575846400,3575846421,21
2,400,2361,3575846400,3575846423,23
2,400,2362,3575846400,3575846423,23
2,400,2363,3575846400,3575846428,28
2,400,2364,3575846400,3575846435,35
2,400,2365,3575846400,3575846438,38
2,400,2366,3575846400,3575846440,40
2,400,2367,3575846400,3575846445,45
2,400,2368,3575846400,3575846446,46
2,400,2369,3575846400,3575846447,47
2,400,2370,3575846400,3575846450,50
2,401,2371,3575846452,3575846453,1
2,401,2372,3575846452,3575846456,4
2,401,2373,3575846452,3575846465,13
2,401,2374,3575846452,3575846469,17
2,401,2375,3575846452,3575846475,23
2,401,2376,3575846452,3575846477,25
2,401,2377,3575846452,3575846479,27
2,401,2378,3575846452,3575846479,27
2,401,2379,3575846452,3575846482,30
2,401,2380,3575846452,3575846482,30
2,401,2381,3575846452,3575846484,32
2,401,2382,3575846452,3575846486,34
2,401,2383,3575846452,3575846489,37
2,401,2384,3575846452,3575846494,42
2,401,2385,3575846452,3575846498,46
2,401,2386,3575846452,3575846499,47
2,401,2387,3575846452,3575846501,49
2,402,2388,3575846505,3575846505,0
2,402,2389,3575846505,3575846507,2
2,402,2390,3575846505,3575846511,6
2,402,2391,3575846505,3575846514,9
2,402,2392,3575846505,3575846522,17
2,402,2393,3575846505,3575846524,19
2,402,2394,3575846505,3575846526,21
2,402,2395,3575846505,3575846526,21
2,402,2396,3575846505,3575846529,24
2,402,2397,3575846505,3575846532,27
2,402,2398,3575846505,3575846533,28
2,402,2399,3575846505,3575846537,32
2,402,2400,3575846505,3575846539,34
2,402,2401,3575846505,3575846544,39
2,402,2402,3575846505,3575846546,41
2,402,2403,3575846505,3575846549,44
2,402,2404,3575846505,3575846551,46
2,403,2405,3575846558,3575846558,0
2,403,2406,3575846558,3575846561,3
2,403,2407,3575846558,3575846565,7
2,403,2408,3575846558,3575846568,10
2,403,2409,3575846558,3575846569,11
2,403,2410,3575846558,3575846573,15
2,403,2411,3575846558,3575846577,19
2,403,2412,3575846558,3575846582,24
2,403,2413,3575846558,3575846584,26
2,403,2414,3575846558,3575846585,27
2,403,2415,3575846558,3575846585,27
2,403,2416,3575846558,3575846587,29
2,403,2417,3575846558,3575846588,30
2,403,2418,3575846558,3575846590,32
2,403,2419,3575846558,3575846591,33
2,403,2420,3575846558,3575846593,35
2,403,2421,3575846558,3575846596,38
2,403,2422,3575846558,3575846600,42
2,404,2423,3575846610,3575846611,1
2,404,2424,3575846610,3575846615,5
2,404,2425,3575846610,3575846616,6
2,404,2426,3575846610,3575846620,10
2,404,2427,3575846610,3575846622,12
2,404,2428,3575846610,3575846623,13
2,404,2429,3575846610,3575846628,18
2,404,2430,3575846610,3575846635,25
2,404,2431,3575846610,3575846638,28
2,404,2432,3575846610,3575846639,29
2,404,2433,3575846610,3575846644,34
2,404,2434,3575846610,3575846646,36
2,404,2435,3575846610,3575846646,36
2,404,2436,3575846610,3575846649,39
2,404,2437,3575846610,3575846652,42
2,404,2438,3575846610,3575846656,46
2,405,2439,3575846662,3575846664,2
2,405,2440,3575846662,3575846668,6
2,405,2441,3575846662,3575846675,13
2,405,2442,3575846662,3575846677,15
2,405,2443,3575846662,3575846678,16
2,405,2444,3575846662,3575846679,17
2,405,2445,3575846662,3575846682,20
2,405,2446,3575846662,3575846683,21
2,405,2447,3575846662,3575846685,23
2,405,2448,3575846662,3575846686,24
2,405,2449,3575846662,3575846689,27
2,405,2450,3575846662,3575846693,31
2,405,2451,3575846662,3575846698,36
2,405,2452,3575846662,3575846699,37
2,405,2453,3575846662,3575846702,40
2,405,2454,3575846662,3575846703,41
2,405,2455,3575846662,3575846705,43
2,405,2456,3575846662,3575846712,50
2,406,2457,3575846714,3575846715,1
2,406,2458,3575846714,3575846722,8
2,406,2459,3575846714,3575846723,9
2,406,2460,3575846714,3575846727,13
2,406,2461,3575846714,3575846727,13
2,406,2462,3575846714,3575846729,15
2,406,2463,3575846714,3575846733,19
2,406,2464,3575846714,3575846733,19
2,406,2465,3575846714,3575846737,23
2,406,2466,3575846714,3575846739,25
2,406,2467,3575846714,3575846745,31
2,406,2468,3575846714,3575846749,35
2,406,2469,3575846714,3575846752,38
2,406,2470,3575846714,3575846758,44
2,406,2471,3575846714,3575846762,48
2,407,2472,3575846767,3575846767,0
2,407,2473,3575846767,3575846767,0
2,407,2474,3575846767,3575846767,0
2,407,2475,3575846767,3575846769,2
2,407,2476,3575846767,3575846777,10
2,407,2477,3575846767,3575846783,16
2,407,2478,3575846767,3575846785,18
2,407,2479,3575846767,3575846785,18
2,407,2480,3575846767,3575846785,18
2,407,2481,3575846767,3575846788,21
2,407,2482,3575846767,3575846788,21
2,407,2483,3575846767,3575846790,23
2,407,2484,3575846767,3575846791,24
2,407,2485,3575846767,3575846793,26
2,407,2486,3575846767,3575846796,29
2,407,2487,3575846767,3575846800,33
2,407,2488,3575846767,3575846806,39
2,407,2489,3575846767,3575846811,44
2,407,2490,3575846767,3575846815,48
2,408,2491,3575846819,3575846819,0
2,408,2492,3575846819,3575846820,1
2,408,2493,3575846819,3575846822,3
2,408,2494,3575846819,3575846822,3
2,408,2495,3575846819,3575846828,9
2,408,2496,3575846819,3575846834,15
2,408,2497,3575846819,3575846837,18
2,408,2498,3575846819,3575846839,20
2,408,2499,3575846819,3575846845,26
2,408,2500,3575846819,3575846846,27
2,408,2501,3575846819,3575846846,27
2,408,2502,3575846819,3575846849,30
2,408,2503,3575846819,3575846853,34
2,408,2504,3575846819,3575846856,37
2,408,2505,3575846819,3575846857,38
2,408,2506,3575846819,3575846864,45
2,408,2507,3575846819,3575846868,49
2,409,2508,3575846872,3575846876,4
2,409,2509,3575846872,3575846878,6
2,409,2510,3575846872,3575846879,7
2,409,2511,3575846872,3575846879,7
2,409,2512,3575846872,3575846882,10
2,409,2513,3575846872,3575846883,11
2,409,2514,3575846872,3575846885,13
2,409,2515,3575846872,3575846887,15
2,409,2516,3575846872,3575846889,17
2,409,2517,3575846872,3575846893,21
2,409,2518,3575846872,3575846897,25
2,409,2519,3575846872,3575846898,26
2,409,2520,3575846872,3575846902,30
2,409,2521,3575846872,3575846903,31
2,409,2522,3575846872,3575846906,34
2,409,2523,3575846872,3575846910,38
2,409,2524,3575846872,3575846911,39
2,409,2525,3575846872,3575846915,43
2,409,2526,3575846872,3575846922,50
2,410,2527,3575846924,3575846924,0
2,410,2528,3575846924,3575846927,3
2,410,2529,3575846924,3575846927,3
2,410,2530,3575846924,3575846930,6
2,410,2531,3575846924,3575846932,8
2,410,2532,3575846924,3575846934,10
2,410,2533,3575846924,3575846938,14
2,410,2534,3575846924,3575846939,15
2,410,2535,3575846924,3575846946,22
2,410,2536,3575846924,3575846949,25
2,410,2537,3575846924,3575846952,28
2,410,2538,3575846924,3575846957,33
2,410,2539,3575846924,3575846962,38
2,410,2540,3575846924,3575846965,41
2,410,2541,3575846924,3575846967,43
2,410,2542,3575846924,3575846968,44
2,410,2543,3575846924,3575846969,45
2,411,2544,3575846977,3575846977,0
2,411,2545,3575846977,3575846983,6
2,411,2546,3575846977,3575846985,8
2,411,2547,3575846977,3575846985,8
2,411,2548,3575846977,3575846986,9
2,411,2549,3575846977,3575846987,10
2,411,2550,3575846977,3575846988,11
2,411,2551,3575846977,3575846990,13
2,411,2552,3575846977,3575846991,14
2,411,2553,3575846977,3575846994,17
2,411,2554,3575846977,3575846996,19
2,411,2555,3575846977,3575847000,23
2,411,2556,3575846977,3575847006,29
2,411,2557,3575846977,3575847011,34
2,411,2558,3575846977,3575847014,37
2,411,2559,3575846977,3575847017,40
2,411,2560,3575846977,3575847019,42
2,411,2561,3575846977,3575847022,45
2,411,2562,3575846977,3575847023,46
2,411,2563,3575846977,3575847026,49
2,412,2564,3575847029,3575847029,0
2,412,2565,3575847029,3575847035,6
2,412,2566,3575847029,3575847037,8
2,412,2567,3575847029,3575847039,10
2,412,2568,3575847029,3575847045,16
2,412,2569,3575847029,3575847046,17
2,412,2570,3575847029,3575847046,17
2,412,2571,3575847029,3575847049,20
2,412,2572,3575847029,3575847053,24
2,412,2573,3575847029,3575847056,27
2,412,2574,3575847029,3575847057,28
2,412,2575,3575847029,3575847060,31
2,412,2576,3575847029,3575847064,35
2,412,2577,3575847029,3575847069,40
2,412,2578,3575847029,3575847076,47
2,412,2579,3575847029,3575847078,49
2,412,2580,3575847029,3575847079,50
2,413,2581,3575847082,3575847082,0
2,413,2582,3575847082,3575847083,1
2,413,2583,3575847082,3575847083,1
2,413,2584,3575847082,3575847085,3
2,413,2585,3575847082,3575847087,5
2,413,2586,3575847082,3575847089,7
2,413,2587,3575847082,3575847094,12
2,413,2588,3575847082,3575847097,15
2,413,2589,3575847082,3575847099,17
2,413,2590,3575847082,3575847102,20
2,413,2591,3575847082,3575847103,21
2,413,2592,3575847082,3575847106,24
2,413,2593,3575847082,3575847110,28
2,413,2594,3575847082,3575847111,29
2,413,2595,3575847082,3575847112,30
2,413,2596,3575847082,3575847115,33
2,413,2597,3575847082,3575847121,39
2,413,2598,3575847082,3575847124,42
2,413,2599,3575847082,3575847127,45
2,413,2600,3575847082,3575847128,46
2,413,2601,3575847082,3575847131,49
2,414,2602,3575847134,3575847134,0
2,414,2603,3575847134,3575847134,0
2,414,2604,3575847134,3575847138,4
2,414,2605,3575847134,3575847140,6
2,414,2606,3575847134,3575847146,12
2,414,2607,3575847134,3575847149,15
2,414,2608,3575847134,3575847152,18
2,414,2609,3575847134,3575847157,23
2,414,2610,3575847134,3575847161,27
2,414,2611,3575847134,3575847165,31
2,414,2612,3575847134,3575847167,33
2,414,2613,3575847134,3575847169,35
2,414,2614,3575847134,3575847170,36
2,414,2615,3575847134,3575847178,44
2,414,2616,3575847134,3575847183,49
2,415,2617,3575847186,3575847186,0
2,415,2618,3575847186,3575847186,0
2,415,2619,3575847186,3575847186,0
2,415,2620,3575847186,3575847187,1
2,415,2621,3575847186,3575847188,2
2,415,2622,3575847186,3575847190,4
2,415,2623,3575847186,3575847191,5
2,415,2624,3575847186,3575847193,7
2,415,2625,3575847186,3575847197,11
2,415,2626,3575847186,3575847200,14
2,415,2627,3575847186,3575847206,20
2,415,2628,3575847186,3575847213,27
2,415,2629,3575847186,3575847214,28
2,415,2630,3575847186,3575847217,31
2,415,2631,3575847186,3575847221,35
2,415,2632,3575847186,3575847222,36
2,415,2633,3575847186,3575847223,37
2,415,2634,3575847186,3575847227,41
2,415,2635,3575847186,3575847228,42
2,415,2636,3575847186,3575847235,49
2,416,2637,3575847239,3575847239,0
2,416,2638,3575847239,3575847246,7
2,416,2639,3575847239,3575847246,7
2,416,2640,3575847239,3575847249,10
2,416,2641,3575847239,3575847253,14
2,416,2642,3575847239,3575847256,17
2,416,2643,3575847239,3575847256,17
2,416,2644,3575847239,3575847261,22
2,416,2645,3575847239,3575847264,25
2,416,2646,3575847239,3575847268,29
2,416,2647,3575847239,3575847276,37
2,416,2648,3575847239,3575847279,40
2,416,2649,3575847239,3575847279,40
2,416,2650,3575847239,3575847283,44
2,416,2651,3575847239,3575847283,44
2,416,2652,3575847239,3575847285,46
2,416,2653,3575847239,3575847287,48
2,416,2654,3575847239,3575847289,50
2,417,2655,3575847291,3575847294,3
2,417,2656,3575847291,3575847298,7
2,417,2657,3575847291,3575847300,9
2,417,2658,3575847291,3575847302,11
2,417,2659,3575847291,3575847303,12
2,417,2660,3575847291,3575847306,15
2,417,2661,3575847291,3575847310,19
2,417,2662,3575847291,3575847312,21
2,417,2663,3575847291,3575847312,21
2,417,2664,3575847291,3575847313,22
2,417,2665,3575847291,3575847314,23
2,417,2666,3575847291,3575847316,25
2,417,2667,3575847291,3575847321,30
2,417,2668,3575847291,3575847324,33
2,417,2669,3575847291,3575847327,36
2,417,2670,3575847291,3575847328,37
2,417,2671,3575847291,3575847331,40
2,417,2672,3575847291,3575847333,42
2,417,2673,3575847291,3575847334,43
2,417,2674,3575847291,3575847338,47
2,417,2675,3575847291,3575847341,50
2,418,2676,3575847344,3575847345,1
2,418,2677,3575847344,3575847350,6
2,418,2678,3575847344,3575847351,7
2,418,2679,3575847344,3575847358,14
2,418,2680,3575847344,3575847361,17
2,418,2681,3575847344,3575847365,21
2,418,2682,3575847344,3575847366,22
2,418,2683,3575847344,3575847369,25
2,418,2684,3575847344,3575847370,26
2,418,2685,3575847344,3575847374,30
2,418,2686,3575847344,3575847377,33
2,418,2687,3575847344,3575847383,39
2,418,2688,3575847344,3575847385,41
2,418,2689,3575847344,3575847385,41
2,418,2690,3575847344,3575847386,42
2,418,2691,3575847344,3575847387,43
2,418,2692,3575847344,3575847388,44
2,418,2693,3575847344,3575847391,47
2,418,2694,3575847344,3575847391,47
2,418,2695,3575847344,3575847394,50
2,419,2696,3575847396,3575847397,1
2,419,2697,3575847396,3575847401,5
2,419,2698,3575847396,3575847406,10
2,419,2699,3575847396,3575847413,17
2,419,2700,3575847396,3575847415,19
2,419,2701,3575847396,3575847415,19
2,419,2702,3575847396,3575847417,21
2,419,2703,3575847396,3575847421,25
2,419,2704,3575847396,3575847423,27
2,419,2705,3575847396,3575847424,28
2,419,2706,3575847396,3575847426,30
2,419,2707,3575847396,3575847429,33
2,419,2708,3575847396,3575847436,40
2,419,2709,3575847396,3575847439,43
2,419,2710,3575847396,3575847440,44
2,419,2711,3575847396,3575847446,50
2,420,2712,3575847449,3575847449,0
2,420,2713,3575847449,3575847450,1
2,420,2714,3575847449,3575847454,5
2,420,2715,3575847449,3575847456,7
2,420,2716,3575847449,3575847456,7
2,420,2717,3575847449,3575847461,12
2,420,2718,3575847449,3575847464,15
2,420,2719,3575847449,3575847469,20
2,420,2720,3575847449,3575847476,27
2,420,2721,3575847449,3575847479,30
2,420,2722,3575847449,3575847479,30
2,420,2723,3575847449,3575847482,33
2,420,2724,3575847449,3575847483,34
2,420,2725,3575847449,3575847485,36
2,420,2726,3575847449,3575847487,38
2,420,2727,3575847449,3575847489,40
2,420,2728,3575847449,3575847494,45
2,420,2729,3575847449,3575847498,49
2,421,2730,3575847502,3575847502,0
2,421,2731,3575847502,3575847502,0
2,421,2732,3575847502,3575847502,0
2,421,2733,3575847502,3575847505,3
2,421,2734,3575847502,3575847509,7
2,421,2735,3575847502,3575847511,9
2,421,2736,3575847502,3575847511,9
2,421,2737,3575847502,3575847513,11
2,421,2738,3575847502,3575847513,11
2,421,2739,3575847502,3575847514,12
2,421,2740,3575847502,3575847515,13
2,421,2741,3575847502,3575847515,13
2,421,2742,3575847502,3575847520,18
2,421,2743,3575847502,3575847524,22
2,421,2744,3575847502,3575847526,24
2,421,2745,3575847502,3575847527,25
2,421,2746,3575847502,3575847529,27
2,421,2747,3575847502,3575847532,30
2,421,2748,3575847502,3575847533,31
2,421,2749,3575847502,3575847538,36
2,421,2750,3575847502,3575847540,38
2,421,2751,3575847502,3575847545,43
2,421,2752,3575847502,3575847549,47
2,421,2753,3575847502,3575847551,49
2,422,2754,3575847555,3575847557,2
2,422,2755,3575847555,3575847561,6
2,422,2756,3575847555,3575847565,10
2,422,2757,3575847555,3575847566,11
2,422,2758,3575847555,3575847568,13
2,422,2759,3575847555,3575847569,14
2,422,2760,3575847555,3575847574,19
2,422,2761,3575847555,3575847576,21
2,422,2762,3575847555,3575847582,27
2,422,2763,3575847555,3575847584,29
2,422,2764,3575847555,3575847585,30
2,422,2765,3575847555,3575847585,30
2,422,2766,3575847555,3575847587,32
2,422,2767,3575847555,3575847588,33
2,422,2768,3575847555,3575847590,35
2,422,2769,3575847555,3575847590,35
2,422,2770,3575847555,3575847593,38
2,422,2771,3575847555,3575847596,41
2,422,2772,3575847555,3575847600,45
2,422,2773,3575847555,3575847605,50
2,423,2774,3575847607,3575847612,5
2,423,2775,3575847607,3575847614,7
2,423,2776,3575847607,3575847614,7
2,423,2777,3575847607,3575847616,9
2,423,2778,3575847607,3575847619,12
2,423,2779,3575847607,3575847622,15
2,423,2780,3575847607,3575847623,16
2,423,2781,3575847607,3575847625,18
2,423,2782,3575847607,3575847627,20
2,423,2783,3575847607,3575847634,27
2,423,2784,3575847607,3575847637,30
2,423,2785,3575847607,3575847639,32
2,423,2786,3575847607,3575847645,38
2,423,2787,3575847607,3575847645,38
2,423,2788,3575847607,3575847647,40
2,423,2789,3575847607,3575847649,42
2,423,2790,3575847607,3575847652,45
2,423,2791,3575847607,3575847654,47
2,423,2792,3575847607,3575847656,49
2,424,2793,3575847660,3575847660,0
2,424,2794,3575847660,3575847663,3
2,424,2795,3575847660,3575847667,7
2,424,2796,3575847660,3575847668,8
2,424,2797,3575847660,3575847676,16
2,424,2798,3575847660,3575847678,18
2,424,2799,3575847660,3575847679,19
2,424,2800,3575847660,3575847679,19
2,424,2801,3575847660,3575847682,22
2,424,2802,3575847660,3575847683,23
2,424,2803,3575847660,3575847685,25
2,424,2804,3575847660,3575847687,27
2,424,2805,3575847660,3575847689,29
2,424,2806,3575847660,3575847694,34
2,424,2807,3575847660,3575847699,39
2,424,2808,3575847660,3575847701,41
2,424,2809,3575847660,3575847701,41
2,424,2810,3575847660,3575847701,41
2,424,2811,3575847660,3575847705,45
2,424,2812,3575847660,3575847709,49
2,425,2813,3575847713,3575847713,0
2,425,2814,3575847713,3575847713,0
2,425,2815,3575847713,3575847713,0
2,425,2816,3575847713,3575847713,0
2,425,2817,3575847713,3575847715,2
2,425,2818,3575847713,3575847715,2
2,425,2819,3575847713,3575847715,2
2,425,2820,3575847713,3575847718,5
2,425,2821,3575847713,3575847720,7
2,425,2822,3575847713,3575847724,11
2,425,2823,3575847713,3575847727,14
2,425,2824,3575847713,3575847727,14
2,425,2825,3575847713,3575847730,17
2,425,2826,3575847713,3575847732,19
2,425,2827,3575847713,3575847733,20
2,425,2828,3575847713,3575847737,24
2,425,2829,3575847713,3575847739,26
2,425,2830,3575847713,3575847745,32
2,425,2831,3575847713,3575847749,36
2,425,2832,3575847713,3575847751,38
2,425,2833,3575847713,3575847757,44
2,425,2834,3575847713,3575847762,49
2,426,2835,3575847765,3575847765,0
2,426,2836,3575847765,3575847766,1
2,426,2837,3575847765,3575847768,3
2,426,2838,3575847765,3575847769,4
2,426,2839,3575847765,3575847775,10
2,426,2840,3575847765,3575847778,13
2,426,2841,3575847765,3575847782,17
2,426,2842,3575847765,3575847784,19
2,426,2843,3575847765,3575847785,20
2,426,2844,3575847765,3575847785,20
2,426,2845,3575847765,3575847787,22
2,426,2846,3575847765,3575847788,23
2,426,2847,3575847765,3575847791,26
2,426,2848,3575847765,3575847791,26
2,426,2849,3575847765,3575847793,28
2,426,2850,3575847765,3575847795,30
2,426,2851,3575847765,3575847800,35
2,426,2852,3575847765,3575847805,40
2,426,2853,3575847765,3575847812,47
2,426,2854,3575847765,3575847814,49
2,426,2855,3575847765,3575847815,50
2,427,2856,3575847818,3575847818,0
2,427,2857,3575847818,3575847819,1
2,427,2858,3575847818,3575847822,4
2,427,2859,3575847818,3575847822,4
2,427,2860,3575847818,3575847825,7
2,427,2861,3575847818,3575847828,10
2,427,2862,3575847818,3575847834,16
2,427,2863,3575847818,3575847837,19
2,427,2864,3575847818,3575847839,21
2,427,2865,3575847818,3575847845,27
2,427,2866,3575847818,3575847845,27
2,427,2867,3575847818,3575847847,29
2,427,2868,3575847818,3575847849,31
2,427,2869,3575847818,3575847853,35
2,427,2870,3575847818,3575847855,37
2,427,2871,3575847818,3575847856,38
2,427,2872,3575847818,3575847860,42
2,427,2873,3575847818,3575847863,45
2,427,2874,3575847818,3575847867,49
2,427,2875,3575847818,3575847868,50
2,428,2876,3575847871,3575847876,5
2,428,2877,3575847871,3575847879,8
2,428,2878,3575847871,3575847879,8
2,428,2879,3575847871,3575847880,9
2,428,2880,3575847871,3575847883,12
2,428,2881,3575847871,3575847883,12
2,428,2882,3575847871,3575847884,13
2,428,2883,3575847871,3575847887,16
2,428,2884,3575847871,3575847889,18
2,428,2885,3575847871,3575847894,23
2,428,2886,3575847871,3575847898,27
2,428,2887,3575847871,3575847900,29
2,428,2888,3575847871,3575847901,30
2,428,2889,3575847871,3575847901,30
2,428,2890,3575847871,3575847905,34
2,428,2891,3575847871,3575847909,38
2,428,2892,3575847871,3575847910,39
2,428,2893,3575847871,3575847911,40
2,428,2894,3575847871,3575847913,42
2,428,2895,3575847871,3575847913,42
2,428,2896,3575847871,3575847915,44
2,428,2897,3575847871,3575847915,44
2,428,2898,3575847871,3575847915,44
2,428,2899,3575847871,3575847918,47
2,428,2900,3575847871,3575847921,50
2,429,2901,3575847924,3575847925,1
2,429,2902,3575847924,3575847927,3
2,429,2903,3575847924,3575847927,3
2,429,2904,3575847924,3575847931,7
2,429,2905,3575847924,3575847933,9
2,429,2906,3575847924,3575847934,10
2,429,2907,3575847924,3575847938,14
2,429,2908,3575847924,3575847940,16
2,429,2909,3575847924,3575847945,21
2,429,2910,3575847924,3575847949,25
2,429,2911,3575847924,3575847952,28
2,429,2912,3575847924,3575847957,33
2,429,2913,3575847924,3575847962,38
2,429,2914,3575847924,3575847966,42
2,429,2915,3575847924,3575847967,43
2,429,2916,3575847924,3575847968,44
2,429,2917,3575847924,3575847969,45
2,429,2918,3575847924,3575847973,49
2,430,2919,3575847977,3575847977,0
2,430,2920,3575847977,3575847977,0
2,430,2921,3575847977,3575847982,5
2,430,2922,3575847977,3575847983,6
2,430,2923,3575847977,3575847985,8
2,430,2924,3575847977,3575847985,8
2,430,2925,3575847977,3575847988,11
2,430,2926,3575847977,3575847988,11
2,430,2927,3575847977,3575847990,13
2,430,2928,3575847977,3575847991,14
2,430,2929,3575847977,3575847994,17
2,430,2930,3575847977,3575847995,18
2,430,2931,3575847977,3575847999,22
2,430,2932,3575847977,3575848005,28
2,430,2933,3575847977,3575848010,33
2,430,2934,3575847977,3575848013,36
2,430,2935,3575847977,3575848014,37
2,430,2936,3575847977,3575848016,39
2,430,2937,3575847977,3575848019,42
2,430,2938,3575847977,3575848020,43
2,430,2939,3575847977,3575848022,45
2,430,2940,3575847977,3575848023,46
2,430,2941,3575847977,3575848025,48
2,431,2942,3575848030,3575848030,0
2,431,2943,3575848030,3575848036,6
2,431,2944,3575848030,3575848038,8
2,431,2945,3575848030,3575848039,9
2,431,2946,3575848030,3575848044,14
2,431,2947,3575848030,3575848045,15
2,431,2948,3575848030,3575848047,17
2,431,2949,3575848030,3575848049,19
2,431,2950,3575848030,3575848052,22
2,431,2951,3575848030,3575848055,25
2,431,2952,3575848030,3575848056,26
2,431,2953,3575848030,3575848060,30
2,431,2954,3575848030,3575848063,33
2,431,2955,3575848030,3575848067,37
2,431,2956,3575848030,3575848069,39
2,431,2957,3575848030,3575848073,43
2,431,2958,3575848030,3575848076,46
2,431,2959,3575848030,3575848079,49
2,431,2960,3575848030,3575848079,49
2,432,2961,3575848082,3575848083,1
2,432,2962,3575848082,3575848083,1
2,432,2963,3575848082,3575848085,3
2,432,2964,3575848082,3575848087,5
2,432,2965,3575848082,3575848089,7
2,432,2966,3575848082,3575848094,12
2,432,2967,3575848082,3575848098,16
2,432,2968,3575848082,3575848100,18
2,432,2969,3575848082,3575848101,19
2,432,2970,3575848082,3575848102,20
2,432,2971,3575848082,3575848105,23
2,432,2972,3575848082,3575848109,27
2,432,2973,3575848082,3575848111,29
2,432,2974,3575848082,3575848112,30
2,432,2975,3575848082,3575848114,32
2,432,2976,3575848082,3575848114,32
2,432,2977,3575848082,3575848115,33
2,432,2978,3575848082,3575848115,33
2,432,2979,3575848082,3575848119,37
2,432,2980,3575848082,3575848121,39
2,432,2981,3575848082,3575848124,42
2,432,2982,3575848082,3575848126,44
2,432,2983,3575848082,3575848126,44
2,432,2984,3575848082,3575848128,46
2,432,2985,3575848082,3575848131,49
2,433,2986,3575848136,3575848136,0
2,433,2987,3575848136,3575848136,0
2,433,2988,3575848136,3575848139,3
2,433,2989,3575848136,3575848146,10
2,433,2990,3575848136,3575848149,13
2,433,2991,3575848136,3575848152,16
2,433,2992,3575848136,3575848158,22
2,433,2993,3575848136,3575848162,26
2,433,2994,3575848136,3575848166,30
2,433,2995,3575848136,3575848167,31
2,433,2996,3575848136,3575848168,32
2,433,2997,3575848136,3575848170,34
2,433,2998,3575848136,3575848173,37
2,433,2999,3575848136,3575848175,39
2,433,3000,3575848136,3575848178,42
2,433,3001,3575848136,3575848184,48
2,433,3002,3575848136,3575848184,48
2,433,3003,3575848136,3575848185,49
2,433,3004,3575848136,3575848186,50
2,434,3005,3575848189,3575848189,0
2,434,3006,3575848189,3575848189,0
2,434,3007,3575848189,3575848190,1
2,434,3008,3575848189,3575848191,2
2,434,3009,3575848189,3575848195,6
2,434,3010,3575848189,3575848195,6
2,434,3011,3575848189,3575848199,10
2,434,3012,3575848189,3575848205,16
2,434,3013,3575848189,3575848213,24
2,434,3014,3575848189,3575848214,25
2,434,3015,3575848189,3575848215,26
2,434,3016,3575848189,3575848219,30
2,434,3017,3575848189,3575848220,31
2,434,3018,3575848189,3575848222,33
2,434,3019,3575848189,3575848222,33
2,434,3020,3575848189,3575848226,37
2,434,3021,3575848189,3575848226,37
2,434,3022,3575848189,3575848228,39
2,434,3023,3575848189,3575848235,46
2,434,3024,3575848189,3575848238,49
2,434,3025,3575848189,3575848239,50
2,435,3026,3575848242,3575848245,3
2,435,3027,3575848242,3575848245,3
2,435,3028,3575848242,3575848247,5
2,435,3029,3575848242,3575848249,7
2,435,3030,3575848242,3575848253,11
2,435,3031,3575848242,3575848256,14
2,435,3032,3575848242,3575848256,14
2,435,3033,3575848242,3575848260,18
2,435,3034,3575848242,3575848263,21
2,435,3035,3575848242,3575848267,25
2,435,3036,3575848242,3575848269,27
2,435,3037,3575848242,3575848273,31
2,435,3038,3575848242,3575848276,34
2,435,3039,3575848242,3575848278,36
2,435,3040,3575848242,3575848280,38
2,435,3041,3575848242,3575848282,40
2,435,3042,3575848242,3575848283,41
2,435,3043,3575848242,3575848285,43
2,435,3044,3575848242,3575848289,47
2,436,3045,3575848296,3575848296,0
2,436,3046,3575848296,3575848296,0
2,436,3047,3575848296,3575848299,3
2,436,3048,3575848296,3575848301,5
2,436,3049,3575848296,3575848301,5
2,436,3050,3575848296,3575848301,5
2,436,3051,3575848296,3575848305,9
2,436,3052,3575848296,3575848309,13
2,436,3053,3575848296,3575848311,15
2,436,3054,3575848296,3575848313,17
2,436,3055,3575848296,3575848313,17
2,436,3056,3575848296,3575848314,18
2,436,3057,3575848296,3575848315,19
2,436,3058,3575848296,3575848315,19
2,436,3059,3575848296,3575848319,23
2,436,3060,3575848296,3575848320,24
2,436,3061,3575848296,3575848324,28
2,436,3062,3575848296,3575848325,29
2,436,3063,3575848296,3575848326,30
2,436,3064,3575848296,3575848328,32
2,436,3065,3575848296,3575848330,34
2,436,3066,3575848296,3575848333,37
2,436,3067,3575848296,3575848334,38
2,436,3068,3575848296,3575848338,42
2,436,3069,3575848296,3575848346,50
2,437,3070,3575848349,3575848349,0
2,437,3071,3575848349,3575848352,3
2,437,3072,3575848349,3575848358,9
2,437,3073,3575848349,3575848362,13
2,437,3074,3575848349,3575848365,16
2,437,3075,3575848349,3575848367,18
2,437,3076,3575848349,3575848367,18
2,437,3077,3575848349,3575848371,22
2,437,3078,3575848349,3575848372,23
2,437,3079,3575848349,3575848375,26
2,437,3080,3575848349,3575848377,28
2,437,3081,3575848349,3575848383,34
2,437,3082,3575848349,3575848385,36
2,437,3083,3575848349,3575848385,36
2,437,3084,3575848349,3575848386,37
2,437,3085,3575848349,3575848387,38
2,437,3086,3575848349,3575848389,40
2,437,3087,3575848349,3575848390,41
2,437,3088,3575848349,3575848391,42
2,437,3089,3575848349,3575848395,46
2,437,3090,3575848349,3575848396,47
2,438,3091,3575848401,3575848401,0
2,438,3092,3575848401,3575848405,4
2,438,3093,3575848401,3575848413,12
2,438,3094,3575848401,3575848414,13
2,438,3095,3575848401,3575848415,14
2,438,3096,3575848401,3575848419,18
2,438,3097,3575848401,3575848420,19
2,438,3098,3575848401,3575848423,22
2,438,3099,3575848401,3575848425,24
2,438,3100,3575848401,3575848426,25
2,438,3101,3575848401,3575848428,27
2,438,3102,3575848401,3575848428,27
2,438,3103,3575848401,3575848435,34
2,438,3104,3575848401,3575848437,36
2,438,3105,3575848401,3575848440,39
2,438,3106,3575848401,3575848445,44
2,438,3107,3575848401,3575848447,46
2,438,3108,3575848401,3575848450,49
2,439,3109,3575848454,3575848454,0
2,439,3110,3575848454,3575848455,1
2,439,3111,3575848454,3575848456,2
2,439,3112,3575848454,3575848460,6
2,439,3113,3575848454,3575848463,9
2,439,3114,3575848454,3575848467,13
2,439,3115,3575848454,3575848469,15
2,439,3116,3575848454,3575848473,19
2,439,3117,3575848454,3575848478,24
2,439,3118,3575848454,3575848479,25
2,439,3119,3575848454,3575848479,25
2,439,3120,3575848454,3575848482,28
2,439,3121,3575848454,3575848483,29
2,439,3122,3575848454,3575848485,31
2,439,3123,3575848454,3575848489,35
2,439,3124,3575848454,3575848495,41
2,439,3125,3575848454,3575848495,41
2,439,3126,3575848454,3575848499,45
2,439,3127,3575848454,3575848501,47
2,439,3128,3575848454,3575848501,47
2,439,3129,3575848454,3575848502,48
2,440,3130,3575848507,3575848507,0
2,440,3131,3575848507,3575848508,1
2,440,3132,3575848507,3575848509,2
2,440,3133,3575848507,3575848510,3
2,440,3134,3575848507,3575848511,4
2,440,3135,3575848507,3575848513,6
2,440,3136,3575848507,3575848514,7
2,440,3137,3575848507,3575848514,7
2,440,3138,3575848507,3575848515,8
2,440,3139,3575848507,3575848519,12
2,440,3140,3575848507,3575848519,12
2,440,3141,3575848507,3575848523,16
2,440,3142,3575848507,3575848525,18
2,440,3143,3575848507,3575848527,20
2,440,3144,3575848507,3575848529,22
2,440,3145,3575848507,3575848530,23
2,440,3146,3575848507,3575848532,25
2,440,3147,3575848507,3575848533,26
2,440,3148,3575848507,3575848538,31
2,440,3149,3575848507,3575848538,31
2,440,3150,3575848507,3575848545,38
2,440,3151,3575848507,3575848548,41
2,440,3152,3575848507,3575848551,44
2,440,3153,3575848507,3575848556,49
2,441,3154,3575848560,3575848562,2
2,441,3155,3575848560,3575848564,4
2,441,3156,3575848560,3575848566,6
2,441,3157,3575848560,3575848567,7
2,441,3158,3575848560,3575848570,10
2,441,3159,3575848560,3575848572,12
2,441,3160,3575848560,3575848574,14
2,441,3161,3575848560,3575848577,17
2,441,3162,3575848560,3575848579,19
2,441,3163,3575848560,3575848582,22
2,441,3164,3575848560,3575848584,24
2,441,3165,3575848560,3575848584,24
2,441,3166,3575848560,3575848585,25
2,441,3167,3575848560,3575848587,27
2,441,3168,3575848560,3575848588,28
2,441,3169,3575848560,3575848590,30
2,441,3170,3575848560,3575848590,30
2,441,3171,3575848560,3575848594,34
2,441,3172,3575848560,3575848594,34
2,441,3173,3575848560,3575848598,38
2,441,3174,3575848560,3575848605,45
2,441,3175,3575848560,3575848608,48
2,442,3176,3575848613,3575848613,0
2,442,3177,3575848613,3575848613,0
2,442,3178,3575848613,3575848615,2
2,442,3179,3575848613,3575848617,4
2,442,3180,3575848613,3575848620,7
2,442,3181,3575848613,3575848622,9
2,442,3182,3575848613,3575848624,11
2,442,3183,3575848613,3575848625,12
2,442,3184,3575848613,3575848628,15
2,442,3185,3575848613,3575848628,15
2,442,3186,3575848613,3575848635,22
2,442,3187,3575848613,3575848638,25
2,442,3188,3575848613,3575848639,26
2,442,3189,3575848613,3575848644,31
2,442,3190,3575848613,3575848645,32
2,442,3191,3575848613,3575848646,33
2,442,3192,3575848613,3575848649,36
2,442,3193,3575848613,3575848652,39
2,442,3194,3575848613,3575848654,41
2,442,3195,3575848613,3575848655,42
2,442,3196,3575848613,3575848659,46
2,442,3197,3575848613,3575848663,50
2,443,3198,3575848666,3575848666,0
2,443,3199,3575848666,3575848668,2
2,443,3200,3575848666,3575848673,7
2,443,3201,3575848666,3575848678,12
2,443,3202,3575848666,3575848679,13
2,443,3203,3575848666,3575848679,13
2,443,3204,3575848666,3575848682,16
2,443,3205,3575848666,3575848683,17
2,443,3206,3575848666,3575848685,19
2,443,3207,3575848666,3575848686,20
2,443,3208,3575848666,3575848689,23
2,443,3209,3575848666,3575848695,29
2,443,3210,3575848666,3575848695,29
2,443,3211,3575848666,3575848699,33
2,443,3212,3575848666,3575848701,35
2,443,3213,3575848666,3575848701,35
2,443,3214,3575848666,3575848702,36
2,443,3215,3575848666,3575848705,39
2,443,3216,3575848666,3575848708,42
2,443,3217,3575848666,3575848710,44
2,443,3218,3575848666,3575848711,45
2,443,3219,3575848666,3575848711,45
2,443,3220,3575848666,3575848713,47
2,443,3221,3575848666,3575848714,48
2,443,3222,3575848666,3575848714,48
2,443,3223,3575848666,3575848715,49
2,444,3224,3575848719,3575848719,0
2,444,3225,3575848719,3575848719,0
2,444,3226,3575848719,3575848722,3
2,444,3227,3575848719,3575848725,6
2,444,3228,3575848719,3575848727,8
2,444,3229,3575848719,3575848728,9
2,444,3230,3575848719,3575848729,10
2,444,3231,3575848719,3575848732,13
2,444,3232,3575848719,3575848732,13
2,444,3233,3575848719,3575848733,14
2,444,3234,3575848719,3575848738,19
2,444,3235,3575848719,3575848745,26
2,444,3236,3575848719,3575848748,29
2,444,3237,3575848719,3575848750,31
2,444,3238,3575848719,3575848757,38
2,444,3239,3575848719,3575848762,43
2,444,3240,3575848719,3575848765,46
2,444,3241,3575848719,3575848767,48
2,445,3242,3575848771,3575848771,0
2,445,3243,3575848771,3575848772,1
2,445,3244,3575848771,3575848774,3
2,445,3245,3575848771,3575848779,8
2,445,3246,3575848771,3575848782,11
2,445,3247,3575848771,3575848784,13
2,445,3248,3575848771,3575848784,13
2,445,3249,3575848771,3575848785,14
2,445,3250,3575848771,3575848787,16
2,445,3251,3575848771,3575848788,17
2,445,3252,3575848771,3575848790,19
2,445,3253,3575848771,3575848791,20
2,445,3254,3575848771,3575848794,23
2,445,3255,3575848771,3575848795,24
2,445,3256,3575848771,3575848798,27
2,445,3257,3575848771,3575848805,34
2,445,3258,3575848771,3575848809,38
2,445,3259,3575848771,3575848812,41
2,445,3260,3575848771,3575848813,42
2,445,3261,3575848771,3575848814,43
2,445,3262,3575848771,3575848818,47
2,445,3263,3575848771,3575848819,48
2,446,3264,3575848823,3575848823,0
2,446,3265,3575848823,3575848824,1
2,446,3266,3575848823,3575848825,2
2,446,3267,3575848823,3575848828,5
2,446,3268,3575848823,3575848829,6
2,446,3269,3575848823,3575848835,12
2,446,3270,3575848823,3575848837,14
2,446,3271,3575848823,3575848839,16
2,446,3272,3575848823,3575848843,20
2,446,3273,3575848823,3575848845,22
2,446,3274,3575848823,3575848846,23
2,446,3275,3575848823,3575848849,26
2,446,3276,3575848823,3575848853,30
2,446,3277,3575848823,3575848855,32
2,446,3278,3575848823,3575848856,33
2,446,3279,3575848823,3575848859,36
2,446,3280,3575848823,3575848863,40
2,446,3281,3575848823,3575848866,43
2,446,3282,3575848823,3575848868,45
2,447,3283,3575848876,3575848876,0
2,447,3284,3575848876,3575848879,3
2,447,3285,3575848876,3575848879,3
2,447,3286,3575848876,3575848879,3
2,447,3287,3575848876,3575848883,7
2,447,3288,3575848876,3575848883,7
2,447,3289,3575848876,3575848885,9
2,447,3290,3575848876,3575848887,11
2,447,3291,3575848876,3575848889,13
2,447,3292,3575848876,3575848895,19
2,447,3293,3575848876,3575848896,20
2,447,3294,3575848876,3575848899,23
2,447,3295,3575848876,3575848901,25
2,447,3296,3575848876,3575848901,25
2,447,3297,3575848876,3575848902,26
2,447,3298,3575848876,3575848905,29
2,447,3299,3575848876,3575848908,32
2,447,3300,3575848876,3575848910,34
2,447,3301,3575848876,3575848911,35
2,447,3302,3575848876,3575848912,36
2,447,3303,3575848876,3575848913,37
2,447,3304,3575848876,3575848914,38
2,447,3305,3575848876,3575848915,39
2,447,3306,3575848876,3575848915,39
2,447,3307,3575848876,3575848919,43
2,447,3308,3575848876,3575848921,45
2,447,3309,3575848876,3575848923,47
2,447,3310,3575848876,3575848924,48
2,448,3311,3575848929,3575848929,0
2,448,3312,3575848929,3575848929,0
2,448,3313,3575848929,3575848929,0
2,448,3314,3575848929,3575848931,2
2,448,3315,3575848929,3575848932,3
2,448,3316,3575848929,3575848932,3
2,448,3317,3575848929,3575848934,5
2,448,3318,3575848929,3575848938,9
2,448,3319,3575848929,3575848945,16
2,448,3320,3575848929,3575848949,20
2,448,3321,3575848929,3575848952,23
2,448,3322,3575848929,3575848957,28
2,448,3323,3575848929,3575848962,33
2,448,3324,3575848929,3575848965,36
2,448,3325,3575848929,3575848968,39
2,448,3326,3575848929,3575848971,42
2,448,3327,3575848929,3575848972,43
2,448,3328,3575848929,3575848974,45
2,448,3329,3575848929,3575848979,50
2,449,3330,3575848982,3575848983,1
2,449,3331,3575848982,3575848983,1
2,449,3332,3575848982,3575848985,3
2,449,3333,3575848982,3575848986,4
2,449,3334,3575848982,3575848986,4
2,449,3335,3575848982,3575848987,5
2,449,3336,3575848982,3575848988,6
2,449,3337,3575848982,3575848991,9
2,449,3338,3575848982,3575848991,9
2,449,3339,3575848982,3575848994,12
2,449,3340,3575848982,3575848995,13
2,449,3341,3575848982,3575848998,16
2,449,3342,3575848982,3575849005,23
2,449,3343,3575848982,3575849008,26
2,449,3344,3575848982,3575849011,29
2,449,3345,3575848982,3575849014,32
2,449,3346,3575848982,3575849018,36
2,449,3347,3575848982,3575849020,38
2,449,3348,3575848982,3575849022,40
2,449,3349,3575848982,3575849025,43
2,449,3350,3575848982,3575849025,43
2,449,3351,3575848982,3575849028,46
2,449,3352,3575848982,3575849029,47
2,450,3353,3575849035,3575849035,0
2,450,3354,3575849035,3575849036,1
2,450,3355,3575849035,3575849038,3
2,450,3356,3575849035,3575849045,10
2,450,3357,3575849035,3575849045,10
2,450,3358,3575849035,3575849046,11
2,450,3359,3575849035,3575849050,15
2,450,3360,3575849035,3575849052,17
2,450,3361,3575849035,3575849055,20
2,450,3362,3575849035,3575849055,20
2,450,3363,3575849035,3575849059,24
2,450,3364,3575849035,3575849063,28
2,450,3365,3575849035,3575849066,31
2,450,3366,3575849035,3575849068,33
2,450,3367,3575849035,3575849073,38
2,450,3368,3575849035,3575849079,44
2,450,3369,3575849035,3575849079,44
2,450,3370,3575849035,3575849080,45
2,450,3371,3575849035,3575849083,48
2,450,3372,3575849035,3575849083,48
2,450,3373,3575849035,3575849084,49
2,451,3374,3575849088,3575849088,0
2,451,3375,3575849088,3575849090,2
2,451,3376,3575849088,3575849094,6
2,451,3377,3575849088,3575849095,7
2,451,3378,3575849088,3575849098,10
2,451,3379,3575849088,3575849101,13
2,451,3380,3575849088,3575849101,13
2,451,3381,3575849088,3575849102,14
2,451,3382,3575849088,3575849105,17
2,451,3383,3575849088,3575849108,20
2,451,3384,3575849088,3575849111,23
2,451,3385,3575849088,3575849111,23
2,451,3386,3575849088,3575849113,25
2,451,3387,3575849088,3575849113,25
2,451,3388,3575849088,3575849114,26
2,451,3389,3575849088,3575849115,27
2,451,3390,3575849088,3575849115,27
2,451,3391,3575849088,3575849119,31
2,451,3392,3575849088,3575849121,33
2,451,3393,3575849088,3575849123,35
2,451,3394,3575849088,3575849125,37
2,451,3395,3575849088,3575849127,39
2,451,3396,3575849088,3575849127,39
2,451,3397,3575849088,3575849128,40
2,451,3398,3575849088,3575849131,43
2,451,3399,3575849088,3575849132,44
2,451,3400,3575849088,3575849132,44
2,451,3401,3575849088,3575849134,46
2,451,3402,3575849088,3575849138,50
2,452,3403,3575849142,3575849142,0
2,452,3404,3575849142,3575849146,4
2,452,3405,3575849142,3575849149,7
2,452,3406,3575849142,3575849152,10
2,452,3407,3575849142,3575849158,16
2,452,3408,3575849142,3575849162,20
2,452,3409,3575849142,3575849166,24
2,452,3410,3575849142,3575849167,25
2,452,3411,3575849142,3575849167,25
2,452,3412,3575849142,3575849171,29
2,452,3413,3575849142,3575849171,29
2,452,3414,3575849142,3575849175,33
2,452,3415,3575849142,3575849180,38
2,452,3416,3575849142,3575849184,42
2,452,3417,3575849142,3575849185,43
2,452,3418,3575849142,3575849185,43
2,452,3419,3575849142,3575849186,44
2,452,3420,3575849142,3575849186,44
2,452,3421,3575849142,3575849188,46
2,452,3422,3575849142,3575849188,46
2,452,3423,3575849142,3575849190,48
2,452,3424,3575849142,3575849191,49
2,453,3425,3575849195,3575849195,0
2,453,3426,3575849195,3575849195,0
2,453,3427,3575849195,3575849199,4
2,453,3428,3575849195,3575849205,10
2,453,3429,3575849195,3575849209,14
2,453,3430,3575849195,3575849213,18
2,453,3431,3575849195,3575849214,19
2,453,3432,3575849195,3575849215,20
2,453,3433,3575849195,3575849218,23
2,453,3434,3575849195,3575849222,27
2,453,3435,3575849195,3575849225,30
2,453,3436,3575849195,3575849226,31
2,453,3437,3575849195,3575849228,33
2,453,3438,3575849195,3575849229,34
2,453,3439,3575849195,3575849236,41
2,453,3440,3575849195,3575849237,42
2,453,3441,3575849195,3575849238,43
2,453,3442,3575849195,3575849244,49
2,453,3443,3575849195,3575849245,50
2,454,3444,3575849248,3575849248,0
2,454,3445,3575849248,3575849249,1
2,454,3446,3575849248,3575849252,4
2,454,3447,3575849248,3575849255,7
2,454,3448,3575849248,3575849255,7
2,454,3449,3575849248,3575849259,11
2,454,3450,3575849248,3575849263,15
2,454,3451,3575849248,3575849266,18
2,454,3452,3575849248,3575849269,21
2,454,3453,3575849248,3575849273,25
2,454,3454,3575849248,3575849278,30
2,454,3455,3575849248,3575849279,31
2,454,3456,3575849248,3575849279,31
2,454,3457,3575849248,3575849282,34
2,454,3458,3575849248,3575849283,35
2,454,3459,3575849248,3575849285,37
2,454,3460,3575849248,3575849287,39
2,454,3461,3575849248,3575849290,42
2,454,3462,3575849248,3575849290,42
2,454,3463,3575849248,3575849295,47
2,454,3464,3575849248,3575849296,48
2,455,3465,3575849300,3575849300,0
2,455,3466,3575849300,3575849301,1
2,455,3467,3575849300,3575849302,2
2,455,3468,3575849300,3575849302,2
2,455,3469,3575849300,3575849306,6
2,455,3470,3575849300,3575849308,8
2,455,3471,3575849300,3575849310,10
2,455,3472,3575849300,3575849311,11
2,455,3473,3575849300,3575849313,13
2,455,3474,3575849300,3575849313,13
2,455,3475,3575849300,3575849315,15
2,455,3476,3575849300,3575849315,15
2,455,3477,3575849300,3575849315,15
2,455,3478,3575849300,3575849318,18
2,455,3479,3575849300,3575849322,22
2,455,3480,3575849300,3575849323,23
2,455,3481,3575849300,3575849324,24
2,455,3482,3575849300,3575849327,27
2,455,3483,3575849300,3575849328,28
2,455,3484,3575849300,3575849328,28
2,455,3485,3575849300,3575849331,31
2,455,3486,3575849300,3575849332,32
2,455,3487,3575849300,3575849332,32
2,455,3488,3575849300,3575849334,34
2,455,3489,3575849300,3575849338,38
2,455,3490,3575849300,3575849340,40
2,455,3491,3575849300,3575849345,45
2,455,3492,3575849300,3575849349,49
2,456,3493,3575849353,3575849358,5
2,456,3494,3575849353,3575849362,9
2,456,3495,3575849353,3575849366,13
2,456,3496,3575849353,3575849367,14
2,456,3497,3575849353,3575849368,15
2,456,3498,3575849353,3575849371,18
2,456,3499,3575849353,3575849372,19
2,456,3500,3575849353,3575849375,22
2,456,3501,3575849353,3575849380,27
2,456,3502,3575849353,3575849385,32
2,456,3503,3575849353,3575849386,33
2,456,3504,3575849353,3575849386,33
2,456,3505,3575849353,3575849386,33
2,456,3506,3575849353,3575849388,35
2,456,3507,3575849353,3575849390,37
2,456,3508,3575849353,3575849391,38
2,456,3509,3575849353,3575849395,42
2,456,3510,3575849353,3575849395,42
2,456,3511,3575849353,3575849400,47
2,457,3512,3575849407,3575849407,0
2,457,3513,3575849407,3575849409,2
2,457,3514,3575849407,3575849412,5
2,457,3515,3575849407,3575849414,7
2,457,3516,3575849407,3575849414,7
2,457,3517,3575849407,3575849417,10
2,457,3518,3575849407,3575849421,14
2,457,3519,3575849407,3575849423,16
2,457,3520,3575849407,3575849425,18
2,457,3521,3575849407,3575849426,19
2,457,3522,3575849407,3575849428,21
2,457,3523,3575849407,3575849429,22
2,457,3524,3575849407,3575849436,29
2,457,3525,3575849407,3575849436,29
2,457,3526,3575849407,3575849438,31
2,457,3527,3575849407,3575849445,38
2,457,3528,3575849407,3575849445,38
2,457,3529,3575849407,3575849448,41
2,457,3530,3575849407,3575849450,43
2,457,3531,3575849407,3575849452,45
2,457,3532,3575849407,3575849454,47
2,457,3533,3575849407,3575849455,48
2,458,3534,3575849462,3575849462,0
2,458,3535,3575849462,3575849463,1
2,458,3536,3575849462,3575849467,5
2,458,3537,3575849462,3575849468,6
2,458,3538,3575849462,3575849473,11
2,458,3539,3575849462,3575849478,16
2,458,3540,3575849462,3575849478,16
2,458,3541,3575849462,3575849480,18
2,458,3542,3575849462,3575849483,21
2,458,3543,3575849462,3575849483,21
2,458,3544,3575849462,3575849485,23
2,458,3545,3575849462,3575849488,26
2,458,3546,3575849462,3575849490,28
2,458,3547,3575849462,3575849490,28
2,458,3548,3575849462,3575849494,32
2,458,3549,3575849462,3575849495,33
2,458,3550,3575849462,3575849495,33
2,458,3551,3575849462,3575849499,37
2,458,3552,3575849462,3575849500,38
2,458,3553,3575849462,3575849502,40
2,458,3554,3575849462,3575849502,40
2,458,3555,3575849462,3575849506,44
2,458,3556,3575849462,3575849508,46
2,458,3557,3575849462,3575849510,48
2,458,3558,3575849462,3575849511,49
2,459,3559,3575849515,3575849515,0
2,459,3560,3575849515,3575849515,0
2,459,3561,3575849515,3575849515,0
2,459,3562,3575849515,3575849515,0
2,459,3563,3575849515,3575849515,0
2,459,3564,3575849515,3575849519,4
2,459,3565,3575849515,3575849521,6
2,459,3566,3575849515,3575849522,7
2,459,3567,3575849515,3575849524,9
2,459,3568,3575849515,3575849526,11
2,459,3569,3575849515,3575849527,12
2,459,3570,3575849515,3575849528,13
2,459,3571,3575849515,3575849529,14
2,459,3572,3575849515,3575849531,16
2,459,3573,3575849515,3575849532,17
2,459,3574,3575849515,3575849533,18
2,459,3575,3575849515,3575849537,22
2,459,3576,3575849515,3575849540,25
2,459,3577,3575849515,3575849544,29
2,459,3578,3575849515,3575849549,34
2,459,3579,3575849515,3575849551,36
2,459,3580,3575849515,3575849557,42
2,459,3581,3575849515,3575849561,46
2,460,3582,3575849568,3575849568,0
2,460,3583,3575849568,3575849568,0
2,460,3584,3575849568,3575849568,0
2,460,3585,3575849568,3575849568,0
2,460,3586,3575849568,3575849570,2
2,460,3587,3575849568,3575849571,3
2,460,3588,3575849568,3575849574,6
2,460,3589,3575849568,3575849578,10
2,460,3590,3575849568,3575849583,15
2,460,3591,3575849568,3575849584,16
2,460,3592,3575849568,3575849585,17
2,460,3593,3575849568,3575849585,17
2,460,3594,3575849568,3575849587,19
2,460,3595,3575849568,3575849590,22
2,460,3596,3575849568,3575849590,22
2,460,3597,3575849568,3575849594,26
2,460,3598,3575849568,3575849595,27
2,460,3599,3575849568,3575849598,30
2,460,3600,3575849568,3575849604,36
2,460,3601,3575849568,3575849612,44
2,460,3602,3575849568,3575849613,45
2,460,3603,3575849568,3575849614,46
2,460,3604,3575849568,3575849617,49
2,461,3605,3575849621,3575849621,0
2,461,3606,3575849621,3575849622,1
2,461,3607,3575849621,3575849624,3
2,461,3608,3575849621,3575849626,5
2,461,3609,3575849621,3575849627,6
2,461,3610,3575849621,3575849627,6
2,461,3611,3575849621,3575849634,13
2,461,3612,3575849621,3575849635,14
2,461,3613,3575849621,3575849638,17
2,461,3614,3575849621,3575849639,18
2,461,3615,3575849621,3575849644,23
2,461,3616,3575849621,3575849644,23
2,461,3617,3575849621,3575849644,23
2,461,3618,3575849621,3575849647,26
2,461,3619,3575849621,3575849649,28
2,461,3620,3575849621,3575849652,31
2,461,3621,3575849621,3575849655,34
2,461,3622,3575849621,3575849655,34
2,461,3623,3575849621,3575849658,37
2,461,3624,3575849621,3575849663,42
2,461,3625,3575849621,3575849666,45
2,461,3626,3575849621,3575849667,46
2,462,3627,3575849674,3575849674,0
2,462,3628,3575849674,3575849678,4
2,462,3629,3575849674,3575849679,5
2,462,3630,3575849674,3575849679,5
2,462,3631,3575849674,3575849679,5
2,462,3632,3575849674,3575849683,9
2,462,3633,3575849674,3575849684,10
2,462,3634,3575849674,3575849685,11
2,462,3635,3575849674,3575849688,14
2,462,3636,3575849674,3575849690,16
2,462,3637,3575849674,3575849690,16
2,462,3638,3575849674,3575849694,20
2,462,3639,3575849674,3575849695,21
2,462,3640,3575849674,3575849695,21
2,462,3641,3575849674,3575849699,25
2,462,3642,3575849674,3575849700,26
2,462,3643,3575849674,3575849702,28
2,462,3644,3575849674,3575849702,28
2,462,3645,3575849674,3575849706,32
2,462,3646,3575849674,3575849708,34
2,462,3647,3575849674,3575849710,36
2,462,3648,3575849674,3575849711,37
2,462,3649,3575849674,3575849714,40
2,462,3650,3575849674,3575849714,40
2,462,3651,3575849674,3575849714,40
2,462,3652,3575849674,3575849714,40
2,462,3653,3575849674,3575849716,42
2,462,3654,3575849674,3575849719,45
2,462,3655,3575849674,3575849721,47
2,462,3656,3575849674,3575849722,48
2,462,3657,3575849674,3575849724,50
2,463,3658,3575849727,3575849727,0
2,463,3659,3575849727,3575849727,0
2,463,3660,3575849727,3575849727,0
2,463,3661,3575849727,3575849730,3
2,463,3662,3575849727,3575849732,5
2,463,3663,3575849727,3575849732,5
2,463,3664,3575849727,3575849733,6
2,463,3665,3575849727,3575849738,11
2,463,3666,3575849727,3575849740,13
2,463,3667,3575849727,3575849745,18
2,463,3668,3575849727,3575849746,19
2,463,3669,3575849727,3575849749,22
2,463,3670,3575849727,3575849751,24
2,463,3671,3575849727,3575849756,29
2,463,3672,3575849727,3575849761,34
2,463,3673,3575849727,3575849766,39
2,463,3674,3575849727,3575849767,40
2,463,3675,3575849727,3575849768,41
2,463,3676,3575849727,3575849770,43
2,463,3677,3575849727,3575849772,45
2,463,3678,3575849727,3575849774,47
2,464,3679,3575849780,3575849780,0
2,464,3680,3575849780,3575849780,0
2,464,3681,3575849780,3575849782,2
2,464,3682,3575849780,3575849784,4
2,464,3683,3575849780,3575849784,4
2,464,3684,3575849780,3575849785,5
2,464,3685,3575849780,3575849785,5
2,464,3686,3575849780,3575849788,8
2,464,3687,3575849780,3575849790,10
2,464,3688,3575849780,3575849791,11
2,464,3689,3575849780,3575849794,14
2,464,3690,3575849780,3575849795,15
2,464,3691,3575849780,3575849798,18
2,464,3692,3575849780,3575849804,24
2,464,3693,3575849780,3575849812,32
2,464,3694,3575849780,3575849813,33
2,464,3695,3575849780,3575849815,35
2,464,3696,3575849780,3575849818,38
2,464,3697,3575849780,3575849819,39
2,464,3698,3575849780,3575849822,42
2,464,3699,3575849780,3575849824,44
2,464,3700,3575849780,3575849825,45
2,464,3701,3575849780,3575849827,47
2,464,3702,3575849780,3575849829,49
2,465,3703,3575849833,3575849834,1
2,465,3704,3575849833,3575849835,2
2,465,3705,3575849833,3575849838,5
2,465,3706,3575849833,3575849839,6
2,465,3707,3575849833,3575849844,11
2,465,3708,3575849833,3575849844,11
2,465,3709,3575849833,3575849845,12
2,465,3710,3575849833,3575849847,14
2,465,3711,3575849833,3575849849,16
2,465,3712,3575849833,3575849853,20
2,465,3713,3575849833,3575849855,22
2,465,3714,3575849833,3575849856,23
2,465,3715,3575849833,3575849859,26
2,465,3716,3575849833,3575849861,28
2,465,3717,3575849833,3575849863,30
2,465,3718,3575849833,3575849866,33
2,465,3719,3575849833,3575849868,35
2,465,3720,3575849833,3575849873,40
2,465,3721,3575849833,3575849878,45
2,465,3722,3575849833,3575849878,45
2,465,3723,3575849833,3575849879,46
2,465,3724,3575849833,3575849879,46
2,465,3725,3575849833,3575849883,50
2,466,3726,3575849886,3575849886,0
2,466,3727,3575849886,3575849886,0
2,466,3728,3575849886,3575849888,2
2,466,3729,3575849886,3575849890,4
2,466,3730,3575849886,3575849891,5
2,466,3731,3575849886,3575849894,8
2,466,3732,3575849886,3575849894,8
2,466,3733,3575849886,3575849895,9
2,466,3734,3575849886,3575849899,13
2,466,3735,3575849886,3575849900,14
2,466,3736,3575849886,3575849902,16
2,466,3737,3575849886,3575849903,17
2,466,3738,3575849886,3575849906,20
2,466,3739,3575849886,3575849908,22
2,466,3740,3575849886,3575849910,24
2,466,3741,3575849886,3575849912,26
2,466,3742,3575849886,3575849914,28
2,466,3743,3575849886,3575849914,28
2,466,3744,3575849886,3575849914,28
2,466,3745,3575849886,3575849915,29
2,466,3746,3575849886,3575849917,31
2,466,3747,3575849886,3575849919,33
2,466,3748,3575849886,3575849921,35
2,466,3749,3575849886,3575849923,37
2,466,3750,3575849886,3575849927,41
2,466,3751,3575849886,3575849927,41
2,466,3752,3575849886,3575849927,41
2,466,3753,3575849886,3575849931,45
2,466,3754,3575849886,3575849931,45
2,466,3755,3575849886,3575849931,45
2,466,3756,3575849886,3575849934,48
2,467,3757,3575849939,3575849939,0
2,467,3758,3575849939,3575849940,1
2,467,3759,3575849939,3575849945,6
2,467,3760,3575849939,3575849946,7
2,467,3761,3575849939,3575849949,10
2,467,3762,3575849939,3575849949,10
2,467,3763,3575849939,3575849952,13
2,467,3764,3575849939,3575849957,18
2,467,3765,3575849939,3575849962,23
2,467,3766,3575849939,3575849967,28
2,467,3767,3575849939,3575849967,28
2,467,3768,3575849939,3575849967,28
2,467,3769,3575849939,3575849970,31
2,467,3770,3575849939,3575849971,32
2,467,3771,3575849939,3575849974,35
2,467,3772,3575849939,3575849977,38
2,467,3773,3575849939,3575849978,39
2,467,3774,3575849939,3575849982,43
2,467,3775,3575849939,3575849984,45
2,467,3776,3575849939,3575849985,46
2,467,3777,3575849939,3575849985,46
2,467,3778,3575849939,3575849985,46
2,467,3779,3575849939,3575849988,49
2,468,3780,3575849992,3575849992,0
2,468,3781,3575849992,3575849992,0
2,468,3782,3575849992,3575849994,2
2,468,3783,3575849992,3575849995,3
2,468,3784,3575849992,3575849998,6
2,468,3785,3575849992,3575850004,12
2,468,3786,3575849992,3575850009,17
2,468,3787,3575849992,3575850013,21
2,468,3788,3575849992,3575850015,23
2,468,3789,3575849992,3575850018,26
2,468,3790,3575849992,3575850020,28
2,468,3791,3575849992,3575850022,30
2,468,3792,3575849992,3575850024,32
2,468,3793,3575849992,3575850025,33
2,468,3794,3575849992,3575850028,36
2,468,3795,3575849992,3575850029,37
2,468,3796,3575849992,3575850036,44
2,468,3797,3575849992,3575850036,44
2,468,3798,3575849992,3575850037,45
2,468,3799,3575849992,3575850038,46
2,469,3800,3575850045,3575850045,0
2,469,3801,3575850045,3575850045,0
2,469,3802,3575850045,3575850045,0
2,469,3803,3575850045,3575850047,2
2,469,3804,3575850045,3575850049,4
2,469,3805,3575850045,3575850053,8
2,469,3806,3575850045,3575850054,9
2,469,3807,3575850045,3575850056,11
2,469,3808,3575850045,3575850059,14
2,469,3809,3575850045,3575850062,17
2,469,3810,3575850045,3575850063,18
2,469,3811,3575850045,3575850066,21
2,469,3812,3575850045,3575850069,24
2,469,3813,3575850045,3575850073,28
2,469,3814,3575850045,3575850078,33
2,469,3815,3575850045,3575850078,33
2,469,3816,3575850045,3575850079,34
2,469,3817,3575850045,3575850080,35
2,469,3818,3575850045,3575850083,38
2,469,3819,3575850045,3575850083,38
2,469,3820,3575850045,3575850086,41
2,469,3821,3575850045,3575850088,43
2,469,3822,3575850045,3575850090,45
2,469,3823,3575850045,3575850091,46
2,469,3824,3575850045,3575850094,49
2,469,3825,3575850045,3575850095,50
2,470,3826,3575850097,3575850097,0
2,470,3827,3575850097,3575850099,2
2,470,3828,3575850097,3575850101,4
2,470,3829,3575850097,3575850101,4
2,470,3830,3575850097,3575850102,5
2,470,3831,3575850097,3575850102,5
2,470,3832,3575850097,3575850106,9
2,470,3833,3575850097,3575850108,11
2,470,3834,3575850097,3575850110,13
2,470,3835,3575850097,3575850111,14
2,470,3836,3575850097,3575850114,17
2,470,3837,3575850097,3575850114,17
2,470,3838,3575850097,3575850114,17
2,470,3839,3575850097,3575850114,17
2,470,3840,3575850097,3575850117,20
2,470,3841,3575850097,3575850118,21
2,470,3842,3575850097,3575850121,24
2,470,3843,3575850097,3575850123,26
2,470,3844,3575850097,3575850125,28
2,470,3845,3575850097,3575850127,30
2,470,3846,3575850097,3575850127,30
2,470,3847,3575850097,3575850128,31
2,470,3848,3575850097,3575850131,34
2,470,3849,3575850097,3575850132,35
2,470,3850,3575850097,3575850134,37
2,470,3851,3575850097,3575850134,37
2,470,3852,3575850097,3575850138,41
2,470,3853,3575850097,3575850146,49
2,470,3854,3575850097,3575850147,50
2,471,3855,3575850150,3575850150,0
2,471,3856,3575850150,3575850150,0
2,471,3857,3575850150,3575850152,2
2,471,3858,3575850150,3575850153,3
2,471,3859,3575850150,3575850157,7
2,471,3860,3575850150,3575850162,12
2,471,3861,3575850150,3575850165,15
2,471,3862,3575850150,3575850167,17
2,471,3863,3575850150,3575850167,17
2,471,3864,3575850150,3575850168,18
2,471,3865,3575850150,3575850170,20
2,471,3866,3575850150,3575850172,22
2,471,3867,3575850150,3575850174,24
2,471,3868,3575850150,3575850177,27
2,471,3869,3575850150,3575850178,28
2,471,3870,3575850150,3575850183,33
2,471,3871,3575850150,3575850185,35
2,471,3872,3575850150,3575850185,35
2,471,3873,3575850150,3575850185,35
2,471,3874,3575850150,3575850185,35
2,471,3875,3575850150,3575850187,37
2,471,3876,3575850150,3575850190,40
2,471,3877,3575850150,3575850191,41
2,471,3878,3575850150,3575850194,44
2,471,3879,3575850150,3575850195,45
2,471,3880,3575850150,3575850199,49
2,472,3881,3575850203,3575850203,0
2,472,3882,3575850203,3575850204,1
2,472,3883,3575850203,3575850209,6
2,472,3884,3575850203,3575850214,11
2,472,3885,3575850203,3575850215,12
2,472,3886,3575850203,3575850217,14
2,472,3887,3575850203,3575850221,18
2,472,3888,3575850203,3575850222,19
2,472,3889,3575850203,3575850224,21
2,472,3890,3575850203,3575850224,21
2,472,3891,3575850203,3575850226,23
2,472,3892,3575850203,3575850228,25
2,472,3893,3575850203,3575850229,26
2,472,3894,3575850203,3575850236,33
2,472,3895,3575850203,3575850236,33
2,472,3896,3575850203,3575850238,35
2,472,3897,3575850203,3575850238,35
2,472,3898,3575850203,3575850244,41
2,472,3899,3575850203,3575850244,41
2,472,3900,3575850203,3575850245,42
2,472,3901,3575850203,3575850247,44
2,472,3902,3575850203,3575850249,46
2,472,3903,3575850203,3575850252,49
2,473,3904,3575850258,3575850258,0
2,473,3905,3575850258,3575850258,0
2,473,3906,3575850258,3575850259,1
2,473,3907,3575850258,3575850261,3
2,473,3908,3575850258,3575850263,5
2,473,3909,3575850258,3575850266,8
2,473,3910,3575850258,3575850269,11
2,473,3911,3575850258,3575850273,15
2,473,3912,3575850258,3575850277,19
2,473,3913,3575850258,3575850278,20
2,473,3914,3575850258,3575850278,20
2,473,3915,3575850258,3575850279,21
2,473,3916,3575850258,3575850279,21
2,473,3917,3575850258,3575850282,24
2,473,3918,3575850258,3575850283,25
2,473,3919,3575850258,3575850286,28
2,473,3920,3575850258,3575850288,30
2,473,3921,3575850258,3575850290,32
2,473,3922,3575850258,3575850290,32
2,473,3923,3575850258,3575850294,36
2,473,3924,3575850258,3575850295,37
2,473,3925,3575850258,3575850296,38
2,473,3926,3575850258,3575850299,41
2,473,3927,3575850258,3575850301,43
2,473,3928,3575850258,3575850301,43
2,473,3929,3575850258,3575850302,44
2,473,3930,3575850258,3575850303,45
2,473,3931,3575850258,3575850305,47
2,473,3932,3575850258,3575850306,48
2,474,3933,3575850312,3575850312,0
2,474,3934,3575850312,3575850312,0
2,474,3935,3575850312,3575850312,0
2,474,3936,3575850312,3575850313,1
2,474,3937,3575850312,3575850314,2
2,474,3938,3575850312,3575850315,3
2,474,3939,3575850312,3575850315,3
2,474,3940,3575850312,3575850317,5
2,474,3941,3575850312,3575850318,6
2,474,3942,3575850312,3575850322,10
2,474,3943,3575850312,3575850323,11
2,474,3944,3575850312,3575850325,13
2,474,3945,3575850312,3575850327,15
2,474,3946,3575850312,3575850327,15
2,474,3947,3575850312,3575850328,16
2,474,3948,3575850312,3575850331,19
2,474,3949,3575850312,3575850331,19
2,474,3950,3575850312,3575850332,20
2,474,3951,3575850312,3575850334,22
2,474,3952,3575850312,3575850335,23
2,474,3953,3575850312,3575850338,26
2,474,3954,3575850312,3575850345,33
2,474,3955,3575850312,3575850346,34
2,474,3956,3575850312,3575850349,37
2,474,3957,3575850312,3575850349,37
2,474,3958,3575850312,3575850351,39
2,474,3959,3575850312,3575850353,41
2,474,3960,3575850312,3575850358,46
2,475,3961,3575850365,3575850365,0
2,475,3962,3575850365,3575850365,0
2,475,3963,3575850365,3575850366,1
2,475,3964,3575850365,3575850368,3
2,475,3965,3575850365,3575850368,3
2,475,3966,3575850365,3575850370,5
2,475,3967,3575850365,3575850372,7
2,475,3968,3575850365,3575850373,8
2,475,3969,3575850365,3575850378,13
2,475,3970,3575850365,3575850379,14
2,475,3971,3575850365,3575850383,18
2,475,3972,3575850365,3575850384,19
2,475,3973,3575850365,3575850385,20
2,475,3974,3575850365,3575850385,20
2,475,3975,3575850365,3575850386,21
2,475,3976,3575850365,3575850387,22
2,475,3977,3575850365,3575850391,26
2,475,3978,3575850365,3575850391,26
2,475,3979,3575850365,3575850395,30
2,475,3980,3575850365,3575850395,30
2,475,3981,3575850365,3575850399,34
2,475,3982,3575850365,3575850403,38
2,475,3983,3575850365,3575850404,39
2,475,3984,3575850365,3575850405,40
2,475,3985,3575850365,3575850409,44
2,475,3986,3575850365,3575850413,48
2,475,3987,3575850365,3575850414,49
2,476,3988,3575850418,3575850418,0
2,476,3989,3575850418,3575850418,0
2,476,3990,3575850418,3575850421,3
2,476,3991,3575850418,3575850423,5
2,476,3992,3575850418,3575850423,5
2,476,3993,3575850418,3575850424,6
2,476,3994,3575850418,3575850426,8
2,476,3995,3575850418,3575850428,10
2,476,3996,3575850418,3575850429,11
2,476,3997,3575850418,3575850435,17
2,476,3998,3575850418,3575850435,17
2,476,3999,3575850418,3575850438,20
2,476,4000,3575850418,3575850444,26
2,476,4001,3575850418,3575850445,27
2,476,4002,3575850418,3575850445,27
2,476,4003,3575850418,3575850447,29
2,476,4004,3575850418,3575850449,31
2,476,4005,3575850418,3575850455,37
2,476,4006,3575850418,3575850457,39
2,476,4007,3575850418,3575850460,42
2,476,4008,3575850418,3575850462,44
2,476,4009,3575850418,3575850463,45
2,476,4010,3575850418,3575850467,49
2,477,4011,3575850471,3575850471,0
2,477,4012,3575850471,3575850473,2
2,477,4013,3575850471,3575850477,6
2,477,4014,3575850471,3575850478,7
2,477,4015,3575850471,3575850479,8
2,477,4016,3575850471,3575850479,8
2,477,4017,3575850471,3575850480,9
2,477,4018,3575850471,3575850483,12
2,477,4019,3575850471,3575850484,13
2,477,4020,3575850471,3575850486,15
2,477,4021,3575850471,3575850488,17
2,477,4022,3575850471,3575850490,19
2,477,4023,3575850471,3575850491,20
2,477,4024,3575850471,3575850494,23
2,477,4025,3575850471,3575850495,24
2,477,4026,3575850471,3575850495,24
2,477,4027,3575850471,3575850500,29
2,477,4028,3575850471,3575850501,30
2,477,4029,3575850471,3575850502,31
2,477,4030,3575850471,3575850503,32
2,477,4031,3575850471,3575850504,33
2,477,4032,3575850471,3575850506,35
2,477,4033,3575850471,3575850507,36
2,477,4034,3575850471,3575850510,39
2,477,4035,3575850471,3575850510,39
2,477,4036,3575850471,3575850512,41
2,477,4037,3575850471,3575850513,42
2,477,4038,3575850471,3575850514,43
2,477,4039,3575850471,3575850515,44
2,477,4040,3575850471,3575850516,45
2,477,4041,3575850471,3575850518,47
2,477,4042,3575850471,3575850519,48
2,478,4043,3575850525,3575850525,0
2,478,4044,3575850525,3575850525,0
2,478,4045,3575850525,3575850525,0
2,478,4046,3575850525,3575850527,2
2,478,4047,3575850525,3575850528,3
2,478,4048,3575850525,3575850529,4
2,478,4049,3575850525,3575850531,6
2,478,4050,3575850525,3575850531,6
2,478,4051,3575850525,3575850533,8
2,478,4052,3575850525,3575850534,9
2,478,4053,3575850525,3575850538,13
2,478,4054,3575850525,3575850539,14
2,478,4055,3575850525,3575850545,20
2,478,4056,3575850525,3575850546,21
2,478,4057,3575850525,3575850548,23
2,478,4058,3575850525,3575850549,24
2,478,4059,3575850525,3575850552,27
2,478,4060,3575850525,3575850557,32
2,478,4061,3575850525,3575850562,37
2,478,4062,3575850525,3575850565,40
2,478,4063,3575850525,3575850566,41
2,478,4064,3575850525,3575850566,41
2,478,4065,3575850525,3575850567,42
2,478,4066,3575850525,3575850569,44
2,478,4067,3575850525,3575850570,45
2,478,4068,3575850525,3575850573,48
2,479,4069,3575850579,3575850579,0
2,479,4070,3575850579,3575850579,0
2,479,4071,3575850579,3575850582,3
2,479,4072,3575850579,3575850583,4
2,479,4073,3575850579,3575850583,4
2,479,4074,3575850579,3575850584,5
2,479,4075,3575850579,3575850585,6
2,479,4076,3575850579,3575850587,8
2,479,4077,3575850579,3575850590,11
2,479,4078,3575850579,3575850590,11
2,479,4079,3575850579,3575850593,14
2,479,4080,3575850579,3575850594,15
2,479,4081,3575850579,3575850598,19
2,479,4082,3575850579,3575850602,23
2,479,4083,3575850579,3575850604,25
2,479,4084,3575850579,3575850604,25
2,479,4085,3575850579,3575850608,29
2,479,4086,3575850579,3575850612,33
2,479,4087,3575850579,3575850613,34
2,479,4088,3575850579,3575850615,36
2,479,4089,3575850579,3575850617,38
2,479,4090,3575850579,3575850620,41
2,479,4091,3575850579,3575850622,43
2,479,4092,3575850579,3575850622,43
2,479,4093,3575850579,3575850624,45
2,479,4094,3575850579,3575850625,46
2,479,4095,3575850579,3575850626,47
2,479,4096,3575850579,3575850627,48
2,480,4097,3575850632,3575850635,3
2,480,4098,3575850632,3575850638,6
2,480,4099,3575850632,3575850643,11
2,480,4100,3575850632,3575850644,12
2,480,4101,3575850632,3575850644,12
2,480,4102,3575850632,3575850646,14
2,480,4103,3575850632,3575850649,17
2,480,4104,3575850632,3575850654,22
2,480,4105,3575850632,3575850656,24
2,480,4106,3575850632,3575850659,27
2,480,4107,3575850632,3575850661,29
2,480,4108,3575850632,3575850663,31
2,480,4109,3575850632,3575850666,34
2,480,4110,3575850632,3575850670,38
2,480,4111,3575850632,3575850673,41
2,480,4112,3575850632,3575850677,45
2,480,4113,3575850632,3575850678,46
2,480,4114,3575850632,3575850678,46
2,480,4115,3575850632,3575850679,47
2,480,4116,3575850632,3575850680,48
2,481,4117,3575850685,3575850685,0
2,481,4118,3575850685,3575850685,0
2,481,4119,3575850685,3575850686,1
2,481,4120,3575850685,3575850689,4
2,481,4121,3575850685,3575850691,6
2,481,4122,3575850685,3575850691,6
2,481,4123,3575850685,3575850694,9
2,481,4124,3575850685,3575850695,10
2,481,4125,3575850685,3575850695,10
2,481,4126,3575850685,3575850701,16
2,481,4127,3575850685,3575850702,17
2,481,4128,3575850685,3575850702,17
2,481,4129,3575850685,3575850703,18
2,481,4130,3575850685,3575850705,20
2,481,4131,3575850685,3575850706,21
2,481,4132,3575850685,3575850707,22
2,481,4133,3575850685,3575850710,25
2,481,4134,3575850685,3575850711,26
2,481,4135,3575850685,3575850712,27
2,481,4136,3575850685,3575850713,28
2,481,4137,3575850685,3575850714,29
2,481,4138,3575850685,3575850715,30
2,481,4139,3575850685,3575850716,31
2,481,4140,3575850685,3575850718,33
2,481,4141,3575850685,3575850719,34
2,481,4142,3575850685,3575850721,36
2,481,4143,3575850685,3575850722,37
2,481,4144,3575850685,3575850723,38
2,481,4145,3575850685,3575850727,42
2,481,4146,3575850685,3575850728,43
2,481,4147,3575850685,3575850729,44
2,481,4148,3575850685,3575850730,45
2,481,4149,3575850685,3575850731,46
2,481,4150,3575850685,3575850733,48
2,481,4151,3575850685,3575850734,49
2,482,4152,3575850738,3575850739,1
2,482,4153,3575850738,3575850739,1
2,482,4154,3575850738,3575850745,7
2,482,4155,3575850738,3575850745,7
2,482,4156,3575850738,3575850748,10
2,482,4157,3575850738,3575850748,10
2,482,4158,3575850738,3575850752,14
2,482,4159,3575850738,3575850757,19
2,482,4160,3575850738,3575850761,23
2,482,4161,3575850738,3575850762,24
2,482,4162,3575850738,3575850765,27
2,482,4163,3575850738,3575850766,28
2,482,4164,3575850738,3575850767,29
2,482,4165,3575850738,3575850768,30
2,482,4166,3575850738,3575850769,31
2,482,4167,3575850738,3575850772,34
2,482,4168,3575850738,3575850772,34
2,482,4169,3575850738,3575850778,40
2,482,4170,3575850738,3575850778,40
2,482,4171,3575850738,3575850782,44
2,482,4172,3575850738,3575850784,46
2,482,4173,3575850738,3575850784,46
2,482,4174,3575850738,3575850784,46
2,482,4175,3575850738,3575850785,47
2,482,4176,3575850738,3575850787,49
2,483,4177,3575850791,3575850791,0
2,483,4178,3575850791,3575850791,0
2,483,4179,3575850791,3575850794,3
2,483,4180,3575850791,3575850795,4
2,483,4181,3575850791,3575850798,7
2,483,4182,3575850791,3575850802,11
2,483,4183,3575850791,3575850804,13
2,483,4184,3575850791,3575850805,14
2,483,4185,3575850791,3575850808,17
2,483,4186,3575850791,3575850811,20
2,483,4187,3575850791,3575850812,21
2,483,4188,3575850791,3575850813,22
2,483,4189,3575850791,3575850814,23
2,483,4190,3575850791,3575850818,27
2,483,4191,3575850791,3575850822,31
2,483,4192,3575850791,3575850822,31
2,483,4193,3575850791,3575850824,33
2,483,4194,3575850791,3575850825,34
2,483,4195,3575850791,3575850828,37
2,483,4196,3575850791,3575850829,38
2,483,4197,3575850791,3575850835,44
2,483,4198,3575850791,3575850838,47
2,483,4199,3575850791,3575850839,48
2,484,4200,3575850844,3575850844,0
2,484,4201,3575850844,3575850844,0
2,484,4202,3575850844,3575850845,1
2,484,4203,3575850844,3575850846,2
2,484,4204,3575850844,3575850848,4
2,484,4205,3575850844,3575850851,7
2,484,4206,3575850844,3575850854,10
2,484,4207,3575850844,3575850856,12
2,484,4208,3575850844,3575850860,16
2,484,4209,3575850844,3575850861,17
2,484,4210,3575850844,3575850862,18
2,484,4211,3575850844,3575850863,19
2,484,4212,3575850844,3575850866,22
2,484,4213,3575850844,3575850870,26
2,484,4214,3575850844,3575850873,29
2,484,4215,3575850844,3575850877,33
2,484,4216,3575850844,3575850878,34
2,484,4217,3575850844,3575850878,34
2,484,4218,3575850844,3575850879,35
2,484,4219,3575850844,3575850879,35
2,484,4220,3575850844,3575850882,38
2,484,4221,3575850844,3575850884,40
2,484,4222,3575850844,3575850886,42
2,484,4223,3575850844,3575850888,44
2,484,4224,3575850844,3575850891,47
2,484,4225,3575850844,3575850892,48
2,485,4226,3575850897,3575850897,0
2,485,4227,3575850897,3575850897,0
2,485,4228,3575850897,3575850897,0
2,485,4229,3575850897,3575850900,3
2,485,4230,3575850897,3575850901,4
2,485,4231,3575850897,3575850902,5
2,485,4232,3575850897,3575850903,6
2,485,4233,3575850897,3575850904,7
2,485,4234,3575850897,3575850906,9
2,485,4235,3575850897,3575850907,10
2,485,4236,3575850897,3575850910,13
2,485,4237,3575850897,3575850910,13
2,485,4238,3575850897,3575850912,15
2,485,4239,3575850897,3575850913,16
2,485,4240,3575850897,3575850914,17
2,485,4241,3575850897,3575850915,18
2,485,4242,3575850897,3575850916,19
2,485,4243,3575850897,3575850918,21
2,485,4244,3575850897,3575850919,22
2,485,4245,3575850897,3575850922,25
2,485,4246,3575850897,3575850923,26
2,485,4247,3575850897,3575850923,26
2,485,4248,3575850897,3575850927,30
2,485,4249,3575850897,3575850927,30
2,485,4250,3575850897,3575850931,34
2,485,4251,3575850897,3575850931,34
2,485,4252,3575850897,3575850932,35
2,485,4253,3575850897,3575850933,36
2,485,4254,3575850897,3575850934,37
2,485,4255,3575850897,3575850939,42
2,485,4256,3575850897,3575850940,43
2,485,4257,3575850897,3575850945,48
2,485,4258,3575850897,3575850946,49
2,486,4259,3575850950,3575850950,0
2,486,4260,3575850950,3575850950,0
2,486,4261,3575850950,3575850951,1
2,486,4262,3575850950,3575850951,1
2,486,4263,3575850950,3575850957,7
2,486,4264,3575850950,3575850960,10
2,486,4265,3575850950,3575850962,12
2,486,4266,3575850950,3575850964,14
2,486,4267,3575850950,3575850965,15
2,486,4268,3575850950,3575850967,17
2,486,4269,3575850950,3575850967,17
2,486,4270,3575850950,3575850968,18
2,486,4271,3575850950,3575850969,19
2,486,4272,3575850950,3575850972,22
2,486,4273,3575850950,3575850973,23
2,486,4274,3575850950,3575850977,27
2,486,4275,3575850950,3575850979,29
2,486,4276,3575850950,3575850983,33
2,486,4277,3575850950,3575850984,34
2,486,4278,3575850950,3575850985,35
2,486,4279,3575850950,3575850985,35
2,486,4280,3575850950,3575850986,36
2,486,4281,3575850950,3575850988,38
2,486,4282,3575850950,3575850990,40
2,486,4283,3575850950,3575850991,41
2,486,4284,3575850950,3575850993,43
2,486,4285,3575850950,3575850995,45
2,486,4286,3575850950,3575850999,49
2,487,4287,3575851003,3575851003,0
2,487,4288,3575851003,3575851004,1
2,487,4289,3575851003,3575851005,2
2,487,4290,3575851003,3575851012,9
2,487,4291,3575851003,3575851012,9
2,487,4292,3575851003,3575851013,10
2,487,4293,3575851003,3575851014,11
2,487,4294,3575851003,3575851017,14
2,487,4295,3575851003,3575851022,19
2,487,4296,3575851003,3575851022,19
2,487,4297,3575851003,3575851025,22
2,487,4298,3575851003,3575851025,22
2,487,4299,3575851003,3575851029,26
2,487,4300,3575851003,3575851029,26
2,487,4301,3575851003,3575851035,32
2,487,4302,3575851003,3575851036,33
2,487,4303,3575851003,3575851038,35
2,487,4304,3575851003,3575851039,36
2,487,4305,3575851003,3575851043,40
2,487,4306,3575851003,3575851045,42
2,487,4307,3575851003,3575851045,42
2,487,4308,3575851003,3575851046,43
2,487,4309,3575851003,3575851049,46
2,487,4310,3575851003,3575851051,48
2,488,4311,3575851057,3575851057,0
2,488,4312,3575851057,3575851057,0
2,488,4313,3575851057,3575851060,3
2,488,4314,3575851057,3575851061,4
2,488,4315,3575851057,3575851062,5
2,488,4316,3575851057,3575851063,6
2,488,4317,3575851057,3575851066,9
2,488,4318,3575851057,3575851070,13
2,488,4319,3575851057,3575851073,16
2,488,4320,3575851057,3575851077,20
2,488,4321,3575851057,3575851078,21
2,488,4322,3575851057,3575851079,22
2,488,4323,3575851057,3575851079,22
2,488,4324,3575851057,3575851079,22
2,488,4325,3575851057,3575851083,26
2,488,4326,3575851057,3575851084,27
2,488,4327,3575851057,3575851086,29
2,488,4328,3575851057,3575851089,32
2,488,4329,3575851057,3575851091,34
2,488,4330,3575851057,3575851092,35
2,488,4331,3575851057,3575851094,37
2,488,4332,3575851057,3575851095,38
2,488,4333,3575851057,3575851096,39
2,488,4334,3575851057,3575851099,42
2,488,4335,3575851057,3575851101,44
2,488,4336,3575851057,3575851101,44
2,488,4337,3575851057,3575851102,45
2,488,4338,3575851057,3575851103,46
2,488,4339,3575851057,3575851105,48
2,488,4340,3575851057,3575851106,49
2,488,4341,3575851057,3575851107,50
2,489,4342,3575851111,3575851111,0
2,489,4343,3575851111,3575851111,0
2,489,4344,3575851111,3575851112,1
2,489,4345,3575851111,3575851114,3
2,489,4346,3575851111,3575851114,3
2,489,4347,3575851111,3575851115,4
2,489,4348,3575851111,3575851115,4
2,489,4349,3575851111,3575851115,4
2,489,4350,3575851111,3575851118,7
2,489,4351,3575851111,3575851119,8
2,489,4352,3575851111,3575851122,11
2,489,4353,3575851111,3575851123,12
2,489,4354,3575851111,3575851124,13
2,489,4355,3575851111,3575851127,16
2,489,4356,3575851111,3575851127,16
2,489,4357,3575851111,3575851131,20
2,489,4358,3575851111,3575851131,20
2,489,4359,3575851111,3575851133,22
2,489,4360,3575851111,3575851134,23
2,489,4361,3575851111,3575851134,23
2,489,4362,3575851111,3575851139,28
2,489,4363,3575851111,3575851140,29
2,489,4364,3575851111,3575851145,34
2,489,4365,3575851111,3575851146,35
2,489,4366,3575851111,3575851149,38
2,489,4367,3575851111,3575851150,39
2,489,4368,3575851111,3575851150,39
2,489,4369,3575851111,3575851158,47
2,489,4370,3575851111,3575851160,49
2,490,4371,3575851164,3575851164,0
2,490,4372,3575851164,3575851164,0
2,490,4373,3575851164,3575851165,1
2,490,4374,3575851164,3575851167,3
2,490,4375,3575851164,3575851167,3
2,490,4376,3575851164,3575851167,3
2,490,4377,3575851164,3575851170,6
2,490,4378,3575851164,3575851172,8
2,490,4379,3575851164,3575851174,10
2,490,4380,3575851164,3575851177,13
2,490,4381,3575851164,3575851179,15
2,490,4382,3575851164,3575851183,19
2,490,4383,3575851164,3575851185,21
2,490,4384,3575851164,3575851185,21
2,490,4385,3575851164,3575851185,21
2,490,4386,3575851164,3575851185,21
2,490,4387,3575851164,3575851188,24
2,490,4388,3575851164,3575851191,27
2,490,4389,3575851164,3575851194,30
2,490,4390,3575851164,3575851195,31
2,490,4391,3575851164,3575851199,35
2,490,4392,3575851164,3575851202,38
2,490,4393,3575851164,3575851204,40
2,490,4394,3575851164,3575851204,40
2,490,4395,3575851164,3575851209,45
2,490,4396,3575851164,3575851212,48
2,490,4397,3575851164,3575851213,49
2,490,4398,3575851164,3575851214,50
2,491,4399,3575851217,3575851217,0
2,491,4400,3575851217,3575851217,0
2,491,4401,3575851217,3575851220,3
2,491,4402,3575851217,3575851222,5
2,491,4403,3575851217,3575851222,5
2,491,4404,3575851217,3575851225,8
2,491,4405,3575851217,3575851229,12
2,491,4406,3575851217,3575851229,12
2,491,4407,3575851217,3575851235,18
2,491,4408,3575851217,3575851236,19
2,491,4409,3575851217,3575851238,21
2,491,4410,3575851217,3575851238,21
2,491,4411,3575851217,3575851244,27
2,491,4412,3575851217,3575851245,28
2,491,4413,3575851217,3575851247,30
2,491,4414,3575851217,3575851250,33
2,491,4415,3575851217,3575851251,34
2,491,4416,3575851217,3575851255,38
2,491,4417,3575851217,3575851255,38
2,491,4418,3575851217,3575851259,42
2,491,4419,3575851217,3575851260,43
2,491,4420,3575851217,3575851263,46
2,491,4421,3575851217,3575851266,49
2,492,4422,3575851271,3575851271,0
2,492,4423,3575851271,3575851274,3
2,492,4424,3575851271,3575851277,6
2,492,4425,3575851271,3575851278,7
2,492,4426,3575851271,3575851278,7
2,492,4427,3575851271,3575851279,8
2,492,4428,3575851271,3575851280,9
2,492,4429,3575851271,3575851283,12
2,492,4430,3575851271,3575851284,13
2,492,4431,3575851271,3575851286,15
2,492,4432,3575851271,3575851291,20
2,492,4433,3575851271,3575851292,21
2,492,4434,3575851271,3575851294,23
2,492,4435,3575851271,3575851296,25
2,492,4436,3575851271,3575851297,26
2,492,4437,3575851271,3575851299,28
2,492,4438,3575851271,3575851301,30
2,492,4439,3575851271,3575851301,30
2,492,4440,3575851271,3575851302,31
2,492,4441,3575851271,3575851303,32
2,492,4442,3575851271,3575851304,33
2,492,4443,3575851271,3575851306,35
2,492,4444,3575851271,3575851307,36
2,492,4445,3575851271,3575851310,39
2,492,4446,3575851271,3575851310,39
2,492,4447,3575851271,3575851312,41
2,492,4448,3575851271,3575851314,43
2,492,4449,3575851271,3575851315,44
2,492,4450,3575851271,3575851315,44
2,492,4451,3575851271,3575851315,44
2,492,4452,3575851271,3575851316,45
2,492,4453,3575851271,3575851318,47
2,492,4454,3575851271,3575851319,48
2,493,4455,3575851325,3575851325,0
2,493,4456,3575851325,3575851325,0
2,493,4457,3575851325,3575851325,0
2,493,4458,3575851325,3575851327,2
2,493,4459,3575851325,3575851328,3
2,493,4460,3575851325,3575851330,5
2,493,4461,3575851325,3575851332,7
2,493,4462,3575851325,3575851334,9
2,493,4463,3575851325,3575851334,9
2,493,4464,3575851325,3575851335,10
2,493,4465,3575851325,3575851339,14
2,493,4466,3575851325,3575851340,15
2,493,4467,3575851325,3575851345,20
2,493,4468,3575851325,3575851346,21
2,493,4469,3575851325,3575851349,24
2,493,4470,3575851325,3575851350,25
2,493,4471,3575851325,3575851352,27
2,493,4472,3575851325,3575851358,33
2,493,4473,3575851325,3575851360,35
2,493,4474,3575851325,3575851362,37
2,493,4475,3575851325,3575851364,39
2,493,4476,3575851325,3575851365,40
2,493,4477,3575851325,3575851367,42
2,493,4478,3575851325,3575851367,42
2,493,4479,3575851325,3575851368,43
2,493,4480,3575851325,3575851370,45
2,493,4481,3575851325,3575851373,48
2,493,4482,3575851325,3575851374,49
2,494,4483,3575851379,3575851379,0
2,494,4484,3575851379,3575851379,0
2,494,4485,3575851379,3575851383,4
2,494,4486,3575851379,3575851384,5
2,494,4487,3575851379,3575851384,5
2,494,4488,3575851379,3575851385,6
2,494,4489,3575851379,3575851386,7
2,494,4490,3575851379,3575851387,8
2,494,4491,3575851379,3575851390,11
2,494,4492,3575851379,3575851394,15
2,494,4493,3575851379,3575851395,16
2,494,4494,3575851379,3575851399,20
2,494,4495,3575851379,3575851403,24
2,494,4496,3575851379,3575851404,25
2,494,4497,3575851379,3575851404,25
2,494,4498,3575851379,3575851409,30
2,494,4499,3575851379,3575851413,34
2,494,4500,3575851379,3575851414,35
2,494,4501,3575851379,3575851414,35
2,494,4502,3575851379,3575851418,39
2,494,4503,3575851379,3575851421,42
2,494,4504,3575851379,3575851423,44
2,494,4505,3575851379,3575851423,44
2,494,4506,3575851379,3575851424,45
2,494,4507,3575851379,3575851426,47
2,494,4508,3575851379,3575851428,49
2,494,4509,3575851379,3575851429,50
2,495,4510,3575851432,3575851436,4
2,495,4511,3575851432,3575851436,4
2,495,4512,3575851432,3575851438,6
2,495,4513,3575851432,3575851440,8
2,495,4514,3575851432,3575851444,12
2,495,4515,3575851432,3575851445,13
2,495,4516,3575851432,3575851445,13
2,495,4517,3575851432,3575851447,15
2,495,4518,3575851432,3575851450,18
2,495,4519,3575851432,3575851451,19
2,495,4520,3575851432,3575851454,22
2,495,4521,3575851432,3575851456,24
2,495,4522,3575851432,3575851459,27
2,495,4523,3575851432,3575851462,30
2,495,4524,3575851432,3575851463,31
2,495,4525,3575851432,3575851467,35
2,495,4526,3575851432,3575851470,38
2,495,4527,3575851432,3575851474,42
2,495,4528,3575851432,3575851477,45
2,495,4529,3575851432,3575851478,46
2,495,4530,3575851432,3575851478,46
2,495,4531,3575851432,3575851479,47
2,495,4532,3575851432,3575851479,47
2,496,4533,3575851485,3575851485,0
2,496,4534,3575851485,3575851485,0
2,496,4535,3575851485,3575851485,0
2,496,4536,3575851485,3575851489,4
2,496,4537,3575851485,3575851491,6
2,496,4538,3575851485,3575851493,8
2,496,4539,3575851485,3575851494,9
2,496,4540,3575851485,3575851496,11
2,496,4541,3575851485,3575851499,14
2,496,4542,3575851485,3575851499,14
2,496,4543,3575851485,3575851500,15
2,496,4544,3575851485,3575851501,16
2,496,4545,3575851485,3575851502,17
2,496,4546,3575851485,3575851503,18
2,496,4547,3575851485,3575851505,20
2,496,4548,3575851485,3575851506,21
2,496,4549,3575851485,3575851509,24
2,496,4550,3575851485,3575851509,24
2,496,4551,3575851485,3575851511,26
2,496,4552,3575851485,3575851513,28
2,496,4553,3575851485,3575851514,29
2,496,4554,3575851485,3575851514,29
2,496,4555,3575851485,3575851514,29
2,496,4556,3575851485,3575851515,30
2,496,4557,3575851485,3575851517,32
2,496,4558,3575851485,3575851518,33
2,496,4559,3575851485,3575851520,35
2,496,4560,3575851485,3575851520,35
2,496,4561,3575851485,3575851522,37
2,496,4562,3575851485,3575851524,39
2,496,4563,3575851485,3575851527,42
2,496,4564,3575851485,3575851528,43
2,496,4565,3575851485,3575851530,45
2,496,4566,3575851485,3575851531,46
2,496,4567,3575851485,3575851533,48
2,496,4568,3575851485,3575851534,49
2,497,4569,3575851538,3575851538,0
2,497,4570,3575851538,3575851538,0
2,497,4571,3575851538,3575851544,6
2,497,4572,3575851538,3575851545,7
2,497,4573,3575851538,3575851549,11
2,497,4574,3575851538,3575851549,11
2,497,4575,3575851538,3575851550,12
2,497,4576,3575851538,3575851551,13
2,497,4577,3575851538,3575851557,19
2,497,4578,3575851538,3575851560,22
2,497,4579,3575851538,3575851562,24
2,497,4580,3575851538,3575851564,26
2,497,4581,3575851538,3575851564,26
2,497,4582,3575851538,3575851565,27
2,497,4583,3575851538,3575851566,28
2,497,4584,3575851538,3575851566,28
2,497,4585,3575851538,3575851567,29
2,497,4586,3575851538,3575851570,32
2,497,4587,3575851538,3575851571,33
2,497,4588,3575851538,3575851573,35
2,497,4589,3575851538,3575851576,38
2,497,4590,3575851538,3575851578,40
2,497,4591,3575851538,3575851582,44
2,497,4592,3575851538,3575851583,45
2,497,4593,3575851538,3575851584,46
2,497,4594,3575851538,3575851584,46
2,497,4595,3575851538,3575851585,47
2,498,4596,3575851592,3575851592,0
2,498,4597,3575851592,3575851592,0
2,498,4598,3575851592,3575851592,0
2,498,4599,3575851592,3575851592,0
2,498,4600,3575851592,3575851594,2
2,498,4601,3575851592,3575851598,6
2,498,4602,3575851592,3575851601,9
2,498,4603,3575851592,3575851603,11
2,498,4604,3575851592,3575851604,12
2,498,4605,3575851592,3575851612,20
2,498,4606,3575851592,3575851612,20
2,498,4607,3575851592,3575851613,21
2,498,4608,3575851592,3575851615,23
2,498,4609,3575851592,3575851617,25
2,498,4610,3575851592,3575851620,28
2,498,4611,3575851592,3575851622,30
2,498,4612,3575851592,3575851623,31
2,498,4613,3575851592,3575851624,32
2,498,4614,3575851592,3575851625,33
2,498,4615,3575851592,3575851628,36
2,498,4616,3575851592,3575851628,36
2,498,4617,3575851592,3575851635,43
2,498,4618,3575851592,3575851636,44
2,498,4619,3575851592,3575851638,46
2,498,4620,3575851592,3575851638,46
2,499,4621,3575851646,3575851646,0
2,499,4622,3575851646,3575851646,0
2,499,4623,3575851646,3575851646,0
2,499,4624,3575851646,3575851646,0
2,499,4625,3575851646,3575851649,3
2,499,4626,3575851646,3575851651,5
2,499,4627,3575851646,3575851654,8
2,499,4628,3575851646,3575851655,9
2,499,4629,3575851646,3575851658,12
2,499,4630,3575851646,3575851660,14
2,499,4631,3575851646,3575851663,17
2,499,4632,3575851646,3575851666,20
2,499,4633,3575851646,3575851668,22
2,499,4634,3575851646,3575851674,28
2,499,4635,3575851646,3575851677,31
2,499,4636,3575851646,3575851678,32
2,499,4637,3575851646,3575851679,33
2,499,4638,3575851646,3575851680,34
2,499,4639,3575851646,3575851680,34
2,499,4640,3575851646,3575851683,37
2,499,4641,3575851646,3575851684,38
2,499,4642,3575851646,3575851685,39
2,499,4643,3575851646,3575851687,41
2,499,4644,3575851646,3575851690,44
2,499,4645,3575851646,3575851690,44
2,499,4646,3575851646,3575851693,47
2,499,4647,3575851646,3575851695,49
2,500,4648,3575851700,3575851700,0
2,500,4649,3575851700,3575851700,0
2,500,4650,3575851700,3575851700,0
2,500,4651,3575851700,3575851700,0
2,500,4652,3575851700,3575851701,1
2,500,4653,3575851700,3575851702,2
2,500,4654,3575851700,3575851703,3
2,500,4655,3575851700,3575851705,5
2,500,4656,3575851700,3575851706,6
2,500,4657,3575851700,3575851709,9
2,500,4658,3575851700,3575851709,9
2,500,4659,3575851700,3575851711,11
2,500,4660,3575851700,3575851713,13
2,500,4661,3575851700,3575851714,14
2,500,4662,3575851700,3575851714,14
2,500,4663,3575851700,3575851714,14
2,500,4664,3575851700,3575851715,15
2,500,4665,3575851700,3575851717,17
2,500,4666,3575851700,3575851718,18
2,500,4667,3575851700,3575851720,20
2,500,4668,3575851700,3575851721,21
2,500,4669,3575851700,3575851722,22
2,500,4670,3575851700,3575851724,24
2,500,4671,3575851700,3575851727,27
2,500,4672,3575851700,3575851729,29
2,500,4673,3575851700,3575851730,30
2,500,4674,3575851700,3575851731,31
2,500,4675,3575851700,3575851733,33
2,500,4676,3575851700,3575851734,34
2,500,4677,3575851700,3575851737,37
2,500,4678,3575851700,3575851745,45
2,500,4679,3575851700,3575851745,45
2,500,4680,3575851700,3575851748,48
2,500,4681,3575851700,3575851749,49
2,501,4682,3575851753,3575851753,0
2,501,4683,3575851753,3575851753,0
2,501,4684,3575851753,3575851757,4
2,501,4685,3575851753,3575851759,6
2,501,4686,3575851753,3575851762,9
2,501,4687,3575851753,3575851763,10
2,501,4688,3575851753,3575851765,12
2,501,4689,3575851753,3575851765,12
2,501,4690,3575851753,3575851767,14
2,501,4691,3575851753,3575851768,15
2,501,4692,3575851753,3575851769,16
2,501,4693,3575851753,3575851770,17
2,501,4694,3575851753,3575851772,19
2,501,4695,3575851753,3575851774,21
2,501,4696,3575851753,3575851777,24
2,501,4697,3575851753,3575851779,26
2,501,4698,3575851753,3575851782,29
2,501,4699,3575851753,3575851784,31
2,501,4700,3575851753,3575851784,31
2,501,4701,3575851753,3575851784,31
2,501,4702,3575851753,3575851785,32
2,501,4703,3575851753,3575851787,34
2,501,4704,3575851753,3575851791,38
2,501,4705,3575851753,3575851791,38
2,501,4706,3575851753,3575851793,40
2,501,4707,3575851753,3575851794,41
2,501,4708,3575851753,3575851798,45
2,501,4709,3575851753,3575851802,49
2,502,4710,3575851806,3575851806,0
2,502,4711,3575851806,3575851806,0
2,502,4712,3575851806,3575851811,5
2,502,4713,3575851806,3575851812,6
2,502,4714,3575851806,3575851813,7
2,502,4715,3575851806,3575851814,8
2,502,4716,3575851806,3575851818,12
2,502,4717,3575851806,3575851819,13
2,502,4718,3575851806,3575851822,16
2,502,4719,3575851806,3575851824,18
2,502,4720,3575851806,3575851825,19
2,502,4721,3575851806,3575851828,22
2,502,4722,3575851806,3575851828,22
2,502,4723,3575851806,3575851835,29
2,502,4724,3575851806,3575851836,30
2,502,4725,3575851806,3575851838,32
2,502,4726,3575851806,3575851839,33
2,502,4727,3575851806,3575851843,37
2,502,4728,3575851806,3575851845,39
2,502,4729,3575851806,3575851845,39
2,502,4730,3575851806,3575851846,40
2,502,4731,3575851806,3575851848,42
2,502,4732,3575851806,3575851849,43
2,502,4733,3575851806,3575851852,46
2,502,4734,3575851806,3575851855,49
2,503,4735,3575851860,3575851860,0
2,503,4736,3575851860,3575851860,0
2,503,4737,3575851860,3575851860,0
2,503,4738,3575851860,3575851861,1
2,503,4739,3575851860,3575851863,3
2,503,4740,3575851860,3575851866,6
2,503,4741,3575851860,3575851869,9
2,503,4742,3575851860,3575851875,15
2,503,4743,3575851860,3575851876,16
2,503,4744,3575851860,3575851878,18
2,503,4745,3575851860,3575851879,19
2,503,4746,3575851860,3575851879,19
2,503,4747,3575851860,3575851880,20
2,503,4748,3575851860,3575851884,24
2,503,4749,3575851860,3575851884,24
2,503,4750,3575851860,3575851885,25
2,503,4751,3575851860,3575851888,28
2,503,4752,3575851860,3575851891,31
2,503,4753,3575851860,3575851891,31
2,503,4754,3575851860,3575851893,33
2,503,4755,3575851860,3575851895,35
2,503,4756,3575851860,3575851896,36
2,503,4757,3575851860,3575851899,39
2,503,4758,3575851860,3575851900,40
2,503,4759,3575851860,3575851900,40
2,503,4760,3575851860,3575851901,41
2,503,4761,3575851860,3575851902,42
2,503,4762,3575851860,3575851904,44
2,503,4763,3575851860,3575851905,45
2,503,4764,3575851860,3575851906,46
2,503,4765,3575851860,3575851910,50
2,504,4766,3575851913,3575851913,0
2,504,4767,3575851913,3575851913,0
2,504,4768,3575851913,3575851913,0
2,504,4769,3575851913,3575851914,1
2,504,4770,3575851913,3575851915,2
2,504,4771,3575851913,3575851915,2
2,504,4772,3575851913,3575851915,2
2,504,4773,3575851913,3575851917,4
2,504,4774,3575851913,3575851918,5
2,504,4775,3575851913,3575851920,7
2,504,4776,3575851913,3575851920,7
2,504,4777,3575851913,3575851923,10
2,504,4778,3575851913,3575851924,11
2,504,4779,3575851913,3575851928,15
2,504,4780,3575851913,3575851928,15
2,504,4781,3575851913,3575851930,17
2,504,4782,3575851913,3575851931,18
2,504,4783,3575851913,3575851934,21
2,504,4784,3575851913,3575851934,21
2,504,4785,3575851913,3575851938,25
2,504,4786,3575851913,3575851944,31
2,504,4787,3575851913,3575851945,32
2,504,4788,3575851913,3575851948,35
2,504,4789,3575851913,3575851949,36
2,504,4790,3575851913,3575851952,39
2,504,4791,3575851913,3575851957,44
2,504,4792,3575851913,3575851959,46
2,504,4793,3575851913,3575851962,49
2,505,4794,3575851967,3575851967,0
2,505,4795,3575851967,3575851967,0
2,505,4796,3575851967,3575851967,0
2,505,4797,3575851967,3575851968,1
2,505,4798,3575851967,3575851968,1
2,505,4799,3575851967,3575851970,3
2,505,4800,3575851967,3575851972,5
2,505,4801,3575851967,3575851974,7
2,505,4802,3575851967,3575851978,11
2,505,4803,3575851967,3575851978,11
2,505,4804,3575851967,3575851982,15
2,505,4805,3575851967,3575851983,16
2,505,4806,3575851967,3575851985,18
2,505,4807,3575851967,3575851985,18
2,505,4808,3575851967,3575851986,19
2,505,4809,3575851967,3575851987,20
2,505,4810,3575851967,3575851991,24
2,505,4811,3575851967,3575851991,24
2,505,4812,3575851967,3575851994,27
2,505,4813,3575851967,3575851995,28
2,505,4814,3575851967,3575851999,32
2,505,4815,3575851967,3575852002,35
2,505,4816,3575851967,3575852004,37
2,505,4817,3575851967,3575852004,37
2,505,4818,3575851967,3575852011,44
2,505,4819,3575851967,3575852012,45
2,505,4820,3575851967,3575852013,46
2,505,4821,3575851967,3575852014,47
2,506,4822,3575852020,3575852020,0
2,506,4823,3575852020,3575852020,0
2,506,4824,3575852020,3575852022,2
2,506,4825,3575852020,3575852025,5
2,506,4826,3575852020,3575852025,5
2,506,4827,3575852020,3575852028,8
2,506,4828,3575852020,3575852029,9
2,506,4829,3575852020,3575852035,15
2,506,4830,3575852020,3575852037,17
2,506,4831,3575852020,3575852038,18
2,506,4832,3575852020,3575852039,19
2,506,4833,3575852020,3575852043,23
2,506,4834,3575852020,3575852044,24
2,506,4835,3575852020,3575852045,25
2,506,4836,3575852020,3575852047,27
2,506,4837,3575852020,3575852049,29
2,506,4838,3575852020,3575852051,31
2,506,4839,3575852020,3575852055,35
2,506,4840,3575852020,3575852055,35
2,506,4841,3575852020,3575852059,39
2,506,4842,3575852020,3575852060,40
2,506,4843,3575852020,3575852061,41
2,506,4844,3575852020,3575852063,43
2,506,4845,3575852020,3575852066,46
2,506,4846,3575852020,3575852069,49
2,507,4847,3575852073,3575852074,1
2,507,4848,3575852073,3575852077,4
2,507,4849,3575852073,3575852078,5
2,507,4850,3575852073,3575852078,5
2,507,4851,3575852073,3575852080,7
2,507,4852,3575852073,3575852080,7
2,507,4853,3575852073,3575852080,7
2,507,4854,3575852073,3575852083,10
2,507,4855,3575852073,3575852085,12
2,507,4856,3575852073,3575852085,12
2,507,4857,3575852073,3575852087,14
2,507,4858,3575852073,3575852091,18
2,507,4859,3575852073,3575852091,18
2,507,4860,3575852073,3575852093,20
2,507,4861,3575852073,3575852095,22
2,507,4862,3575852073,3575852096,23
2,507,4863,3575852073,3575852100,27
2,507,4864,3575852073,3575852100,27
2,507,4865,3575852073,3575852101,28
2,507,4866,3575852073,3575852101,28
2,507,4867,3575852073,3575852102,29
2,507,4868,3575852073,3575852103,30
2,507,4869,3575852073,3575852105,32
2,507,4870,3575852073,3575852106,33
2,507,4871,3575852073,3575852110,37
2,507,4872,3575852073,3575852111,38
2,507,4873,3575852073,3575852114,41
2,507,4874,3575852073,3575852114,41
2,507,4875,3575852073,3575852114,41
2,507,4876,3575852073,3575852114,41
2,507,4877,3575852073,3575852115,42
2,507,4878,3575852073,3575852117,44
2,507,4879,3575852073,3575852118,45
2,507,4880,3575852073,3575852121,48
2,507,4881,3575852073,3575852121,48
2,508,4882,3575852126,3575852126,0
2,508,4883,3575852126,3575852126,0
2,508,4884,3575852126,3575852127,1
2,508,4885,3575852126,3575852127,1
2,508,4886,3575852126,3575852128,2
2,508,4887,3575852126,3575852130,4
2,508,4888,3575852126,3575852131,5
2,508,4889,3575852126,3575852132,6
2,508,4890,3575852126,3575852134,8
2,508,4891,3575852126,3575852134,8
2,508,4892,3575852126,3575852138,12
2,508,4893,3575852126,3575852144,18
2,508,4894,3575852126,3575852146,20
2,508,4895,3575852126,3575852148,22
2,508,4896,3575852126,3575852149,23
2,508,4897,3575852126,3575852152,26
2,508,4898,3575852126,3575852158,32
2,508,4899,3575852126,3575852159,33
2,508,4900,3575852126,3575852162,36
2,508,4901,3575852126,3575852163,37
2,508,4902,3575852126,3575852165,39
2,508,4903,3575852126,3575852167,41
2,508,4904,3575852126,3575852167,41
2,508,4905,3575852126,3575852168,42
2,508,4906,3575852126,3575852169,43
2,508,4907,3575852126,3575852170,44
2,508,4908,3575852126,3575852171,45
2,508,4909,3575852126,3575852174,48
2,509,4910,3575852181,3575852181,0
2,509,4911,3575852181,3575852182,1
2,509,4912,3575852181,3575852183,2
2,509,4913,3575852181,3575852184,3
2,509,4914,3575852181,3575852184,3
2,509,4915,3575852181,3575852185,4
2,509,4916,3575852181,3575852185,4
2,509,4917,3575852181,3575852187,6
2,509,4918,3575852181,3575852191,10
2,509,4919,3575852181,3575852191,10
2,509,4920,3575852181,3575852193,12
2,509,4921,3575852181,3575852195,14
2,509,4922,3575852181,3575852199,18
2,509,4923,3575852181,3575852202,21
2,509,4924,3575852181,3575852204,23
2,509,4925,3575852181,3575852204,23
2,509,4926,3575852181,3575852209,28
2,509,4927,3575852181,3575852212,31
2,509,4928,3575852181,3575852213,32
2,509,4929,3575852181,3575852214,33
2,509,4930,3575852181,3575852214,33
2,509,4931,3575852181,3575852218,37
2,509,4932,3575852181,3575852220,39
2,509,4933,3575852181,3575852222,41
2,509,4934,3575852181,3575852222,41
2,509,4935,3575852181,3575852224,43
2,509,4936,3575852181,3575852226,45
2,509,4937,3575852181,3575852228,47
2,509,4938,3575852181,3575852229,48
2,510,4939,3575852235,3575852236,1
2,510,4940,3575852235,3575852236,1
2,510,4941,3575852235,3575852238,3
2,510,4942,3575852235,3575852239,4
2,510,4943,3575852235,3575852243,8
2,510,4944,3575852235,3575852244,9
2,510,4945,3575852235,3575852245,10
2,510,4946,3575852235,3575852247,12
2,510,4947,3575852235,3575852248,13
2,510,4948,3575852235,3575852249,14
2,510,4949,3575852235,3575852252,17
2,510,4950,3575852235,3575852254,19
2,510,4951,3575852235,3575852256,21
2,510,4952,3575852235,3575852259,24
2,510,4953,3575852235,3575852261,26
2,510,4954,3575852235,3575852263,28
2,510,4955,3575852235,3575852266,31
2,510,4956,3575852235,3575852269,34
2,510,4957,3575852235,3575852275,40
2,510,4958,3575852235,3575852277,42
2,510,4959,3575852235,3575852279,44
2,510,4960,3575852235,3575852279,44
2,510,4961,3575852235,3575852280,45
2,510,4962,3575852235,3575852281,46
2,510,4963,3575852235,3575852283,48
2,510,4964,3575852235,3575852285,50
2,510,4965,3575852235,3575852285,50
2,511,4966,3575852289,3575852289,0
2,511,4967,3575852289,3575852291,2
2,511,4968,3575852289,3575852292,3
2,511,4969,3575852289,3575852294,5
2,511,4970,3575852289,3575852296,7
2,511,4971,3575852289,3575852296,7
2,511,4972,3575852289,3575852300,11
2,511,4973,3575852289,3575852301,12
2,511,4974,3575852289,3575852301,12
2,511,4975,3575852289,3575852301,12
2,511,4976,3575852289,3575852302,13
2,511,4977,3575852289,3575852303,14
2,511,4978,3575852289,3575852305,16
2,511,4979,3575852289,3575852306,17
2,511,4980,3575852289,3575852310,21
2,511,4981,3575852289,3575852311,22
2,511,4982,3575852289,3575852314,25
2,511,4983,3575852289,3575852314,25
2,511,4984,3575852289,3575852315,26
2,511,4985,3575852289,3575852315,26
2,511,4986,3575852289,3575852315,26
2,511,4987,3575852289,3575852317,28
2,511,4988,3575852289,3575852320,31
2,511,4989,3575852289,3575852320,31
2,511,4990,3575852289,3575852322,33
2,511,4991,3575852289,3575852325,36
2,511,4992,3575852289,3575852327,38
2,511,4993,3575852289,3575852328,39
2,511,4994,3575852289,3575852329,40
2,511,4995,3575852289,3575852330,41
2,511,4996,3575852289,3575852331,42
2,511,4997,3575852289,3575852332,43
2,511,4998,3575852289,3575852334,45
2,511,4999,3575852289,3575852335,46
2,511,5000,3575852289,3575852338,49
2,512,5001,3575852343,3575852343,0
2,512,5002,3575852343,3575852344,1
2,512,5003,3575852343,3575852345,2
2,512,5004,3575852343,3575852348,5
2,512,5005,3575852343,3575852349,6
2,512,5006,3575852343,3575852352,9
2,512,5007,3575852343,3575852358,15
2,512,5008,3575852343,3575852359,16
2,512,5009,3575852343,3575852362,19
2,512,5010,3575852343,3575852363,20
2,512,5011,3575852343,3575852366,23
2,512,5012,3575852343,3575852367,24
2,512,5013,3575852343,3575852368,25
2,512,5014,3575852343,3575852368,25
2,512,5015,3575852343,3575852369,26
2,512,5016,3575852343,3575852370,27
2,512,5017,3575852343,3575852372,29
2,512,5018,3575852343,3575852373,30
2,512,5019,3575852343,3575852379,36
2,512,5020,3575852343,3575852382,39
2,512,5021,3575852343,3575852384,41
2,512,5022,3575852343,3575852384,41
2,512,5023,3575852343,3575852386,43
2,512,5024,3575852343,3575852386,43
2,512,5025,3575852343,3575852390,47
2,512,5026,3575852343,3575852391,48
2,513,5027,3575852396,3575852396,0
2,513,5028,3575852396,3575852396,0
2,513,5029,3575852396,3575852400,4
2,513,5030,3575852396,3575852402,6
2,513,5031,3575852396,3575852404,8
2,513,5032,3575852396,3575852405,9
2,513,5033,3575852396,3575852408,12
2,513,5034,3575852396,3575852413,17
2,513,5035,3575852396,3575852413,17
2,513,5036,3575852396,3575852414,18
2,513,5037,3575852396,3575852414,18
2,513,5038,3575852396,3575852417,21
2,513,5039,3575852396,3575852421,25
2,513,5040,3575852396,3575852423,27
2,513,5041,3575852396,3575852423,27
2,513,5042,3575852396,3575852426,30
2,513,5043,3575852396,3575852429,33
2,513,5044,3575852396,3575852429,33
2,513,5045,3575852396,3575852436,40
2,513,5046,3575852396,3575852437,41
2,513,5047,3575852396,3575852437,41
2,513,5048,3575852396,3575852440,44
2,513,5049,3575852396,3575852445,49
2,513,5050,3575852396,3575852445,49
2,513,5051,3575852396,3575852445,49
2,514,5052,3575852449,3575852449,0
2,514,5053,3575852449,3575852450,1
2,514,5054,3575852449,3575852450,1
2,514,5055,3575852449,3575852451,2
2,514,5056,3575852449,3575852454,5
2,514,5057,3575852449,3575852456,7
2,514,5058,3575852449,3575852460,11
2,514,5059,3575852449,3575852461,12
2,514,5060,3575852449,3575852463,14
2,514,5061,3575852449,3575852467,18
2,514,5062,3575852449,3575852469,20
2,514,5063,3575852449,3575852474,25
2,514,5064,3575852449,3575852477,28
2,514,5065,3575852449,3575852479,30
2,514,5066,3575852449,3575852479,30
2,514,5067,3575852449,3575852480,31
2,514,5068,3575852449,3575852484,35
2,514,5069,3575852449,3575852485,36
2,514,5070,3575852449,3575852485,36
2,514,5071,3575852449,3575852488,39
2,514,5072,3575852449,3575852492,43
2,514,5073,3575852449,3575852492,43
2,514,5074,3575852449,3575852493,44
2,514,5075,3575852449,3575852496,47
2,514,5076,3575852449,3575852496,47
2,515,5077,3575852505,3575852505,0
2,515,5078,3575852505,3575852505,0
2,515,5079,3575852505,3575852505,0
2,515,5080,3575852505,3575852505,0
2,515,5081,3575852505,3575852505,0
2,515,5082,3575852505,3575852505,0
2,515,5083,3575852505,3575852505,0
2,515,5084,3575852505,3575852505,0
2,515,5085,3575852505,3575852509,4
2,515,5086,3575852505,3575852509,4
2,515,5087,3575852505,3575852511,6
2,515,5088,3575852505,3575852513,8
2,515,5089,3575852505,3575852514,9
2,515,5090,3575852505,3575852514,9
2,515,5091,3575852505,3575852514,9
2,515,5092,3575852505,3575852514,9
2,515,5093,3575852505,3575852516,11
2,515,5094,3575852505,3575852517,12
2,515,5095,3575852505,3575852519,14
2,515,5096,3575852505,3575852520,15
2,515,5097,3575852505,3575852521,16
2,515,5098,3575852505,3575852525,20
2,515,5099,3575852505,3575852526,21
2,515,5100,3575852505,3575852527,22
2,515,5101,3575852505,3575852527,22
2,515,5102,3575852505,3575852530,25
2,515,5103,3575852505,3575852530,25
2,515,5104,3575852505,3575852531,26
2,515,5105,3575852505,3575852533,28
2,515,5106,3575852505,3575852534,29
2,515,5107,3575852505,3575852538,33
2,515,5108,3575852505,3575852539,34
2,515,5109,3575852505,3575852545,40
2,515,5110,3575852505,3575852545,40
2,515,5111,3575852505,3575852548,43
2,515,5112,3575852505,3575852548,43
2,515,5113,3575852505,3575852550,45
2,515,5114,3575852505,3575852551,46
2,516,5115,3575852558,3575852558,0
2,516,5116,3575852558,3575852558,0
2,516,5117,3575852558,3575852562,4
2,516,5118,3575852558,3575852562,4
2,516,5119,3575852558,3575852565,7
2,516,5120,3575852558,3575852566,8
2,516,5121,3575852558,3575852567,9
2,516,5122,3575852558,3575852567,9
2,516,5123,3575852558,3575852567,9
2,516,5124,3575852558,3575852569,11
2,516,5125,3575852558,3575852571,13
2,516,5126,3575852558,3575852573,15
2,516,5127,3575852558,3575852578,20
2,516,5128,3575852558,3575852581,23
2,516,5129,3575852558,3575852582,24
2,516,5130,3575852558,3575852583,25
2,516,5131,3575852558,3575852584,26
2,516,5132,3575852558,3575852584,26
2,516,5133,3575852558,3575852585,27
2,516,5134,3575852558,3575852587,29
2,516,5135,3575852558,3575852589,31
2,516,5136,3575852558,3575852590,32
2,516,5137,3575852558,3575852593,35
2,516,5138,3575852558,3575852594,36
2,516,5139,3575852558,3575852598,40
2,516,5140,3575852558,3575852601,43
2,516,5141,3575852558,3575852603,45
2,516,5142,3575852558,3575852604,46
2,517,5143,3575852611,3575852611,0
2,517,5144,3575852611,3575852612,1
2,517,5145,3575852611,3575852612,1
2,517,5146,3575852611,3575852613,2
2,517,5147,3575852611,3575852614,3
2,517,5148,3575852611,3575852617,6
2,517,5149,3575852611,3575852620,9
2,517,5150,3575852611,3575852622,11
2,517,5151,3575852611,3575852623,12
2,517,5152,3575852611,3575852625,14
2,517,5153,3575852611,3575852627,16
2,517,5154,3575852611,3575852628,17
2,517,5155,3575852611,3575852635,24
2,517,5156,3575852611,3575852636,25
2,517,5157,3575852611,3575852637,26
2,517,5158,3575852611,3575852638,27
2,517,5159,3575852611,3575852639,28
2,517,5160,3575852611,3575852643,32
2,517,5161,3575852611,3575852643,32
2,517,5162,3575852611,3575852644,33
2,517,5163,3575852611,3575852646,35
2,517,5164,3575852611,3575852648,37
2,517,5165,3575852611,3575852649,38
2,517,5166,3575852611,3575852652,41
2,517,5167,3575852611,3575852654,43
2,517,5168,3575852611,3575852655,44
2,517,5169,3575852611,3575852658,47
2,517,5170,3575852611,3575852661,50
2,518,5171,3575852664,3575852664,0
2,518,5172,3575852664,3575852666,2
2,518,5173,3575852664,3575852668,4
2,518,5174,3575852664,3575852674,10
2,518,5175,3575852664,3575852677,13
2,518,5176,3575852664,3575852678,14
2,518,5177,3575852664,3575852680,16
2,518,5178,3575852664,3575852680,16
2,518,5179,3575852664,3575852684,20
2,518,5180,3575852664,3575852685,21
2,518,5181,3575852664,3575852685,21
2,518,5182,3575852664,3575852691,27
2,518,5183,3575852664,3575852692,28
2,518,5184,3575852664,3575852692,28
2,518,5185,3575852664,3575852693,29
2,518,5186,3575852664,3575852696,32
2,518,5187,3575852664,3575852696,32
2,518,5188,3575852664,3575852700,36
2,518,5189,3575852664,3575852700,36
2,518,5190,3575852664,3575852700,36
2,518,5191,3575852664,3575852701,37
2,518,5192,3575852664,3575852702,38
2,518,5193,3575852664,3575852703,39
2,518,5194,3575852664,3575852704,40
2,518,5195,3575852664,3575852705,41
2,518,5196,3575852664,3575852709,45
2,518,5197,3575852664,3575852709,45
2,518,5198,3575852664,3575852711,47
2,518,5199,3575852664,3575852713,49
2,518,5200,3575852664,3575852714,50
2,519,5201,3575852717,3575852717,0
2,519,5202,3575852717,3575852717,0
2,519,5203,3575852717,3575852717,0
2,519,5204,3575852717,3575852717,0
2,519,5205,3575852717,3575852717,0
2,519,5206,3575852717,3575852719,2
2,519,5207,3575852717,3575852719,2
2,519,5208,3575852717,3575852722,5
2,519,5209,3575852717,3575852725,8
2,519,5210,3575852717,3575852727,10
2,519,5211,3575852717,3575852728,11
2,519,5212,3575852717,3575852731,14
2,519,5213,3575852717,3575852732,15
2,519,5214,3575852717,3575852733,16
2,519,5215,3575852717,3575852734,17
2,519,5216,3575852717,3575852738,21
2,519,5217,3575852717,3575852740,23
2,519,5218,3575852717,3575852745,28
2,519,5219,3575852717,3575852746,29
2,519,5220,3575852717,3575852748,31
2,519,5221,3575852717,3575852748,31
2,519,5222,3575852717,3575852751,34
2,519,5223,3575852717,3575852751,34
2,519,5224,3575852717,3575852757,40
2,519,5225,3575852717,3575852758,41
2,519,5226,3575852717,3575852762,45
2,519,5227,3575852717,3575852762,45
2,519,5228,3575852717,3575852765,48
2,519,5229,3575852717,3575852766,49
2,519,5230,3575852717,3575852767,50
2,520,5231,3575852771,3575852771,0
2,520,5232,3575852771,3575852771,0
2,520,5233,3575852771,3575852771,0
2,520,5234,3575852771,3575852772,1
2,520,5235,3575852771,3575852773,2
2,520,5236,3575852771,3575852778,7
2,520,5237,3575852771,3575852781,10
2,520,5238,3575852771,3575852782,11
2,520,5239,3575852771,3575852784,13
2,520,5240,3575852771,3575852784,13
2,520,5241,3575852771,3575852785,14
2,520,5242,3575852771,3575852785,14
2,520,5243,3575852771,3575852787,16
2,520,5244,3575852771,3575852791,20
2,520,5245,3575852771,3575852791,20
2,520,5246,3575852771,3575852793,22
2,520,5247,3575852771,3575852795,24
2,520,5248,3575852771,3575852799,28
2,520,5249,3575852771,3575852801,30
2,520,5250,3575852771,3575852804,33
2,520,5251,3575852771,3575852804,33
2,520,5252,3575852771,3575852808,37
2,520,5253,3575852771,3575852811,40
2,520,5254,3575852771,3575852812,41
2,520,5255,3575852771,3575852813,42
2,520,5256,3575852771,3575852814,43
2,520,5257,3575852771,3575852818,47
2,520,5258,3575852771,3575852820,49
2,521,5259,3575852825,3575852825,0
2,521,5260,3575852825,3575852825,0
2,521,5261,3575852825,3575852825,0
2,521,5262,3575852825,3575852828,3
2,521,5263,3575852825,3575852828,3
2,521,5264,3575852825,3575852835,10
2,521,5265,3575852825,3575852835,10
2,521,5266,3575852825,3575852837,12
2,521,5267,3575852825,3575852837,12
2,521,5268,3575852825,3575852839,14
2,521,5269,3575852825,3575852843,18
2,521,5270,3575852825,3575852844,19
2,521,5271,3575852825,3575852845,20
2,521,5272,3575852825,3575852846,21
2,521,5273,3575852825,3575852848,23
2,521,5274,3575852825,3575852849,24
2,521,5275,3575852825,3575852852,27
2,521,5276,3575852825,3575852855,30
2,521,5277,3575852825,3575852856,31
2,521,5278,3575852825,3575852859,34
2,521,5279,3575852825,3575852860,35
2,521,5280,3575852825,3575852861,36
2,521,5281,3575852825,3575852863,38
2,521,5282,3575852825,3575852866,41
2,521,5283,3575852825,3575852868,43
2,521,5284,3575852825,3575852875,50
2,522,5285,3575852880,3575852880,0
2,522,5286,3575852880,3575852880,0
2,522,5287,3575852880,3575852880,0
2,522,5288,3575852880,3575852880,0
2,522,5289,3575852880,3575852880,0
2,522,5290,3575852880,3575852881,1
2,522,5291,3575852880,3575852883,3
2,522,5292,3575852880,3575852885,5
2,522,5293,3575852880,3575852885,5
2,522,5294,3575852880,3575852890,10
2,522,5295,3575852880,3575852892,12
2,522,5296,3575852880,3575852892,12
2,522,5297,3575852880,3575852893,13
2,522,5298,3575852880,3575852896,16
2,522,5299,3575852880,3575852896,16
2,522,5300,3575852880,3575852900,20
2,522,5301,3575852880,3575852900,20
2,522,5302,3575852880,3575852900,20
2,522,5303,3575852880,3575852901,21
2,522,5304,3575852880,3575852902,22
2,522,5305,3575852880,3575852902,22
2,522,5306,3575852880,3575852904,24
2,522,5307,3575852880,3575852905,25
2,522,5308,3575852880,3575852909,29
2,522,5309,3575852880,3575852910,30
2,522,5310,3575852880,3575852911,31
2,522,5311,3575852880,3575852913,33
2,522,5312,3575852880,3575852914,34
2,522,5313,3575852880,3575852914,34
2,522,5314,3575852880,3575852914,34
2,522,5315,3575852880,3575852914,34
2,522,5316,3575852880,3575852916,36
2,522,5317,3575852880,3575852916,36
2,522,5318,3575852880,3575852919,39
2,522,5319,3575852880,3575852920,40
2,522,5320,3575852880,3575852923,43
2,522,5321,3575852880,3575852926,46
2,522,5322,3575852880,3575852926,46
2,522,5323,3575852880,3575852927,47
2,523,5324,3575852934,3575852934,0
2,523,5325,3575852934,3575852934,0
2,523,5326,3575852934,3575852934,0
2,523,5327,3575852934,3575852934,0
2,523,5328,3575852934,3575852938,4
2,523,5329,3575852934,3575852940,6
2,523,5330,3575852934,3575852943,9
2,523,5331,3575852934,3575852945,11
2,523,5332,3575852934,3575852946,12
2,523,5333,3575852934,3575852948,14
2,523,5334,3575852934,3575852949,15
2,523,5335,3575852934,3575852950,16
2,523,5336,3575852934,3575852952,18
2,523,5337,3575852934,3575852957,23
2,523,5338,3575852934,3575852958,24
2,523,5339,3575852934,3575852961,27
2,523,5340,3575852934,3575852962,28
2,523,5341,3575852934,3575852967,33
2,523,5342,3575852934,3575852968,34
2,523,5343,3575852934,3575852968,34
2,523,5344,3575852934,3575852969,35
2,523,5345,3575852934,3575852970,36
2,523,5346,3575852934,3575852972,38
2,523,5347,3575852934,3575852973,39
2,523,5348,3575852934,3575852979,45
2,523,5349,3575852934,3575852981,47
2,523,5350,3575852934,3575852982,48
2,523,5351,3575852934,3575852984,50
2,524,5352,3575852987,3575852987,0
2,524,5353,3575852987,3575852987,0
2,524,5354,3575852987,3575852987,0
2,524,5355,3575852987,3575852987,0
2,524,5356,3575852987,3575852990,3
2,524,5357,3575852987,3575852992,5
2,524,5358,3575852987,3575852994,7
2,524,5359,3575852987,3575852994,7
2,524,5360,3575852987,3575852998,11
2,524,5361,3575852987,3575853002,15
2,524,5362,3575852987,3575853004,17
2,524,5363,3575852987,3575853005,18
2,524,5364,3575852987,3575853008,21
2,524,5365,3575852987,3575853013,26
2,524,5366,3575852987,3575853013,26
2,524,5367,3575852987,3575853014,27
2,524,5368,3575852987,3575853018,31
2,524,5369,3575852987,3575853020,33
2,524,5370,3575852987,3575853023,36
2,524,5371,3575852987,3575853025,38
2,524,5372,3575852987,3575853025,38
2,524,5373,3575852987,3575853029,42
2,524,5374,3575852987,3575853035,48
2,524,5375,3575852987,3575853036,49
2,525,5376,3575853041,3575853041,0
2,525,5377,3575853041,3575853041,0
2,525,5378,3575853041,3575853041,0
2,525,5379,3575853041,3575853044,3
2,525,5380,3575853041,3575853045,4
2,525,5381,3575853041,3575853045,4
2,525,5382,3575853041,3575853046,5
2,525,5383,3575853041,3575853048,7
2,525,5384,3575853041,3575853048,7
2,525,5385,3575853041,3575853051,10
2,525,5386,3575853041,3575853055,14
2,525,5387,3575853041,3575853055,14
2,525,5388,3575853041,3575853059,18
2,525,5389,3575853041,3575853061,20
2,525,5390,3575853041,3575853062,21
2,525,5391,3575853041,3575853063,22
2,525,5392,3575853041,3575853066,25
2,525,5393,3575853041,3575853069,28
2,525,5394,3575853041,3575853074,33
2,525,5395,3575853041,3575853076,35
2,525,5396,3575853041,3575853078,37
2,525,5397,3575853041,3575853080,39
2,525,5398,3575853041,3575853081,40
2,525,5399,3575853041,3575853081,40
2,525,5400,3575853041,3575853081,40
2,525,5401,3575853041,3575853083,42
2,525,5402,3575853041,3575853085,44
2,525,5403,3575853041,3575853085,44
2,525,5404,3575853041,3575853090,49
2,525,5405,3575853041,3575853091,50
2,526,5406,3575853095,3575853095,0
2,526,5407,3575853095,3575853095,0
2,526,5408,3575853095,3575853096,1
2,526,5409,3575853095,3575853096,1
2,526,5410,3575853095,3575853100,5
2,526,5411,3575853095,3575853100,5
2,526,5412,3575853095,3575853101,6
2,526,5413,3575853095,3575853101,6
2,526,5414,3575853095,3575853102,7
2,526,5415,3575853095,3575853104,9
2,526,5416,3575853095,3575853104,9
2,526,5417,3575853095,3575853105,10
2,526,5418,3575853095,3575853109,14
2,526,5419,3575853095,3575853110,15
2,526,5420,3575853095,3575853110,15
2,526,5421,3575853095,3575853114,19
2,526,5422,3575853095,3575853114,19
2,526,5423,3575853095,3575853114,19
2,526,5424,3575853095,3575853114,19
2,526,5425,3575853095,3575853115,20
2,526,5426,3575853095,3575853116,21
2,526,5427,3575853095,3575853117,22
2,526,5428,3575853095,3575853119,24
2,526,5429,3575853095,3575853121,26
2,526,5430,3575853095,3575853123,28
2,526,5431,3575853095,3575853125,30
2,526,5432,3575853095,3575853127,32
2,526,5433,3575853095,3575853127,32
2,526,5434,3575853095,3575853133,38
2,526,5435,3575853095,3575853133,38
2,526,5436,3575853095,3575853133,38
2,526,5437,3575853095,3575853134,39
2,526,5438,3575853095,3575853138,43
2,526,5439,3575853095,3575853140,45
2,526,5440,3575853095,3575853143,48
2,527,5441,3575853149,3575853149,0
2,527,5442,3575853149,3575853149,0
2,527,5443,3575853149,3575853149,0
2,527,5444,3575853149,3575853149,0
2,527,5445,3575853149,3575853150,1
2,527,5446,3575853149,3575853150,1
2,527,5447,3575853149,3575853152,3
2,527,5448,3575853149,3575853157,8
2,527,5449,3575853149,3575853158,9
2,527,5450,3575853149,3575853162,13
2,527,5451,3575853149,3575853162,13
2,527,5452,3575853149,3575853166,17
2,527,5453,3575853149,3575853168,19
2,527,5454,3575853149,3575853169,20
2,527,5455,3575853149,3575853169,20
2,527,5456,3575853149,3575853170,21
2,527,5457,3575853149,3575853172,23
2,527,5458,3575853149,3575853174,25
2,527,5459,3575853149,3575853178,29
2,527,5460,3575853149,3575853179,30
2,527,5461,3575853149,3575853181,32
2,527,5462,3575853149,3575853183,34
2,527,5463,3575853149,3575853184,35
2,527,5464,3575853149,3575853185,36
2,527,5465,3575853149,3575853186,37
2,527,5466,3575853149,3575853187,38
2,527,5467,3575853149,3575853191,42
2,527,5468,3575853149,3575853192,43
2,527,5469,3575853149,3575853194,45
2,528,5470,3575853204,3575853204,0
2,528,5471,3575853204,3575853204,0
2,528,5472,3575853204,3575853204,0
2,528,5473,3575853204,3575853205,1
2,528,5474,3575853204,3575853209,5
2,528,5475,3575853204,3575853212,8
2,528,5476,3575853204,3575853212,8
2,528,5477,3575853204,3575853214,10
2,528,5478,3575853204,3575853214,10
2,528,5479,3575853204,3575853217,13
2,528,5480,3575853204,3575853220,16
2,528,5481,3575853204,3575853223,19
2,528,5482,3575853204,3575853224,20
2,528,5483,3575853204,3575853224,20
2,528,5484,3575853204,3575853226,22
2,528,5485,3575853204,3575853229,25
2,528,5486,3575853204,3575853235,31
2,528,5487,3575853204,3575853236,32
2,528,5488,3575853204,3575853238,34
2,528,5489,3575853204,3575853238,34
2,528,5490,3575853204,3575853238,34
2,528,5491,3575853204,3575853244,40
2,528,5492,3575853204,3575853245,41
2,528,5493,3575853204,3575853245,41
2,528,5494,3575853204,3575853247,43
2,528,5495,3575853204,3575853249,45
2,528,5496,3575853204,3575853249,45
2,528,5497,3575853204,3575853251,47
2,529,5498,3575853258,3575853258,0
2,529,5499,3575853258,3575853258,0
2,529,5500,3575853258,3575853261,3
2,529,5501,3575853258,3575853261,3
2,529,5502,3575853258,3575853263,5
2,529,5503,3575853258,3575853266,8
2,529,5504,3575853258,3575853269,11
2,529,5505,3575853258,3575853275,17
2,529,5506,3575853258,3575853277,19
2,529,5507,3575853258,3575853279,21
2,529,5508,3575853258,3575853280,22
2,529,5509,3575853258,3575853280,22
2,529,5510,3575853258,3575853281,23
2,529,5511,3575853258,3575853281,23
2,529,5512,3575853258,3575853284,26
2,529,5513,3575853258,3575853285,27
2,529,5514,3575853258,3575853285,27
2,529,5515,3575853258,3575853288,30
2,529,5516,3575853258,3575853290,32
2,529,5517,3575853258,3575853292,34
2,529,5518,3575853258,3575853292,34
2,529,5519,3575853258,3575853294,36
2,529,5520,3575853258,3575853296,38
2,529,5521,3575853258,3575853297,39
2,529,5522,3575853258,3575853300,42
2,529,5523,3575853258,3575853301,43
2,529,5524,3575853258,3575853301,43
2,529,5525,3575853258,3575853301,43
2,529,5526,3575853258,3575853303,45
2,529,5527,3575853258,3575853304,46
2,529,5528,3575853258,3575853305,47
2,529,5529,3575853258,3575853306,48
2,530,5530,3575853312,3575853312,0
2,530,5531,3575853312,3575853312,0
2,530,5532,3575853312,3575853313,1
2,530,5533,3575853312,3575853314,2
2,530,5534,3575853312,3575853315,3
2,530,5535,3575853312,3575853315,3
2,530,5536,3575853312,3575853315,3
2,530,5537,3575853312,3575853316,4
2,530,5538,3575853312,3575853317,5
2,530,5539,3575853312,3575853320,8
2,530,5540,3575853312,3575853321,9
2,530,5541,3575853312,3575853323,11
2,530,5542,3575853312,3575853325,13
2,530,5543,3575853312,3575853327,15
2,530,5544,3575853312,3575853327,15
2,530,5545,3575853312,3575853328,16
2,530,5546,3575853312,3575853333,21
2,530,5547,3575853312,3575853333,21
2,530,5548,3575853312,3575853334,22
2,530,5549,3575853312,3575853335,23
2,530,5550,3575853312,3575853338,26
2,530,5551,3575853312,3575853343,31
2,530,5552,3575853312,3575853345,33
2,530,5553,3575853312,3575853347,35
2,530,5554,3575853312,3575853347,35
2,530,5555,3575853312,3575853348,36
2,530,5556,3575853312,3575853348,36
2,530,5557,3575853312,3575853349,37
2,530,5558,3575853312,3575853351,39
2,530,5559,3575853312,3575853351,39
2,530,5560,3575853312,3575853358,46
2,530,5561,3575853312,3575853359,47
2,530,5562,3575853312,3575853361,49
2,530,5563,3575853312,3575853362,50
2,531,5564,3575853367,3575853367,0
2,531,5565,3575853367,3575853368,1
2,531,5566,3575853367,3575853368,1
2,531,5567,3575853367,3575853369,2
2,531,5568,3575853367,3575853370,3
2,531,5569,3575853367,3575853372,5
2,531,5570,3575853367,3575853374,7
2,531,5571,3575853367,3575853379,12
2,531,5572,3575853367,3575853379,12
2,531,5573,3575853367,3575853381,14
2,531,5574,3575853367,3575853384,17
2,531,5575,3575853367,3575853385,18
2,531,5576,3575853367,3575853385,18
2,531,5577,3575853367,3575853386,19
2,531,5578,3575853367,3575853387,20
2,531,5579,3575853367,3575853387,20
2,531,5580,3575853367,3575853391,24
2,531,5581,3575853367,3575853392,25
2,531,5582,3575853367,3575853394,27
2,531,5583,3575853367,3575853396,29
2,531,5584,3575853367,3575853400,33
2,531,5585,3575853367,3575853400,33
2,531,5586,3575853367,3575853402,35
2,531,5587,3575853367,3575853405,38
2,531,5588,3575853367,3575853405,38
2,531,5589,3575853367,3575853408,41
2,531,5590,3575853367,3575853412,45
2,531,5591,3575853367,3575853413,46
2,531,5592,3575853367,3575853414,47
2,531,5593,3575853367,3575853414,47
2,532,5594,3575853422,3575853422,0
2,532,5595,3575853422,3575853422,0
2,532,5596,3575853422,3575853423,1
2,532,5597,3575853422,3575853423,1
2,532,5598,3575853422,3575853425,3
2,532,5599,3575853422,3575853426,4
2,532,5600,3575853422,3575853429,7
2,532,5601,3575853422,3575853435,13
2,532,5602,3575853422,3575853437,15
2,532,5603,3575853422,3575853438,16
2,532,5604,3575853422,3575853438,16
2,532,5605,3575853422,3575853440,18
2,532,5606,3575853422,3575853445,23
2,532,5607,3575853422,3575853445,23
2,532,5608,3575853422,3575853447,25
2,532,5609,3575853422,3575853449,27
2,532,5610,3575853422,3575853450,28
2,532,5611,3575853422,3575853451,29
2,532,5612,3575853422,3575853455,33
2,532,5613,3575853422,3575853456,34
2,532,5614,3575853422,3575853459,37
2,532,5615,3575853422,3575853461,39
2,532,5616,3575853422,3575853461,39
2,532,5617,3575853422,3575853463,41
2,532,5618,3575853422,3575853468,46
2,532,5619,3575853422,3575853468,46
2,533,5620,3575853476,3575853476,0
2,533,5621,3575853476,3575853476,0
2,533,5622,3575853476,3575853478,2
2,533,5623,3575853476,3575853479,3
2,533,5624,3575853476,3575853480,4
2,533,5625,3575853476,3575853480,4
2,533,5626,3575853476,3575853481,5
2,533,5627,3575853476,3575853483,7
2,533,5628,3575853476,3575853484,8
2,533,5629,3575853476,3575853484,8
2,533,5630,3575853476,3575853488,12
2,533,5631,3575853476,3575853489,13
2,533,5632,3575853476,3575853490,14
2,533,5633,3575853476,3575853491,15
2,533,5634,3575853476,3575853493,17
2,533,5635,3575853476,3575853495,19
2,533,5636,3575853476,3575853500,24
2,533,5637,3575853476,3575853500,24
2,533,5638,3575853476,3575853500,24
2,533,5639,3575853476,3575853500,24
2,533,5640,3575853476,3575853501,25
2,533,5641,3575853476,3575853503,27
2,533,5642,3575853476,3575853504,28
2,533,5643,3575853476,3575853505,29
2,533,5644,3575853476,3575853508,32
2,533,5645,3575853476,3575853510,34
2,533,5646,3575853476,3575853510,34
2,533,5647,3575853476,3575853513,37
2,533,5648,3575853476,3575853513,37
2,533,5649,3575853476,3575853513,37
2,533,5650,3575853476,3575853515,39
2,533,5651,3575853476,3575853515,39
2,533,5652,3575853476,3575853515,39
2,533,5653,3575853476,3575853517,41
2,533,5654,3575853476,3575853520,44
2,533,5655,3575853476,3575853520,44
2,533,5656,3575853476,3575853522,46
2,533,5657,3575853476,3575853524,48
2,533,5658,3575853476,3575853526,50
2,534,5659,3575853530,3575853530,0
2,534,5660,3575853530,3575853530,0
2,534,5661,3575853530,3575853531,1
2,534,5662,3575853530,3575853532,2
2,534,5663,3575853530,3575853533,3
2,534,5664,3575853530,3575853533,3
2,534,5665,3575853530,3575853538,8
2,534,5666,3575853530,3575853542,12
2,534,5667,3575853530,3575853544,14
2,534,5668,3575853530,3575853546,16
2,534,5669,3575853530,3575853546,16
2,534,5670,3575853530,3575853547,17
2,534,5671,3575853530,3575853548,18
2,534,5672,3575853530,3575853548,18
2,534,5673,3575853530,3575853550,20
2,534,5674,3575853530,3575853551,21
2,534,5675,3575853530,3575853557,27
2,534,5676,3575853530,3575853558,28
2,534,5677,3575853530,3575853562,32
2,534,5678,3575853530,3575853562,32
2,534,5679,3575853530,3575853565,35
2,534,5680,3575853530,3575853566,36
2,534,5681,3575853530,3575853567,37
2,534,5682,3575853530,3575853568,38
2,534,5683,3575853530,3575853568,38
2,534,5684,3575853530,3575853569,39
2,534,5685,3575853530,3575853571,41
2,534,5686,3575853530,3575853573,43
2,534,5687,3575853530,3575853578,48
2,534,5688,3575853530,3575853578,48
2,535,5689,3575853584,3575853584,0
2,535,5690,3575853584,3575853584,0
2,535,5691,3575853584,3575853584,0
2,535,5692,3575853584,3575853584,0
2,535,5693,3575853584,3575853585,1
2,535,5694,3575853584,3575853586,2
2,535,5695,3575853584,3575853587,3
2,535,5696,3575853584,3575853591,7
2,535,5697,3575853584,3575853591,7
2,535,5698,3575853584,3575853593,9
2,535,5699,3575853584,3575853595,11
2,535,5700,3575853584,3575853599,15
2,535,5701,3575853584,3575853600,16
2,535,5702,3575853584,3575853601,17
2,535,5703,3575853584,3575853604,20
2,535,5704,3575853584,3575853608,24
2,535,5705,3575853584,3575853611,27
2,535,5706,3575853584,3575853613,29
2,535,5707,3575853584,3575853615,31
2,535,5708,3575853584,3575853617,33
2,535,5709,3575853584,3575853619,35
2,535,5710,3575853584,3575853622,38
2,535,5711,3575853584,3575853623,39
2,535,5712,3575853584,3575853623,39
2,535,5713,3575853584,3575853625,41
2,535,5714,3575853584,3575853626,42
2,535,5715,3575853584,3575853627,43
2,536,5716,3575853637,3575853637,0
2,536,5717,3575853637,3575853637,0
2,536,5718,3575853637,3575853637,0
2,536,5719,3575853637,3575853638,1
2,536,5720,3575853637,3575853639,2
2,536,5721,3575853637,3575853644,7
2,536,5722,3575853637,3575853644,7
2,536,5723,3575853637,3575853646,9
2,536,5724,3575853637,3575853648,11
2,536,5725,3575853637,3575853649,12
2,536,5726,3575853637,3575853652,15
2,536,5727,3575853637,3575853654,17
2,536,5728,3575853637,3575853656,19
2,536,5729,3575853637,3575853658,21
2,536,5730,3575853637,3575853660,23
2,536,5731,3575853637,3575853661,24
2,536,5732,3575853637,3575853667,30
2,536,5733,3575853637,3575853668,31
2,536,5734,3575853637,3575853675,38
2,536,5735,3575853637,3575853676,39
2,536,5736,3575853637,3575853678,41
2,536,5737,3575853637,3575853679,42
2,536,5738,3575853637,3575853679,42
2,536,5739,3575853637,3575853680,43
2,536,5740,3575853637,3575853680,43
2,536,5741,3575853637,3575853682,45
2,536,5742,3575853637,3575853684,47
2,536,5743,3575853637,3575853684,47
2,537,5744,3575853691,3575853691,0
2,537,5745,3575853691,3575853691,0
2,537,5746,3575853691,3575853691,0
2,537,5747,3575853691,3575853691,0
2,537,5748,3575853691,3575853693,2
2,537,5749,3575853691,3575853695,4
2,537,5750,3575853691,3575853696,5
2,537,5751,3575853691,3575853699,8
2,537,5752,3575853691,3575853700,9
2,537,5753,3575853691,3575853700,9
2,537,5754,3575853691,3575853702,11
2,537,5755,3575853691,3575853703,12
2,537,5756,3575853691,3575853704,13
2,537,5757,3575853691,3575853705,14
2,537,5758,3575853691,3575853708,17
2,537,5759,3575853691,3575853709,18
2,537,5760,3575853691,3575853710,19
2,537,5761,3575853691,3575853713,22
2,537,5762,3575853691,3575853713,22
2,537,5763,3575853691,3575853713,22
2,537,5764,3575853691,3575853714,23
2,537,5765,3575853691,3575853715,24
2,537,5766,3575853691,3575853716,25
2,537,5767,3575853691,3575853717,26
2,537,5768,3575853691,3575853720,29
2,537,5769,3575853691,3575853720,29
2,537,5770,3575853691,3575853722,31
2,537,5771,3575853691,3575853724,33
2,537,5772,3575853691,3575853727,36
2,537,5773,3575853691,3575853727,36
2,537,5774,3575853691,3575853728,37
2,537,5775,3575853691,3575853731,40
2,537,5776,3575853691,3575853732,41
2,537,5777,3575853691,3575853733,42
2,537,5778,3575853691,3575853734,43
2,537,5779,3575853691,3575853738,47
2,537,5780,3575853691,3575853739,48
2,538,5781,3575853744,3575853745,1
2,538,5782,3575853744,3575853745,1
2,538,5783,3575853744,3575853745,1
2,538,5784,3575853744,3575853746,2
2,538,5785,3575853744,3575853747,3
2,538,5786,3575853744,3575853748,4
2,538,5787,3575853744,3575853748,4
2,538,5788,3575853744,3575853750,6
2,538,5789,3575853744,3575853751,7
2,538,5790,3575853744,3575853757,13
2,538,5791,3575853744,3575853758,14
2,538,5792,3575853744,3575853761,17
2,538,5793,3575853744,3575853763,19
2,538,5794,3575853744,3575853766,22
2,538,5795,3575853744,3575853766,22
2,538,5796,3575853744,3575853768,24
2,538,5797,3575853744,3575853768,24
2,538,5798,3575853744,3575853768,24
2,538,5799,3575853744,3575853769,25
2,538,5800,3575853744,3575853772,28
2,538,5801,3575853744,3575853773,29
2,538,5802,3575853744,3575853778,34
2,538,5803,3575853744,3575853779,35
2,538,5804,3575853744,3575853780,36
2,538,5805,3575853744,3575853783,39
2,538,5806,3575853744,3575853784,40
2,538,5807,3575853744,3575853785,41
2,538,5808,3575853744,3575853786,42
2,538,5809,3575853744,3575853786,42
2,538,5810,3575853744,3575853787,43
2,538,5811,3575853744,3575853792,48
2,538,5812,3575853744,3575853793,49
2,539,5813,3575853798,3575853798,0
2,539,5814,3575853798,3575853799,1
2,539,5815,3575853798,3575853799,1
2,539,5816,3575853798,3575853801,3
2,539,5817,3575853798,3575853805,7
2,539,5818,3575853798,3575853809,11
2,539,5819,3575853798,3575853811,13
2,539,5820,3575853798,3575853813,15
2,539,5821,3575853798,3575853814,16
2,539,5822,3575853798,3575853818,20
2,539,5823,3575853798,3575853819,21
2,539,5824,3575853798,3575853822,24
2,539,5825,3575853798,3575853823,25
2,539,5826,3575853798,3575853824,26
2,539,5827,3575853798,3575853825,27
2,539,5828,3575853798,3575853827,29
2,539,5829,3575853798,3575853829,31
2,539,5830,3575853798,3575853835,37
2,539,5831,3575853798,3575853836,38
2,539,5832,3575853798,3575853836,38
2,539,5833,3575853798,3575853838,40
2,539,5834,3575853798,3575853839,41
2,539,5835,3575853798,3575853843,45
2,539,5836,3575853798,3575853844,46
2,539,5837,3575853798,3575853845,47
2,539,5838,3575853798,3575853846,48
2,540,5839,3575853852,3575853852,0
2,540,5840,3575853852,3575853852,0
2,540,5841,3575853852,3575853854,2
2,540,5842,3575853852,3575853856,4
2,540,5843,3575853852,3575853860,8
2,540,5844,3575853852,3575853860,8
2,540,5845,3575853852,3575853863,11
2,540,5846,3575853852,3575853867,15
2,540,5847,3575853852,3575853867,15
2,540,5848,3575853852,3575853874,22
2,540,5849,3575853852,3575853876,24
2,540,5850,3575853852,3575853878,26
2,540,5851,3575853852,3575853879,27
2,540,5852,3575853852,3575853880,28
2,540,5853,3575853852,3575853880,28
2,540,5854,3575853852,3575853880,28
2,540,5855,3575853852,3575853882,30
2,540,5856,3575853852,3575853884,32
2,540,5857,3575853852,3575853884,32
2,540,5858,3575853852,3575853888,36
2,540,5859,3575853852,3575853889,37
2,540,5860,3575853852,3575853890,38
2,540,5861,3575853852,3575853891,39
2,540,5862,3575853852,3575853894,42
2,540,5863,3575853852,3575853895,43
2,540,5864,3575853852,3575853896,44
2,540,5865,3575853852,3575853899,47
2,540,5866,3575853852,3575853900,48
2,540,5867,3575853852,3575853900,48
2,540,5868,3575853852,3575853900,48
2,541,5869,3575853906,3575853906,0
2,541,5870,3575853906,3575853906,0
2,541,5871,3575853906,3575853906,0
2,541,5872,3575853906,3575853906,0
2,541,5873,3575853906,3575853908,2
2,541,5874,3575853906,3575853910,4
2,541,5875,3575853906,3575853913,7
2,541,5876,3575853906,3575853914,8
2,541,5877,3575853906,3575853915,9
2,541,5878,3575853906,3575853915,9
2,541,5879,3575853906,3575853915,9
2,541,5880,3575853906,3575853916,10
2,541,5881,3575853906,3575853917,11
2,541,5882,3575853906,3575853920,14
2,541,5883,3575853906,3575853920,14
2,541,5884,3575853906,3575853922,16
2,541,5885,3575853906,3575853924,18
2,541,5886,3575853906,3575853927,21
2,541,5887,3575853906,3575853927,21
2,541,5888,3575853906,3575853928,22
2,541,5889,3575853906,3575853931,25
2,541,5890,3575853906,3575853932,26
2,541,5891,3575853906,3575853934,28
2,541,5892,3575853906,3575853934,28
2,541,5893,3575853906,3575853939,33
2,541,5894,3575853906,3575853940,34
2,541,5895,3575853906,3575853945,39
2,541,5896,3575853906,3575853945,39
2,541,5897,3575853906,3575853945,39
2,541,5898,3575853906,3575853946,40
2,541,5899,3575853906,3575853948,42
2,541,5900,3575853906,3575853948,42
2,541,5901,3575853906,3575853948,42
2,541,5902,3575853906,3575853951,45
2,541,5903,3575853906,3575853952,46
2,542,5904,3575853960,3575853960,0
2,542,5905,3575853960,3575853962,2
2,542,5906,3575853960,3575853963,3
2,542,5907,3575853960,3575853966,6
2,542,5908,3575853960,3575853967,7
2,542,5909,3575853960,3575853967,7
2,542,5910,3575853960,3575853968,8
2,542,5911,3575853960,3575853969,9
2,542,5912,3575853960,3575853971,11
2,542,5913,3575853960,3575853973,13
2,542,5914,3575853960,3575853977,17
2,542,5915,3575853960,3575853978,18
2,542,5916,3575853960,3575853981,21
2,542,5917,3575853960,3575853983,23
2,542,5918,3575853960,3575853985,25
2,542,5919,3575853960,3575853985,25
2,542,5920,3575853960,3575853986,26
2,542,5921,3575853960,3575853986,26
2,542,5922,3575853960,3575853988,28
2,542,5923,3575853960,3575853991,31
2,542,5924,3575853960,3575853994,34
2,542,5925,3575853960,3575853996,36
2,542,5926,3575853960,3575853999,39
2,542,5927,3575853960,3575854000,40
2,542,5928,3575853960,3575854002,42
2,542,5929,3575853960,3575854004,44
2,542,5930,3575853960,3575854005,45
2,542,5931,3575853960,3575854010,50
2,543,5932,3575854014,3575854014,0
2,543,5933,3575854014,3575854014,0
2,543,5934,3575854014,3575854014,0
2,543,5935,3575854014,3575854017,3
2,543,5936,3575854014,3575854019,5
2,543,5937,3575854014,3575854022,8
2,543,5938,3575854014,3575854023,9
2,543,5939,3575854014,3575854024,10
2,543,5940,3575854014,3575854025,11
2,543,5941,3575854014,3575854027,13
2,543,5942,3575854014,3575854029,15
2,543,5943,3575854014,3575854035,21
2,543,5944,3575854014,3575854036,22
2,543,5945,3575854014,3575854037,23
2,543,5946,3575854014,3575854037,23
2,543,5947,3575854014,3575854039,25
2,543,5948,3575854014,3575854043,29
2,543,5949,3575854014,3575854044,30
2,543,5950,3575854014,3575854045,31
2,543,5951,3575854014,3575854046,32
2,543,5952,3575854014,3575854049,35
2,543,5953,3575854014,3575854052,38
2,543,5954,3575854014,3575854055,41
2,543,5955,3575854014,3575854056,42
2,543,5956,3575854014,3575854059,45
2,543,5957,3575854014,3575854060,46
2,543,5958,3575854014,3575854060,46
2,543,5959,3575854014,3575854063,49
2,544,5960,3575854069,3575854069,0
2,544,5961,3575854069,3575854069,0
2,544,5962,3575854069,3575854075,6
2,544,5963,3575854069,3575854076,7
2,544,5964,3575854069,3575854079,10
2,544,5965,3575854069,3575854079,10
2,544,5966,3575854069,3575854079,10
2,544,5967,3575854069,3575854080,11
2,544,5968,3575854069,3575854080,11
2,544,5969,3575854069,3575854083,14
2,544,5970,3575854069,3575854084,15
2,544,5971,3575854069,3575854084,15
2,544,5972,3575854069,3575854088,19
2,544,5973,3575854069,3575854089,20
2,544,5974,3575854069,3575854090,21
2,544,5975,3575854069,3575854092,23
2,544,5976,3575854069,3575854094,25
2,544,5977,3575854069,3575854095,26
2,544,5978,3575854069,3575854096,27
2,544,5979,3575854069,3575854100,31
2,544,5980,3575854069,3575854100,31
2,544,5981,3575854069,3575854100,31
2,544,5982,3575854069,3575854100,31
2,544,5983,3575854069,3575854102,33
2,544,5984,3575854069,3575854105,36
2,544,5985,3575854069,3575854105,36
2,544,5986,3575854069,3575854108,39
2,544,5987,3575854069,3575854110,41
2,544,5988,3575854069,3575854113,44
2,544,5989,3575854069,3575854114,45
2,544,5990,3575854069,3575854115,46
2,544,5991,3575854069,3575854115,46
2,544,5992,3575854069,3575854115,46
2,544,5993,3575854069,3575854116,47
2,544,5994,3575854069,3575854117,48
2,545,5995,3575854123,3575854123,0
2,545,5996,3575854123,3575854123,0
2,545,5997,3575854123,3575854123,0
2,545,5998,3575854123,3575854124,1
2,545,5999,3575854123,3575854127,4
2,545,6000,3575854123,3575854127,4
2,545,6001,3575854123,3575854128,5
2,545,6002,3575854123,3575854132,9
2,545,6003,3575854123,3575854133,10
2,545,6004,3575854123,3575854134,11
2,545,6005,3575854123,3575854134,11
2,545,6006,3575854123,3575854138,15
2,545,6007,3575854123,3575854140,17
2,545,6008,3575854123,3575854144,21
2,545,6009,3575854123,3575854145,22
2,545,6010,3575854123,3575854145,22
2,545,6011,3575854123,3575854146,23
2,545,6012,3575854123,3575854147,24
2,545,6013,3575854123,3575854148,25
2,545,6014,3575854123,3575854149,26
2,545,6015,3575854123,3575854151,28
2,545,6016,3575854123,3575854152,29
2,545,6017,3575854123,3575854158,35
2,545,6018,3575854123,3575854161,38
2,545,6019,3575854123,3575854162,39
2,545,6020,3575854123,3575854163,40
2,545,6021,3575854123,3575854165,42
2,545,6022,3575854123,3575854167,44
2,545,6023,3575854123,3575854168,45
2,545,6024,3575854123,3575854168,45
2,545,6025,3575854123,3575854170,47
2,545,6026,3575854123,3575854171,48
2,546,6027,3575854177,3575854177,0
2,546,6028,3575854177,3575854177,0
2,546,6029,3575854177,3575854178,1
2,546,6030,3575854177,3575854181,4
2,546,6031,3575854177,3575854183,6
2,546,6032,3575854177,3575854184,7
2,546,6033,3575854177,3575854184,7
2,546,6034,3575854177,3575854185,8
2,546,6035,3575854177,3575854186,9
2,546,6036,3575854177,3575854188,11
2,546,6037,3575854177,3575854192,15
2,546,6038,3575854177,3575854194,17
2,546,6039,3575854177,3575854195,18
2,546,6040,3575854177,3575854199,22
2,546,6041,3575854177,3575854199,22
2,546,6042,3575854177,3575854203,26
2,546,6043,3575854177,3575854204,27
2,546,6044,3575854177,3575854205,28
2,546,6045,3575854177,3575854211,34
2,546,6046,3575854177,3575854213,36
2,546,6047,3575854177,3575854214,37
2,546,6048,3575854177,3575854214,37
2,546,6049,3575854177,3575854218,41
2,546,6050,3575854177,3575854220,43
2,546,6051,3575854177,3575854222,45
2,546,6052,3575854177,3575854222,45
2,546,6053,3575854177,3575854224,47
2,546,6054,3575854177,3575854226,49
2,547,6055,3575854234,3575854234,0
2,547,6056,3575854234,3575854234,0
2,547,6057,3575854234,3575854236,2
2,547,6058,3575854234,3575854237,3
2,547,6059,3575854234,3575854237,3
2,547,6060,3575854234,3575854237,3
2,547,6061,3575854234,3575854240,6
2,547,6062,3575854234,3575854243,9
2,547,6063,3575854234,3575854245,11
2,547,6064,3575854234,3575854245,11
2,547,6065,3575854234,3575854247,13
2,547,6066,3575854234,3575854249,15
2,547,6067,3575854234,3575854252,18
2,547,6068,3575854234,3575854256,22
2,547,6069,3575854234,3575854259,25
2,547,6070,3575854234,3575854261,27
2,547,6071,3575854234,3575854264,30
2,547,6072,3575854234,3575854268,34
2,547,6073,3575854234,3575854269,35
2,547,6074,3575854234,3575854274,40
2,547,6075,3575854234,3575854276,42
2,547,6076,3575854234,3575854279,45
2,547,6077,3575854234,3575854279,45
2,547,6078,3575854234,3575854280,46
2,547,6079,3575854234,3575854280,46
2,547,6080,3575854234,3575854281,47
2,547,6081,3575854234,3575854283,49
2,547,6082,3575854234,3575854284,50
2,548,6083,3575854288,3575854288,0
2,548,6084,3575854288,3575854289,1
2,548,6085,3575854288,3575854290,2
2,548,6086,3575854288,3575854291,3
2,548,6087,3575854288,3575854292,4
2,548,6088,3575854288,3575854294,6
2,548,6089,3575854288,3575854295,7
2,548,6090,3575854288,3575854296,8
2,548,6091,3575854288,3575854300,12
2,548,6092,3575854288,3575854300,12
2,548,6093,3575854288,3575854301,13
2,548,6094,3575854288,3575854301,13
2,548,6095,3575854288,3575854302,14
2,548,6096,3575854288,3575854304,16
2,548,6097,3575854288,3575854305,17
2,548,6098,3575854288,3575854306,18
2,548,6099,3575854288,3575854308,20
2,548,6100,3575854288,3575854311,23
2,548,6101,3575854288,3575854313,25
2,548,6102,3575854288,3575854314,26
2,548,6103,3575854288,3575854314,26
2,548,6104,3575854288,3575854315,27
2,548,6105,3575854288,3575854316,28
2,548,6106,3575854288,3575854317,29
2,548,6107,3575854288,3575854317,29
2,548,6108,3575854288,3575854320,32
2,548,6109,3575854288,3575854320,32
2,548,6110,3575854288,3575854323,35
2,548,6111,3575854288,3575854325,37
2,548,6112,3575854288,3575854327,39
2,548,6113,3575854288,3575854328,40
2,548,6114,3575854288,3575854329,41
2,548,6115,3575854288,3575854331,43
2,548,6116,3575854288,3575854332,44
2,548,6117,3575854288,3575854334,46
2,548,6118,3575854288,3575854335,47
2,549,6119,3575854342,3575854342,0
2,549,6120,3575854342,3575854342,0
2,549,6121,3575854342,3575854345,3
2,549,6122,3575854342,3575854345,3
2,549,6123,3575854342,3575854346,4
2,549,6124,3575854342,3575854346,4
2,549,6125,3575854342,3575854348,6
2,549,6126,3575854342,3575854348,6
2,549,6127,3575854342,3575854349,7
2,549,6128,3575854342,3575854351,9
2,549,6129,3575854342,3575854351,9
2,549,6130,3575854342,3575854358,16
2,549,6131,3575854342,3575854358,16
2,549,6132,3575854342,3575854361,19
2,549,6133,3575854342,3575854362,20
2,549,6134,3575854342,3575854363,21
2,549,6135,3575854342,3575854366,24
2,549,6136,3575854342,3575854367,25
2,549,6137,3575854342,3575854368,26
2,549,6138,3575854342,3575854368,26
2,549,6139,3575854342,3575854370,28
2,549,6140,3575854342,3575854372,30
2,549,6141,3575854342,3575854376,34
2,549,6142,3575854342,3575854378,36
2,549,6143,3575854342,3575854379,37
2,549,6144,3575854342,3575854381,39
2,549,6145,3575854342,3575854383,41
2,549,6146,3575854342,3575854385,43
2,549,6147,3575854342,3575854385,43
2,549,6148,3575854342,3575854386,44
2,549,6149,3575854342,3575854386,44
2,549,6150,3575854342,3575854387,45
2,549,6151,3575854342,3575854391,49
2,549,6152,3575854342,3575854392,50
2,550,6153,3575854396,3575854396,0
2,550,6154,3575854396,3575854396,0
2,550,6155,3575854396,3575854399,3
2,550,6156,3575854396,3575854400,4
2,550,6157,3575854396,3575854403,7
2,550,6158,3575854396,3575854404,8
2,550,6159,3575854396,3575854404,8
2,550,6160,3575854396,3575854412,16
2,550,6161,3575854396,3575854413,17
2,550,6162,3575854396,3575854415,19
2,550,6163,3575854396,3575854415,19
2,550,6164,3575854396,3575854418,22
2,550,6165,3575854396,3575854420,24
2,550,6166,3575854396,3575854423,27
2,550,6167,3575854396,3575854424,28
2,550,6168,3575854396,3575854425,29
2,550,6169,3575854396,3575854426,30
2,550,6170,3575854396,3575854427,31
2,550,6171,3575854396,3575854428,32
2,550,6172,3575854396,3575854435,39
2,550,6173,3575854396,3575854436,40
2,550,6174,3575854396,3575854438,42
2,550,6175,3575854396,3575854438,42
2,550,6176,3575854396,3575854441,45
2,550,6177,3575854396,3575854444,48
2,550,6178,3575854396,3575854446,50
2,551,6179,3575854450,3575854450,0
2,551,6180,3575854450,3575854450,0
2,551,6181,3575854450,3575854450,0
2,551,6182,3575854450,3575854452,2
2,551,6183,3575854450,3575854456,6
2,551,6184,3575854450,3575854462,12
2,551,6185,3575854450,3575854464,14
2,551,6186,3575854450,3575854468,18
2,551,6187,3575854450,3575854468,18
2,551,6188,3575854450,3575854469,19
2,551,6189,3575854450,3575854475,25
2,551,6190,3575854450,3575854476,26
2,551,6191,3575854450,3575854478,28
2,551,6192,3575854450,3575854479,29
2,551,6193,3575854450,3575854479,29
2,551,6194,3575854450,3575854480,30
2,551,6195,3575854450,3575854480,30
2,551,6196,3575854450,3575854482,32
2,551,6197,3575854450,3575854484,34
2,551,6198,3575854450,3575854484,34
2,551,6199,3575854450,3575854488,38
2,551,6200,3575854450,3575854490,40
2,551,6201,3575854450,3575854491,41
2,551,6202,3575854450,3575854492,42
2,551,6203,3575854450,3575854495,45
2,551,6204,3575854450,3575854495,45
2,552,6205,3575854504,3575854504,0
2,552,6206,3575854504,3575854504,0
2,552,6207,3575854504,3575854504,0
2,552,6208,3575854504,3575854504,0
2,552,6209,3575854504,3575854504,0
2,552,6210,3575854504,3575854504,0
2,552,6211,3575854504,3575854504,0
2,552,6212,3575854504,3575854505,1
2,552,6213,3575854504,3575854507,3
2,552,6214,3575854504,3575854509,5
2,552,6215,3575854504,3575854510,6
2,552,6216,3575854504,3575854512,8
2,552,6217,3575854504,3575854513,9
2,552,6218,3575854504,3575854514,10
2,552,6219,3575854504,3575854514,10
2,552,6220,3575854504,3575854514,10
2,552,6221,3575854504,3575854517,13
2,552,6222,3575854504,3575854517,13
2,552,6223,3575854504,3575854519,15
2,552,6224,3575854504,3575854519,15
2,552,6225,3575854504,3575854522,18
2,552,6226,3575854504,3575854523,19
2,552,6227,3575854504,3575854525,21
2,552,6228,3575854504,3575854526,22
2,552,6229,3575854504,3575854527,23
2,552,6230,3575854504,3575854531,27
2,552,6231,3575854504,3575854531,27
2,552,6232,3575854504,3575854533,29
2,552,6233,3575854504,3575854534,30
2,552,6234,3575854504,3575854539,35
2,552,6235,3575854504,3575854539,35
2,552,6236,3575854504,3575854544,40
2,552,6237,3575854504,3575854544,40
2,552,6238,3575854504,3575854545,41
2,552,6239,3575854504,3575854545,41
2,552,6240,3575854504,3575854546,42
2,552,6241,3575854504,3575854547,43
2,552,6242,3575854504,3575854548,44
2,552,6243,3575854504,3575854550,46
2,552,6244,3575854504,3575854551,47
2,553,6245,3575854558,3575854558,0
2,553,6246,3575854558,3575854558,0
2,553,6247,3575854558,3575854561,3
2,553,6248,3575854558,3575854562,4
2,553,6249,3575854558,3575854563,5
2,553,6250,3575854558,3575854565,7
2,553,6251,3575854558,3575854566,8
2,553,6252,3575854558,3575854566,8
2,553,6253,3575854558,3575854568,10
2,553,6254,3575854558,3575854569,11
2,553,6255,3575854558,3575854570,12
2,553,6256,3575854558,3575854575,17
2,553,6257,3575854558,3575854576,18
2,553,6258,3575854558,3575854578,20
2,553,6259,3575854558,3575854580,22
2,553,6260,3575854558,3575854582,24
2,553,6261,3575854558,3575854584,26
2,553,6262,3575854558,3575854584,26
2,553,6263,3575854558,3575854585,27
2,553,6264,3575854558,3575854585,27
2,553,6265,3575854558,3575854587,29
2,553,6266,3575854558,3575854590,32
2,553,6267,3575854558,3575854591,33
2,553,6268,3575854558,3575854593,35
2,553,6269,3575854558,3575854595,37
2,553,6270,3575854558,3575854598,40
2,553,6271,3575854558,3575854598,40
2,553,6272,3575854558,3575854602,44
2,553,6273,3575854558,3575854603,45
2,553,6274,3575854558,3575854604,46
2,554,6275,3575854611,3575854611,0
2,554,6276,3575854611,3575854612,1
2,554,6277,3575854611,3575854615,4
2,554,6278,3575854611,3575854615,4
2,554,6279,3575854611,3575854616,5
2,554,6280,3575854611,3575854620,9
2,554,6281,3575854611,3575854622,11
2,554,6282,3575854611,3575854623,12
2,554,6283,3575854611,3575854623,12
2,554,6284,3575854611,3575854625,14
2,554,6285,3575854611,3575854627,16
2,554,6286,3575854611,3575854628,17
2,554,6287,3575854611,3575854634,23
2,554,6288,3575854611,3575854636,25
2,554,6289,3575854611,3575854636,25
2,554,6290,3575854611,3575854638,27
2,554,6291,3575854611,3575854640,29
2,554,6292,3575854611,3575854643,32
2,554,6293,3575854611,3575854645,34
2,554,6294,3575854611,3575854646,35
2,554,6295,3575854611,3575854649,38
2,554,6296,3575854611,3575854649,38
2,554,6297,3575854611,3575854651,40
2,554,6298,3575854611,3575854655,44
2,554,6299,3575854611,3575854655,44
2,554,6300,3575854611,3575854659,48
2,554,6301,3575854611,3575854660,49
2,555,6302,3575854665,3575854665,0
2,555,6303,3575854665,3575854665,0
2,555,6304,3575854665,3575854667,2
2,555,6305,3575854665,3575854667,2
2,555,6306,3575854665,3575854667,2
2,555,6307,3575854665,3575854668,3
2,555,6308,3575854665,3575854674,9
2,555,6309,3575854665,3575854676,11
2,555,6310,3575854665,3575854679,14
2,555,6311,3575854665,3575854679,14
2,555,6312,3575854665,3575854680,15
2,555,6313,3575854665,3575854680,15
2,555,6314,3575854665,3575854681,16
2,555,6315,3575854665,3575854683,18
2,555,6316,3575854665,3575854683,18
2,555,6317,3575854665,3575854684,19
2,555,6318,3575854665,3575854689,24
2,555,6319,3575854665,3575854690,25
2,555,6320,3575854665,3575854690,25
2,555,6321,3575854665,3575854692,27
2,555,6322,3575854665,3575854695,30
2,555,6323,3575854665,3575854695,30
2,555,6324,3575854665,3575854699,34
2,555,6325,3575854665,3575854700,35
2,555,6326,3575854665,3575854700,35
2,555,6327,3575854665,3575854702,37
2,555,6328,3575854665,3575854702,37
2,555,6329,3575854665,3575854703,38
2,555,6330,3575854665,3575854704,39
2,555,6331,3575854665,3575854705,40
2,555,6332,3575854665,3575854708,43
2,555,6333,3575854665,3575854709,44
2,555,6334,3575854665,3575854710,45
2,555,6335,3575854665,3575854713,48
2,555,6336,3575854665,3575854713,48
2,555,6337,3575854665,3575854713,48
2,555,6338,3575854665,3575854714,49
2,555,6339,3575854665,3575854714,49
2,556,6340,3575854719,3575854719,0
2,556,6341,3575854719,3575854719,0
2,556,6342,3575854719,3575854719,0
2,556,6343,3575854719,3575854720,1
2,556,6344,3575854719,3575854722,3
2,556,6345,3575854719,3575854724,5
2,556,6346,3575854719,3575854727,8
2,556,6347,3575854719,3575854727,8
2,556,6348,3575854719,3575854727,8
2,556,6349,3575854719,3575854730,11
2,556,6350,3575854719,3575854731,12
2,556,6351,3575854719,3575854733,14
2,556,6352,3575854719,3575854735,16
2,556,6353,3575854719,3575854739,20
2,556,6354,3575854719,3575854740,21
2,556,6355,3575854719,3575854744,25
2,556,6356,3575854719,3575854744,25
2,556,6357,3575854719,3575854744,25
2,556,6358,3575854719,3575854745,26
2,556,6359,3575854719,3575854746,27
2,556,6360,3575854719,3575854748,29
2,556,6361,3575854719,3575854749,30
2,556,6362,3575854719,3575854751,32
2,556,6363,3575854719,3575854751,32
2,556,6364,3575854719,3575854758,39
2,556,6365,3575854719,3575854761,42
2,556,6366,3575854719,3575854762,43
2,556,6367,3575854719,3575854762,43
2,556,6368,3575854719,3575854765,46
2,556,6369,3575854719,3575854766,47
2,556,6370,3575854719,3575854767,48
2,556,6371,3575854719,3575854769,50
2,557,6372,3575854773,3575854773,0
2,557,6373,3575854773,3575854773,0
2,557,6374,3575854773,3575854775,2
2,557,6375,3575854773,3575854777,4
2,557,6376,3575854773,3575854778,5
2,557,6377,3575854773,3575854780,7
2,557,6378,3575854773,3575854783,10
2,557,6379,3575854773,3575854783,10
2,557,6380,3575854773,3575854785,12
2,557,6381,3575854773,3575854785,12
2,557,6382,3575854773,3575854785,12
2,557,6383,3575854773,3575854787,14
2,557,6384,3575854773,3575854791,18
2,557,6385,3575854773,3575854791,18
2,557,6386,3575854773,3575854792,19
2,557,6387,3575854773,3575854795,22
2,557,6388,3575854773,3575854798,25
2,557,6389,3575854773,3575854799,26
2,557,6390,3575854773,3575854801,28
2,557,6391,3575854773,3575854804,31
2,557,6392,3575854773,3575854804,31
2,557,6393,3575854773,3575854810,37
2,557,6394,3575854773,3575854811,38
2,557,6395,3575854773,3575854813,40
2,557,6396,3575854773,3575854815,42
2,557,6397,3575854773,3575854815,42
2,557,6398,3575854773,3575854818,45
2,557,6399,3575854773,3575854820,47
2,557,6400,3575854773,3575854822,49
2,557,6401,3575854773,3575854822,49
2,558,6402,3575854828,3575854828,0
2,558,6403,3575854828,3575854828,0
2,558,6404,3575854828,3575854828,0
2,558,6405,3575854828,3575854828,0
2,558,6406,3575854828,3575854836,8
2,558,6407,3575854828,3575854836,8
2,558,6408,3575854828,3575854837,9
2,558,6409,3575854828,3575854838,10
2,558,6410,3575854828,3575854840,12
2,558,6411,3575854828,3575854843,15
2,558,6412,3575854828,3575854844,16
2,558,6413,3575854828,3575854845,17
2,558,6414,3575854828,3575854846,18
2,558,6415,3575854828,3575854848,20
2,558,6416,3575854828,3575854851,23
2,558,6417,3575854828,3575854856,28
2,558,6418,3575854828,3575854859,31
2,558,6419,3575854828,3575854860,32
2,558,6420,3575854828,3575854861,33
2,558,6421,3575854828,3575854863,35
2,558,6422,3575854828,3575854867,39
2,558,6423,3575854828,3575854867,39
2,558,6424,3575854828,3575854868,40
2,558,6425,3575854828,3575854868,40
2,558,6426,3575854828,3575854872,44
2,558,6427,3575854828,3575854874,46
2,558,6428,3575854828,3575854876,48
2,559,6429,3575854882,3575854882,0
2,559,6430,3575854882,3575854882,0
2,559,6431,3575854882,3575854882,0
2,559,6432,3575854882,3575854882,0
2,559,6433,3575854882,3575854882,0
2,559,6434,3575854882,3575854883,1
2,559,6435,3575854882,3575854884,2
2,559,6436,3575854882,3575854885,3
2,559,6437,3575854882,3575854890,8
2,559,6438,3575854882,3575854891,9
2,559,6439,3575854882,3575854892,10
2,559,6440,3575854882,3575854894,12
2,559,6441,3575854882,3575854894,12
2,559,6442,3575854882,3575854900,18
2,559,6443,3575854882,3575854901,19
2,559,6444,3575854882,3575854901,19
2,559,6445,3575854882,3575854902,20
2,559,6446,3575854882,3575854902,20
2,559,6447,3575854882,3575854904,22
2,559,6448,3575854882,3575854904,22
2,559,6449,3575854882,3575854905,23
2,559,6450,3575854882,3575854908,26
2,559,6451,3575854882,3575854910,28
2,559,6452,3575854882,3575854911,29
2,559,6453,3575854882,3575854911,29
2,559,6454,3575854882,3575854913,31
2,559,6455,3575854882,3575854913,31
2,559,6456,3575854882,3575854914,32
2,559,6457,3575854882,3575854914,32
2,559,6458,3575854882,3575854914,32
2,559,6459,3575854882,3575854916,34
2,559,6460,3575854882,3575854917,35
2,559,6461,3575854882,3575854920,38
2,559,6462,3575854882,3575854920,38
2,559,6463,3575854882,3575854922,40
2,559,6464,3575854882,3575854927,45
2,559,6465,3575854882,3575854927,45
2,559,6466,3575854882,3575854928,46
2,559,6467,3575854882,3575854930,48
2,559,6468,3575854882,3575854931,49
2,560,6469,3575854936,3575854936,0
2,560,6470,3575854936,3575854936,0
2,560,6471,3575854936,3575854938,2
2,560,6472,3575854936,3575854939,3
2,560,6473,3575854936,3575854945,9
2,560,6474,3575854936,3575854945,9
2,560,6475,3575854936,3575854945,9
2,560,6476,3575854936,3575854945,9
2,560,6477,3575854936,3575854947,11
2,560,6478,3575854936,3575854948,12
2,560,6479,3575854936,3575854948,12
2,560,6480,3575854936,3575854951,15
2,560,6481,3575854936,3575854952,16
2,560,6482,3575854936,3575854959,23
2,560,6483,3575854936,3575854961,25
2,560,6484,3575854936,3575854962,26
2,560,6485,3575854936,3575854963,27
2,560,6486,3575854936,3575854965,29
2,560,6487,3575854936,3575854967,31
2,560,6488,3575854936,3575854969,33
2,560,6489,3575854936,3575854969,33
2,560,6490,3575854936,3575854972,36
2,560,6491,3575854936,3575854975,39
2,560,6492,3575854936,3575854977,41
2,560,6493,3575854936,3575854978,42
2,560,6494,3575854936,3575854981,45
2,560,6495,3575854936,3575854982,46
2,560,6496,3575854936,3575854983,47
2,560,6497,3575854936,3575854985,49
2,560,6498,3575854936,3575854985,49
2,560,6499,3575854936,3575854985,49
2,561,6500,3575854990,3575854990,0
2,561,6501,3575854990,3575854990,0
2,561,6502,3575854990,3575854990,0
2,561,6503,3575854990,3575854992,2
2,561,6504,3575854990,3575854994,4
2,561,6505,3575854990,3575854996,6
2,561,6506,3575854990,3575854998,8
2,561,6507,3575854990,3575854998,8
2,561,6508,3575854990,3575855002,12
2,561,6509,3575854990,3575855003,13
2,561,6510,3575854990,3575855004,14
2,561,6511,3575854990,3575855011,21
2,561,6512,3575854990,3575855012,22
2,561,6513,3575854990,3575855015,25
2,561,6514,3575854990,3575855015,25
2,561,6515,3575854990,3575855017,27
2,561,6516,3575854990,3575855020,30
2,561,6517,3575854990,3575855022,32
2,561,6518,3575854990,3575855022,32
2,561,6519,3575854990,3575855024,34
2,561,6520,3575854990,3575855025,35
2,561,6521,3575854990,3575855027,37
2,561,6522,3575854990,3575855029,39
2,561,6523,3575854990,3575855035,45
2,561,6524,3575854990,3575855037,47
2,561,6525,3575854990,3575855037,47
2,561,6526,3575854990,3575855038,48
2,561,6527,3575854990,3575855040,50
2,562,6528,3575855044,3575855045,1
2,562,6529,3575855044,3575855045,1
2,562,6530,3575855044,3575855045,1
2,562,6531,3575855044,3575855046,2
2,562,6532,3575855044,3575855049,5
2,562,6533,3575855044,3575855053,9
2,562,6534,3575855044,3575855056,12
2,562,6535,3575855044,3575855060,16
2,562,6536,3575855044,3575855060,16
2,562,6537,3575855044,3575855062,18
2,562,6538,3575855044,3575855067,23
2,562,6539,3575855044,3575855067,23
2,562,6540,3575855044,3575855068,24
2,562,6541,3575855044,3575855069,25
2,562,6542,3575855044,3575855073,29
2,562,6543,3575855044,3575855074,30
2,562,6544,3575855044,3575855076,32
2,562,6545,3575855044,3575855078,34
2,562,6546,3575855044,3575855079,35
2,562,6547,3575855044,3575855079,35
2,562,6548,3575855044,3575855079,35
2,562,6549,3575855044,3575855080,36
2,562,6550,3575855044,3575855082,38
2,562,6551,3575855044,3575855085,41
2,562,6552,3575855044,3575855085,41
2,562,6553,3575855044,3575855090,46
2,562,6554,3575855044,3575855091,47
2,562,6555,3575855044,3575855092,48
2,563,6556,3575855100,3575855100,0
2,563,6557,3575855100,3575855100,0
2,563,6558,3575855100,3575855100,0
2,563,6559,3575855100,3575855100,0
2,563,6560,3575855100,3575855101,1
2,563,6561,3575855100,3575855101,1
2,563,6562,3575855100,3575855102,2
2,563,6563,3575855100,3575855103,3
2,563,6564,3575855100,3575855104,4
2,563,6565,3575855100,3575855104,4
2,563,6566,3575855100,3575855105,5
2,563,6567,3575855100,3575855108,8
2,563,6568,3575855100,3575855110,10
2,563,6569,3575855100,3575855110,10
2,563,6570,3575855100,3575855111,11
2,563,6571,3575855100,3575855113,13
2,563,6572,3575855100,3575855114,14
2,563,6573,3575855100,3575855114,14
2,563,6574,3575855100,3575855114,14
2,563,6575,3575855100,3575855116,16
2,563,6576,3575855100,3575855117,17
2,563,6577,3575855100,3575855120,20
2,563,6578,3575855100,3575855120,20
2,563,6579,3575855100,3575855123,23
2,563,6580,3575855100,3575855125,25
2,563,6581,3575855100,3575855127,27
2,563,6582,3575855100,3575855128,28
2,563,6583,3575855100,3575855131,31
2,563,6584,3575855100,3575855132,32
2,563,6585,3575855100,3575855134,34
2,563,6586,3575855100,3575855135,35
2,563,6587,3575855100,3575855139,39
2,563,6588,3575855100,3575855140,40
2,563,6589,3575855100,3575855145,45
2,563,6590,3575855100,3575855145,45
2,563,6591,3575855100,3575855145,45
2,563,6592,3575855100,3575855146,46
2,563,6593,3575855100,3575855148,48
2,563,6594,3575855100,3575855148,48
2,563,6595,3575855100,3575855149,49
2,564,6596,3575855154,3575855154,0
2,564,6597,3575855154,3575855154,0
2,564,6598,3575855154,3575855157,3
2,564,6599,3575855154,3575855162,8
2,564,6600,3575855154,3575855162,8
2,564,6601,3575855154,3575855163,9
2,564,6602,3575855154,3575855165,11
2,564,6603,3575855154,3575855166,12
2,564,6604,3575855154,3575855168,14
2,564,6605,3575855154,3575855170,16
2,564,6606,3575855154,3575855173,19
2,564,6607,3575855154,3575855176,22
2,564,6608,3575855154,3575855178,24
2,564,6609,3575855154,3575855178,24
2,564,6610,3575855154,3575855181,27
2,564,6611,3575855154,3575855184,30
2,564,6612,3575855154,3575855185,31
2,564,6613,3575855154,3575855185,31
2,564,6614,3575855154,3575855185,31
2,564,6615,3575855154,3575855187,33
2,564,6616,3575855154,3575855188,34
2,564,6617,3575855154,3575855191,37
2,564,6618,3575855154,3575855192,38
2,564,6619,3575855154,3575855194,40
2,564,6620,3575855154,3575855195,41
2,564,6621,3575855154,3575855199,45
2,564,6622,3575855154,3575855199,45
2,564,6623,3575855154,3575855201,47
2,564,6624,3575855154,3575855204,50
2,565,6625,3575855208,3575855208,0
2,565,6626,3575855208,3575855211,3
2,565,6627,3575855208,3575855211,3
2,565,6628,3575855208,3575855213,5
2,565,6629,3575855208,3575855216,8
2,565,6630,3575855208,3575855218,10
2,565,6631,3575855208,3575855220,12
2,565,6632,3575855208,3575855223,15
2,565,6633,3575855208,3575855223,15
2,565,6634,3575855208,3575855224,16
2,565,6635,3575855208,3575855226,18
2,565,6636,3575855208,3575855228,20
2,565,6637,3575855208,3575855229,21
2,565,6638,3575855208,3575855230,22
2,565,6639,3575855208,3575855235,27
2,565,6640,3575855208,3575855236,28
2,565,6641,3575855208,3575855237,29
2,565,6642,3575855208,3575855239,31
2,565,6643,3575855208,3575855240,32
2,565,6644,3575855208,3575855245,37
2,565,6645,3575855208,3575855245,37
2,565,6646,3575855208,3575855247,39
2,565,6647,3575855208,3575855249,41
2,565,6648,3575855208,3575855253,45
2,565,6649,3575855208,3575855256,48
2,566,6650,3575855262,3575855262,0
2,566,6651,3575855262,3575855262,0
2,566,6652,3575855262,3575855262,0
2,566,6653,3575855262,3575855267,5
2,566,6654,3575855262,3575855268,6
2,566,6655,3575855262,3575855269,7
2,566,6656,3575855262,3575855269,7
2,566,6657,3575855262,3575855272,10
2,566,6658,3575855262,3575855274,12
2,566,6659,3575855262,3575855276,14
2,566,6660,3575855262,3575855279,17
2,566,6661,3575855262,3575855279,17
2,566,6662,3575855262,3575855280,18
2,566,6663,3575855262,3575855280,18
2,566,6664,3575855262,3575855280,18
2,566,6665,3575855262,3575855283,21
2,566,6666,3575855262,3575855285,23
2,566,6667,3575855262,3575855286,24
2,566,6668,3575855262,3575855290,28
2,566,6669,3575855262,3575855292,30
2,566,6670,3575855262,3575855292,30
2,566,6671,3575855262,3575855294,32
2,566,6672,3575855262,3575855295,33
2,566,6673,3575855262,3575855297,35
2,566,6674,3575855262,3575855300,38
2,566,6675,3575855262,3575855301,39
2,566,6676,3575855262,3575855301,39
2,566,6677,3575855262,3575855302,40
2,566,6678,3575855262,3575855303,41
2,566,6679,3575855262,3575855304,42
2,566,6680,3575855262,3575855304,42
2,566,6681,3575855262,3575855306,44
2,566,6682,3575855262,3575855308,46
2,566,6683,3575855262,3575855310,48
2,566,6684,3575855262,3575855311,49
2,567,6685,3575855316,3575855316,0
2,567,6686,3575855316,3575855316,0
2,567,6687,3575855316,3575855316,0
2,567,6688,3575855316,3575855316,0
2,567,6689,3575855316,3575855317,1
2,567,6690,3575855316,3575855317,1
2,567,6691,3575855316,3575855320,4
2,567,6692,3575855316,3575855321,5
2,567,6693,3575855316,3575855323,7
2,567,6694,3575855316,3575855325,9
2,567,6695,3575855316,3575855326,10
2,567,6696,3575855316,3575855328,12
2,567,6697,3575855316,3575855331,15
2,567,6698,3575855316,3575855332,16
2,567,6699,3575855316,3575855335,19
2,567,6700,3575855316,3575855340,24
2,567,6701,3575855316,3575855340,24
2,567,6702,3575855316,3575855345,29
2,567,6703,3575855316,3575855345,29
2,567,6704,3575855316,3575855345,29
2,567,6705,3575855316,3575855346,30
2,567,6706,3575855316,3575855347,31
2,567,6707,3575855316,3575855349,33
2,567,6708,3575855316,3575855349,33
2,567,6709,3575855316,3575855352,36
2,567,6710,3575855316,3575855352,36
2,567,6711,3575855316,3575855358,42
2,567,6712,3575855316,3575855359,43
2,567,6713,3575855316,3575855361,45
2,567,6714,3575855316,3575855362,46
2,567,6715,3575855316,3575855364,48
2,567,6716,3575855316,3575855365,49
2,568,6717,3575855370,3575855370,0
2,568,6718,3575855370,3575855370,0
2,568,6719,3575855370,3575855370,0
2,568,6720,3575855370,3575855373,3
2,568,6721,3575855370,3575855376,6
2,568,6722,3575855370,3575855378,8
2,568,6723,3575855370,3575855379,9
2,568,6724,3575855370,3575855381,11
2,568,6725,3575855370,3575855383,13
2,568,6726,3575855370,3575855385,15
2,568,6727,3575855370,3575855385,15
2,568,6728,3575855370,3575855385,15
2,568,6729,3575855370,3575855386,16
2,568,6730,3575855370,3575855388,18
2,568,6731,3575855370,3575855388,18
2,568,6732,3575855370,3575855390,20
2,568,6733,3575855370,3575855392,22
2,568,6734,3575855370,3575855394,24
2,568,6735,3575855370,3575855395,25
2,568,6736,3575855370,3575855399,29
2,568,6737,3575855370,3575855399,29
2,568,6738,3575855370,3575855402,32
2,568,6739,3575855370,3575855404,34
2,568,6740,3575855370,3575855404,34
2,568,6741,3575855370,3575855411,41
2,568,6742,3575855370,3575855411,41
2,568,6743,3575855370,3575855412,42
2,568,6744,3575855370,3575855416,46
2,568,6745,3575855370,3575855417,47
2,568,6746,3575855370,3575855420,50
2,569,6747,3575855426,3575855426,0
2,569,6748,3575855426,3575855426,0
2,569,6749,3575855426,3575855426,0
2,569,6750,3575855426,3575855427,1
2,569,6751,3575855426,3575855429,3
2,569,6752,3575855426,3575855429,3
2,569,6753,3575855426,3575855430,4
2,569,6754,3575855426,3575855435,9
2,569,6755,3575855426,3575855436,10
2,569,6756,3575855426,3575855438,12
2,569,6757,3575855426,3575855438,12
2,569,6758,3575855426,3575855440,14
2,569,6759,3575855426,3575855445,19
2,569,6760,3575855426,3575855445,19
2,569,6761,3575855426,3575855446,20
2,569,6762,3575855426,3575855447,21
2,569,6763,3575855426,3575855450,24
2,569,6764,3575855426,3575855450,24
2,569,6765,3575855426,3575855452,26
2,569,6766,3575855426,3575855455,29
2,569,6767,3575855426,3575855456,30
2,569,6768,3575855426,3575855460,34
2,569,6769,3575855426,3575855461,35
2,569,6770,3575855426,3575855463,37
2,569,6771,3575855426,3575855467,41
2,569,6772,3575855426,3575855468,42
2,569,6773,3575855426,3575855468,42
2,569,6774,3575855426,3575855468,42
2,569,6775,3575855426,3575855473,47
2,569,6776,3575855426,3575855475,49
2,570,6777,3575855480,3575855480,0
2,570,6778,3575855480,3575855480,0
2,570,6779,3575855480,3575855480,0
2,570,6780,3575855480,3575855480,0
2,570,6781,3575855480,3575855480,0
2,570,6782,3575855480,3575855481,1
2,570,6783,3575855480,3575855484,4
2,570,6784,3575855480,3575855485,5
2,570,6785,3575855480,3575855489,9
2,570,6786,3575855480,3575855491,11
2,570,6787,3575855480,3575855491,11
2,570,6788,3575855480,3575855493,13
2,570,6789,3575855480,3575855493,13
2,570,6790,3575855480,3575855496,16
2,570,6791,3575855480,3575855500,20
2,570,6792,3575855480,3575855500,20
2,570,6793,3575855480,3575855500,20
2,570,6794,3575855480,3575855502,22
2,570,6795,3575855480,3575855502,22
2,570,6796,3575855480,3575855503,23
2,570,6797,3575855480,3575855503,23
2,570,6798,3575855480,3575855506,26
2,570,6799,3575855480,3575855507,27
2,570,6800,3575855480,3575855509,29
2,570,6801,3575855480,3575855511,31
2,570,6802,3575855480,3575855513,33
2,570,6803,3575855480,3575855513,33
2,570,6804,3575855480,3575855514,34
2,570,6805,3575855480,3575855514,34
2,570,6806,3575855480,3575855515,35
2,570,6807,3575855480,3575855516,36
2,570,6808,3575855480,3575855516,36
2,570,6809,3575855480,3575855519,39
2,570,6810,3575855480,3575855519,39
2,570,6811,3575855480,3575855521,41
2,570,6812,3575855480,3575855524,44
2,570,6813,3575855480,3575855527,47
2,570,6814,3575855480,3575855530,50
2,571,6815,3575855534,3575855534,0
2,571,6816,3575855534,3575855534,0
2,571,6817,3575855534,3575855534,0
2,571,6818,3575855534,3575855534,0
2,571,6819,3575855534,3575855538,4
2,571,6820,3575855534,3575855539,5
2,571,6821,3575855534,3575855544,10
2,571,6822,3575855534,3575855544,10
2,571,6823,3575855534,3575855545,11
2,571,6824,3575855534,3575855546,12
2,571,6825,3575855534,3575855547,13
2,571,6826,3575855534,3575855548,14
2,571,6827,3575855534,3575855549,15
2,571,6828,3575855534,3575855551,17
2,571,6829,3575855534,3575855551,17
2,571,6830,3575855534,3575855557,23
2,571,6831,3575855534,3575855558,24
2,571,6832,3575855534,3575855561,27
2,571,6833,3575855534,3575855563,29
2,571,6834,3575855534,3575855563,29
2,571,6835,3575855534,3575855565,31
2,571,6836,3575855534,3575855566,32
2,571,6837,3575855534,3575855567,33
2,571,6838,3575855534,3575855568,34
2,571,6839,3575855534,3575855569,35
2,571,6840,3575855534,3575855571,37
2,571,6841,3575855534,3575855576,42
2,571,6842,3575855534,3575855576,42
2,571,6843,3575855534,3575855578,44
2,571,6844,3575855534,3575855580,46
2,571,6845,3575855534,3575855582,48
2,571,6846,3575855534,3575855584,50
2,572,6847,3575855589,3575855589,0
2,572,6848,3575855589,3575855589,0
2,572,6849,3575855589,3575855589,0
2,572,6850,3575855589,3575855589,0
2,572,6851,3575855589,3575855589,0
2,572,6852,3575855589,3575855590,1
2,572,6853,3575855589,3575855591,2
2,572,6854,3575855589,3575855593,4
2,572,6855,3575855589,3575855595,6
2,572,6856,3575855589,3575855598,9
2,572,6857,3575855589,3575855599,10
2,572,6858,3575855589,3575855602,13
2,572,6859,3575855589,3575855603,14
2,572,6860,3575855589,3575855605,16
2,572,6861,3575855589,3575855609,20
2,572,6862,3575855589,3575855610,21
2,572,6863,3575855589,3575855611,22
2,572,6864,3575855589,3575855614,25
2,572,6865,3575855589,3575855617,28
2,572,6866,3575855589,3575855620,31
2,572,6867,3575855589,3575855622,33
2,572,6868,3575855589,3575855623,34
2,572,6869,3575855589,3575855626,37
2,572,6870,3575855589,3575855627,38
2,572,6871,3575855589,3575855628,39
2,572,6872,3575855589,3575855630,41
2,572,6873,3575855589,3575855634,45
2,572,6874,3575855589,3575855636,47
2,572,6875,3575855589,3575855637,48
2,572,6876,3575855589,3575855638,49
2,572,6877,3575855589,3575855638,49
2,573,6878,3575855643,3575855643,0
2,573,6879,3575855643,3575855644,1
2,573,6880,3575855643,3575855645,2
2,573,6881,3575855643,3575855647,4
2,573,6882,3575855643,3575855649,6
2,573,6883,3575855643,3575855649,6
2,573,6884,3575855643,3575855651,8
2,573,6885,3575855643,3575855655,12
2,573,6886,3575855643,3575855655,12
2,573,6887,3575855643,3575855659,16
2,573,6888,3575855643,3575855660,17
2,573,6889,3575855643,3575855661,18
2,573,6890,3575855643,3575855666,23
2,573,6891,3575855643,3575855667,24
2,573,6892,3575855643,3575855667,24
2,573,6893,3575855643,3575855668,25
2,573,6894,3575855643,3575855672,29
2,573,6895,3575855643,3575855674,31
2,573,6896,3575855643,3575855676,33
2,573,6897,3575855643,3575855679,36
2,573,6898,3575855643,3575855679,36
2,573,6899,3575855643,3575855680,37
2,573,6900,3575855643,3575855680,37
2,573,6901,3575855643,3575855681,38
2,573,6902,3575855643,3575855682,39
2,573,6903,3575855643,3575855684,41
2,573,6904,3575855643,3575855685,42
2,573,6905,3575855643,3575855685,42
2,573,6906,3575855643,3575855689,46
2,573,6907,3575855643,3575855690,47
2,573,6908,3575855643,3575855691,48
2,574,6909,3575855696,3575855696,0
2,574,6910,3575855696,3575855696,0
2,574,6911,3575855696,3575855696,0
2,574,6912,3575855696,3575855699,3
2,574,6913,3575855696,3575855700,4
2,574,6914,3575855696,3575855701,5
2,574,6915,3575855696,3575855702,6
2,574,6916,3575855696,3575855702,6
2,574,6917,3575855696,3575855703,7
2,574,6918,3575855696,3575855703,7
2,574,6919,3575855696,3575855706,10
2,574,6920,3575855696,3575855708,12
2,574,6921,3575855696,3575855709,13
2,574,6922,3575855696,3575855710,14
2,574,6923,3575855696,3575855713,17
2,574,6924,3575855696,3575855713,17
2,574,6925,3575855696,3575855713,17
2,574,6926,3575855696,3575855714,18
2,574,6927,3575855696,3575855714,18
2,574,6928,3575855696,3575855716,20
2,574,6929,3575855696,3575855716,20
2,574,6930,3575855696,3575855719,23
2,574,6931,3575855696,3575855720,24
2,574,6932,3575855696,3575855722,26
2,574,6933,3575855696,3575855724,28
2,574,6934,3575855696,3575855727,31
2,574,6935,3575855696,3575855728,32
2,574,6936,3575855696,3575855730,34
2,574,6937,3575855696,3575855731,35
2,574,6938,3575855696,3575855732,36
2,574,6939,3575855696,3575855733,37
2,574,6940,3575855696,3575855735,39
2,574,6941,3575855696,3575855736,40
2,574,6942,3575855696,3575855739,43
2,574,6943,3575855696,3575855743,47
2,574,6944,3575855696,3575855744,48
2,574,6945,3575855696,3575855745,49
2,574,6946,3575855696,3575855745,49
2,574,6947,3575855696,3575855746,50
2,575,6948,3575855751,3575855751,0
2,575,6949,3575855751,3575855751,0
2,575,6950,3575855751,3575855751,0
2,575,6951,3575855751,3575855751,0
2,575,6952,3575855751,3575855757,6
2,575,6953,3575855751,3575855758,7
2,575,6954,3575855751,3575855761,10
2,575,6955,3575855751,3575855763,12
2,575,6956,3575855751,3575855763,12
2,575,6957,3575855751,3575855766,15
2,575,6958,3575855751,3575855768,17
2,575,6959,3575855751,3575855769,18
2,575,6960,3575855751,3575855769,18
2,575,6961,3575855751,3575855772,21
2,575,6962,3575855751,3575855776,25
2,575,6963,3575855751,3575855778,27
2,575,6964,3575855751,3575855778,27
2,575,6965,3575855751,3575855780,29
2,575,6966,3575855751,3575855782,31
2,575,6967,3575855751,3575855784,33
2,575,6968,3575855751,3575855784,33
2,575,6969,3575855751,3575855784,33
2,575,6970,3575855751,3575855787,36
2,575,6971,3575855751,3575855788,37
2,575,6972,3575855751,3575855788,37
2,575,6973,3575855751,3575855791,40
2,575,6974,3575855751,3575855791,40
2,575,6975,3575855751,3575855794,43
2,575,6976,3575855751,3575855794,43
2,575,6977,3575855751,3575855798,47
2,575,6978,3575855751,3575855798,47
2,576,6979,3575855805,3575855805,0
2,576,6980,3575855805,3575855805,0
2,576,6981,3575855805,3575855805,0
2,576,6982,3575855805,3575855809,4
2,576,6983,3575855805,3575855810,5
2,576,6984,3575855805,3575855811,6
2,576,6985,3575855805,3575855814,9
2,576,6986,3575855805,3575855815,10
2,576,6987,3575855805,3575855818,13
2,576,6988,3575855805,3575855819,14
2,576,6989,3575855805,3575855823,18
2,576,6990,3575855805,3575855824,19
2,576,6991,3575855805,3575855826,21
2,576,6992,3575855805,3575855827,22
2,576,6993,3575855805,3575855828,23
2,576,6994,3575855805,3575855830,25
2,576,6995,3575855805,3575855835,30
2,576,6996,3575855805,3575855835,30
2,576,6997,3575855805,3575855836,31
2,576,6998,3575855805,3575855837,32
2,576,6999,3575855805,3575855838,33
2,576,7000,3575855805,3575855839,34
2,576,7001,3575855805,3575855844,39
2,576,7002,3575855805,3575855845,40
2,576,7003,3575855805,3575855845,40
2,576,7004,3575855805,3575855849,44
2,576,7005,3575855805,3575855850,45
2,576,7006,3575855805,3575855852,47
2,576,7007,3575855805,3575855854,49
2,577,7008,3575855860,3575855860,0
2,577,7009,3575855860,3575855860,0
2,577,7010,3575855860,3575855862,2
2,577,7011,3575855860,3575855866,6
2,577,7012,3575855860,3575855867,7
2,577,7013,3575855860,3575855867,7
2,577,7014,3575855860,3575855868,8
2,577,7015,3575855860,3575855872,12
2,577,7016,3575855860,3575855874,14
2,577,7017,3575855860,3575855876,16
2,577,7018,3575855860,3575855879,19
2,577,7019,3575855860,3575855879,19
2,577,7020,3575855860,3575855880,20
2,577,7021,3575855860,3575855880,20
2,577,7022,3575855860,3575855881,21
2,577,7023,3575855860,3575855882,22
2,577,7024,3575855860,3575855883,23
2,577,7025,3575855860,3575855885,25
2,577,7026,3575855860,3575855885,25
2,577,7027,3575855860,3575855888,28
2,577,7028,3575855860,3575855890,30
2,577,7029,3575855860,3575855891,31
2,577,7030,3575855860,3575855893,33
2,577,7031,3575855860,3575855894,34
2,577,7032,3575855860,3575855896,36
2,577,7033,3575855860,3575855900,40
2,577,7034,3575855860,3575855900,40
2,577,7035,3575855860,3575855900,40
2,577,7036,3575855860,3575855901,41
2,577,7037,3575855860,3575855903,43
2,577,7038,3575855860,3575855903,43
2,577,7039,3575855860,3575855903,43
2,577,7040,3575855860,3575855906,46
2,577,7041,3575855860,3575855908,48
2,577,7042,3575855860,3575855910,50
2,578,7043,3575855915,3575855915,0
2,578,7044,3575855915,3575855915,0
2,578,7045,3575855915,3575855915,0
2,578,7046,3575855915,3575855915,0
2,578,7047,3575855915,3575855915,0
2,578,7048,3575855915,3575855915,0
2,578,7049,3575855915,3575855915,0
2,578,7050,3575855915,3575855916,1
2,578,7051,3575855915,3575855916,1
2,578,7052,3575855915,3575855919,4
2,578,7053,3575855915,3575855921,6
2,578,7054,3575855915,3575855922,7
2,578,7055,3575855915,3575855923,8
2,578,7056,3575855915,3575855927,12
2,578,7057,3575855915,3575855927,12
2,578,7058,3575855915,3575855927,12
2,578,7059,3575855915,3575855930,15
2,578,7060,3575855915,3575855931,16
2,578,7061,3575855915,3575855934,19
2,578,7062,3575855915,3575855935,20
2,578,7063,3575855915,3575855935,20
2,578,7064,3575855915,3575855939,24
2,578,7065,3575855915,3575855944,29
2,578,7066,3575855915,3575855945,30
2,578,7067,3575855915,3575855945,30
2,578,7068,3575855915,3575855945,30
2,578,7069,3575855915,3575855946,31
2,578,7070,3575855915,3575855948,33
2,578,7071,3575855915,3575855950,35
2,578,7072,3575855915,3575855952,37
2,578,7073,3575855915,3575855952,37
2,578,7074,3575855915,3575855957,42
2,578,7075,3575855915,3575855959,44
2,578,7076,3575855915,3575855960,45
2,578,7077,3575855915,3575855963,48
2,578,7078,3575855915,3575855964,49
2,579,7079,3575855970,3575855970,0
2,579,7080,3575855970,3575855970,0
2,579,7081,3575855970,3575855970,0
2,579,7082,3575855970,3575855972,2
2,579,7083,3575855970,3575855976,6
2,579,7084,3575855970,3575855978,8
2,579,7085,3575855970,3575855978,8
2,579,7086,3575855970,3575855981,11
2,579,7087,3575855970,3575855983,13
2,579,7088,3575855970,3575855984,14
2,579,7089,3575855970,3575855985,15
2,579,7090,3575855970,3575855985,15
2,579,7091,3575855970,3575855987,17
2,579,7092,3575855970,3575855988,18
2,579,7093,3575855970,3575855989,19
2,579,7094,3575855970,3575855990,20
2,579,7095,3575855970,3575855991,21
2,579,7096,3575855970,3575855994,24
2,579,7097,3575855970,3575855995,25
2,579,7098,3575855970,3575855998,28
2,579,7099,3575855970,3575855998,28
2,579,7100,3575855970,3575856003,33
2,579,7101,3575855970,3575856003,33
2,579,7102,3575855970,3575856005,35
2,579,7103,3575855970,3575856010,40
2,579,7104,3575855970,3575856010,40
2,579,7105,3575855970,3575856011,41
2,579,7106,3575855970,3575856014,44
2,579,7107,3575855970,3575856014,44
2,579,7108,3575855970,3575856017,47
2,579,7109,3575855970,3575856019,49
2,580,7110,3575856025,3575856025,0
2,580,7111,3575856025,3575856025,0
2,580,7112,3575856025,3575856025,0
2,580,7113,3575856025,3575856026,1
2,580,7114,3575856025,3575856028,3
2,580,7115,3575856025,3575856028,3
2,580,7116,3575856025,3575856030,5
2,580,7117,3575856025,3575856035,10
2,580,7118,3575856025,3575856035,10
2,580,7119,3575856025,3575856037,12
2,580,7120,3575856025,3575856037,12
2,580,7121,3575856025,3575856037,12
2,580,7122,3575856025,3575856039,14
2,580,7123,3575856025,3575856043,18
2,580,7124,3575856025,3575856045,20
2,580,7125,3575856025,3575856045,20
2,580,7126,3575856025,3575856045,20
2,580,7127,3575856025,3575856049,24
2,580,7128,3575856025,3575856050,25
2,580,7129,3575856025,3575856052,27
2,580,7130,3575856025,3575856055,30
2,580,7131,3575856025,3575856058,33
2,580,7132,3575856025,3575856059,34
2,580,7133,3575856025,3575856059,34
2,580,7134,3575856025,3575856061,36
2,580,7135,3575856025,3575856066,41
2,580,7136,3575856025,3575856067,42
2,580,7137,3575856025,3575856067,42
2,580,7138,3575856025,3575856069,44
2,580,7139,3575856025,3575856072,47
2,580,7140,3575856025,3575856074,49
2,581,7141,3575856080,3575856080,0
2,581,7142,3575856080,3575856080,0
2,581,7143,3575856080,3575856080,0
2,581,7144,3575856080,3575856080,0
2,581,7145,3575856080,3575856080,0
2,581,7146,3575856080,3575856081,1
2,581,7147,3575856080,3575856084,4
2,581,7148,3575856080,3575856085,5
2,581,7149,3575856080,3575856085,5
2,581,7150,3575856080,3575856089,9
2,581,7151,3575856080,3575856089,9
2,581,7152,3575856080,3575856090,10
2,581,7153,3575856080,3575856093,13
2,581,7154,3575856080,3575856094,14
2,581,7155,3575856080,3575856096,16
2,581,7156,3575856080,3575856100,20
2,581,7157,3575856080,3575856100,20
2,581,7158,3575856080,3575856101,21
2,581,7159,3575856080,3575856102,22
2,581,7160,3575856080,3575856103,23
2,581,7161,3575856080,3575856103,23
2,581,7162,3575856080,3575856103,23
2,581,7163,3575856080,3575856106,26
2,581,7164,3575856080,3575856108,28
2,581,7165,3575856080,3575856110,30
2,581,7166,3575856080,3575856111,31
2,581,7167,3575856080,3575856111,31
2,581,7168,3575856080,3575856113,33
2,581,7169,3575856080,3575856114,34
2,581,7170,3575856080,3575856114,34
2,581,7171,3575856080,3575856114,34
2,581,7172,3575856080,3575856115,35
2,581,7173,3575856080,3575856116,36
2,581,7174,3575856080,3575856116,36
2,581,7175,3575856080,3575856120,40
2,581,7176,3575856080,3575856121,41
2,581,7177,3575856080,3575856123,43
2,581,7178,3575856080,3575856124,44
2,581,7179,3575856080,3575856127,47
2,581,7180,3575856080,3575856127,47
2,582,7181,3575856134,3575856134,0
2,582,7182,3575856134,3575856134,0
2,582,7183,3575856134,3575856134,0
2,582,7184,3575856134,3575856135,1
2,582,7185,3575856134,3575856136,2
2,582,7186,3575856134,3575856139,5
2,582,7187,3575856134,3575856144,10
2,582,7188,3575856134,3575856145,11
2,582,7189,3575856134,3575856146,12
2,582,7190,3575856134,3575856146,12
2,582,7191,3575856134,3575856148,14
2,582,7192,3575856134,3575856148,14
2,582,7193,3575856134,3575856151,17
2,582,7194,3575856134,3575856151,17
2,582,7195,3575856134,3575856152,18
2,582,7196,3575856134,3575856158,24
2,582,7197,3575856134,3575856158,24
2,582,7198,3575856134,3575856161,27
2,582,7199,3575856134,3575856163,29
2,582,7200,3575856134,3575856163,29
2,582,7201,3575856134,3575856166,32
2,582,7202,3575856134,3575856167,33
2,582,7203,3575856134,3575856168,34
2,582,7204,3575856134,3575856170,36
2,582,7205,3575856134,3575856172,38
2,582,7206,3575856134,3575856177,43
2,582,7207,3575856134,3575856178,44
2,582,7208,3575856134,3575856179,45
2,582,7209,3575856134,3575856181,47
2,582,7210,3575856134,3575856183,49
2,583,7211,3575856188,3575856188,0
2,583,7212,3575856188,3575856188,0
2,583,7213,3575856188,3575856188,0
2,583,7214,3575856188,3575856188,0
2,583,7215,3575856188,3575856188,0
2,583,7216,3575856188,3575856188,0
2,583,7217,3575856188,3575856191,3
2,583,7218,3575856188,3575856191,3
2,583,7219,3575856188,3575856195,7
2,583,7220,3575856188,3575856195,7
2,583,7221,3575856188,3575856199,11
2,583,7222,3575856188,3575856199,11
2,583,7223,3575856188,3575856203,15
2,583,7224,3575856188,3575856205,17
2,583,7225,3575856188,3575856213,25
2,583,7226,3575856188,3575856214,26
2,583,7227,3575856188,3575856214,26
2,583,7228,3575856188,3575856218,30
2,583,7229,3575856188,3575856220,32
2,583,7230,3575856188,3575856222,34
2,583,7231,3575856188,3575856224,36
2,583,7232,3575856188,3575856225,37
2,583,7233,3575856188,3575856226,38
2,583,7234,3575856188,3575856228,40
2,583,7235,3575856188,3575856228,40
2,583,7236,3575856188,3575856231,43
2,583,7237,3575856188,3575856235,47
2,583,7238,3575856188,3575856236,48
2,583,7239,3575856188,3575856236,48
2,583,7240,3575856188,3575856237,49
2,583,7241,3575856188,3575856238,50
2,584,7242,3575856243,3575856243,0
2,584,7243,3575856243,3575856243,0
2,584,7244,3575856243,3575856243,0
2,584,7245,3575856243,3575856245,2
2,584,7246,3575856243,3575856245,2
2,584,7247,3575856243,3575856245,2
2,584,7248,3575856243,3575856248,5
2,584,7249,3575856243,3575856249,6
2,584,7250,3575856243,3575856250,7
2,584,7251,3575856243,3575856252,9
2,584,7252,3575856243,3575856255,12
2,584,7253,3575856243,3575856258,15
2,584,7254,3575856243,3575856259,16
2,584,7255,3575856243,3575856260,17
2,584,7256,3575856243,3575856262,19
2,584,7257,3575856243,3575856266,23
2,584,7258,3575856243,3575856267,24
2,584,7259,3575856243,3575856268,25
2,584,7260,3575856243,3575856269,26
2,584,7261,3575856243,3575856272,29
2,584,7262,3575856243,3575856274,31
2,584,7263,3575856243,3575856276,33
2,584,7264,3575856243,3575856279,36
2,584,7265,3575856243,3575856279,36
2,584,7266,3575856243,3575856280,37
2,584,7267,3575856243,3575856281,38
2,584,7268,3575856243,3575856282,39
2,584,7269,3575856243,3575856282,39
2,584,7270,3575856243,3575856284,41
2,584,7271,3575856243,3575856284,41
2,584,7272,3575856243,3575856285,42
2,584,7273,3575856243,3575856289,46
2,584,7274,3575856243,3575856289,46
2,584,7275,3575856243,3575856290,47
2,584,7276,3575856243,3575856291,48
2,584,7277,3575856243,3575856293,50
2,585,7278,3575856298,3575856298,0
2,585,7279,3575856298,3575856298,0
2,585,7280,3575856298,3575856300,2
2,585,7281,3575856298,3575856300,2
2,585,7282,3575856298,3575856301,3
2,585,7283,3575856298,3575856301,3
2,585,7284,3575856298,3575856303,5
2,585,7285,3575856298,3575856303,5
2,585,7286,3575856298,3575856305,7
2,585,7287,3575856298,3575856308,10
2,585,7288,3575856298,3575856310,12
2,585,7289,3575856298,3575856310,12
2,585,7290,3575856298,3575856311,13
2,585,7291,3575856298,3575856313,15
2,585,7292,3575856298,3575856314,16
2,585,7293,3575856298,3575856314,16
2,585,7294,3575856298,3575856315,17
2,585,7295,3575856298,3575856315,17
2,585,7296,3575856298,3575856317,19
2,585,7297,3575856298,3575856317,19
2,585,7298,3575856298,3575856320,22
2,585,7299,3575856298,3575856320,22
2,585,7300,3575856298,3575856323,25
2,585,7301,3575856298,3575856323,25
2,585,7302,3575856298,3575856327,29
2,585,7303,3575856298,3575856327,29
2,585,7304,3575856298,3575856331,33
2,585,7305,3575856298,3575856331,33
2,585,7306,3575856298,3575856334,36
2,585,7307,3575856298,3575856334,36
2,585,7308,3575856298,3575856335,37
2,585,7309,3575856298,3575856339,41
2,585,7310,3575856298,3575856340,42
2,585,7311,3575856298,3575856344,46
2,585,7312,3575856298,3575856345,47
2,585,7313,3575856298,3575856346,48
2,585,7314,3575856298,3575856347,49
2,586,7315,3575856352,3575856352,0
2,586,7316,3575856352,3575856352,0
2,586,7317,3575856352,3575856352,0
2,586,7318,3575856352,3575856352,0
2,586,7319,3575856352,3575856352,0
2,586,7320,3575856352,3575856358,6
2,586,7321,3575856352,3575856358,6
2,586,7322,3575856352,3575856360,8
2,586,7323,3575856352,3575856364,12
2,586,7324,3575856352,3575856364,12
2,586,7325,3575856352,3575856365,13
2,586,7326,3575856352,3575856367,15
2,586,7327,3575856352,3575856368,16
2,586,7328,3575856352,3575856370,18
2,586,7329,3575856352,3575856372,20
2,586,7330,3575856352,3575856377,25
2,586,7331,3575856352,3575856379,27
2,586,7332,3575856352,3575856380,28
2,586,7333,3575856352,3575856381,29
2,586,7334,3575856352,3575856384,32
2,586,7335,3575856352,3575856384,32
2,586,7336,3575856352,3575856385,33
2,586,7337,3575856352,3575856386,34
2,586,7338,3575856352,3575856386,34
2,586,7339,3575856352,3575856388,36
2,586,7340,3575856352,3575856388,36
2,586,7341,3575856352,3575856390,38
2,586,7342,3575856352,3575856391,39
2,586,7343,3575856352,3575856395,43
2,586,7344,3575856352,3575856395,43
2,586,7345,3575856352,3575856399,47
2,586,7346,3575856352,3575856400,48
2,587,7347,3575856407,3575856407,0
2,587,7348,3575856407,3575856407,0
2,587,7349,3575856407,3575856410,3
2,587,7350,3575856407,3575856414,7
2,587,7351,3575856407,3575856414,7
2,587,7352,3575856407,3575856418,11
2,587,7353,3575856407,3575856420,13
2,587,7354,3575856407,3575856423,16
2,587,7355,3575856407,3575856424,17
2,587,7356,3575856407,3575856426,19
2,587,7357,3575856407,3575856426,19
2,587,7358,3575856407,3575856428,21
2,587,7359,3575856407,3575856428,21
2,587,7360,3575856407,3575856430,23
2,587,7361,3575856407,3575856435,28
2,587,7362,3575856407,3575856435,28
2,587,7363,3575856407,3575856437,30
2,587,7364,3575856407,3575856437,30
2,587,7365,3575856407,3575856438,31
2,587,7366,3575856407,3575856440,33
2,587,7367,3575856407,3575856443,36
2,587,7368,3575856407,3575856443,36
2,587,7369,3575856407,3575856445,38
2,587,7370,3575856407,3575856445,38
2,587,7371,3575856407,3575856445,38
2,587,7372,3575856407,3575856449,42
2,587,7373,3575856407,3575856450,43
2,587,7374,3575856407,3575856451,44
2,587,7375,3575856407,3575856451,44
2,587,7376,3575856407,3575856455,48
2,588,7377,3575856461,3575856461,0
2,588,7378,3575856461,3575856461,0
2,588,7379,3575856461,3575856461,0
2,588,7380,3575856461,3575856461,0
2,588,7381,3575856461,3575856467,6
2,588,7382,3575856461,3575856468,7
2,588,7383,3575856461,3575856468,7
2,588,7384,3575856461,3575856469,8
2,588,7385,3575856461,3575856472,11
2,588,7386,3575856461,3575856474,13
2,588,7387,3575856461,3575856476,15
2,588,7388,3575856461,3575856478,17
2,588,7389,3575856461,3575856479,18
2,588,7390,3575856461,3575856481,20
2,588,7391,3575856461,3575856482,21
2,588,7392,3575856461,3575856482,21
2,588,7393,3575856461,3575856489,28
2,588,7394,3575856461,3575856489,28
2,588,7395,3575856461,3575856489,28
2,588,7396,3575856461,3575856489,28
2,588,7397,3575856461,3575856490,29
2,588,7398,3575856461,3575856492,31
2,588,7399,3575856461,3575856492,31
2,588,7400,3575856461,3575856493,32
2,588,7401,3575856461,3575856493,32
2,588,7402,3575856461,3575856496,35
2,588,7403,3575856461,3575856500,39
2,588,7404,3575856461,3575856501,40
2,588,7405,3575856461,3575856501,40
2,588,7406,3575856461,3575856503,42
2,588,7407,3575856461,3575856504,43
2,588,7408,3575856461,3575856504,43
2,588,7409,3575856461,3575856508,47
2,588,7410,3575856461,3575856510,49
2,589,7411,3575856515,3575856515,0
2,589,7412,3575856515,3575856515,0
2,589,7413,3575856515,3575856515,0
2,589,7414,3575856515,3575856515,0
2,589,7415,3575856515,3575856515,0
2,589,7416,3575856515,3575856515,0
2,589,7417,3575856515,3575856515,0
2,589,7418,3575856515,3575856516,1
2,589,7419,3575856515,3575856517,2
2,589,7420,3575856515,3575856519,4
2,589,7421,3575856515,3575856520,5
2,589,7422,3575856515,3575856522,7
2,589,7423,3575856515,3575856524,9
2,589,7424,3575856515,3575856526,11
2,589,7425,3575856515,3575856531,16
2,589,7426,3575856515,3575856534,19
2,589,7427,3575856515,3575856534,19
2,589,7428,3575856515,3575856535,20
2,589,7429,3575856515,3575856538,23
2,589,7430,3575856515,3575856539,24
2,589,7431,3575856515,3575856543,28
2,589,7432,3575856515,3575856543,28
2,589,7433,3575856515,3575856545,30
2,589,7434,3575856515,3575856545,30
2,589,7435,3575856515,3575856546,31
2,589,7436,3575856515,3575856547,32
2,589,7437,3575856515,3575856548,33
2,589,7438,3575856515,3575856549,34
2,589,7439,3575856515,3575856550,35
2,589,7440,3575856515,3575856551,36
2,589,7441,3575856515,3575856557,42
2,589,7442,3575856515,3575856558,43
2,589,7443,3575856515,3575856559,44
2,589,7444,3575856515,3575856563,48
2,589,7445,3575856515,3575856563,48
2,589,7446,3575856515,3575856565,50
2,590,7447,3575856569,3575856569,0
2,590,7448,3575856569,3575856569,0
2,590,7449,3575856569,3575856569,0
2,590,7450,3575856569,3575856570,1
2,590,7451,3575856569,3575856575,6
2,590,7452,3575856569,3575856577,8
2,590,7453,3575856569,3575856579,10
2,590,7454,3575856569,3575856580,11
2,590,7455,3575856569,3575856582,13
2,590,7456,3575856569,3575856583,14
2,590,7457,3575856569,3575856584,15
2,590,7458,3575856569,3575856585,16
2,590,7459,3575856569,3575856586,17
2,590,7460,3575856569,3575856588,19
2,590,7461,3575856569,3575856589,20
2,590,7462,3575856569,3575856589,20
2,590,7463,3575856569,3575856589,20
2,590,7464,3575856569,3575856594,25
2,590,7465,3575856569,3575856595,26
2,590,7466,3575856569,3575856598,29
2,590,7467,3575856569,3575856598,29
2,590,7468,3575856569,3575856603,34
2,590,7469,3575856569,3575856604,35
2,590,7470,3575856569,3575856605,36
2,590,7471,3575856569,3575856610,41
2,590,7472,3575856569,3575856613,44
2,590,7473,3575856569,3575856614,45
2,590,7474,3575856569,3575856617,48
2,590,7475,3575856569,3575856619,50
2,591,7476,3575856624,3575856624,0
2,591,7477,3575856624,3575856624,0
2,591,7478,3575856624,3575856625,1
2,591,7479,3575856624,3575856626,2
2,591,7480,3575856624,3575856627,3
2,591,7481,3575856624,3575856627,3
2,591,7482,3575856624,3575856629,5
2,591,7483,3575856624,3575856634,10
2,591,7484,3575856624,3575856634,10
2,591,7485,3575856624,3575856636,12
2,591,7486,3575856624,3575856637,13
2,591,7487,3575856624,3575856638,14
2,591,7488,3575856624,3575856639,15
2,591,7489,3575856624,3575856642,18
2,591,7490,3575856624,3575856643,19
2,591,7491,3575856624,3575856644,20
2,591,7492,3575856624,3575856644,20
2,591,7493,3575856624,3575856644,20
2,591,7494,3575856624,3575856648,24
2,591,7495,3575856624,3575856649,25
2,591,7496,3575856624,3575856650,26
2,591,7497,3575856624,3575856651,27
2,591,7498,3575856624,3575856655,31
2,591,7499,3575856624,3575856658,34
2,591,7500,3575856624,3575856659,35
2,591,7501,3575856624,3575856660,36
2,591,7502,3575856624,3575856660,36
2,591,7503,3575856624,3575856666,42
2,591,7504,3575856624,3575856666,42
2,591,7505,3575856624,3575856667,43
2,591,7506,3575856624,3575856667,43
2,591,7507,3575856624,3575856673,49
2,592,7508,3575856679,3575856679,0
2,592,7509,3575856679,3575856679,0
2,592,7510,3575856679,3575856679,0
2,592,7511,3575856679,3575856680,1
2,592,7512,3575856679,3575856681,2
2,592,7513,3575856679,3575856681,2
2,592,7514,3575856679,3575856683,4
2,592,7515,3575856679,3575856687,8
2,592,7516,3575856679,3575856687,8
2,592,7517,3575856679,3575856688,9
2,592,7518,3575856679,3575856690,11
2,592,7519,3575856679,3575856692,13
2,592,7520,3575856679,3575856692,13
2,592,7521,3575856679,3575856693,14
2,592,7522,3575856679,3575856694,15
2,592,7523,3575856679,3575856696,17
2,592,7524,3575856679,3575856700,21
2,592,7525,3575856679,3575856700,21
2,592,7526,3575856679,3575856701,22
2,592,7527,3575856679,3575856701,22
2,592,7528,3575856679,3575856704,25
2,592,7529,3575856679,3575856704,25
2,592,7530,3575856679,3575856704,25
2,592,7531,3575856679,3575856706,27
2,592,7532,3575856679,3575856708,29
2,592,7533,3575856679,3575856711,32
2,592,7534,3575856679,3575856713,34
2,592,7535,3575856679,3575856713,34
2,592,7536,3575856679,3575856714,35
2,592,7537,3575856679,3575856714,35
2,592,7538,3575856679,3575856714,35
2,592,7539,3575856679,3575856714,35
2,592,7540,3575856679,3575856715,36
2,592,7541,3575856679,3575856716,37
2,592,7542,3575856679,3575856716,37
2,592,7543,3575856679,3575856720,41
2,592,7544,3575856679,3575856720,41
2,592,7545,3575856679,3575856722,43
2,592,7546,3575856679,3575856724,45
2,592,7547,3575856679,3575856728,49
2,593,7548,3575856733,3575856733,0
2,593,7549,3575856733,3575856734,1
2,593,7550,3575856733,3575856734,1
2,593,7551,3575856733,3575856735,2
2,593,7552,3575856733,3575856737,4
2,593,7553,3575856733,3575856739,6
2,593,7554,3575856733,3575856743,10
2,593,7555,3575856733,3575856743,10
2,593,7556,3575856733,3575856745,12
2,593,7557,3575856733,3575856745,12
2,593,7558,3575856733,3575856745,12
2,593,7559,3575856733,3575856747,14
2,593,7560,3575856733,3575856749,16
2,593,7561,3575856733,3575856749,16
2,593,7562,3575856733,3575856751,18
2,593,7563,3575856733,3575856751,18
2,593,7564,3575856733,3575856751,18
2,593,7565,3575856733,3575856753,20
2,593,7566,3575856733,3575856758,25
2,593,7567,3575856733,3575856758,25
2,593,7568,3575856733,3575856760,27
2,593,7569,3575856733,3575856763,30
2,593,7570,3575856733,3575856764,31
2,593,7571,3575856733,3575856765,32
2,593,7572,3575856733,3575856767,34
2,593,7573,3575856733,3575856767,34
2,593,7574,3575856733,3575856769,36
2,593,7575,3575856733,3575856769,36
2,593,7576,3575856733,3575856772,39
2,593,7577,3575856733,3575856776,43
2,593,7578,3575856733,3575856777,44
2,593,7579,3575856733,3575856779,46
2,593,7580,3575856733,3575856780,47
2,593,7581,3575856733,3575856782,49
2,594,7582,3575856788,3575856788,0
2,594,7583,3575856788,3575856788,0
2,594,7584,3575856788,3575856788,0
2,594,7585,3575856788,3575856788,0
2,594,7586,3575856788,3575856788,0
2,594,7587,3575856788,3575856788,0
2,594,7588,3575856788,3575856790,2
2,594,7589,3575856788,3575856791,3
2,594,7590,3575856788,3575856794,6
2,594,7591,3575856788,3575856795,7
2,594,7592,3575856788,3575856798,10
2,594,7593,3575856788,3575856799,11
2,594,7594,3575856788,3575856802,14
2,594,7595,3575856788,3575856804,16
2,594,7596,3575856788,3575856804,16
2,594,7597,3575856788,3575856809,21
2,594,7598,3575856788,3575856809,21
2,594,7599,3575856788,3575856813,25
2,594,7600,3575856788,3575856814,26
2,594,7601,3575856788,3575856818,30
2,594,7602,3575856788,3575856819,31
2,594,7603,3575856788,3575856824,36
2,594,7604,3575856788,3575856825,37
2,594,7605,3575856788,3575856826,38
2,594,7606,3575856788,3575856826,38
2,594,7607,3575856788,3575856828,40
2,594,7608,3575856788,3575856829,41
2,594,7609,3575856788,3575856834,46
2,594,7610,3575856788,3575856836,48
2,594,7611,3575856788,3575856836,48
2,594,7612,3575856788,3575856837,49
2,594,7613,3575856788,3575856838,50
2,595,7614,3575856842,3575856842,0
2,595,7615,3575856842,3575856842,0
2,595,7616,3575856842,3575856842,0
2,595,7617,3575856842,3575856844,2
2,595,7618,3575856842,3575856844,2
2,595,7619,3575856842,3575856845,3
2,595,7620,3575856842,3575856848,6
2,595,7621,3575856842,3575856849,7
2,595,7622,3575856842,3575856851,9
2,595,7623,3575856842,3575856855,13
2,595,7624,3575856842,3575856858,16
2,595,7625,3575856842,3575856860,18
2,595,7626,3575856842,3575856860,18
2,595,7627,3575856842,3575856861,19
2,595,7628,3575856842,3575856866,24
2,595,7629,3575856842,3575856866,24
2,595,7630,3575856842,3575856867,25
2,595,7631,3575856842,3575856867,25
2,595,7632,3575856842,3575856873,31
2,595,7633,3575856842,3575856876,34
2,595,7634,3575856842,3575856879,37
2,595,7635,3575856842,3575856880,38
2,595,7636,3575856842,3575856881,39
2,595,7637,3575856842,3575856881,39
2,595,7638,3575856842,3575856882,40
2,595,7639,3575856842,3575856887,45
2,595,7640,3575856842,3575856888,46
2,595,7641,3575856842,3575856888,46
2,595,7642,3575856842,3575856889,47
2,595,7643,3575856842,3575856891,49
2,596,7644,3575856896,3575856896,0
2,596,7645,3575856896,3575856896,0
2,596,7646,3575856896,3575856896,0
2,596,7647,3575856896,3575856896,0
2,596,7648,3575856896,3575856897,1
2,596,7649,3575856896,3575856900,4
2,596,7650,3575856896,3575856900,4
2,596,7651,3575856896,3575856901,5
2,596,7652,3575856896,3575856901,5
2,596,7653,3575856896,3575856903,7
2,596,7654,3575856896,3575856904,8
2,596,7655,3575856896,3575856904,8
2,596,7656,3575856896,3575856906,10
2,596,7657,3575856896,3575856908,12
2,596,7658,3575856896,3575856910,14
2,596,7659,3575856896,3575856912,16
2,596,7660,3575856896,3575856913,17
2,596,7661,3575856896,3575856913,17
2,596,7662,3575856896,3575856914,18
2,596,7663,3575856896,3575856914,18
2,596,7664,3575856896,3575856915,19
2,596,7665,3575856896,3575856915,19
2,596,7666,3575856896,3575856916,20
2,596,7667,3575856896,3575856916,20
2,596,7668,3575856896,3575856920,24
2,596,7669,3575856896,3575856921,25
2,596,7670,3575856896,3575856923,27
2,596,7671,3575856896,3575856923,27
2,596,7672,3575856896,3575856928,32
2,596,7673,3575856896,3575856931,35
2,596,7674,3575856896,3575856933,37
2,596,7675,3575856896,3575856933,37
2,596,7676,3575856896,3575856934,38
2,596,7677,3575856896,3575856935,39
2,596,7678,3575856896,3575856938,42
2,596,7679,3575856896,3575856940,44
2,596,7680,3575856896,3575856944,48
2,596,7681,3575856896,3575856944,48
2,596,7682,3575856896,3575856945,49
2,597,7683,3575856950,3575856950,0
2,597,7684,3575856950,3575856950,0
2,597,7685,3575856950,3575856950,0
2,597,7686,3575856950,3575856950,0
2,597,7687,3575856950,3575856951,1
2,597,7688,3575856950,3575856952,2
2,597,7689,3575856950,3575856952,2
2,597,7690,3575856950,3575856954,4
2,597,7691,3575856950,3575856958,8
2,597,7692,3575856950,3575856958,8
2,597,7693,3575856950,3575856960,10
2,597,7694,3575856950,3575856963,13
2,597,7695,3575856950,3575856963,13
2,597,7696,3575856950,3575856965,15
2,597,7697,3575856950,3575856967,17
2,597,7698,3575856950,3575856968,18
2,597,7699,3575856950,3575856970,20
2,597,7700,3575856950,3575856970,20
2,597,7701,3575856950,3575856972,22
2,597,7702,3575856950,3575856977,27
2,597,7703,3575856950,3575856978,28
2,597,7704,3575856950,3575856979,29
2,597,7705,3575856950,3575856981,31
2,597,7706,3575856950,3575856982,32
2,597,7707,3575856950,3575856985,35
2,597,7708,3575856950,3575856985,35
2,597,7709,3575856950,3575856985,35
2,597,7710,3575856950,3575856986,36
2,597,7711,3575856950,3575856987,37
2,597,7712,3575856950,3575856988,38
2,597,7713,3575856950,3575856991,41
2,597,7714,3575856950,3575856991,41
2,597,7715,3575856950,3575856995,45
2,597,7716,3575856950,3575856995,45
2,597,7717,3575856950,3575856998,48
2,597,7718,3575856950,3575856999,49
2,598,7719,3575857004,3575857004,0
2,598,7720,3575857004,3575857004,0
2,598,7721,3575857004,3575857005,1
2,598,7722,3575857004,3575857009,5
2,598,7723,3575857004,3575857010,6
2,598,7724,3575857004,3575857011,7
2,598,7725,3575857004,3575857011,7
2,598,7726,3575857004,3575857013,9
2,598,7727,3575857004,3575857013,9
2,598,7728,3575857004,3575857014,10
2,598,7729,3575857004,3575857018,14
2,598,7730,3575857004,3575857019,15
2,598,7731,3575857004,3575857024,20
2,598,7732,3575857004,3575857026,22
2,598,7733,3575857004,3575857027,23
2,598,7734,3575857004,3575857029,25
2,598,7735,3575857004,3575857030,26
2,598,7736,3575857004,3575857035,31
2,598,7737,3575857004,3575857036,32
2,598,7738,3575857004,3575857036,32
2,598,7739,3575857004,3575857036,32
2,598,7740,3575857004,3575857038,34
2,598,7741,3575857004,3575857039,35
2,598,7742,3575857004,3575857042,38
2,598,7743,3575857004,3575857044,40
2,598,7744,3575857004,3575857045,41
2,598,7745,3575857004,3575857045,41
2,598,7746,3575857004,3575857049,45
2,598,7747,3575857004,3575857049,45
2,598,7748,3575857004,3575857052,48
2,599,7749,3575857058,3575857058,0
2,599,7750,3575857058,3575857058,0
2,599,7751,3575857058,3575857060,2
2,599,7752,3575857058,3575857060,2
2,599,7753,3575857058,3575857061,3
2,599,7754,3575857058,3575857066,8
2,599,7755,3575857058,3575857067,9
2,599,7756,3575857058,3575857067,9
2,599,7757,3575857058,3575857068,10
2,599,7758,3575857058,3575857073,15
2,599,7759,3575857058,3575857076,18
2,599,7760,3575857058,3575857078,20
2,599,7761,3575857058,3575857079,21
2,599,7762,3575857058,3575857079,21
2,599,7763,3575857058,3575857081,23
2,599,7764,3575857058,3575857081,23
2,599,7765,3575857058,3575857082,24
2,599,7766,3575857058,3575857088,30
2,599,7767,3575857058,3575857088,30
2,599,7768,3575857058,3575857088,30
2,599,7769,3575857058,3575857088,30
2,599,7770,3575857058,3575857090,32
2,599,7771,3575857058,3575857092,34
2,599,7772,3575857058,3575857092,34
2,599,7773,3575857058,3575857093,35
2,599,7774,3575857058,3575857094,36
2,599,7775,3575857058,3575857096,38
2,599,7776,3575857058,3575857100,42
2,599,7777,3575857058,3575857100,42
2,599,7778,3575857058,3575857102,44
2,599,7779,3575857058,3575857102,44
2,599,7780,3575857058,3575857103,45
2,599,7781,3575857058,3575857104,46
2,599,7782,3575857058,3575857105,47
2,599,7783,3575857058,3575857105,47
2,599,7784,3575857058,3575857108,50
2,600,7785,3575857112,3575857112,0
2,600,7786,3575857112,3575857113,1
2,600,7787,3575857112,3575857113,1
2,600,7788,3575857112,3575857114,2
2,600,7789,3575857112,3575857114,2
2,600,7790,3575857112,3575857114,2
2,600,7791,3575857112,3575857115,3
2,600,7792,3575857112,3575857116,4
2,600,7793,3575857112,3575857116,4
2,600,7794,3575857112,3575857116,4
2,600,7795,3575857112,3575857119,7
2,600,7796,3575857112,3575857120,8
2,600,7797,3575857112,3575857123,11
2,600,7798,3575857112,3575857123,11
2,600,7799,3575857112,3575857128,16
2,600,7800,3575857112,3575857132,20
2,600,7801,3575857112,3575857132,20
2,600,7802,3575857112,3575857134,22
2,600,7803,3575857112,3575857134,22
2,600,7804,3575857112,3575857135,23
2,600,7805,3575857112,3575857138,26
2,600,7806,3575857112,3575857144,32
2,600,7807,3575857112,3575857145,33
2,600,7808,3575857112,3575857145,33
2,600,7809,3575857112,3575857146,34
2,600,7810,3575857112,3575857147,35
2,600,7811,3575857112,3575857149,37
2,600,7812,3575857112,3575857151,39
2,600,7813,3575857112,3575857151,39
2,600,7814,3575857112,3575857152,40
2,600,7815,3575857112,3575857153,41
2,600,7816,3575857112,3575857153,41
2,600,7817,3575857112,3575857158,46
2,600,7818,3575857112,3575857159,47
2,600,7819,3575857112,3575857161,49
2,601,7820,3575857168,3575857168,0
2,601,7821,3575857168,3575857168,0
2,601,7822,3575857168,3575857168,0
2,601,7823,3575857168,3575857168,0
2,601,7824,3575857168,3575857168,0
2,601,7825,3575857168,3575857169,1
2,601,7826,3575857168,3575857170,2
2,601,7827,3575857168,3575857172,4
2,601,7828,3575857168,3575857177,9
2,601,7829,3575857168,3575857179,11
2,601,7830,3575857168,3575857179,11
2,601,7831,3575857168,3575857181,13
2,601,7832,3575857168,3575857184,16
2,601,7833,3575857168,3575857185,17
2,601,7834,3575857168,3575857186,18
2,601,7835,3575857168,3575857186,18
2,601,7836,3575857168,3575857186,18
2,601,7837,3575857168,3575857187,19
2,601,7838,3575857168,3575857188,20
2,601,7839,3575857168,3575857190,22
2,601,7840,3575857168,3575857191,23
2,601,7841,3575857168,3575857194,26
2,601,7842,3575857168,3575857196,28
2,601,7843,3575857168,3575857199,31
2,601,7844,3575857168,3575857200,32
2,601,7845,3575857168,3575857202,34
2,601,7846,3575857168,3575857204,36
2,601,7847,3575857168,3575857205,37
2,601,7848,3575857168,3575857209,41
2,601,7849,3575857168,3575857210,42
2,601,7850,3575857168,3575857211,43
2,601,7851,3575857168,3575857211,43
2,601,7852,3575857168,3575857212,44
2,601,7853,3575857168,3575857214,46
2,601,7854,3575857168,3575857214,46
2,601,7855,3575857168,3575857217,49
2,602,7856,3575857223,3575857223,0
2,602,7857,3575857223,3575857224,1
2,602,7858,3575857223,3575857224,1
2,602,7859,3575857223,3575857226,3
2,602,7860,3575857223,3575857227,4
2,602,7861,3575857223,3575857230,7
2,602,7862,3575857223,3575857235,12
2,602,7863,3575857223,3575857236,13
2,602,7864,3575857223,3575857236,13
2,602,7865,3575857223,3575857237,14
2,602,7866,3575857223,3575857239,16
2,602,7867,3575857223,3575857239,16
2,602,7868,3575857223,3575857241,18
2,602,7869,3575857223,3575857242,19
2,602,7870,3575857223,3575857244,21
2,602,7871,3575857223,3575857245,22
2,602,7872,3575857223,3575857245,22
2,602,7873,3575857223,3575857248,25
2,602,7874,3575857223,3575857249,26
2,602,7875,3575857223,3575857251,28
2,602,7876,3575857223,3575857252,29
2,602,7877,3575857223,3575857255,32
2,602,7878,3575857223,3575857257,34
2,602,7879,3575857223,3575857260,37
2,602,7880,3575857223,3575857260,37
2,602,7881,3575857223,3575857261,38
2,602,7882,3575857223,3575857266,43
2,602,7883,3575857223,3575857267,44
2,602,7884,3575857223,3575857268,45
2,602,7885,3575857223,3575857269,46
2,602,7886,3575857223,3575857272,49
2,603,7887,3575857278,3575857278,0
2,603,7888,3575857278,3575857278,0
2,603,7889,3575857278,3575857278,0
2,603,7890,3575857278,3575857279,1
2,603,7891,3575857278,3575857279,1
2,603,7892,3575857278,3575857281,3
2,603,7893,3575857278,3575857281,3
2,603,7894,3575857278,3575857282,4
2,603,7895,3575857278,3575857282,4
2,603,7896,3575857278,3575857288,10
2,603,7897,3575857278,3575857288,10
2,603,7898,3575857278,3575857289,11
2,603,7899,3575857278,3575857289,11
2,603,7900,3575857278,3575857290,12
2,603,7901,3575857278,3575857291,13
2,603,7902,3575857278,3575857292,14
2,603,7903,3575857278,3575857293,15
2,603,7904,3575857278,3575857294,16
2,603,7905,3575857278,3575857296,18
2,603,7906,3575857278,3575857300,22
2,603,7907,3575857278,3575857301,23
2,603,7908,3575857278,3575857302,24
2,603,7909,3575857278,3575857302,24
2,603,7910,3575857278,3575857303,25
2,603,7911,3575857278,3575857304,26
2,603,7912,3575857278,3575857305,27
2,603,7913,3575857278,3575857306,28
2,603,7914,3575857278,3575857308,30
2,603,7915,3575857278,3575857311,33
2,603,7916,3575857278,3575857313,35
2,603,7917,3575857278,3575857313,35
2,603,7918,3575857278,3575857314,36
2,603,7919,3575857278,3575857314,36
2,603,7920,3575857278,3575857315,37
2,603,7921,3575857278,3575857315,37
2,603,7922,3575857278,3575857316,38
2,603,7923,3575857278,3575857316,38
2,603,7924,3575857278,3575857316,38
2,603,7925,3575857278,3575857320,42
2,603,7926,3575857278,3575857320,42
2,603,7927,3575857278,3575857323,45
2,603,7928,3575857278,3575857324,46
2,603,7929,3575857278,3575857327,49
2,603,7930,3575857278,3575857328,50
2,604,7931,3575857333,3575857333,0
2,604,7932,3575857333,3575857333,0
2,604,7933,3575857333,3575857334,1
2,604,7934,3575857333,3575857335,2
2,604,7935,3575857333,3575857336,3
2,604,7936,3575857333,3575857338,5
2,604,7937,3575857333,3575857340,7
2,604,7938,3575857333,3575857344,11
2,604,7939,3575857333,3575857345,12
2,604,7940,3575857333,3575857346,13
2,604,7941,3575857333,3575857347,14
2,604,7942,3575857333,3575857348,15
2,604,7943,3575857333,3575857349,16
2,604,7944,3575857333,3575857351,18
2,604,7945,3575857333,3575857352,19
2,604,7946,3575857333,3575857352,19
2,604,7947,3575857333,3575857352,19
2,604,7948,3575857333,3575857353,20
2,604,7949,3575857333,3575857358,25
2,604,7950,3575857333,3575857359,26
2,604,7951,3575857333,3575857360,27
2,604,7952,3575857333,3575857363,30
2,604,7953,3575857333,3575857364,31
2,604,7954,3575857333,3575857367,34
2,604,7955,3575857333,3575857368,35
2,604,7956,3575857333,3575857369,36
2,604,7957,3575857333,3575857370,37
2,604,7958,3575857333,3575857372,39
2,604,7959,3575857333,3575857377,44
2,604,7960,3575857333,3575857380,47
2,604,7961,3575857333,3575857380,47
2,604,7962,3575857333,3575857381,48
2,605,7963,3575857388,3575857388,0
2,605,7964,3575857388,3575857388,0
2,605,7965,3575857388,3575857388,0
2,605,7966,3575857388,3575857388,0
2,605,7967,3575857388,3575857388,0
2,605,7968,3575857388,3575857388,0
2,605,7969,3575857388,3575857388,0
2,605,7970,3575857388,3575857391,3
2,605,7971,3575857388,3575857391,3
2,605,7972,3575857388,3575857394,6
2,605,7973,3575857388,3575857396,8
2,605,7974,3575857388,3575857399,11
2,605,7975,3575857388,3575857402,14
2,605,7976,3575857388,3575857403,15
2,605,7977,3575857388,3575857404,16
2,605,7978,3575857388,3575857404,16
2,605,7979,3575857388,3575857409,21
2,605,7980,3575857388,3575857410,22
2,605,7981,3575857388,3575857411,23
2,605,7982,3575857388,3575857412,24
2,605,7983,3575857388,3575857413,25
2,605,7984,3575857388,3575857414,26
2,605,7985,3575857388,3575857414,26
2,605,7986,3575857388,3575857418,30
2,605,7987,3575857388,3575857420,32
2,605,7988,3575857388,3575857424,36
2,605,7989,3575857388,3575857425,37
2,605,7990,3575857388,3575857426,38
2,605,7991,3575857388,3575857427,39
2,605,7992,3575857388,3575857429,41
2,605,7993,3575857388,3575857436,48
2,605,7994,3575857388,3575857436,48
2,605,7995,3575857388,3575857436,48
2,605,7996,3575857388,3575857438,50
2,606,7997,3575857445,3575857445,0
2,606,7998,3575857445,3575857445,0
2,606,7999,3575857445,3575857445,0
2,606,8000,3575857445,3575857445,0
2,606,8001,3575857445,3575857445,0
2,606,8002,3575857445,3575857445,0
2,606,8003,3575857445,3575857445,0
2,606,8004,3575857445,3575857448,3
2,606,8005,3575857445,3575857450,5
2,606,8006,3575857445,3575857450,5
2,606,8007,3575857445,3575857451,6
2,606,8008,3575857445,3575857455,10
2,606,8009,3575857445,3575857458,13
2,606,8010,3575857445,3575857460,15
2,606,8011,3575857445,3575857461,16
2,606,8012,3575857445,3575857461,16
2,606,8013,3575857445,3575857467,22
2,606,8014,3575857445,3575857467,22
2,606,8015,3575857445,3575857468,23
2,606,8016,3575857445,3575857468,23
2,606,8017,3575857445,3575857473,28
2,606,8018,3575857445,3575857474,29
2,606,8019,3575857445,3575857476,31
2,606,8020,3575857445,3575857478,33
2,606,8021,3575857445,3575857479,34
2,606,8022,3575857445,3575857480,35
2,606,8023,3575857445,3575857481,36
2,606,8024,3575857445,3575857481,36
2,606,8025,3575857445,3575857481,36
2,606,8026,3575857445,3575857482,37
2,606,8027,3575857445,3575857488,43
2,606,8028,3575857445,3575857488,43
2,606,8029,3575857445,3575857489,44
2,606,8030,3575857445,3575857489,44
2,606,8031,3575857445,3575857490,45
2,606,8032,3575857445,3575857491,46
2,606,8033,3575857445,3575857492,47
2,606,8034,3575857445,3575857493,48
2,606,8035,3575857445,3575857494,49
2,607,8036,3575857499,3575857499,0
2,607,8037,3575857499,3575857499,0
2,607,8038,3575857499,3575857499,0
2,607,8039,3575857499,3575857500,1
2,607,8040,3575857499,3575857501,2
2,607,8041,3575857499,3575857502,3
2,607,8042,3575857499,3575857503,4
2,607,8043,3575857499,3575857503,4
2,607,8044,3575857499,3575857505,6
2,607,8045,3575857499,3575857507,8
2,607,8046,3575857499,3575857510,11
2,607,8047,3575857499,3575857512,13
2,607,8048,3575857499,3575857513,14
2,607,8049,3575857499,3575857513,14
2,607,8050,3575857499,3575857514,15
2,607,8051,3575857499,3575857514,15
2,607,8052,3575857499,3575857514,15
2,607,8053,3575857499,3575857516,17
2,607,8054,3575857499,3575857516,17
2,607,8055,3575857499,3575857520,21
2,607,8056,3575857499,3575857520,21
2,607,8057,3575857499,3575857524,25
2,607,8058,3575857499,3575857526,27
2,607,8059,3575857499,3575857528,29
2,607,8060,3575857499,3575857531,32
2,607,8061,3575857499,3575857532,33
2,607,8062,3575857499,3575857533,34
2,607,8063,3575857499,3575857534,35
2,607,8064,3575857499,3575857535,36
2,607,8065,3575857499,3575857538,39
2,607,8066,3575857499,3575857539,40
2,607,8067,3575857499,3575857542,43
2,607,8068,3575857499,3575857543,44
2,607,8069,3575857499,3575857544,45
2,607,8070,3575857499,3575857545,46
2,607,8071,3575857499,3575857546,47
2,607,8072,3575857499,3575857548,49
2,608,8073,3575857553,3575857553,0
2,608,8074,3575857553,3575857553,0
2,608,8075,3575857553,3575857553,0
2,608,8076,3575857553,3575857553,0
2,608,8077,3575857553,3575857553,0
2,608,8078,3575857553,3575857557,4
2,608,8079,3575857553,3575857559,6
2,608,8080,3575857553,3575857559,6
2,608,8081,3575857553,3575857562,9
2,608,8082,3575857553,3575857562,9
2,608,8083,3575857553,3575857566,13
2,608,8084,3575857553,3575857567,14
2,608,8085,3575857553,3575857569,16
2,608,8086,3575857553,3575857569,16
2,608,8087,3575857553,3575857571,18
2,608,8088,3575857553,3575857576,23
2,608,8089,3575857553,3575857579,26
2,608,8090,3575857553,3575857580,27
2,608,8091,3575857553,3575857580,27
2,608,8092,3575857553,3575857583,30
2,608,8093,3575857553,3575857584,31
2,608,8094,3575857553,3575857584,31
2,608,8095,3575857553,3575857585,32
2,608,8096,3575857553,3575857585,32
2,608,8097,3575857553,3575857587,34
2,608,8098,3575857553,3575857588,35
2,608,8099,3575857553,3575857590,37
2,608,8100,3575857553,3575857591,38
2,608,8101,3575857553,3575857594,41
2,608,8102,3575857553,3575857594,41
2,608,8103,3575857553,3575857598,45
2,608,8104,3575857553,3575857601,48
2,608,8105,3575857553,3575857603,50
2,609,8106,3575857608,3575857608,0
2,609,8107,3575857608,3575857608,0
2,609,8108,3575857608,3575857609,1
2,609,8109,3575857608,3575857609,1
2,609,8110,3575857608,3575857610,2
2,609,8111,3575857608,3575857610,2
2,609,8112,3575857608,3575857612,4
2,609,8113,3575857608,3575857613,5
2,609,8114,3575857608,3575857614,6
2,609,8115,3575857608,3575857617,9
2,609,8116,3575857608,3575857619,11
2,609,8117,3575857608,3575857620,12
2,609,8118,3575857608,3575857623,15
2,609,8119,3575857608,3575857623,15
2,609,8120,3575857608,3575857624,16
2,609,8121,3575857608,3575857626,18
2,609,8122,3575857608,3575857627,19
2,609,8123,3575857608,3575857629,21
2,609,8124,3575857608,3575857634,26
2,609,8125,3575857608,3575857635,27
2,609,8126,3575857608,3575857635,27
2,609,8127,3575857608,3575857636,28
2,609,8128,3575857608,3575857638,30
2,609,8129,3575857608,3575857640,32
2,609,8130,3575857608,3575857640,32
2,609,8131,3575857608,3575857642,34
2,609,8132,3575857608,3575857643,35
2,609,8133,3575857608,3575857644,36
2,609,8134,3575857608,3575857644,36
2,609,8135,3575857608,3575857647,39
2,609,8136,3575857608,3575857649,41
2,609,8137,3575857608,3575857649,41
2,609,8138,3575857608,3575857652,44
2,609,8139,3575857608,3575857654,46
2,609,8140,3575857608,3575857657,49
2,610,8141,3575857663,3575857663,0
2,610,8142,3575857663,3575857663,0
2,610,8143,3575857663,3575857663,0
2,610,8144,3575857663,3575857663,0
2,610,8145,3575857663,3575857666,3
2,610,8146,3575857663,3575857666,3
2,610,8147,3575857663,3575857667,4
2,610,8148,3575857663,3575857668,5
2,610,8149,3575857663,3575857672,9
2,610,8150,3575857663,3575857674,11
2,610,8151,3575857663,3575857674,11
2,610,8152,3575857663,3575857676,13
2,610,8153,3575857663,3575857679,16
2,610,8154,3575857663,3575857680,17
2,610,8155,3575857663,3575857681,18
2,610,8156,3575857663,3575857682,19
2,610,8157,3575857663,3575857682,19
2,610,8158,3575857663,3575857682,19
2,610,8159,3575857663,3575857688,25
2,610,8160,3575857663,3575857688,25
2,610,8161,3575857663,3575857688,25
2,610,8162,3575857663,3575857689,26
2,610,8163,3575857663,3575857691,28
2,610,8164,3575857663,3575857691,28
2,610,8165,3575857663,3575857692,29
2,610,8166,3575857663,3575857693,30
2,610,8167,3575857663,3575857694,31
2,610,8168,3575857663,3575857696,33
2,610,8169,3575857663,3575857699,36
2,610,8170,3575857663,3575857699,36
2,610,8171,3575857663,3575857700,37
2,610,8172,3575857663,3575857701,38
2,610,8173,3575857663,3575857702,39
2,610,8174,3575857663,3575857703,40
2,610,8175,3575857663,3575857704,41
2,610,8176,3575857663,3575857705,42
2,610,8177,3575857663,3575857708,45
2,610,8178,3575857663,3575857709,46
2,610,8179,3575857663,3575857712,49
2,610,8180,3575857663,3575857712,49
2,610,8181,3575857663,3575857713,50
2,611,8182,3575857718,3575857718,0
2,611,8183,3575857718,3575857718,0
2,611,8184,3575857718,3575857718,0
2,611,8185,3575857718,3575857718,0
2,611,8186,3575857718,3575857718,0
2,611,8187,3575857718,3575857718,0
2,611,8188,3575857718,3575857719,1
2,611,8189,3575857718,3575857720,2
2,611,8190,3575857718,3575857722,4
2,611,8191,3575857718,3575857726,8
2,611,8192,3575857718,3575857728,10
2,611,8193,3575857718,3575857732,14
2,611,8194,3575857718,3575857733,15
2,611,8195,3575857718,3575857733,15
2,611,8196,3575857718,3575857734,16
2,611,8197,3575857718,3575857735,17
2,611,8198,3575857718,3575857738,20
2,611,8199,3575857718,3575857740,22
2,611,8200,3575857718,3575857741,23
2,611,8201,3575857718,3575857742,24
2,611,8202,3575857718,3575857744,26
2,611,8203,3575857718,3575857745,27
2,611,8204,3575857718,3575857745,27
2,611,8205,3575857718,3575857747,29
2,611,8206,3575857718,3575857748,30
2,611,8207,3575857718,3575857750,32
2,611,8208,3575857718,3575857751,33
2,611,8209,3575857718,3575857752,34
2,611,8210,3575857718,3575857752,34
2,611,8211,3575857718,3575857757,39
2,611,8212,3575857718,3575857758,40
2,611,8213,3575857718,3575857760,42
2,611,8214,3575857718,3575857762,44
2,611,8215,3575857718,3575857763,45
2,611,8216,3575857718,3575857766,48
2,611,8217,3575857718,3575857767,49
2,612,8218,3575857775,3575857775,0
2,612,8219,3575857775,3575857775,0
2,612,8220,3575857775,3575857775,0
2,612,8221,3575857775,3575857777,2
2,612,8222,3575857775,3575857779,4
2,612,8223,3575857775,3575857779,4
2,612,8224,3575857775,3575857780,5
2,612,8225,3575857775,3575857782,7
2,612,8226,3575857775,3575857784,9
2,612,8227,3575857775,3575857784,9
2,612,8228,3575857775,3575857785,10
2,612,8229,3575857775,3575857785,10
2,612,8230,3575857775,3575857787,12
2,612,8231,3575857775,3575857789,14
2,612,8232,3575857775,3575857790,15
2,612,8233,3575857775,3575857790,15
2,612,8234,3575857775,3575857794,19
2,612,8235,3575857775,3575857795,20
2,612,8236,3575857775,3575857798,23
2,612,8237,3575857775,3575857801,26
2,612,8238,3575857775,3575857803,28
2,612,8239,3575857775,3575857804,29
2,612,8240,3575857775,3575857804,29
2,612,8241,3575857775,3575857810,35
2,612,8242,3575857775,3575857810,35
2,612,8243,3575857775,3575857810,35
2,612,8244,3575857775,3575857810,35
2,612,8245,3575857775,3575857813,38
2,612,8246,3575857775,3575857813,38
2,612,8247,3575857775,3575857815,40
2,612,8248,3575857775,3575857817,42
2,612,8249,3575857775,3575857819,44
2,612,8250,3575857775,3575857821,46
2,612,8251,3575857775,3575857823,48
2,612,8252,3575857775,3575857823,48
2,612,8253,3575857775,3575857824,49
2,613,8254,3575857830,3575857830,0
2,613,8255,3575857830,3575857830,0
2,613,8256,3575857830,3575857830,0
2,613,8257,3575857830,3575857830,0
2,613,8258,3575857830,3575857835,5
2,613,8259,3575857830,3575857835,5
2,613,8260,3575857830,3575857835,5
2,613,8261,3575857830,3575857836,6
2,613,8262,3575857830,3575857840,10
2,613,8263,3575857830,3575857841,11
2,613,8264,3575857830,3575857842,12
2,613,8265,3575857830,3575857843,13
2,613,8266,3575857830,3575857843,13
2,613,8267,3575857830,3575857845,15
2,613,8268,3575857830,3575857848,18
2,613,8269,3575857830,3575857849,19
2,613,8270,3575857830,3575857850,20
2,613,8271,3575857830,3575857851,21
2,613,8272,3575857830,3575857855,25
2,613,8273,3575857830,3575857856,26
2,613,8274,3575857830,3575857858,28
2,613,8275,3575857830,3575857860,30
2,613,8276,3575857830,3575857860,30
2,613,8277,3575857830,3575857860,30
2,613,8278,3575857830,3575857866,36
2,613,8279,3575857830,3575857867,37
2,613,8280,3575857830,3575857867,37
2,613,8281,3575857830,3575857868,38
2,613,8282,3575857830,3575857872,42
2,613,8283,3575857830,3575857873,43
2,613,8284,3575857830,3575857874,44
2,613,8285,3575857830,3575857876,46
2,613,8286,3575857830,3575857879,49
2,613,8287,3575857830,3575857879,49
2,613,8288,3575857830,3575857880,50
2,614,8289,3575857885,3575857885,0
2,614,8290,3575857885,3575857885,0
2,614,8291,3575857885,3575857885,0
2,614,8292,3575857885,3575857885,0
2,614,8293,3575857885,3575857888,3
2,614,8294,3575857885,3575857888,3
2,614,8295,3575857885,3575857889,4
2,614,8296,3575857885,3575857891,6
2,614,8297,3575857885,3575857891,6
2,614,8298,3575857885,3575857892,7
2,614,8299,3575857885,3575857893,8
2,614,8300,3575857885,3575857893,8
2,614,8301,3575857885,3575857896,11
2,614,8302,3575857885,3575857899,14
2,614,8303,3575857885,3575857900,15
2,614,8304,3575857885,3575857900,15
2,614,8305,3575857885,3575857901,16
2,614,8306,3575857885,3575857902,17
2,614,8307,3575857885,3575857903,18
2,614,8308,3575857885,3575857905,20
2,614,8309,3575857885,3575857905,20
2,614,8310,3575857885,3575857911,26
2,614,8311,3575857885,3575857912,27
2,614,8312,3575857885,3575857912,27
2,614,8313,3575857885,3575857913,28
2,614,8314,3575857885,3575857914,29
2,614,8315,3575857885,3575857914,29
2,614,8316,3575857885,3575857914,29
2,614,8317,3575857885,3575857915,30
2,614,8318,3575857885,3575857916,31
2,614,8319,3575857885,3575857917,32
2,614,8320,3575857885,3575857920,35
2,614,8321,3575857885,3575857920,35
2,614,8322,3575857885,3575857923,38
2,614,8323,3575857885,3575857926,41
2,614,8324,3575857885,3575857928,43
2,614,8325,3575857885,3575857928,43
2,614,8326,3575857885,3575857931,46
2,614,8327,3575857885,3575857932,47
2,614,8328,3575857885,3575857934,49
2,614,8329,3575857885,3575857934,49
2,615,8330,3575857940,3575857940,0
2,615,8331,3575857940,3575857940,0
2,615,8332,3575857940,3575857940,0
2,615,8333,3575857940,3575857941,1
2,615,8334,3575857940,3575857942,2
2,615,8335,3575857940,3575857945,5
2,615,8336,3575857940,3575857945,5
2,615,8337,3575857940,3575857945,5
2,615,8338,3575857940,3575857947,7
2,615,8339,3575857940,3575857947,7
2,615,8340,3575857940,3575857948,8
2,615,8341,3575857940,3575857950,10
2,615,8342,3575857940,3575857950,10
2,615,8343,3575857940,3575857952,12
2,615,8344,3575857940,3575857952,12
2,615,8345,3575857940,3575857953,13
2,615,8346,3575857940,3575857957,17
2,615,8347,3575857940,3575857958,18
2,615,8348,3575857940,3575857961,21
2,615,8349,3575857940,3575857962,22
2,615,8350,3575857940,3575857964,24
2,615,8351,3575857940,3575857965,25
2,615,8352,3575857940,3575857967,27
2,615,8353,3575857940,3575857968,28
2,615,8354,3575857940,3575857969,29
2,615,8355,3575857940,3575857969,29
2,615,8356,3575857940,3575857972,32
2,615,8357,3575857940,3575857977,37
2,615,8358,3575857940,3575857980,40
2,615,8359,3575857940,3575857980,40
2,615,8360,3575857940,3575857982,42
2,615,8361,3575857940,3575857984,44
2,615,8362,3575857940,3575857985,45
2,615,8363,3575857940,3575857986,46
2,615,8364,3575857940,3575857986,46
2,615,8365,3575857940,3575857987,47
2,615,8366,3575857940,3575857989,49
2,616,8367,3575857995,3575857995,0
2,616,8368,3575857995,3575857995,0
2,616,8369,3575857995,3575857995,0
2,616,8370,3575857995,3575857995,0
2,616,8371,3575857995,3575857998,3
2,616,8372,3575857995,3575858001,6
2,616,8373,3575857995,3575858002,7
2,616,8374,3575857995,3575858004,9
2,616,8375,3575857995,3575858004,9
2,616,8376,3575857995,3575858010,15
2,616,8377,3575857995,3575858010,15
2,616,8378,3575857995,3575858011,16
2,616,8379,3575857995,3575858011,16
2,616,8380,3575857995,3575858013,18
2,616,8381,3575857995,3575858013,18
2,616,8382,3575857995,3575858015,20
2,616,8383,3575857995,3575858017,22
2,616,8384,3575857995,3575858020,25
2,616,8385,3575857995,3575858021,26
2,616,8386,3575857995,3575858023,28
2,616,8387,3575857995,3575858023,28
2,616,8388,3575857995,3575858025,30
2,616,8389,3575857995,3575858025,30
2,616,8390,3575857995,3575858027,32
2,616,8391,3575857995,3575858028,33
2,616,8392,3575857995,3575858029,34
2,616,8393,3575857995,3575858034,39
2,616,8394,3575857995,3575858035,40
2,616,8395,3575857995,3575858036,41
2,616,8396,3575857995,3575858036,41
2,616,8397,3575857995,3575858039,44
2,616,8398,3575857995,3575858041,46
2,616,8399,3575857995,3575858042,47
2,616,8400,3575857995,3575858043,48
2,616,8401,3575857995,3575858044,49
2,616,8402,3575857995,3575858045,50
2,617,8403,3575858049,3575858050,1
2,617,8404,3575858049,3575858050,1
2,617,8405,3575858049,3575858050,1
2,617,8406,3575858049,3575858051,2
2,617,8407,3575858049,3575858055,6
2,617,8408,3575858049,3575858057,8
2,617,8409,3575858049,3575858058,9
2,617,8410,3575858049,3575858060,11
2,617,8411,3575858049,3575858060,11
2,617,8412,3575858049,3575858061,12
2,617,8413,3575858049,3575858066,17
2,617,8414,3575858049,3575858067,18
2,617,8415,3575858049,3575858069,20
2,617,8416,3575858049,3575858073,24
2,617,8417,3575858049,3575858073,24
2,617,8418,3575858049,3575858074,25
2,617,8419,3575858049,3575858076,27
2,617,8420,3575858049,3575858079,30
2,617,8421,3575858049,3575858079,30
2,617,8422,3575858049,3575858080,31
2,617,8423,3575858049,3575858081,32
2,617,8424,3575858049,3575858081,32
2,617,8425,3575858049,3575858082,33
2,617,8426,3575858049,3575858083,34
2,617,8427,3575858049,3575858088,39
2,617,8428,3575858049,3575858088,39
2,617,8429,3575858049,3575858089,40
2,617,8430,3575858049,3575858092,43
2,617,8431,3575858049,3575858092,43
2,617,8432,3575858049,3575858092,43
2,617,8433,3575858049,3575858093,44
2,617,8434,3575858049,3575858094,45
2,617,8435,3575858049,3575858096,47
2,617,8436,3575858049,3575858099,50
2,618,8437,3575858104,3575858104,0
2,618,8438,3575858104,3575858104,0
2,618,8439,3575858104,3575858104,0
2,618,8440,3575858104,3575858104,0
2,618,8441,3575858104,3575858104,0
2,618,8442,3575858104,3575858106,2
2,618,8443,3575858104,3575858108,4
2,618,8444,3575858104,3575858110,6
2,618,8445,3575858104,3575858112,8
2,618,8446,3575858104,3575858113,9
2,618,8447,3575858104,3575858114,10
2,618,8448,3575858104,3575858114,10
2,618,8449,3575858104,3575858114,10
2,618,8450,3575858104,3575858114,10
2,618,8451,3575858104,3575858117,13
2,618,8452,3575858104,3575858117,13
2,618,8453,3575858104,3575858120,16
2,618,8454,3575858104,3575858121,17
2,618,8455,3575858104,3575858123,19
2,618,8456,3575858104,3575858127,23
2,618,8457,3575858104,3575858127,23
2,618,8458,3575858104,3575858127,23
2,618,8459,3575858104,3575858131,27
2,618,8460,3575858104,3575858132,28
2,618,8461,3575858104,3575858132,28
2,618,8462,3575858104,3575858133,29
2,618,8463,3575858104,3575858138,34
2,618,8464,3575858104,3575858139,35
2,618,8465,3575858104,3575858140,36
2,618,8466,3575858104,3575858141,37
2,618,8467,3575858104,3575858142,38
2,618,8468,3575858104,3575858144,40
2,618,8469,3575858104,3575858146,42
2,618,8470,3575858104,3575858146,42
2,618,8471,3575858104,3575858147,43
2,618,8472,3575858104,3575858149,45
2,618,8473,3575858104,3575858150,46
2,618,8474,3575858104,3575858150,46
2,618,8475,3575858104,3575858152,48
2,618,8476,3575858104,3575858152,48
2,619,8477,3575858158,3575858158,0
2,619,8478,3575858158,3575858158,0
2,619,8479,3575858158,3575858160,2
2,619,8480,3575858158,3575858162,4
2,619,8481,3575858158,3575858164,6
2,619,8482,3575858158,3575858166,8
2,619,8483,3575858158,3575858167,9
2,619,8484,3575858158,3575858168,10
2,619,8485,3575858158,3575858169,11
2,619,8486,3575858158,3575858170,12
2,619,8487,3575858158,3575858172,14
2,619,8488,3575858158,3575858177,19
2,619,8489,3575858158,3575858179,21
2,619,8490,3575858158,3575858180,22
2,619,8491,3575858158,3575858181,23
2,619,8492,3575858158,3575858183,25
2,619,8493,3575858158,3575858185,27
2,619,8494,3575858158,3575858185,27
2,619,8495,3575858158,3575858186,28
2,619,8496,3575858158,3575858186,28
2,619,8497,3575858158,3575858187,29
2,619,8498,3575858158,3575858189,31
2,619,8499,3575858158,3575858191,33
2,619,8500,3575858158,3575858192,34
2,619,8501,3575858158,3575858194,36
2,619,8502,3575858158,3575858195,37
2,619,8503,3575858158,3575858199,41
2,619,8504,3575858158,3575858201,43
2,619,8505,3575858158,3575858203,45
2,619,8506,3575858158,3575858204,46
2,619,8507,3575858158,3575858205,47
2,620,8508,3575858212,3575858212,0
2,620,8509,3575858212,3575858212,0
2,620,8510,3575858212,3575858212,0
2,620,8511,3575858212,3575858212,0
2,620,8512,3575858212,3575858212,0
2,620,8513,3575858212,3575858214,2
2,620,8514,3575858212,3575858216,4
2,620,8515,3575858212,3575858218,6
2,620,8516,3575858212,3575858220,8
2,620,8517,3575858212,3575858220,8
2,620,8518,3575858212,3575858223,11
2,620,8519,3575858212,3575858223,11
2,620,8520,3575858212,3575858225,13
2,620,8521,3575858212,3575858226,14
2,620,8522,3575858212,3575858228,16
2,620,8523,3575858212,3575858228,16
2,620,8524,3575858212,3575858230,18
2,620,8525,3575858212,3575858235,23
2,620,8526,3575858212,3575858235,23
2,620,8527,3575858212,3575858235,23
2,620,8528,3575858212,3575858236,24
2,620,8529,3575858212,3575858239,27
2,620,8530,3575858212,3575858240,28
2,620,8531,3575858212,3575858241,29
2,620,8532,3575858212,3575858243,31
2,620,8533,3575858212,3575858243,31
2,620,8534,3575858212,3575858244,32
2,620,8535,3575858212,3575858245,33
2,620,8536,3575858212,3575858249,37
2,620,8537,3575858212,3575858249,37
2,620,8538,3575858212,3575858250,38
2,620,8539,3575858212,3575858252,40
2,620,8540,3575858212,3575858255,43
2,620,8541,3575858212,3575858257,45
2,620,8542,3575858212,3575858259,47
2,620,8543,3575858212,3575858260,48
2,620,8544,3575858212,3575858260,48
2,620,8545,3575858212,3575858260,48
2,621,8546,3575858267,3575858267,0
2,621,8547,3575858267,3575858267,0
2,621,8548,3575858267,3575858269,2
2,621,8549,3575858267,3575858273,6
2,621,8550,3575858267,3575858273,6
2,621,8551,3575858267,3575858275,8
2,621,8552,3575858267,3575858276,9
2,621,8553,3575858267,3575858278,11
2,621,8554,3575858267,3575858279,12
2,621,8555,3575858267,3575858280,13
2,621,8556,3575858267,3575858280,13
2,621,8557,3575858267,3575858281,14
2,621,8558,3575858267,3575858282,15
2,621,8559,3575858267,3575858283,16
2,621,8560,3575858267,3575858287,20
2,621,8561,3575858267,3575858288,21
2,621,8562,3575858267,3575858289,22
2,621,8563,3575858267,3575858289,22
2,621,8564,3575858267,3575858292,25
2,621,8565,3575858267,3575858292,25
2,621,8566,3575858267,3575858292,25
2,621,8567,3575858267,3575858293,26
2,621,8568,3575858267,3575858294,27
2,621,8569,3575858267,3575858296,29
2,621,8570,3575858267,3575858299,32
2,621,8571,3575858267,3575858300,33
2,621,8572,3575858267,3575858300,33
2,621,8573,3575858267,3575858303,36
2,621,8574,3575858267,3575858304,37
2,621,8575,3575858267,3575858306,39
2,621,8576,3575858267,3575858306,39
2,621,8577,3575858267,3575858308,41
2,621,8578,3575858267,3575858310,43
2,621,8579,3575858267,3575858312,45
2,621,8580,3575858267,3575858313,46
2,621,8581,3575858267,3575858314,47
2,621,8582,3575858267,3575858315,48
2,621,8583,3575858267,3575858315,48
2,621,8584,3575858267,3575858315,48
2,621,8585,3575858267,3575858317,50
2,622,8586,3575858321,3575858321,0
2,622,8587,3575858321,3575858321,0
2,622,8588,3575858321,3575858321,0
2,622,8589,3575858321,3575858323,2
2,622,8590,3575858321,3575858325,4
2,622,8591,3575858321,3575858326,5
2,622,8592,3575858321,3575858327,6
2,622,8593,3575858321,3575858329,8
2,622,8594,3575858321,3575858331,10
2,622,8595,3575858321,3575858332,11
2,622,8596,3575858321,3575858332,11
2,622,8597,3575858321,3575858335,14
2,622,8598,3575858321,3575858340,19
2,622,8599,3575858321,3575858340,19
2,622,8600,3575858321,3575858342,21
2,622,8601,3575858321,3575858342,21
2,622,8602,3575858321,3575858344,23
2,622,8603,3575858321,3575858346,25
2,622,8604,3575858321,3575858346,25
2,622,8605,3575858321,3575858346,25
2,622,8606,3575858321,3575858349,28
2,622,8607,3575858321,3575858350,29
2,622,8608,3575858321,3575858352,31
2,622,8609,3575858321,3575858352,31
2,622,8610,3575858321,3575858353,32
2,622,8611,3575858321,3575858358,37
2,622,8612,3575858321,3575858359,38
2,622,8613,3575858321,3575858361,40
2,622,8614,3575858321,3575858363,42
2,622,8615,3575858321,3575858363,42
2,622,8616,3575858321,3575858365,44
2,622,8617,3575858321,3575858366,45
2,622,8618,3575858321,3575858367,46
2,622,8619,3575858321,3575858368,47
2,622,8620,3575858321,3575858370,49
2,623,8621,3575858375,3575858375,0
2,623,8622,3575858375,3575858377,2
2,623,8623,3575858375,3575858380,5
2,623,8624,3575858375,3575858380,5
2,623,8625,3575858375,3575858381,6
2,623,8626,3575858375,3575858383,8
2,623,8627,3575858375,3575858384,9
2,623,8628,3575858375,3575858385,10
2,623,8629,3575858375,3575858386,11
2,623,8630,3575858375,3575858386,11
2,623,8631,3575858375,3575858387,12
2,623,8632,3575858375,3575858389,14
2,623,8633,3575858375,3575858391,16
2,623,8634,3575858375,3575858391,16
2,623,8635,3575858375,3575858394,19
2,623,8636,3575858375,3575858395,20
2,623,8637,3575858375,3575858399,24
2,623,8638,3575858375,3575858401,26
2,623,8639,3575858375,3575858404,29
2,623,8640,3575858375,3575858404,29
2,623,8641,3575858375,3575858405,30
2,623,8642,3575858375,3575858410,35
2,623,8643,3575858375,3575858411,36
2,623,8644,3575858375,3575858411,36
2,623,8645,3575858375,3575858411,36
2,623,8646,3575858375,3575858413,38
2,623,8647,3575858375,3575858415,40
2,623,8648,3575858375,3575858417,42
2,623,8649,3575858375,3575858418,43
2,623,8650,3575858375,3575858421,46
2,623,8651,3575858375,3575858421,46
2,623,8652,3575858375,3575858423,48
2,623,8653,3575858375,3575858423,48
2,623,8654,3575858375,3575858425,50
2,624,8655,3575858429,3575858429,0
2,624,8656,3575858429,3575858429,0
2,624,8657,3575858429,3575858429,0
2,624,8658,3575858429,3575858430,1
2,624,8659,3575858429,3575858435,6
2,624,8660,3575858429,3575858435,6
2,624,8661,3575858429,3575858436,7
2,624,8662,3575858429,3575858438,9
2,624,8663,3575858429,3575858439,10
2,624,8664,3575858429,3575858440,11
2,624,8665,3575858429,3575858442,13
2,624,8666,3575858429,3575858444,15
2,624,8667,3575858429,3575858445,16
2,624,8668,3575858429,3575858445,16
2,624,8669,3575858429,3575858450,21
2,624,8670,3575858429,3575858450,21
2,624,8671,3575858429,3575858450,21
2,624,8672,3575858429,3575858452,23
2,624,8673,3575858429,3575858454,25
2,624,8674,3575858429,3575858456,27
2,624,8675,3575858429,3575858460,31
2,624,8676,3575858429,3575858460,31
2,624,8677,3575858429,3575858460,31
2,624,8678,3575858429,3575858461,32
2,624,8679,3575858429,3575858467,38
2,624,8680,3575858429,3575858468,39
2,624,8681,3575858429,3575858469,40
2,624,8682,3575858429,3575858472,43
2,624,8683,3575858429,3575858473,44
2,624,8684,3575858429,3575858474,45
2,624,8685,3575858429,3575858476,47
2,624,8686,3575858429,3575858479,50
2,625,8687,3575858484,3575858484,0
2,625,8688,3575858484,3575858484,0
2,625,8689,3575858484,3575858484,0
2,625,8690,3575858484,3575858484,0
2,625,8691,3575858484,3575858484,0
2,625,8692,3575858484,3575858486,2
2,625,8693,3575858484,3575858486,2
2,625,8694,3575858484,3575858487,3
2,625,8695,3575858484,3575858488,4
2,625,8696,3575858484,3575858491,7
2,625,8697,3575858484,3575858491,7
2,625,8698,3575858484,3575858491,7
2,625,8699,3575858484,3575858492,8
2,625,8700,3575858484,3575858493,9
2,625,8701,3575858484,3575858495,11
2,625,8702,3575858484,3575858499,15
2,625,8703,3575858484,3575858499,15
2,625,8704,3575858484,3575858500,16
2,625,8705,3575858484,3575858502,18
2,625,8706,3575858484,3575858503,19
2,625,8707,3575858484,3575858503,19
2,625,8708,3575858484,3575858505,21
2,625,8709,3575858484,3575858505,21
2,625,8710,3575858484,3575858507,23
2,625,8711,3575858484,3575858510,26
2,625,8712,3575858484,3575858511,27
2,625,8713,3575858484,3575858512,28
2,625,8714,3575858484,3575858514,30
2,625,8715,3575858484,3575858514,30
2,625,8716,3575858484,3575858515,31
2,625,8717,3575858484,3575858515,31
2,625,8718,3575858484,3575858516,32
2,625,8719,3575858484,3575858517,33
2,625,8720,3575858484,3575858519,35
2,625,8721,3575858484,3575858520,36
2,625,8722,3575858484,3575858522,38
2,625,8723,3575858484,3575858523,39
2,625,8724,3575858484,3575858526,42
2,625,8725,3575858484,3575858526,42
2,625,8726,3575858484,3575858530,46
2,625,8727,3575858484,3575858530,46
2,625,8728,3575858484,3575858531,47
2,625,8729,3575858484,3575858533,49
2,626,8730,3575858539,3575858539,0
2,626,8731,3575858539,3575858539,0
2,626,8732,3575858539,3575858540,1
2,626,8733,3575858539,3575858541,2
2,626,8734,3575858539,3575858544,5
2,626,8735,3575858539,3575858544,5
2,626,8736,3575858539,3575858545,6
2,626,8737,3575858539,3575858545,6
2,626,8738,3575858539,3575858546,7
2,626,8739,3575858539,3575858547,8
2,626,8740,3575858539,3575858548,9
2,626,8741,3575858539,3575858550,11
2,626,8742,3575858539,3575858551,12
2,626,8743,3575858539,3575858551,12
2,626,8744,3575858539,3575858552,13
2,626,8745,3575858539,3575858557,18
2,626,8746,3575858539,3575858559,20
2,626,8747,3575858539,3575858560,21
2,626,8748,3575858539,3575858561,22
2,626,8749,3575858539,3575858562,23
2,626,8750,3575858539,3575858565,26
2,626,8751,3575858539,3575858567,28
2,626,8752,3575858539,3575858567,28
2,626,8753,3575858539,3575858567,28
2,626,8754,3575858539,3575858569,30
2,626,8755,3575858539,3575858571,32
2,626,8756,3575858539,3575858576,37
2,626,8757,3575858539,3575858579,40
2,626,8758,3575858539,3575858579,40
2,626,8759,3575858539,3575858580,41
2,626,8760,3575858539,3575858583,44
2,626,8761,3575858539,3575858583,44
2,626,8762,3575858539,3575858584,45
2,626,8763,3575858539,3575858585,46
2,626,8764,3575858539,3575858586,47
2,626,8765,3575858539,3575858587,48
2,626,8766,3575858539,3575858588,49
2,626,8767,3575858539,3575858588,49
2,627,8768,3575858594,3575858594,0
2,627,8769,3575858594,3575858594,0
2,627,8770,3575858594,3575858594,0
2,627,8771,3575858594,3575858595,1
2,627,8772,3575858594,3575858598,4
2,627,8773,3575858594,3575858600,6
2,627,8774,3575858594,3575858602,8
2,627,8775,3575858594,3575858604,10
2,627,8776,3575858594,3575858604,10
2,627,8777,3575858594,3575858609,15
2,627,8778,3575858594,3575858609,15
2,627,8779,3575858594,3575858610,16
2,627,8780,3575858594,3575858611,17
2,627,8781,3575858594,3575858612,18
2,627,8782,3575858594,3575858614,20
2,627,8783,3575858594,3575858617,23
2,627,8784,3575858594,3575858617,23
2,627,8785,3575858594,3575858620,26
2,627,8786,3575858594,3575858622,28
2,627,8787,3575858594,3575858622,28
2,627,8788,3575858594,3575858624,30
2,627,8789,3575858594,3575858626,32
2,627,8790,3575858594,3575858627,33
2,627,8791,3575858594,3575858628,34
2,627,8792,3575858594,3575858628,34
2,627,8793,3575858594,3575858634,40
2,627,8794,3575858594,3575858635,41
2,627,8795,3575858594,3575858635,41
2,627,8796,3575858594,3575858636,42
2,627,8797,3575858594,3575858639,45
2,627,8798,3575858594,3575858639,45
2,627,8799,3575858594,3575858640,46
2,627,8800,3575858594,3575858641,47
2,627,8801,3575858594,3575858643,49
2,627,8802,3575858594,3575858643,49
2,627,8803,3575858594,3575858644,50
2,628,8804,3575858649,3575858649,0
2,628,8805,3575858649,3575858649,0
2,628,8806,3575858649,3575858649,0
2,628,8807,3575858649,3575858651,2
2,628,8808,3575858649,3575858655,6
2,628,8809,3575858649,3575858656,7
2,628,8810,3575858649,3575858659,10
2,628,8811,3575858649,3575858659,10
2,628,8812,3575858649,3575858660,11
2,628,8813,3575858649,3575858660,11
2,628,8814,3575858649,3575858666,17
2,628,8815,3575858649,3575858667,18
2,628,8816,3575858649,3575858668,19
2,628,8817,3575858649,3575858673,24
2,628,8818,3575858649,3575858674,25
2,628,8819,3575858649,3575858674,25
2,628,8820,3575858649,3575858676,27
2,628,8821,3575858649,3575858680,31
2,628,8822,3575858649,3575858680,31
2,628,8823,3575858649,3575858681,32
2,628,8824,3575858649,3575858681,32
2,628,8825,3575858649,3575858682,33
2,628,8826,3575858649,3575858683,34
2,628,8827,3575858649,3575858686,37
2,628,8828,3575858649,3575858687,38
2,628,8829,3575858649,3575858688,39
2,628,8830,3575858649,3575858688,39
2,628,8831,3575858649,3575858688,39
2,628,8832,3575858649,3575858690,41
2,628,8833,3575858649,3575858690,41
2,628,8834,3575858649,3575858692,43
2,628,8835,3575858649,3575858692,43
2,628,8836,3575858649,3575858693,44
2,628,8837,3575858649,3575858693,44
2,628,8838,3575858649,3575858695,46
2,628,8839,3575858649,3575858699,50
2,629,8840,3575858704,3575858704,0
2,629,8841,3575858704,3575858704,0
2,629,8842,3575858704,3575858704,0
2,629,8843,3575858704,3575858704,0
2,629,8844,3575858704,3575858704,0
2,629,8845,3575858704,3575858705,1
2,629,8846,3575858704,3575858705,1
2,629,8847,3575858704,3575858708,4
2,629,8848,3575858704,3575858711,7
2,629,8849,3575858704,3575858711,7
2,629,8850,3575858704,3575858712,8
2,629,8851,3575858704,3575858713,9
2,629,8852,3575858704,3575858714,10
2,629,8853,3575858704,3575858714,10
2,629,8854,3575858704,3575858715,11
2,629,8855,3575858704,3575858717,13
2,629,8856,3575858704,3575858719,15
2,629,8857,3575858704,3575858719,15
2,629,8858,3575858704,3575858721,17
2,629,8859,3575858704,3575858723,19
2,629,8860,3575858704,3575858727,23
2,629,8861,3575858704,3575858727,23
2,629,8862,3575858704,3575858728,24
2,629,8863,3575858704,3575858730,26
2,629,8864,3575858704,3575858731,27
2,629,8865,3575858704,3575858731,27
2,629,8866,3575858704,3575858733,29
2,629,8867,3575858704,3575858738,34
2,629,8868,3575858704,3575858738,34
2,629,8869,3575858704,3575858740,36
2,629,8870,3575858704,3575858740,36
2,629,8871,3575858704,3575858741,37
2,629,8872,3575858704,3575858744,40
2,629,8873,3575858704,3575858745,41
2,629,8874,3575858704,3575858745,41
2,629,8875,3575858704,3575858746,42
2,629,8876,3575858704,3575858748,44
2,629,8877,3575858704,3575858749,45
2,629,8878,3575858704,3575858750,46
2,629,8879,3575858704,3575858751,47
2,629,8880,3575858704,3575858752,48
2,629,8881,3575858704,3575858752,48
2,630,8882,3575858759,3575858759,0
2,630,8883,3575858759,3575858759,0
2,630,8884,3575858759,3575858759,0
2,630,8885,3575858759,3575858762,3
2,630,8886,3575858759,3575858763,4
2,630,8887,3575858759,3575858765,6
2,630,8888,3575858759,3575858767,8
2,630,8889,3575858759,3575858767,8
2,630,8890,3575858759,3575858768,9
2,630,8891,3575858759,3575858769,10
2,630,8892,3575858759,3575858772,13
2,630,8893,3575858759,3575858776,17
2,630,8894,3575858759,3575858778,19
2,630,8895,3575858759,3575858779,20
2,630,8896,3575858759,3575858782,23
2,630,8897,3575858759,3575858784,25
2,630,8898,3575858759,3575858784,25
2,630,8899,3575858759,3575858785,26
2,630,8900,3575858759,3575858786,27
2,630,8901,3575858759,3575858787,28
2,630,8902,3575858759,3575858788,29
2,630,8903,3575858759,3575858788,29
2,630,8904,3575858759,3575858790,31
2,630,8905,3575858759,3575858792,33
2,630,8906,3575858759,3575858793,34
2,630,8907,3575858759,3575858798,39
2,630,8908,3575858759,3575858801,42
2,630,8909,3575858759,3575858803,44
2,630,8910,3575858759,3575858803,44
2,630,8911,3575858759,3575858804,45
2,631,8912,3575858814,3575858814,0
2,631,8913,3575858814,3575858814,0
2,631,8914,3575858814,3575858814,0
2,631,8915,3575858814,3575858814,0
2,631,8916,3575858814,3575858814,0
2,631,8917,3575858814,3575858814,0
2,631,8918,3575858814,3575858816,2
2,631,8919,3575858814,3575858818,4
2,631,8920,3575858814,3575858820,6
2,631,8921,3575858814,3575858821,7
2,631,8922,3575858814,3575858822,8
2,631,8923,3575858814,3575858823,9
2,631,8924,3575858814,3575858823,9
2,631,8925,3575858814,3575858826,12
2,631,8926,3575858814,3575858827,13
2,631,8927,3575858814,3575858828,14
2,631,8928,3575858814,3575858829,15
2,631,8929,3575858814,3575858835,21
2,631,8930,3575858814,3575858835,21
2,631,8931,3575858814,3575858836,22
2,631,8932,3575858814,3575858836,22
2,631,8933,3575858814,3575858837,23
2,631,8934,3575858814,3575858839,25
2,631,8935,3575858814,3575858841,27
2,631,8936,3575858814,3575858843,29
2,631,8937,3575858814,3575858844,30
2,631,8938,3575858814,3575858845,31
2,631,8939,3575858814,3575858848,34
2,631,8940,3575858814,3575858849,35
2,631,8941,3575858814,3575858849,35
2,631,8942,3575858814,3575858851,37
2,631,8943,3575858814,3575858855,41
2,631,8944,3575858814,3575858856,42
2,631,8945,3575858814,3575858859,45
2,631,8946,3575858814,3575858859,45
2,631,8947,3575858814,3575858860,46
2,631,8948,3575858814,3575858861,47
2,632,8949,3575858870,3575858870,0
2,632,8950,3575858870,3575858870,0
2,632,8951,3575858870,3575858870,0
2,632,8952,3575858870,3575858873,3
2,632,8953,3575858870,3575858874,4
2,632,8954,3575858870,3575858875,5
2,632,8955,3575858870,3575858880,10
2,632,8956,3575858870,3575858880,10
2,632,8957,3575858870,3575858881,11
2,632,8958,3575858870,3575858881,11
2,632,8959,3575858870,3575858882,12
2,632,8960,3575858870,3575858883,13
2,632,8961,3575858870,3575858885,15
2,632,8962,3575858870,3575858887,17
2,632,8963,3575858870,3575858888,18
2,632,8964,3575858870,3575858888,18
2,632,8965,3575858870,3575858889,19
2,632,8966,3575858870,3575858890,20
2,632,8967,3575858870,3575858891,21
2,632,8968,3575858870,3575858892,22
2,632,8969,3575858870,3575858892,22
2,632,8970,3575858870,3575858892,22
2,632,8971,3575858870,3575858892,22
2,632,8972,3575858870,3575858895,25
2,632,8973,3575858870,3575858899,29
2,632,8974,3575858870,3575858900,30
2,632,8975,3575858870,3575858900,30
2,632,8976,3575858870,3575858902,32
2,632,8977,3575858870,3575858903,33
2,632,8978,3575858870,3575858904,34
2,632,8979,3575858870,3575858905,35
2,632,8980,3575858870,3575858905,35
2,632,8981,3575858870,3575858908,38
2,632,8982,3575858870,3575858910,40
2,632,8983,3575858870,3575858911,41
2,632,8984,3575858870,3575858912,42
2,632,8985,3575858870,3575858914,44
2,632,8986,3575858870,3575858914,44
2,632,8987,3575858870,3575858915,45
2,632,8988,3575858870,3575858915,45
2,632,8989,3575858870,3575858916,46
2,632,8990,3575858870,3575858920,50
2,633,8991,3575858926,3575858926,0
2,633,8992,3575858926,3575858926,0
2,633,8993,3575858926,3575858926,0
2,633,8994,3575858926,3575858926,0
2,633,8995,3575858926,3575858928,2
2,633,8996,3575858926,3575858929,3
2,633,8997,3575858926,3575858931,5
2,633,8998,3575858926,3575858931,5
2,633,8999,3575858926,3575858931,5
2,633,9000,3575858926,3575858934,8
2,633,9001,3575858926,3575858934,8
2,633,9002,3575858926,3575858938,12
2,633,9003,3575858926,3575858939,13
2,633,9004,3575858926,3575858940,14
2,633,9005,3575858926,3575858941,15
2,633,9006,3575858926,3575858945,19
2,633,9007,3575858926,3575858946,20
2,633,9008,3575858926,3575858946,20
2,633,9009,3575858926,3575858946,20
2,633,9010,3575858926,3575858949,23
2,633,9011,3575858926,3575858949,23
2,633,9012,3575858926,3575858951,25
2,633,9013,3575858926,3575858951,25
2,633,9014,3575858926,3575858952,26
2,633,9015,3575858926,3575858952,26
2,633,9016,3575858926,3575858957,31
2,633,9017,3575858926,3575858960,34
2,633,9018,3575858926,3575858961,35
2,633,9019,3575858926,3575858961,35
2,633,9020,3575858926,3575858963,37
2,633,9021,3575858926,3575858965,39
2,633,9022,3575858926,3575858967,41
2,633,9023,3575858926,3575858967,41
2,633,9024,3575858926,3575858968,42
2,633,9025,3575858926,3575858969,43
2,633,9026,3575858926,3575858972,46
2,634,9027,3575858981,3575858981,0
2,634,9028,3575858981,3575858981,0
2,634,9029,3575858981,3575858981,0
2,634,9030,3575858981,3575858981,0
2,634,9031,3575858981,3575858982,1
2,634,9032,3575858981,3575858984,3
2,634,9033,3575858981,3575858985,4
2,634,9034,3575858981,3575858986,5
2,634,9035,3575858981,3575858986,5
2,634,9036,3575858981,3575858987,6
2,634,9037,3575858981,3575858989,8
2,634,9038,3575858981,3575858989,8
2,634,9039,3575858981,3575858990,9
2,634,9040,3575858981,3575858992,11
2,634,9041,3575858981,3575858994,13
2,634,9042,3575858981,3575858998,17
2,634,9043,3575858981,3575859000,19
2,634,9044,3575858981,3575859000,19
2,634,9045,3575858981,3575859003,22
2,634,9046,3575858981,3575859003,22
2,634,9047,3575858981,3575859004,23
2,634,9048,3575858981,3575859010,29
2,634,9049,3575858981,3575859010,29
2,634,9050,3575858981,3575859010,29
2,634,9051,3575858981,3575859011,30
2,634,9052,3575858981,3575859014,33
2,634,9053,3575858981,3575859017,36
2,634,9054,3575858981,3575859017,36
2,634,9055,3575858981,3575859019,38
2,634,9056,3575858981,3575859020,39
2,634,9057,3575858981,3575859022,41
2,634,9058,3575858981,3575859022,41
2,634,9059,3575858981,3575859025,44
2,634,9060,3575858981,3575859026,45
2,634,9061,3575858981,3575859027,46
2,634,9062,3575858981,3575859029,48
2,634,9063,3575858981,3575859029,48
2,635,9064,3575859035,3575859035,0
2,635,9065,3575859035,3575859036,1
2,635,9066,3575859035,3575859036,1
2,635,9067,3575859035,3575859037,2
2,635,9068,3575859035,3575859039,4
2,635,9069,3575859035,3575859041,6
2,635,9070,3575859035,3575859042,7
2,635,9071,3575859035,3575859043,8
2,635,9072,3575859035,3575859045,10
2,635,9073,3575859035,3575859045,10
2,635,9074,3575859035,3575859049,14
2,635,9075,3575859035,3575859049,14
2,635,9076,3575859035,3575859049,14
2,635,9077,3575859035,3575859051,16
2,635,9078,3575859035,3575859055,20
2,635,9079,3575859035,3575859055,20
2,635,9080,3575859035,3575859059,24
2,635,9081,3575859035,3575859059,24
2,635,9082,3575859035,3575859060,25
2,635,9083,3575859035,3575859060,25
2,635,9084,3575859035,3575859063,28
2,635,9085,3575859035,3575859066,31
2,635,9086,3575859035,3575859068,33
2,635,9087,3575859035,3575859069,34
2,635,9088,3575859035,3575859073,38
2,635,9089,3575859035,3575859073,38
2,635,9090,3575859035,3575859074,39
2,635,9091,3575859035,3575859079,44
2,635,9092,3575859035,3575859080,45
2,635,9093,3575859035,3575859080,45
2,635,9094,3575859035,3575859081,46
2,635,9095,3575859035,3575859081,46
2,635,9096,3575859035,3575859082,47
2,635,9097,3575859035,3575859083,48
2,636,9098,3575859090,3575859090,0
2,636,9099,3575859090,3575859090,0
2,636,9100,3575859090,3575859090,0
2,636,9101,3575859090,3575859090,0
2,636,9102,3575859090,3575859090,0
2,636,9103,3575859090,3575859090,0
2,636,9104,3575859090,3575859090,0
2,636,9105,3575859090,3575859091,1
2,636,9106,3575859090,3575859092,2
2,636,9107,3575859090,3575859093,3
2,636,9108,3575859090,3575859093,3
2,636,9109,3575859090,3575859095,5
2,636,9110,3575859090,3575859100,10
2,636,9111,3575859090,3575859100,10
2,636,9112,3575859090,3575859100,10
2,636,9113,3575859090,3575859102,12
2,636,9114,3575859090,3575859103,13
2,636,9115,3575859090,3575859103,13
2,636,9116,3575859090,3575859103,13
2,636,9117,3575859090,3575859105,15
2,636,9118,3575859090,3575859105,15
2,636,9119,3575859090,3575859108,18
2,636,9120,3575859090,3575859110,20
2,636,9121,3575859090,3575859111,21
2,636,9122,3575859090,3575859113,23
2,636,9123,3575859090,3575859115,25
2,636,9124,3575859090,3575859115,25
2,636,9125,3575859090,3575859115,25
2,636,9126,3575859090,3575859115,25
2,636,9127,3575859090,3575859115,25
2,636,9128,3575859090,3575859116,26
2,636,9129,3575859090,3575859117,27
2,636,9130,3575859090,3575859119,29
2,636,9131,3575859090,3575859124,34
2,636,9132,3575859090,3575859127,37
2,636,9133,3575859090,3575859128,38
2,636,9134,3575859090,3575859129,39
2,636,9135,3575859090,3575859131,41
2,636,9136,3575859090,3575859131,41
2,636,9137,3575859090,3575859132,42
2,636,9138,3575859090,3575859134,44
2,636,9139,3575859090,3575859134,44
2,636,9140,3575859090,3575859138,48
2,636,9141,3575859090,3575859139,49
2,637,9142,3575859145,3575859145,0
2,637,9143,3575859145,3575859145,0
2,637,9144,3575859145,3575859145,0
2,637,9145,3575859145,3575859145,0
2,637,9146,3575859145,3575859146,1
2,637,9147,3575859145,3575859146,1
2,637,9148,3575859145,3575859148,3
2,637,9149,3575859145,3575859149,4
2,637,9150,3575859145,3575859150,5
2,637,9151,3575859145,3575859152,7
2,637,9152,3575859145,3575859152,7
2,637,9153,3575859145,3575859153,8
2,637,9154,3575859145,3575859158,13
2,637,9155,3575859145,3575859159,14
2,637,9156,3575859145,3575859160,15
2,637,9157,3575859145,3575859162,17
2,637,9158,3575859145,3575859163,18
2,637,9159,3575859145,3575859166,21
2,637,9160,3575859145,3575859167,22
2,637,9161,3575859145,3575859168,23
2,637,9162,3575859145,3575859169,24
2,637,9163,3575859145,3575859169,24
2,637,9164,3575859145,3575859172,27
2,637,9165,3575859145,3575859178,33
2,637,9166,3575859145,3575859178,33
2,637,9167,3575859145,3575859179,34
2,637,9168,3575859145,3575859183,38
2,637,9169,3575859145,3575859184,39
2,637,9170,3575859145,3575859184,39
2,637,9171,3575859145,3575859185,40
2,637,9172,3575859145,3575859186,41
2,637,9173,3575859145,3575859188,43
2,637,9174,3575859145,3575859188,43
2,637,9175,3575859145,3575859189,44
2,637,9176,3575859145,3575859191,46
2,637,9177,3575859145,3575859191,46
2,637,9178,3575859145,3575859193,48
2,638,9179,3575859200,3575859200,0
2,638,9180,3575859200,3575859200,0
2,638,9181,3575859200,3575859200,0
2,638,9182,3575859200,3575859203,3
2,638,9183,3575859200,3575859203,3
2,638,9184,3575859200,3575859204,4
2,638,9185,3575859200,3575859205,5
2,638,9186,3575859200,3575859210,10
2,638,9187,3575859200,3575859210,10
2,638,9188,3575859200,3575859210,10
2,638,9189,3575859200,3575859211,11
2,638,9190,3575859200,3575859215,15
2,638,9191,3575859200,3575859217,17
2,638,9192,3575859200,3575859218,18
2,638,9193,3575859200,3575859220,20
2,638,9194,3575859200,3575859220,20
2,638,9195,3575859200,3575859222,22
2,638,9196,3575859200,3575859222,22
2,638,9197,3575859200,3575859225,25
2,638,9198,3575859200,3575859226,26
2,638,9199,3575859200,3575859228,28
2,638,9200,3575859200,3575859230,30
2,638,9201,3575859200,3575859235,35
2,638,9202,3575859200,3575859235,35
2,638,9203,3575859200,3575859236,36
2,638,9204,3575859200,3575859237,37
2,638,9205,3575859200,3575859239,39
2,638,9206,3575859200,3575859242,42
2,638,9207,3575859200,3575859243,43
2,638,9208,3575859200,3575859245,45
2,638,9209,3575859200,3575859245,45
2,638,9210,3575859200,3575859248,48
2,638,9211,3575859200,3575859249,49
2,638,9212,3575859200,3575859249,49
2,639,9213,3575859255,3575859255,0
2,639,9214,3575859255,3575859256,1
2,639,9215,3575859255,3575859256,1
2,639,9216,3575859255,3575859259,4
2,639,9217,3575859255,3575859259,4
2,639,9218,3575859255,3575859260,5
2,639,9219,3575859255,3575859260,5
2,639,9220,3575859255,3575859263,8
2,639,9221,3575859255,3575859268,13
2,639,9222,3575859255,3575859269,14
2,639,9223,3575859255,3575859273,18
2,639,9224,3575859255,3575859273,18
2,639,9225,3575859255,3575859274,19
2,639,9226,3575859255,3575859279,24
2,639,9227,3575859255,3575859279,24
2,639,9228,3575859255,3575859280,25
2,639,9229,3575859255,3575859281,26
2,639,9230,3575859255,3575859281,26
2,639,9231,3575859255,3575859283,28
2,639,9232,3575859255,3575859283,28
2,639,9233,3575859255,3575859286,31
2,639,9234,3575859255,3575859286,31
2,639,9235,3575859255,3575859288,33
2,639,9236,3575859255,3575859288,33
2,639,9237,3575859255,3575859288,33
2,639,9238,3575859255,3575859291,36
2,639,9239,3575859255,3575859291,36
2,639,9240,3575859255,3575859291,36
2,639,9241,3575859255,3575859292,37
2,639,9242,3575859255,3575859293,38
2,639,9243,3575859255,3575859294,39
2,639,9244,3575859255,3575859295,40
2,639,9245,3575859255,3575859299,44
2,639,9246,3575859255,3575859301,46
2,639,9247,3575859255,3575859301,46
2,639,9248,3575859255,3575859303,48
2,639,9249,3575859255,3575859303,48
2,639,9250,3575859255,3575859303,48
2,639,9251,3575859255,3575859304,49
2,640,9252,3575859310,3575859310,0
2,640,9253,3575859310,3575859310,0
2,640,9254,3575859310,3575859310,0
2,640,9255,3575859310,3575859310,0
2,640,9256,3575859310,3575859311,1
2,640,9257,3575859310,3575859312,2
2,640,9258,3575859310,3575859314,4
2,640,9259,3575859310,3575859314,4
2,640,9260,3575859310,3575859315,5
2,640,9261,3575859310,3575859316,6
2,640,9262,3575859310,3575859316,6
2,640,9263,3575859310,3575859317,7
2,640,9264,3575859310,3575859317,7
2,640,9265,3575859310,3575859320,10
2,640,9266,3575859310,3575859321,11
2,640,9267,3575859310,3575859323,13
2,640,9268,3575859310,3575859324,14
2,640,9269,3575859310,3575859327,17
2,640,9270,3575859310,3575859327,17
2,640,9271,3575859310,3575859328,18
2,640,9272,3575859310,3575859329,19
2,640,9273,3575859310,3575859331,21
2,640,9274,3575859310,3575859331,21
2,640,9275,3575859310,3575859332,22
2,640,9276,3575859310,3575859334,24
2,640,9277,3575859310,3575859335,25
2,640,9278,3575859310,3575859338,28
2,640,9279,3575859310,3575859338,28
2,640,9280,3575859310,3575859342,32
2,640,9281,3575859310,3575859342,32
2,640,9282,3575859310,3575859342,32
2,640,9283,3575859310,3575859345,35
2,640,9284,3575859310,3575859346,36
2,640,9285,3575859310,3575859347,37
2,640,9286,3575859310,3575859348,38
2,640,9287,3575859310,3575859349,39
2,640,9288,3575859310,3575859351,41
2,640,9289,3575859310,3575859352,42
2,640,9290,3575859310,3575859352,42
2,640,9291,3575859310,3575859353,43
2,640,9292,3575859310,3575859359,49
2,640,9293,3575859310,3575859360,50
2,641,9294,3575859365,3575859365,0
2,641,9295,3575859365,3575859365,0
2,641,9296,3575859365,3575859365,0
2,641,9297,3575859365,3575859366,1
2,641,9298,3575859365,3575859367,2
2,641,9299,3575859365,3575859368,3
2,641,9300,3575859365,3575859369,4
2,641,9301,3575859365,3575859370,5
2,641,9302,3575859365,3575859372,7
2,641,9303,3575859365,3575859378,13
2,641,9304,3575859365,3575859379,14
2,641,9305,3575859365,3575859379,14
2,641,9306,3575859365,3575859381,16
2,641,9307,3575859365,3575859383,18
2,641,9308,3575859365,3575859384,19
2,641,9309,3575859365,3575859385,20
2,641,9310,3575859365,3575859386,21
2,641,9311,3575859365,3575859386,21
2,641,9312,3575859365,3575859388,23
2,641,9313,3575859365,3575859388,23
2,641,9314,3575859365,3575859389,24
2,641,9315,3575859365,3575859391,26
2,641,9316,3575859365,3575859392,27
2,641,9317,3575859365,3575859394,29
2,641,9318,3575859365,3575859399,34
2,641,9319,3575859365,3575859399,34
2,641,9320,3575859365,3575859400,35
2,641,9321,3575859365,3575859402,37
2,641,9322,3575859365,3575859403,38
2,641,9323,3575859365,3575859404,39
2,641,9324,3575859365,3575859404,39
2,641,9325,3575859365,3575859406,41
2,641,9326,3575859365,3575859410,45
2,641,9327,3575859365,3575859410,45
2,641,9328,3575859365,3575859411,46
2,641,9329,3575859365,3575859411,46
2,641,9330,3575859365,3575859412,47
2,641,9331,3575859365,3575859415,50
2,642,9332,3575859419,3575859419,0
2,642,9333,3575859419,3575859420,1
2,642,9334,3575859419,3575859420,1
2,642,9335,3575859419,3575859421,2
2,642,9336,3575859419,3575859424,5
2,642,9337,3575859419,3575859424,5
2,642,9338,3575859419,3575859424,5
2,642,9339,3575859419,3575859426,7
2,642,9340,3575859419,3575859427,8
2,642,9341,3575859419,3575859429,10
2,642,9342,3575859419,3575859435,16
2,642,9343,3575859419,3575859436,17
2,642,9344,3575859419,3575859436,17
2,642,9345,3575859419,3575859438,19
2,642,9346,3575859419,3575859438,19
2,642,9347,3575859419,3575859440,21
2,642,9348,3575859419,3575859442,23
2,642,9349,3575859419,3575859443,24
2,642,9350,3575859419,3575859444,25
2,642,9351,3575859419,3575859445,26
2,642,9352,3575859419,3575859445,26
2,642,9353,3575859419,3575859449,30
2,642,9354,3575859419,3575859450,31
2,642,9355,3575859419,3575859450,31
2,642,9356,3575859419,3575859451,32
2,642,9357,3575859419,3575859456,37
2,642,9358,3575859419,3575859456,37
2,642,9359,3575859419,3575859457,38
2,642,9360,3575859419,3575859459,40
2,642,9361,3575859419,3575859460,41
2,642,9362,3575859419,3575859460,41
2,642,9363,3575859419,3575859461,42
2,642,9364,3575859419,3575859463,44
2,642,9365,3575859419,3575859469,50
2,643,9366,3575859476,3575859476,0
2,643,9367,3575859476,3575859476,0
2,643,9368,3575859476,3575859476,0
2,643,9369,3575859476,3575859476,0
2,643,9370,3575859476,3575859479,3
2,643,9371,3575859476,3575859479,3
2,643,9372,3575859476,3575859479,3
2,643,9373,3575859476,3575859480,4
2,643,9374,3575859476,3575859480,4
2,643,9375,3575859476,3575859482,6
2,643,9376,3575859476,3575859483,7
2,643,9377,3575859476,3575859486,10
2,643,9378,3575859476,3575859486,10
2,643,9379,3575859476,3575859488,12
2,643,9380,3575859476,3575859488,12
2,643,9381,3575859476,3575859488,12
2,643,9382,3575859476,3575859490,14
2,643,9383,3575859476,3575859491,15
2,643,9384,3575859476,3575859491,15
2,643,9385,3575859476,3575859492,16
2,643,9386,3575859476,3575859493,17
2,643,9387,3575859476,3575859494,18
2,643,9388,3575859476,3575859494,18
2,643,9389,3575859476,3575859499,23
2,643,9390,3575859476,3575859500,24
2,643,9391,3575859476,3575859500,24
2,643,9392,3575859476,3575859502,26
2,643,9393,3575859476,3575859503,27
2,643,9394,3575859476,3575859503,27
2,643,9395,3575859476,3575859503,27
2,643,9396,3575859476,3575859505,29
2,643,9397,3575859476,3575859506,30
2,643,9398,3575859476,3575859508,32
2,643,9399,3575859476,3575859510,34
2,643,9400,3575859476,3575859512,36
2,643,9401,3575859476,3575859513,37
2,643,9402,3575859476,3575859514,38
2,643,9403,3575859476,3575859514,38
2,643,9404,3575859476,3575859514,38
2,643,9405,3575859476,3575859516,40
2,643,9406,3575859476,3575859516,40
2,643,9407,3575859476,3575859516,40
2,643,9408,3575859476,3575859517,41
2,643,9409,3575859476,3575859519,43
2,643,9410,3575859476,3575859521,45
2,643,9411,3575859476,3575859524,48
2,643,9412,3575859476,3575859524,48
2,643,9413,3575859476,3575859526,50
2,644,9414,3575859532,3575859532,0
2,644,9415,3575859532,3575859532,0
2,644,9416,3575859532,3575859532,0
2,644,9417,3575859532,3575859532,0
2,644,9418,3575859532,3575859532,0
2,644,9419,3575859532,3575859532,0
2,644,9420,3575859532,3575859533,1
2,644,9421,3575859532,3575859534,2
2,644,9422,3575859532,3575859537,5
2,644,9423,3575859532,3575859538,6
2,644,9424,3575859532,3575859540,8
2,644,9425,3575859532,3575859540,8
2,644,9426,3575859532,3575859541,9
2,644,9427,3575859532,3575859541,9
2,644,9428,3575859532,3575859544,12
2,644,9429,3575859532,3575859545,13
2,644,9430,3575859532,3575859546,14
2,644,9431,3575859532,3575859546,14
2,644,9432,3575859532,3575859548,16
2,644,9433,3575859532,3575859549,17
2,644,9434,3575859532,3575859549,17
2,644,9435,3575859532,3575859551,19
2,644,9436,3575859532,3575859552,20
2,644,9437,3575859532,3575859558,26
2,644,9438,3575859532,3575859559,27
2,644,9439,3575859532,3575859559,27
2,644,9440,3575859532,3575859562,30
2,644,9441,3575859532,3575859563,31
2,644,9442,3575859532,3575859565,33
2,644,9443,3575859532,3575859566,34
2,644,9444,3575859532,3575859567,35
2,644,9445,3575859532,3575859567,35
2,644,9446,3575859532,3575859569,37
2,644,9447,3575859532,3575859571,39
2,644,9448,3575859532,3575859578,46
2,644,9449,3575859532,3575859582,50
2,645,9450,3575859587,3575859587,0
2,645,9451,3575859587,3575859587,0
2,645,9452,3575859587,3575859587,0
2,645,9453,3575859587,3575859587,0
2,645,9454,3575859587,3575859587,0
2,645,9455,3575859587,3575859588,1
2,645,9456,3575859587,3575859588,1
2,645,9457,3575859587,3575859590,3
2,645,9458,3575859587,3575859592,5
2,645,9459,3575859587,3575859592,5
2,645,9460,3575859587,3575859598,11
2,645,9461,3575859587,3575859598,11
2,645,9462,3575859587,3575859600,13
2,645,9463,3575859587,3575859601,14
2,645,9464,3575859587,3575859602,15
2,645,9465,3575859587,3575859603,16
2,645,9466,3575859587,3575859604,17
2,645,9467,3575859587,3575859605,18
2,645,9468,3575859587,3575859609,22
2,645,9469,3575859587,3575859610,23
2,645,9470,3575859587,3575859611,24
2,645,9471,3575859587,3575859611,24
2,645,9472,3575859587,3575859614,27
2,645,9473,3575859587,3575859616,29
2,645,9474,3575859587,3575859619,32
2,645,9475,3575859587,3575859620,33
2,645,9476,3575859587,3575859621,34
2,645,9477,3575859587,3575859623,36
2,645,9478,3575859587,3575859623,36
2,645,9479,3575859587,3575859624,37
2,645,9480,3575859587,3575859626,39
2,645,9481,3575859587,3575859627,40
2,645,9482,3575859587,3575859628,41
2,645,9483,3575859587,3575859628,41
2,645,9484,3575859587,3575859635,48
2,645,9485,3575859587,3575859635,48
2,645,9486,3575859587,3575859635,48
2,645,9487,3575859587,3575859637,50
2,646,9488,3575859642,3575859642,0
2,646,9489,3575859642,3575859642,0
2,646,9490,3575859642,3575859642,0
2,646,9491,3575859642,3575859642,0
2,646,9492,3575859642,3575859643,1
2,646,9493,3575859642,3575859644,2
2,646,9494,3575859642,3575859648,6
2,646,9495,3575859642,3575859649,7
2,646,9496,3575859642,3575859649,7
2,646,9497,3575859642,3575859652,10
2,646,9498,3575859642,3575859654,12
2,646,9499,3575859642,3575859655,13
2,646,9500,3575859642,3575859656,14
2,646,9501,3575859642,3575859658,16
2,646,9502,3575859642,3575859658,16
2,646,9503,3575859642,3575859660,18
2,646,9504,3575859642,3575859661,19
2,646,9505,3575859642,3575859663,21
2,646,9506,3575859642,3575859667,25
2,646,9507,3575859642,3575859672,30
2,646,9508,3575859642,3575859673,31
2,646,9509,3575859642,3575859674,32
2,646,9510,3575859642,3575859674,32
2,646,9511,3575859642,3575859679,37
2,646,9512,3575859642,3575859679,37
2,646,9513,3575859642,3575859679,37
2,646,9514,3575859642,3575859680,38
2,646,9515,3575859642,3575859680,38
2,646,9516,3575859642,3575859683,41
2,646,9517,3575859642,3575859683,41
2,646,9518,3575859642,3575859685,43
2,646,9519,3575859642,3575859687,45
2,646,9520,3575859642,3575859688,46
2,646,9521,3575859642,3575859688,46
2,646,9522,3575859642,3575859689,47
2,646,9523,3575859642,3575859690,48
2,646,9524,3575859642,3575859692,50
2,647,9525,3575859696,3575859696,0
2,647,9526,3575859696,3575859696,0
2,647,9527,3575859696,3575859696,0
2,647,9528,3575859696,3575859696,0
2,647,9529,3575859696,3575859699,3
2,647,9530,3575859696,3575859701,5
2,647,9531,3575859696,3575859701,5
2,647,9532,3575859696,3575859702,6
2,647,9533,3575859696,3575859702,6
2,647,9534,3575859696,3575859703,7
2,647,9535,3575859696,3575859703,7
2,647,9536,3575859696,3575859705,9
2,647,9537,3575859696,3575859706,10
2,647,9538,3575859696,3575859708,12
2,647,9539,3575859696,3575859709,13
2,647,9540,3575859696,3575859712,16
2,647,9541,3575859696,3575859712,16
2,647,9542,3575859696,3575859714,18
2,647,9543,3575859696,3575859714,18
2,647,9544,3575859696,3575859714,18
2,647,9545,3575859696,3575859715,19
2,647,9546,3575859696,3575859716,20
2,647,9547,3575859696,3575859716,20
2,647,9548,3575859696,3575859717,21
2,647,9549,3575859696,3575859719,23
2,647,9550,3575859696,3575859721,25
2,647,9551,3575859696,3575859723,27
2,647,9552,3575859696,3575859724,28
2,647,9553,3575859696,3575859729,33
2,647,9554,3575859696,3575859730,34
2,647,9555,3575859696,3575859730,34
2,647,9556,3575859696,3575859730,34
2,647,9557,3575859696,3575859733,37
2,647,9558,3575859696,3575859734,38
2,647,9559,3575859696,3575859737,41
2,647,9560,3575859696,3575859738,42
2,647,9561,3575859696,3575859739,43
2,647,9562,3575859696,3575859740,44
2,647,9563,3575859696,3575859742,46
2,647,9564,3575859696,3575859742,46
2,647,9565,3575859696,3575859744,48
2,647,9566,3575859696,3575859745,49
2,647,9567,3575859696,3575859745,49
2,647,9568,3575859696,3575859746,50
2,648,9569,3575859753,3575859753,0
2,648,9570,3575859753,3575859753,0
2,648,9571,3575859753,3575859753,0
2,648,9572,3575859753,3575859753,0
2,648,9573,3575859753,3575859753,0
2,648,9574,3575859753,3575859758,5
2,648,9575,3575859753,3575859759,6
2,648,9576,3575859753,3575859759,6
2,648,9577,3575859753,3575859762,9
2,648,9578,3575859753,3575859763,10
2,648,9579,3575859753,3575859766,13
2,648,9580,3575859753,3575859766,13
2,648,9581,3575859753,3575859767,14
2,648,9582,3575859753,3575859769,16
2,648,9583,3575859753,3575859769,16
2,648,9584,3575859753,3575859772,19
2,648,9585,3575859753,3575859777,24
2,648,9586,3575859753,3575859778,25
2,648,9587,3575859753,3575859779,26
2,648,9588,3575859753,3575859780,27
2,648,9589,3575859753,3575859782,29
2,648,9590,3575859753,3575859784,31
2,648,9591,3575859753,3575859784,31
2,648,9592,3575859753,3575859785,32
2,648,9593,3575859753,3575859786,33
2,648,9594,3575859753,3575859787,34
2,648,9595,3575859753,3575859788,35
2,648,9596,3575859753,3575859788,35
2,648,9597,3575859753,3575859790,37
2,648,9598,3575859753,3575859792,39
2,648,9599,3575859753,3575859792,39
2,648,9600,3575859753,3575859798,45
2,648,9601,3575859753,3575859798,45
2,648,9602,3575859753,3575859800,47
2,648,9603,3575859753,3575859802,49
2,648,9604,3575859753,3575859802,49
2,649,9605,3575859808,3575859808,0
2,649,9606,3575859808,3575859808,0
2,649,9607,3575859808,3575859808,0
2,649,9608,3575859808,3575859809,1
2,649,9609,3575859808,3575859810,2
2,649,9610,3575859808,3575859810,2
2,649,9611,3575859808,3575859811,3
2,649,9612,3575859808,3575859812,4
2,649,9613,3575859808,3575859813,5
2,649,9614,3575859808,3575859814,6
2,649,9615,3575859808,3575859818,10
2,649,9616,3575859808,3575859819,11
2,649,9617,3575859808,3575859820,12
2,649,9618,3575859808,3575859821,13
2,649,9619,3575859808,3575859823,15
2,649,9620,3575859808,3575859823,15
2,649,9621,3575859808,3575859824,16
2,649,9622,3575859808,3575859827,19
2,649,9623,3575859808,3575859828,20
2,649,9624,3575859808,3575859829,21
2,649,9625,3575859808,3575859835,27
2,649,9626,3575859808,3575859836,28
2,649,9627,3575859808,3575859837,29
2,649,9628,3575859808,3575859838,30
2,649,9629,3575859808,3575859839,31
2,649,9630,3575859808,3575859841,33
2,649,9631,3575859808,3575859841,33
2,649,9632,3575859808,3575859841,33
2,649,9633,3575859808,3575859844,36
2,649,9634,3575859808,3575859844,36
2,649,9635,3575859808,3575859845,37
2,649,9636,3575859808,3575859849,41
2,649,9637,3575859808,3575859849,41
2,649,9638,3575859808,3575859849,41
2,649,9639,3575859808,3575859852,44
2,649,9640,3575859808,3575859854,46
2,649,9641,3575859808,3575859855,47
2,649,9642,3575859808,3575859856,48
2,650,9643,3575859866,3575859866,0
2,650,9644,3575859866,3575859866,0
2,650,9645,3575859866,3575859866,0
2,650,9646,3575859866,3575859866,0
2,650,9647,3575859866,3575859866,0
2,650,9648,3575859866,3575859866,0
2,650,9649,3575859866,3575859867,1
2,650,9650,3575859866,3575859872,6
2,650,9651,3575859866,3575859873,7
2,650,9652,3575859866,3575859873,7
2,650,9653,3575859866,3575859874,8
2,650,9654,3575859866,3575859879,13
2,650,9655,3575859866,3575859879,13
2,650,9656,3575859866,3575859880,14
2,650,9657,3575859866,3575859880,14
2,650,9658,3575859866,3575859881,15
2,650,9659,3575859866,3575859882,16
2,650,9660,3575859866,3575859883,17
2,650,9661,3575859866,3575859886,20
2,650,9662,3575859866,3575859886,20
2,650,9663,3575859866,3575859887,21
2,650,9664,3575859866,3575859888,22
2,650,9665,3575859866,3575859888,22
2,650,9666,3575859866,3575859891,25
2,650,9667,3575859866,3575859891,25
2,650,9668,3575859866,3575859892,26
2,650,9669,3575859866,3575859893,27
2,650,9670,3575859866,3575859894,28
2,650,9671,3575859866,3575859894,28
2,650,9672,3575859866,3575859898,32
2,650,9673,3575859866,3575859901,35
2,650,9674,3575859866,3575859901,35
2,650,9675,3575859866,3575859902,36
2,650,9676,3575859866,3575859903,37
2,650,9677,3575859866,3575859903,37
2,650,9678,3575859866,3575859904,38
2,650,9679,3575859866,3575859905,39
2,650,9680,3575859866,3575859906,40
2,650,9681,3575859866,3575859908,42
2,650,9682,3575859866,3575859910,44
2,650,9683,3575859866,3575859912,46
2,650,9684,3575859866,3575859913,47
2,650,9685,3575859866,3575859914,48
2,650,9686,3575859866,3575859915,49
2,650,9687,3575859866,3575859916,50
2,651,9688,3575859922,3575859922,0
2,651,9689,3575859922,3575859922,0
2,651,9690,3575859922,3575859922,0
2,651,9691,3575859922,3575859924,2
2,651,9692,3575859922,3575859925,3
2,651,9693,3575859922,3575859930,8
2,651,9694,3575859922,3575859930,8
2,651,9695,3575859922,3575859930,8
2,651,9696,3575859922,3575859930,8
2,651,9697,3575859922,3575859930,8
2,651,9698,3575859922,3575859934,12
2,651,9699,3575859922,3575859934,12
2,651,9700,3575859922,3575859938,16
2,651,9701,3575859922,3575859938,16
2,651,9702,3575859922,3575859939,17
2,651,9703,3575859922,3575859940,18
2,651,9704,3575859922,3575859942,20
2,651,9705,3575859922,3575859942,20
2,651,9706,3575859922,3575859945,23
2,651,9707,3575859922,3575859945,23
2,651,9708,3575859922,3575859946,24
2,651,9709,3575859922,3575859946,24
2,651,9710,3575859922,3575859949,27
2,651,9711,3575859922,3575859950,28
2,651,9712,3575859922,3575859950,28
2,651,9713,3575859922,3575859952,30
2,651,9714,3575859922,3575859952,30
2,651,9715,3575859922,3575859952,30
2,651,9716,3575859922,3575859958,36
2,651,9717,3575859922,3575859959,37
2,651,9718,3575859922,3575859961,39
2,651,9719,3575859922,3575859963,41
2,651,9720,3575859922,3575859964,42
2,651,9721,3575859922,3575859965,43
2,651,9722,3575859922,3575859967,45
2,651,9723,3575859922,3575859967,45
2,651,9724,3575859922,3575859969,47
2,651,9725,3575859922,3575859970,48
2,651,9726,3575859922,3575859972,50
2,652,9727,3575859977,3575859977,0
2,652,9728,3575859977,3575859978,1
2,652,9729,3575859977,3575859979,2
2,652,9730,3575859977,3575859982,5
2,652,9731,3575859977,3575859985,8
2,652,9732,3575859977,3575859985,8
2,652,9733,3575859977,3575859985,8
2,652,9734,3575859977,3575859985,8
2,652,9735,3575859977,3575859987,10
2,652,9736,3575859977,3575859988,11
2,652,9737,3575859977,3575859989,12
2,652,9738,3575859977,3575859991,14
2,652,9739,3575859977,3575859993,16
2,652,9740,3575859977,3575859993,16
2,652,9741,3575859977,3575859998,21
2,652,9742,3575859977,3575859998,21
2,652,9743,3575859977,3575860000,23
2,652,9744,3575859977,3575860001,24
2,652,9745,3575859977,3575860002,25
2,652,9746,3575859977,3575860003,26
2,652,9747,3575859977,3575860003,26
2,652,9748,3575859977,3575860005,28
2,652,9749,3575859977,3575860010,33
2,652,9750,3575859977,3575860010,33
2,652,9751,3575859977,3575860011,34
2,652,9752,3575859977,3575860011,34
2,652,9753,3575859977,3575860013,36
2,652,9754,3575859977,3575860014,37
2,652,9755,3575859977,3575860018,41
2,652,9756,3575859977,3575860019,42
2,652,9757,3575859977,3575860020,43
2,652,9758,3575859977,3575860022,45
2,652,9759,3575859977,3575860022,45
2,652,9760,3575859977,3575860025,48
2,652,9761,3575859977,3575860025,48
2,652,9762,3575859977,3575860026,49
2,653,9763,3575860033,3575860033,0
2,653,9764,3575860033,3575860033,0
2,653,9765,3575860033,3575860035,2
2,653,9766,3575860033,3575860035,2
2,653,9767,3575860033,3575860035,2
2,653,9768,3575860033,3575860036,3
2,653,9769,3575860033,3575860037,4
2,653,9770,3575860033,3575860039,6
2,653,9771,3575860033,3575860041,8
2,653,9772,3575860033,3575860042,9
2,653,9773,3575860033,3575860042,9
2,653,9774,3575860033,3575860044,11
2,653,9775,3575860033,3575860045,12
2,653,9776,3575860033,3575860045,12
2,653,9777,3575860033,3575860049,16
2,653,9778,3575860033,3575860049,16
2,653,9779,3575860033,3575860052,19
2,653,9780,3575860033,3575860055,22
2,653,9781,3575860033,3575860055,22
2,653,9782,3575860033,3575860056,23
2,653,9783,3575860033,3575860058,25
2,653,9784,3575860033,3575860059,26
2,653,9785,3575860033,3575860060,27
2,653,9786,3575860033,3575860060,27
2,653,9787,3575860033,3575860063,30
2,653,9788,3575860033,3575860066,33
2,653,9789,3575860033,3575860067,34
2,653,9790,3575860033,3575860072,39
2,653,9791,3575860033,3575860073,40
2,653,9792,3575860033,3575860074,41
2,653,9793,3575860033,3575860074,41
2,653,9794,3575860033,3575860079,46
2,653,9795,3575860033,3575860079,46
2,653,9796,3575860033,3575860080,47
2,653,9797,3575860033,3575860081,48
2,653,9798,3575860033,3575860082,49
2,653,9799,3575860033,3575860083,50
2,654,9800,3575860090,3575860090,0
2,654,9801,3575860090,3575860090,0
2,654,9802,3575860090,3575860090,0
2,654,9803,3575860090,3575860090,0
2,654,9804,3575860090,3575860090,0
2,654,9805,3575860090,3575860092,2
2,654,9806,3575860090,3575860092,2
2,654,9807,3575860090,3575860092,2
2,654,9808,3575860090,3575860093,3
2,654,9809,3575860090,3575860094,4
2,654,9810,3575860090,3575860095,5
2,654,9811,3575860090,3575860098,8
2,654,9812,3575860090,3575860101,11
2,654,9813,3575860090,3575860102,12
2,654,9814,3575860090,3575860102,12
2,654,9815,3575860090,3575860103,13
2,654,9816,3575860090,3575860103,13
2,654,9817,3575860090,3575860105,15
2,654,9818,3575860090,3575860106,16
2,654,9819,3575860090,3575860108,18
2,654,9820,3575860090,3575860110,20
2,654,9821,3575860090,3575860112,22
2,654,9822,3575860090,3575860113,23
2,654,9823,3575860090,3575860114,24
2,654,9824,3575860090,3575860115,25
2,654,9825,3575860090,3575860115,25
2,654,9826,3575860090,3575860115,25
2,654,9827,3575860090,3575860116,26
2,654,9828,3575860090,3575860117,27
2,654,9829,3575860090,3575860117,27
2,654,9830,3575860090,3575860121,31
2,654,9831,3575860090,3575860124,34
2,654,9832,3575860090,3575860125,35
2,654,9833,3575860090,3575860127,37
2,654,9834,3575860090,3575860130,40
2,654,9835,3575860090,3575860130,40
2,654,9836,3575860090,3575860130,40
2,654,9837,3575860090,3575860131,41
2,654,9838,3575860090,3575860131,41
2,654,9839,3575860090,3575860134,44
2,654,9840,3575860090,3575860134,44
2,654,9841,3575860090,3575860138,48
2,654,9842,3575860090,3575860138,48
2,654,9843,3575860090,3575860140,50
2,655,9844,3575860145,3575860145,0
2,655,9845,3575860145,3575860145,0
2,655,9846,3575860145,3575860145,0
2,655,9847,3575860145,3575860145,0
2,655,9848,3575860145,3575860145,0
2,655,9849,3575860145,3575860146,1
2,655,9850,3575860145,3575860146,1
2,655,9851,3575860145,3575860147,2
2,655,9852,3575860145,3575860149,4
2,655,9853,3575860145,3575860149,4
2,655,9854,3575860145,3575860150,5
2,655,9855,3575860145,3575860151,6
2,655,9856,3575860145,3575860152,7
2,655,9857,3575860145,3575860152,7
2,655,9858,3575860145,3575860158,13
2,655,9859,3575860145,3575860159,14
2,655,9860,3575860145,3575860160,15
2,655,9861,3575860145,3575860163,18
2,655,9862,3575860145,3575860164,19
2,655,9863,3575860145,3575860165,20
2,655,9864,3575860145,3575860167,22
2,655,9865,3575860145,3575860168,23
2,655,9866,3575860145,3575860169,24
2,655,9867,3575860145,3575860170,25
2,655,9868,3575860145,3575860177,32
2,655,9869,3575860145,3575860178,33
2,655,9870,3575860145,3575860180,35
2,655,9871,3575860145,3575860181,36
2,655,9872,3575860145,3575860183,38
2,655,9873,3575860145,3575860184,39
2,655,9874,3575860145,3575860185,40
2,655,9875,3575860145,3575860185,40
2,655,9876,3575860145,3575860185,40
2,655,9877,3575860145,3575860188,43
2,655,9878,3575860145,3575860188,43
2,655,9879,3575860145,3575860189,44
2,655,9880,3575860145,3575860191,46
2,655,9881,3575860145,3575860193,48
2,655,9882,3575860145,3575860193,48
2,656,9883,3575860201,3575860201,0
2,656,9884,3575860201,3575860201,0
2,656,9885,3575860201,3575860201,0
2,656,9886,3575860201,3575860202,1
2,656,9887,3575860201,3575860202,1
2,656,9888,3575860201,3575860204,3
2,656,9889,3575860201,3575860204,3
2,656,9890,3575860201,3575860209,8
2,656,9891,3575860201,3575860210,9
2,656,9892,3575860201,3575860211,10
2,656,9893,3575860201,3575860211,10
2,656,9894,3575860201,3575860214,13
2,656,9895,3575860201,3575860214,13
2,656,9896,3575860201,3575860218,17
2,656,9897,3575860201,3575860218,17
2,656,9898,3575860201,3575860220,19
2,656,9899,3575860201,3575860220,19
2,656,9900,3575860201,3575860221,20
2,656,9901,3575860201,3575860222,21
2,656,9902,3575860201,3575860225,24
2,656,9903,3575860201,3575860225,24
2,656,9904,3575860201,3575860226,25
2,656,9905,3575860201,3575860228,27
2,656,9906,3575860201,3575860229,28
2,656,9907,3575860201,3575860230,29
2,656,9908,3575860201,3575860235,34
2,656,9909,3575860201,3575860236,35
2,656,9910,3575860201,3575860236,35
2,656,9911,3575860201,3575860236,35
2,656,9912,3575860201,3575860237,36
2,656,9913,3575860201,3575860239,38
2,656,9914,3575860201,3575860242,41
2,656,9915,3575860201,3575860242,41
2,656,9916,3575860201,3575860242,41
2,656,9917,3575860201,3575860244,43
2,656,9918,3575860201,3575860245,44
2,656,9919,3575860201,3575860246,45
2,656,9920,3575860201,3575860249,48
2,656,9921,3575860201,3575860249,48
2,657,9922,3575860256,3575860256,0
2,657,9923,3575860256,3575860256,0
2,657,9924,3575860256,3575860256,0
2,657,9925,3575860256,3575860256,0
2,657,9926,3575860256,3575860259,3
2,657,9927,3575860256,3575860260,4
2,657,9928,3575860256,3575860260,4
2,657,9929,3575860256,3575860261,5
2,657,9930,3575860256,3575860264,8
2,657,9931,3575860256,3575860266,10
2,657,9932,3575860256,3575860268,12
2,657,9933,3575860256,3575860273,17
2,657,9934,3575860256,3575860273,17
2,657,9935,3575860256,3575860274,18
2,657,9936,3575860256,3575860275,19
2,657,9937,3575860256,3575860279,23
2,657,9938,3575860256,3575860279,23
2,657,9939,3575860256,3575860281,25
2,657,9940,3575860256,3575860282,26
2,657,9941,3575860256,3575860282,26
2,657,9942,3575860256,3575860286,30
2,657,9943,3575860256,3575860287,31
2,657,9944,3575860256,3575860288,32
2,657,9945,3575860256,3575860289,33
2,657,9946,3575860256,3575860289,33
2,657,9947,3575860256,3575860291,35
2,657,9948,3575860256,3575860292,36
2,657,9949,3575860256,3575860292,36
2,657,9950,3575860256,3575860293,37
2,657,9951,3575860256,3575860294,38
2,657,9952,3575860256,3575860295,39
2,657,9953,3575860256,3575860299,43
2,657,9954,3575860256,3575860302,46
2,657,9955,3575860256,3575860302,46
2,657,9956,3575860256,3575860303,47
2,657,9957,3575860256,3575860303,47
2,657,9958,3575860256,3575860303,47
2,657,9959,3575860256,3575860303,47
2,657,9960,3575860256,3575860305,49
2,657,9961,3575860256,3575860306,50
2,658,9962,3575860309,3575860309,0
2,658,9963,3575860309,3575860310,1
2,658,9964,3575860309,3575860312,3
2,658,9965,3575860309,3575860312,3
2,658,9966,3575860309,3575860315,6
2,658,9967,3575860309,3575860315,6
2,658,9968,3575860309,3575860315,6
2,658,9969,3575860309,3575860316,7
2,658,9970,3575860309,3575860316,7
2,658,9971,3575860309,3575860317,8
2,658,9972,3575860309,3575860317,8
2,658,9973,3575860309,3575860320,11
2,658,9974,3575860309,3575860321,12
2,658,9975,3575860309,3575860324,15
2,658,9976,3575860309,3575860327,18
2,658,9977,3575860309,3575860327,18
2,658,9978,3575860309,3575860329,20
2,658,9979,3575860309,3575860330,21
2,658,9980,3575860309,3575860330,21
2,658,9981,3575860309,3575860331,22
2,658,9982,3575860309,3575860334,25
2,658,9983,3575860309,3575860335,26
2,658,9984,3575860309,3575860338,29
2,658,9985,3575860309,3575860340,31
2,658,9986,3575860309,3575860340,31
2,658,9987,3575860309,3575860342,33
2,658,9988,3575860309,3575860342,33
2,658,9989,3575860309,3575860346,37
2,658,9990,3575860309,3575860346,37
2,658,9991,3575860309,3575860346,37
2,658,9992,3575860309,3575860347,38
2,658,9993,3575860309,3575860348,39
2,658,9994,3575860309,3575860349,40
2,658,9995,3575860309,3575860350,41
2,658,9996,3575860309,3575860350,41
2,658,9997,3575860309,3575860351,42
2,658,9998,3575860309,3575860351,42
2,658,9999,3575860309,3575860352,43
2,658,10000,3575860309,3575860358,49
2,658,10001,3575860309,3575860359,50
2,659,10002,3575860365,3575860365,0
2,659,10003,3575860365,3575860365,0
2,659,10004,3575860365,3575860365,0
2,659,10005,3575860365,3575860365,0
2,659,10006,3575860365,3575860367,2
2,659,10007,3575860365,3575860368,3
2,659,10008,3575860365,3575860369,4
2,659,10009,3575860365,3575860370,5
2,659,10010,3575860365,3575860378,13
2,659,10011,3575860365,3575860379,14
2,659,10012,3575860365,3575860380,15
2,659,10013,3575860365,3575860383,18
2,659,10014,3575860365,3575860384,19
2,659,10015,3575860365,3575860385,20
2,659,10016,3575860365,3575860385,20
2,659,10017,3575860365,3575860386,21
2,659,10018,3575860365,3575860388,23
2,659,10019,3575860365,3575860389,24
2,659,10020,3575860365,3575860390,25
2,659,10021,3575860365,3575860391,26
2,659,10022,3575860365,3575860393,28
2,659,10023,3575860365,3575860394,29
2,659,10024,3575860365,3575860398,33
2,659,10025,3575860365,3575860399,34
2,659,10026,3575860365,3575860400,35
2,659,10027,3575860365,3575860402,37
2,659,10028,3575860365,3575860402,37
2,659,10029,3575860365,3575860404,39
2,659,10030,3575860365,3575860405,40
2,659,10031,3575860365,3575860410,45
2,659,10032,3575860365,3575860410,45
2,659,10033,3575860365,3575860411,46
2,659,10034,3575860365,3575860411,46
2,659,10035,3575860365,3575860414,49
2,659,10036,3575860365,3575860414,49
2,660,10037,3575860420,3575860420,0
2,660,10038,3575860420,3575860420,0
2,660,10039,3575860420,3575860421,1
2,660,10040,3575860420,3575860421,1
2,660,10041,3575860420,3575860421,1
2,660,10042,3575860420,3575860424,4
2,660,10043,3575860420,3575860425,5
2,660,10044,3575860420,3575860425,5
2,660,10045,3575860420,3575860426,6
2,660,10046,3575860420,3575860428,8
2,660,10047,3575860420,3575860429,9
2,660,10048,3575860420,3575860430,10
2,660,10049,3575860420,3575860435,15
2,660,10050,3575860420,3575860436,16
2,660,10051,3575860420,3575860436,16
2,660,10052,3575860420,3575860437,17
2,660,10053,3575860420,3575860438,18
2,660,10054,3575860420,3575860440,20
2,660,10055,3575860420,3575860442,22
2,660,10056,3575860420,3575860442,22
2,660,10057,3575860420,3575860442,22
2,660,10058,3575860420,3575860445,25
2,660,10059,3575860420,3575860446,26
2,660,10060,3575860420,3575860449,29
2,660,10061,3575860420,3575860449,29
2,660,10062,3575860420,3575860450,30
2,660,10063,3575860420,3575860452,32
2,660,10064,3575860420,3575860455,35
2,660,10065,3575860420,3575860455,35
2,660,10066,3575860420,3575860456,36
2,660,10067,3575860420,3575860459,39
2,660,10068,3575860420,3575860459,39
2,660,10069,3575860420,3575860460,40
2,660,10070,3575860420,3575860462,42
2,660,10071,3575860420,3575860464,44
2,660,10072,3575860420,3575860467,47
2,660,10073,3575860420,3575860468,48
2,661,10074,3575860475,3575860475,0
2,661,10075,3575860475,3575860475,0
2,661,10076,3575860475,3575860475,0
2,661,10077,3575860475,3575860475,0
2,661,10078,3575860475,3575860478,3
2,661,10079,3575860475,3575860478,3
2,661,10080,3575860475,3575860479,4
2,661,10081,3575860475,3575860481,6
2,661,10082,3575860475,3575860481,6
2,661,10083,3575860475,3575860481,6
2,661,10084,3575860475,3575860485,10
2,661,10085,3575860475,3575860486,11
2,661,10086,3575860475,3575860487,12
2,661,10087,3575860475,3575860488,13
2,661,10088,3575860475,3575860489,14
2,661,10089,3575860475,3575860490,15
2,661,10090,3575860475,3575860491,16
2,661,10091,3575860475,3575860492,17
2,661,10092,3575860475,3575860492,17
2,661,10093,3575860475,3575860493,18
2,661,10094,3575860475,3575860494,19
2,661,10095,3575860475,3575860494,19
2,661,10096,3575860475,3575860498,23
2,661,10097,3575860475,3575860501,26
2,661,10098,3575860475,3575860501,26
2,661,10099,3575860475,3575860502,27
2,661,10100,3575860475,3575860503,28
2,661,10101,3575860475,3575860503,28
2,661,10102,3575860475,3575860503,28
2,661,10103,3575860475,3575860504,29
2,661,10104,3575860475,3575860505,30
2,661,10105,3575860475,3575860508,33
2,661,10106,3575860475,3575860509,34
2,661,10107,3575860475,3575860511,36
2,661,10108,3575860475,3575860512,37
2,661,10109,3575860475,3575860513,38
2,661,10110,3575860475,3575860514,39
2,661,10111,3575860475,3575860514,39
2,661,10112,3575860475,3575860514,39
2,661,10113,3575860475,3575860517,42
2,661,10114,3575860475,3575860517,42
2,661,10115,3575860475,3575860517,42
2,661,10116,3575860475,3575860518,43
2,661,10117,3575860475,3575860519,44
2,661,10118,3575860475,3575860521,46
2,661,10119,3575860475,3575860524,49
2,662,10120,3575860531,3575860531,0
2,662,10121,3575860531,3575860531,0
2,662,10122,3575860531,3575860531,0
2,662,10123,3575860531,3575860531,0
2,662,10124,3575860531,3575860531,0
2,662,10125,3575860531,3575860534,3
2,662,10126,3575860531,3575860538,7
2,662,10127,3575860531,3575860538,7
2,662,10128,3575860531,3575860539,8
2,662,10129,3575860531,3575860541,10
2,662,10130,3575860531,3575860542,11
2,662,10131,3575860531,3575860544,13
2,662,10132,3575860531,3575860545,14
2,662,10133,3575860531,3575860545,14
2,662,10134,3575860531,3575860548,17
2,662,10135,3575860531,3575860548,17
2,662,10136,3575860531,3575860548,17
2,662,10137,3575860531,3575860549,18
2,662,10138,3575860531,3575860550,19
2,662,10139,3575860531,3575860551,20
2,662,10140,3575860531,3575860551,20
2,662,10141,3575860531,3575860558,27
2,662,10142,3575860531,3575860558,27
2,662,10143,3575860531,3575860560,29
2,662,10144,3575860531,3575860562,31
2,662,10145,3575860531,3575860564,33
2,662,10146,3575860531,3575860564,33
2,662,10147,3575860531,3575860567,36
2,662,10148,3575860531,3575860567,36
2,662,10149,3575860531,3575860567,36
2,662,10150,3575860531,3575860569,38
2,662,10151,3575860531,3575860571,40
2,662,10152,3575860531,3575860573,42
2,662,10153,3575860531,3575860577,46
2,662,10154,3575860531,3575860578,47
2,662,10155,3575860531,3575860580,49
2,662,10156,3575860531,3575860580,49
2,663,10157,3575860587,3575860587,0
2,663,10158,3575860587,3575860587,0
2,663,10159,3575860587,3575860587,0
2,663,10160,3575860587,3575860587,0
2,663,10161,3575860587,3575860587,0
2,663,10162,3575860587,3575860587,0
2,663,10163,3575860587,3575860588,1
2,663,10164,3575860587,3575860590,3
2,663,10165,3575860587,3575860590,3
2,663,10166,3575860587,3575860591,4
2,663,10167,3575860587,3575860593,6
2,663,10168,3575860587,3575860598,11
2,663,10169,3575860587,3575860598,11
2,663,10170,3575860587,3575860600,13
2,663,10171,3575860587,3575860600,13
2,663,10172,3575860587,3575860601,14
2,663,10173,3575860587,3575860603,16
2,663,10174,3575860587,3575860604,17
2,663,10175,3575860587,3575860604,17
2,663,10176,3575860587,3575860609,22
2,663,10177,3575860587,3575860609,22
2,663,10178,3575860587,3575860610,23
2,663,10179,3575860587,3575860610,23
2,663,10180,3575860587,3575860612,25
2,663,10181,3575860587,3575860613,26
2,663,10182,3575860587,3575860614,27
2,663,10183,3575860587,3575860617,30
2,663,10184,3575860587,3575860620,33
2,663,10185,3575860587,3575860621,34
2,663,10186,3575860587,3575860621,34
2,663,10187,3575860587,3575860622,35
2,663,10188,3575860587,3575860624,37
2,663,10189,3575860587,3575860625,38
2,663,10190,3575860587,3575860625,38
2,663,10191,3575860587,3575860627,40
2,663,10192,3575860587,3575860628,41
2,663,10193,3575860587,3575860634,47
2,663,10194,3575860587,3575860634,47
2,663,10195,3575860587,3575860634,47
2,663,10196,3575860587,3575860636,49
2,663,10197,3575860587,3575860636,49
2,664,10198,3575860644,3575860644,0
2,664,10199,3575860644,3575860644,0
2,664,10200,3575860644,3575860644,0
2,664,10201,3575860644,3575860644,0
2,664,10202,3575860644,3575860645,1
2,664,10203,3575860644,3575860645,1
2,664,10204,3575860644,3575860648,4
2,664,10205,3575860644,3575860648,4
2,664,10206,3575860644,3575860649,5
2,664,10207,3575860644,3575860652,8
2,664,10208,3575860644,3575860654,10
2,664,10209,3575860644,3575860655,11
2,664,10210,3575860644,3575860655,11
2,664,10211,3575860644,3575860658,14
2,664,10212,3575860644,3575860658,14
2,664,10213,3575860644,3575860660,16
2,664,10214,3575860644,3575860661,17
2,664,10215,3575860644,3575860663,19
2,664,10216,3575860644,3575860666,22
2,664,10217,3575860644,3575860667,23
2,664,10218,3575860644,3575860673,29
2,664,10219,3575860644,3575860674,30
2,664,10220,3575860644,3575860674,30
2,664,10221,3575860644,3575860675,31
2,664,10222,3575860644,3575860678,34
2,664,10223,3575860644,3575860680,36
2,664,10224,3575860644,3575860681,37
2,664,10225,3575860644,3575860681,37
2,664,10226,3575860644,3575860682,38
2,664,10227,3575860644,3575860685,41
2,664,10228,3575860644,3575860685,41
2,664,10229,3575860644,3575860687,43
2,664,10230,3575860644,3575860688,44
2,664,10231,3575860644,3575860689,45
2,664,10232,3575860644,3575860690,46
2,664,10233,3575860644,3575860691,47
2,664,10234,3575860644,3575860692,48
2,664,10235,3575860644,3575860692,48
2,664,10236,3575860644,3575860693,49
2,664,10237,3575860644,3575860694,50
2,665,10238,3575860700,3575860700,0
2,665,10239,3575860700,3575860701,1
2,665,10240,3575860700,3575860701,1
2,665,10241,3575860700,3575860703,3
2,665,10242,3575860700,3575860703,3
2,665,10243,3575860700,3575860703,3
2,665,10244,3575860700,3575860705,5
2,665,10245,3575860700,3575860708,8
2,665,10246,3575860700,3575860710,10
2,665,10247,3575860700,3575860710,10
2,665,10248,3575860700,3575860711,11
2,665,10249,3575860700,3575860712,12
2,665,10250,3575860700,3575860713,13
2,665,10251,3575860700,3575860714,14
2,665,10252,3575860700,3575860714,14
2,665,10253,3575860700,3575860714,14
2,665,10254,3575860700,3575860716,16
2,665,10255,3575860700,3575860717,17
2,665,10256,3575860700,3575860718,18
2,665,10257,3575860700,3575860718,18
2,665,10258,3575860700,3575860719,19
2,665,10259,3575860700,3575860725,25
2,665,10260,3575860700,3575860725,25
2,665,10261,3575860700,3575860727,27
2,665,10262,3575860700,3575860727,27
2,665,10263,3575860700,3575860729,29
2,665,10264,3575860700,3575860730,30
2,665,10265,3575860700,3575860734,34
2,665,10266,3575860700,3575860734,34
2,665,10267,3575860700,3575860736,36
2,665,10268,3575860700,3575860738,38
2,665,10269,3575860700,3575860740,40
2,665,10270,3575860700,3575860741,41
2,665,10271,3575860700,3575860742,42
2,665,10272,3575860700,3575860744,44
2,665,10273,3575860700,3575860745,45
2,665,10274,3575860700,3575860745,45
2,665,10275,3575860700,3575860748,48
2,665,10276,3575860700,3575860749,49
2,665,10277,3575860700,3575860749,49
2,665,10278,3575860700,3575860749,49
2,665,10279,3575860700,3575860750,50
2,666,10280,3575860756,3575860756,0
2,666,10281,3575860756,3575860756,0
2,666,10282,3575860756,3575860758,2
2,666,10283,3575860756,3575860758,2
2,666,10284,3575860756,3575860760,4
2,666,10285,3575860756,3575860762,6
2,666,10286,3575860756,3575860765,9
2,666,10287,3575860756,3575860765,9
2,666,10288,3575860756,3575860766,10
2,666,10289,3575860756,3575860768,12
2,666,10290,3575860756,3575860769,13
2,666,10291,3575860756,3575860769,13
2,666,10292,3575860756,3575860771,15
2,666,10293,3575860756,3575860773,17
2,666,10294,3575860756,3575860775,19
2,666,10295,3575860756,3575860776,20
2,666,10296,3575860756,3575860777,21
2,666,10297,3575860756,3575860778,22
2,666,10298,3575860756,3575860778,22
2,666,10299,3575860756,3575860780,24
2,666,10300,3575860756,3575860780,24
2,666,10301,3575860756,3575860782,26
2,666,10302,3575860756,3575860784,28
2,666,10303,3575860756,3575860784,28
2,666,10304,3575860756,3575860785,29
2,666,10305,3575860756,3575860785,29
2,666,10306,3575860756,3575860788,32
2,666,10307,3575860756,3575860789,33
2,666,10308,3575860756,3575860789,33
2,666,10309,3575860756,3575860790,34
2,666,10310,3575860756,3575860792,36
2,666,10311,3575860756,3575860792,36
2,666,10312,3575860756,3575860798,42
2,666,10313,3575860756,3575860798,42
2,666,10314,3575860756,3575860800,44
2,666,10315,3575860756,3575860801,45
2,666,10316,3575860756,3575860801,45
2,666,10317,3575860756,3575860803,47
2,666,10318,3575860756,3575860803,47
2,667,10319,3575860813,3575860813,0
2,667,10320,3575860813,3575860813,0
2,667,10321,3575860813,3575860813,0
2,667,10322,3575860813,3575860813,0
2,667,10323,3575860813,3575860813,0
2,667,10324,3575860813,3575860813,0
2,667,10325,3575860813,3575860814,1
2,667,10326,3575860813,3575860817,4
2,667,10327,3575860813,3575860820,7
2,667,10328,3575860813,3575860821,8
2,667,10329,3575860813,3575860823,10
2,667,10330,3575860813,3575860824,11
2,667,10331,3575860813,3575860825,12
2,667,10332,3575860813,3575860826,13
2,667,10333,3575860813,3575860826,13
2,667,10334,3575860813,3575860829,16
2,667,10335,3575860813,3575860835,22
2,667,10336,3575860813,3575860835,22
2,667,10337,3575860813,3575860835,22
2,667,10338,3575860813,3575860837,24
2,667,10339,3575860813,3575860837,24
2,667,10340,3575860813,3575860839,26
2,667,10341,3575860813,3575860841,28
2,667,10342,3575860813,3575860841,28
2,667,10343,3575860813,3575860842,29
2,667,10344,3575860813,3575860844,31
2,667,10345,3575860813,3575860845,32
2,667,10346,3575860813,3575860845,32
2,667,10347,3575860813,3575860849,36
2,667,10348,3575860813,3575860849,36
2,667,10349,3575860813,3575860850,37
2,667,10350,3575860813,3575860851,38
2,667,10351,3575860813,3575860855,42
2,667,10352,3575860813,3575860855,42
2,667,10353,3575860813,3575860856,43
2,667,10354,3575860813,3575860858,45
2,667,10355,3575860813,3575860859,46
2,667,10356,3575860813,3575860860,47
2,667,10357,3575860813,3575860860,47
2,668,10358,3575860869,3575860869,0
2,668,10359,3575860869,3575860869,0
2,668,10360,3575860869,3575860869,0
2,668,10361,3575860869,3575860874,5
2,668,10362,3575860869,3575860874,5
2,668,10363,3575860869,3575860874,5
2,668,10364,3575860869,3575860878,9
2,668,10365,3575860869,3575860880,11
2,668,10366,3575860869,3575860880,11
2,668,10367,3575860869,3575860881,12
2,668,10368,3575860869,3575860882,13
2,668,10369,3575860869,3575860885,16
2,668,10370,3575860869,3575860886,17
2,668,10371,3575860869,3575860887,18
2,668,10372,3575860869,3575860888,19
2,668,10373,3575860869,3575860889,20
2,668,10374,3575860869,3575860891,22
2,668,10375,3575860869,3575860891,22
2,668,10376,3575860869,3575860892,23
2,668,10377,3575860869,3575860892,23
2,668,10378,3575860869,3575860893,24
2,668,10379,3575860869,3575860894,25
2,668,10380,3575860869,3575860898,29
2,668,10381,3575860869,3575860901,32
2,668,10382,3575860869,3575860901,32
2,668,10383,3575860869,3575860902,33
2,668,10384,3575860869,3575860903,34
2,668,10385,3575860869,3575860903,34
2,668,10386,3575860869,3575860904,35
2,668,10387,3575860869,3575860905,36
2,668,10388,3575860869,3575860908,39
2,668,10389,3575860869,3575860910,41
2,668,10390,3575860869,3575860911,42
2,668,10391,3575860869,3575860911,42
2,668,10392,3575860869,3575860911,42
2,668,10393,3575860869,3575860913,44
2,668,10394,3575860869,3575860914,45
2,668,10395,3575860869,3575860915,46
2,668,10396,3575860869,3575860915,46
2,668,10397,3575860869,3575860916,47
2,668,10398,3575860869,3575860916,47
2,668,10399,3575860869,3575860918,49
2,668,10400,3575860869,3575860918,49
2,668,10401,3575860869,3575860919,50
2,669,10402,3575860924,3575860924,0
2,669,10403,3575860924,3575860924,0
2,669,10404,3575860924,3575860925,1
2,669,10405,3575860924,3575860926,2
2,669,10406,3575860924,3575860927,3
2,669,10407,3575860924,3575860930,6
2,669,10408,3575860924,3575860930,6
2,669,10409,3575860924,3575860931,7
2,669,10410,3575860924,3575860934,10
2,669,10411,3575860924,3575860934,10
2,669,10412,3575860924,3575860936,12
2,669,10413,3575860924,3575860936,12
2,669,10414,3575860924,3575860938,14
2,669,10415,3575860924,3575860940,16
2,669,10416,3575860924,3575860941,17
2,669,10417,3575860924,3575860942,18
2,669,10418,3575860924,3575860942,18
2,669,10419,3575860924,3575860945,21
2,669,10420,3575860924,3575860945,21
2,669,10421,3575860924,3575860946,22
2,669,10422,3575860924,3575860948,24
2,669,10423,3575860924,3575860948,24
2,669,10424,3575860924,3575860949,25
2,669,10425,3575860924,3575860949,25
2,669,10426,3575860924,3575860951,27
2,669,10427,3575860924,3575860951,27
2,669,10428,3575860924,3575860952,28
2,669,10429,3575860924,3575860958,34
2,669,10430,3575860924,3575860958,34
2,669,10431,3575860924,3575860961,37
2,669,10432,3575860924,3575860962,38
2,669,10433,3575860924,3575860965,41
2,669,10434,3575860924,3575860966,42
2,669,10435,3575860924,3575860968,44
2,669,10436,3575860924,3575860968,44
2,669,10437,3575860924,3575860969,45
2,669,10438,3575860924,3575860969,45
2,669,10439,3575860924,3575860972,48
2,669,10440,3575860924,3575860974,50
2,670,10441,3575860980,3575860980,0
2,670,10442,3575860980,3575860980,0
2,670,10443,3575860980,3575860980,0
2,670,10444,3575860980,3575860980,0
2,670,10445,3575860980,3575860980,0
2,670,10446,3575860980,3575860980,0
2,670,10447,3575860980,3575860981,1
2,670,10448,3575860980,3575860983,3
2,670,10449,3575860980,3575860984,4
2,670,10450,3575860980,3575860985,5
2,670,10451,3575860980,3575860985,5
2,670,10452,3575860980,3575860986,6
2,670,10453,3575860980,3575860987,7
2,670,10454,3575860980,3575860989,9
2,670,10455,3575860980,3575860990,10
2,670,10456,3575860980,3575860990,10
2,670,10457,3575860980,3575860993,13
2,670,10458,3575860980,3575860994,14
2,670,10459,3575860980,3575860998,18
2,670,10460,3575860980,3575860999,19
2,670,10461,3575860980,3575860999,19
2,670,10462,3575860980,3575861000,20
2,670,10463,3575860980,3575861002,22
2,670,10464,3575860980,3575861002,22
2,670,10465,3575860980,3575861004,24
2,670,10466,3575860980,3575861010,30
2,670,10467,3575860980,3575861010,30
2,670,10468,3575860980,3575861010,30
2,670,10469,3575860980,3575861012,32
2,670,10470,3575860980,3575861012,32
2,670,10471,3575860980,3575861014,34
2,670,10472,3575860980,3575861014,34
2,670,10473,3575860980,3575861018,38
2,670,10474,3575860980,3575861020,40
2,670,10475,3575860980,3575861021,41
2,670,10476,3575860980,3575861025,45
2,670,10477,3575860980,3575861025,45
2,670,10478,3575860980,3575861026,46
2,670,10479,3575860980,3575861027,47
2,670,10480,3575860980,3575861030,50
2,671,10481,3575861036,3575861036,0
2,671,10482,3575861036,3575861036,0
2,671,10483,3575861036,3575861036,0
2,671,10484,3575861036,3575861038,2
2,671,10485,3575861036,3575861039,3
2,671,10486,3575861036,3575861040,4
2,671,10487,3575861036,3575861041,5
2,671,10488,3575861036,3575861043,7
2,671,10489,3575861036,3575861045,9
2,671,10490,3575861036,3575861045,9
2,671,10491,3575861036,3575861045,9
2,671,10492,3575861036,3575861048,12
2,671,10493,3575861036,3575861049,13
2,671,10494,3575861036,3575861050,14
2,671,10495,3575861036,3575861052,16
2,671,10496,3575861036,3575861054,18
2,671,10497,3575861036,3575861055,19
2,671,10498,3575861036,3575861056,20
2,671,10499,3575861036,3575861059,23
2,671,10500,3575861036,3575861059,23
2,671,10501,3575861036,3575861060,24
2,671,10502,3575861036,3575861061,25
2,671,10503,3575861036,3575861065,29
2,671,10504,3575861036,3575861066,30
2,671,10505,3575861036,3575861066,30
2,671,10506,3575861036,3575861067,31
2,671,10507,3575861036,3575861074,38
2,671,10508,3575861036,3575861075,39
2,671,10509,3575861036,3575861075,39
2,671,10510,3575861036,3575861078,42
2,671,10511,3575861036,3575861079,43
2,671,10512,3575861036,3575861079,43
2,671,10513,3575861036,3575861081,45
2,671,10514,3575861036,3575861081,45
2,671,10515,3575861036,3575861082,46
2,671,10516,3575861036,3575861083,47
2,671,10517,3575861036,3575861086,50
2,672,10518,3575861092,3575861092,0
2,672,10519,3575861092,3575861092,0
2,672,10520,3575861092,3575861092,0
2,672,10521,3575861092,3575861092,0
2,672,10522,3575861092,3575861092,0
2,672,10523,3575861092,3575861092,0
2,672,10524,3575861092,3575861092,0
2,672,10525,3575861092,3575861092,0
2,672,10526,3575861092,3575861093,1
2,672,10527,3575861092,3575861094,2
2,672,10528,3575861092,3575861095,3
2,672,10529,3575861092,3575861097,5
2,672,10530,3575861092,3575861098,6
2,672,10531,3575861092,3575861101,9
2,672,10532,3575861092,3575861101,9
2,672,10533,3575861092,3575861103,11
2,672,10534,3575861092,3575861103,11
2,672,10535,3575861092,3575861103,11
2,672,10536,3575861092,3575861104,12
2,672,10537,3575861092,3575861105,13
2,672,10538,3575861092,3575861108,16
2,672,10539,3575861092,3575861110,18
2,672,10540,3575861092,3575861111,19
2,672,10541,3575861092,3575861111,19
2,672,10542,3575861092,3575861113,21
2,672,10543,3575861092,3575861113,21
2,672,10544,3575861092,3575861114,22
2,672,10545,3575861092,3575861115,23
2,672,10546,3575861092,3575861116,24
2,672,10547,3575861092,3575861116,24
2,672,10548,3575861092,3575861116,24
2,672,10549,3575861092,3575861118,26
2,672,10550,3575861092,3575861119,27
2,672,10551,3575861092,3575861119,27
2,672,10552,3575861092,3575861120,28
2,672,10553,3575861092,3575861125,33
2,672,10554,3575861092,3575861126,34
2,672,10555,3575861092,3575861127,35
2,672,10556,3575861092,3575861127,35
2,672,10557,3575861092,3575861129,37
2,672,10558,3575861092,3575861130,38
2,672,10559,3575861092,3575861130,38
2,672,10560,3575861092,3575861130,38
2,672,10561,3575861092,3575861134,42
2,672,10562,3575861092,3575861134,42
2,672,10563,3575861092,3575861135,43
2,672,10564,3575861092,3575861136,44
2,672,10565,3575861092,3575861136,44
2,672,10566,3575861092,3575861138,46
2,672,10567,3575861092,3575861139,47
2,672,10568,3575861092,3575861140,48
2,672,10569,3575861092,3575861142,50
2,673,10570,3575861147,3575861148,1
2,673,10571,3575861147,3575861148,1
2,673,10572,3575861147,3575861148,1
2,673,10573,3575861147,3575861148,1
2,673,10574,3575861147,3575861149,2
2,673,10575,3575861147,3575861149,2
2,673,10576,3575861147,3575861150,3
2,673,10577,3575861147,3575861150,3
2,673,10578,3575861147,3575861151,4
2,673,10579,3575861147,3575861152,5
2,673,10580,3575861147,3575861158,11
2,673,10581,3575861147,3575861158,11
2,673,10582,3575861147,3575861162,15
2,673,10583,3575861147,3575861162,15
2,673,10584,3575861147,3575861165,18
2,673,10585,3575861147,3575861165,18
2,673,10586,3575861147,3575861168,21
2,673,10587,3575861147,3575861169,22
2,673,10588,3575861147,3575861169,22
2,673,10589,3575861147,3575861172,25
2,673,10590,3575861147,3575861174,27
2,673,10591,3575861147,3575861176,29
2,673,10592,3575861147,3575861177,30
2,673,10593,3575861147,3575861178,31
2,673,10594,3575861147,3575861178,31
2,673,10595,3575861147,3575861180,33
2,673,10596,3575861147,3575861181,34
2,673,10597,3575861147,3575861183,36
2,673,10598,3575861147,3575861184,37
2,673,10599,3575861147,3575861184,37
2,673,10600,3575861147,3575861185,38
2,673,10601,3575861147,3575861185,38
2,673,10602,3575861147,3575861185,38
2,673,10603,3575861147,3575861187,40
2,673,10604,3575861147,3575861189,42
2,673,10605,3575861147,3575861189,42
2,673,10606,3575861147,3575861190,43
2,673,10607,3575861147,3575861193,46
2,673,10608,3575861147,3575861194,47
2,674,10609,3575861202,3575861202,0
2,674,10610,3575861202,3575861202,0
2,674,10611,3575861202,3575861202,0
2,674,10612,3575861202,3575861202,0
2,674,10613,3575861202,3575861202,0
2,674,10614,3575861202,3575861202,0
2,674,10615,3575861202,3575861204,2
2,674,10616,3575861202,3575861204,2
2,674,10617,3575861202,3575861205,3
2,674,10618,3575861202,3575861210,8
2,674,10619,3575861202,3575861210,8
2,674,10620,3575861202,3575861210,8
2,674,10621,3575861202,3575861211,9
2,674,10622,3575861202,3575861213,11
2,674,10623,3575861202,3575861213,11
2,674,10624,3575861202,3575861215,13
2,674,10625,3575861202,3575861217,15
2,674,10626,3575861202,3575861220,18
2,674,10627,3575861202,3575861222,20
2,674,10628,3575861202,3575861224,22
2,674,10629,3575861202,3575861224,22
2,674,10630,3575861202,3575861226,24
2,674,10631,3575861202,3575861227,25
2,674,10632,3575861202,3575861230,28
2,674,10633,3575861202,3575861235,33
2,674,10634,3575861202,3575861236,34
2,674,10635,3575861202,3575861236,34
2,674,10636,3575861202,3575861239,37
2,674,10637,3575861202,3575861239,37
2,674,10638,3575861202,3575861241,39
2,674,10639,3575861202,3575861242,40
2,674,10640,3575861202,3575861242,40
2,674,10641,3575861202,3575861245,43
2,674,10642,3575861202,3575861245,43
2,674,10643,3575861202,3575861246,44
2,674,10644,3575861202,3575861248,46
2,674,10645,3575861202,3575861249,47
2,674,10646,3575861202,3575861249,47
2,674,10647,3575861202,3575861251,49
2,675,10648,3575861258,3575861258,0
2,675,10649,3575861258,3575861258,0
2,675,10650,3575861258,3575861258,0
2,675,10651,3575861258,3575861259,1
2,675,10652,3575861258,3575861260,2
2,675,10653,3575861258,3575861260,2
2,675,10654,3575861258,3575861260,2
2,675,10655,3575861258,3575861265,7
2,675,10656,3575861258,3575861266,8
2,675,10657,3575861258,3575861266,8
2,675,10658,3575861258,3575861267,9
2,675,10659,3575861258,3575861273,15
2,675,10660,3575861258,3575861275,17
2,675,10661,3575861258,3575861275,17
2,675,10662,3575861258,3575861278,20
2,675,10663,3575861258,3575861279,21
2,675,10664,3575861258,3575861279,21
2,675,10665,3575861258,3575861279,21
2,675,10666,3575861258,3575861280,22
2,675,10667,3575861258,3575861281,23
2,675,10668,3575861258,3575861281,23
2,675,10669,3575861258,3575861283,25
2,675,10670,3575861258,3575861286,28
2,675,10671,3575861258,3575861286,28
2,675,10672,3575861258,3575861286,28
2,675,10673,3575861258,3575861287,29
2,675,10674,3575861258,3575861288,30
2,675,10675,3575861258,3575861290,32
2,675,10676,3575861258,3575861290,32
2,675,10677,3575861258,3575861292,34
2,675,10678,3575861258,3575861292,34
2,675,10679,3575861258,3575861292,34
2,675,10680,3575861258,3575861293,35
2,675,10681,3575861258,3575861295,37
2,675,10682,3575861258,3575861295,37
2,675,10683,3575861258,3575861298,40
2,675,10684,3575861258,3575861298,40
2,675,10685,3575861258,3575861301,43
2,675,10686,3575861258,3575861302,44
2,675,10687,3575861258,3575861303,45
2,675,10688,3575861258,3575861303,45
2,675,10689,3575861258,3575861303,45
2,675,10690,3575861258,3575861304,46
2,675,10691,3575861258,3575861306,48
2,676,10692,3575861313,3575861313,0
2,676,10693,3575861313,3575861313,0
2,676,10694,3575861313,3575861313,0
2,676,10695,3575861313,3575861313,0
2,676,10696,3575861313,3575861313,0
2,676,10697,3575861313,3575861314,1
2,676,10698,3575861313,3575861315,2
2,676,10699,3575861313,3575861316,3
2,676,10700,3575861313,3575861316,3
2,676,10701,3575861313,3575861317,4
2,676,10702,3575861313,3575861318,5
2,676,10703,3575861313,3575861318,5
2,676,10704,3575861313,3575861321,8
2,676,10705,3575861313,3575861325,12
2,676,10706,3575861313,3575861326,13
2,676,10707,3575861313,3575861327,14
2,676,10708,3575861313,3575861327,14
2,676,10709,3575861313,3575861330,17
2,676,10710,3575861313,3575861330,17
2,676,10711,3575861313,3575861330,17
2,676,10712,3575861313,3575861331,18
2,676,10713,3575861313,3575861334,21
2,676,10714,3575861313,3575861335,22
2,676,10715,3575861313,3575861336,23
2,676,10716,3575861313,3575861336,23
2,676,10717,3575861313,3575861338,25
2,676,10718,3575861313,3575861340,27
2,676,10719,3575861313,3575861341,28
2,676,10720,3575861313,3575861342,29
2,676,10721,3575861313,3575861344,31
2,676,10722,3575861313,3575861345,32
2,676,10723,3575861313,3575861346,33
2,676,10724,3575861313,3575861346,33
2,676,10725,3575861313,3575861350,37
2,676,10726,3575861313,3575861350,37
2,676,10727,3575861313,3575861350,37
2,676,10728,3575861313,3575861352,39
2,676,10729,3575861313,3575861352,39
2,676,10730,3575861313,3575861358,45
2,676,10731,3575861313,3575861359,46
2,676,10732,3575861313,3575861362,49
2,676,10733,3575861313,3575861362,49
2,677,10734,3575861368,3575861368,0
2,677,10735,3575861368,3575861368,0
2,677,10736,3575861368,3575861368,0
2,677,10737,3575861368,3575861369,1
2,677,10738,3575861368,3575861372,4
2,677,10739,3575861368,3575861374,6
2,677,10740,3575861368,3575861377,9
2,677,10741,3575861368,3575861377,9
2,677,10742,3575861368,3575861378,10
2,677,10743,3575861368,3575861379,11
2,677,10744,3575861368,3575861380,12
2,677,10745,3575861368,3575861381,13
2,677,10746,3575861368,3575861383,15
2,677,10747,3575861368,3575861384,16
2,677,10748,3575861368,3575861384,16
2,677,10749,3575861368,3575861385,17
2,677,10750,3575861368,3575861385,17
2,677,10751,3575861368,3575861385,17
2,677,10752,3575861368,3575861385,17
2,677,10753,3575861368,3575861388,20
2,677,10754,3575861368,3575861389,21
2,677,10755,3575861368,3575861390,22
2,677,10756,3575861368,3575861391,23
2,677,10757,3575861368,3575861393,25
2,677,10758,3575861368,3575861394,26
2,677,10759,3575861368,3575861398,30
2,677,10760,3575861368,3575861399,31
2,677,10761,3575861368,3575861401,33
2,677,10762,3575861368,3575861402,34
2,677,10763,3575861368,3575861404,36
2,677,10764,3575861368,3575861405,37
2,677,10765,3575861368,3575861405,37
2,677,10766,3575861368,3575861409,41
2,677,10767,3575861368,3575861410,42
2,677,10768,3575861368,3575861410,42
2,677,10769,3575861368,3575861411,43
2,677,10770,3575861368,3575861412,44
2,677,10771,3575861368,3575861413,45
2,677,10772,3575861368,3575861415,47
2,678,10773,3575861425,3575861425,0
2,678,10774,3575861425,3575861425,0
2,678,10775,3575861425,3575861425,0
2,678,10776,3575861425,3575861425,0
2,678,10777,3575861425,3575861425,0
2,678,10778,3575861425,3575861426,1
2,678,10779,3575861425,3575861427,2
2,678,10780,3575861425,3575861430,5
2,678,10781,3575861425,3575861435,10
2,678,10782,3575861425,3575861436,11
2,678,10783,3575861425,3575861436,11
2,678,10784,3575861425,3575861438,13
2,678,10785,3575861425,3575861438,13
2,678,10786,3575861425,3575861440,15
2,678,10787,3575861425,3575861441,16
2,678,10788,3575861425,3575861442,17
2,678,10789,3575861425,3575861442,17
2,678,10790,3575861425,3575861445,20
2,678,10791,3575861425,3575861445,20
2,678,10792,3575861425,3575861446,21
2,678,10793,3575861425,3575861449,24
2,678,10794,3575861425,3575861449,24
2,678,10795,3575861425,3575861450,25
2,678,10796,3575861425,3575861452,27
2,678,10797,3575861425,3575861456,31
2,678,10798,3575861425,3575861457,32
2,678,10799,3575861425,3575861458,33
2,678,10800,3575861425,3575861459,34
2,678,10801,3575861425,3575861459,34
2,678,10802,3575861425,3575861460,35
2,678,10803,3575861425,3575861462,37
2,678,10804,3575861425,3575861465,40
2,678,10805,3575861425,3575861466,41
2,678,10806,3575861425,3575861467,42
2,678,10807,3575861425,3575861468,43
2,678,10808,3575861425,3575861474,49
2,678,10809,3575861425,3575861474,49
2,678,10810,3575861425,3575861475,50
2,679,10811,3575861480,3575861480,0
2,679,10812,3575861480,3575861480,0
2,679,10813,3575861480,3575861480,0
2,679,10814,3575861480,3575861480,0
2,679,10815,3575861480,3575861480,0
2,679,10816,3575861480,3575861480,0
2,679,10817,3575861480,3575861480,0
2,679,10818,3575861480,3575861480,0
2,679,10819,3575861480,3575861482,2
2,679,10820,3575861480,3575861485,5
2,679,10821,3575861480,3575861485,5
2,679,10822,3575861480,3575861486,6
2,679,10823,3575861480,3575861486,6
2,679,10824,3575861480,3575861488,8
2,679,10825,3575861480,3575861490,10
2,679,10826,3575861480,3575861491,11
2,679,10827,3575861480,3575861491,11
2,679,10828,3575861480,3575861491,11
2,679,10829,3575861480,3575861492,12
2,679,10830,3575861480,3575861493,13
2,679,10831,3575861480,3575861494,14
2,679,10832,3575861480,3575861497,17
2,679,10833,3575861480,3575861497,17
2,679,10834,3575861480,3575861500,20
2,679,10835,3575861480,3575861500,20
2,679,10836,3575861480,3575861502,22
2,679,10837,3575861480,3575861502,22
2,679,10838,3575861480,3575861502,22
2,679,10839,3575861480,3575861503,23
2,679,10840,3575861480,3575861505,25
2,679,10841,3575861480,3575861508,28
2,679,10842,3575861480,3575861509,29
2,679,10843,3575861480,3575861509,29
2,679,10844,3575861480,3575861509,29
2,679,10845,3575861480,3575861512,32
2,679,10846,3575861480,3575861512,32
2,679,10847,3575861480,3575861514,34
2,679,10848,3575861480,3575861514,34
2,679,10849,3575861480,3575861515,35
2,679,10850,3575861480,3575861516,36
2,679,10851,3575861480,3575861516,36
2,679,10852,3575861480,3575861517,37
2,679,10853,3575861480,3575861518,38
2,679,10854,3575861480,3575861520,40
2,679,10855,3575861480,3575861523,43
2,679,10856,3575861480,3575861526,46
2,679,10857,3575861480,3575861526,46
2,679,10858,3575861480,3575861529,49
2,679,10859,3575861480,3575861529,49
2,680,10860,3575861535,3575861535,0
2,680,10861,3575861535,3575861535,0
2,680,10862,3575861535,3575861535,0
2,680,10863,3575861535,3575861535,0
2,680,10864,3575861535,3575861535,0
2,680,10865,3575861535,3575861535,0
2,680,10866,3575861535,3575861538,3
2,680,10867,3575861535,3575861539,4
2,680,10868,3575861535,3575861539,4
2,680,10869,3575861535,3575861541,6
2,680,10870,3575861535,3575861543,8
2,680,10871,3575861535,3575861544,9
2,680,10872,3575861535,3575861544,9
2,680,10873,3575861535,3575861545,10
2,680,10874,3575861535,3575861548,13
2,680,10875,3575861535,3575861548,13
2,680,10876,3575861535,3575861550,15
2,680,10877,3575861535,3575861550,15
2,680,10878,3575861535,3575861550,15
2,680,10879,3575861535,3575861552,17
2,680,10880,3575861535,3575861556,21
2,680,10881,3575861535,3575861559,24
2,680,10882,3575861535,3575861561,26
2,680,10883,3575861535,3575861562,27
2,680,10884,3575861535,3575861564,29
2,680,10885,3575861535,3575861565,30
2,680,10886,3575861535,3575861567,32
2,680,10887,3575861535,3575861568,33
2,680,10888,3575861535,3575861569,34
2,680,10889,3575861535,3575861571,36
2,680,10890,3575861535,3575861573,38
2,680,10891,3575861535,3575861576,41
2,680,10892,3575861535,3575861577,42
2,680,10893,3575861535,3575861577,42
2,680,10894,3575861535,3575861579,44
2,680,10895,3575861535,3575861580,45
2,680,10896,3575861535,3575861580,45
2,680,10897,3575861535,3575861583,48
2,680,10898,3575861535,3575861583,48
2,680,10899,3575861535,3575861584,49
2,680,10900,3575861535,3575861584,49
2,680,10901,3575861535,3575861584,49
2,681,10902,3575861590,3575861590,0
2,681,10903,3575861590,3575861590,0
2,681,10904,3575861590,3575861590,0
2,681,10905,3575861590,3575861590,0
2,681,10906,3575861590,3575861590,0
2,681,10907,3575861590,3575861590,0
2,681,10908,3575861590,3575861591,1
2,681,10909,3575861590,3575861592,2
2,681,10910,3575861590,3575861592,2
2,681,10911,3575861590,3575861597,7
2,681,10912,3575861590,3575861599,9
2,681,10913,3575861590,3575861600,10
2,681,10914,3575861590,3575861601,11
2,681,10915,3575861590,3575861603,13
2,681,10916,3575861590,3575861603,13
2,681,10917,3575861590,3575861604,14
2,681,10918,3575861590,3575861609,19
2,681,10919,3575861590,3575861609,19
2,681,10920,3575861590,3575861609,19
2,681,10921,3575861590,3575861610,20
2,681,10922,3575861590,3575861611,21
2,681,10923,3575861590,3575861612,22
2,681,10924,3575861590,3575861614,24
2,681,10925,3575861590,3575861619,29
2,681,10926,3575861590,3575861620,30
2,681,10927,3575861590,3575861621,31
2,681,10928,3575861590,3575861622,32
2,681,10929,3575861590,3575861624,34
2,681,10930,3575861590,3575861625,35
2,681,10931,3575861590,3575861626,36
2,681,10932,3575861590,3575861626,36
2,681,10933,3575861590,3575861628,38
2,681,10934,3575861590,3575861634,44
2,681,10935,3575861590,3575861635,45
2,681,10936,3575861590,3575861635,45
2,681,10937,3575861590,3575861637,47
2,681,10938,3575861590,3575861637,47
2,681,10939,3575861590,3575861639,49
2,681,10940,3575861590,3575861640,50
2,682,10941,3575861648,3575861648,0
2,682,10942,3575861648,3575861648,0
2,682,10943,3575861648,3575861648,0
2,682,10944,3575861648,3575861648,0
2,682,10945,3575861648,3575861649,1
2,682,10946,3575861648,3575861649,1
2,682,10947,3575861648,3575861652,4
2,682,10948,3575861648,3575861655,7
2,682,10949,3575861648,3575861655,7
2,682,10950,3575861648,3575861658,10
2,682,10951,3575861648,3575861658,10
2,682,10952,3575861648,3575861659,11
2,682,10953,3575861648,3575861660,12
2,682,10954,3575861648,3575861661,13
2,682,10955,3575861648,3575861664,16
2,682,10956,3575861648,3575861665,17
2,682,10957,3575861648,3575861666,18
2,682,10958,3575861648,3575861667,19
2,682,10959,3575861648,3575861674,26
2,682,10960,3575861648,3575861675,27
2,682,10961,3575861648,3575861675,27
2,682,10962,3575861648,3575861678,30
2,682,10963,3575861648,3575861678,30
2,682,10964,3575861648,3575861679,31
2,682,10965,3575861648,3575861681,33
2,682,10966,3575861648,3575861681,33
2,682,10967,3575861648,3575861681,33
2,682,10968,3575861648,3575861681,33
2,682,10969,3575861648,3575861683,35
2,682,10970,3575861648,3575861684,36
2,682,10971,3575861648,3575861685,37
2,682,10972,3575861648,3575861686,38
2,682,10973,3575861648,3575861687,39
2,682,10974,3575861648,3575861687,39
2,682,10975,3575861648,3575861688,40
2,682,10976,3575861648,3575861690,42
2,682,10977,3575861648,3575861690,42
2,682,10978,3575861648,3575861691,43
2,682,10979,3575861648,3575861691,43
2,682,10980,3575861648,3575861692,44
2,682,10981,3575861648,3575861693,45
2,682,10982,3575861648,3575861694,46
2,682,10983,3575861648,3575861696,48
2,682,10984,3575861648,3575861697,49
2,683,10985,3575861704,3575861704,0
2,683,10986,3575861704,3575861704,0
2,683,10987,3575861704,3575861704,0
2,683,10988,3575861704,3575861704,0
2,683,10989,3575861704,3575861704,0
2,683,10990,3575861704,3575861704,0
2,683,10991,3575861704,3575861705,1
2,683,10992,3575861704,3575861708,4
2,683,10993,3575861704,3575861709,5
2,683,10994,3575861704,3575861709,5
2,683,10995,3575861704,3575861710,6
2,683,10996,3575861704,3575861712,8
2,683,10997,3575861704,3575861713,9
2,683,10998,3575861704,3575861714,10
2,683,10999,3575861704,3575861716,12
2,683,11000,3575861704,3575861716,12
2,683,11001,3575861704,3575861717,13
2,683,11002,3575861704,3575861717,13
2,683,11003,3575861704,3575861719,15
2,683,11004,3575861704,3575861720,16
2,683,11005,3575861704,3575861724,20
2,683,11006,3575861704,3575861726,22
2,683,11007,3575861704,3575861726,22
2,683,11008,3575861704,3575861727,23
2,683,11009,3575861704,3575861729,25
2,683,11010,3575861704,3575861730,26
2,683,11011,3575861704,3575861731,27
2,683,11012,3575861704,3575861731,27
2,683,11013,3575861704,3575861733,29
2,683,11014,3575861704,3575861734,30
2,683,11015,3575861704,3575861735,31
2,683,11016,3575861704,3575861736,32
2,683,11017,3575861704,3575861738,34
2,683,11018,3575861704,3575861739,35
2,683,11019,3575861704,3575861740,36
2,683,11020,3575861704,3575861742,38
2,683,11021,3575861704,3575861744,40
2,683,11022,3575861704,3575861745,41
2,683,11023,3575861704,3575861745,41
2,683,11024,3575861704,3575861746,42
2,683,11025,3575861704,3575861749,45
2,683,11026,3575861704,3575861749,45
2,683,11027,3575861704,3575861750,46
2,683,11028,3575861704,3575861750,46
2,683,11029,3575861704,3575861750,46
2,683,11030,3575861704,3575861752,48
2,684,11031,3575861760,3575861760,0
2,684,11032,3575861760,3575861760,0
2,684,11033,3575861760,3575861760,0
2,684,11034,3575861760,3575861762,2
2,684,11035,3575861760,3575861765,5
2,684,11036,3575861760,3575861766,6
2,684,11037,3575861760,3575861767,7
2,684,11038,3575861760,3575861768,8
2,684,11039,3575861760,3575861769,9
2,684,11040,3575861760,3575861771,11
2,684,11041,3575861760,3575861773,13
2,684,11042,3575861760,3575861776,16
2,684,11043,3575861760,3575861777,17
2,684,11044,3575861760,3575861778,18
2,684,11045,3575861760,3575861779,19
2,684,11046,3575861760,3575861779,19
2,684,11047,3575861760,3575861780,20
2,684,11048,3575861760,3575861783,23
2,684,11049,3575861760,3575861783,23
2,684,11050,3575861760,3575861783,23
2,684,11051,3575861760,3575861784,24
2,684,11052,3575861760,3575861784,24
2,684,11053,3575861760,3575861785,25
2,684,11054,3575861760,3575861786,26
2,684,11055,3575861760,3575861789,29
2,684,11056,3575861760,3575861789,29
2,684,11057,3575861760,3575861789,29
2,684,11058,3575861760,3575861790,30
2,684,11059,3575861760,3575861791,31
2,684,11060,3575861760,3575861792,32
2,684,11061,3575861760,3575861792,32
2,684,11062,3575861760,3575861798,38
2,684,11063,3575861760,3575861798,38
2,684,11064,3575861760,3575861799,39
2,684,11065,3575861760,3575861800,40
2,684,11066,3575861760,3575861801,41
2,684,11067,3575861760,3575861801,41
2,684,11068,3575861760,3575861803,43
2,684,11069,3575861760,3575861804,44
2,684,11070,3575861760,3575861804,44
2,684,11071,3575861760,3575861809,49
2,684,11072,3575861760,3575861810,50
2,685,11073,3575861816,3575861816,0
2,685,11074,3575861816,3575861816,0
2,685,11075,3575861816,3575861816,0
2,685,11076,3575861816,3575861816,0
2,685,11077,3575861816,3575861819,3
2,685,11078,3575861816,3575861820,4
2,685,11079,3575861816,3575861821,5
2,685,11080,3575861816,3575861822,6
2,685,11081,3575861816,3575861824,8
2,685,11082,3575861816,3575861826,10
2,685,11083,3575861816,3575861826,10
2,685,11084,3575861816,3575861827,11
2,685,11085,3575861816,3575861828,12
2,685,11086,3575861816,3575861834,18
2,685,11087,3575861816,3575861835,19
2,685,11088,3575861816,3575861835,19
2,685,11089,3575861816,3575861836,20
2,685,11090,3575861816,3575861838,22
2,685,11091,3575861816,3575861839,23
2,685,11092,3575861816,3575861840,24
2,685,11093,3575861816,3575861841,25
2,685,11094,3575861816,3575861844,28
2,685,11095,3575861816,3575861845,29
2,685,11096,3575861816,3575861846,30
2,685,11097,3575861816,3575861848,32
2,685,11098,3575861816,3575861849,33
2,685,11099,3575861816,3575861850,34
2,685,11100,3575861816,3575861851,35
2,685,11101,3575861816,3575861856,40
2,685,11102,3575861816,3575861856,40
2,685,11103,3575861816,3575861859,43
2,685,11104,3575861816,3575861859,43
2,685,11105,3575861816,3575861860,44
2,685,11106,3575861816,3575861860,44
2,685,11107,3575861816,3575861860,44
2,685,11108,3575861816,3575861864,48
2,685,11109,3575861816,3575861866,50
2,686,11110,3575861871,3575861871,0
2,686,11111,3575861871,3575861871,0
2,686,11112,3575861871,3575861874,3
2,686,11113,3575861871,3575861875,4
2,686,11114,3575861871,3575861875,4
2,686,11115,3575861871,3575861877,6
2,686,11116,3575861871,3575861879,8
2,686,11117,3575861871,3575861879,8
2,686,11118,3575861871,3575861880,9
2,686,11119,3575861871,3575861880,9
2,686,11120,3575861871,3575861881,10
2,686,11121,3575861871,3575861881,10
2,686,11122,3575861871,3575861882,11
2,686,11123,3575861871,3575861885,14
2,686,11124,3575861871,3575861885,14
2,686,11125,3575861871,3575861885,14
2,686,11126,3575861871,3575861886,15
2,686,11127,3575861871,3575861887,16
2,686,11128,3575861871,3575861888,17
2,686,11129,3575861871,3575861889,18
2,686,11130,3575861871,3575861891,20
2,686,11131,3575861871,3575861892,21
2,686,11132,3575861871,3575861892,21
2,686,11133,3575861871,3575861892,21
2,686,11134,3575861871,3575861893,22
2,686,11135,3575861871,3575861894,23
2,686,11136,3575861871,3575861897,26
2,686,11137,3575861871,3575861897,26
2,686,11138,3575861871,3575861900,29
2,686,11139,3575861871,3575861901,30
2,686,11140,3575861871,3575861902,31
2,686,11141,3575861871,3575861903,32
2,686,11142,3575861871,3575861903,32
2,686,11143,3575861871,3575861905,34
2,686,11144,3575861871,3575861908,37
2,686,11145,3575861871,3575861909,38
2,686,11146,3575861871,3575861909,38
2,686,11147,3575861871,3575861910,39
2,686,11148,3575861871,3575861912,41
2,686,11149,3575861871,3575861913,42
2,686,11150,3575861871,3575861914,43
2,686,11151,3575861871,3575861915,44
2,686,11152,3575861871,3575861916,45
2,686,11153,3575861871,3575861916,45
2,686,11154,3575861871,3575861918,47
2,686,11155,3575861871,3575861918,47
2,686,11156,3575861871,3575861919,48
2,686,11157,3575861871,3575861921,50
2,687,11158,3575861926,3575861926,0
2,687,11159,3575861926,3575861926,0
2,687,11160,3575861926,3575861927,1
2,687,11161,3575861926,3575861927,1
2,687,11162,3575861926,3575861928,2
2,687,11163,3575861926,3575861930,4
2,687,11164,3575861926,3575861930,4
2,687,11165,3575861926,3575861930,4
2,687,11166,3575861926,3575861934,8
2,687,11167,3575861926,3575861934,8
2,687,11168,3575861926,3575861935,9
2,687,11169,3575861926,3575861936,10
2,687,11170,3575861926,3575861938,12
2,687,11171,3575861926,3575861939,13
2,687,11172,3575861926,3575861940,14
2,687,11173,3575861926,3575861942,16
2,687,11174,3575861926,3575861944,18
2,687,11175,3575861926,3575861945,19
2,687,11176,3575861926,3575861945,19
2,687,11177,3575861926,3575861946,20
2,687,11178,3575861926,3575861948,22
2,687,11179,3575861926,3575861948,22
2,687,11180,3575861926,3575861950,24
2,687,11181,3575861926,3575861951,25
2,687,11182,3575861926,3575861951,25
2,687,11183,3575861926,3575861959,33
2,687,11184,3575861926,3575861960,34
2,687,11185,3575861926,3575861961,35
2,687,11186,3575861926,3575861962,36
2,687,11187,3575861926,3575861965,39
2,687,11188,3575861926,3575861966,40
2,687,11189,3575861926,3575861968,42
2,687,11190,3575861926,3575861968,42
2,687,11191,3575861926,3575861969,43
2,687,11192,3575861926,3575861972,46
2,687,11193,3575861926,3575861973,47
2,688,11194,3575861981,3575861981,0
2,688,11195,3575861981,3575861981,0
2,688,11196,3575861981,3575861981,0
2,688,11197,3575861981,3575861981,0
2,688,11198,3575861981,3575861983,2
2,688,11199,3575861981,3575861983,2
2,688,11200,3575861981,3575861984,3
2,688,11201,3575861981,3575861984,3
2,688,11202,3575861981,3575861985,4
2,688,11203,3575861981,3575861985,4
2,688,11204,3575861981,3575861987,6
2,688,11205,3575861981,3575861988,7
2,688,11206,3575861981,3575861988,7
2,688,11207,3575861981,3575861989,8
2,688,11208,3575861981,3575861991,10
2,688,11209,3575861981,3575861992,11
2,688,11210,3575861981,3575861992,11
2,688,11211,3575861981,3575861994,13
2,688,11212,3575861981,3575861998,17
2,688,11213,3575861981,3575861998,17
2,688,11214,3575861981,3575861999,18
2,688,11215,3575861981,3575862000,19
2,688,11216,3575861981,3575862001,20
2,688,11217,3575861981,3575862002,21
2,688,11218,3575861981,3575862003,22
2,688,11219,3575861981,3575862004,23
2,688,11220,3575861981,3575862008,27
2,688,11221,3575861981,3575862010,29
2,688,11222,3575861981,3575862011,30
2,688,11223,3575861981,3575862011,30
2,688,11224,3575861981,3575862012,31
2,688,11225,3575861981,3575862013,32
2,688,11226,3575861981,3575862014,33
2,688,11227,3575861981,3575862019,38
2,688,11228,3575861981,3575862019,38
2,688,11229,3575861981,3575862020,39
2,688,11230,3575861981,3575862020,39
2,688,11231,3575861981,3575862022,41
2,688,11232,3575861981,3575862025,44
2,688,11233,3575861981,3575862026,45
2,688,11234,3575861981,3575862026,45
2,688,11235,3575861981,3575862027,46
2,688,11236,3575861981,3575862029,48
2,689,11237,3575862036,3575862036,0
2,689,11238,3575862036,3575862036,0
2,689,11239,3575862036,3575862036,0
2,689,11240,3575862036,3575862036,0
2,689,11241,3575862036,3575862038,2
2,689,11242,3575862036,3575862039,3
2,689,11243,3575862036,3575862040,4
2,689,11244,3575862036,3575862042,6
2,689,11245,3575862036,3575862044,8
2,689,11246,3575862036,3575862044,8
2,689,11247,3575862036,3575862045,9
2,689,11248,3575862036,3575862045,9
2,689,11249,3575862036,3575862048,12
2,689,11250,3575862036,3575862049,13
2,689,11251,3575862036,3575862050,14
2,689,11252,3575862036,3575862051,15
2,689,11253,3575862036,3575862056,20
2,689,11254,3575862036,3575862056,20
2,689,11255,3575862036,3575862059,23
2,689,11256,3575862036,3575862059,23
2,689,11257,3575862036,3575862059,23
2,689,11258,3575862036,3575862060,24
2,689,11259,3575862036,3575862061,25
2,689,11260,3575862036,3575862064,28
2,689,11261,3575862036,3575862066,30
2,689,11262,3575862036,3575862066,30
2,689,11263,3575862036,3575862067,31
2,689,11264,3575862036,3575862074,38
2,689,11265,3575862036,3575862074,38
2,689,11266,3575862036,3575862075,39
2,689,11267,3575862036,3575862075,39
2,689,11268,3575862036,3575862078,42
2,689,11269,3575862036,3575862079,43
2,689,11270,3575862036,3575862079,43
2,689,11271,3575862036,3575862080,44
2,689,11272,3575862036,3575862080,44
2,689,11273,3575862036,3575862081,45
2,689,11274,3575862036,3575862082,46
2,689,11275,3575862036,3575862082,46
2,689,11276,3575862036,3575862085,49
2,689,11277,3575862036,3575862085,49
2,689,11278,3575862036,3575862086,50
2,690,11279,3575862091,3575862091,0
2,690,11280,3575862091,3575862091,0
2,690,11281,3575862091,3575862091,0
2,690,11282,3575862091,3575862091,0
2,690,11283,3575862091,3575862091,0
2,690,11284,3575862091,3575862092,1
2,690,11285,3575862091,3575862092,1
2,690,11286,3575862091,3575862092,1
2,690,11287,3575862091,3575862094,3
2,690,11288,3575862091,3575862094,3
2,690,11289,3575862091,3575862096,5
2,690,11290,3575862091,3575862097,6
2,690,11291,3575862091,3575862100,9
2,690,11292,3575862091,3575862101,10
2,690,11293,3575862091,3575862102,11
2,690,11294,3575862091,3575862103,12
2,690,11295,3575862091,3575862103,12
2,690,11296,3575862091,3575862103,12
2,690,11297,3575862091,3575862105,14
2,690,11298,3575862091,3575862108,17
2,690,11299,3575862091,3575862108,17
2,690,11300,3575862091,3575862110,19
2,690,11301,3575862091,3575862110,19
2,690,11302,3575862091,3575862113,22
2,690,11303,3575862091,3575862114,23
2,690,11304,3575862091,3575862114,23
2,690,11305,3575862091,3575862115,24
2,690,11306,3575862091,3575862116,25
2,690,11307,3575862091,3575862116,25
2,690,11308,3575862091,3575862117,26
2,690,11309,3575862091,3575862117,26
2,690,11310,3575862091,3575862119,28
2,690,11311,3575862091,3575862119,28
2,690,11312,3575862091,3575862121,30
2,690,11313,3575862091,3575862124,33
2,690,11314,3575862091,3575862126,35
2,690,11315,3575862091,3575862126,35
2,690,11316,3575862091,3575862127,36
2,690,11317,3575862091,3575862129,38
2,690,11318,3575862091,3575862131,40
2,690,11319,3575862091,3575862131,40
2,690,11320,3575862091,3575862131,40
2,690,11321,3575862091,3575862134,43
2,690,11322,3575862091,3575862134,43
2,690,11323,3575862091,3575862135,44
2,690,11324,3575862091,3575862136,45
2,690,11325,3575862091,3575862137,46
2,690,11326,3575862091,3575862139,48
2,690,11327,3575862091,3575862139,48
2,690,11328,3575862091,3575862141,50
2,691,11329,3575862146,3575862146,0
2,691,11330,3575862146,3575862146,0
2,691,11331,3575862146,3575862146,0
2,691,11332,3575862146,3575862146,0
2,691,11333,3575862146,3575862146,0
2,691,11334,3575862146,3575862148,2
2,691,11335,3575862146,3575862151,5
2,691,11336,3575862146,3575862151,5
2,691,11337,3575862146,3575862152,6
2,691,11338,3575862146,3575862159,13
2,691,11339,3575862146,3575862159,13
2,691,11340,3575862146,3575862161,15
2,691,11341,3575862146,3575862162,16
2,691,11342,3575862146,3575862165,19
2,691,11343,3575862146,3575862166,20
2,691,11344,3575862146,3575862168,22
2,691,11345,3575862146,3575862168,22
2,691,11346,3575862146,3575862170,24
2,691,11347,3575862146,3575862173,27
2,691,11348,3575862146,3575862174,28
2,691,11349,3575862146,3575862177,31
2,691,11350,3575862146,3575862178,32
2,691,11351,3575862146,3575862181,35
2,691,11352,3575862146,3575862181,35
2,691,11353,3575862146,3575862181,35
2,691,11354,3575862146,3575862183,37
2,691,11355,3575862146,3575862183,37
2,691,11356,3575862146,3575862184,38
2,691,11357,3575862146,3575862184,38
2,691,11358,3575862146,3575862185,39
2,691,11359,3575862146,3575862185,39
2,691,11360,3575862146,3575862187,41
2,691,11361,3575862146,3575862188,42
2,691,11362,3575862146,3575862188,42
2,691,11363,3575862146,3575862189,43
2,691,11364,3575862146,3575862191,45
2,691,11365,3575862146,3575862192,46
2,691,11366,3575862146,3575862193,47
2,691,11367,3575862146,3575862195,49
2,692,11368,3575862201,3575862201,0
2,692,11369,3575862201,3575862201,0
2,692,11370,3575862201,3575862201,0
2,692,11371,3575862201,3575862201,0
2,692,11372,3575862201,3575862204,3
2,692,11373,3575862201,3575862204,3
2,692,11374,3575862201,3575862209,8
2,692,11375,3575862201,3575862210,9
2,692,11376,3575862201,3575862211,10
2,692,11377,3575862201,3575862211,10
2,692,11378,3575862201,3575862213,12
2,692,11379,3575862201,3575862213,12
2,692,11380,3575862201,3575862214,13
2,692,11381,3575862201,3575862220,19
2,692,11382,3575862201,3575862221,20
2,692,11383,3575862201,3575862221,20
2,692,11384,3575862201,3575862222,21
2,692,11385,3575862201,3575862224,23
2,692,11386,3575862201,3575862226,25
2,692,11387,3575862201,3575862228,27
2,692,11388,3575862201,3575862228,27
2,692,11389,3575862201,3575862228,27
2,692,11390,3575862201,3575862235,34
2,692,11391,3575862201,3575862235,34
2,692,11392,3575862201,3575862235,34
2,692,11393,3575862201,3575862237,36
2,692,11394,3575862201,3575862237,36
2,692,11395,3575862201,3575862240,39
2,692,11396,3575862201,3575862241,40
2,692,11397,3575862201,3575862242,41
2,692,11398,3575862201,3575862244,43
2,692,11399,3575862201,3575862245,44
2,692,11400,3575862201,3575862245,44
2,692,11401,3575862201,3575862246,45
2,692,11402,3575862201,3575862249,48
2,692,11403,3575862201,3575862250,49
2,693,11404,3575862257,3575862257,0
2,693,11405,3575862257,3575862257,0
2,693,11406,3575862257,3575862257,0
2,693,11407,3575862257,3575862259,2
2,693,11408,3575862257,3575862259,2
2,693,11409,3575862257,3575862260,3
2,693,11410,3575862257,3575862260,3
2,693,11411,3575862257,3575862261,4
2,693,11412,3575862257,3575862264,7
2,693,11413,3575862257,3575862266,9
2,693,11414,3575862257,3575862266,9
2,693,11415,3575862257,3575862267,10
2,693,11416,3575862257,3575862273,16
2,693,11417,3575862257,3575862275,18
2,693,11418,3575862257,3575862275,18
2,693,11419,3575862257,3575862276,19
2,693,11420,3575862257,3575862279,22
2,693,11421,3575862257,3575862279,22
2,693,11422,3575862257,3575862280,23
2,693,11423,3575862257,3575862281,24
2,693,11424,3575862257,3575862282,25
2,693,11425,3575862257,3575862283,26
2,693,11426,3575862257,3575862285,28
2,693,11427,3575862257,3575862286,29
2,693,11428,3575862257,3575862286,29
2,693,11429,3575862257,3575862287,30
2,693,11430,3575862257,3575862288,31
2,693,11431,3575862257,3575862289,32
2,693,11432,3575862257,3575862289,32
2,693,11433,3575862257,3575862291,34
2,693,11434,3575862257,3575862291,34
2,693,11435,3575862257,3575862292,35
2,693,11436,3575862257,3575862292,35
2,693,11437,3575862257,3575862294,37
2,693,11438,3575862257,3575862294,37
2,693,11439,3575862257,3575862297,40
2,693,11440,3575862257,3575862298,41
2,693,11441,3575862257,3575862300,43
2,693,11442,3575862257,3575862301,44
2,693,11443,3575862257,3575862302,45
2,693,11444,3575862257,3575862303,46
2,693,11445,3575862257,3575862303,46
2,693,11446,3575862257,3575862304,47
2,693,11447,3575862257,3575862306,49
2,694,11448,3575862313,3575862313,0
2,694,11449,3575862313,3575862313,0
2,694,11450,3575862313,3575862313,0
2,694,11451,3575862313,3575862313,0
2,694,11452,3575862313,3575862313,0
2,694,11453,3575862313,3575862313,0
2,694,11454,3575862313,3575862314,1
2,694,11455,3575862313,3575862316,3
2,694,11456,3575862313,3575862318,5
2,694,11457,3575862313,3575862318,5
2,694,11458,3575862313,3575862318,5
2,694,11459,3575862313,3575862320,7
2,694,11460,3575862313,3575862321,8
2,694,11461,3575862313,3575862323,10
2,694,11462,3575862313,3575862326,13
2,694,11463,3575862313,3575862326,13
2,694,11464,3575862313,3575862327,14
2,694,11465,3575862313,3575862329,16
2,694,11466,3575862313,3575862331,18
2,694,11467,3575862313,3575862331,18
2,694,11468,3575862313,3575862332,19
2,694,11469,3575862313,3575862334,21
2,694,11470,3575862313,3575862335,22
2,694,11471,3575862313,3575862335,22
2,694,11472,3575862313,3575862336,23
2,694,11473,3575862313,3575862337,24
2,694,11474,3575862313,3575862339,26
2,694,11475,3575862313,3575862340,27
2,694,11476,3575862313,3575862345,32
2,694,11477,3575862313,3575862346,33
2,694,11478,3575862313,3575862346,33
2,694,11479,3575862313,3575862347,34
2,694,11480,3575862313,3575862348,35
2,694,11481,3575862313,3575862348,35
2,694,11482,3575862313,3575862351,38
2,694,11483,3575862313,3575862351,38
2,694,11484,3575862313,3575862352,39
2,694,11485,3575862313,3575862355,42
2,694,11486,3575862313,3575862359,46
2,694,11487,3575862313,3575862360,47
2,694,11488,3575862313,3575862362,49
2,695,11489,3575862369,3575862369,0
2,695,11490,3575862369,3575862369,0
2,695,11491,3575862369,3575862369,0
2,695,11492,3575862369,3575862369,0
2,695,11493,3575862369,3575862370,1
2,695,11494,3575862369,3575862373,4
2,695,11495,3575862369,3575862374,5
2,695,11496,3575862369,3575862377,8
2,695,11497,3575862369,3575862379,10
2,695,11498,3575862369,3575862381,12
2,695,11499,3575862369,3575862381,12
2,695,11500,3575862369,3575862382,13
2,695,11501,3575862369,3575862383,14
2,695,11502,3575862369,3575862383,14
2,695,11503,3575862369,3575862384,15
2,695,11504,3575862369,3575862385,16
2,695,11505,3575862369,3575862385,16
2,695,11506,3575862369,3575862386,17
2,695,11507,3575862369,3575862387,18
2,695,11508,3575862369,3575862388,19
2,695,11509,3575862369,3575862389,20
2,695,11510,3575862369,3575862390,21
2,695,11511,3575862369,3575862390,21
2,695,11512,3575862369,3575862392,23
2,695,11513,3575862369,3575862393,24
2,695,11514,3575862369,3575862395,26
2,695,11515,3575862369,3575862399,30
2,695,11516,3575862369,3575862399,30
2,695,11517,3575862369,3575862401,32
2,695,11518,3575862369,3575862402,33
2,695,11519,3575862369,3575862404,35
2,695,11520,3575862369,3575862404,35
2,695,11521,3575862369,3575862405,36
2,695,11522,3575862369,3575862409,40
2,695,11523,3575862369,3575862410,41
2,695,11524,3575862369,3575862411,42
2,695,11525,3575862369,3575862412,43
2,695,11526,3575862369,3575862413,44
2,695,11527,3575862369,3575862413,44
2,695,11528,3575862369,3575862414,45
2,696,11529,3575862424,3575862424,0
2,696,11530,3575862424,3575862424,0
2,696,11531,3575862424,3575862424,0
2,696,11532,3575862424,3575862424,0
2,696,11533,3575862424,3575862425,1
2,696,11534,3575862424,3575862426,2
2,696,11535,3575862424,3575862427,3
2,696,11536,3575862424,3575862427,3
2,696,11537,3575862424,3575862428,4
2,696,11538,3575862424,3575862434,10
2,696,11539,3575862424,3575862437,13
2,696,11540,3575862424,3575862437,13
2,696,11541,3575862424,3575862440,16
2,696,11542,3575862424,3575862440,16
2,696,11543,3575862424,3575862441,17
2,696,11544,3575862424,3575862442,18
2,696,11545,3575862424,3575862444,20
2,696,11546,3575862424,3575862445,21
2,696,11547,3575862424,3575862446,22
2,696,11548,3575862424,3575862446,22
2,696,11549,3575862424,3575862450,26
2,696,11550,3575862424,3575862451,27
2,696,11551,3575862424,3575862452,28
2,696,11552,3575862424,3575862456,32
2,696,11553,3575862424,3575862457,33
2,696,11554,3575862424,3575862459,35
2,696,11555,3575862424,3575862459,35
2,696,11556,3575862424,3575862460,36
2,696,11557,3575862424,3575862461,37
2,696,11558,3575862424,3575862461,37
2,696,11559,3575862424,3575862464,40
2,696,11560,3575862424,3575862466,42
2,696,11561,3575862424,3575862467,43
2,696,11562,3575862424,3575862468,44
2,696,11563,3575862424,3575862473,49
2,697,11564,3575862481,3575862481,0
2,697,11565,3575862481,3575862481,0
2,697,11566,3575862481,3575862481,0
2,697,11567,3575862481,3575862481,0
2,697,11568,3575862481,3575862481,0
2,697,11569,3575862481,3575862481,0
2,697,11570,3575862481,3575862481,0
2,697,11571,3575862481,3575862481,0
2,697,11572,3575862481,3575862481,0
2,697,11573,3575862481,3575862482,1
2,697,11574,3575862481,3575862484,3
2,697,11575,3575862481,3575862484,3
2,697,11576,3575862481,3575862486,5
2,697,11577,3575862481,3575862487,6
2,697,11578,3575862481,3575862488,7
2,697,11579,3575862481,3575862488,7
2,697,11580,3575862481,3575862490,9
2,697,11581,3575862481,3575862490,9
2,697,11582,3575862481,3575862491,10
2,697,11583,3575862481,3575862491,10
2,697,11584,3575862481,3575862493,12
2,697,11585,3575862481,3575862494,13
2,697,11586,3575862481,3575862496,15
2,697,11587,3575862481,3575862497,16
2,697,11588,3575862481,3575862499,18
2,697,11589,3575862481,3575862500,19
2,697,11590,3575862481,3575862502,21
2,697,11591,3575862481,3575862502,21
2,697,11592,3575862481,3575862504,23
2,697,11593,3575862481,3575862505,24
2,697,11594,3575862481,3575862507,26
2,697,11595,3575862481,3575862507,26
2,697,11596,3575862481,3575862508,27
2,697,11597,3575862481,3575862509,28
2,697,11598,3575862481,3575862509,28
2,697,11599,3575862481,3575862512,31
2,697,11600,3575862481,3575862513,32
2,697,11601,3575862481,3575862514,33
2,697,11602,3575862481,3575862515,34
2,697,11603,3575862481,3575862515,34
2,697,11604,3575862481,3575862515,34
2,697,11605,3575862481,3575862516,35
2,697,11606,3575862481,3575862517,36
2,697,11607,3575862481,3575862520,39
2,697,11608,3575862481,3575862521,40
2,697,11609,3575862481,3575862524,43
2,697,11610,3575862481,3575862525,44
2,697,11611,3575862481,3575862525,44
2,697,11612,3575862481,3575862526,45
2,697,11613,3575862481,3575862527,46
2,697,11614,3575862481,3575862530,49
2,697,11615,3575862481,3575862531,50
2,698,11616,3575862538,3575862538,0
2,698,11617,3575862538,3575862538,0
2,698,11618,3575862538,3575862538,0
2,698,11619,3575862538,3575862538,0
2,698,11620,3575862538,3575862538,0
2,698,11621,3575862538,3575862538,0
2,698,11622,3575862538,3575862539,1
2,698,11623,3575862538,3575862539,1
2,698,11624,3575862538,3575862540,2
2,698,11625,3575862538,3575862541,3
2,698,11626,3575862538,3575862543,5
2,698,11627,3575862538,3575862545,7
2,698,11628,3575862538,3575862545,7
2,698,11629,3575862538,3575862546,8
2,698,11630,3575862538,3575862547,9
2,698,11631,3575862538,3575862547,9
2,698,11632,3575862538,3575862550,12
2,698,11633,3575862538,3575862551,13
2,698,11634,3575862538,3575862551,13
2,698,11635,3575862538,3575862551,13
2,698,11636,3575862538,3575862553,15
2,698,11637,3575862538,3575862558,20
2,698,11638,3575862538,3575862560,22
2,698,11639,3575862538,3575862564,26
2,698,11640,3575862538,3575862566,28
2,698,11641,3575862538,3575862567,29
2,698,11642,3575862538,3575862569,31
2,698,11643,3575862538,3575862569,31
2,698,11644,3575862538,3575862572,34
2,698,11645,3575862538,3575862573,35
2,698,11646,3575862538,3575862576,38
2,698,11647,3575862538,3575862576,38
2,698,11648,3575862538,3575862578,40
2,698,11649,3575862538,3575862580,42
2,698,11650,3575862538,3575862580,42
2,698,11651,3575862538,3575862580,42
2,698,11652,3575862538,3575862582,44
2,698,11653,3575862538,3575862583,45
2,698,11654,3575862538,3575862583,45
2,698,11655,3575862538,3575862584,46
2,698,11656,3575862538,3575862585,47
2,698,11657,3575862538,3575862586,48
2,698,11658,3575862538,3575862587,49
2,698,11659,3575862538,3575862588,50
2,699,11660,3575862593,3575862593,0
2,699,11661,3575862593,3575862593,0
2,699,11662,3575862593,3575862593,0
2,699,11663,3575862593,3575862593,0
2,699,11664,3575862593,3575862593,0
2,699,11665,3575862593,3575862598,5
2,699,11666,3575862593,3575862598,5
2,699,11667,3575862593,3575862599,6
2,699,11668,3575862593,3575862600,7
2,699,11669,3575862593,3575862601,8
2,699,11670,3575862593,3575862603,10
2,699,11671,3575862593,3575862603,10
2,699,11672,3575862593,3575862608,15
2,699,11673,3575862593,3575862609,16
2,699,11674,3575862593,3575862611,18
2,699,11675,3575862593,3575862611,18
2,699,11676,3575862593,3575862611,18
2,699,11677,3575862593,3575862612,19
2,699,11678,3575862593,3575862613,20
2,699,11679,3575862593,3575862619,26
2,699,11680,3575862593,3575862619,26
2,699,11681,3575862593,3575862620,27
2,699,11682,3575862593,3575862620,27
2,699,11683,3575862593,3575862622,29
2,699,11684,3575862593,3575862624,31
2,699,11685,3575862593,3575862625,32
2,699,11686,3575862593,3575862626,33
2,699,11687,3575862593,3575862626,33
2,699,11688,3575862593,3575862627,34
2,699,11689,3575862593,3575862634,41
2,699,11690,3575862593,3575862634,41
2,699,11691,3575862593,3575862635,42
2,699,11692,3575862593,3575862636,43
2,699,11693,3575862593,3575862637,44
2,699,11694,3575862593,3575862639,46
2,699,11695,3575862593,3575862639,46
2,699,11696,3575862593,3575862640,47
2,699,11697,3575862593,3575862641,48
2,699,11698,3575862593,3575862643,50
2,700,11699,3575862649,3575862649,0
2,700,11700,3575862649,3575862649,0
2,700,11701,3575862649,3575862649,0
2,700,11702,3575862649,3575862649,0
2,700,11703,3575862649,3575862651,2
2,700,11704,3575862649,3575862651,2
2,700,11705,3575862649,3575862654,5
2,700,11706,3575862649,3575862656,7
2,700,11707,3575862649,3575862658,9
2,700,11708,3575862649,3575862658,9
2,700,11709,3575862649,3575862658,9
2,700,11710,3575862649,3575862660,11
2,700,11711,3575862649,3575862660,11
2,700,11712,3575862649,3575862663,14
2,700,11713,3575862649,3575862665,16
2,700,11714,3575862649,3575862666,17
2,700,11715,3575862649,3575862667,18
2,700,11716,3575862649,3575862674,25
2,700,11717,3575862649,3575862675,26
2,700,11718,3575862649,3575862675,26
2,700,11719,3575862649,3575862676,27
2,700,11720,3575862649,3575862676,27
2,700,11721,3575862649,3575862679,30
2,700,11722,3575862649,3575862679,30
2,700,11723,3575862649,3575862679,30
2,700,11724,3575862649,3575862680,31
2,700,11725,3575862649,3575862680,31
2,700,11726,3575862649,3575862681,32
2,700,11727,3575862649,3575862682,33
2,700,11728,3575862649,3575862684,35
2,700,11729,3575862649,3575862685,36
2,700,11730,3575862649,3575862686,37
2,700,11731,3575862649,3575862686,37
2,700,11732,3575862649,3575862687,38
2,700,11733,3575862649,3575862688,39
2,700,11734,3575862649,3575862690,41
2,700,11735,3575862649,3575862691,42
2,700,11736,3575862649,3575862691,42
2,700,11737,3575862649,3575862691,42
2,700,11738,3575862649,3575862693,44
2,700,11739,3575862649,3575862695,46
2,700,11740,3575862649,3575862696,47
2,700,11741,3575862649,3575862697,48
2,700,11742,3575862649,3575862699,50
2,701,11743,3575862706,3575862706,0
2,701,11744,3575862706,3575862706,0
2,701,11745,3575862706,3575862706,0
2,701,11746,3575862706,3575862706,0
2,701,11747,3575862706,3575862706,0
2,701,11748,3575862706,3575862706,0
2,701,11749,3575862706,3575862706,0
2,701,11750,3575862706,3575862708,2
2,701,11751,3575862706,3575862708,2
2,701,11752,3575862706,3575862708,2
2,701,11753,3575862706,3575862709,3
2,701,11754,3575862706,3575862711,5
2,701,11755,3575862706,3575862713,7
2,701,11756,3575862706,3575862713,7
2,701,11757,3575862706,3575862715,9
2,701,11758,3575862706,3575862715,9
2,701,11759,3575862706,3575862715,9
2,701,11760,3575862706,3575862717,11
2,701,11761,3575862706,3575862718,12
2,701,11762,3575862706,3575862719,13
2,701,11763,3575862706,3575862721,15
2,701,11764,3575862706,3575862724,18
2,701,11765,3575862706,3575862725,19
2,701,11766,3575862706,3575862726,20
2,701,11767,3575862706,3575862727,21
2,701,11768,3575862706,3575862728,22
2,701,11769,3575862706,3575862731,25
2,701,11770,3575862706,3575862731,25
2,701,11771,3575862706,3575862731,25
2,701,11772,3575862706,3575862732,26
2,701,11773,3575862706,3575862733,27
2,701,11774,3575862706,3575862734,28
2,701,11775,3575862706,3575862734,28
2,701,11776,3575862706,3575862735,29
2,701,11777,3575862706,3575862738,32
2,701,11778,3575862706,3575862739,33
2,701,11779,3575862706,3575862740,34
2,701,11780,3575862706,3575862740,34
2,701,11781,3575862706,3575862742,36
2,701,11782,3575862706,3575862744,38
2,701,11783,3575862706,3575862745,39
2,701,11784,3575862706,3575862746,40
2,701,11785,3575862706,3575862746,40
2,701,11786,3575862706,3575862747,41
2,701,11787,3575862706,3575862748,42
2,701,11788,3575862706,3575862748,42
2,701,11789,3575862706,3575862750,44
2,701,11790,3575862706,3575862750,44
2,701,11791,3575862706,3575862751,45
2,701,11792,3575862706,3575862751,45
2,701,11793,3575862706,3575862754,48
2,702,11794,3575862762,3575862762,0
2,702,11795,3575862762,3575862762,0
2,702,11796,3575862762,3575862762,0
2,702,11797,3575862762,3575862765,3
2,702,11798,3575862762,3575862766,4
2,702,11799,3575862762,3575862767,5
2,702,11800,3575862762,3575862769,7
2,702,11801,3575862762,3575862770,8
2,702,11802,3575862762,3575862773,11
2,702,11803,3575862762,3575862773,11
2,702,11804,3575862762,3575862775,13
2,702,11805,3575862762,3575862777,15
2,702,11806,3575862762,3575862778,16
2,702,11807,3575862762,3575862780,18
2,702,11808,3575862762,3575862780,18
2,702,11809,3575862762,3575862781,19
2,702,11810,3575862762,3575862782,20
2,702,11811,3575862762,3575862782,20
2,702,11812,3575862762,3575862783,21
2,702,11813,3575862762,3575862784,22
2,702,11814,3575862762,3575862785,23
2,702,11815,3575862762,3575862786,24
2,702,11816,3575862762,3575862788,26
2,702,11817,3575862762,3575862788,26
2,702,11818,3575862762,3575862789,27
2,702,11819,3575862762,3575862792,30
2,702,11820,3575862762,3575862792,30
2,702,11821,3575862762,3575862793,31
2,702,11822,3575862762,3575862793,31
2,702,11823,3575862762,3575862798,36
2,702,11824,3575862762,3575862798,36
2,702,11825,3575862762,3575862799,37
2,702,11826,3575862762,3575862801,39
2,702,11827,3575862762,3575862801,39
2,702,11828,3575862762,3575862803,41
2,702,11829,3575862762,3575862804,42
2,702,11830,3575862762,3575862809,47
2,702,11831,3575862762,3575862810,48
2,702,11832,3575862762,3575862811,49
2,702,11833,3575862762,3575862811,49
2,702,11834,3575862762,3575862811,49
2,702,11835,3575862762,3575862812,50
2,703,11836,3575862817,3575862817,0
2,703,11837,3575862817,3575862819,2
2,703,11838,3575862817,3575862820,3
2,703,11839,3575862817,3575862820,3
2,703,11840,3575862817,3575862820,3
2,703,11841,3575862817,3575862822,5
2,703,11842,3575862817,3575862823,6
2,703,11843,3575862817,3575862826,9
2,703,11844,3575862817,3575862827,10
2,703,11845,3575862817,3575862827,10
2,703,11846,3575862817,3575862828,11
2,703,11847,3575862817,3575862835,18
2,703,11848,3575862817,3575862835,18
2,703,11849,3575862817,3575862835,18
2,703,11850,3575862817,3575862836,19
2,703,11851,3575862817,3575862837,20
2,703,11852,3575862817,3575862839,22
2,703,11853,3575862817,3575862840,23
2,703,11854,3575862817,3575862840,23
2,703,11855,3575862817,3575862841,24
2,703,11856,3575862817,3575862844,27
2,703,11857,3575862817,3575862845,28
2,703,11858,3575862817,3575862845,28
2,703,11859,3575862817,3575862845,28
2,703,11860,3575862817,3575862848,31
2,703,11861,3575862817,3575862849,32
2,703,11862,3575862817,3575862850,33
2,703,11863,3575862817,3575862852,35
2,703,11864,3575862817,3575862854,37
2,703,11865,3575862817,3575862856,39
2,703,11866,3575862817,3575862858,41
2,703,11867,3575862817,3575862858,41
2,703,11868,3575862817,3575862859,42
2,703,11869,3575862817,3575862860,43
2,703,11870,3575862817,3575862861,44
2,703,11871,3575862817,3575862863,46
2,703,11872,3575862817,3575862865,48
2,704,11873,3575862874,3575862874,0
2,704,11874,3575862874,3575862874,0
2,704,11875,3575862874,3575862874,0
2,704,11876,3575862874,3575862875,1
2,704,11877,3575862874,3575862876,2
2,704,11878,3575862874,3575862876,2
2,704,11879,3575862874,3575862879,5
2,704,11880,3575862874,3575862879,5
2,704,11881,3575862874,3575862880,6
2,704,11882,3575862874,3575862881,7
2,704,11883,3575862874,3575862881,7
2,704,11884,3575862874,3575862882,8
2,704,11885,3575862874,3575862884,10
2,704,11886,3575862874,3575862886,12
2,704,11887,3575862874,3575862887,13
2,704,11888,3575862874,3575862887,13
2,704,11889,3575862874,3575862888,14
2,704,11890,3575862874,3575862889,15
2,704,11891,3575862874,3575862891,17
2,704,11892,3575862874,3575862891,17
2,704,11893,3575862874,3575862892,18
2,704,11894,3575862874,3575862894,20
2,704,11895,3575862874,3575862895,21
2,704,11896,3575862874,3575862896,22
2,704,11897,3575862874,3575862899,25
2,704,11898,3575862874,3575862900,26
2,704,11899,3575862874,3575862903,29
2,704,11900,3575862874,3575862903,29
2,704,11901,3575862874,3575862905,31
2,704,11902,3575862874,3575862907,33
2,704,11903,3575862874,3575862908,34
2,704,11904,3575862874,3575862908,34
2,704,11905,3575862874,3575862909,35
2,704,11906,3575862874,3575862911,37
2,704,11907,3575862874,3575862912,38
2,704,11908,3575862874,3575862914,40
2,704,11909,3575862874,3575862915,41
2,704,11910,3575862874,3575862916,42
2,704,11911,3575862874,3575862916,42
2,704,11912,3575862874,3575862916,42
2,704,11913,3575862874,3575862917,43
2,704,11914,3575862874,3575862918,44
2,704,11915,3575862874,3575862919,45
2,704,11916,3575862874,3575862921,47
2,704,11917,3575862874,3575862923,49
2,705,11918,3575862930,3575862930,0
2,705,11919,3575862930,3575862930,0
2,705,11920,3575862930,3575862930,0
2,705,11921,3575862930,3575862930,0
2,705,11922,3575862930,3575862931,1
2,705,11923,3575862930,3575862931,1
2,705,11924,3575862930,3575862931,1
2,705,11925,3575862930,3575862933,3
2,705,11926,3575862930,3575862934,4
2,705,11927,3575862930,3575862935,5
2,705,11928,3575862930,3575862935,5
2,705,11929,3575862930,3575862939,9
2,705,11930,3575862930,3575862939,9
2,705,11931,3575862930,3575862939,9
2,705,11932,3575862930,3575862940,10
2,705,11933,3575862930,3575862942,12
2,705,11934,3575862930,3575862945,15
2,705,11935,3575862930,3575862946,16
2,705,11936,3575862930,3575862946,16
2,705,11937,3575862930,3575862947,17
2,705,11938,3575862930,3575862948,18
2,705,11939,3575862930,3575862948,18
2,705,11940,3575862930,3575862948,18
2,705,11941,3575862930,3575862950,20
2,705,11942,3575862930,3575862950,20
2,705,11943,3575862930,3575862951,21
2,705,11944,3575862930,3575862952,22
2,705,11945,3575862930,3575862954,24
2,705,11946,3575862930,3575862958,28
2,705,11947,3575862930,3575862958,28
2,705,11948,3575862930,3575862960,30
2,705,11949,3575862930,3575862962,32
2,705,11950,3575862930,3575862966,36
2,705,11951,3575862930,3575862966,36
2,705,11952,3575862930,3575862967,37
2,705,11953,3575862930,3575862969,39
2,705,11954,3575862930,3575862970,40
2,705,11955,3575862930,3575862972,42
2,705,11956,3575862930,3575862974,44
2,705,11957,3575862930,3575862975,45
2,705,11958,3575862930,3575862977,47
2,705,11959,3575862930,3575862978,48
2,706,11960,3575862987,3575862987,0
2,706,11961,3575862987,3575862987,0
2,706,11962,3575862987,3575862987,0
2,706,11963,3575862987,3575862987,0
2,706,11964,3575862987,3575862987,0
2,706,11965,3575862987,3575862987,0
2,706,11966,3575862987,3575862987,0
2,706,11967,3575862987,3575862987,0
2,706,11968,3575862987,3575862987,0
2,706,11969,3575862987,3575862988,1
2,706,11970,3575862987,3575862988,1
2,706,11971,3575862987,3575862988,1
2,706,11972,3575862987,3575862992,5
2,706,11973,3575862987,3575862993,6
2,706,11974,3575862987,3575862993,6
2,706,11975,3575862987,3575862993,6
2,706,11976,3575862987,3575862998,11
2,706,11977,3575862987,3575862998,11
2,706,11978,3575862987,3575862998,11
2,706,11979,3575862987,3575863001,14
2,706,11980,3575862987,3575863002,15
2,706,11981,3575862987,3575863004,17
2,706,11982,3575862987,3575863004,17
2,706,11983,3575862987,3575863009,22
2,706,11984,3575862987,3575863010,23
2,706,11985,3575862987,3575863011,24
2,706,11986,3575862987,3575863012,25
2,706,11987,3575862987,3575863012,25
2,706,11988,3575862987,3575863014,27
2,706,11989,3575862987,3575863019,32
2,706,11990,3575862987,3575863020,33
2,706,11991,3575862987,3575863020,33
2,706,11992,3575862987,3575863022,35
2,706,11993,3575862987,3575863025,38
2,706,11994,3575862987,3575863025,38
2,706,11995,3575862987,3575863026,39
2,706,11996,3575862987,3575863028,41
2,706,11997,3575862987,3575863028,41
2,706,11998,3575862987,3575863035,48
2,706,11999,3575862987,3575863035,48
2,706,12000,3575862987,3575863037,50
2,707,12001,3575863043,3575863043,0
2,707,12002,3575863043,3575863043,0
2,707,12003,3575863043,3575863043,0
2,707,12004,3575863043,3575863043,0
2,707,12005,3575863043,3575863043,0
2,707,12006,3575863043,3575863043,0
2,707,12007,3575863043,3575863044,1
2,707,12008,3575863043,3575863044,1
2,707,12009,3575863043,3575863045,2
2,707,12010,3575863043,3575863048,5
2,707,12011,3575863043,3575863049,6
2,707,12012,3575863043,3575863051,8
2,707,12013,3575863043,3575863051,8
2,707,12014,3575863043,3575863055,12
2,707,12015,3575863043,3575863056,13
2,707,12016,3575863043,3575863058,15
2,707,12017,3575863043,3575863060,17
2,707,12018,3575863043,3575863060,17
2,707,12019,3575863043,3575863061,18
2,707,12020,3575863043,3575863063,20
2,707,12021,3575863043,3575863065,22
2,707,12022,3575863043,3575863067,24
2,707,12023,3575863043,3575863067,24
2,707,12024,3575863043,3575863072,29
2,707,12025,3575863043,3575863074,31
2,707,12026,3575863043,3575863076,33
2,707,12027,3575863043,3575863076,33
2,707,12028,3575863043,3575863077,34
2,707,12029,3575863043,3575863079,36
2,707,12030,3575863043,3575863080,37
2,707,12031,3575863043,3575863081,38
2,707,12032,3575863043,3575863081,38
2,707,12033,3575863043,3575863081,38
2,707,12034,3575863043,3575863082,39
2,707,12035,3575863043,3575863085,42
2,707,12036,3575863043,3575863086,43
2,707,12037,3575863043,3575863086,43
2,707,12038,3575863043,3575863087,44
2,707,12039,3575863043,3575863087,44
2,707,12040,3575863043,3575863088,45
2,707,12041,3575863043,3575863089,46
2,707,12042,3575863043,3575863089,46
2,707,12043,3575863043,3575863092,49
2,707,12044,3575863043,3575863092,49
2,707,12045,3575863043,3575863092,49
2,708,12046,3575863099,3575863099,0
2,708,12047,3575863099,3575863099,0
2,708,12048,3575863099,3575863099,0
2,708,12049,3575863099,3575863099,0
2,708,12050,3575863099,3575863099,0
2,708,12051,3575863099,3575863100,1
2,708,12052,3575863099,3575863103,4
2,708,12053,3575863099,3575863103,4
2,708,12054,3575863099,3575863104,5
2,708,12055,3575863099,3575863105,6
2,708,12056,3575863099,3575863107,8
2,708,12057,3575863099,3575863107,8
2,708,12058,3575863099,3575863108,9
2,708,12059,3575863099,3575863110,11
2,708,12060,3575863099,3575863111,12
2,708,12061,3575863099,3575863112,13
2,708,12062,3575863099,3575863114,15
2,708,12063,3575863099,3575863115,16
2,708,12064,3575863099,3575863115,16
2,708,12065,3575863099,3575863115,16
2,708,12066,3575863099,3575863116,17
2,708,12067,3575863099,3575863117,18
2,708,12068,3575863099,3575863118,19
2,708,12069,3575863099,3575863118,19
2,708,12070,3575863099,3575863119,20
2,708,12071,3575863099,3575863121,22
2,708,12072,3575863099,3575863124,25
2,708,12073,3575863099,3575863125,26
2,708,12074,3575863099,3575863126,27
2,708,12075,3575863099,3575863127,28
2,708,12076,3575863099,3575863128,29
2,708,12077,3575863099,3575863129,30
2,708,12078,3575863099,3575863131,32
2,708,12079,3575863099,3575863132,33
2,708,12080,3575863099,3575863132,33
2,708,12081,3575863099,3575863133,34
2,708,12082,3575863099,3575863134,35
2,708,12083,3575863099,3575863135,36
2,708,12084,3575863099,3575863136,37
2,708,12085,3575863099,3575863139,40
2,708,12086,3575863099,3575863140,41
2,708,12087,3575863099,3575863140,41
2,708,12088,3575863099,3575863142,43
2,708,12089,3575863099,3575863145,46
2,708,12090,3575863099,3575863146,47
2,708,12091,3575863099,3575863147,48
2,708,12092,3575863099,3575863147,48
2,708,12093,3575863099,3575863148,49
2,708,12094,3575863099,3575863149,50
2,709,12095,3575863156,3575863156,0
2,709,12096,3575863156,3575863156,0
2,709,12097,3575863156,3575863156,0
2,709,12098,3575863156,3575863156,0
2,709,12099,3575863156,3575863156,0
2,709,12100,3575863156,3575863158,2
2,709,12101,3575863156,3575863159,3
2,709,12102,3575863156,3575863160,4
2,709,12103,3575863156,3575863162,6
2,709,12104,3575863156,3575863166,10
2,709,12105,3575863156,3575863167,11
2,709,12106,3575863156,3575863167,11
2,709,12107,3575863156,3575863170,14
2,709,12108,3575863156,3575863170,14
2,709,12109,3575863156,3575863170,14
2,709,12110,3575863156,3575863173,17
2,709,12111,3575863156,3575863174,18
2,709,12112,3575863156,3575863176,20
2,709,12113,3575863156,3575863177,21
2,709,12114,3575863156,3575863179,23
2,709,12115,3575863156,3575863181,25
2,709,12116,3575863156,3575863181,25
2,709,12117,3575863156,3575863182,26
2,709,12118,3575863156,3575863183,27
2,709,12119,3575863156,3575863183,27
2,709,12120,3575863156,3575863184,28
2,709,12121,3575863156,3575863184,28
2,709,12122,3575863156,3575863185,29
2,709,12123,3575863156,3575863187,31
2,709,12124,3575863156,3575863187,31
2,709,12125,3575863156,3575863189,33
2,709,12126,3575863156,3575863190,34
2,709,12127,3575863156,3575863192,36
2,709,12128,3575863156,3575863192,36
2,709,12129,3575863156,3575863193,37
2,709,12130,3575863156,3575863194,38
2,709,12131,3575863156,3575863196,40
2,709,12132,3575863156,3575863199,43
2,709,12133,3575863156,3575863199,43
2,709,12134,3575863156,3575863200,44
2,709,12135,3575863156,3575863202,46
2,709,12136,3575863156,3575863202,46
2,709,12137,3575863156,3575863205,49
2,709,12138,3575863156,3575863205,49
2,709,12139,3575863156,3575863205,49
2,710,12140,3575863212,3575863212,0
2,710,12141,3575863212,3575863212,0
2,710,12142,3575863212,3575863212,0
2,710,12143,3575863212,3575863212,0
2,710,12144,3575863212,3575863212,0
2,710,12145,3575863212,3575863214,2
2,710,12146,3575863212,3575863219,7
2,710,12147,3575863212,3575863220,8
2,710,12148,3575863212,3575863220,8
2,710,12149,3575863212,3575863221,9
2,710,12150,3575863212,3575863223,11
2,710,12151,3575863212,3575863225,13
2,710,12152,3575863212,3575863226,14
2,710,12153,3575863212,3575863228,16
2,710,12154,3575863212,3575863228,16
2,710,12155,3575863212,3575863229,17
2,710,12156,3575863212,3575863235,23
2,710,12157,3575863212,3575863235,23
2,710,12158,3575863212,3575863236,24
2,710,12159,3575863212,3575863237,25
2,710,12160,3575863212,3575863239,27
2,710,12161,3575863212,3575863240,28
2,710,12162,3575863212,3575863241,29
2,710,12163,3575863212,3575863242,30
2,710,12164,3575863212,3575863243,31
2,710,12165,3575863212,3575863244,32
2,710,12166,3575863212,3575863245,33
2,710,12167,3575863212,3575863245,33
2,710,12168,3575863212,3575863248,36
2,710,12169,3575863212,3575863251,39
2,710,12170,3575863212,3575863252,40
2,710,12171,3575863212,3575863256,44
2,710,12172,3575863212,3575863259,47
2,710,12173,3575863212,3575863260,48
2,710,12174,3575863212,3575863260,48
2,711,12175,3575863268,3575863268,0
2,711,12176,3575863268,3575863268,0
2,711,12177,3575863268,3575863268,0
2,711,12178,3575863268,3575863268,0
2,711,12179,3575863268,3575863268,0
2,711,12180,3575863268,3575863268,0
2,711,12181,3575863268,3575863272,4
2,711,12182,3575863268,3575863273,5
2,711,12183,3575863268,3575863275,7
2,711,12184,3575863268,3575863275,7
2,711,12185,3575863268,3575863276,8
2,711,12186,3575863268,3575863276,8
2,711,12187,3575863268,3575863279,11
2,711,12188,3575863268,3575863279,11
2,711,12189,3575863268,3575863280,12
2,711,12190,3575863268,3575863280,12
2,711,12191,3575863268,3575863281,13
2,711,12192,3575863268,3575863281,13
2,711,12193,3575863268,3575863282,14
2,711,12194,3575863268,3575863285,17
2,711,12195,3575863268,3575863286,18
2,711,12196,3575863268,3575863286,18
2,711,12197,3575863268,3575863287,19
2,711,12198,3575863268,3575863287,19
2,711,12199,3575863268,3575863288,20
2,711,12200,3575863268,3575863290,22
2,711,12201,3575863268,3575863290,22
2,711,12202,3575863268,3575863292,24
2,711,12203,3575863268,3575863292,24
2,711,12204,3575863268,3575863292,24
2,711,12205,3575863268,3575863295,27
2,711,12206,3575863268,3575863296,28
2,711,12207,3575863268,3575863297,29
2,711,12208,3575863268,3575863297,29
2,711,12209,3575863268,3575863299,31
2,711,12210,3575863268,3575863300,32
2,711,12211,3575863268,3575863302,34
2,711,12212,3575863268,3575863303,35
2,711,12213,3575863268,3575863303,35
2,711,12214,3575863268,3575863305,37
2,711,12215,3575863268,3575863306,38
2,711,12216,3575863268,3575863307,39
2,711,12217,3575863268,3575863308,40
2,711,12218,3575863268,3575863308,40
2,711,12219,3575863268,3575863311,43
2,711,12220,3575863268,3575863311,43
2,711,12221,3575863268,3575863315,47
2,711,12222,3575863268,3575863315,47
2,711,12223,3575863268,3575863315,47
2,711,12224,3575863268,3575863316,48
2,711,12225,3575863268,3575863317,49
2,711,12226,3575863268,3575863318,50
2,712,12227,3575863325,3575863325,0
2,712,12228,3575863325,3575863325,0
2,712,12229,3575863325,3575863325,0
2,712,12230,3575863325,3575863325,0
2,712,12231,3575863325,3575863325,0
2,712,12232,3575863325,3575863325,0
2,712,12233,3575863325,3575863326,1
2,712,12234,3575863325,3575863327,2
2,712,12235,3575863325,3575863328,3
2,712,12236,3575863325,3575863330,5
2,712,12237,3575863325,3575863332,7
2,712,12238,3575863325,3575863333,8
2,712,12239,3575863325,3575863334,9
2,712,12240,3575863325,3575863335,10
2,712,12241,3575863325,3575863335,10
2,712,12242,3575863325,3575863336,11
2,712,12243,3575863325,3575863340,15
2,712,12244,3575863325,3575863340,15
2,712,12245,3575863325,3575863340,15
2,712,12246,3575863325,3575863342,17
2,712,12247,3575863325,3575863345,20
2,712,12248,3575863325,3575863346,21
2,712,12249,3575863325,3575863346,21
2,712,12250,3575863325,3575863347,22
2,712,12251,3575863325,3575863348,23
2,712,12252,3575863325,3575863348,23
2,712,12253,3575863325,3575863349,24
2,712,12254,3575863325,3575863352,27
2,712,12255,3575863325,3575863352,27
2,712,12256,3575863325,3575863354,29
2,712,12257,3575863325,3575863358,33
2,712,12258,3575863325,3575863358,33
2,712,12259,3575863325,3575863360,35
2,712,12260,3575863325,3575863362,37
2,712,12261,3575863325,3575863366,41
2,712,12262,3575863325,3575863366,41
2,712,12263,3575863325,3575863368,43
2,712,12264,3575863325,3575863369,44
2,712,12265,3575863325,3575863370,45
2,712,12266,3575863325,3575863370,45
2,712,12267,3575863325,3575863374,49
2,712,12268,3575863325,3575863375,50
2,713,12269,3575863382,3575863382,0
2,713,12270,3575863382,3575863382,0
2,713,12271,3575863382,3575863382,0
2,713,12272,3575863382,3575863382,0
2,713,12273,3575863382,3575863382,0
2,713,12274,3575863382,3575863383,1
2,713,12275,3575863382,3575863383,1
2,713,12276,3575863382,3575863384,2
2,713,12277,3575863382,3575863384,2
2,713,12278,3575863382,3575863385,3
2,713,12279,3575863382,3575863385,3
2,713,12280,3575863382,3575863386,4
2,713,12281,3575863382,3575863387,5
2,713,12282,3575863382,3575863388,6
2,713,12283,3575863382,3575863390,8
2,713,12284,3575863382,3575863390,8
2,713,12285,3575863382,3575863392,10
2,713,12286,3575863382,3575863392,10
2,713,12287,3575863382,3575863393,11
2,713,12288,3575863382,3575863394,12
2,713,12289,3575863382,3575863395,13
2,713,12290,3575863382,3575863398,16
2,713,12291,3575863382,3575863399,17
2,713,12292,3575863382,3575863400,18
2,713,12293,3575863382,3575863402,20
2,713,12294,3575863382,3575863402,20
2,713,12295,3575863382,3575863404,22
2,713,12296,3575863382,3575863405,23
2,713,12297,3575863382,3575863405,23
2,713,12298,3575863382,3575863409,27
2,713,12299,3575863382,3575863411,29
2,713,12300,3575863382,3575863411,29
2,713,12301,3575863382,3575863412,30
2,713,12302,3575863382,3575863413,31
2,713,12303,3575863382,3575863414,32
2,713,12304,3575863382,3575863420,38
2,713,12305,3575863382,3575863421,39
2,713,12306,3575863382,3575863421,39
2,713,12307,3575863382,3575863424,42
2,713,12308,3575863382,3575863424,42
2,713,12309,3575863382,3575863426,44
2,713,12310,3575863382,3575863428,46
2,713,12311,3575863382,3575863429,47
2,714,12312,3575863439,3575863439,0
2,714,12313,3575863439,3575863439,0
2,714,12314,3575863439,3575863439,0
2,714,12315,3575863439,3575863439,0
2,714,12316,3575863439,3575863439,0
2,714,12317,3575863439,3575863440,1
2,714,12318,3575863439,3575863440,1
2,714,12319,3575863439,3575863441,2
2,714,12320,3575863439,3575863442,3
2,714,12321,3575863439,3575863444,5
2,714,12322,3575863439,3575863444,5
2,714,12323,3575863439,3575863445,6
2,714,12324,3575863439,3575863450,11
2,714,12325,3575863439,3575863452,13
2,714,12326,3575863439,3575863453,14
2,714,12327,3575863439,3575863456,17
2,714,12328,3575863439,3575863458,19
2,714,12329,3575863439,3575863459,20
2,714,12330,3575863439,3575863460,21
2,714,12331,3575863439,3575863460,21
2,714,12332,3575863439,3575863462,23
2,714,12333,3575863439,3575863463,24
2,714,12334,3575863439,3575863464,25
2,714,12335,3575863439,3575863465,26
2,714,12336,3575863439,3575863467,28
2,714,12337,3575863439,3575863469,30
2,714,12338,3575863439,3575863473,34
2,714,12339,3575863439,3575863473,34
2,714,12340,3575863439,3575863474,35
2,714,12341,3575863439,3575863475,36
2,714,12342,3575863439,3575863475,36
2,714,12343,3575863439,3575863476,37
2,714,12344,3575863439,3575863476,37
2,714,12345,3575863439,3575863478,39
2,714,12346,3575863439,3575863479,40
2,714,12347,3575863439,3575863480,41
2,714,12348,3575863439,3575863481,42
2,714,12349,3575863439,3575863481,42
2,714,12350,3575863439,3575863481,42
2,714,12351,3575863439,3575863482,43
2,714,12352,3575863439,3575863485,46
2,714,12353,3575863439,3575863486,47
2,714,12354,3575863439,3575863486,47
2,714,12355,3575863439,3575863487,48
2,714,12356,3575863439,3575863488,49
2,714,12357,3575863439,3575863488,49
2,714,12358,3575863439,3575863489,50
2,715,12359,3575863496,3575863496,0
2,715,12360,3575863496,3575863496,0
2,715,12361,3575863496,3575863496,0
2,715,12362,3575863496,3575863496,0
2,715,12363,3575863496,3575863496,0
2,715,12364,3575863496,3575863496,0
2,715,12365,3575863496,3575863496,0
2,715,12366,3575863496,3575863497,1
2,715,12367,3575863496,3575863498,2
2,715,12368,3575863496,3575863499,3
2,715,12369,3575863496,3575863501,5
2,715,12370,3575863496,3575863502,6
2,715,12371,3575863496,3575863503,7
2,715,12372,3575863496,3575863504,8
2,715,12373,3575863496,3575863505,9
2,715,12374,3575863496,3575863506,10
2,715,12375,3575863496,3575863506,10
2,715,12376,3575863496,3575863507,11
2,715,12377,3575863496,3575863509,13
2,715,12378,3575863496,3575863510,14
2,715,12379,3575863496,3575863512,16
2,715,12380,3575863496,3575863514,18
2,715,12381,3575863496,3575863514,18
2,715,12382,3575863496,3575863514,18
2,715,12383,3575863496,3575863514,18
2,715,12384,3575863496,3575863517,21
2,715,12385,3575863496,3575863517,21
2,715,12386,3575863496,3575863518,22
2,715,12387,3575863496,3575863519,23
2,715,12388,3575863496,3575863519,23
2,715,12389,3575863496,3575863521,25
2,715,12390,3575863496,3575863523,27
2,715,12391,3575863496,3575863524,28
2,715,12392,3575863496,3575863525,29
2,715,12393,3575863496,3575863526,30
2,715,12394,3575863496,3575863528,32
2,715,12395,3575863496,3575863531,35
2,715,12396,3575863496,3575863532,36
2,715,12397,3575863496,3575863532,36
2,715,12398,3575863496,3575863533,37
2,715,12399,3575863496,3575863533,37
2,715,12400,3575863496,3575863534,38
2,715,12401,3575863496,3575863534,38
2,715,12402,3575863496,3575863539,43
2,715,12403,3575863496,3575863540,44
2,715,12404,3575863496,3575863540,44
2,715,12405,3575863496,3575863540,44
2,715,12406,3575863496,3575863541,45
2,715,12407,3575863496,3575863544,48
2,715,12408,3575863496,3575863545,49
2,715,12409,3575863496,3575863546,50
2,716,12410,3575863552,3575863552,0
2,716,12411,3575863552,3575863552,0
2,716,12412,3575863552,3575863552,0
2,716,12413,3575863552,3575863552,0
2,716,12414,3575863552,3575863552,0
2,716,12415,3575863552,3575863552,0
2,716,12416,3575863552,3575863552,0
2,716,12417,3575863552,3575863553,1
2,716,12418,3575863552,3575863557,5
2,716,12419,3575863552,3575863559,7
2,716,12420,3575863552,3575863565,13
2,716,12421,3575863552,3575863566,14
2,716,12422,3575863552,3575863567,15
2,716,12423,3575863552,3575863568,16
2,716,12424,3575863552,3575863569,17
2,716,12425,3575863552,3575863569,17
2,716,12426,3575863552,3575863573,21
2,716,12427,3575863552,3575863574,22
2,716,12428,3575863552,3575863575,23
2,716,12429,3575863552,3575863576,24
2,716,12430,3575863552,3575863578,26
2,716,12431,3575863552,3575863580,28
2,716,12432,3575863552,3575863581,29
2,716,12433,3575863552,3575863582,30
2,716,12434,3575863552,3575863583,31
2,716,12435,3575863552,3575863583,31
2,716,12436,3575863552,3575863583,31
2,716,12437,3575863552,3575863583,31
2,716,12438,3575863552,3575863585,33
2,716,12439,3575863552,3575863585,33
2,716,12440,3575863552,3575863586,34
2,716,12441,3575863552,3575863587,35
2,716,12442,3575863552,3575863589,37
2,716,12443,3575863552,3575863589,37
2,716,12444,3575863552,3575863591,39
2,716,12445,3575863552,3575863592,40
2,716,12446,3575863552,3575863592,40
2,716,12447,3575863552,3575863592,40
2,716,12448,3575863552,3575863594,42
2,716,12449,3575863552,3575863598,46
2,716,12450,3575863552,3575863598,46
2,716,12451,3575863552,3575863600,48
2,716,12452,3575863552,3575863600,48
2,716,12453,3575863552,3575863602,50
2,717,12454,3575863610,3575863610,0
2,717,12455,3575863610,3575863610,0
2,717,12456,3575863610,3575863610,0
2,717,12457,3575863610,3575863610,0
2,717,12458,3575863610,3575863610,0
2,717,12459,3575863610,3575863610,0
2,717,12460,3575863610,3575863612,2
2,717,12461,3575863610,3575863612,2
2,717,12462,3575863610,3575863613,3
2,717,12463,3575863610,3575863620,10
2,717,12464,3575863610,3575863620,10
2,717,12465,3575863610,3575863621,11
2,717,12466,3575863610,3575863622,12
2,717,12467,3575863610,3575863622,12
2,717,12468,3575863610,3575863624,14
2,717,12469,3575863610,3575863625,15
2,717,12470,3575863610,3575863627,17
2,717,12471,3575863610,3575863627,17
2,717,12472,3575863610,3575863634,24
2,717,12473,3575863610,3575863634,24
2,717,12474,3575863610,3575863635,25
2,717,12475,3575863610,3575863638,28
2,717,12476,3575863610,3575863640,30
2,717,12477,3575863610,3575863640,30
2,717,12478,3575863610,3575863641,31
2,717,12479,3575863610,3575863643,33
2,717,12480,3575863610,3575863644,34
2,717,12481,3575863610,3575863649,39
2,717,12482,3575863610,3575863651,41
2,717,12483,3575863610,3575863653,43
2,717,12484,3575863610,3575863655,45
2,717,12485,3575863610,3575863655,45
2,717,12486,3575863610,3575863657,47
2,717,12487,3575863610,3575863658,48
2,717,12488,3575863610,3575863659,49
2,717,12489,3575863610,3575863659,49
2,718,12490,3575863666,3575863666,0
2,718,12491,3575863666,3575863666,0
2,718,12492,3575863666,3575863666,0
2,718,12493,3575863666,3575863666,0
2,718,12494,3575863666,3575863666,0
2,718,12495,3575863666,3575863668,2
2,718,12496,3575863666,3575863673,7
2,718,12497,3575863666,3575863675,9
2,718,12498,3575863666,3575863675,9
2,718,12499,3575863666,3575863675,9
2,718,12500,3575863666,3575863677,11
2,718,12501,3575863666,3575863677,11
2,718,12502,3575863666,3575863678,12
2,718,12503,3575863666,3575863679,13
2,718,12504,3575863666,3575863680,14
2,718,12505,3575863666,3575863680,14
2,718,12506,3575863666,3575863681,15
2,718,12507,3575863666,3575863681,15
2,718,12508,3575863666,3575863682,16
2,718,12509,3575863666,3575863682,16
2,718,12510,3575863666,3575863685,19
2,718,12511,3575863666,3575863685,19
2,718,12512,3575863666,3575863686,20
2,718,12513,3575863666,3575863687,21
2,718,12514,3575863666,3575863687,21
2,718,12515,3575863666,3575863687,21
2,718,12516,3575863666,3575863688,22
2,718,12517,3575863666,3575863690,24
2,718,12518,3575863666,3575863690,24
2,718,12519,3575863666,3575863691,25
2,718,12520,3575863666,3575863693,27
2,718,12521,3575863666,3575863695,29
2,718,12522,3575863666,3575863696,30
2,718,12523,3575863666,3575863696,30
2,718,12524,3575863666,3575863697,31
2,718,12525,3575863666,3575863699,33
2,718,12526,3575863666,3575863701,35
2,718,12527,3575863666,3575863702,36
2,718,12528,3575863666,3575863703,37
2,718,12529,3575863666,3575863704,38
2,718,12530,3575863666,3575863705,39
2,718,12531,3575863666,3575863706,40
2,718,12532,3575863666,3575863707,41
2,718,12533,3575863666,3575863708,42
2,718,12534,3575863666,3575863709,43
2,718,12535,3575863666,3575863710,44
2,718,12536,3575863666,3575863711,45
2,718,12537,3575863666,3575863714,48
2,718,12538,3575863666,3575863714,48
2,718,12539,3575863666,3575863714,48
2,718,12540,3575863666,3575863715,49
2,718,12541,3575863666,3575863716,50
2,719,12542,3575863722,3575863722,0
2,719,12543,3575863722,3575863722,0
2,719,12544,3575863722,3575863722,0
2,719,12545,3575863722,3575863722,0
2,719,12546,3575863722,3575863722,0
2,719,12547,3575863722,3575863722,0
2,719,12548,3575863722,3575863724,2
2,719,12549,3575863722,3575863724,2
2,719,12550,3575863722,3575863726,4
2,719,12551,3575863722,3575863726,4
2,719,12552,3575863722,3575863728,6
2,719,12553,3575863722,3575863730,8
2,719,12554,3575863722,3575863731,9
2,719,12555,3575863722,3575863732,10
2,719,12556,3575863722,3575863732,10
2,719,12557,3575863722,3575863733,11
2,719,12558,3575863722,3575863734,12
2,719,12559,3575863722,3575863734,12
2,719,12560,3575863722,3575863734,12
2,719,12561,3575863722,3575863739,17
2,719,12562,3575863722,3575863739,17
2,719,12563,3575863722,3575863740,18
2,719,12564,3575863722,3575863740,18
2,719,12565,3575863722,3575863742,20
2,719,12566,3575863722,3575863744,22
2,719,12567,3575863722,3575863745,23
2,719,12568,3575863722,3575863746,24
2,719,12569,3575863722,3575863747,25
2,719,12570,3575863722,3575863748,26
2,719,12571,3575863722,3575863748,26
2,719,12572,3575863722,3575863749,27
2,719,12573,3575863722,3575863750,28
2,719,12574,3575863722,3575863751,29
2,719,12575,3575863722,3575863751,29
2,719,12576,3575863722,3575863754,32
2,719,12577,3575863722,3575863757,35
2,719,12578,3575863722,3575863758,36
2,719,12579,3575863722,3575863765,43
2,719,12580,3575863722,3575863766,44
2,719,12581,3575863722,3575863767,45
2,719,12582,3575863722,3575863769,47
2,719,12583,3575863722,3575863769,47
2,719,12584,3575863722,3575863769,47
2,720,12585,3575863778,3575863778,0
2,720,12586,3575863778,3575863778,0
2,720,12587,3575863778,3575863778,0
2,720,12588,3575863778,3575863778,0
2,720,12589,3575863778,3575863778,0
2,720,12590,3575863778,3575863780,2
2,720,12591,3575863778,3575863782,4
2,720,12592,3575863778,3575863782,4
2,720,12593,3575863778,3575863783,5
2,720,12594,3575863778,3575863783,5
2,720,12595,3575863778,3575863783,5
2,720,12596,3575863778,3575863784,6
2,720,12597,3575863778,3575863785,7
2,720,12598,3575863778,3575863785,7
2,720,12599,3575863778,3575863785,7
2,720,12600,3575863778,3575863785,7
2,720,12601,3575863778,3575863788,10
2,720,12602,3575863778,3575863789,11
2,720,12603,3575863778,3575863789,11
2,720,12604,3575863778,3575863791,13
2,720,12605,3575863778,3575863791,13
2,720,12606,3575863778,3575863792,14
2,720,12607,3575863778,3575863792,14
2,720,12608,3575863778,3575863795,17
2,720,12609,3575863778,3575863798,20
2,720,12610,3575863778,3575863798,20
2,720,12611,3575863778,3575863801,23
2,720,12612,3575863778,3575863801,23
2,720,12613,3575863778,3575863802,24
2,720,12614,3575863778,3575863803,25
2,720,12615,3575863778,3575863804,26
2,720,12616,3575863778,3575863809,31
2,720,12617,3575863778,3575863809,31
2,720,12618,3575863778,3575863810,32
2,720,12619,3575863778,3575863811,33
2,720,12620,3575863778,3575863812,34
2,720,12621,3575863778,3575863813,35
2,720,12622,3575863778,3575863820,42
2,720,12623,3575863778,3575863820,42
2,720,12624,3575863778,3575863820,42
2,720,12625,3575863778,3575863820,42
2,720,12626,3575863778,3575863822,44
2,720,12627,3575863778,3575863822,44
2,720,12628,3575863778,3575863823,45
2,720,12629,3575863778,3575863825,47
2,720,12630,3575863778,3575863826,48
2,720,12631,3575863778,3575863828,50
2,721,12632,3575863835,3575863835,0
2,721,12633,3575863835,3575863835,0
2,721,12634,3575863835,3575863835,0
2,721,12635,3575863835,3575863835,0
2,721,12636,3575863835,3575863838,3
2,721,12637,3575863835,3575863840,5
2,721,12638,3575863835,3575863840,5
2,721,12639,3575863835,3575863840,5
2,721,12640,3575863835,3575863841,6
2,721,12641,3575863835,3575863843,8
2,721,12642,3575863835,3575863844,9
2,721,12643,3575863835,3575863845,10
2,721,12644,3575863835,3575863846,11
2,721,12645,3575863835,3575863849,14
2,721,12646,3575863835,3575863849,14
2,721,12647,3575863835,3575863852,17
2,721,12648,3575863835,3575863852,17
2,721,12649,3575863835,3575863854,19
2,721,12650,3575863835,3575863856,21
2,721,12651,3575863835,3575863857,22
2,721,12652,3575863835,3575863859,24
2,721,12653,3575863835,3575863859,24
2,721,12654,3575863835,3575863860,25
2,721,12655,3575863835,3575863861,26
2,721,12656,3575863835,3575863863,28
2,721,12657,3575863835,3575863864,29
2,721,12658,3575863835,3575863865,30
2,721,12659,3575863835,3575863866,31
2,721,12660,3575863835,3575863868,33
2,721,12661,3575863835,3575863873,38
2,721,12662,3575863835,3575863875,40
2,721,12663,3575863835,3575863875,40
2,721,12664,3575863835,3575863875,40
2,721,12665,3575863835,3575863877,42
2,721,12666,3575863835,3575863878,43
2,721,12667,3575863835,3575863878,43
2,721,12668,3575863835,3575863879,44
2,721,12669,3575863835,3575863880,45
2,721,12670,3575863835,3575863880,45
2,721,12671,3575863835,3575863881,46
2,721,12672,3575863835,3575863882,47
2,721,12673,3575863835,3575863882,47
2,721,12674,3575863835,3575863883,48
2,721,12675,3575863835,3575863884,49
2,721,12676,3575863835,3575863885,50
2,722,12677,3575863892,3575863892,0
2,722,12678,3575863892,3575863892,0
2,722,12679,3575863892,3575863892,0
2,722,12680,3575863892,3575863892,0
2,722,12681,3575863892,3575863892,0
2,722,12682,3575863892,3575863892,0
2,722,12683,3575863892,3575863892,0
2,722,12684,3575863892,3575863892,0
2,722,12685,3575863892,3575863893,1
2,722,12686,3575863892,3575863893,1
2,722,12687,3575863892,3575863895,3
2,722,12688,3575863892,3575863896,4
2,722,12689,3575863892,3575863897,5
2,722,12690,3575863892,3575863897,5
2,722,12691,3575863892,3575863900,8
2,722,12692,3575863892,3575863901,9
2,722,12693,3575863892,3575863901,9
2,722,12694,3575863892,3575863903,11
2,722,12695,3575863892,3575863905,13
2,722,12696,3575863892,3575863905,13
2,722,12697,3575863892,3575863906,14
2,722,12698,3575863892,3575863907,15
2,722,12699,3575863892,3575863910,18
2,722,12700,3575863892,3575863910,18
2,722,12701,3575863892,3575863911,19
2,722,12702,3575863892,3575863914,22
2,722,12703,3575863892,3575863914,22
2,722,12704,3575863892,3575863915,23
2,722,12705,3575863892,3575863915,23
2,722,12706,3575863892,3575863917,25
2,722,12707,3575863892,3575863917,25
2,722,12708,3575863892,3575863919,27
2,722,12709,3575863892,3575863919,27
2,722,12710,3575863892,3575863920,28
2,722,12711,3575863892,3575863920,28
2,722,12712,3575863892,3575863922,30
2,722,12713,3575863892,3575863923,31
2,722,12714,3575863892,3575863924,32
2,722,12715,3575863892,3575863926,34
2,722,12716,3575863892,3575863927,35
2,722,12717,3575863892,3575863928,36
2,722,12718,3575863892,3575863930,38
2,722,12719,3575863892,3575863930,38
2,722,12720,3575863892,3575863932,40
2,722,12721,3575863892,3575863933,41
2,722,12722,3575863892,3575863933,41
2,722,12723,3575863892,3575863934,42
2,722,12724,3575863892,3575863935,43
2,722,12725,3575863892,3575863939,47
2,722,12726,3575863892,3575863939,47
2,722,12727,3575863892,3575863940,48
2,722,12728,3575863892,3575863940,48
2,723,12729,3575863948,3575863948,0
2,723,12730,3575863948,3575863948,0
2,723,12731,3575863948,3575863948,0
2,723,12732,3575863948,3575863948,0
2,723,12733,3575863948,3575863948,0
2,723,12734,3575863948,3575863948,0
2,723,12735,3575863948,3575863949,1
2,723,12736,3575863948,3575863950,2
2,723,12737,3575863948,3575863952,4
2,723,12738,3575863948,3575863952,4
2,723,12739,3575863948,3575863954,6
2,723,12740,3575863948,3575863957,9
2,723,12741,3575863948,3575863958,10
2,723,12742,3575863948,3575863961,13
2,723,12743,3575863948,3575863965,17
2,723,12744,3575863948,3575863966,18
2,723,12745,3575863948,3575863967,19
2,723,12746,3575863948,3575863969,21
2,723,12747,3575863948,3575863969,21
2,723,12748,3575863948,3575863970,22
2,723,12749,3575863948,3575863972,24
2,723,12750,3575863948,3575863974,26
2,723,12751,3575863948,3575863975,27
2,723,12752,3575863948,3575863977,29
2,723,12753,3575863948,3575863978,30
2,723,12754,3575863948,3575863981,33
2,723,12755,3575863948,3575863982,34
2,723,12756,3575863948,3575863983,35
2,723,12757,3575863948,3575863983,35
2,723,12758,3575863948,3575863983,35
2,723,12759,3575863948,3575863984,36
2,723,12760,3575863948,3575863985,37
2,723,12761,3575863948,3575863985,37
2,723,12762,3575863948,3575863985,37
2,723,12763,3575863948,3575863986,38
2,723,12764,3575863948,3575863987,39
2,723,12765,3575863948,3575863989,41
2,723,12766,3575863948,3575863991,43
2,723,12767,3575863948,3575863991,43
2,723,12768,3575863948,3575863993,45
2,723,12769,3575863948,3575863994,46
2,723,12770,3575863948,3575863995,47
2,724,12771,3575864004,3575864004,0
2,724,12772,3575864004,3575864004,0
2,724,12773,3575864004,3575864004,0
2,724,12774,3575864004,3575864004,0
2,724,12775,3575864004,3575864004,0
2,724,12776,3575864004,3575864004,0
2,724,12777,3575864004,3575864004,0
2,724,12778,3575864004,3575864009,5
2,724,12779,3575864004,3575864009,5
2,724,12780,3575864004,3575864011,7
2,724,12781,3575864004,3575864011,7
2,724,12782,3575864004,3575864012,8
2,724,12783,3575864004,3575864013,9
2,724,12784,3575864004,3575864020,16
2,724,12785,3575864004,3575864021,17
2,724,12786,3575864004,3575864021,17
2,724,12787,3575864004,3575864022,18
2,724,12788,3575864004,3575864025,21
2,724,12789,3575864004,3575864025,21
2,724,12790,3575864004,3575864026,22
2,724,12791,3575864004,3575864027,23
2,724,12792,3575864004,3575864028,24
2,724,12793,3575864004,3575864035,31
2,724,12794,3575864004,3575864036,32
2,724,12795,3575864004,3575864036,32
2,724,12796,3575864004,3575864037,33
2,724,12797,3575864004,3575864039,35
2,724,12798,3575864004,3575864040,36
2,724,12799,3575864004,3575864040,36
2,724,12800,3575864004,3575864041,37
2,724,12801,3575864004,3575864042,38
2,724,12802,3575864004,3575864043,39
2,724,12803,3575864004,3575864044,40
2,724,12804,3575864004,3575864045,41
2,724,12805,3575864004,3575864046,42
2,724,12806,3575864004,3575864049,45
2,724,12807,3575864004,3575864049,45
2,724,12808,3575864004,3575864052,48
2,724,12809,3575864004,3575864053,49
2,725,12810,3575864063,3575864063,0
2,725,12811,3575864063,3575864063,0
2,725,12812,3575864063,3575864063,0
2,725,12813,3575864063,3575864063,0
2,725,12814,3575864063,3575864063,0
2,725,12815,3575864063,3575864063,0
2,725,12816,3575864063,3575864063,0
2,725,12817,3575864063,3575864064,1
2,725,12818,3575864063,3575864065,2
2,725,12819,3575864063,3575864066,3
2,725,12820,3575864063,3575864068,5
2,725,12821,3575864063,3575864073,10
2,725,12822,3575864063,3575864073,10
2,725,12823,3575864063,3575864075,12
2,725,12824,3575864063,3575864075,12
2,725,12825,3575864063,3575864075,12
2,725,12826,3575864063,3575864076,13
2,725,12827,3575864063,3575864078,15
2,725,12828,3575864063,3575864079,16
2,725,12829,3575864063,3575864079,16
2,725,12830,3575864063,3575864081,18
2,725,12831,3575864063,3575864081,18
2,725,12832,3575864063,3575864082,19
2,725,12833,3575864063,3575864082,19
2,725,12834,3575864063,3575864082,19
2,725,12835,3575864063,3575864082,19
2,725,12836,3575864063,3575864084,21
2,725,12837,3575864063,3575864085,22
2,725,12838,3575864063,3575864085,22
2,725,12839,3575864063,3575864088,25
2,725,12840,3575864063,3575864088,25
2,725,12841,3575864063,3575864088,25
2,725,12842,3575864063,3575864090,27
2,725,12843,3575864063,3575864090,27
2,725,12844,3575864063,3575864090,27
2,725,12845,3575864063,3575864091,28
2,725,12846,3575864063,3575864092,29
2,725,12847,3575864063,3575864093,30
2,725,12848,3575864063,3575864095,32
2,725,12849,3575864063,3575864096,33
2,725,12850,3575864063,3575864096,33
2,725,12851,3575864063,3575864097,34
2,725,12852,3575864063,3575864098,35
2,725,12853,3575864063,3575864100,37
2,725,12854,3575864063,3575864101,38
2,725,12855,3575864063,3575864102,39
2,725,12856,3575864063,3575864103,40
2,725,12857,3575864063,3575864105,42
2,725,12858,3575864063,3575864105,42
2,725,12859,3575864063,3575864106,43
2,725,12860,3575864063,3575864107,44
2,725,12861,3575864063,3575864110,47
2,725,12862,3575864063,3575864110,47
2,726,12863,3575864120,3575864120,0
2,726,12864,3575864120,3575864120,0
2,726,12865,3575864120,3575864120,0
2,726,12866,3575864120,3575864120,0
2,726,12867,3575864120,3575864120,0
2,726,12868,3575864120,3575864120,0
2,726,12869,3575864120,3575864120,0
2,726,12870,3575864120,3575864121,1
2,726,12871,3575864120,3575864122,2
2,726,12872,3575864120,3575864124,4
2,726,12873,3575864120,3575864125,5
2,726,12874,3575864120,3575864126,6
2,726,12875,3575864120,3575864127,7
2,726,12876,3575864120,3575864131,11
2,726,12877,3575864120,3575864132,12
2,726,12878,3575864120,3575864132,12
2,726,12879,3575864120,3575864133,13
2,726,12880,3575864120,3575864134,14
2,726,12881,3575864120,3575864134,14
2,726,12882,3575864120,3575864139,19
2,726,12883,3575864120,3575864139,19
2,726,12884,3575864120,3575864139,19
2,726,12885,3575864120,3575864140,20
2,726,12886,3575864120,3575864142,22
2,726,12887,3575864120,3575864146,26
2,726,12888,3575864120,3575864146,26
2,726,12889,3575864120,3575864148,28
2,726,12890,3575864120,3575864149,29
2,726,12891,3575864120,3575864149,29
2,726,12892,3575864120,3575864150,30
2,726,12893,3575864120,3575864151,31
2,726,12894,3575864120,3575864152,32
2,726,12895,3575864120,3575864154,34
2,726,12896,3575864120,3575864158,38
2,726,12897,3575864120,3575864159,39
2,726,12898,3575864120,3575864161,41
2,726,12899,3575864120,3575864165,45
2,726,12900,3575864120,3575864165,45
2,726,12901,3575864120,3575864168,48
2,726,12902,3575864120,3575864169,49
2,726,12903,3575864120,3575864170,50
2,727,12904,3575864176,3575864176,0
2,727,12905,3575864176,3575864176,0
2,727,12906,3575864176,3575864176,0
2,727,12907,3575864176,3575864176,0
2,727,12908,3575864176,3575864177,1
2,727,12909,3575864176,3575864178,2
2,727,12910,3575864176,3575864181,5
2,727,12911,3575864176,3575864182,6
2,727,12912,3575864176,3575864183,7
2,727,12913,3575864176,3575864183,7
2,727,12914,3575864176,3575864183,7
2,727,12915,3575864176,3575864185,9
2,727,12916,3575864176,3575864185,9
2,727,12917,3575864176,3575864185,9
2,727,12918,3575864176,3575864185,9
2,727,12919,3575864176,3575864187,11
2,727,12920,3575864176,3575864187,11
2,727,12921,3575864176,3575864188,12
2,727,12922,3575864176,3575864189,13
2,727,12923,3575864176,3575864189,13
2,727,12924,3575864176,3575864191,15
2,727,12925,3575864176,3575864192,16
2,727,12926,3575864176,3575864193,17
2,727,12927,3575864176,3575864194,18
2,727,12928,3575864176,3575864195,19
2,727,12929,3575864176,3575864199,23
2,727,12930,3575864176,3575864199,23
2,727,12931,3575864176,3575864202,26
2,727,12932,3575864176,3575864202,26
2,727,12933,3575864176,3575864202,26
2,727,12934,3575864176,3575864204,28
2,727,12935,3575864176,3575864205,29
2,727,12936,3575864176,3575864209,33
2,727,12937,3575864176,3575864209,33
2,727,12938,3575864176,3575864211,35
2,727,12939,3575864176,3575864212,36
2,727,12940,3575864176,3575864212,36
2,727,12941,3575864176,3575864214,38
2,727,12942,3575864176,3575864220,44
2,727,12943,3575864176,3575864221,45
2,727,12944,3575864176,3575864221,45
2,727,12945,3575864176,3575864222,46
2,727,12946,3575864176,3575864222,46
2,727,12947,3575864176,3575864225,49
2,728,12948,3575864234,3575864234,0
2,728,12949,3575864234,3575864234,0
2,728,12950,3575864234,3575864234,0
2,728,12951,3575864234,3575864234,0
2,728,12952,3575864234,3575864235,1
2,728,12953,3575864234,3575864236,2
2,728,12954,3575864234,3575864237,3
2,728,12955,3575864234,3575864238,4
2,728,12956,3575864234,3575864239,5
2,728,12957,3575864234,3575864240,6
2,728,12958,3575864234,3575864240,6
2,728,12959,3575864234,3575864242,8
2,728,12960,3575864234,3575864244,10
2,728,12961,3575864234,3575864244,10
2,728,12962,3575864234,3575864245,11
2,728,12963,3575864234,3575864247,13
2,728,12964,3575864234,3575864249,15
2,728,12965,3575864234,3575864250,16
2,728,12966,3575864234,3575864252,18
2,728,12967,3575864234,3575864253,19
2,728,12968,3575864234,3575864255,21
2,728,12969,3575864234,3575864256,22
2,728,12970,3575864234,3575864257,23
2,728,12971,3575864234,3575864260,26
2,728,12972,3575864234,3575864260,26
2,728,12973,3575864234,3575864260,26
2,728,12974,3575864234,3575864262,28
2,728,12975,3575864234,3575864264,30
2,728,12976,3575864234,3575864266,32
2,728,12977,3575864234,3575864266,32
2,728,12978,3575864234,3575864268,34
2,728,12979,3575864234,3575864273,39
2,728,12980,3575864234,3575864273,39
2,728,12981,3575864234,3575864274,40
2,728,12982,3575864234,3575864275,41
2,728,12983,3575864234,3575864276,42
2,728,12984,3575864234,3575864276,42
2,728,12985,3575864234,3575864278,44
2,728,12986,3575864234,3575864279,45
2,728,12987,3575864234,3575864279,45
2,728,12988,3575864234,3575864280,46
2,728,12989,3575864234,3575864280,46
2,728,12990,3575864234,3575864281,47
2,728,12991,3575864234,3575864281,47
2,728,12992,3575864234,3575864282,48
2,728,12993,3575864234,3575864282,48
2,728,12994,3575864234,3575864283,49
2,729,12995,3575864292,3575864292,0
2,729,12996,3575864292,3575864292,0
2,729,12997,3575864292,3575864292,0
2,729,12998,3575864292,3575864292,0
2,729,12999,3575864292,3575864292,0
2,729,13000,3575864292,3575864292,0
2,729,13001,3575864292,3575864292,0
2,729,13002,3575864292,3575864292,0
2,729,13003,3575864292,3575864292,0
2,729,13004,3575864292,3575864292,0
2,729,13005,3575864292,3575864292,0
2,729,13006,3575864292,3575864293,1
2,729,13007,3575864292,3575864293,1
2,729,13008,3575864292,3575864295,3
2,729,13009,3575864292,3575864296,4
2,729,13010,3575864292,3575864298,6
2,729,13011,3575864292,3575864298,6
2,729,13012,3575864292,3575864298,6
2,729,13013,3575864292,3575864300,8
2,729,13014,3575864292,3575864301,9
2,729,13015,3575864292,3575864302,10
2,729,13016,3575864292,3575864303,11
2,729,13017,3575864292,3575864305,13
2,729,13018,3575864292,3575864306,14
2,729,13019,3575864292,3575864306,14
2,729,13020,3575864292,3575864307,15
2,729,13021,3575864292,3575864309,17
2,729,13022,3575864292,3575864309,17
2,729,13023,3575864292,3575864310,18
2,729,13024,3575864292,3575864312,20
2,729,13025,3575864292,3575864312,20
2,729,13026,3575864292,3575864315,23
2,729,13027,3575864292,3575864316,24
2,729,13028,3575864292,3575864317,25
2,729,13029,3575864292,3575864318,26
2,729,13030,3575864292,3575864318,26
2,729,13031,3575864292,3575864319,27
2,729,13032,3575864292,3575864320,28
2,729,13033,3575864292,3575864320,28
2,729,13034,3575864292,3575864321,29
2,729,13035,3575864292,3575864322,30
2,729,13036,3575864292,3575864324,32
2,729,13037,3575864292,3575864324,32
2,729,13038,3575864292,3575864330,38
2,729,13039,3575864292,3575864332,40
2,729,13040,3575864292,3575864332,40
2,729,13041,3575864292,3575864333,41
2,729,13042,3575864292,3575864335,43
2,729,13043,3575864292,3575864335,43
2,729,13044,3575864292,3575864335,43
2,729,13045,3575864292,3575864340,48
2,729,13046,3575864292,3575864340,48
2,729,13047,3575864292,3575864341,49
2,730,13048,3575864351,3575864351,0
2,730,13049,3575864351,3575864351,0
2,730,13050,3575864351,3575864351,0
2,730,13051,3575864351,3575864351,0
2,730,13052,3575864351,3575864351,0
2,730,13053,3575864351,3575864351,0
2,730,13054,3575864351,3575864351,0
2,730,13055,3575864351,3575864351,0
2,730,13056,3575864351,3575864351,0
2,730,13057,3575864351,3575864352,1
2,730,13058,3575864351,3575864353,2
2,730,13059,3575864351,3575864354,3
2,730,13060,3575864351,3575864358,7
2,730,13061,3575864351,3575864361,10
2,730,13062,3575864351,3575864365,14
2,730,13063,3575864351,3575864366,15
2,730,13064,3575864351,3575864368,17
2,730,13065,3575864351,3575864369,18
2,730,13066,3575864351,3575864370,19
2,730,13067,3575864351,3575864373,22
2,730,13068,3575864351,3575864373,22
2,730,13069,3575864351,3575864375,24
2,730,13070,3575864351,3575864375,24
2,730,13071,3575864351,3575864377,26
2,730,13072,3575864351,3575864379,28
2,730,13073,3575864351,3575864381,30
2,730,13074,3575864351,3575864382,31
2,730,13075,3575864351,3575864383,32
2,730,13076,3575864351,3575864383,32
2,730,13077,3575864351,3575864383,32
2,730,13078,3575864351,3575864384,33
2,730,13079,3575864351,3575864385,34
2,730,13080,3575864351,3575864386,35
2,730,13081,3575864351,3575864386,35
2,730,13082,3575864351,3575864386,35
2,730,13083,3575864351,3575864387,36
2,730,13084,3575864351,3575864388,37
2,730,13085,3575864351,3575864389,38
2,730,13086,3575864351,3575864391,40
2,730,13087,3575864351,3575864392,41
2,730,13088,3575864351,3575864393,42
2,730,13089,3575864351,3575864393,42
2,730,13090,3575864351,3575864395,44
2,730,13091,3575864351,3575864398,47
2,730,13092,3575864351,3575864399,48
2,731,13093,3575864409,3575864409,0
2,731,13094,3575864409,3575864409,0
2,731,13095,3575864409,3575864409,0
2,731,13096,3575864409,3575864409,0
2,731,13097,3575864409,3575864409,0
2,731,13098,3575864409,3575864409,0
2,731,13099,3575864409,3575864409,0
2,731,13100,3575864409,3575864410,1
2,731,13101,3575864409,3575864411,2
2,731,13102,3575864409,3575864411,2
2,731,13103,3575864409,3575864413,4
2,731,13104,3575864409,3575864414,5
2,731,13105,3575864409,3575864420,11
2,731,13106,3575864409,3575864421,12
2,731,13107,3575864409,3575864422,13
2,731,13108,3575864409,3575864422,13
2,731,13109,3575864409,3575864423,14
2,731,13110,3575864409,3575864424,15
2,731,13111,3575864409,3575864424,15
2,731,13112,3575864409,3575864426,17
2,731,13113,3575864409,3575864427,18
2,731,13114,3575864409,3575864429,20
2,731,13115,3575864409,3575864435,26
2,731,13116,3575864409,3575864436,27
2,731,13117,3575864409,3575864438,29
2,731,13118,3575864409,3575864438,29
2,731,13119,3575864409,3575864440,31
2,731,13120,3575864409,3575864440,31
2,731,13121,3575864409,3575864441,32
2,731,13122,3575864409,3575864442,33
2,731,13123,3575864409,3575864443,34
2,731,13124,3575864409,3575864444,35
2,731,13125,3575864409,3575864445,36
2,731,13126,3575864409,3575864447,38
2,731,13127,3575864409,3575864450,41
2,731,13128,3575864409,3575864450,41
2,731,13129,3575864409,3575864451,42
2,731,13130,3575864409,3575864452,43
2,731,13131,3575864409,3575864456,47
2,731,13132,3575864409,3575864456,47
2,731,13133,3575864409,3575864457,48
2,731,13134,3575864409,3575864459,50
2,732,13135,3575864467,3575864467,0
2,732,13136,3575864467,3575864467,0
2,732,13137,3575864467,3575864467,0
2,732,13138,3575864467,3575864467,0
2,732,13139,3575864467,3575864467,0
2,732,13140,3575864467,3575864468,1
2,732,13141,3575864467,3575864473,6
2,732,13142,3575864467,3575864474,7
2,732,13143,3575864467,3575864474,7
2,732,13144,3575864467,3575864475,8
2,732,13145,3575864467,3575864476,9
2,732,13146,3575864467,3575864476,9
2,732,13147,3575864467,3575864478,11
2,732,13148,3575864467,3575864479,12
2,732,13149,3575864467,3575864479,12
2,732,13150,3575864467,3575864480,13
2,732,13151,3575864467,3575864480,13
2,732,13152,3575864467,3575864481,14
2,732,13153,3575864467,3575864481,14
2,732,13154,3575864467,3575864482,15
2,732,13155,3575864467,3575864482,15
2,732,13156,3575864467,3575864483,16
2,732,13157,3575864467,3575864485,18
2,732,13158,3575864467,3575864485,18
2,732,13159,3575864467,3575864485,18
2,732,13160,3575864467,3575864486,19
2,732,13161,3575864467,3575864488,21
2,732,13162,3575864467,3575864488,21
2,732,13163,3575864467,3575864488,21
2,732,13164,3575864467,3575864490,23
2,732,13165,3575864467,3575864490,23
2,732,13166,3575864467,3575864490,23
2,732,13167,3575864467,3575864492,25
2,732,13168,3575864467,3575864492,25
2,732,13169,3575864467,3575864492,25
2,732,13170,3575864467,3575864496,29
2,732,13171,3575864467,3575864496,29
2,732,13172,3575864467,3575864498,31
2,732,13173,3575864467,3575864499,32
2,732,13174,3575864467,3575864499,32
2,732,13175,3575864467,3575864500,33
2,732,13176,3575864467,3575864502,35
2,732,13177,3575864467,3575864502,35
2,732,13178,3575864467,3575864504,37
2,732,13179,3575864467,3575864505,38
2,732,13180,3575864467,3575864506,39
2,732,13181,3575864467,3575864507,40
2,732,13182,3575864467,3575864507,40
2,732,13183,3575864467,3575864509,42
2,732,13184,3575864467,3575864510,43
2,732,13185,3575864467,3575864511,44
2,732,13186,3575864467,3575864512,45
2,732,13187,3575864467,3575864515,48
2,732,13188,3575864467,3575864515,48
2,732,13189,3575864467,3575864517,50
2,733,13190,3575864524,3575864524,0
2,733,13191,3575864524,3575864524,0
2,733,13192,3575864524,3575864524,0
2,733,13193,3575864524,3575864524,0
2,733,13194,3575864524,3575864524,0
2,733,13195,3575864524,3575864524,0
2,733,13196,3575864524,3575864524,0
2,733,13197,3575864524,3575864524,0
2,733,13198,3575864524,3575864524,0
2,733,13199,3575864524,3575864524,0
2,733,13200,3575864524,3575864525,1
2,733,13201,3575864524,3575864526,2
2,733,13202,3575864524,3575864527,3
2,733,13203,3575864524,3575864531,7
2,733,13204,3575864524,3575864532,8
2,733,13205,3575864524,3575864532,8
2,733,13206,3575864524,3575864532,8
2,733,13207,3575864524,3575864533,9
2,733,13208,3575864524,3575864533,9
2,733,13209,3575864524,3575864534,10
2,733,13210,3575864524,3575864534,10
2,733,13211,3575864524,3575864539,15
2,733,13212,3575864524,3575864540,16
2,733,13213,3575864524,3575864540,16
2,733,13214,3575864524,3575864541,17
2,733,13215,3575864524,3575864545,21
2,733,13216,3575864524,3575864546,22
2,733,13217,3575864524,3575864546,22
2,733,13218,3575864524,3575864548,24
2,733,13219,3575864524,3575864548,24
2,733,13220,3575864524,3575864548,24
2,733,13221,3575864524,3575864551,27
2,733,13222,3575864524,3575864551,27
2,733,13223,3575864524,3575864552,28
2,733,13224,3575864524,3575864552,28
2,733,13225,3575864524,3575864553,29
2,733,13226,3575864524,3575864558,34
2,733,13227,3575864524,3575864564,40
2,733,13228,3575864524,3575864567,43
2,733,13229,3575864524,3575864568,44
2,733,13230,3575864524,3575864569,45
2,733,13231,3575864524,3575864572,48
2,733,13232,3575864524,3575864572,48
2,734,13233,3575864580,3575864580,0
2,734,13234,3575864580,3575864580,0
2,734,13235,3575864580,3575864580,0
2,734,13236,3575864580,3575864580,0
2,734,13237,3575864580,3575864582,2
2,734,13238,3575864580,3575864582,2
2,734,13239,3575864580,3575864582,2
2,734,13240,3575864580,3575864583,3
2,734,13241,3575864580,3575864583,3
2,734,13242,3575864580,3575864584,4
2,734,13243,3575864580,3575864585,5
2,734,13244,3575864580,3575864586,6
2,734,13245,3575864580,3575864586,6
2,734,13246,3575864580,3575864586,6
2,734,13247,3575864580,3575864587,7
2,734,13248,3575864580,3575864590,10
2,734,13249,3575864580,3575864591,11
2,734,13250,3575864580,3575864592,12
2,734,13251,3575864580,3575864593,13
2,734,13252,3575864580,3575864594,14
2,734,13253,3575864580,3575864597,17
2,734,13254,3575864580,3575864600,20
2,734,13255,3575864580,3575864601,21
2,734,13256,3575864580,3575864602,22
2,734,13257,3575864580,3575864603,23
2,734,13258,3575864580,3575864604,24
2,734,13259,3575864580,3575864604,24
2,734,13260,3575864580,3575864608,28
2,734,13261,3575864580,3575864610,30
2,734,13262,3575864580,3575864611,31
2,734,13263,3575864580,3575864611,31
2,734,13264,3575864580,3575864612,32
2,734,13265,3575864580,3575864613,33
2,734,13266,3575864580,3575864619,39
2,734,13267,3575864580,3575864620,40
2,734,13268,3575864580,3575864621,41
2,734,13269,3575864580,3575864623,43
2,734,13270,3575864580,3575864623,43
2,734,13271,3575864580,3575864624,44
2,734,13272,3575864580,3575864625,45
2,734,13273,3575864580,3575864626,46
2,734,13274,3575864580,3575864627,47
2,734,13275,3575864580,3575864628,48
2,735,13276,3575864638,3575864638,0
2,735,13277,3575864638,3575864638,0
2,735,13278,3575864638,3575864638,0
2,735,13279,3575864638,3575864638,0
2,735,13280,3575864638,3575864638,0
2,735,13281,3575864638,3575864639,1
2,735,13282,3575864638,3575864640,2
2,735,13283,3575864638,3575864641,3
2,735,13284,3575864638,3575864643,5
2,735,13285,3575864638,3575864644,6
2,735,13286,3575864638,3575864645,7
2,735,13287,3575864638,3575864648,10
2,735,13288,3575864638,3575864648,10
2,735,13289,3575864638,3575864650,12
2,735,13290,3575864638,3575864651,13
2,735,13291,3575864638,3575864651,13
2,735,13292,3575864638,3575864654,16
2,735,13293,3575864638,3575864655,17
2,735,13294,3575864638,3575864657,19
2,735,13295,3575864638,3575864658,20
2,735,13296,3575864638,3575864660,22
2,735,13297,3575864638,3575864660,22
2,735,13298,3575864638,3575864661,23
2,735,13299,3575864638,3575864663,25
2,735,13300,3575864638,3575864665,27
2,735,13301,3575864638,3575864666,28
2,735,13302,3575864638,3575864667,29
2,735,13303,3575864638,3575864673,35
2,735,13304,3575864638,3575864674,36
2,735,13305,3575864638,3575864674,36
2,735,13306,3575864638,3575864674,36
2,735,13307,3575864638,3575864676,38
2,735,13308,3575864638,3575864676,38
2,735,13309,3575864638,3575864677,39
2,735,13310,3575864638,3575864678,40
2,735,13311,3575864638,3575864679,41
2,735,13312,3575864638,3575864679,41
2,735,13313,3575864638,3575864680,42
2,735,13314,3575864638,3575864681,43
2,735,13315,3575864638,3575864682,44
2,735,13316,3575864638,3575864682,44
2,735,13317,3575864638,3575864682,44
2,735,13318,3575864638,3575864685,47
2,735,13319,3575864638,3575864685,47
2,735,13320,3575864638,3575864686,48
2,735,13321,3575864638,3575864686,48
2,735,13322,3575864638,3575864687,49
2,735,13323,3575864638,3575864688,50
2,735,13324,3575864638,3575864688,50
2,736,13325,3575864695,3575864695,0
2,736,13326,3575864695,3575864695,0
2,736,13327,3575864695,3575864695,0
2,736,13328,3575864695,3575864695,0
2,736,13329,3575864695,3575864695,0
2,736,13330,3575864695,3575864695,0
2,736,13331,3575864695,3575864696,1
2,736,13332,3575864695,3575864698,3
2,736,13333,3575864695,3575864699,4
2,736,13334,3575864695,3575864699,4
2,736,13335,3575864695,3575864700,5
2,736,13336,3575864695,3575864702,7
2,736,13337,3575864695,3575864702,7
2,736,13338,3575864695,3575864705,10
2,736,13339,3575864695,3575864706,11
2,736,13340,3575864695,3575864706,11
2,736,13341,3575864695,3575864709,14
2,736,13342,3575864695,3575864710,15
2,736,13343,3575864695,3575864710,15
2,736,13344,3575864695,3575864711,16
2,736,13345,3575864695,3575864715,20
2,736,13346,3575864695,3575864716,21
2,736,13347,3575864695,3575864717,22
2,736,13348,3575864695,3575864717,22
2,736,13349,3575864695,3575864718,23
2,736,13350,3575864695,3575864718,23
2,736,13351,3575864695,3575864719,24
2,736,13352,3575864695,3575864720,25
2,736,13353,3575864695,3575864720,25
2,736,13354,3575864695,3575864721,26
2,736,13355,3575864695,3575864721,26
2,736,13356,3575864695,3575864724,29
2,736,13357,3575864695,3575864726,31
2,736,13358,3575864695,3575864727,32
2,736,13359,3575864695,3575864728,33
2,736,13360,3575864695,3575864731,36
2,736,13361,3575864695,3575864731,36
2,736,13362,3575864695,3575864731,36
2,736,13363,3575864695,3575864732,37
2,736,13364,3575864695,3575864733,38
2,736,13365,3575864695,3575864733,38
2,736,13366,3575864695,3575864734,39
2,736,13367,3575864695,3575864734,39
2,736,13368,3575864695,3575864735,40
2,736,13369,3575864695,3575864739,44
2,736,13370,3575864695,3575864740,45
2,736,13371,3575864695,3575864740,45
2,736,13372,3575864695,3575864741,46
2,736,13373,3575864695,3575864742,47
2,736,13374,3575864695,3575864743,48
2,736,13375,3575864695,3575864744,49
2,737,13376,3575864750,3575864750,0
2,737,13377,3575864750,3575864750,0
2,737,13378,3575864750,3575864750,0
2,737,13379,3575864750,3575864750,0
2,737,13380,3575864750,3575864750,0
2,737,13381,3575864750,3575864750,0
2,737,13382,3575864750,3575864750,0
2,737,13383,3575864750,3575864750,0
2,737,13384,3575864750,3575864752,2
2,737,13385,3575864750,3575864752,2
2,737,13386,3575864750,3575864753,3
2,737,13387,3575864750,3575864757,7
2,737,13388,3575864750,3575864759,9
2,737,13389,3575864750,3575864764,14
2,737,13390,3575864750,3575864766,16
2,737,13391,3575864750,3575864767,17
2,737,13392,3575864750,3575864768,18
2,737,13393,3575864750,3575864770,20
2,737,13394,3575864750,3575864772,22
2,737,13395,3575864750,3575864773,23
2,737,13396,3575864750,3575864774,24
2,737,13397,3575864750,3575864777,27
2,737,13398,3575864750,3575864779,29
2,737,13399,3575864750,3575864780,30
2,737,13400,3575864750,3575864782,32
2,737,13401,3575864750,3575864782,32
2,737,13402,3575864750,3575864782,32
2,737,13403,3575864750,3575864783,33
2,737,13404,3575864750,3575864783,33
2,737,13405,3575864750,3575864785,35
2,737,13406,3575864750,3575864785,35
2,737,13407,3575864750,3575864786,36
2,737,13408,3575864750,3575864787,37
2,737,13409,3575864750,3575864787,37
2,737,13410,3575864750,3575864788,38
2,737,13411,3575864750,3575864788,38
2,737,13412,3575864750,3575864791,41
2,737,13413,3575864750,3575864791,41
2,737,13414,3575864750,3575864792,42
2,737,13415,3575864750,3575864793,43
2,737,13416,3575864750,3575864795,45
2,737,13417,3575864750,3575864798,48
2,737,13418,3575864750,3575864798,48
2,738,13419,3575864808,3575864808,0
2,738,13420,3575864808,3575864808,0
2,738,13421,3575864808,3575864808,0
2,738,13422,3575864808,3575864808,0
2,738,13423,3575864808,3575864808,0
2,738,13424,3575864808,3575864808,0
2,738,13425,3575864808,3575864809,1
2,738,13426,3575864808,3575864810,2
2,738,13427,3575864808,3575864811,3
2,738,13428,3575864808,3575864812,4
2,738,13429,3575864808,3575864819,11
2,738,13430,3575864808,3575864820,12
2,738,13431,3575864808,3575864821,13
2,738,13432,3575864808,3575864822,14
2,738,13433,3575864808,3575864824,16
2,738,13434,3575864808,3575864824,16
2,738,13435,3575864808,3575864826,18
2,738,13436,3575864808,3575864827,19
2,738,13437,3575864808,3575864828,20
2,738,13438,3575864808,3575864834,26
2,738,13439,3575864808,3575864835,27
2,738,13440,3575864808,3575864835,27
2,738,13441,3575864808,3575864838,30
2,738,13442,3575864808,3575864838,30
2,738,13443,3575864808,3575864839,31
2,738,13444,3575864808,3575864840,32
2,738,13445,3575864808,3575864840,32
2,738,13446,3575864808,3575864841,33
2,738,13447,3575864808,3575864843,35
2,738,13448,3575864808,3575864844,36
2,738,13449,3575864808,3575864845,37
2,738,13450,3575864808,3575864848,40
2,738,13451,3575864808,3575864849,41
2,738,13452,3575864808,3575864849,41
2,738,13453,3575864808,3575864851,43
2,738,13454,3575864808,3575864854,46
2,738,13455,3575864808,3575864855,47
2,738,13456,3575864808,3575864857,49
2,739,13457,3575864865,3575864865,0
2,739,13458,3575864865,3575864865,0
2,739,13459,3575864865,3575864865,0
2,739,13460,3575864865,3575864865,0
2,739,13461,3575864865,3575864865,0
2,739,13462,3575864865,3575864866,1
2,739,13463,3575864865,3575864867,2
2,739,13464,3575864865,3575864873,8
2,739,13465,3575864865,3575864874,9
2,739,13466,3575864865,3575864874,9
2,739,13467,3575864865,3575864875,10
2,739,13468,3575864865,3575864875,10
2,739,13469,3575864865,3575864877,12
2,739,13470,3575864865,3575864877,12
2,739,13471,3575864865,3575864878,13
2,739,13472,3575864865,3575864879,14
2,739,13473,3575864865,3575864880,15
2,739,13474,3575864865,3575864880,15
2,739,13475,3575864865,3575864881,16
2,739,13476,3575864865,3575864882,17
2,739,13477,3575864865,3575864882,17
2,739,13478,3575864865,3575864885,20
2,739,13479,3575864865,3575864885,20
2,739,13480,3575864865,3575864886,21
2,739,13481,3575864865,3575864886,21
2,739,13482,3575864865,3575864888,23
2,739,13483,3575864865,3575864888,23
2,739,13484,3575864865,3575864888,23
2,739,13485,3575864865,3575864890,25
2,739,13486,3575864865,3575864890,25
2,739,13487,3575864865,3575864890,25
2,739,13488,3575864865,3575864893,28
2,739,13489,3575864865,3575864893,28
2,739,13490,3575864865,3575864893,28
2,739,13491,3575864865,3575864897,32
2,739,13492,3575864865,3575864898,33
2,739,13493,3575864865,3575864899,34
2,739,13494,3575864865,3575864899,34
2,739,13495,3575864865,3575864900,35
2,739,13496,3575864865,3575864900,35
2,739,13497,3575864865,3575864901,36
2,739,13498,3575864865,3575864902,37
2,739,13499,3575864865,3575864905,40
2,739,13500,3575864865,3575864906,41
2,739,13501,3575864865,3575864906,41
2,739,13502,3575864865,3575864909,44
2,739,13503,3575864865,3575864910,45
2,739,13504,3575864865,3575864910,45
2,739,13505,3575864865,3575864911,46
2,739,13506,3575864865,3575864915,50
2,740,13507,3575864926,3575864926,0
2,740,13508,3575864926,3575864926,0
2,740,13509,3575864926,3575864926,0
2,740,13510,3575864926,3575864926,0
2,740,13511,3575864926,3575864926,0
2,740,13512,3575864926,3575864926,0
2,740,13513,3575864926,3575864926,0
2,740,13514,3575864926,3575864926,0
2,740,13515,3575864926,3575864926,0
2,740,13516,3575864926,3575864926,0
2,740,13517,3575864926,3575864926,0
2,740,13518,3575864926,3575864926,0
2,740,13519,3575864926,3575864927,1
2,740,13520,3575864926,3575864928,2
2,740,13521,3575864926,3575864930,4
2,740,13522,3575864926,3575864931,5
2,740,13523,3575864926,3575864931,5
2,740,13524,3575864926,3575864933,7
2,740,13525,3575864926,3575864933,7
2,740,13526,3575864926,3575864934,8
2,740,13527,3575864926,3575864934,8
2,740,13528,3575864926,3575864934,8
2,740,13529,3575864926,3575864935,9
2,740,13530,3575864926,3575864939,13
2,740,13531,3575864926,3575864940,14
2,740,13532,3575864926,3575864940,14
2,740,13533,3575864926,3575864941,15
2,740,13534,3575864926,3575864943,17
2,740,13535,3575864926,3575864944,18
2,740,13536,3575864926,3575864946,20
2,740,13537,3575864926,3575864946,20
2,740,13538,3575864926,3575864946,20
2,740,13539,3575864926,3575864947,21
2,740,13540,3575864926,3575864948,22
2,740,13541,3575864926,3575864949,23
2,740,13542,3575864926,3575864949,23
2,740,13543,3575864926,3575864950,24
2,740,13544,3575864926,3575864952,26
2,740,13545,3575864926,3575864953,27
2,740,13546,3575864926,3575864953,27
2,740,13547,3575864926,3575864957,31
2,740,13548,3575864926,3575864961,35
2,740,13549,3575864926,3575864965,39
2,740,13550,3575864926,3575864966,40
2,740,13551,3575864926,3575864968,42
2,740,13552,3575864926,3575864968,42
2,740,13553,3575864926,3575864969,43
2,740,13554,3575864926,3575864972,46
2,740,13555,3575864926,3575864973,47
2,740,13556,3575864926,3575864973,47
2,740,13557,3575864926,3575864974,48
2,741,13558,3575864983,3575864983,0
2,741,13559,3575864983,3575864983,0
2,741,13560,3575864983,3575864983,0
2,741,13561,3575864983,3575864983,0
2,741,13562,3575864983,3575864983,0
2,741,13563,3575864983,3575864983,0
2,741,13564,3575864983,3575864983,0
2,741,13565,3575864983,3575864984,1
2,741,13566,3575864983,3575864984,1
2,741,13567,3575864983,3575864985,2
2,741,13568,3575864983,3575864986,3
2,741,13569,3575864983,3575864988,5
2,741,13570,3575864983,3575864988,5
2,741,13571,3575864983,3575864988,5
2,741,13572,3575864983,3575864989,6
2,741,13573,3575864983,3575864989,6
2,741,13574,3575864983,3575864991,8
2,741,13575,3575864983,3575864991,8
2,741,13576,3575864983,3575864993,10
2,741,13577,3575864983,3575864994,11
2,741,13578,3575864983,3575864995,12
2,741,13579,3575864983,3575864998,15
2,741,13580,3575864983,3575864999,16
2,741,13581,3575864983,3575865001,18
2,741,13582,3575864983,3575865001,18
2,741,13583,3575864983,3575865002,19
2,741,13584,3575864983,3575865002,19
2,741,13585,3575864983,3575865003,20
2,741,13586,3575864983,3575865004,21
2,741,13587,3575864983,3575865005,22
2,741,13588,3575864983,3575865009,26
2,741,13589,3575864983,3575865010,27
2,741,13590,3575864983,3575865011,28
2,741,13591,3575864983,3575865012,29
2,741,13592,3575864983,3575865014,31
2,741,13593,3575864983,3575865020,37
2,741,13594,3575864983,3575865021,38
2,741,13595,3575864983,3575865022,39
2,741,13596,3575864983,3575865025,42
2,741,13597,3575864983,3575865025,42
2,741,13598,3575864983,3575865026,43
2,741,13599,3575864983,3575865028,45
2,741,13600,3575864983,3575865028,45
2,742,13601,3575865040,3575865040,0
2,742,13602,3575865040,3575865040,0
2,742,13603,3575865040,3575865040,0
2,742,13604,3575865040,3575865040,0
2,742,13605,3575865040,3575865040,0
2,742,13606,3575865040,3575865040,0
2,742,13607,3575865040,3575865040,0
2,742,13608,3575865040,3575865042,2
2,742,13609,3575865040,3575865044,4
2,742,13610,3575865040,3575865044,4
2,742,13611,3575865040,3575865045,5
2,742,13612,3575865040,3575865048,8
2,742,13613,3575865040,3575865049,9
2,742,13614,3575865040,3575865049,9
2,742,13615,3575865040,3575865051,11
2,742,13616,3575865040,3575865052,12
2,742,13617,3575865040,3575865055,15
2,742,13618,3575865040,3575865055,15
2,742,13619,3575865040,3575865057,17
2,742,13620,3575865040,3575865059,19
2,742,13621,3575865040,3575865060,20
2,742,13622,3575865040,3575865060,20
2,742,13623,3575865040,3575865062,22
2,742,13624,3575865040,3575865063,23
2,742,13625,3575865040,3575865065,25
2,742,13626,3575865040,3575865066,26
2,742,13627,3575865040,3575865067,27
2,742,13628,3575865040,3575865074,34
2,742,13629,3575865040,3575865074,34
2,742,13630,3575865040,3575865074,34
2,742,13631,3575865040,3575865075,35
2,742,13632,3575865040,3575865076,36
2,742,13633,3575865040,3575865077,37
2,742,13634,3575865040,3575865078,38
2,742,13635,3575865040,3575865080,40
2,742,13636,3575865040,3575865080,40
2,742,13637,3575865040,3575865081,41
2,742,13638,3575865040,3575865082,42
2,742,13639,3575865040,3575865082,42
2,742,13640,3575865040,3575865085,45
2,742,13641,3575865040,3575865085,45
2,742,13642,3575865040,3575865086,46
2,742,13643,3575865040,3575865087,47
2,742,13644,3575865040,3575865087,47
2,742,13645,3575865040,3575865088,48
2,742,13646,3575865040,3575865088,48
2,742,13647,3575865040,3575865089,49
2,742,13648,3575865040,3575865089,49
2,742,13649,3575865040,3575865090,50
2,743,13650,3575865097,3575865097,0
2,743,13651,3575865097,3575865097,0
2,743,13652,3575865097,3575865097,0
2,743,13653,3575865097,3575865097,0
2,743,13654,3575865097,3575865099,2
2,743,13655,3575865097,3575865099,2
2,743,13656,3575865097,3575865099,2
2,743,13657,3575865097,3575865100,3
2,743,13658,3575865097,3575865100,3
2,743,13659,3575865097,3575865102,5
2,743,13660,3575865097,3575865102,5
2,743,13661,3575865097,3575865102,5
2,743,13662,3575865097,3575865104,7
2,743,13663,3575865097,3575865106,9
2,743,13664,3575865097,3575865106,9
2,743,13665,3575865097,3575865109,12
2,743,13666,3575865097,3575865110,13
2,743,13667,3575865097,3575865111,14
2,743,13668,3575865097,3575865111,14
2,743,13669,3575865097,3575865113,16
2,743,13670,3575865097,3575865115,18
2,743,13671,3575865097,3575865116,19
2,743,13672,3575865097,3575865117,20
2,743,13673,3575865097,3575865118,21
2,743,13674,3575865097,3575865119,22
2,743,13675,3575865097,3575865119,22
2,743,13676,3575865097,3575865121,24
2,743,13677,3575865097,3575865121,24
2,743,13678,3575865097,3575865121,24
2,743,13679,3575865097,3575865122,25
2,743,13680,3575865097,3575865124,27
2,743,13681,3575865097,3575865124,27
2,743,13682,3575865097,3575865126,29
2,743,13683,3575865097,3575865127,30
2,743,13684,3575865097,3575865130,33
2,743,13685,3575865097,3575865131,34
2,743,13686,3575865097,3575865131,34
2,743,13687,3575865097,3575865133,36
2,743,13688,3575865097,3575865133,36
2,743,13689,3575865097,3575865134,37
2,743,13690,3575865097,3575865134,37
2,743,13691,3575865097,3575865135,38
2,743,13692,3575865097,3575865139,42
2,743,13693,3575865097,3575865140,43
2,743,13694,3575865097,3575865141,44
2,743,13695,3575865097,3575865143,46
2,743,13696,3575865097,3575865144,47
2,743,13697,3575865097,3575865146,49
2,743,13698,3575865097,3575865146,49
2,743,13699,3575865097,3575865147,50
2,744,13700,3575865154,3575865154,0
2,744,13701,3575865154,3575865154,0
2,744,13702,3575865154,3575865154,0
2,744,13703,3575865154,3575865154,0
2,744,13704,3575865154,3575865154,0
2,744,13705,3575865154,3575865154,0
2,744,13706,3575865154,3575865154,0
2,744,13707,3575865154,3575865154,0
2,744,13708,3575865154,3575865158,4
2,744,13709,3575865154,3575865162,8
2,744,13710,3575865154,3575865165,11
2,744,13711,3575865154,3575865165,11
2,744,13712,3575865154,3575865168,14
2,744,13713,3575865154,3575865170,16
2,744,13714,3575865154,3575865172,18
2,744,13715,3575865154,3575865173,19
2,744,13716,3575865154,3575865173,19
2,744,13717,3575865154,3575865174,20
2,744,13718,3575865154,3575865174,20
2,744,13719,3575865154,3575865177,23
2,744,13720,3575865154,3575865179,25
2,744,13721,3575865154,3575865181,27
2,744,13722,3575865154,3575865181,27
2,744,13723,3575865154,3575865183,29
2,744,13724,3575865154,3575865184,30
2,744,13725,3575865154,3575865184,30
2,744,13726,3575865154,3575865184,30
2,744,13727,3575865154,3575865185,31
2,744,13728,3575865154,3575865185,31
2,744,13729,3575865154,3575865187,33
2,744,13730,3575865154,3575865187,33
2,744,13731,3575865154,3575865188,34
2,744,13732,3575865154,3575865188,34
2,744,13733,3575865154,3575865189,35
2,744,13734,3575865154,3575865189,35
2,744,13735,3575865154,3575865191,37
2,744,13736,3575865154,3575865192,38
2,744,13737,3575865154,3575865194,40
2,744,13738,3575865154,3575865194,40
2,744,13739,3575865154,3575865196,42
2,744,13740,3575865154,3575865198,44
2,744,13741,3575865154,3575865201,47
2,744,13742,3575865154,3575865201,47
2,744,13743,3575865154,3575865201,47
2,744,13744,3575865154,3575865204,50
2,745,13745,3575865211,3575865211,0
2,745,13746,3575865211,3575865211,0
2,745,13747,3575865211,3575865211,0
2,745,13748,3575865211,3575865211,0
2,745,13749,3575865211,3575865211,0
2,745,13750,3575865211,3575865212,1
2,745,13751,3575865211,3575865214,3
2,745,13752,3575865211,3575865221,10
2,745,13753,3575865211,3575865222,11
2,745,13754,3575865211,3575865223,12
2,745,13755,3575865211,3575865224,13
2,745,13756,3575865211,3575865225,14
2,745,13757,3575865211,3575865226,15
2,745,13758,3575865211,3575865228,17
2,745,13759,3575865211,3575865229,18
2,745,13760,3575865211,3575865235,24
2,745,13761,3575865211,3575865235,24
2,745,13762,3575865211,3575865236,25
2,745,13763,3575865211,3575865237,26
2,745,13764,3575865211,3575865238,27
2,745,13765,3575865211,3575865238,27
2,745,13766,3575865211,3575865240,29
2,745,13767,3575865211,3575865241,30
2,745,13768,3575865211,3575865242,31
2,745,13769,3575865211,3575865244,33
2,745,13770,3575865211,3575865244,33
2,745,13771,3575865211,3575865245,34
2,745,13772,3575865211,3575865248,37
2,745,13773,3575865211,3575865250,39
2,745,13774,3575865211,3575865250,39
2,745,13775,3575865211,3575865252,41
2,745,13776,3575865211,3575865252,41
2,745,13777,3575865211,3575865252,41
2,745,13778,3575865211,3575865255,44
2,745,13779,3575865211,3575865256,45
2,745,13780,3575865211,3575865256,45
2,745,13781,3575865211,3575865257,46
2,745,13782,3575865211,3575865259,48
2,745,13783,3575865211,3575865259,48
2,745,13784,3575865211,3575865261,50
2,746,13785,3575865269,3575865269,0
2,746,13786,3575865269,3575865269,0
2,746,13787,3575865269,3575865269,0
2,746,13788,3575865269,3575865269,0
2,746,13789,3575865269,3575865269,0
2,746,13790,3575865269,3575865273,4
2,746,13791,3575865269,3575865274,5
2,746,13792,3575865269,3575865275,6
2,746,13793,3575865269,3575865275,6
2,746,13794,3575865269,3575865276,7
2,746,13795,3575865269,3575865276,7
2,746,13796,3575865269,3575865279,10
2,746,13797,3575865269,3575865279,10
2,746,13798,3575865269,3575865279,10
2,746,13799,3575865269,3575865280,11
2,746,13800,3575865269,3575865280,11
2,746,13801,3575865269,3575865281,12
2,746,13802,3575865269,3575865282,13
2,746,13803,3575865269,3575865282,13
2,746,13804,3575865269,3575865284,15
2,746,13805,3575865269,3575865285,16
2,746,13806,3575865269,3575865286,17
2,746,13807,3575865269,3575865287,18
2,746,13808,3575865269,3575865288,19
2,746,13809,3575865269,3575865288,19
2,746,13810,3575865269,3575865289,20
2,746,13811,3575865269,3575865290,21
2,746,13812,3575865269,3575865290,21
2,746,13813,3575865269,3575865291,22
2,746,13814,3575865269,3575865294,25
2,746,13815,3575865269,3575865294,25
2,746,13816,3575865269,3575865295,26
2,746,13817,3575865269,3575865296,27
2,746,13818,3575865269,3575865299,30
2,746,13819,3575865269,3575865299,30
2,746,13820,3575865269,3575865299,30
2,746,13821,3575865269,3575865300,31
2,746,13822,3575865269,3575865300,31
2,746,13823,3575865269,3575865301,32
2,746,13824,3575865269,3575865302,33
2,746,13825,3575865269,3575865304,35
2,746,13826,3575865269,3575865306,37
2,746,13827,3575865269,3575865306,37
2,746,13828,3575865269,3575865306,37
2,746,13829,3575865269,3575865307,38
2,746,13830,3575865269,3575865307,38
2,746,13831,3575865269,3575865309,40
2,746,13832,3575865269,3575865311,42
2,746,13833,3575865269,3575865311,42
2,746,13834,3575865269,3575865312,43
2,746,13835,3575865269,3575865315,46
2,746,13836,3575865269,3575865316,47
2,746,13837,3575865269,3575865317,48
2,746,13838,3575865269,3575865318,49
2,746,13839,3575865269,3575865319,50
2,747,13840,3575865325,3575865325,0
2,747,13841,3575865325,3575865325,0
2,747,13842,3575865325,3575865325,0
2,747,13843,3575865325,3575865325,0
2,747,13844,3575865325,3575865325,0
2,747,13845,3575865325,3575865325,0
2,747,13846,3575865325,3575865325,0
2,747,13847,3575865325,3575865327,2
2,747,13848,3575865325,3575865327,2
2,747,13849,3575865325,3575865329,4
2,747,13850,3575865325,3575865331,6
2,747,13851,3575865325,3575865331,6
2,747,13852,3575865325,3575865333,8
2,747,13853,3575865325,3575865333,8
2,747,13854,3575865325,3575865334,9
2,747,13855,3575865325,3575865334,9
2,747,13856,3575865325,3575865335,10
2,747,13857,3575865325,3575865339,14
2,747,13858,3575865325,3575865340,15
2,747,13859,3575865325,3575865340,15
2,747,13860,3575865325,3575865341,16
2,747,13861,3575865325,3575865345,20
2,747,13862,3575865325,3575865346,21
2,747,13863,3575865325,3575865347,22
2,747,13864,3575865325,3575865347,22
2,747,13865,3575865325,3575865348,23
2,747,13866,3575865325,3575865349,24
2,747,13867,3575865325,3575865350,25
2,747,13868,3575865325,3575865350,25
2,747,13869,3575865325,3575865351,26
2,747,13870,3575865325,3575865352,27
2,747,13871,3575865325,3575865352,27
2,747,13872,3575865325,3575865354,29
2,747,13873,3575865325,3575865354,29
2,747,13874,3575865325,3575865358,33
2,747,13875,3575865325,3575865358,33
2,747,13876,3575865325,3575865359,34
2,747,13877,3575865325,3575865362,37
2,747,13878,3575865325,3575865365,40
2,747,13879,3575865325,3575865365,40
2,747,13880,3575865325,3575865368,43
2,747,13881,3575865325,3575865370,45
2,747,13882,3575865325,3575865373,48
2,747,13883,3575865325,3575865373,48
2,747,13884,3575865325,3575865373,48
2,747,13885,3575865325,3575865374,49
2,747,13886,3575865325,3575865374,49
2,748,13887,3575865384,3575865384,0
2,748,13888,3575865384,3575865384,0
2,748,13889,3575865384,3575865384,0
2,748,13890,3575865384,3575865384,0
2,748,13891,3575865384,3575865384,0
2,748,13892,3575865384,3575865385,1
2,748,13893,3575865384,3575865385,1
2,748,13894,3575865384,3575865386,2
2,748,13895,3575865384,3575865386,2
2,748,13896,3575865384,3575865387,3
2,748,13897,3575865384,3575865388,4
2,748,13898,3575865384,3575865388,4
2,748,13899,3575865384,3575865389,5
2,748,13900,3575865384,3575865390,6
2,748,13901,3575865384,3575865391,7
2,748,13902,3575865384,3575865392,8
2,748,13903,3575865384,3575865394,10
2,748,13904,3575865384,3575865394,10
2,748,13905,3575865384,3575865396,12
2,748,13906,3575865384,3575865399,15
2,748,13907,3575865384,3575865399,15
2,748,13908,3575865384,3575865400,16
2,748,13909,3575865384,3575865402,18
2,748,13910,3575865384,3575865402,18
2,748,13911,3575865384,3575865404,20
2,748,13912,3575865384,3575865404,20
2,748,13913,3575865384,3575865405,21
2,748,13914,3575865384,3575865408,24
2,748,13915,3575865384,3575865409,25
2,748,13916,3575865384,3575865411,27
2,748,13917,3575865384,3575865411,27
2,748,13918,3575865384,3575865413,29
2,748,13919,3575865384,3575865414,30
2,748,13920,3575865384,3575865421,37
2,748,13921,3575865384,3575865422,38
2,748,13922,3575865384,3575865422,38
2,748,13923,3575865384,3575865423,39
2,748,13924,3575865384,3575865424,40
2,748,13925,3575865384,3575865426,42
2,748,13926,3575865384,3575865426,42
2,748,13927,3575865384,3575865427,43
2,748,13928,3575865384,3575865428,44
2,748,13929,3575865384,3575865429,45
2,749,13930,3575865439,3575865439,0
2,749,13931,3575865439,3575865439,0
2,749,13932,3575865439,3575865439,0
2,749,13933,3575865439,3575865439,0
2,749,13934,3575865439,3575865439,0
2,749,13935,3575865439,3575865439,0
2,749,13936,3575865439,3575865440,1
2,749,13937,3575865439,3575865441,2
2,749,13938,3575865439,3575865442,3
2,749,13939,3575865439,3575865444,5
2,749,13940,3575865439,3575865445,6
2,749,13941,3575865439,3575865448,9
2,749,13942,3575865439,3575865449,10
2,749,13943,3575865439,3575865450,11
2,749,13944,3575865439,3575865452,13
2,749,13945,3575865439,3575865452,13
2,749,13946,3575865439,3575865453,14
2,749,13947,3575865439,3575865455,16
2,749,13948,3575865439,3575865455,16
2,749,13949,3575865439,3575865456,17
2,749,13950,3575865439,3575865456,17
2,749,13951,3575865439,3575865460,21
2,749,13952,3575865439,3575865462,23
2,749,13953,3575865439,3575865463,24
2,749,13954,3575865439,3575865464,25
2,749,13955,3575865439,3575865464,25
2,749,13956,3575865439,3575865465,26
2,749,13957,3575865439,3575865467,28
2,749,13958,3575865439,3575865468,29
2,749,13959,3575865439,3575865474,35
2,749,13960,3575865439,3575865474,35
2,749,13961,3575865439,3575865475,36
2,749,13962,3575865439,3575865475,36
2,749,13963,3575865439,3575865476,37
2,749,13964,3575865439,3575865476,37
2,749,13965,3575865439,3575865479,40
2,749,13966,3575865439,3575865479,40
2,749,13967,3575865439,3575865479,40
2,749,13968,3575865439,3575865480,41
2,749,13969,3575865439,3575865481,42
2,749,13970,3575865439,3575865481,42
2,749,13971,3575865439,3575865482,43
2,749,13972,3575865439,3575865482,43
2,749,13973,3575865439,3575865482,43
2,749,13974,3575865439,3575865485,46
2,749,13975,3575865439,3575865485,46
2,749,13976,3575865439,3575865486,47
2,749,13977,3575865439,3575865487,48
2,749,13978,3575865439,3575865488,49
2,749,13979,3575865439,3575865488,49
2,750,13980,3575865496,3575865496,0
2,750,13981,3575865496,3575865496,0
2,750,13982,3575865496,3575865496,0
2,750,13983,3575865496,3575865496,0
2,750,13984,3575865496,3575865496,0
2,750,13985,3575865496,3575865496,0
2,750,13986,3575865496,3575865498,2
2,750,13987,3575865496,3575865498,2
2,750,13988,3575865496,3575865499,3
2,750,13989,3575865496,3575865499,3
2,750,13990,3575865496,3575865500,4
2,750,13991,3575865496,3575865501,5
2,750,13992,3575865496,3575865502,6
2,750,13993,3575865496,3575865503,7
2,750,13994,3575865496,3575865504,8
2,750,13995,3575865496,3575865505,9
2,750,13996,3575865496,3575865505,9
2,750,13997,3575865496,3575865506,10
2,750,13998,3575865496,3575865506,10
2,750,13999,3575865496,3575865508,12
2,750,14000,3575865496,3575865509,13
2,750,14001,3575865496,3575865509,13
2,750,14002,3575865496,3575865510,14
2,750,14003,3575865496,3575865515,19
2,750,14004,3575865496,3575865515,19
2,750,14005,3575865496,3575865516,20
2,750,14006,3575865496,3575865517,21
2,750,14007,3575865496,3575865518,22
2,750,14008,3575865496,3575865518,22
2,750,14009,3575865496,3575865521,25
2,750,14010,3575865496,3575865521,25
2,750,14011,3575865496,3575865522,26
2,750,14012,3575865496,3575865522,26
2,750,14013,3575865496,3575865523,27
2,750,14014,3575865496,3575865526,30
2,750,14015,3575865496,3575865527,31
2,750,14016,3575865496,3575865530,34
2,750,14017,3575865496,3575865531,35
2,750,14018,3575865496,3575865531,35
2,750,14019,3575865496,3575865533,37
2,750,14020,3575865496,3575865533,37
2,750,14021,3575865496,3575865534,38
2,750,14022,3575865496,3575865539,43
2,750,14023,3575865496,3575865539,43
2,750,14024,3575865496,3575865540,44
2,750,14025,3575865496,3575865541,45
2,750,14026,3575865496,3575865541,45
2,750,14027,3575865496,3575865543,47
2,750,14028,3575865496,3575865545,49
2,750,14029,3575865496,3575865545,49
2,751,14030,3575865553,3575865553,0
2,751,14031,3575865553,3575865553,0
2,751,14032,3575865553,3575865553,0
2,751,14033,3575865553,3575865553,0
2,751,14034,3575865553,3575865553,0
2,751,14035,3575865553,3575865553,0
2,751,14036,3575865553,3575865553,0
2,751,14037,3575865553,3575865553,0
2,751,14038,3575865553,3575865553,0
2,751,14039,3575865553,3575865553,0
2,751,14040,3575865553,3575865553,0
2,751,14041,3575865553,3575865557,4
2,751,14042,3575865553,3575865557,4
2,751,14043,3575865553,3575865558,5
2,751,14044,3575865553,3575865564,11
2,751,14045,3575865553,3575865564,11
2,751,14046,3575865553,3575865567,14
2,751,14047,3575865553,3575865567,14
2,751,14048,3575865553,3575865569,16
2,751,14049,3575865553,3575865572,19
2,751,14050,3575865553,3575865573,20
2,751,14051,3575865553,3575865573,20
2,751,14052,3575865553,3575865573,20
2,751,14053,3575865553,3575865574,21
2,751,14054,3575865553,3575865576,23
2,751,14055,3575865553,3575865578,25
2,751,14056,3575865553,3575865581,28
2,751,14057,3575865553,3575865583,30
2,751,14058,3575865553,3575865583,30
2,751,14059,3575865553,3575865583,30
2,751,14060,3575865553,3575865584,31
2,751,14061,3575865553,3575865584,31
2,751,14062,3575865553,3575865585,32
2,751,14063,3575865553,3575865586,33
2,751,14064,3575865553,3575865588,35
2,751,14065,3575865553,3575865588,35
2,751,14066,3575865553,3575865589,36
2,751,14067,3575865553,3575865589,36
2,751,14068,3575865553,3575865590,37
2,751,14069,3575865553,3575865590,37
2,751,14070,3575865553,3575865592,39
2,751,14071,3575865553,3575865594,41
2,751,14072,3575865553,3575865596,43
2,751,14073,3575865553,3575865597,44
2,751,14074,3575865553,3575865598,45
2,751,14075,3575865553,3575865600,47
2,751,14076,3575865553,3575865601,48
2,751,14077,3575865553,3575865601,48
2,752,14078,3575865611,3575865611,0
2,752,14079,3575865611,3575865611,0
2,752,14080,3575865611,3575865611,0
2,752,14081,3575865611,3575865611,0
2,752,14082,3575865611,3575865611,0
2,752,14083,3575865611,3575865611,0
2,752,14084,3575865611,3575865611,0
2,752,14085,3575865611,3575865612,1
2,752,14086,3575865611,3575865613,2
2,752,14087,3575865611,3575865621,10
2,752,14088,3575865611,3575865622,11
2,752,14089,3575865611,3575865622,11
2,752,14090,3575865611,3575865622,11
2,752,14091,3575865611,3575865623,12
2,752,14092,3575865611,3575865625,14
2,752,14093,3575865611,3575865625,14
2,752,14094,3575865611,3575865627,16
2,752,14095,3575865611,3575865627,16
2,752,14096,3575865611,3575865628,17
2,752,14097,3575865611,3575865634,23
2,752,14098,3575865611,3575865636,25
2,752,14099,3575865611,3575865636,25
2,752,14100,3575865611,3575865638,27
2,752,14101,3575865611,3575865638,27
2,752,14102,3575865611,3575865639,28
2,752,14103,3575865611,3575865639,28
2,752,14104,3575865611,3575865641,30
2,752,14105,3575865611,3575865643,32
2,752,14106,3575865611,3575865644,33
2,752,14107,3575865611,3575865647,36
2,752,14108,3575865611,3575865649,38
2,752,14109,3575865611,3575865649,38
2,752,14110,3575865611,3575865651,40
2,752,14111,3575865611,3575865652,41
2,752,14112,3575865611,3575865652,41
2,752,14113,3575865611,3575865654,43
2,752,14114,3575865611,3575865655,44
2,752,14115,3575865611,3575865655,44
2,752,14116,3575865611,3575865656,45
2,752,14117,3575865611,3575865660,49
2,752,14118,3575865611,3575865660,49
2,753,14119,3575865668,3575865668,0
2,753,14120,3575865668,3575865668,0
2,753,14121,3575865668,3575865668,0
2,753,14122,3575865668,3575865668,0
2,753,14123,3575865668,3575865668,0
2,753,14124,3575865668,3575865668,0
2,753,14125,3575865668,3575865674,6
2,753,14126,3575865668,3575865674,6
2,753,14127,3575865668,3575865674,6
2,753,14128,3575865668,3575865675,7
2,753,14129,3575865668,3575865676,8
2,753,14130,3575865668,3575865676,8
2,753,14131,3575865668,3575865677,9
2,753,14132,3575865668,3575865679,11
2,753,14133,3575865668,3575865679,11
2,753,14134,3575865668,3575865680,12
2,753,14135,3575865668,3575865680,12
2,753,14136,3575865668,3575865681,13
2,753,14137,3575865668,3575865682,14
2,753,14138,3575865668,3575865682,14
2,753,14139,3575865668,3575865682,14
2,753,14140,3575865668,3575865685,17
2,753,14141,3575865668,3575865685,17
2,753,14142,3575865668,3575865687,19
2,753,14143,3575865668,3575865687,19
2,753,14144,3575865668,3575865688,20
2,753,14145,3575865668,3575865688,20
2,753,14146,3575865668,3575865690,22
2,753,14147,3575865668,3575865690,22
2,753,14148,3575865668,3575865691,23
2,753,14149,3575865668,3575865692,24
2,753,14150,3575865668,3575865693,25
2,753,14151,3575865668,3575865696,28
2,753,14152,3575865668,3575865699,31
2,753,14153,3575865668,3575865699,31
2,753,14154,3575865668,3575865700,32
2,753,14155,3575865668,3575865700,32
2,753,14156,3575865668,3575865703,35
2,753,14157,3575865668,3575865705,37
2,753,14158,3575865668,3575865705,37
2,753,14159,3575865668,3575865705,37
2,753,14160,3575865668,3575865706,38
2,753,14161,3575865668,3575865707,39
2,753,14162,3575865668,3575865708,40
2,753,14163,3575865668,3575865709,41
2,753,14164,3575865668,3575865709,41
2,753,14165,3575865668,3575865710,42
2,753,14166,3575865668,3575865715,47
2,753,14167,3575865668,3575865715,47
2,753,14168,3575865668,3575865716,48
2,753,14169,3575865668,3575865718,50
2,754,14170,3575865726,3575865726,0
2,754,14171,3575865726,3575865726,0
2,754,14172,3575865726,3575865726,0
2,754,14173,3575865726,3575865726,0
2,754,14174,3575865726,3575865726,0
2,754,14175,3575865726,3575865726,0
2,754,14176,3575865726,3575865726,0
2,754,14177,3575865726,3575865726,0
2,754,14178,3575865726,3575865726,0
2,754,14179,3575865726,3575865727,1
2,754,14180,3575865726,3575865729,3
2,754,14181,3575865726,3575865730,4
2,754,14182,3575865726,3575865731,5
2,754,14183,3575865726,3575865731,5
2,754,14184,3575865726,3575865732,6
2,754,14185,3575865726,3575865733,7
2,754,14186,3575865726,3575865733,7
2,754,14187,3575865726,3575865733,7
2,754,14188,3575865726,3575865734,8
2,754,14189,3575865726,3575865735,9
2,754,14190,3575865726,3575865739,13
2,754,14191,3575865726,3575865739,13
2,754,14192,3575865726,3575865740,14
2,754,14193,3575865726,3575865740,14
2,754,14194,3575865726,3575865742,16
2,754,14195,3575865726,3575865743,17
2,754,14196,3575865726,3575865745,19
2,754,14197,3575865726,3575865746,20
2,754,14198,3575865726,3575865746,20
2,754,14199,3575865726,3575865746,20
2,754,14200,3575865726,3575865748,22
2,754,14201,3575865726,3575865748,22
2,754,14202,3575865726,3575865749,23
2,754,14203,3575865726,3575865749,23
2,754,14204,3575865726,3575865750,24
2,754,14205,3575865726,3575865751,25
2,754,14206,3575865726,3575865752,26
2,754,14207,3575865726,3575865753,27
2,754,14208,3575865726,3575865757,31
2,754,14209,3575865726,3575865758,32
2,754,14210,3575865726,3575865764,38
2,754,14211,3575865726,3575865766,40
2,754,14212,3575865726,3575865766,40
2,754,14213,3575865726,3575865767,41
2,754,14214,3575865726,3575865768,42
2,754,14215,3575865726,3575865773,47
2,754,14216,3575865726,3575865774,48
2,754,14217,3575865726,3575865774,48
2,755,14218,3575865782,3575865782,0
2,755,14219,3575865782,3575865782,0
2,755,14220,3575865782,3575865782,0
2,755,14221,3575865782,3575865783,1
2,755,14222,3575865782,3575865783,1
2,755,14223,3575865782,3575865784,2
2,755,14224,3575865782,3575865785,3
2,755,14225,3575865782,3575865785,3
2,755,14226,3575865782,3575865786,4
2,755,14227,3575865782,3575865786,4
2,755,14228,3575865782,3575865787,5
2,755,14229,3575865782,3575865788,6
2,755,14230,3575865782,3575865789,7
2,755,14231,3575865782,3575865790,8
2,755,14232,3575865782,3575865790,8
2,755,14233,3575865782,3575865790,8
2,755,14234,3575865782,3575865793,11
2,755,14235,3575865782,3575865794,12
2,755,14236,3575865782,3575865797,15
2,755,14237,3575865782,3575865798,16
2,755,14238,3575865782,3575865799,17
2,755,14239,3575865782,3575865799,17
2,755,14240,3575865782,3575865801,19
2,755,14241,3575865782,3575865801,19
2,755,14242,3575865782,3575865803,21
2,755,14243,3575865782,3575865804,22
2,755,14244,3575865782,3575865805,23
2,755,14245,3575865782,3575865807,25
2,755,14246,3575865782,3575865809,27
2,755,14247,3575865782,3575865809,27
2,755,14248,3575865782,3575865812,30
2,755,14249,3575865782,3575865812,30
2,755,14250,3575865782,3575865813,31
2,755,14251,3575865782,3575865821,39
2,755,14252,3575865782,3575865822,40
2,755,14253,3575865782,3575865822,40
2,755,14254,3575865782,3575865822,40
2,755,14255,3575865782,3575865822,40
2,755,14256,3575865782,3575865823,41
2,755,14257,3575865782,3575865824,42
2,755,14258,3575865782,3575865825,43
2,755,14259,3575865782,3575865827,45
2,755,14260,3575865782,3575865827,45
2,755,14261,3575865782,3575865829,47
2,756,14262,3575865839,3575865839,0
2,756,14263,3575865839,3575865839,0
2,756,14264,3575865839,3575865839,0
2,756,14265,3575865839,3575865839,0
2,756,14266,3575865839,3575865839,0
2,756,14267,3575865839,3575865839,0
2,756,14268,3575865839,3575865841,2
2,756,14269,3575865839,3575865843,4
2,756,14270,3575865839,3575865844,5
2,756,14271,3575865839,3575865844,5
2,756,14272,3575865839,3575865847,8
2,756,14273,3575865839,3575865848,9
2,756,14274,3575865839,3575865848,9
2,756,14275,3575865839,3575865851,12
2,756,14276,3575865839,3575865852,13
2,756,14277,3575865839,3575865853,14
2,756,14278,3575865839,3575865855,16
2,756,14279,3575865839,3575865855,16
2,756,14280,3575865839,3575865855,16
2,756,14281,3575865839,3575865856,17
2,756,14282,3575865839,3575865860,21
2,756,14283,3575865839,3575865860,21
2,756,14284,3575865839,3575865862,23
2,756,14285,3575865839,3575865863,24
2,756,14286,3575865839,3575865864,25
2,756,14287,3575865839,3575865866,27
2,756,14288,3575865839,3575865867,28
2,756,14289,3575865839,3575865867,28
2,756,14290,3575865839,3575865874,35
2,756,14291,3575865839,3575865874,35
2,756,14292,3575865839,3575865874,35
2,756,14293,3575865839,3575865875,36
2,756,14294,3575865839,3575865875,36
2,756,14295,3575865839,3575865876,37
2,756,14296,3575865839,3575865877,38
2,756,14297,3575865839,3575865879,40
2,756,14298,3575865839,3575865879,40
2,756,14299,3575865839,3575865879,40
2,756,14300,3575865839,3575865879,40
2,756,14301,3575865839,3575865880,41
2,756,14302,3575865839,3575865881,42
2,756,14303,3575865839,3575865881,42
2,756,14304,3575865839,3575865882,43
2,756,14305,3575865839,3575865885,46
2,756,14306,3575865839,3575865887,48
2,756,14307,3575865839,3575865887,48
2,756,14308,3575865839,3575865887,48
2,756,14309,3575865839,3575865888,49
2,757,14310,3575865898,3575865898,0
2,757,14311,3575865898,3575865898,0
2,757,14312,3575865898,3575865898,0
2,757,14313,3575865898,3575865898,0
2,757,14314,3575865898,3575865898,0
2,757,14315,3575865898,3575865898,0
2,757,14316,3575865898,3575865899,1
2,757,14317,3575865898,3575865900,2
2,757,14318,3575865898,3575865901,3
2,757,14319,3575865898,3575865901,3
2,757,14320,3575865898,3575865902,4
2,757,14321,3575865898,3575865903,5
2,757,14322,3575865898,3575865904,6
2,757,14323,3575865898,3575865905,7
2,757,14324,3575865898,3575865906,8
2,757,14325,3575865898,3575865906,8
2,757,14326,3575865898,3575865908,10
2,757,14327,3575865898,3575865910,12
2,757,14328,3575865898,3575865910,12
2,757,14329,3575865898,3575865912,14
2,757,14330,3575865898,3575865915,17
2,757,14331,3575865898,3575865916,18
2,757,14332,3575865898,3575865916,18
2,757,14333,3575865898,3575865917,19
2,757,14334,3575865898,3575865918,20
2,757,14335,3575865898,3575865919,21
2,757,14336,3575865898,3575865920,22
2,757,14337,3575865898,3575865921,23
2,757,14338,3575865898,3575865922,24
2,757,14339,3575865898,3575865923,25
2,757,14340,3575865898,3575865923,25
2,757,14341,3575865898,3575865924,26
2,757,14342,3575865898,3575865926,28
2,757,14343,3575865898,3575865931,33
2,757,14344,3575865898,3575865931,33
2,757,14345,3575865898,3575865931,33
2,757,14346,3575865898,3575865933,35
2,757,14347,3575865898,3575865933,35
2,757,14348,3575865898,3575865934,36
2,757,14349,3575865898,3575865934,36
2,757,14350,3575865898,3575865934,36
2,757,14351,3575865898,3575865936,38
2,757,14352,3575865898,3575865939,41
2,757,14353,3575865898,3575865939,41
2,757,14354,3575865898,3575865940,42
2,757,14355,3575865898,3575865941,43
2,757,14356,3575865898,3575865942,44
2,757,14357,3575865898,3575865943,45
2,757,14358,3575865898,3575865944,46
2,757,14359,3575865898,3575865946,48
2,757,14360,3575865898,3575865946,48
2,757,14361,3575865898,3575865947,49
2,758,14362,3575865957,3575865957,0
2,758,14363,3575865957,3575865957,0
2,758,14364,3575865957,3575865957,0
2,758,14365,3575865957,3575865957,0
2,758,14366,3575865957,3575865957,0
2,758,14367,3575865957,3575865957,0
2,758,14368,3575865957,3575865957,0
2,758,14369,3575865957,3575865957,0
2,758,14370,3575865957,3575865957,0
2,758,14371,3575865957,3575865957,0
2,758,14372,3575865957,3575865958,1
2,758,14373,3575865957,3575865962,5
2,758,14374,3575865957,3575865964,7
2,758,14375,3575865957,3575865965,8
2,758,14376,3575865957,3575865967,10
2,758,14377,3575865957,3575865968,11
2,758,14378,3575865957,3575865968,11
2,758,14379,3575865957,3575865974,17
2,758,14380,3575865957,3575865974,17
2,758,14381,3575865957,3575865975,18
2,758,14382,3575865957,3575865978,21
2,758,14383,3575865957,3575865979,22
2,758,14384,3575865957,3575865980,23
2,758,14385,3575865957,3575865981,24
2,758,14386,3575865957,3575865983,26
2,758,14387,3575865957,3575865983,26
2,758,14388,3575865957,3575865984,27
2,758,14389,3575865957,3575865985,28
2,758,14390,3575865957,3575865986,29
2,758,14391,3575865957,3575865986,29
2,758,14392,3575865957,3575865987,30
2,758,14393,3575865957,3575865988,31
2,758,14394,3575865957,3575865989,32
2,758,14395,3575865957,3575865990,33
2,758,14396,3575865957,3575865990,33
2,758,14397,3575865957,3575865994,37
2,758,14398,3575865957,3575865994,37
2,758,14399,3575865957,3575865997,40
2,758,14400,3575865957,3575865999,42
2,758,14401,3575865957,3575865999,42
2,758,14402,3575865957,3575865999,42
2,758,14403,3575865957,3575866001,44
2,758,14404,3575865957,3575866004,47
2,758,14405,3575865957,3575866004,47
2,758,14406,3575865957,3575866004,47
2,758,14407,3575865957,3575866007,50
2,759,14408,3575866013,3575866013,0
2,759,14409,3575866013,3575866013,0
2,759,14410,3575866013,3575866013,0
2,759,14411,3575866013,3575866013,0
2,759,14412,3575866013,3575866013,0
2,759,14413,3575866013,3575866022,9
2,759,14414,3575866013,3575866022,9
2,759,14415,3575866013,3575866022,9
2,759,14416,3575866013,3575866022,9
2,759,14417,3575866013,3575866022,9
2,759,14418,3575866013,3575866023,10
2,759,14419,3575866013,3575866025,12
2,759,14420,3575866013,3575866025,12
2,759,14421,3575866013,3575866026,13
2,759,14422,3575866013,3575866026,13
2,759,14423,3575866013,3575866027,14
2,759,14424,3575866013,3575866029,16
2,759,14425,3575866013,3575866036,23
2,759,14426,3575866013,3575866036,23
2,759,14427,3575866013,3575866036,23
2,759,14428,3575866013,3575866036,23
2,759,14429,3575866013,3575866038,25
2,759,14430,3575866013,3575866039,26
2,759,14431,3575866013,3575866042,29
2,759,14432,3575866013,3575866043,30
2,759,14433,3575866013,3575866044,31
2,759,14434,3575866013,3575866045,32
2,759,14435,3575866013,3575866047,34
2,759,14436,3575866013,3575866049,36
2,759,14437,3575866013,3575866049,36
2,759,14438,3575866013,3575866051,38
2,759,14439,3575866013,3575866051,38
2,759,14440,3575866013,3575866054,41
2,759,14441,3575866013,3575866054,41
2,759,14442,3575866013,3575866055,42
2,759,14443,3575866013,3575866055,42
2,759,14444,3575866013,3575866055,42
2,759,14445,3575866013,3575866059,46
2,759,14446,3575866013,3575866060,47
2,759,14447,3575866013,3575866060,47
2,759,14448,3575866013,3575866063,50
2,760,14449,3575866068,3575866068,0
2,760,14450,3575866068,3575866068,0
2,760,14451,3575866068,3575866068,0
2,760,14452,3575866068,3575866068,0
2,760,14453,3575866068,3575866068,0
2,760,14454,3575866068,3575866074,6
2,760,14455,3575866068,3575866074,6
2,760,14456,3575866068,3575866075,7
2,760,14457,3575866068,3575866075,7
2,760,14458,3575866068,3575866076,8
2,760,14459,3575866068,3575866076,8
2,760,14460,3575866068,3575866077,9
2,760,14461,3575866068,3575866079,11
2,760,14462,3575866068,3575866079,11
2,760,14463,3575866068,3575866080,12
2,760,14464,3575866068,3575866081,13
2,760,14465,3575866068,3575866081,13
2,760,14466,3575866068,3575866081,13
2,760,14467,3575866068,3575866082,14
2,760,14468,3575866068,3575866082,14
2,760,14469,3575866068,3575866084,16
2,760,14470,3575866068,3575866085,17
2,760,14471,3575866068,3575866086,18
2,760,14472,3575866068,3575866087,19
2,760,14473,3575866068,3575866088,20
2,760,14474,3575866068,3575866088,20
2,760,14475,3575866068,3575866089,21
2,760,14476,3575866068,3575866092,24
2,760,14477,3575866068,3575866093,25
2,760,14478,3575866068,3575866094,26
2,760,14479,3575866068,3575866094,26
2,760,14480,3575866068,3575866094,26
2,760,14481,3575866068,3575866098,30
2,760,14482,3575866068,3575866098,30
2,760,14483,3575866068,3575866098,30
2,760,14484,3575866068,3575866098,30
2,760,14485,3575866068,3575866099,31
2,760,14486,3575866068,3575866100,32
2,760,14487,3575866068,3575866100,32
2,760,14488,3575866068,3575866100,32
2,760,14489,3575866068,3575866103,35
2,760,14490,3575866068,3575866104,36
2,760,14491,3575866068,3575866105,37
2,760,14492,3575866068,3575866105,37
2,760,14493,3575866068,3575866107,39
2,760,14494,3575866068,3575866107,39
2,760,14495,3575866068,3575866108,40
2,760,14496,3575866068,3575866110,42
2,760,14497,3575866068,3575866110,42
2,760,14498,3575866068,3575866116,48
2,760,14499,3575866068,3575866116,48
2,760,14500,3575866068,3575866116,48
2,760,14501,3575866068,3575866117,49
2,761,14502,3575866126,3575866126,0
2,761,14503,3575866126,3575866126,0
2,761,14504,3575866126,3575866126,0
2,761,14505,3575866126,3575866126,0
2,761,14506,3575866126,3575866126,0
2,761,14507,3575866126,3575866126,0
2,761,14508,3575866126,3575866126,0
2,761,14509,3575866126,3575866126,0
2,761,14510,3575866126,3575866127,1
2,761,14511,3575866126,3575866127,1
2,761,14512,3575866126,3575866129,3
2,761,14513,3575866126,3575866131,5
2,761,14514,3575866126,3575866131,5
2,761,14515,3575866126,3575866133,7
2,761,14516,3575866126,3575866133,7
2,761,14517,3575866126,3575866134,8
2,761,14518,3575866126,3575866134,8
2,761,14519,3575866126,3575866135,9
2,761,14520,3575866126,3575866136,10
2,761,14521,3575866126,3575866139,13
2,761,14522,3575866126,3575866140,14
2,761,14523,3575866126,3575866140,14
2,761,14524,3575866126,3575866141,15
2,761,14525,3575866126,3575866142,16
2,761,14526,3575866126,3575866143,17
2,761,14527,3575866126,3575866144,18
2,761,14528,3575866126,3575866145,19
2,761,14529,3575866126,3575866146,20
2,761,14530,3575866126,3575866146,20
2,761,14531,3575866126,3575866147,21
2,761,14532,3575866126,3575866148,22
2,761,14533,3575866126,3575866148,22
2,761,14534,3575866126,3575866149,23
2,761,14535,3575866126,3575866150,24
2,761,14536,3575866126,3575866150,24
2,761,14537,3575866126,3575866150,24
2,761,14538,3575866126,3575866153,27
2,761,14539,3575866126,3575866153,27
2,761,14540,3575866126,3575866154,28
2,761,14541,3575866126,3575866157,31
2,761,14542,3575866126,3575866158,32
2,761,14543,3575866126,3575866158,32
2,761,14544,3575866126,3575866162,36
2,761,14545,3575866126,3575866165,39
2,761,14546,3575866126,3575866165,39
2,761,14547,3575866126,3575866168,42
2,761,14548,3575866126,3575866168,42
2,761,14549,3575866126,3575866168,42
2,761,14550,3575866126,3575866170,44
2,761,14551,3575866126,3575866174,48
2,761,14552,3575866126,3575866174,48
2,761,14553,3575866126,3575866175,49
2,761,14554,3575866126,3575866175,49
2,761,14555,3575866126,3575866175,49
2,762,14556,3575866184,3575866184,0
2,762,14557,3575866184,3575866184,0
2,762,14558,3575866184,3575866184,0
2,762,14559,3575866184,3575866184,0
2,762,14560,3575866184,3575866184,0
2,762,14561,3575866184,3575866184,0
2,762,14562,3575866184,3575866184,0
2,762,14563,3575866184,3575866185,1
2,762,14564,3575866184,3575866185,1
2,762,14565,3575866184,3575866186,2
2,762,14566,3575866184,3575866186,2
2,762,14567,3575866184,3575866188,4
2,762,14568,3575866184,3575866188,4
2,762,14569,3575866184,3575866190,6
2,762,14570,3575866184,3575866190,6
2,762,14571,3575866184,3575866190,6
2,762,14572,3575866184,3575866195,11
2,762,14573,3575866184,3575866195,11
2,762,14574,3575866184,3575866198,14
2,762,14575,3575866184,3575866199,15
2,762,14576,3575866184,3575866199,15
2,762,14577,3575866184,3575866200,16
2,762,14578,3575866184,3575866202,18
2,762,14579,3575866184,3575866202,18
2,762,14580,3575866184,3575866204,20
2,762,14581,3575866184,3575866204,20
2,762,14582,3575866184,3575866205,21
2,762,14583,3575866184,3575866207,23
2,762,14584,3575866184,3575866209,25
2,762,14585,3575866184,3575866211,27
2,762,14586,3575866184,3575866214,30
2,762,14587,3575866184,3575866214,30
2,762,14588,3575866184,3575866221,37
2,762,14589,3575866184,3575866223,39
2,762,14590,3575866184,3575866223,39
2,762,14591,3575866184,3575866223,39
2,762,14592,3575866184,3575866225,41
2,762,14593,3575866184,3575866226,42
2,762,14594,3575866184,3575866226,42
2,762,14595,3575866184,3575866227,43
2,762,14596,3575866184,3575866228,44
2,762,14597,3575866184,3575866229,45
2,763,14598,3575866244,3575866244,0
2,763,14599,3575866244,3575866244,0
2,763,14600,3575866244,3575866244,0
2,763,14601,3575866244,3575866244,0
2,763,14602,3575866244,3575866244,0
2,763,14603,3575866244,3575866244,0
2,763,14604,3575866244,3575866244,0
2,763,14605,3575866244,3575866245,1
2,763,14606,3575866244,3575866248,4
2,763,14607,3575866244,3575866249,5
2,763,14608,3575866244,3575866251,7
2,763,14609,3575866244,3575866251,7
2,763,14610,3575866244,3575866254,10
2,763,14611,3575866244,3575866255,11
2,763,14612,3575866244,3575866255,11
2,763,14613,3575866244,3575866256,12
2,763,14614,3575866244,3575866260,16
2,763,14615,3575866244,3575866261,17
2,763,14616,3575866244,3575866263,19
2,763,14617,3575866244,3575866264,20
2,763,14618,3575866244,3575866266,22
2,763,14619,3575866244,3575866267,23
2,763,14620,3575866244,3575866267,23
2,763,14621,3575866244,3575866273,29
2,763,14622,3575866244,3575866274,30
2,763,14623,3575866244,3575866275,31
2,763,14624,3575866244,3575866275,31
2,763,14625,3575866244,3575866276,32
2,763,14626,3575866244,3575866276,32
2,763,14627,3575866244,3575866277,33
2,763,14628,3575866244,3575866279,35
2,763,14629,3575866244,3575866279,35
2,763,14630,3575866244,3575866279,35
2,763,14631,3575866244,3575866280,36
2,763,14632,3575866244,3575866280,36
2,763,14633,3575866244,3575866280,36
2,763,14634,3575866244,3575866281,37
2,763,14635,3575866244,3575866282,38
2,763,14636,3575866244,3575866283,39
2,763,14637,3575866244,3575866285,41
2,763,14638,3575866244,3575866285,41
2,763,14639,3575866244,3575866286,42
2,763,14640,3575866244,3575866287,43
2,763,14641,3575866244,3575866288,44
2,763,14642,3575866244,3575866288,44
2,763,14643,3575866244,3575866288,44
2,763,14644,3575866244,3575866290,46
2,763,14645,3575866244,3575866292,48
2,763,14646,3575866244,3575866293,49
2,763,14647,3575866244,3575866294,50
2,764,14648,3575866300,3575866300,0
2,764,14649,3575866300,3575866300,0
2,764,14650,3575866300,3575866300,0
2,764,14651,3575866300,3575866300,0
2,764,14652,3575866300,3575866300,0
2,764,14653,3575866300,3575866300,0
2,764,14654,3575866300,3575866300,0
2,764,14655,3575866300,3575866300,0
2,764,14656,3575866300,3575866301,1
2,764,14657,3575866300,3575866301,1
2,764,14658,3575866300,3575866303,3
2,764,14659,3575866300,3575866305,5
2,764,14660,3575866300,3575866306,6
2,764,14661,3575866300,3575866307,7
2,764,14662,3575866300,3575866307,7
2,764,14663,3575866300,3575866307,7
2,764,14664,3575866300,3575866308,8
2,764,14665,3575866300,3575866310,10
2,764,14666,3575866300,3575866311,11
2,764,14667,3575866300,3575866315,15
2,764,14668,3575866300,3575866316,16
2,764,14669,3575866300,3575866318,18
2,764,14670,3575866300,3575866318,18
2,764,14671,3575866300,3575866319,19
2,764,14672,3575866300,3575866319,19
2,764,14673,3575866300,3575866321,21
2,764,14674,3575866300,3575866321,21
2,764,14675,3575866300,3575866323,23
2,764,14676,3575866300,3575866323,23
2,764,14677,3575866300,3575866323,23
2,764,14678,3575866300,3575866324,24
2,764,14679,3575866300,3575866327,27
2,764,14680,3575866300,3575866327,27
2,764,14681,3575866300,3575866328,28
2,764,14682,3575866300,3575866329,29
2,764,14683,3575866300,3575866331,31
2,764,14684,3575866300,3575866331,31
2,764,14685,3575866300,3575866333,33
2,764,14686,3575866300,3575866333,33
2,764,14687,3575866300,3575866334,34
2,764,14688,3575866300,3575866335,35
2,764,14689,3575866300,3575866335,35
2,764,14690,3575866300,3575866336,36
2,764,14691,3575866300,3575866339,39
2,764,14692,3575866300,3575866340,40
2,764,14693,3575866300,3575866341,41
2,764,14694,3575866300,3575866342,42
2,764,14695,3575866300,3575866344,44
2,764,14696,3575866300,3575866344,44
2,764,14697,3575866300,3575866346,46
2,764,14698,3575866300,3575866346,46
2,764,14699,3575866300,3575866347,47
2,764,14700,3575866300,3575866347,47
2,764,14701,3575866300,3575866348,48
2,764,14702,3575866300,3575866348,48
2,764,14703,3575866300,3575866349,49
2,764,14704,3575866300,3575866349,49
2,764,14705,3575866300,3575866350,50
2,765,14706,3575866360,3575866360,0
2,765,14707,3575866360,3575866360,0
2,765,14708,3575866360,3575866360,0
2,765,14709,3575866360,3575866360,0
2,765,14710,3575866360,3575866360,0
2,765,14711,3575866360,3575866360,0
2,765,14712,3575866360,3575866360,0
2,765,14713,3575866360,3575866360,0
2,765,14714,3575866360,3575866362,2
2,765,14715,3575866360,3575866365,5
2,765,14716,3575866360,3575866367,7
2,765,14717,3575866360,3575866368,8
2,765,14718,3575866360,3575866369,9
2,765,14719,3575866360,3575866370,10
2,765,14720,3575866360,3575866374,14
2,765,14721,3575866360,3575866375,15
2,765,14722,3575866360,3575866375,15
2,765,14723,3575866360,3575866375,15
2,765,14724,3575866360,3575866379,19
2,765,14725,3575866360,3575866379,19
2,765,14726,3575866360,3575866381,21
2,765,14727,3575866360,3575866383,23
2,765,14728,3575866360,3575866383,23
2,765,14729,3575866360,3575866383,23
2,765,14730,3575866360,3575866384,24
2,765,14731,3575866360,3575866384,24
2,765,14732,3575866360,3575866385,25
2,765,14733,3575866360,3575866386,26
2,765,14734,3575866360,3575866386,26
2,765,14735,3575866360,3575866388,28
2,765,14736,3575866360,3575866390,30
2,765,14737,3575866360,3575866390,30
2,765,14738,3575866360,3575866391,31
2,765,14739,3575866360,3575866395,35
2,765,14740,3575866360,3575866395,35
2,765,14741,3575866360,3575866398,38
2,765,14742,3575866360,3575866399,39
2,765,14743,3575866360,3575866399,39
2,765,14744,3575866360,3575866400,40
2,765,14745,3575866360,3575866401,41
2,765,14746,3575866360,3575866402,42
2,765,14747,3575866360,3575866404,44
2,765,14748,3575866360,3575866404,44
2,765,14749,3575866360,3575866405,45
2,765,14750,3575866360,3575866408,48
2,765,14751,3575866360,3575866409,49
2,766,14752,3575866417,3575866417,0
2,766,14753,3575866417,3575866417,0
2,766,14754,3575866417,3575866417,0
2,766,14755,3575866417,3575866417,0
2,766,14756,3575866417,3575866422,5
2,766,14757,3575866417,3575866422,5
2,766,14758,3575866417,3575866422,5
2,766,14759,3575866417,3575866423,6
2,766,14760,3575866417,3575866423,6
2,766,14761,3575866417,3575866424,7
2,766,14762,3575866417,3575866424,7
2,766,14763,3575866417,3575866426,9
2,766,14764,3575866417,3575866427,10
2,766,14765,3575866417,3575866428,11
2,766,14766,3575866417,3575866428,11
2,766,14767,3575866417,3575866429,12
2,766,14768,3575866417,3575866435,18
2,766,14769,3575866417,3575866436,19
2,766,14770,3575866417,3575866437,20
2,766,14771,3575866417,3575866437,20
2,766,14772,3575866417,3575866438,21
2,766,14773,3575866417,3575866440,23
2,766,14774,3575866417,3575866440,23
2,766,14775,3575866417,3575866443,26
2,766,14776,3575866417,3575866444,27
2,766,14777,3575866417,3575866444,27
2,766,14778,3575866417,3575866445,28
2,766,14779,3575866417,3575866447,30
2,766,14780,3575866417,3575866449,32
2,766,14781,3575866417,3575866450,33
2,766,14782,3575866417,3575866451,34
2,766,14783,3575866417,3575866454,37
2,766,14784,3575866417,3575866455,38
2,766,14785,3575866417,3575866455,38
2,766,14786,3575866417,3575866456,39
2,766,14787,3575866417,3575866456,39
2,766,14788,3575866417,3575866459,42
2,766,14789,3575866417,3575866460,43
2,766,14790,3575866417,3575866461,44
2,766,14791,3575866417,3575866463,46
2,766,14792,3575866417,3575866464,47
2,767,14793,3575866473,3575866473,0
2,767,14794,3575866473,3575866473,0
2,767,14795,3575866473,3575866473,0
2,767,14796,3575866473,3575866473,0
2,767,14797,3575866473,3575866473,0
2,767,14798,3575866473,3575866473,0
2,767,14799,3575866473,3575866475,2
2,767,14800,3575866473,3575866476,3
2,767,14801,3575866473,3575866476,3
2,767,14802,3575866473,3575866478,5
2,767,14803,3575866473,3575866478,5
2,767,14804,3575866473,3575866480,7
2,767,14805,3575866473,3575866480,7
2,767,14806,3575866473,3575866481,8
2,767,14807,3575866473,3575866481,8
2,767,14808,3575866473,3575866482,9
2,767,14809,3575866473,3575866483,10
2,767,14810,3575866473,3575866485,12
2,767,14811,3575866473,3575866485,12
2,767,14812,3575866473,3575866485,12
2,767,14813,3575866473,3575866486,13
2,767,14814,3575866473,3575866487,14
2,767,14815,3575866473,3575866489,16
2,767,14816,3575866473,3575866489,16
2,767,14817,3575866473,3575866490,17
2,767,14818,3575866473,3575866491,18
2,767,14819,3575866473,3575866494,21
2,767,14820,3575866473,3575866494,21
2,767,14821,3575866473,3575866498,25
2,767,14822,3575866473,3575866498,25
2,767,14823,3575866473,3575866498,25
2,767,14824,3575866473,3575866499,26
2,767,14825,3575866473,3575866500,27
2,767,14826,3575866473,3575866500,27
2,767,14827,3575866473,3575866501,28
2,767,14828,3575866473,3575866501,28
2,767,14829,3575866473,3575866503,30
2,767,14830,3575866473,3575866504,31
2,767,14831,3575866473,3575866506,33
2,767,14832,3575866473,3575866506,33
2,767,14833,3575866473,3575866506,33
2,767,14834,3575866473,3575866507,34
2,767,14835,3575866473,3575866508,35
2,767,14836,3575866473,3575866509,36
2,767,14837,3575866473,3575866510,37
2,767,14838,3575866473,3575866511,38
2,767,14839,3575866473,3575866515,42
2,767,14840,3575866473,3575866516,43
2,767,14841,3575866473,3575866516,43
2,767,14842,3575866473,3575866517,44
2,767,14843,3575866473,3575866518,45
2,767,14844,3575866473,3575866519,46
2,767,14845,3575866473,3575866519,46
2,767,14846,3575866473,3575866519,46
2,767,14847,3575866473,3575866521,48
2,767,14848,3575866473,3575866522,49
2,767,14849,3575866473,3575866522,49
2,768,14850,3575866530,3575866530,0
2,768,14851,3575866530,3575866530,0
2,768,14852,3575866530,3575866530,0
2,768,14853,3575866530,3575866530,0
2,768,14854,3575866530,3575866530,0
2,768,14855,3575866530,3575866531,1
2,768,14856,3575866530,3575866531,1
2,768,14857,3575866530,3575866531,1
2,768,14858,3575866530,3575866532,2
2,768,14859,3575866530,3575866533,3
2,768,14860,3575866530,3575866534,4
2,768,14861,3575866530,3575866534,4
2,768,14862,3575866530,3575866534,4
2,768,14863,3575866530,3575866535,5
2,768,14864,3575866530,3575866539,9
2,768,14865,3575866530,3575866541,11
2,768,14866,3575866530,3575866541,11
2,768,14867,3575866530,3575866543,13
2,768,14868,3575866530,3575866544,14
2,768,14869,3575866530,3575866545,15
2,768,14870,3575866530,3575866545,15
2,768,14871,3575866530,3575866545,15
2,768,14872,3575866530,3575866547,17
2,768,14873,3575866530,3575866547,17
2,768,14874,3575866530,3575866548,18
2,768,14875,3575866530,3575866549,19
2,768,14876,3575866530,3575866549,19
2,768,14877,3575866530,3575866553,23
2,768,14878,3575866530,3575866553,23
2,768,14879,3575866530,3575866554,24
2,768,14880,3575866530,3575866556,26
2,768,14881,3575866530,3575866557,27
2,768,14882,3575866530,3575866559,29
2,768,14883,3575866530,3575866561,31
2,768,14884,3575866530,3575866564,34
2,768,14885,3575866530,3575866566,36
2,768,14886,3575866530,3575866568,38
2,768,14887,3575866530,3575866568,38
2,768,14888,3575866530,3575866569,39
2,768,14889,3575866530,3575866573,43
2,768,14890,3575866530,3575866574,44
2,768,14891,3575866530,3575866575,45
2,768,14892,3575866530,3575866575,45
2,768,14893,3575866530,3575866578,48
2,768,14894,3575866530,3575866578,48
2,769,14895,3575866587,3575866587,0
2,769,14896,3575866587,3575866587,0
2,769,14897,3575866587,3575866587,0
2,769,14898,3575866587,3575866587,0
2,769,14899,3575866587,3575866587,0
2,769,14900,3575866587,3575866587,0
2,769,14901,3575866587,3575866587,0
2,769,14902,3575866587,3575866587,0
2,769,14903,3575866587,3575866587,0
2,769,14904,3575866587,3575866588,1
2,769,14905,3575866587,3575866589,2
2,769,14906,3575866587,3575866590,3
2,769,14907,3575866587,3575866591,4
2,769,14908,3575866587,3575866594,7
2,769,14909,3575866587,3575866594,7
2,769,14910,3575866587,3575866597,10
2,769,14911,3575866587,3575866598,11
2,769,14912,3575866587,3575866598,11
2,769,14913,3575866587,3575866598,11
2,769,14914,3575866587,3575866600,13
2,769,14915,3575866587,3575866603,16
2,769,14916,3575866587,3575866603,16
2,769,14917,3575866587,3575866604,17
2,769,14918,3575866587,3575866607,20
2,769,14919,3575866587,3575866608,21
2,769,14920,3575866587,3575866611,24
2,769,14921,3575866587,3575866611,24
2,769,14922,3575866587,3575866613,26
2,769,14923,3575866587,3575866613,26
2,769,14924,3575866587,3575866622,35
2,769,14925,3575866587,3575866622,35
2,769,14926,3575866587,3575866622,35
2,769,14927,3575866587,3575866623,36
2,769,14928,3575866587,3575866623,36
2,769,14929,3575866587,3575866625,38
2,769,14930,3575866587,3575866626,39
2,769,14931,3575866587,3575866627,40
2,769,14932,3575866587,3575866628,41
2,769,14933,3575866587,3575866629,42
2,769,14934,3575866587,3575866635,48
2,769,14935,3575866587,3575866636,49
2,769,14936,3575866587,3575866636,49
2,769,14937,3575866587,3575866637,50
2,770,14938,3575866646,3575866646,0
2,770,14939,3575866646,3575866646,0
2,770,14940,3575866646,3575866646,0
2,770,14941,3575866646,3575866646,0
2,770,14942,3575866646,3575866646,0
2,770,14943,3575866646,3575866646,0
2,770,14944,3575866646,3575866646,0
2,770,14945,3575866646,3575866646,0
2,770,14946,3575866646,3575866648,2
2,770,14947,3575866646,3575866649,3
2,770,14948,3575866646,3575866649,3
2,770,14949,3575866646,3575866652,6
2,770,14950,3575866646,3575866652,6
2,770,14951,3575866646,3575866653,7
2,770,14952,3575866646,3575866654,8
2,770,14953,3575866646,3575866654,8
2,770,14954,3575866646,3575866654,8
2,770,14955,3575866646,3575866655,9
2,770,14956,3575866646,3575866659,13
2,770,14957,3575866646,3575866660,14
2,770,14958,3575866646,3575866663,17
2,770,14959,3575866646,3575866663,17
2,770,14960,3575866646,3575866668,22
2,770,14961,3575866646,3575866669,23
2,770,14962,3575866646,3575866673,27
2,770,14963,3575866646,3575866673,27
2,770,14964,3575866646,3575866674,28
2,770,14965,3575866646,3575866675,29
2,770,14966,3575866646,3575866676,30
2,770,14967,3575866646,3575866676,30
2,770,14968,3575866646,3575866677,31
2,770,14969,3575866646,3575866678,32
2,770,14970,3575866646,3575866679,33
2,770,14971,3575866646,3575866679,33
2,770,14972,3575866646,3575866680,34
2,770,14973,3575866646,3575866681,35
2,770,14974,3575866646,3575866681,35
2,770,14975,3575866646,3575866681,35
2,770,14976,3575866646,3575866682,36
2,770,14977,3575866646,3575866683,37
2,770,14978,3575866646,3575866685,39
2,770,14979,3575866646,3575866686,40
2,770,14980,3575866646,3575866686,40
2,770,14981,3575866646,3575866686,40
2,770,14982,3575866646,3575866687,41
2,770,14983,3575866646,3575866690,44
2,770,14984,3575866646,3575866690,44
2,770,14985,3575866646,3575866690,44
2,770,14986,3575866646,3575866690,44
2,770,14987,3575866646,3575866693,47
2,770,14988,3575866646,3575866694,48
2,770,14989,3575866646,3575866694,48
2,770,14990,3575866646,3575866694,48
2,771,14991,3575866703,3575866703,0
2,771,14992,3575866703,3575866703,0
2,771,14993,3575866703,3575866703,0
2,771,14994,3575866703,3575866703,0
2,771,14995,3575866703,3575866703,0
2,771,14996,3575866703,3575866703,0
2,771,14997,3575866703,3575866703,0
2,771,14998,3575866703,3575866703,0
2,771,14999,3575866703,3575866703,0
2,771,15000,3575866703,3575866705,2
2,771,15001,3575866703,3575866706,3
2,771,15002,3575866703,3575866706,3
2,771,15003,3575866703,3575866706,3
2,771,15004,3575866703,3575866706,3
2,771,15005,3575866703,3575866709,6
2,771,15006,3575866703,3575866710,7
2,771,15007,3575866703,3575866711,8
2,771,15008,3575866703,3575866713,10
2,771,15009,3575866703,3575866715,12
2,771,15010,3575866703,3575866716,13
2,771,15011,3575866703,3575866717,14
2,771,15012,3575866703,3575866717,14
2,771,15013,3575866703,3575866718,15
2,771,15014,3575866703,3575866719,16
2,771,15015,3575866703,3575866719,16
2,771,15016,3575866703,3575866720,17
2,771,15017,3575866703,3575866722,19
2,771,15018,3575866703,3575866722,19
2,771,15019,3575866703,3575866723,20
2,771,15020,3575866703,3575866724,21
2,771,15021,3575866703,3575866725,22
2,771,15022,3575866703,3575866726,23
2,771,15023,3575866703,3575866727,24
2,771,15024,3575866703,3575866728,25
2,771,15025,3575866703,3575866730,27
2,771,15026,3575866703,3575866730,27
2,771,15027,3575866703,3575866731,28
2,771,15028,3575866703,3575866731,28
2,771,15029,3575866703,3575866732,29
2,771,15030,3575866703,3575866734,31
2,771,15031,3575866703,3575866734,31
2,771,15032,3575866703,3575866734,31
2,771,15033,3575866703,3575866734,31
2,771,15034,3575866703,3575866735,32
2,771,15035,3575866703,3575866739,36
2,771,15036,3575866703,3575866741,38
2,771,15037,3575866703,3575866741,38
2,771,15038,3575866703,3575866743,40
2,771,15039,3575866703,3575866745,42
2,771,15040,3575866703,3575866745,42
2,771,15041,3575866703,3575866745,42
2,771,15042,3575866703,3575866746,43
2,771,15043,3575866703,3575866746,43
2,771,15044,3575866703,3575866748,45
2,771,15045,3575866703,3575866749,46
2,771,15046,3575866703,3575866749,46
2,771,15047,3575866703,3575866749,46
2,771,15048,3575866703,3575866751,48
2,771,15049,3575866703,3575866753,50
2,772,15050,3575866759,3575866759,0
2,772,15051,3575866759,3575866759,0
2,772,15052,3575866759,3575866759,0
2,772,15053,3575866759,3575866759,0
2,772,15054,3575866759,3575866759,0
2,772,15055,3575866759,3575866761,2
2,772,15056,3575866759,3575866765,6
2,772,15057,3575866759,3575866767,8
2,772,15058,3575866759,3575866768,9
2,772,15059,3575866759,3575866768,9
2,772,15060,3575866759,3575866770,11
2,772,15061,3575866759,3575866773,14
2,772,15062,3575866759,3575866774,15
2,772,15063,3575866759,3575866774,15
2,772,15064,3575866759,3575866775,16
2,772,15065,3575866759,3575866775,16
2,772,15066,3575866759,3575866778,19
2,772,15067,3575866759,3575866778,19
2,772,15068,3575866759,3575866781,22
2,772,15069,3575866759,3575866783,24
2,772,15070,3575866759,3575866783,24
2,772,15071,3575866759,3575866783,24
2,772,15072,3575866759,3575866783,24
2,772,15073,3575866759,3575866784,25
2,772,15074,3575866759,3575866784,25
2,772,15075,3575866759,3575866785,26
2,772,15076,3575866759,3575866786,27
2,772,15077,3575866759,3575866787,28
2,772,15078,3575866759,3575866787,28
2,772,15079,3575866759,3575866788,29
2,772,15080,3575866759,3575866790,31
2,772,15081,3575866759,3575866791,32
2,772,15082,3575866759,3575866791,32
2,772,15083,3575866759,3575866794,35
2,772,15084,3575866759,3575866794,35
2,772,15085,3575866759,3575866796,37
2,772,15086,3575866759,3575866798,39
2,772,15087,3575866759,3575866800,41
2,772,15088,3575866759,3575866803,44
2,772,15089,3575866759,3575866803,44
2,772,15090,3575866759,3575866804,45
2,772,15091,3575866759,3575866807,48
2,772,15092,3575866759,3575866809,50
2,773,15093,3575866822,3575866822,0
2,773,15094,3575866822,3575866822,0
2,773,15095,3575866822,3575866822,0
2,773,15096,3575866822,3575866822,0
2,773,15097,3575866822,3575866822,0
2,773,15098,3575866822,3575866822,0
2,773,15099,3575866822,3575866822,0
2,773,15100,3575866822,3575866823,1
2,773,15101,3575866822,3575866823,1
2,773,15102,3575866822,3575866823,1
2,773,15103,3575866822,3575866825,3
2,773,15104,3575866822,3575866827,5
2,773,15105,3575866822,3575866827,5
2,773,15106,3575866822,3575866827,5
2,773,15107,3575866822,3575866835,13
2,773,15108,3575866822,3575866835,13
2,773,15109,3575866822,3575866836,14
2,773,15110,3575866822,3575866838,16
2,773,15111,3575866822,3575866840,18
2,773,15112,3575866822,3575866840,18
2,773,15113,3575866822,3575866842,20
2,773,15114,3575866822,3575866843,21
2,773,15115,3575866822,3575866844,22
2,773,15116,3575866822,3575866844,22
2,773,15117,3575866822,3575866845,23
2,773,15118,3575866822,3575866846,24
2,773,15119,3575866822,3575866848,26
2,773,15120,3575866822,3575866849,27
2,773,15121,3575866822,3575866849,27
2,773,15122,3575866822,3575866851,29
2,773,15123,3575866822,3575866852,30
2,773,15124,3575866822,3575866853,31
2,773,15125,3575866822,3575866854,32
2,773,15126,3575866822,3575866855,33
2,773,15127,3575866822,3575866855,33
2,773,15128,3575866822,3575866856,34
2,773,15129,3575866822,3575866859,37
2,773,15130,3575866822,3575866859,37
2,773,15131,3575866822,3575866860,38
2,773,15132,3575866822,3575866863,41
2,773,15133,3575866822,3575866863,41
2,773,15134,3575866822,3575866867,45
2,773,15135,3575866822,3575866869,47
2,773,15136,3575866822,3575866869,47
2,774,15137,3575866879,3575866879,0
2,774,15138,3575866879,3575866879,0
2,774,15139,3575866879,3575866879,0
2,774,15140,3575866879,3575866879,0
2,774,15141,3575866879,3575866879,0
2,774,15142,3575866879,3575866879,0
2,774,15143,3575866879,3575866879,0
2,774,15144,3575866879,3575866879,0
2,774,15145,3575866879,3575866879,0
2,774,15146,3575866879,3575866881,2
2,774,15147,3575866879,3575866881,2
2,774,15148,3575866879,3575866882,3
2,774,15149,3575866879,3575866882,3
2,774,15150,3575866879,3575866883,4
2,774,15151,3575866879,3575866885,6
2,774,15152,3575866879,3575866886,7
2,774,15153,3575866879,3575866886,7
2,774,15154,3575866879,3575866886,7
2,774,15155,3575866879,3575866887,8
2,774,15156,3575866879,3575866889,10
2,774,15157,3575866879,3575866889,10
2,774,15158,3575866879,3575866890,11
2,774,15159,3575866879,3575866890,11
2,774,15160,3575866879,3575866891,12
2,774,15161,3575866879,3575866894,15
2,774,15162,3575866879,3575866894,15
2,774,15163,3575866879,3575866898,19
2,774,15164,3575866879,3575866898,19
2,774,15165,3575866879,3575866898,19
2,774,15166,3575866879,3575866899,20
2,774,15167,3575866879,3575866901,22
2,774,15168,3575866879,3575866901,22
2,774,15169,3575866879,3575866901,22
2,774,15170,3575866879,3575866902,23
2,774,15171,3575866879,3575866903,24
2,774,15172,3575866879,3575866905,26
2,774,15173,3575866879,3575866906,27
2,774,15174,3575866879,3575866906,27
2,774,15175,3575866879,3575866907,28
2,774,15176,3575866879,3575866908,29
2,774,15177,3575866879,3575866909,30
2,774,15178,3575866879,3575866911,32
2,774,15179,3575866879,3575866915,36
2,774,15180,3575866879,3575866916,37
2,774,15181,3575866879,3575866917,38
2,774,15182,3575866879,3575866917,38
2,774,15183,3575866879,3575866918,39
2,774,15184,3575866879,3575866919,40
2,774,15185,3575866879,3575866920,41
2,774,15186,3575866879,3575866920,41
2,774,15187,3575866879,3575866922,43
2,774,15188,3575866879,3575866922,43
2,774,15189,3575866879,3575866923,44
2,774,15190,3575866879,3575866925,46
2,774,15191,3575866879,3575866925,46
2,774,15192,3575866879,3575866926,47
2,774,15193,3575866879,3575866927,48
2,774,15194,3575866879,3575866927,48
2,775,15195,3575866936,3575866936,0
2,775,15196,3575866936,3575866936,0
2,775,15197,3575866936,3575866936,0
2,775,15198,3575866936,3575866936,0
2,775,15199,3575866936,3575866936,0
2,775,15200,3575866936,3575866936,0
2,775,15201,3575866936,3575866936,0
2,775,15202,3575866936,3575866936,0
2,775,15203,3575866936,3575866939,3
2,775,15204,3575866936,3575866940,4
2,775,15205,3575866936,3575866941,5
2,775,15206,3575866936,3575866941,5
2,775,15207,3575866936,3575866942,6
2,775,15208,3575866936,3575866943,7
2,775,15209,3575866936,3575866945,9
2,775,15210,3575866936,3575866945,9
2,775,15211,3575866936,3575866946,10
2,775,15212,3575866936,3575866946,10
2,775,15213,3575866936,3575866947,11
2,775,15214,3575866936,3575866948,12
2,775,15215,3575866936,3575866948,12
2,775,15216,3575866936,3575866949,13
2,775,15217,3575866936,3575866950,14
2,775,15218,3575866936,3575866952,16
2,775,15219,3575866936,3575866953,17
2,775,15220,3575866936,3575866953,17
2,775,15221,3575866936,3575866954,18
2,775,15222,3575866936,3575866956,20
2,775,15223,3575866936,3575866957,21
2,775,15224,3575866936,3575866959,23
2,775,15225,3575866936,3575866960,24
2,775,15226,3575866936,3575866961,25
2,775,15227,3575866936,3575866963,27
2,775,15228,3575866936,3575866966,30
2,775,15229,3575866936,3575866966,30
2,775,15230,3575866936,3575866968,32
2,775,15231,3575866936,3575866968,32
2,775,15232,3575866936,3575866970,34
2,775,15233,3575866936,3575866973,37
2,775,15234,3575866936,3575866974,38
2,775,15235,3575866936,3575866976,40
2,775,15236,3575866936,3575866976,40
2,775,15237,3575866936,3575866978,42
2,775,15238,3575866936,3575866982,46
2,775,15239,3575866936,3575866983,47
2,775,15240,3575866936,3575866983,47
2,775,15241,3575866936,3575866983,47
2,775,15242,3575866936,3575866984,48
2,775,15243,3575866936,3575866984,48
2,775,15244,3575866936,3575866985,49
2,775,15245,3575866936,3575866985,49
2,775,15246,3575866936,3575866986,50
2,776,15247,3575866993,3575866993,0
2,776,15248,3575866993,3575866993,0
2,776,15249,3575866993,3575866993,0
2,776,15250,3575866993,3575866993,0
2,776,15251,3575866993,3575866993,0
2,776,15252,3575866993,3575866993,0
2,776,15253,3575866993,3575866994,1
2,776,15254,3575866993,3575866995,2
2,776,15255,3575866993,3575866997,4
2,776,15256,3575866993,3575866997,4
2,776,15257,3575866993,3575866998,5
2,776,15258,3575866993,3575866998,5
2,776,15259,3575866993,3575867001,8
2,776,15260,3575866993,3575867003,10
2,776,15261,3575866993,3575867004,11
2,776,15262,3575866993,3575867004,11
2,776,15263,3575866993,3575867004,11
2,776,15264,3575866993,3575867007,14
2,776,15265,3575866993,3575867009,16
2,776,15266,3575866993,3575867011,18
2,776,15267,3575866993,3575867012,19
2,776,15268,3575866993,3575867012,19
2,776,15269,3575866993,3575867013,20
2,776,15270,3575866993,3575867014,21
2,776,15271,3575866993,3575867021,28
2,776,15272,3575866993,3575867023,30
2,776,15273,3575866993,3575867023,30
2,776,15274,3575866993,3575867024,31
2,776,15275,3575866993,3575867025,32
2,776,15276,3575866993,3575867028,35
2,776,15277,3575866993,3575867028,35
2,776,15278,3575866993,3575867029,36
2,776,15279,3575866993,3575867035,42
2,776,15280,3575866993,3575867036,43
2,776,15281,3575866993,3575867037,44
2,776,15282,3575866993,3575867037,44
2,776,15283,3575866993,3575867039,46
2,776,15284,3575866993,3575867039,46
2,776,15285,3575866993,3575867042,49
2,776,15286,3575866993,3575867043,50
2,777,15287,3575867050,3575867050,0
2,777,15288,3575867050,3575867050,0
2,777,15289,3575867050,3575867050,0
2,777,15290,3575867050,3575867050,0
2,777,15291,3575867050,3575867050,0
2,777,15292,3575867050,3575867050,0
2,777,15293,3575867050,3575867050,0
2,777,15294,3575867050,3575867052,2
2,777,15295,3575867050,3575867053,3
2,777,15296,3575867050,3575867054,4
2,777,15297,3575867050,3575867055,5
2,777,15298,3575867050,3575867055,5
2,777,15299,3575867050,3575867056,6
2,777,15300,3575867050,3575867056,6
2,777,15301,3575867050,3575867059,9
2,777,15302,3575867050,3575867059,9
2,777,15303,3575867050,3575867060,10
2,777,15304,3575867050,3575867063,13
2,777,15305,3575867050,3575867064,14
2,777,15306,3575867050,3575867067,17
2,777,15307,3575867050,3575867069,19
2,777,15308,3575867050,3575867069,19
2,777,15309,3575867050,3575867073,23
2,777,15310,3575867050,3575867073,23
2,777,15311,3575867050,3575867074,24
2,777,15312,3575867050,3575867075,25
2,777,15313,3575867050,3575867076,26
2,777,15314,3575867050,3575867077,27
2,777,15315,3575867050,3575867078,28
2,777,15316,3575867050,3575867078,28
2,777,15317,3575867050,3575867078,28
2,777,15318,3575867050,3575867079,29
2,777,15319,3575867050,3575867080,30
2,777,15320,3575867050,3575867082,32
2,777,15321,3575867050,3575867082,32
2,777,15322,3575867050,3575867083,33
2,777,15323,3575867050,3575867085,35
2,777,15324,3575867050,3575867086,36
2,777,15325,3575867050,3575867086,36
2,777,15326,3575867050,3575867086,36
2,777,15327,3575867050,3575867087,37
2,777,15328,3575867050,3575867089,39
2,777,15329,3575867050,3575867089,39
2,777,15330,3575867050,3575867090,40
2,777,15331,3575867050,3575867090,40
2,777,15332,3575867050,3575867091,41
2,777,15333,3575867050,3575867094,44
2,777,15334,3575867050,3575867094,44
2,777,15335,3575867050,3575867098,48
2,777,15336,3575867050,3575867099,49
2,778,15337,3575867111,3575867111,0
2,778,15338,3575867111,3575867111,0
2,778,15339,3575867111,3575867111,0
2,778,15340,3575867111,3575867111,0
2,778,15341,3575867111,3575867111,0
2,778,15342,3575867111,3575867111,0
2,778,15343,3575867111,3575867111,0
2,778,15344,3575867111,3575867111,0
2,778,15345,3575867111,3575867111,0
2,778,15346,3575867111,3575867111,0
2,778,15347,3575867111,3575867111,0
2,778,15348,3575867111,3575867111,0
2,778,15349,3575867111,3575867111,0
2,778,15350,3575867111,3575867111,0
2,778,15351,3575867111,3575867111,0
2,778,15352,3575867111,3575867112,1
2,778,15353,3575867111,3575867116,5
2,778,15354,3575867111,3575867116,5
2,778,15355,3575867111,3575867117,6
2,778,15356,3575867111,3575867118,7
2,778,15357,3575867111,3575867119,8
2,778,15358,3575867111,3575867119,8
2,778,15359,3575867111,3575867120,9
2,778,15360,3575867111,3575867120,9
2,778,15361,3575867111,3575867122,11
2,778,15362,3575867111,3575867122,11
2,778,15363,3575867111,3575867124,13
2,778,15364,3575867111,3575867126,15
2,778,15365,3575867111,3575867126,15
2,778,15366,3575867111,3575867127,16
2,778,15367,3575867111,3575867128,17
2,778,15368,3575867111,3575867131,20
2,778,15369,3575867111,3575867131,20
2,778,15370,3575867111,3575867133,22
2,778,15371,3575867111,3575867134,23
2,778,15372,3575867111,3575867134,23
2,778,15373,3575867111,3575867134,23
2,778,15374,3575867111,3575867135,24
2,778,15375,3575867111,3575867135,24
2,778,15376,3575867111,3575867139,28
2,778,15377,3575867111,3575867140,29
2,778,15378,3575867111,3575867141,30
2,778,15379,3575867111,3575867142,31
2,778,15380,3575867111,3575867142,31
2,778,15381,3575867111,3575867143,32
2,778,15382,3575867111,3575867145,34
2,778,15383,3575867111,3575867146,35
2,778,15384,3575867111,3575867146,35
2,778,15385,3575867111,3575867146,35
2,778,15386,3575867111,3575867147,36
2,778,15387,3575867111,3575867147,36
2,778,15388,3575867111,3575867149,38
2,778,15389,3575867111,3575867149,38
2,778,15390,3575867111,3575867149,38
2,778,15391,3575867111,3575867150,39
2,778,15392,3575867111,3575867151,40
2,778,15393,3575867111,3575867151,40
2,778,15394,3575867111,3575867152,41
2,778,15395,3575867111,3575867153,42
2,778,15396,3575867111,3575867154,43
2,778,15397,3575867111,3575867155,44
2,778,15398,3575867111,3575867158,47
2,778,15399,3575867111,3575867158,47
2,778,15400,3575867111,3575867161,50
2,779,15401,3575867166,3575867167,1
2,779,15402,3575867166,3575867167,1
2,779,15403,3575867166,3575867167,1
2,779,15404,3575867166,3575867168,2
2,779,15405,3575867166,3575867170,4
2,779,15406,3575867166,3575867172,6
2,779,15407,3575867166,3575867174,8
2,779,15408,3575867166,3575867176,10
2,779,15409,3575867166,3575867176,10
2,779,15410,3575867166,3575867178,12
2,779,15411,3575867166,3575867178,12
2,779,15412,3575867166,3575867182,16
2,779,15413,3575867166,3575867183,17
2,779,15414,3575867166,3575867183,17
2,779,15415,3575867166,3575867183,17
2,779,15416,3575867166,3575867184,18
2,779,15417,3575867166,3575867185,19
2,779,15418,3575867166,3575867185,19
2,779,15419,3575867166,3575867186,20
2,779,15420,3575867166,3575867188,22
2,779,15421,3575867166,3575867189,23
2,779,15422,3575867166,3575867190,24
2,779,15423,3575867166,3575867190,24
2,779,15424,3575867166,3575867190,24
2,779,15425,3575867166,3575867192,26
2,779,15426,3575867166,3575867194,28
2,779,15427,3575867166,3575867195,29
2,779,15428,3575867166,3575867196,30
2,779,15429,3575867166,3575867197,31
2,779,15430,3575867166,3575867199,33
2,779,15431,3575867166,3575867199,33
2,779,15432,3575867166,3575867200,34
2,779,15433,3575867166,3575867200,34
2,779,15434,3575867166,3575867204,38
2,779,15435,3575867166,3575867204,38
2,779,15436,3575867166,3575867205,39
2,779,15437,3575867166,3575867205,39
2,779,15438,3575867166,3575867207,41
2,779,15439,3575867166,3575867209,43
2,779,15440,3575867166,3575867212,46
2,779,15441,3575867166,3575867212,46
2,779,15442,3575867166,3575867213,47
2,779,15443,3575867166,3575867213,47
2,779,15444,3575867166,3575867214,48
2,780,15445,3575867227,3575867227,0
2,780,15446,3575867227,3575867227,0
2,780,15447,3575867227,3575867227,0
2,780,15448,3575867227,3575867227,0
2,780,15449,3575867227,3575867227,0
2,780,15450,3575867227,3575867227,0
2,780,15451,3575867227,3575867227,0
2,780,15452,3575867227,3575867228,1
2,780,15453,3575867227,3575867228,1
2,780,15454,3575867227,3575867229,2
2,780,15455,3575867227,3575867229,2
2,780,15456,3575867227,3575867235,8
2,780,15457,3575867227,3575867236,9
2,780,15458,3575867227,3575867236,9
2,780,15459,3575867227,3575867237,10
2,780,15460,3575867227,3575867238,11
2,780,15461,3575867227,3575867239,12
2,780,15462,3575867227,3575867240,13
2,780,15463,3575867227,3575867240,13
2,780,15464,3575867227,3575867242,15
2,780,15465,3575867227,3575867243,16
2,780,15466,3575867227,3575867244,17
2,780,15467,3575867227,3575867246,19
2,780,15468,3575867227,3575867248,21
2,780,15469,3575867227,3575867248,21
2,780,15470,3575867227,3575867249,22
2,780,15471,3575867227,3575867252,25
2,780,15472,3575867227,3575867253,26
2,780,15473,3575867227,3575867255,28
2,780,15474,3575867227,3575867255,28
2,780,15475,3575867227,3575867255,28
2,780,15476,3575867227,3575867256,29
2,780,15477,3575867227,3575867256,29
2,780,15478,3575867227,3575867259,32
2,780,15479,3575867227,3575867259,32
2,780,15480,3575867227,3575867260,33
2,780,15481,3575867227,3575867263,36
2,780,15482,3575867227,3575867264,37
2,780,15483,3575867227,3575867267,40
2,780,15484,3575867227,3575867269,42
2,780,15485,3575867227,3575867269,42
2,780,15486,3575867227,3575867273,46
2,780,15487,3575867227,3575867274,47
2,780,15488,3575867227,3575867275,48
2,780,15489,3575867227,3575867276,49
2,780,15490,3575867227,3575867277,50
2,781,15491,3575867284,3575867284,0
2,781,15492,3575867284,3575867284,0
2,781,15493,3575867284,3575867284,0
2,781,15494,3575867284,3575867284,0
2,781,15495,3575867284,3575867284,0
2,781,15496,3575867284,3575867284,0
2,781,15497,3575867284,3575867284,0
2,781,15498,3575867284,3575867284,0
2,781,15499,3575867284,3575867284,0
2,781,15500,3575867284,3575867285,1
2,781,15501,3575867284,3575867286,2
2,781,15502,3575867284,3575867286,2
2,781,15503,3575867284,3575867286,2
2,781,15504,3575867284,3575867286,2
2,781,15505,3575867284,3575867289,5
2,781,15506,3575867284,3575867290,6
2,781,15507,3575867284,3575867290,6
2,781,15508,3575867284,3575867291,7
2,781,15509,3575867284,3575867294,10
2,781,15510,3575867284,3575867295,11
2,781,15511,3575867284,3575867295,11
2,781,15512,3575867284,3575867298,14
2,781,15513,3575867284,3575867298,14
2,781,15514,3575867284,3575867299,15
2,781,15515,3575867284,3575867300,16
2,781,15516,3575867284,3575867300,16
2,781,15517,3575867284,3575867301,17
2,781,15518,3575867284,3575867301,17
2,781,15519,3575867284,3575867302,18
2,781,15520,3575867284,3575867303,19
2,781,15521,3575867284,3575867303,19
2,781,15522,3575867284,3575867303,19
2,781,15523,3575867284,3575867304,20
2,781,15524,3575867284,3575867306,22
2,781,15525,3575867284,3575867306,22
2,781,15526,3575867284,3575867307,23
2,781,15527,3575867284,3575867308,24
2,781,15528,3575867284,3575867310,26
2,781,15529,3575867284,3575867311,27
2,781,15530,3575867284,3575867311,27
2,781,15531,3575867284,3575867316,32
2,781,15532,3575867284,3575867316,32
2,781,15533,3575867284,3575867317,33
2,781,15534,3575867284,3575867318,34
2,781,15535,3575867284,3575867319,35
2,781,15536,3575867284,3575867320,36
2,781,15537,3575867284,3575867320,36
2,781,15538,3575867284,3575867320,36
2,781,15539,3575867284,3575867321,37
2,781,15540,3575867284,3575867323,39
2,781,15541,3575867284,3575867323,39
2,781,15542,3575867284,3575867324,40
2,781,15543,3575867284,3575867326,42
2,781,15544,3575867284,3575867327,43
2,781,15545,3575867284,3575867329,45
2,781,15546,3575867284,3575867330,46
2,781,15547,3575867284,3575867331,47
2,781,15548,3575867284,3575867331,47
2,781,15549,3575867284,3575867332,48
2,781,15550,3575867284,3575867333,49
2,782,15551,3575867341,3575867341,0
2,782,15552,3575867341,3575867341,0
2,782,15553,3575867341,3575867341,0
2,782,15554,3575867341,3575867341,0
2,782,15555,3575867341,3575867341,0
2,782,15556,3575867341,3575867341,0
2,782,15557,3575867341,3575867341,0
2,782,15558,3575867341,3575867341,0
2,782,15559,3575867341,3575867342,1
2,782,15560,3575867341,3575867344,3
2,782,15561,3575867341,3575867345,4
2,782,15562,3575867341,3575867346,5
2,782,15563,3575867341,3575867346,5
2,782,15564,3575867341,3575867346,5
2,782,15565,3575867341,3575867347,6
2,782,15566,3575867341,3575867347,6
2,782,15567,3575867341,3575867348,7
2,782,15568,3575867341,3575867348,7
2,782,15569,3575867341,3575867349,8
2,782,15570,3575867341,3575867350,9
2,782,15571,3575867341,3575867352,11
2,782,15572,3575867341,3575867352,11
2,782,15573,3575867341,3575867353,12
2,782,15574,3575867341,3575867355,14
2,782,15575,3575867341,3575867355,14
2,782,15576,3575867341,3575867357,16
2,782,15577,3575867341,3575867359,18
2,782,15578,3575867341,3575867359,18
2,782,15579,3575867341,3575867360,19
2,782,15580,3575867341,3575867365,24
2,782,15581,3575867341,3575867366,25
2,782,15582,3575867341,3575867368,27
2,782,15583,3575867341,3575867368,27
2,782,15584,3575867341,3575867370,29
2,782,15585,3575867341,3575867373,32
2,782,15586,3575867341,3575867374,33
2,782,15587,3575867341,3575867374,33
2,782,15588,3575867341,3575867376,35
2,782,15589,3575867341,3575867376,35
2,782,15590,3575867341,3575867378,37
2,782,15591,3575867341,3575867379,38
2,782,15592,3575867341,3575867382,41
2,782,15593,3575867341,3575867383,42
2,782,15594,3575867341,3575867383,42
2,782,15595,3575867341,3575867384,43
2,782,15596,3575867341,3575867384,43
2,782,15597,3575867341,3575867385,44
2,782,15598,3575867341,3575867385,44
2,782,15599,3575867341,3575867385,44
2,782,15600,3575867341,3575867388,47
2,782,15601,3575867341,3575867389,48
2,782,15602,3575867341,3575867391,50
2,783,15603,3575867400,3575867400,0
2,783,15604,3575867400,3575867400,0
2,783,15605,3575867400,3575867400,0
2,783,15606,3575867400,3575867400,0
2,783,15607,3575867400,3575867400,0
2,783,15608,3575867400,3575867400,0
2,783,15609,3575867400,3575867400,0
2,783,15610,3575867400,3575867400,0
2,783,15611,3575867400,3575867400,0
2,783,15612,3575867400,3575867400,0
2,783,15613,3575867400,3575867401,1
2,783,15614,3575867400,3575867404,4
2,783,15615,3575867400,3575867404,4
2,783,15616,3575867400,3575867404,4
2,783,15617,3575867400,3575867404,4
2,783,15618,3575867400,3575867406,6
2,783,15619,3575867400,3575867407,7
2,783,15620,3575867400,3575867408,8
2,783,15621,3575867400,3575867411,11
2,783,15622,3575867400,3575867412,12
2,783,15623,3575867400,3575867414,14
2,783,15624,3575867400,3575867415,15
2,783,15625,3575867400,3575867421,21
2,783,15626,3575867400,3575867422,22
2,783,15627,3575867400,3575867424,24
2,783,15628,3575867400,3575867424,24
2,783,15629,3575867400,3575867424,24
2,783,15630,3575867400,3575867424,24
2,783,15631,3575867400,3575867425,25
2,783,15632,3575867400,3575867426,26
2,783,15633,3575867400,3575867429,29
2,783,15634,3575867400,3575867429,29
2,783,15635,3575867400,3575867429,29
2,783,15636,3575867400,3575867429,29
2,783,15637,3575867400,3575867435,35
2,783,15638,3575867400,3575867436,36
2,783,15639,3575867400,3575867436,36
2,783,15640,3575867400,3575867437,37
2,783,15641,3575867400,3575867438,38
2,783,15642,3575867400,3575867439,39
2,783,15643,3575867400,3575867440,40
2,783,15644,3575867400,3575867443,43
2,783,15645,3575867400,3575867443,43
2,783,15646,3575867400,3575867443,43
2,783,15647,3575867400,3575867444,44
2,783,15648,3575867400,3575867445,45
2,783,15649,3575867400,3575867446,46
2,783,15650,3575867400,3575867448,48
2,783,15651,3575867400,3575867449,49
2,784,15652,3575867458,3575867458,0
2,784,15653,3575867458,3575867458,0
2,784,15654,3575867458,3575867458,0
2,784,15655,3575867458,3575867458,0
2,784,15656,3575867458,3575867458,0
2,784,15657,3575867458,3575867458,0
2,784,15658,3575867458,3575867458,0
2,784,15659,3575867458,3575867458,0
2,784,15660,3575867458,3575867459,1
2,784,15661,3575867458,3575867460,2
2,784,15662,3575867458,3575867463,5
2,784,15663,3575867458,3575867464,6
2,784,15664,3575867458,3575867469,11
2,784,15665,3575867458,3575867469,11
2,784,15666,3575867458,3575867469,11
2,784,15667,3575867458,3575867473,15
2,784,15668,3575867458,3575867473,15
2,784,15669,3575867458,3575867474,16
2,784,15670,3575867458,3575867475,17
2,784,15671,3575867458,3575867477,19
2,784,15672,3575867458,3575867477,19
2,784,15673,3575867458,3575867478,20
2,784,15674,3575867458,3575867479,21
2,784,15675,3575867458,3575867479,21
2,784,15676,3575867458,3575867480,22
2,784,15677,3575867458,3575867481,23
2,784,15678,3575867458,3575867481,23
2,784,15679,3575867458,3575867482,24
2,784,15680,3575867458,3575867482,24
2,784,15681,3575867458,3575867482,24
2,784,15682,3575867458,3575867483,25
2,784,15683,3575867458,3575867484,26
2,784,15684,3575867458,3575867485,27
2,784,15685,3575867458,3575867486,28
2,784,15686,3575867458,3575867486,28
2,784,15687,3575867458,3575867487,29
2,784,15688,3575867458,3575867487,29
2,784,15689,3575867458,3575867489,31
2,784,15690,3575867458,3575867490,32
2,784,15691,3575867458,3575867490,32
2,784,15692,3575867458,3575867490,32
2,784,15693,3575867458,3575867491,33
2,784,15694,3575867458,3575867493,35
2,784,15695,3575867458,3575867494,36
2,784,15696,3575867458,3575867495,37
2,784,15697,3575867458,3575867495,37
2,784,15698,3575867458,3575867498,40
2,784,15699,3575867458,3575867498,40
2,784,15700,3575867458,3575867498,40
2,784,15701,3575867458,3575867500,42
2,784,15702,3575867458,3575867501,43
2,784,15703,3575867458,3575867501,43
2,784,15704,3575867458,3575867501,43
2,784,15705,3575867458,3575867502,44
2,784,15706,3575867458,3575867502,44
2,784,15707,3575867458,3575867503,45
2,784,15708,3575867458,3575867503,45
2,784,15709,3575867458,3575867504,46
2,784,15710,3575867458,3575867505,47
2,784,15711,3575867458,3575867506,48
2,784,15712,3575867458,3575867508,50
2,785,15713,3575867515,3575867515,0
2,785,15714,3575867515,3575867515,0
2,785,15715,3575867515,3575867515,0
2,785,15716,3575867515,3575867515,0
2,785,15717,3575867515,3575867515,0
2,785,15718,3575867515,3575867516,1
2,785,15719,3575867515,3575867517,2
2,785,15720,3575867515,3575867517,2
2,785,15721,3575867515,3575867519,4
2,785,15722,3575867515,3575867520,5
2,785,15723,3575867515,3575867521,6
2,785,15724,3575867515,3575867522,7
2,785,15725,3575867515,3575867524,9
2,785,15726,3575867515,3575867525,10
2,785,15727,3575867515,3575867527,12
2,785,15728,3575867515,3575867529,14
2,785,15729,3575867515,3575867531,16
2,785,15730,3575867515,3575867531,16
2,785,15731,3575867515,3575867531,16
2,785,15732,3575867515,3575867532,17
2,785,15733,3575867515,3575867533,18
2,785,15734,3575867515,3575867533,18
2,785,15735,3575867515,3575867533,18
2,785,15736,3575867515,3575867535,20
2,785,15737,3575867515,3575867539,24
2,785,15738,3575867515,3575867540,25
2,785,15739,3575867515,3575867541,26
2,785,15740,3575867515,3575867541,26
2,785,15741,3575867515,3575867543,28
2,785,15742,3575867515,3575867543,28
2,785,15743,3575867515,3575867545,30
2,785,15744,3575867515,3575867545,30
2,785,15745,3575867515,3575867546,31
2,785,15746,3575867515,3575867546,31
2,785,15747,3575867515,3575867546,31
2,785,15748,3575867515,3575867548,33
2,785,15749,3575867515,3575867548,33
2,785,15750,3575867515,3575867549,34
2,785,15751,3575867515,3575867550,35
2,785,15752,3575867515,3575867550,35
2,785,15753,3575867515,3575867552,37
2,785,15754,3575867515,3575867552,37
2,785,15755,3575867515,3575867554,39
2,785,15756,3575867515,3575867556,41
2,785,15757,3575867515,3575867558,43
2,785,15758,3575867515,3575867559,44
2,785,15759,3575867515,3575867560,45
2,786,15760,3575867572,3575867572,0
2,786,15761,3575867572,3575867572,0
2,786,15762,3575867572,3575867572,0
2,786,15763,3575867572,3575867572,0
2,786,15764,3575867572,3575867572,0
2,786,15765,3575867572,3575867572,0
2,786,15766,3575867572,3575867573,1
2,786,15767,3575867572,3575867574,2
2,786,15768,3575867572,3575867575,3
2,786,15769,3575867572,3575867576,4
2,786,15770,3575867572,3575867577,5
2,786,15771,3575867572,3575867578,6
2,786,15772,3575867572,3575867581,9
2,786,15773,3575867572,3575867582,10
2,786,15774,3575867572,3575867582,10
2,786,15775,3575867572,3575867582,10
2,786,15776,3575867572,3575867583,11
2,786,15777,3575867572,3575867584,12
2,786,15778,3575867572,3575867585,13
2,786,15779,3575867572,3575867585,13
2,786,15780,3575867572,3575867585,13
2,786,15781,3575867572,3575867588,16
2,786,15782,3575867572,3575867588,16
2,786,15783,3575867572,3575867590,18
2,786,15784,3575867572,3575867590,18
2,786,15785,3575867572,3575867591,19
2,786,15786,3575867572,3575867592,20
2,786,15787,3575867572,3575867594,22
2,786,15788,3575867572,3575867594,22
2,786,15789,3575867572,3575867595,23
2,786,15790,3575867572,3575867596,24
2,786,15791,3575867572,3575867598,26
2,786,15792,3575867572,3575867598,26
2,786,15793,3575867572,3575867600,28
2,786,15794,3575867572,3575867600,28
2,786,15795,3575867572,3575867603,31
2,786,15796,3575867572,3575867604,32
2,786,15797,3575867572,3575867604,32
2,786,15798,3575867572,3575867604,32
2,786,15799,3575867572,3575867605,33
2,786,15800,3575867572,3575867606,34
2,786,15801,3575867572,3575867608,36
2,786,15802,3575867572,3575867611,39
2,786,15803,3575867572,3575867612,40
2,786,15804,3575867572,3575867612,40
2,786,15805,3575867572,3575867620,48
2,786,15806,3575867572,3575867621,49
2,787,15807,3575867631,3575867631,0
2,787,15808,3575867631,3575867631,0
2,787,15809,3575867631,3575867631,0
2,787,15810,3575867631,3575867631,0
2,787,15811,3575867631,3575867631,0
2,787,15812,3575867631,3575867631,0
2,787,15813,3575867631,3575867631,0
2,787,15814,3575867631,3575867631,0
2,787,15815,3575867631,3575867631,0
2,787,15816,3575867631,3575867631,0
2,787,15817,3575867631,3575867634,3
2,787,15818,3575867631,3575867635,4
2,787,15819,3575867631,3575867637,6
2,787,15820,3575867631,3575867637,6
2,787,15821,3575867631,3575867638,7
2,787,15822,3575867631,3575867639,8
2,787,15823,3575867631,3575867639,8
2,787,15824,3575867631,3575867641,10
2,787,15825,3575867631,3575867643,12
2,787,15826,3575867631,3575867643,12
2,787,15827,3575867631,3575867644,13
2,787,15828,3575867631,3575867644,13
2,787,15829,3575867631,3575867645,14
2,787,15830,3575867631,3575867647,16
2,787,15831,3575867631,3575867649,18
2,787,15832,3575867631,3575867650,19
2,787,15833,3575867631,3575867651,20
2,787,15834,3575867631,3575867652,21
2,787,15835,3575867631,3575867654,23
2,787,15836,3575867631,3575867654,23
2,787,15837,3575867631,3575867655,24
2,787,15838,3575867631,3575867655,24
2,787,15839,3575867631,3575867656,25
2,787,15840,3575867631,3575867656,25
2,787,15841,3575867631,3575867658,27
2,787,15842,3575867631,3575867658,27
2,787,15843,3575867631,3575867660,29
2,787,15844,3575867631,3575867663,32
2,787,15845,3575867631,3575867663,32
2,787,15846,3575867631,3575867668,37
2,787,15847,3575867631,3575867668,37
2,787,15848,3575867631,3575867673,42
2,787,15849,3575867631,3575867674,43
2,787,15850,3575867631,3575867674,43
2,787,15851,3575867631,3575867675,44
2,787,15852,3575867631,3575867676,45
2,787,15853,3575867631,3575867677,46
2,787,15854,3575867631,3575867678,47
2,787,15855,3575867631,3575867680,49
2,787,15856,3575867631,3575867680,49
2,787,15857,3575867631,3575867680,49
2,788,15858,3575867689,3575867689,0
2,788,15859,3575867689,3575867689,0
2,788,15860,3575867689,3575867689,0
2,788,15861,3575867689,3575867689,0
2,788,15862,3575867689,3575867689,0
2,788,15863,3575867689,3575867689,0
2,788,15864,3575867689,3575867689,0
2,788,15865,3575867689,3575867689,0
2,788,15866,3575867689,3575867689,0
2,788,15867,3575867689,3575867689,0
2,788,15868,3575867689,3575867689,0
2,788,15869,3575867689,3575867689,0
2,788,15870,3575867689,3575867689,0
2,788,15871,3575867689,3575867690,1
2,788,15872,3575867689,3575867690,1
2,788,15873,3575867689,3575867691,2
2,788,15874,3575867689,3575867691,2
2,788,15875,3575867689,3575867693,4
2,788,15876,3575867689,3575867694,5
2,788,15877,3575867689,3575867695,6
2,788,15878,3575867689,3575867698,9
2,788,15879,3575867689,3575867699,10
2,788,15880,3575867689,3575867699,10
2,788,15881,3575867689,3575867700,11
2,788,15882,3575867689,3575867701,12
2,788,15883,3575867689,3575867701,12
2,788,15884,3575867689,3575867702,13
2,788,15885,3575867689,3575867702,13
2,788,15886,3575867689,3575867703,14
2,788,15887,3575867689,3575867703,14
2,788,15888,3575867689,3575867704,15
2,788,15889,3575867689,3575867706,17
2,788,15890,3575867689,3575867709,20
2,788,15891,3575867689,3575867709,20
2,788,15892,3575867689,3575867710,21
2,788,15893,3575867689,3575867711,22
2,788,15894,3575867689,3575867712,23
2,788,15895,3575867689,3575867716,27
2,788,15896,3575867689,3575867716,27
2,788,15897,3575867689,3575867718,29
2,788,15898,3575867689,3575867719,30
2,788,15899,3575867689,3575867719,30
2,788,15900,3575867689,3575867720,31
2,788,15901,3575867689,3575867721,32
2,788,15902,3575867689,3575867722,33
2,788,15903,3575867689,3575867724,35
2,788,15904,3575867689,3575867725,36
2,788,15905,3575867689,3575867727,38
2,788,15906,3575867689,3575867727,38
2,788,15907,3575867689,3575867731,42
2,788,15908,3575867689,3575867731,42
2,788,15909,3575867689,3575867732,43
2,788,15910,3575867689,3575867733,44
2,788,15911,3575867689,3575867733,44
2,788,15912,3575867689,3575867733,44
2,788,15913,3575867689,3575867736,47
2,789,15914,3575867745,3575867745,0
2,789,15915,3575867745,3575867745,0
2,789,15916,3575867745,3575867745,0
2,789,15917,3575867745,3575867745,0
2,789,15918,3575867745,3575867745,0
2,789,15919,3575867745,3575867745,0
2,789,15920,3575867745,3575867745,0
2,789,15921,3575867745,3575867746,1
2,789,15922,3575867745,3575867746,1
2,789,15923,3575867745,3575867746,1
2,789,15924,3575867745,3575867746,1
2,789,15925,3575867745,3575867748,3
2,789,15926,3575867745,3575867749,4
2,789,15927,3575867745,3575867749,4
2,789,15928,3575867745,3575867749,4
2,789,15929,3575867745,3575867751,6
2,789,15930,3575867745,3575867751,6
2,789,15931,3575867745,3575867752,7
2,789,15932,3575867745,3575867752,7
2,789,15933,3575867745,3575867754,9
2,789,15934,3575867745,3575867757,12
2,789,15935,3575867745,3575867758,13
2,789,15936,3575867745,3575867759,14
2,789,15937,3575867745,3575867760,15
2,789,15938,3575867745,3575867762,17
2,789,15939,3575867745,3575867763,18
2,789,15940,3575867745,3575867768,23
2,789,15941,3575867745,3575867768,23
2,789,15942,3575867745,3575867769,24
2,789,15943,3575867745,3575867771,26
2,789,15944,3575867745,3575867772,27
2,789,15945,3575867745,3575867772,27
2,789,15946,3575867745,3575867773,28
2,789,15947,3575867745,3575867774,29
2,789,15948,3575867745,3575867775,30
2,789,15949,3575867745,3575867776,31
2,789,15950,3575867745,3575867777,32
2,789,15951,3575867745,3575867778,33
2,789,15952,3575867745,3575867781,36
2,789,15953,3575867745,3575867782,37
2,789,15954,3575867745,3575867783,38
2,789,15955,3575867745,3575867784,39
2,789,15956,3575867745,3575867784,39
2,789,15957,3575867745,3575867784,39
2,789,15958,3575867745,3575867785,40
2,789,15959,3575867745,3575867785,40
2,789,15960,3575867745,3575867787,42
2,789,15961,3575867745,3575867788,43
2,789,15962,3575867745,3575867789,44
2,789,15963,3575867745,3575867790,45
2,789,15964,3575867745,3575867790,45
2,789,15965,3575867745,3575867793,48
2,789,15966,3575867745,3575867794,49
2,790,15967,3575867802,3575867802,0
2,790,15968,3575867802,3575867802,0
2,790,15969,3575867802,3575867802,0
2,790,15970,3575867802,3575867802,0
2,790,15971,3575867802,3575867802,0
2,790,15972,3575867802,3575867802,0
2,790,15973,3575867802,3575867803,1
2,790,15974,3575867802,3575867804,2
2,790,15975,3575867802,3575867804,2
2,790,15976,3575867802,3575867804,2
2,790,15977,3575867802,3575867806,4
2,790,15978,3575867802,3575867806,4
2,790,15979,3575867802,3575867809,7
2,790,15980,3575867802,3575867811,9
2,790,15981,3575867802,3575867811,9
2,790,15982,3575867802,3575867812,10
2,790,15983,3575867802,3575867812,10
2,790,15984,3575867802,3575867814,12
2,790,15985,3575867802,3575867820,18
2,790,15986,3575867802,3575867821,19
2,790,15987,3575867802,3575867822,20
2,790,15988,3575867802,3575867825,23
2,790,15989,3575867802,3575867825,23
2,790,15990,3575867802,3575867825,23
2,790,15991,3575867802,3575867827,25
2,790,15992,3575867802,3575867828,26
2,790,15993,3575867802,3575867829,27
2,790,15994,3575867802,3575867829,27
2,790,15995,3575867802,3575867830,28
2,790,15996,3575867802,3575867835,33
2,790,15997,3575867802,3575867835,33
2,790,15998,3575867802,3575867837,35
2,790,15999,3575867802,3575867838,36
2,790,16000,3575867802,3575867841,39
2,790,16001,3575867802,3575867842,40
2,790,16002,3575867802,3575867844,42
2,790,16003,3575867802,3575867844,42
2,790,16004,3575867802,3575867844,42
2,790,16005,3575867802,3575867845,43
2,790,16006,3575867802,3575867847,45
2,790,16007,3575867802,3575867849,47
2,790,16008,3575867802,3575867850,48
2,790,16009,3575867802,3575867851,49
2,791,16010,3575867859,3575867859,0
2,791,16011,3575867859,3575867859,0
2,791,16012,3575867859,3575867859,0
2,791,16013,3575867859,3575867859,0
2,791,16014,3575867859,3575867859,0
2,791,16015,3575867859,3575867859,0
2,791,16016,3575867859,3575867859,0
2,791,16017,3575867859,3575867860,1
2,791,16018,3575867859,3575867863,4
2,791,16019,3575867859,3575867863,4
2,791,16020,3575867859,3575867863,4
2,791,16021,3575867859,3575867868,9
2,791,16022,3575867859,3575867868,9
2,791,16023,3575867859,3575867868,9
2,791,16024,3575867859,3575867873,14
2,791,16025,3575867859,3575867874,15
2,791,16026,3575867859,3575867875,16
2,791,16027,3575867859,3575867875,16
2,791,16028,3575867859,3575867876,17
2,791,16029,3575867859,3575867877,18
2,791,16030,3575867859,3575867878,19
2,791,16031,3575867859,3575867878,19
2,791,16032,3575867859,3575867879,20
2,791,16033,3575867859,3575867881,22
2,791,16034,3575867859,3575867881,22
2,791,16035,3575867859,3575867881,22
2,791,16036,3575867859,3575867882,23
2,791,16037,3575867859,3575867882,23
2,791,16038,3575867859,3575867883,24
2,791,16039,3575867859,3575867883,24
2,791,16040,3575867859,3575867884,25
2,791,16041,3575867859,3575867884,25
2,791,16042,3575867859,3575867885,26
2,791,16043,3575867859,3575867886,27
2,791,16044,3575867859,3575867888,29
2,791,16045,3575867859,3575867888,29
2,791,16046,3575867859,3575867889,30
2,791,16047,3575867859,3575867890,31
2,791,16048,3575867859,3575867890,31
2,791,16049,3575867859,3575867891,32
2,791,16050,3575867859,3575867892,33
2,791,16051,3575867859,3575867893,34
2,791,16052,3575867859,3575867894,35
2,791,16053,3575867859,3575867895,36
2,791,16054,3575867859,3575867898,39
2,791,16055,3575867859,3575867898,39
2,791,16056,3575867859,3575867899,40
2,791,16057,3575867859,3575867900,41
2,791,16058,3575867859,3575867901,42
2,791,16059,3575867859,3575867901,42
2,791,16060,3575867859,3575867902,43
2,791,16061,3575867859,3575867903,44
2,791,16062,3575867859,3575867903,44
2,791,16063,3575867859,3575867903,44
2,791,16064,3575867859,3575867905,46
2,791,16065,3575867859,3575867906,47
2,791,16066,3575867859,3575867906,47
2,791,16067,3575867859,3575867908,49
2,791,16068,3575867859,3575867908,49
2,792,16069,3575867916,3575867916,0
2,792,16070,3575867916,3575867916,0
2,792,16071,3575867916,3575867916,0
2,792,16072,3575867916,3575867917,1
2,792,16073,3575867916,3575867917,1
2,792,16074,3575867916,3575867918,2
2,792,16075,3575867916,3575867919,3
2,792,16076,3575867916,3575867919,3
2,792,16077,3575867916,3575867921,5
2,792,16078,3575867916,3575867921,5
2,792,16079,3575867916,3575867922,6
2,792,16080,3575867916,3575867923,7
2,792,16081,3575867916,3575867924,8
2,792,16082,3575867916,3575867925,9
2,792,16083,3575867916,3575867927,11
2,792,16084,3575867916,3575867927,11
2,792,16085,3575867916,3575867928,12
2,792,16086,3575867916,3575867928,12
2,792,16087,3575867916,3575867930,14
2,792,16088,3575867916,3575867931,15
2,792,16089,3575867916,3575867931,15
2,792,16090,3575867916,3575867933,17
2,792,16091,3575867916,3575867933,17
2,792,16092,3575867916,3575867933,17
2,792,16093,3575867916,3575867935,19
2,792,16094,3575867916,3575867936,20
2,792,16095,3575867916,3575867939,23
2,792,16096,3575867916,3575867941,25
2,792,16097,3575867916,3575867941,25
2,792,16098,3575867916,3575867944,28
2,792,16099,3575867916,3575867944,28
2,792,16100,3575867916,3575867944,28
2,792,16101,3575867916,3575867945,29
2,792,16102,3575867916,3575867946,30
2,792,16103,3575867916,3575867946,30
2,792,16104,3575867916,3575867946,30
2,792,16105,3575867916,3575867948,32
2,792,16106,3575867916,3575867949,33
2,792,16107,3575867916,3575867949,33
2,792,16108,3575867916,3575867949,33
2,792,16109,3575867916,3575867951,35
2,792,16110,3575867916,3575867951,35
2,792,16111,3575867916,3575867952,36
2,792,16112,3575867916,3575867953,37
2,792,16113,3575867916,3575867953,37
2,792,16114,3575867916,3575867954,38
2,792,16115,3575867916,3575867957,41
2,792,16116,3575867916,3575867957,41
2,792,16117,3575867916,3575867959,43
2,792,16118,3575867916,3575867961,45
2,792,16119,3575867916,3575867962,46
2,792,16120,3575867916,3575867964,48
2,793,16121,3575867976,3575867976,0
2,793,16122,3575867976,3575867976,0
2,793,16123,3575867976,3575867976,0
2,793,16124,3575867976,3575867976,0
2,793,16125,3575867976,3575867976,0
2,793,16126,3575867976,3575867976,0
2,793,16127,3575867976,3575867976,0
2,793,16128,3575867976,3575867976,0
2,793,16129,3575867976,3575867976,0
2,793,16130,3575867976,3575867976,0
2,793,16131,3575867976,3575867976,0
2,793,16132,3575867976,3575867977,1
2,793,16133,3575867976,3575867981,5
2,793,16134,3575867976,3575867982,6
2,793,16135,3575867976,3575867983,7
2,793,16136,3575867976,3575867984,8
2,793,16137,3575867976,3575867984,8
2,793,16138,3575867976,3575867984,8
2,793,16139,3575867976,3575867985,9
2,793,16140,3575867976,3575867985,9
2,793,16141,3575867976,3575867987,11
2,793,16142,3575867976,3575867988,12
2,793,16143,3575867976,3575867990,14
2,793,16144,3575867976,3575867990,14
2,793,16145,3575867976,3575867992,16
2,793,16146,3575867976,3575867994,18
2,793,16147,3575867976,3575867994,18
2,793,16148,3575867976,3575867996,20
2,793,16149,3575867976,3575867998,22
2,793,16150,3575867976,3575867999,23
2,793,16151,3575867976,3575867999,23
2,793,16152,3575867976,3575868003,27
2,793,16153,3575867976,3575868003,27
2,793,16154,3575867976,3575868003,27
2,793,16155,3575867976,3575868004,28
2,793,16156,3575867976,3575868006,30
2,793,16157,3575867976,3575868007,31
2,793,16158,3575867976,3575868009,33
2,793,16159,3575867976,3575868011,35
2,793,16160,3575867976,3575868011,35
2,793,16161,3575867976,3575868013,37
2,793,16162,3575867976,3575868013,37
2,793,16163,3575867976,3575868014,38
2,793,16164,3575867976,3575868020,44
2,793,16165,3575867976,3575868022,46
2,793,16166,3575867976,3575868023,47
2,793,16167,3575867976,3575868025,49
2,793,16168,3575867976,3575868025,49
2,794,16169,3575868034,3575868034,0
2,794,16170,3575868034,3575868034,0
2,794,16171,3575868034,3575868034,0
2,794,16172,3575868034,3575868034,0
2,794,16173,3575868034,3575868034,0
2,794,16174,3575868034,3575868034,0
2,794,16175,3575868034,3575868035,1
2,794,16176,3575868034,3575868035,1
2,794,16177,3575868034,3575868036,2
2,794,16178,3575868034,3575868036,2
2,794,16179,3575868034,3575868037,3
2,794,16180,3575868034,3575868039,5
2,794,16181,3575868034,3575868040,6
2,794,16182,3575868034,3575868042,8
2,794,16183,3575868034,3575868043,9
2,794,16184,3575868034,3575868044,10
2,794,16185,3575868034,3575868045,11
2,794,16186,3575868034,3575868045,11
2,794,16187,3575868034,3575868047,13
2,794,16188,3575868034,3575868048,14
2,794,16189,3575868034,3575868050,16
2,794,16190,3575868034,3575868051,17
2,794,16191,3575868034,3575868052,18
2,794,16192,3575868034,3575868054,20
2,794,16193,3575868034,3575868056,22
2,794,16194,3575868034,3575868056,22
2,794,16195,3575868034,3575868056,22
2,794,16196,3575868034,3575868056,22
2,794,16197,3575868034,3575868058,24
2,794,16198,3575868034,3575868059,25
2,794,16199,3575868034,3575868060,26
2,794,16200,3575868034,3575868063,29
2,794,16201,3575868034,3575868064,30
2,794,16202,3575868034,3575868064,30
2,794,16203,3575868034,3575868068,34
2,794,16204,3575868034,3575868073,39
2,794,16205,3575868034,3575868074,40
2,794,16206,3575868034,3575868075,41
2,794,16207,3575868034,3575868075,41
2,794,16208,3575868034,3575868077,43
2,794,16209,3575868034,3575868077,43
2,794,16210,3575868034,3575868078,44
2,794,16211,3575868034,3575868078,44
2,794,16212,3575868034,3575868079,45
2,794,16213,3575868034,3575868081,47
2,794,16214,3575868034,3575868081,47
2,794,16215,3575868034,3575868082,48
2,794,16216,3575868034,3575868082,48
2,794,16217,3575868034,3575868082,48
2,794,16218,3575868034,3575868083,49
2,794,16219,3575868034,3575868083,49
2,794,16220,3575868034,3575868084,50
2,795,16221,3575868094,3575868094,0
2,795,16222,3575868094,3575868094,0
2,795,16223,3575868094,3575868094,0
2,795,16224,3575868094,3575868094,0
2,795,16225,3575868094,3575868094,0
2,795,16226,3575868094,3575868094,0
2,795,16227,3575868094,3575868094,0
2,795,16228,3575868094,3575868094,0
2,795,16229,3575868094,3575868094,0
2,795,16230,3575868094,3575868094,0
2,795,16231,3575868094,3575868095,1
2,795,16232,3575868094,3575868096,2
2,795,16233,3575868094,3575868099,5
2,795,16234,3575868094,3575868100,6
2,795,16235,3575868094,3575868100,6
2,795,16236,3575868094,3575868101,7
2,795,16237,3575868094,3575868101,7
2,795,16238,3575868094,3575868102,8
2,795,16239,3575868094,3575868102,8
2,795,16240,3575868094,3575868103,9
2,795,16241,3575868094,3575868103,9
2,795,16242,3575868094,3575868104,10
2,795,16243,3575868094,3575868105,11
2,795,16244,3575868094,3575868106,12
2,795,16245,3575868094,3575868109,15
2,795,16246,3575868094,3575868109,15
2,795,16247,3575868094,3575868109,15
2,795,16248,3575868094,3575868111,17
2,795,16249,3575868094,3575868115,21
2,795,16250,3575868094,3575868116,22
2,795,16251,3575868094,3575868116,22
2,795,16252,3575868094,3575868118,24
2,795,16253,3575868094,3575868118,24
2,795,16254,3575868094,3575868119,25
2,795,16255,3575868094,3575868120,26
2,795,16256,3575868094,3575868121,27
2,795,16257,3575868094,3575868121,27
2,795,16258,3575868094,3575868121,27
2,795,16259,3575868094,3575868122,28
2,795,16260,3575868094,3575868123,29
2,795,16261,3575868094,3575868125,31
2,795,16262,3575868094,3575868125,31
2,795,16263,3575868094,3575868127,33
2,795,16264,3575868094,3575868127,33
2,795,16265,3575868094,3575868128,34
2,795,16266,3575868094,3575868130,36
2,795,16267,3575868094,3575868131,37
2,795,16268,3575868094,3575868132,38
2,795,16269,3575868094,3575868132,38
2,795,16270,3575868094,3575868133,39
2,795,16271,3575868094,3575868133,39
2,795,16272,3575868094,3575868134,40
2,795,16273,3575868094,3575868135,41
2,795,16274,3575868094,3575868136,42
2,795,16275,3575868094,3575868141,47
2,795,16276,3575868094,3575868141,47
2,795,16277,3575868094,3575868144,50
2,796,16278,3575868152,3575868152,0
2,796,16279,3575868152,3575868152,0
2,796,16280,3575868152,3575868152,0
2,796,16281,3575868152,3575868152,0
2,796,16282,3575868152,3575868152,0
2,796,16283,3575868152,3575868152,0
2,796,16284,3575868152,3575868152,0
2,796,16285,3575868152,3575868152,0
2,796,16286,3575868152,3575868152,0
2,796,16287,3575868152,3575868152,0
2,796,16288,3575868152,3575868152,0
2,796,16289,3575868152,3575868152,0
2,796,16290,3575868152,3575868152,0
2,796,16291,3575868152,3575868153,1
2,796,16292,3575868152,3575868154,2
2,796,16293,3575868152,3575868155,3
2,796,16294,3575868152,3575868157,5
2,796,16295,3575868152,3575868157,5
2,796,16296,3575868152,3575868161,9
2,796,16297,3575868152,3575868162,10
2,796,16298,3575868152,3575868169,17
2,796,16299,3575868152,3575868169,17
2,796,16300,3575868152,3575868170,18
2,796,16301,3575868152,3575868170,18
2,796,16302,3575868152,3575868170,18
2,796,16303,3575868152,3575868172,20
2,796,16304,3575868152,3575868173,21
2,796,16305,3575868152,3575868174,22
2,796,16306,3575868152,3575868175,23
2,796,16307,3575868152,3575868176,24
2,796,16308,3575868152,3575868176,24
2,796,16309,3575868152,3575868177,25
2,796,16310,3575868152,3575868181,29
2,796,16311,3575868152,3575868183,31
2,796,16312,3575868152,3575868183,31
2,796,16313,3575868152,3575868184,32
2,796,16314,3575868152,3575868184,32
2,796,16315,3575868152,3575868185,33
2,796,16316,3575868152,3575868185,33
2,796,16317,3575868152,3575868185,33
2,796,16318,3575868152,3575868185,33
2,796,16319,3575868152,3575868188,36
2,796,16320,3575868152,3575868188,36
2,796,16321,3575868152,3575868190,38
2,796,16322,3575868152,3575868191,39
2,796,16323,3575868152,3575868193,41
2,796,16324,3575868152,3575868194,42
2,796,16325,3575868152,3575868196,44
2,796,16326,3575868152,3575868198,46
2,796,16327,3575868152,3575868199,47
2,796,16328,3575868152,3575868200,48
2,797,16329,3575868209,3575868209,0
2,797,16330,3575868209,3575868209,0
2,797,16331,3575868209,3575868209,0
2,797,16332,3575868209,3575868209,0
2,797,16333,3575868209,3575868209,0
2,797,16334,3575868209,3575868209,0
2,797,16335,3575868209,3575868209,0
2,797,16336,3575868209,3575868212,3
2,797,16337,3575868209,3575868212,3
2,797,16338,3575868209,3575868212,3
2,797,16339,3575868209,3575868214,5
2,797,16340,3575868209,3575868220,11
2,797,16341,3575868209,3575868222,13
2,797,16342,3575868209,3575868222,13
2,797,16343,3575868209,3575868226,17
2,797,16344,3575868209,3575868226,17
2,797,16345,3575868209,3575868227,18
2,797,16346,3575868209,3575868229,20
2,797,16347,3575868209,3575868230,21
2,797,16348,3575868209,3575868232,23
2,797,16349,3575868209,3575868235,26
2,797,16350,3575868209,3575868235,26
2,797,16351,3575868209,3575868235,26
2,797,16352,3575868209,3575868238,29
2,797,16353,3575868209,3575868239,30
2,797,16354,3575868209,3575868242,33
2,797,16355,3575868209,3575868243,34
2,797,16356,3575868209,3575868244,35
2,797,16357,3575868209,3575868246,37
2,797,16358,3575868209,3575868246,37
2,797,16359,3575868209,3575868247,38
2,797,16360,3575868209,3575868248,39
2,797,16361,3575868209,3575868250,41
2,797,16362,3575868209,3575868251,42
2,797,16363,3575868209,3575868252,43
2,797,16364,3575868209,3575868254,45
2,797,16365,3575868209,3575868255,46
2,797,16366,3575868209,3575868256,47
2,797,16367,3575868209,3575868256,47
2,797,16368,3575868209,3575868256,47
2,797,16369,3575868209,3575868256,47
2,798,16370,3575868266,3575868266,0
2,798,16371,3575868266,3575868266,0
2,798,16372,3575868266,3575868266,0
2,798,16373,3575868266,3575868266,0
2,798,16374,3575868266,3575868266,0
2,798,16375,3575868266,3575868268,2
2,798,16376,3575868266,3575868273,7
2,798,16377,3575868266,3575868274,8
2,798,16378,3575868266,3575868274,8
2,798,16379,3575868266,3575868276,10
2,798,16380,3575868266,3575868277,11
2,798,16381,3575868266,3575868277,11
2,798,16382,3575868266,3575868278,12
2,798,16383,3575868266,3575868279,13
2,798,16384,3575868266,3575868280,14
2,798,16385,3575868266,3575868281,15
2,798,16386,3575868266,3575868282,16
2,798,16387,3575868266,3575868282,16
2,798,16388,3575868266,3575868282,16
2,798,16389,3575868266,3575868283,17
2,798,16390,3575868266,3575868284,18
2,798,16391,3575868266,3575868284,18
2,798,16392,3575868266,3575868284,18
2,798,16393,3575868266,3575868286,20
2,798,16394,3575868266,3575868287,21
2,798,16395,3575868266,3575868287,21
2,798,16396,3575868266,3575868289,23
2,798,16397,3575868266,3575868289,23
2,798,16398,3575868266,3575868290,24
2,798,16399,3575868266,3575868291,25
2,798,16400,3575868266,3575868291,25
2,798,16401,3575868266,3575868292,26
2,798,16402,3575868266,3575868293,27
2,798,16403,3575868266,3575868294,28
2,798,16404,3575868266,3575868296,30
2,798,16405,3575868266,3575868296,30
2,798,16406,3575868266,3575868299,33
2,798,16407,3575868266,3575868299,33
2,798,16408,3575868266,3575868300,34
2,798,16409,3575868266,3575868301,35
2,798,16410,3575868266,3575868301,35
2,798,16411,3575868266,3575868301,35
2,798,16412,3575868266,3575868302,36
2,798,16413,3575868266,3575868302,36
2,798,16414,3575868266,3575868303,37
2,798,16415,3575868266,3575868303,37
2,798,16416,3575868266,3575868304,38
2,798,16417,3575868266,3575868304,38
2,798,16418,3575868266,3575868306,40
2,798,16419,3575868266,3575868306,40
2,798,16420,3575868266,3575868308,42
2,798,16421,3575868266,3575868310,44
2,798,16422,3575868266,3575868310,44
2,798,16423,3575868266,3575868311,45
2,798,16424,3575868266,3575868312,46
2,798,16425,3575868266,3575868316,50
2,799,16426,3575868323,3575868323,0
2,799,16427,3575868323,3575868323,0
2,799,16428,3575868323,3575868323,0
2,799,16429,3575868323,3575868323,0
2,799,16430,3575868323,3575868323,0
2,799,16431,3575868323,3575868323,0
2,799,16432,3575868323,3575868323,0
2,799,16433,3575868323,3575868323,0
2,799,16434,3575868323,3575868323,0
2,799,16435,3575868323,3575868323,0
2,799,16436,3575868323,3575868323,0
2,799,16437,3575868323,3575868324,1
2,799,16438,3575868323,3575868326,3
2,799,16439,3575868323,3575868327,4
2,799,16440,3575868323,3575868327,4
2,799,16441,3575868323,3575868329,6
2,799,16442,3575868323,3575868331,8
2,799,16443,3575868323,3575868331,8
2,799,16444,3575868323,3575868332,9
2,799,16445,3575868323,3575868334,11
2,799,16446,3575868323,3575868334,11
2,799,16447,3575868323,3575868335,12
2,799,16448,3575868323,3575868335,12
2,799,16449,3575868323,3575868338,15
2,799,16450,3575868323,3575868340,17
2,799,16451,3575868323,3575868341,18
2,799,16452,3575868323,3575868342,19
2,799,16453,3575868323,3575868345,22
2,799,16454,3575868323,3575868345,22
2,799,16455,3575868323,3575868346,23
2,799,16456,3575868323,3575868346,23
2,799,16457,3575868323,3575868347,24
2,799,16458,3575868323,3575868347,24
2,799,16459,3575868323,3575868347,24
2,799,16460,3575868323,3575868348,25
2,799,16461,3575868323,3575868348,25
2,799,16462,3575868323,3575868349,26
2,799,16463,3575868323,3575868350,27
2,799,16464,3575868323,3575868350,27
2,799,16465,3575868323,3575868351,28
2,799,16466,3575868323,3575868351,28
2,799,16467,3575868323,3575868352,29
2,799,16468,3575868323,3575868354,31
2,799,16469,3575868323,3575868354,31
2,799,16470,3575868323,3575868355,32
2,799,16471,3575868323,3575868358,35
2,799,16472,3575868323,3575868360,37
2,799,16473,3575868323,3575868362,39
2,799,16474,3575868323,3575868369,46
2,799,16475,3575868323,3575868369,46
2,799,16476,3575868323,3575868369,46
2,799,16477,3575868323,3575868371,48
2,800,16478,3575868383,3575868383,0
2,800,16479,3575868383,3575868383,0
2,800,16480,3575868383,3575868383,0
2,800,16481,3575868383,3575868383,0
2,800,16482,3575868383,3575868383,0
2,800,16483,3575868383,3575868383,0
2,800,16484,3575868383,3575868383,0
2,800,16485,3575868383,3575868384,1
2,800,16486,3575868383,3575868384,1
2,800,16487,3575868383,3575868385,2
2,800,16488,3575868383,3575868385,2
2,800,16489,3575868383,3575868385,2
2,800,16490,3575868383,3575868385,2
2,800,16491,3575868383,3575868386,3
2,800,16492,3575868383,3575868388,5
2,800,16493,3575868383,3575868388,5
2,800,16494,3575868383,3575868390,7
2,800,16495,3575868383,3575868391,8
2,800,16496,3575868383,3575868393,10
2,800,16497,3575868383,3575868393,10
2,800,16498,3575868383,3575868394,11
2,800,16499,3575868383,3575868396,13
2,800,16500,3575868383,3575868398,15
2,800,16501,3575868383,3575868399,16
2,800,16502,3575868383,3575868399,16
2,800,16503,3575868383,3575868400,17
2,800,16504,3575868383,3575868404,21
2,800,16505,3575868383,3575868404,21
2,800,16506,3575868383,3575868406,23
2,800,16507,3575868383,3575868406,23
2,800,16508,3575868383,3575868407,24
2,800,16509,3575868383,3575868407,24
2,800,16510,3575868383,3575868408,25
2,800,16511,3575868383,3575868411,28
2,800,16512,3575868383,3575868412,29
2,800,16513,3575868383,3575868413,30
2,800,16514,3575868383,3575868413,30
2,800,16515,3575868383,3575868414,31
2,800,16516,3575868383,3575868422,39
2,800,16517,3575868383,3575868422,39
2,800,16518,3575868383,3575868423,40
2,800,16519,3575868383,3575868426,43
2,800,16520,3575868383,3575868426,43
2,800,16521,3575868383,3575868427,44
2,800,16522,3575868383,3575868431,48
2,800,16523,3575868383,3575868432,49
2,801,16524,3575868442,3575868442,0
2,801,16525,3575868442,3575868442,0
2,801,16526,3575868442,3575868442,0
2,801,16527,3575868442,3575868442,0
2,801,16528,3575868442,3575868442,0
2,801,16529,3575868442,3575868442,0
2,801,16530,3575868442,3575868442,0
2,801,16531,3575868442,3575868443,1
2,801,16532,3575868442,3575868445,3
2,801,16533,3575868442,3575868446,4
2,801,16534,3575868442,3575868447,5
2,801,16535,3575868442,3575868447,5
2,801,16536,3575868442,3575868450,8
2,801,16537,3575868442,3575868450,8
2,801,16538,3575868442,3575868453,11
2,801,16539,3575868442,3575868455,13
2,801,16540,3575868442,3575868455,13
2,801,16541,3575868442,3575868456,14
2,801,16542,3575868442,3575868456,14
2,801,16543,3575868442,3575868457,15
2,801,16544,3575868442,3575868459,17
2,801,16545,3575868442,3575868460,18
2,801,16546,3575868442,3575868460,18
2,801,16547,3575868442,3575868463,21
2,801,16548,3575868442,3575868465,23
2,801,16549,3575868442,3575868466,24
2,801,16550,3575868442,3575868468,26
2,801,16551,3575868442,3575868469,27
2,801,16552,3575868442,3575868473,31
2,801,16553,3575868442,3575868475,33
2,801,16554,3575868442,3575868476,34
2,801,16555,3575868442,3575868476,34
2,801,16556,3575868442,3575868477,35
2,801,16557,3575868442,3575868478,36
2,801,16558,3575868442,3575868478,36
2,801,16559,3575868442,3575868479,37
2,801,16560,3575868442,3575868480,38
2,801,16561,3575868442,3575868480,38
2,801,16562,3575868442,3575868481,39
2,801,16563,3575868442,3575868482,40
2,801,16564,3575868442,3575868482,40
2,801,16565,3575868442,3575868482,40
2,801,16566,3575868442,3575868483,41
2,801,16567,3575868442,3575868484,42
2,801,16568,3575868442,3575868484,42
2,801,16569,3575868442,3575868485,43
2,801,16570,3575868442,3575868486,44
2,801,16571,3575868442,3575868487,45
2,801,16572,3575868442,3575868488,46
2,801,16573,3575868442,3575868488,46
2,801,16574,3575868442,3575868490,48
2,801,16575,3575868442,3575868490,48
2,801,16576,3575868442,3575868491,49
2,801,16577,3575868442,3575868491,49
2,802,16578,3575868500,3575868500,0
2,802,16579,3575868500,3575868500,0
2,802,16580,3575868500,3575868500,0
2,802,16581,3575868500,3575868500,0
2,802,16582,3575868500,3575868500,0
2,802,16583,3575868500,3575868500,0
2,802,16584,3575868500,3575868500,0
2,802,16585,3575868500,3575868500,0
2,802,16586,3575868500,3575868501,1
2,802,16587,3575868500,3575868501,1
2,802,16588,3575868500,3575868502,2
2,802,16589,3575868500,3575868502,2
2,802,16590,3575868500,3575868502,2
2,802,16591,3575868500,3575868503,3
2,802,16592,3575868500,3575868503,3
2,802,16593,3575868500,3575868503,3
2,802,16594,3575868500,3575868505,5
2,802,16595,3575868500,3575868507,7
2,802,16596,3575868500,3575868508,8
2,802,16597,3575868500,3575868508,8
2,802,16598,3575868500,3575868511,11
2,802,16599,3575868500,3575868512,12
2,802,16600,3575868500,3575868515,15
2,802,16601,3575868500,3575868515,15
2,802,16602,3575868500,3575868515,15
2,802,16603,3575868500,3575868516,16
2,802,16604,3575868500,3575868518,18
2,802,16605,3575868500,3575868519,19
2,802,16606,3575868500,3575868519,19
2,802,16607,3575868500,3575868520,20
2,802,16608,3575868500,3575868520,20
2,802,16609,3575868500,3575868521,21
2,802,16610,3575868500,3575868523,23
2,802,16611,3575868500,3575868523,23
2,802,16612,3575868500,3575868524,24
2,802,16613,3575868500,3575868525,25
2,802,16614,3575868500,3575868526,26
2,802,16615,3575868500,3575868528,28
2,802,16616,3575868500,3575868528,28
2,802,16617,3575868500,3575868531,31
2,802,16618,3575868500,3575868532,32
2,802,16619,3575868500,3575868533,33
2,802,16620,3575868500,3575868534,34
2,802,16621,3575868500,3575868534,34
2,802,16622,3575868500,3575868534,34
2,802,16623,3575868500,3575868537,37
2,802,16624,3575868500,3575868540,40
2,802,16625,3575868500,3575868540,40
2,802,16626,3575868500,3575868541,41
2,802,16627,3575868500,3575868543,43
2,802,16628,3575868500,3575868544,44
2,802,16629,3575868500,3575868545,45
2,802,16630,3575868500,3575868545,45
2,802,16631,3575868500,3575868545,45
2,802,16632,3575868500,3575868545,45
2,802,16633,3575868500,3575868546,46
2,802,16634,3575868500,3575868547,47
2,802,16635,3575868500,3575868548,48
2,802,16636,3575868500,3575868549,49
2,802,16637,3575868500,3575868549,49
2,802,16638,3575868500,3575868550,50
2,803,16639,3575868559,3575868559,0
2,803,16640,3575868559,3575868559,0
2,803,16641,3575868559,3575868559,0
2,803,16642,3575868559,3575868559,0
2,803,16643,3575868559,3575868559,0
2,803,16644,3575868559,3575868559,0
2,803,16645,3575868559,3575868559,0
2,803,16646,3575868559,3575868560,1
2,803,16647,3575868559,3575868561,2
2,803,16648,3575868559,3575868563,4
2,803,16649,3575868559,3575868568,9
2,803,16650,3575868559,3575868569,10
2,803,16651,3575868559,3575868569,10
2,803,16652,3575868559,3575868570,11
2,803,16653,3575868559,3575868572,13
2,803,16654,3575868559,3575868573,14
2,803,16655,3575868559,3575868574,15
2,803,16656,3575868559,3575868576,17
2,803,16657,3575868559,3575868576,17
2,803,16658,3575868559,3575868577,18
2,803,16659,3575868559,3575868577,18
2,803,16660,3575868559,3575868578,19
2,803,16661,3575868559,3575868581,22
2,803,16662,3575868559,3575868583,24
2,803,16663,3575868559,3575868583,24
2,803,16664,3575868559,3575868584,25
2,803,16665,3575868559,3575868584,25
2,803,16666,3575868559,3575868584,25
2,803,16667,3575868559,3575868584,25
2,803,16668,3575868559,3575868585,26
2,803,16669,3575868559,3575868587,28
2,803,16670,3575868559,3575868588,29
2,803,16671,3575868559,3575868588,29
2,803,16672,3575868559,3575868589,30
2,803,16673,3575868559,3575868590,31
2,803,16674,3575868559,3575868593,34
2,803,16675,3575868559,3575868593,34
2,803,16676,3575868559,3575868595,36
2,803,16677,3575868559,3575868598,39
2,803,16678,3575868559,3575868598,39
2,803,16679,3575868559,3575868599,40
2,803,16680,3575868559,3575868599,40
2,803,16681,3575868559,3575868599,40
2,803,16682,3575868559,3575868603,44
2,803,16683,3575868559,3575868604,45
2,803,16684,3575868559,3575868605,46
2,803,16685,3575868559,3575868605,46
2,803,16686,3575868559,3575868605,46
2,803,16687,3575868559,3575868606,47
2,803,16688,3575868559,3575868607,48
2,804,16689,3575868616,3575868616,0
2,804,16690,3575868616,3575868616,0
2,804,16691,3575868616,3575868616,0
2,804,16692,3575868616,3575868616,0
2,804,16693,3575868616,3575868616,0
2,804,16694,3575868616,3575868620,4
2,804,16695,3575868616,3575868621,5
2,804,16696,3575868616,3575868622,6
2,804,16697,3575868616,3575868624,8
2,804,16698,3575868616,3575868626,10
2,804,16699,3575868616,3575868626,10
2,804,16700,3575868616,3575868626,10
2,804,16701,3575868616,3575868627,11
2,804,16702,3575868616,3575868628,12
2,804,16703,3575868616,3575868628,12
2,804,16704,3575868616,3575868630,14
2,804,16705,3575868616,3575868632,16
2,804,16706,3575868616,3575868634,18
2,804,16707,3575868616,3575868635,19
2,804,16708,3575868616,3575868635,19
2,804,16709,3575868616,3575868637,21
2,804,16710,3575868616,3575868637,21
2,804,16711,3575868616,3575868637,21
2,804,16712,3575868616,3575868639,23
2,804,16713,3575868616,3575868643,27
2,804,16714,3575868616,3575868643,27
2,804,16715,3575868616,3575868644,28
2,804,16716,3575868616,3575868645,29
2,804,16717,3575868616,3575868646,30
2,804,16718,3575868616,3575868647,31
2,804,16719,3575868616,3575868648,32
2,804,16720,3575868616,3575868649,33
2,804,16721,3575868616,3575868651,35
2,804,16722,3575868616,3575868655,39
2,804,16723,3575868616,3575868655,39
2,804,16724,3575868616,3575868655,39
2,804,16725,3575868616,3575868655,39
2,804,16726,3575868616,3575868655,39
2,804,16727,3575868616,3575868656,40
2,804,16728,3575868616,3575868660,44
2,804,16729,3575868616,3575868660,44
2,804,16730,3575868616,3575868663,47
2,804,16731,3575868616,3575868664,48
2,805,16732,3575868675,3575868675,0
2,805,16733,3575868675,3575868675,0
2,805,16734,3575868675,3575868675,0
2,805,16735,3575868675,3575868675,0
2,805,16736,3575868675,3575868675,0
2,805,16737,3575868675,3575868675,0
2,805,16738,3575868675,3575868675,0
2,805,16739,3575868675,3575868676,1
2,805,16740,3575868675,3575868676,1
2,805,16741,3575868675,3575868678,3
2,805,16742,3575868675,3575868678,3
2,805,16743,3575868675,3575868679,4
2,805,16744,3575868675,3575868680,5
2,805,16745,3575868675,3575868680,5
2,805,16746,3575868675,3575868681,6
2,805,16747,3575868675,3575868682,7
2,805,16748,3575868675,3575868682,7
2,805,16749,3575868675,3575868682,7
2,805,16750,3575868675,3575868683,8
2,805,16751,3575868675,3575868683,8
2,805,16752,3575868675,3575868684,9
2,805,16753,3575868675,3575868684,9
2,805,16754,3575868675,3575868684,9
2,805,16755,3575868675,3575868685,10
2,805,16756,3575868675,3575868686,11
2,805,16757,3575868675,3575868687,12
2,805,16758,3575868675,3575868688,13
2,805,16759,3575868675,3575868688,13
2,805,16760,3575868675,3575868690,15
2,805,16761,3575868675,3575868690,15
2,805,16762,3575868675,3575868691,16
2,805,16763,3575868675,3575868692,17
2,805,16764,3575868675,3575868693,18
2,805,16765,3575868675,3575868693,18
2,805,16766,3575868675,3575868694,19
2,805,16767,3575868675,3575868697,22
2,805,16768,3575868675,3575868697,22
2,805,16769,3575868675,3575868698,23
2,805,16770,3575868675,3575868700,25
2,805,16771,3575868675,3575868701,26
2,805,16772,3575868675,3575868701,26
2,805,16773,3575868675,3575868702,27
2,805,16774,3575868675,3575868702,27
2,805,16775,3575868675,3575868703,28
2,805,16776,3575868675,3575868703,28
2,805,16777,3575868675,3575868703,28
2,805,16778,3575868675,3575868705,30
2,805,16779,3575868675,3575868705,30
2,805,16780,3575868675,3575868708,33
2,805,16781,3575868675,3575868708,33
2,805,16782,3575868675,3575868709,34
2,805,16783,3575868675,3575868709,34
2,805,16784,3575868675,3575868711,36
2,805,16785,3575868675,3575868713,38
2,805,16786,3575868675,3575868715,40
2,805,16787,3575868675,3575868715,40
2,805,16788,3575868675,3575868716,41
2,805,16789,3575868675,3575868717,42
2,805,16790,3575868675,3575868717,42
2,805,16791,3575868675,3575868719,44
2,805,16792,3575868675,3575868719,44
2,805,16793,3575868675,3575868720,45
2,805,16794,3575868675,3575868721,46
2,805,16795,3575868675,3575868722,47
2,805,16796,3575868675,3575868723,48
2,806,16797,3575868732,3575868732,0
2,806,16798,3575868732,3575868732,0
2,806,16799,3575868732,3575868732,0
2,806,16800,3575868732,3575868732,0
2,806,16801,3575868732,3575868732,0
2,806,16802,3575868732,3575868732,0
2,806,16803,3575868732,3575868732,0
2,806,16804,3575868732,3575868732,0
2,806,16805,3575868732,3575868732,0
2,806,16806,3575868732,3575868732,0
2,806,16807,3575868732,3575868732,0
2,806,16808,3575868732,3575868733,1
2,806,16809,3575868732,3575868734,2
2,806,16810,3575868732,3575868734,2
2,806,16811,3575868732,3575868737,5
2,806,16812,3575868732,3575868739,7
2,806,16813,3575868732,3575868740,8
2,806,16814,3575868732,3575868741,9
2,806,16815,3575868732,3575868743,11
2,806,16816,3575868732,3575868744,12
2,806,16817,3575868732,3575868745,13
2,806,16818,3575868732,3575868745,13
2,806,16819,3575868732,3575868745,13
2,806,16820,3575868732,3575868745,13
2,806,16821,3575868732,3575868746,14
2,806,16822,3575868732,3575868747,15
2,806,16823,3575868732,3575868749,17
2,806,16824,3575868732,3575868749,17
2,806,16825,3575868732,3575868749,17
2,806,16826,3575868732,3575868751,19
2,806,16827,3575868732,3575868751,19
2,806,16828,3575868732,3575868751,19
2,806,16829,3575868732,3575868753,21
2,806,16830,3575868732,3575868754,22
2,806,16831,3575868732,3575868754,22
2,806,16832,3575868732,3575868757,25
2,806,16833,3575868732,3575868759,27
2,806,16834,3575868732,3575868759,27
2,806,16835,3575868732,3575868764,32
2,806,16836,3575868732,3575868768,36
2,806,16837,3575868732,3575868768,36
2,806,16838,3575868732,3575868769,37
2,806,16839,3575868732,3575868769,37
2,806,16840,3575868732,3575868770,38
2,806,16841,3575868732,3575868773,41
2,806,16842,3575868732,3575868774,42
2,806,16843,3575868732,3575868776,44
2,806,16844,3575868732,3575868777,45
2,806,16845,3575868732,3575868777,45
2,806,16846,3575868732,3575868777,45
2,806,16847,3575868732,3575868778,46
2,806,16848,3575868732,3575868781,49
2,806,16849,3575868732,3575868781,49
2,807,16850,3575868790,3575868790,0
2,807,16851,3575868790,3575868790,0
2,807,16852,3575868790,3575868790,0
2,807,16853,3575868790,3575868790,0
2,807,16854,3575868790,3575868790,0
2,807,16855,3575868790,3575868790,0
2,807,16856,3575868790,3575868790,0
2,807,16857,3575868790,3575868790,0
2,807,16858,3575868790,3575868790,0
2,807,16859,3575868790,3575868790,0
2,807,16860,3575868790,3575868791,1
2,807,16861,3575868790,3575868792,2
2,807,16862,3575868790,3575868793,3
2,807,16863,3575868790,3575868793,3
2,807,16864,3575868790,3575868796,6
2,807,16865,3575868790,3575868798,8
2,807,16866,3575868790,3575868798,8
2,807,16867,3575868790,3575868798,8
2,807,16868,3575868790,3575868799,9
2,807,16869,3575868790,3575868799,9
2,807,16870,3575868790,3575868803,13
2,807,16871,3575868790,3575868805,15
2,807,16872,3575868790,3575868805,15
2,807,16873,3575868790,3575868805,15
2,807,16874,3575868790,3575868806,16
2,807,16875,3575868790,3575868808,18
2,807,16876,3575868790,3575868811,21
2,807,16877,3575868790,3575868811,21
2,807,16878,3575868790,3575868813,23
2,807,16879,3575868790,3575868813,23
2,807,16880,3575868790,3575868821,31
2,807,16881,3575868790,3575868821,31
2,807,16882,3575868790,3575868822,32
2,807,16883,3575868790,3575868824,34
2,807,16884,3575868790,3575868825,35
2,807,16885,3575868790,3575868826,36
2,807,16886,3575868790,3575868827,37
2,807,16887,3575868790,3575868830,40
2,807,16888,3575868790,3575868832,42
2,807,16889,3575868790,3575868835,45
2,807,16890,3575868790,3575868835,45
2,807,16891,3575868790,3575868835,45
2,807,16892,3575868790,3575868837,47
2,807,16893,3575868790,3575868838,48
2,807,16894,3575868790,3575868838,48
2,807,16895,3575868790,3575868839,49
2,808,16896,3575868847,3575868847,0
2,808,16897,3575868847,3575868847,0
2,808,16898,3575868847,3575868847,0
2,808,16899,3575868847,3575868847,0
2,808,16900,3575868847,3575868847,0
2,808,16901,3575868847,3575868847,0
2,808,16902,3575868847,3575868847,0
2,808,16903,3575868847,3575868847,0
2,808,16904,3575868847,3575868849,2
2,808,16905,3575868847,3575868849,2
2,808,16906,3575868847,3575868854,7
2,808,16907,3575868847,3575868855,8
2,808,16908,3575868847,3575868855,8
2,808,16909,3575868847,3575868856,9
2,808,16910,3575868847,3575868856,9
2,808,16911,3575868847,3575868856,9
2,808,16912,3575868847,3575868859,12
2,808,16913,3575868847,3575868860,13
2,808,16914,3575868847,3575868860,13
2,808,16915,3575868847,3575868863,16
2,808,16916,3575868847,3575868863,16
2,808,16917,3575868847,3575868867,20
2,808,16918,3575868847,3575868867,20
2,808,16919,3575868847,3575868867,20
2,808,16920,3575868847,3575868870,23
2,808,16921,3575868847,3575868873,26
2,808,16922,3575868847,3575868875,28
2,808,16923,3575868847,3575868876,29
2,808,16924,3575868847,3575868877,30
2,808,16925,3575868847,3575868877,30
2,808,16926,3575868847,3575868878,31
2,808,16927,3575868847,3575868878,31
2,808,16928,3575868847,3575868878,31
2,808,16929,3575868847,3575868879,32
2,808,16930,3575868847,3575868881,34
2,808,16931,3575868847,3575868881,34
2,808,16932,3575868847,3575868882,35
2,808,16933,3575868847,3575868882,35
2,808,16934,3575868847,3575868882,35
2,808,16935,3575868847,3575868882,35
2,808,16936,3575868847,3575868883,36
2,808,16937,3575868847,3575868884,37
2,808,16938,3575868847,3575868884,37
2,808,16939,3575868847,3575868885,38
2,808,16940,3575868847,3575868885,38
2,808,16941,3575868847,3575868886,39
2,808,16942,3575868847,3575868887,40
2,808,16943,3575868847,3575868888,41
2,808,16944,3575868847,3575868889,42
2,808,16945,3575868847,3575868889,42
2,808,16946,3575868847,3575868890,43
2,808,16947,3575868847,3575868891,44
2,808,16948,3575868847,3575868892,45
2,808,16949,3575868847,3575868893,46
2,808,16950,3575868847,3575868893,46
2,808,16951,3575868847,3575868897,50
2,809,16952,3575868907,3575868907,0
2,809,16953,3575868907,3575868907,0
2,809,16954,3575868907,3575868907,0
2,809,16955,3575868907,3575868907,0
2,809,16956,3575868907,3575868907,0
2,809,16957,3575868907,3575868907,0
2,809,16958,3575868907,3575868907,0
2,809,16959,3575868907,3575868907,0
2,809,16960,3575868907,3575868907,0
2,809,16961,3575868907,3575868907,0
2,809,16962,3575868907,3575868907,0
2,809,16963,3575868907,3575868907,0
2,809,16964,3575868907,3575868907,0
2,809,16965,3575868907,3575868908,1
2,809,16966,3575868907,3575868909,2
2,809,16967,3575868907,3575868910,3
2,809,16968,3575868907,3575868910,3
2,809,16969,3575868907,3575868912,5
2,809,16970,3575868907,3575868915,8
2,809,16971,3575868907,3575868915,8
2,809,16972,3575868907,3575868917,10
2,809,16973,3575868907,3575868917,10
2,809,16974,3575868907,3575868918,11
2,809,16975,3575868907,3575868918,11
2,809,16976,3575868907,3575868919,12
2,809,16977,3575868907,3575868920,13
2,809,16978,3575868907,3575868920,13
2,809,16979,3575868907,3575868921,14
2,809,16980,3575868907,3575868923,16
2,809,16981,3575868907,3575868923,16
2,809,16982,3575868907,3575868924,17
2,809,16983,3575868907,3575868925,18
2,809,16984,3575868907,3575868926,19
2,809,16985,3575868907,3575868927,20
2,809,16986,3575868907,3575868928,21
2,809,16987,3575868907,3575868929,22
2,809,16988,3575868907,3575868930,23
2,809,16989,3575868907,3575868930,23
2,809,16990,3575868907,3575868931,24
2,809,16991,3575868907,3575868931,24
2,809,16992,3575868907,3575868933,26
2,809,16993,3575868907,3575868933,26
2,809,16994,3575868907,3575868933,26
2,809,16995,3575868907,3575868934,27
2,809,16996,3575868907,3575868934,27
2,809,16997,3575868907,3575868937,30
2,809,16998,3575868907,3575868939,32
2,809,16999,3575868907,3575868941,34
2,809,17000,3575868907,3575868941,34
2,809,17001,3575868907,3575868943,36
2,809,17002,3575868907,3575868944,37
2,809,17003,3575868907,3575868945,38
2,809,17004,3575868907,3575868945,38
2,809,17005,3575868907,3575868945,38
2,809,17006,3575868907,3575868945,38
2,809,17007,3575868907,3575868946,39
2,809,17008,3575868907,3575868946,39
2,809,17009,3575868907,3575868946,39
2,809,17010,3575868907,3575868947,40
2,809,17011,3575868907,3575868949,42
2,809,17012,3575868907,3575868949,42
2,809,17013,3575868907,3575868952,45
2,809,17014,3575868907,3575868952,45
2,809,17015,3575868907,3575868953,46
2,809,17016,3575868907,3575868954,47
2,809,17017,3575868907,3575868955,48
2,810,17018,3575868965,3575868965,0
2,810,17019,3575868965,3575868965,0
2,810,17020,3575868965,3575868965,0
2,810,17021,3575868965,3575868965,0
2,810,17022,3575868965,3575868965,0
2,810,17023,3575868965,3575868968,3
2,810,17024,3575868965,3575868968,3
2,810,17025,3575868965,3575868969,4
2,810,17026,3575868965,3575868969,4
2,810,17027,3575868965,3575868970,5
2,810,17028,3575868965,3575868972,7
2,810,17029,3575868965,3575868973,8
2,810,17030,3575868965,3575868974,9
2,810,17031,3575868965,3575868976,11
2,810,17032,3575868965,3575868977,12
2,810,17033,3575868965,3575868977,12
2,810,17034,3575868965,3575868977,12
2,810,17035,3575868965,3575868978,13
2,810,17036,3575868965,3575868981,16
2,810,17037,3575868965,3575868981,16
2,810,17038,3575868965,3575868983,18
2,810,17039,3575868965,3575868984,19
2,810,17040,3575868965,3575868984,19
2,810,17041,3575868965,3575868985,20
2,810,17042,3575868965,3575868986,21
2,810,17043,3575868965,3575868988,23
2,810,17044,3575868965,3575868988,23
2,810,17045,3575868965,3575868988,23
2,810,17046,3575868965,3575868990,25
2,810,17047,3575868965,3575868991,26
2,810,17048,3575868965,3575868994,29
2,810,17049,3575868965,3575868995,30
2,810,17050,3575868965,3575868996,31
2,810,17051,3575868965,3575868998,33
2,810,17052,3575868965,3575868999,34
2,810,17053,3575868965,3575868999,34
2,810,17054,3575868965,3575868999,34
2,810,17055,3575868965,3575869004,39
2,810,17056,3575868965,3575869004,39
2,810,17057,3575868965,3575869005,40
2,810,17058,3575868965,3575869005,40
2,810,17059,3575868965,3575869006,41
2,810,17060,3575868965,3575869007,42
2,810,17061,3575868965,3575869009,44
2,810,17062,3575868965,3575869010,45
2,810,17063,3575868965,3575869011,46
2,810,17064,3575868965,3575869011,46
2,810,17065,3575868965,3575869014,49
2,811,17066,3575869025,3575869025,0
2,811,17067,3575869025,3575869025,0
2,811,17068,3575869025,3575869025,0
2,811,17069,3575869025,3575869025,0
2,811,17070,3575869025,3575869026,1
2,811,17071,3575869025,3575869027,2
2,811,17072,3575869025,3575869027,2
2,811,17073,3575869025,3575869028,3
2,811,17074,3575869025,3575869030,5
2,811,17075,3575869025,3575869030,5
2,811,17076,3575869025,3575869033,8
2,811,17077,3575869025,3575869035,10
2,811,17078,3575869025,3575869035,10
2,811,17079,3575869025,3575869036,11
2,811,17080,3575869025,3575869036,11
2,811,17081,3575869025,3575869037,12
2,811,17082,3575869025,3575869038,13
2,811,17083,3575869025,3575869039,14
2,811,17084,3575869025,3575869041,16
2,811,17085,3575869025,3575869043,18
2,811,17086,3575869025,3575869044,19
2,811,17087,3575869025,3575869044,19
2,811,17088,3575869025,3575869044,19
2,811,17089,3575869025,3575869046,21
2,811,17090,3575869025,3575869046,21
2,811,17091,3575869025,3575869049,24
2,811,17092,3575869025,3575869049,24
2,811,17093,3575869025,3575869051,26
2,811,17094,3575869025,3575869052,27
2,811,17095,3575869025,3575869055,30
2,811,17096,3575869025,3575869055,30
2,811,17097,3575869025,3575869055,30
2,811,17098,3575869025,3575869056,31
2,811,17099,3575869025,3575869056,31
2,811,17100,3575869025,3575869057,32
2,811,17101,3575869025,3575869059,34
2,811,17102,3575869025,3575869060,35
2,811,17103,3575869025,3575869061,36
2,811,17104,3575869025,3575869063,38
2,811,17105,3575869025,3575869063,38
2,811,17106,3575869025,3575869067,42
2,811,17107,3575869025,3575869067,42
2,811,17108,3575869025,3575869067,42
2,811,17109,3575869025,3575869071,46
2,811,17110,3575869025,3575869073,48
2,811,17111,3575869025,3575869075,50
2,812,17112,3575869084,3575869084,0
2,812,17113,3575869084,3575869084,0
2,812,17114,3575869084,3575869084,0
2,812,17115,3575869084,3575869084,0
2,812,17116,3575869084,3575869084,0
2,812,17117,3575869084,3575869084,0
2,812,17118,3575869084,3575869084,0
2,812,17119,3575869084,3575869084,0
2,812,17120,3575869084,3575869084,0
2,812,17121,3575869084,3575869084,0
2,812,17122,3575869084,3575869084,0
2,812,17123,3575869084,3575869084,0
2,812,17124,3575869084,3575869084,0
2,812,17125,3575869084,3575869084,0
2,812,17126,3575869084,3575869085,1
2,812,17127,3575869084,3575869086,2
2,812,17128,3575869084,3575869088,4
2,812,17129,3575869084,3575869088,4
2,812,17130,3575869084,3575869089,5
2,812,17131,3575869084,3575869090,6
2,812,17132,3575869084,3575869090,6
2,812,17133,3575869084,3575869092,8
2,812,17134,3575869084,3575869093,9
2,812,17135,3575869084,3575869093,9
2,812,17136,3575869084,3575869094,10
2,812,17137,3575869084,3575869098,14
2,812,17138,3575869084,3575869098,14
2,812,17139,3575869084,3575869098,14
2,812,17140,3575869084,3575869100,16
2,812,17141,3575869084,3575869101,17
2,812,17142,3575869084,3575869101,17
2,812,17143,3575869084,3575869101,17
2,812,17144,3575869084,3575869101,17
2,812,17145,3575869084,3575869102,18
2,812,17146,3575869084,3575869102,18
2,812,17147,3575869084,3575869103,19
2,812,17148,3575869084,3575869103,19
2,812,17149,3575869084,3575869105,21
2,812,17150,3575869084,3575869106,22
2,812,17151,3575869084,3575869108,24
2,812,17152,3575869084,3575869108,24
2,812,17153,3575869084,3575869110,26
2,812,17154,3575869084,3575869110,26
2,812,17155,3575869084,3575869110,26
2,812,17156,3575869084,3575869112,28
2,812,17157,3575869084,3575869113,29
2,812,17158,3575869084,3575869115,31
2,812,17159,3575869084,3575869116,32
2,812,17160,3575869084,3575869117,33
2,812,17161,3575869084,3575869118,34
2,812,17162,3575869084,3575869118,34
2,812,17163,3575869084,3575869118,34
2,812,17164,3575869084,3575869119,35
2,812,17165,3575869084,3575869119,35
2,812,17166,3575869084,3575869120,36
2,812,17167,3575869084,3575869121,37
2,812,17168,3575869084,3575869121,37
2,812,17169,3575869084,3575869123,39
2,812,17170,3575869084,3575869123,39
2,812,17171,3575869084,3575869124,40
2,812,17172,3575869084,3575869125,41
2,812,17173,3575869084,3575869126,42
2,812,17174,3575869084,3575869129,45
2,812,17175,3575869084,3575869131,47
2,812,17176,3575869084,3575869131,47
2,812,17177,3575869084,3575869132,48
2,812,17178,3575869084,3575869133,49
2,812,17179,3575869084,3575869133,49
2,813,17180,3575869141,3575869141,0
2,813,17181,3575869141,3575869141,0
2,813,17182,3575869141,3575869141,0
2,813,17183,3575869141,3575869141,0
2,813,17184,3575869141,3575869141,0
2,813,17185,3575869141,3575869141,0
2,813,17186,3575869141,3575869142,1
2,813,17187,3575869141,3575869143,2
2,813,17188,3575869141,3575869144,3
2,813,17189,3575869141,3575869145,4
2,813,17190,3575869141,3575869145,4
2,813,17191,3575869141,3575869145,4
2,813,17192,3575869141,3575869146,5
2,813,17193,3575869141,3575869146,5
2,813,17194,3575869141,3575869147,6
2,813,17195,3575869141,3575869148,7
2,813,17196,3575869141,3575869149,8
2,813,17197,3575869141,3575869151,10
2,813,17198,3575869141,3575869152,11
2,813,17199,3575869141,3575869154,13
2,813,17200,3575869141,3575869156,15
2,813,17201,3575869141,3575869158,17
2,813,17202,3575869141,3575869159,18
2,813,17203,3575869141,3575869160,19
2,813,17204,3575869141,3575869161,20
2,813,17205,3575869141,3575869161,20
2,813,17206,3575869141,3575869164,23
2,813,17207,3575869141,3575869168,27
2,813,17208,3575869141,3575869169,28
2,813,17209,3575869141,3575869169,28
2,813,17210,3575869141,3575869169,28
2,813,17211,3575869141,3575869169,28
2,813,17212,3575869141,3575869174,33
2,813,17213,3575869141,3575869177,36
2,813,17214,3575869141,3575869177,36
2,813,17215,3575869141,3575869177,36
2,813,17216,3575869141,3575869178,37
2,813,17217,3575869141,3575869181,40
2,813,17218,3575869141,3575869182,41
2,813,17219,3575869141,3575869183,42
2,813,17220,3575869141,3575869183,42
2,813,17221,3575869141,3575869184,43
2,813,17222,3575869141,3575869185,44
2,813,17223,3575869141,3575869185,44
2,813,17224,3575869141,3575869185,44
2,813,17225,3575869141,3575869187,46
2,813,17226,3575869141,3575869188,47
2,813,17227,3575869141,3575869188,47
2,813,17228,3575869141,3575869190,49
2,814,17229,3575869200,3575869200,0
2,814,17230,3575869200,3575869200,0
2,814,17231,3575869200,3575869200,0
2,814,17232,3575869200,3575869200,0
2,814,17233,3575869200,3575869200,0
2,814,17234,3575869200,3575869200,0
2,814,17235,3575869200,3575869200,0
2,814,17236,3575869200,3575869200,0
2,814,17237,3575869200,3575869200,0
2,814,17238,3575869200,3575869200,0
2,814,17239,3575869200,3575869200,0
2,814,17240,3575869200,3575869205,5
2,814,17241,3575869200,3575869205,5
2,814,17242,3575869200,3575869205,5
2,814,17243,3575869200,3575869206,6
2,814,17244,3575869200,3575869207,7
2,814,17245,3575869200,3575869207,7
2,814,17246,3575869200,3575869209,9
2,814,17247,3575869200,3575869210,10
2,814,17248,3575869200,3575869211,11
2,814,17249,3575869200,3575869211,11
2,814,17250,3575869200,3575869213,13
2,814,17251,3575869200,3575869214,14
2,814,17252,3575869200,3575869221,21
2,814,17253,3575869200,3575869222,22
2,814,17254,3575869200,3575869226,26
2,814,17255,3575869200,3575869226,26
2,814,17256,3575869200,3575869227,27
2,814,17257,3575869200,3575869227,27
2,814,17258,3575869200,3575869228,28
2,814,17259,3575869200,3575869230,30
2,814,17260,3575869200,3575869234,34
2,814,17261,3575869200,3575869235,35
2,814,17262,3575869200,3575869235,35
2,814,17263,3575869200,3575869235,35
2,814,17264,3575869200,3575869237,37
2,814,17265,3575869200,3575869237,37
2,814,17266,3575869200,3575869238,38
2,814,17267,3575869200,3575869238,38
2,814,17268,3575869200,3575869242,42
2,814,17269,3575869200,3575869243,43
2,814,17270,3575869200,3575869244,44
2,814,17271,3575869200,3575869244,44
2,814,17272,3575869200,3575869244,44
2,814,17273,3575869200,3575869246,46
2,814,17274,3575869200,3575869246,46
2,814,17275,3575869200,3575869249,49
2,814,17276,3575869200,3575869250,50
2,815,17277,3575869259,3575869259,0
2,815,17278,3575869259,3575869259,0
2,815,17279,3575869259,3575869259,0
2,815,17280,3575869259,3575869259,0
2,815,17281,3575869259,3575869259,0
2,815,17282,3575869259,3575869259,0
2,815,17283,3575869259,3575869259,0
2,815,17284,3575869259,3575869259,0
2,815,17285,3575869259,3575869259,0
2,815,17286,3575869259,3575869262,3
2,815,17287,3575869259,3575869263,4
2,815,17288,3575869259,3575869264,5
2,815,17289,3575869259,3575869267,8
2,815,17290,3575869259,3575869267,8
2,815,17291,3575869259,3575869268,9
2,815,17292,3575869259,3575869273,14
2,815,17293,3575869259,3575869275,16
2,815,17294,3575869259,3575869276,17
2,815,17295,3575869259,3575869277,18
2,815,17296,3575869259,3575869277,18
2,815,17297,3575869259,3575869278,19
2,815,17298,3575869259,3575869278,19
2,815,17299,3575869259,3575869278,19
2,815,17300,3575869259,3575869280,21
2,815,17301,3575869259,3575869281,22
2,815,17302,3575869259,3575869282,23
2,815,17303,3575869259,3575869282,23
2,815,17304,3575869259,3575869282,23
2,815,17305,3575869259,3575869282,23
2,815,17306,3575869259,3575869284,25
2,815,17307,3575869259,3575869285,26
2,815,17308,3575869259,3575869285,26
2,815,17309,3575869259,3575869285,26
2,815,17310,3575869259,3575869287,28
2,815,17311,3575869259,3575869288,29
2,815,17312,3575869259,3575869288,29
2,815,17313,3575869259,3575869290,31
2,815,17314,3575869259,3575869290,31
2,815,17315,3575869259,3575869293,34
2,815,17316,3575869259,3575869293,34
2,815,17317,3575869259,3575869293,34
2,815,17318,3575869259,3575869293,34
2,815,17319,3575869259,3575869297,38
2,815,17320,3575869259,3575869298,39
2,815,17321,3575869259,3575869299,40
2,815,17322,3575869259,3575869300,41
2,815,17323,3575869259,3575869300,41
2,815,17324,3575869259,3575869301,42
2,815,17325,3575869259,3575869302,43
2,815,17326,3575869259,3575869302,43
2,815,17327,3575869259,3575869302,43
2,815,17328,3575869259,3575869302,43
2,815,17329,3575869259,3575869303,44
2,815,17330,3575869259,3575869303,44
2,815,17331,3575869259,3575869304,45
2,815,17332,3575869259,3575869304,45
2,815,17333,3575869259,3575869306,47
2,815,17334,3575869259,3575869306,47
2,815,17335,3575869259,3575869308,49
2,815,17336,3575869259,3575869308,49
2,816,17337,3575869317,3575869317,0
2,816,17338,3575869317,3575869317,0
2,816,17339,3575869317,3575869317,0
2,816,17340,3575869317,3575869317,0
2,816,17341,3575869317,3575869317,0
2,816,17342,3575869317,3575869317,0
2,816,17343,3575869317,3575869317,0
2,816,17344,3575869317,3575869318,1
2,816,17345,3575869317,3575869318,1
2,816,17346,3575869317,3575869318,1
2,816,17347,3575869317,3575869319,2
2,816,17348,3575869317,3575869319,2
2,816,17349,3575869317,3575869320,3
2,816,17350,3575869317,3575869320,3
2,816,17351,3575869317,3575869320,3
2,816,17352,3575869317,3575869322,5
2,816,17353,3575869317,3575869323,6
2,816,17354,3575869317,3575869323,6
2,816,17355,3575869317,3575869324,7
2,816,17356,3575869317,3575869327,10
2,816,17357,3575869317,3575869327,10
2,816,17358,3575869317,3575869328,11
2,816,17359,3575869317,3575869329,12
2,816,17360,3575869317,3575869332,15
2,816,17361,3575869317,3575869332,15
2,816,17362,3575869317,3575869333,16
2,816,17363,3575869317,3575869333,16
2,816,17364,3575869317,3575869333,16
2,816,17365,3575869317,3575869333,16
2,816,17366,3575869317,3575869334,17
2,816,17367,3575869317,3575869337,20
2,816,17368,3575869317,3575869338,21
2,816,17369,3575869317,3575869340,23
2,816,17370,3575869317,3575869341,24
2,816,17371,3575869317,3575869341,24
2,816,17372,3575869317,3575869344,27
2,816,17373,3575869317,3575869344,27
2,816,17374,3575869317,3575869345,28
2,816,17375,3575869317,3575869345,28
2,816,17376,3575869317,3575869346,29
2,816,17377,3575869317,3575869346,29
2,816,17378,3575869317,3575869347,30
2,816,17379,3575869317,3575869347,30
2,816,17380,3575869317,3575869348,31
2,816,17381,3575869317,3575869348,31
2,816,17382,3575869317,3575869349,32
2,816,17383,3575869317,3575869350,33
2,816,17384,3575869317,3575869352,35
2,816,17385,3575869317,3575869352,35
2,816,17386,3575869317,3575869352,35
2,816,17387,3575869317,3575869354,37
2,816,17388,3575869317,3575869356,39
2,816,17389,3575869317,3575869358,41
2,816,17390,3575869317,3575869360,43
2,816,17391,3575869317,3575869361,44
2,816,17392,3575869317,3575869361,44
2,816,17393,3575869317,3575869362,45
2,816,17394,3575869317,3575869364,47
2,816,17395,3575869317,3575869367,50
2,817,17396,3575869376,3575869376,0
2,817,17397,3575869376,3575869376,0
2,817,17398,3575869376,3575869376,0
2,817,17399,3575869376,3575869376,0
2,817,17400,3575869376,3575869376,0
2,817,17401,3575869376,3575869376,0
2,817,17402,3575869376,3575869377,1
2,817,17403,3575869376,3575869377,1
2,817,17404,3575869376,3575869378,2
2,817,17405,3575869376,3575869381,5
2,817,17406,3575869376,3575869382,6
2,817,17407,3575869376,3575869383,7
2,817,17408,3575869376,3575869383,7
2,817,17409,3575869376,3575869385,9
2,817,17410,3575869376,3575869385,9
2,817,17411,3575869376,3575869385,9
2,817,17412,3575869376,3575869386,10
2,817,17413,3575869376,3575869388,12
2,817,17414,3575869376,3575869388,12
2,817,17415,3575869376,3575869388,12
2,817,17416,3575869376,3575869390,14
2,817,17417,3575869376,3575869391,15
2,817,17418,3575869376,3575869394,18
2,817,17419,3575869376,3575869395,19
2,817,17420,3575869376,3575869396,20
2,817,17421,3575869376,3575869398,22
2,817,17422,3575869376,3575869398,22
2,817,17423,3575869376,3575869399,23
2,817,17424,3575869376,3575869399,23
2,817,17425,3575869376,3575869399,23
2,817,17426,3575869376,3575869400,24
2,817,17427,3575869376,3575869405,29
2,817,17428,3575869376,3575869405,29
2,817,17429,3575869376,3575869406,30
2,817,17430,3575869376,3575869407,31
2,817,17431,3575869376,3575869407,31
2,817,17432,3575869376,3575869408,32
2,817,17433,3575869376,3575869410,34
2,817,17434,3575869376,3575869411,35
2,817,17435,3575869376,3575869414,38
2,817,17436,3575869376,3575869414,38
2,817,17437,3575869376,3575869422,46
2,817,17438,3575869376,3575869424,48
2,817,17439,3575869376,3575869425,49
2,817,17440,3575869376,3575869426,50
2,818,17441,3575869435,3575869435,0
2,818,17442,3575869435,3575869435,0
2,818,17443,3575869435,3575869435,0
2,818,17444,3575869435,3575869435,0
2,818,17445,3575869435,3575869435,0
2,818,17446,3575869435,3575869435,0
2,818,17447,3575869435,3575869435,0
2,818,17448,3575869435,3575869435,0
2,818,17449,3575869435,3575869436,1
2,818,17450,3575869435,3575869437,2
2,818,17451,3575869435,3575869437,2
2,818,17452,3575869435,3575869438,3
2,818,17453,3575869435,3575869439,4
2,818,17454,3575869435,3575869440,5
2,818,17455,3575869435,3575869442,7
2,818,17456,3575869435,3575869444,9
2,818,17457,3575869435,3575869444,9
2,818,17458,3575869435,3575869445,10
2,818,17459,3575869435,3575869445,10
2,818,17460,3575869435,3575869446,11
2,818,17461,3575869435,3575869447,12
2,818,17462,3575869435,3575869449,14
2,818,17463,3575869435,3575869450,15
2,818,17464,3575869435,3575869451,16
2,818,17465,3575869435,3575869454,19
2,818,17466,3575869435,3575869455,20
2,818,17467,3575869435,3575869456,21
2,818,17468,3575869435,3575869457,22
2,818,17469,3575869435,3575869457,22
2,818,17470,3575869435,3575869459,24
2,818,17471,3575869435,3575869463,28
2,818,17472,3575869435,3575869463,28
2,818,17473,3575869435,3575869467,32
2,818,17474,3575869435,3575869467,32
2,818,17475,3575869435,3575869469,34
2,818,17476,3575869435,3575869471,36
2,818,17477,3575869435,3575869473,38
2,818,17478,3575869435,3575869475,40
2,818,17479,3575869435,3575869476,41
2,818,17480,3575869435,3575869477,42
2,818,17481,3575869435,3575869478,43
2,818,17482,3575869435,3575869478,43
2,818,17483,3575869435,3575869478,43
2,818,17484,3575869435,3575869479,44
2,818,17485,3575869435,3575869482,47
2,818,17486,3575869435,3575869482,47
2,818,17487,3575869435,3575869482,47
2,818,17488,3575869435,3575869483,48
2,818,17489,3575869435,3575869483,48
2,818,17490,3575869435,3575869484,49
2,818,17491,3575869435,3575869485,50
2,819,17492,3575869494,3575869494,0
2,819,17493,3575869494,3575869494,0
2,819,17494,3575869494,3575869494,0
2,819,17495,3575869494,3575869494,0
2,819,17496,3575869494,3575869494,0
2,819,17497,3575869494,3575869494,0
2,819,17498,3575869494,3575869494,0
2,819,17499,3575869494,3575869494,0
2,819,17500,3575869494,3575869494,0
2,819,17501,3575869494,3575869494,0
2,819,17502,3575869494,3575869495,1
2,819,17503,3575869494,3575869496,2
2,819,17504,3575869494,3575869497,3
2,819,17505,3575869494,3575869497,3
2,819,17506,3575869494,3575869498,4
2,819,17507,3575869494,3575869498,4
2,819,17508,3575869494,3575869499,5
2,819,17509,3575869494,3575869500,6
2,819,17510,3575869494,3575869501,7
2,819,17511,3575869494,3575869501,7
2,819,17512,3575869494,3575869501,7
2,819,17513,3575869494,3575869501,7
2,819,17514,3575869494,3575869502,8
2,819,17515,3575869494,3575869503,9
2,819,17516,3575869494,3575869503,9
2,819,17517,3575869494,3575869503,9
2,819,17518,3575869494,3575869505,11
2,819,17519,3575869494,3575869505,11
2,819,17520,3575869494,3575869507,13
2,819,17521,3575869494,3575869507,13
2,819,17522,3575869494,3575869508,14
2,819,17523,3575869494,3575869509,15
2,819,17524,3575869494,3575869509,15
2,819,17525,3575869494,3575869510,16
2,819,17526,3575869494,3575869511,17
2,819,17527,3575869494,3575869514,20
2,819,17528,3575869494,3575869517,23
2,819,17529,3575869494,3575869517,23
2,819,17530,3575869494,3575869517,23
2,819,17531,3575869494,3575869518,24
2,819,17532,3575869494,3575869519,25
2,819,17533,3575869494,3575869519,25
2,819,17534,3575869494,3575869519,25
2,819,17535,3575869494,3575869521,27
2,819,17536,3575869494,3575869522,28
2,819,17537,3575869494,3575869523,29
2,819,17538,3575869494,3575869525,31
2,819,17539,3575869494,3575869526,32
2,819,17540,3575869494,3575869527,33
2,819,17541,3575869494,3575869528,34
2,819,17542,3575869494,3575869528,34
2,819,17543,3575869494,3575869531,37
2,819,17544,3575869494,3575869531,37
2,819,17545,3575869494,3575869531,37
2,819,17546,3575869494,3575869532,38
2,819,17547,3575869494,3575869532,38
2,819,17548,3575869494,3575869532,38
2,819,17549,3575869494,3575869533,39
2,819,17550,3575869494,3575869533,39
2,819,17551,3575869494,3575869537,43
2,819,17552,3575869494,3575869537,43
2,819,17553,3575869494,3575869539,45
2,819,17554,3575869494,3575869541,47
2,819,17555,3575869494,3575869541,47
2,819,17556,3575869494,3575869543,49
2,819,17557,3575869494,3575869544,50
2,820,17558,3575869551,3575869551,0
2,820,17559,3575869551,3575869551,0
2,820,17560,3575869551,3575869551,0
2,820,17561,3575869551,3575869551,0
2,820,17562,3575869551,3575869551,0
2,820,17563,3575869551,3575869551,0
2,820,17564,3575869551,3575869551,0
2,820,17565,3575869551,3575869551,0
2,820,17566,3575869551,3575869551,0
2,820,17567,3575869551,3575869551,0
2,820,17568,3575869551,3575869551,0
2,820,17569,3575869551,3575869551,0
2,820,17570,3575869551,3575869553,2
2,820,17571,3575869551,3575869553,2
2,820,17572,3575869551,3575869553,2
2,820,17573,3575869551,3575869556,5
2,820,17574,3575869551,3575869557,6
2,820,17575,3575869551,3575869559,8
2,820,17576,3575869551,3575869560,9
2,820,17577,3575869551,3575869560,9
2,820,17578,3575869551,3575869561,10
2,820,17579,3575869551,3575869564,13
2,820,17580,3575869551,3575869567,16
2,820,17581,3575869551,3575869569,18
2,820,17582,3575869551,3575869569,18
2,820,17583,3575869551,3575869569,18
2,820,17584,3575869551,3575869569,18
2,820,17585,3575869551,3575869573,22
2,820,17586,3575869551,3575869573,22
2,820,17587,3575869551,3575869573,22
2,820,17588,3575869551,3575869575,24
2,820,17589,3575869551,3575869576,25
2,820,17590,3575869551,3575869576,25
2,820,17591,3575869551,3575869577,26
2,820,17592,3575869551,3575869578,27
2,820,17593,3575869551,3575869580,29
2,820,17594,3575869551,3575869580,29
2,820,17595,3575869551,3575869582,31
2,820,17596,3575869551,3575869582,31
2,820,17597,3575869551,3575869583,32
2,820,17598,3575869551,3575869583,32
2,820,17599,3575869551,3575869584,33
2,820,17600,3575869551,3575869585,34
2,820,17601,3575869551,3575869586,35
2,820,17602,3575869551,3575869587,36
2,820,17603,3575869551,3575869587,36
2,820,17604,3575869551,3575869588,37
2,820,17605,3575869551,3575869590,39
2,820,17606,3575869551,3575869590,39
2,820,17607,3575869551,3575869594,43
2,820,17608,3575869551,3575869594,43
2,820,17609,3575869551,3575869594,43
2,820,17610,3575869551,3575869595,44
2,820,17611,3575869551,3575869598,47
2,820,17612,3575869551,3575869598,47
2,820,17613,3575869551,3575869598,47
2,820,17614,3575869551,3575869599,48
2,820,17615,3575869551,3575869599,48
2,821,17616,3575869608,3575869608,0
2,821,17617,3575869608,3575869608,0
2,821,17618,3575869608,3575869608,0
2,821,17619,3575869608,3575869608,0
2,821,17620,3575869608,3575869608,0
2,821,17621,3575869608,3575869608,0
2,821,17622,3575869608,3575869608,0
2,821,17623,3575869608,3575869608,0
2,821,17624,3575869608,3575869611,3
2,821,17625,3575869608,3575869612,4
2,821,17626,3575869608,3575869613,5
2,821,17627,3575869608,3575869614,6
2,821,17628,3575869608,3575869621,13
2,821,17629,3575869608,3575869621,13
2,821,17630,3575869608,3575869622,14
2,821,17631,3575869608,3575869625,17
2,821,17632,3575869608,3575869625,17
2,821,17633,3575869608,3575869626,18
2,821,17634,3575869608,3575869627,19
2,821,17635,3575869608,3575869628,20
2,821,17636,3575869608,3575869629,21
2,821,17637,3575869608,3575869631,23
2,821,17638,3575869608,3575869633,25
2,821,17639,3575869608,3575869635,27
2,821,17640,3575869608,3575869635,27
2,821,17641,3575869608,3575869636,28
2,821,17642,3575869608,3575869636,28
2,821,17643,3575869608,3575869637,29
2,821,17644,3575869608,3575869639,31
2,821,17645,3575869608,3575869639,31
2,821,17646,3575869608,3575869642,34
2,821,17647,3575869608,3575869643,35
2,821,17648,3575869608,3575869644,36
2,821,17649,3575869608,3575869644,36
2,821,17650,3575869608,3575869645,37
2,821,17651,3575869608,3575869645,37
2,821,17652,3575869608,3575869645,37
2,821,17653,3575869608,3575869649,41
2,821,17654,3575869608,3575869649,41
2,821,17655,3575869608,3575869652,44
2,821,17656,3575869608,3575869654,46
2,821,17657,3575869608,3575869654,46
2,821,17658,3575869608,3575869655,47
2,821,17659,3575869608,3575869656,48
2,821,17660,3575869608,3575869657,49
2,822,17661,3575869666,3575869666,0
2,822,17662,3575869666,3575869666,0
2,822,17663,3575869666,3575869666,0
2,822,17664,3575869666,3575869666,0
2,822,17665,3575869666,3575869666,0
2,822,17666,3575869666,3575869669,3
2,822,17667,3575869666,3575869671,5
2,822,17668,3575869666,3575869674,8
2,822,17669,3575869666,3575869675,9
2,822,17670,3575869666,3575869675,9
2,822,17671,3575869666,3575869677,11
2,822,17672,3575869666,3575869678,12
2,822,17673,3575869666,3575869678,12
2,822,17674,3575869666,3575869678,12
2,822,17675,3575869666,3575869678,12
2,822,17676,3575869666,3575869679,13
2,822,17677,3575869666,3575869680,14
2,822,17678,3575869666,3575869682,16
2,822,17679,3575869666,3575869682,16
2,822,17680,3575869666,3575869682,16
2,822,17681,3575869666,3575869682,16
2,822,17682,3575869666,3575869683,17
2,822,17683,3575869666,3575869684,18
2,822,17684,3575869666,3575869684,18
2,822,17685,3575869666,3575869685,19
2,822,17686,3575869666,3575869687,21
2,822,17687,3575869666,3575869687,21
2,822,17688,3575869666,3575869688,22
2,822,17689,3575869666,3575869688,22
2,822,17690,3575869666,3575869688,22
2,822,17691,3575869666,3575869691,25
2,822,17692,3575869666,3575869692,26
2,822,17693,3575869666,3575869693,27
2,822,17694,3575869666,3575869695,29
2,822,17695,3575869666,3575869696,30
2,822,17696,3575869666,3575869697,31
2,822,17697,3575869666,3575869698,32
2,822,17698,3575869666,3575869698,32
2,822,17699,3575869666,3575869699,33
2,822,17700,3575869666,3575869700,34
2,822,17701,3575869666,3575869700,34
2,822,17702,3575869666,3575869700,34
2,822,17703,3575869666,3575869701,35
2,822,17704,3575869666,3575869701,35
2,822,17705,3575869666,3575869701,35
2,822,17706,3575869666,3575869703,37
2,822,17707,3575869666,3575869703,37
2,822,17708,3575869666,3575869704,38
2,822,17709,3575869666,3575869705,39
2,822,17710,3575869666,3575869705,39
2,822,17711,3575869666,3575869706,40
2,822,17712,3575869666,3575869708,42
2,822,17713,3575869666,3575869709,43
2,822,17714,3575869666,3575869709,43
2,822,17715,3575869666,3575869710,44
2,822,17716,3575869666,3575869710,44
2,822,17717,3575869666,3575869712,46
2,822,17718,3575869666,3575869714,48
2,822,17719,3575869666,3575869715,49
2,822,17720,3575869666,3575869716,50
2,823,17721,3575869726,3575869726,0
2,823,17722,3575869726,3575869726,0
2,823,17723,3575869726,3575869726,0
2,823,17724,3575869726,3575869726,0
2,823,17725,3575869726,3575869726,0
2,823,17726,3575869726,3575869726,0
2,823,17727,3575869726,3575869726,0
2,823,17728,3575869726,3575869726,0
2,823,17729,3575869726,3575869726,0
2,823,17730,3575869726,3575869727,1
2,823,17731,3575869726,3575869727,1
2,823,17732,3575869726,3575869727,1
2,823,17733,3575869726,3575869730,4
2,823,17734,3575869726,3575869731,5
2,823,17735,3575869726,3575869732,6
2,823,17736,3575869726,3575869732,6
2,823,17737,3575869726,3575869732,6
2,823,17738,3575869726,3575869733,7
2,823,17739,3575869726,3575869733,7
2,823,17740,3575869726,3575869734,8
2,823,17741,3575869726,3575869737,11
2,823,17742,3575869726,3575869739,13
2,823,17743,3575869726,3575869739,13
2,823,17744,3575869726,3575869741,15
2,823,17745,3575869726,3575869741,15
2,823,17746,3575869726,3575869743,17
2,823,17747,3575869726,3575869744,18
2,823,17748,3575869726,3575869744,18
2,823,17749,3575869726,3575869744,18
2,823,17750,3575869726,3575869745,19
2,823,17751,3575869726,3575869745,19
2,823,17752,3575869726,3575869745,19
2,823,17753,3575869726,3575869746,20
2,823,17754,3575869726,3575869747,21
2,823,17755,3575869726,3575869747,21
2,823,17756,3575869726,3575869748,22
2,823,17757,3575869726,3575869748,22
2,823,17758,3575869726,3575869751,25
2,823,17759,3575869726,3575869751,25
2,823,17760,3575869726,3575869753,27
2,823,17761,3575869726,3575869754,28
2,823,17762,3575869726,3575869757,31
2,823,17763,3575869726,3575869759,33
2,823,17764,3575869726,3575869759,33
2,823,17765,3575869726,3575869760,34
2,823,17766,3575869726,3575869761,35
2,823,17767,3575869726,3575869763,37
2,823,17768,3575869726,3575869767,41
2,823,17769,3575869726,3575869768,42
2,823,17770,3575869726,3575869769,43
2,823,17771,3575869726,3575869769,43
2,823,17772,3575869726,3575869769,43
2,823,17773,3575869726,3575869773,47
2,823,17774,3575869726,3575869773,47
2,823,17775,3575869726,3575869776,50
2,824,17776,3575869786,3575869786,0
2,824,17777,3575869786,3575869786,0
2,824,17778,3575869786,3575869786,0
2,824,17779,3575869786,3575869786,0
2,824,17780,3575869786,3575869786,0
2,824,17781,3575869786,3575869786,0
2,824,17782,3575869786,3575869786,0
2,824,17783,3575869786,3575869786,0
2,824,17784,3575869786,3575869786,0
2,824,17785,3575869786,3575869786,0
2,824,17786,3575869786,3575869786,0
2,824,17787,3575869786,3575869786,0
2,824,17788,3575869786,3575869787,1
2,824,17789,3575869786,3575869788,2
2,824,17790,3575869786,3575869790,4
2,824,17791,3575869786,3575869790,4
2,824,17792,3575869786,3575869794,8
2,824,17793,3575869786,3575869794,8
2,824,17794,3575869786,3575869795,9
2,824,17795,3575869786,3575869796,10
2,824,17796,3575869786,3575869798,12
2,824,17797,3575869786,3575869798,12
2,824,17798,3575869786,3575869798,12
2,824,17799,3575869786,3575869798,12
2,824,17800,3575869786,3575869799,13
2,824,17801,3575869786,3575869803,17
2,824,17802,3575869786,3575869804,18
2,824,17803,3575869786,3575869804,18
2,824,17804,3575869786,3575869805,19
2,824,17805,3575869786,3575869806,20
2,824,17806,3575869786,3575869807,21
2,824,17807,3575869786,3575869809,23
2,824,17808,3575869786,3575869809,23
2,824,17809,3575869786,3575869810,24
2,824,17810,3575869786,3575869811,25
2,824,17811,3575869786,3575869811,25
2,824,17812,3575869786,3575869813,27
2,824,17813,3575869786,3575869814,28
2,824,17814,3575869786,3575869821,35
2,824,17815,3575869786,3575869822,36
2,824,17816,3575869786,3575869823,37
2,824,17817,3575869786,3575869824,38
2,824,17818,3575869786,3575869825,39
2,824,17819,3575869786,3575869826,40
2,824,17820,3575869786,3575869830,44
2,824,17821,3575869786,3575869831,45
2,824,17822,3575869786,3575869833,47
2,824,17823,3575869786,3575869835,49
2,824,17824,3575869786,3575869836,50
2,825,17825,3575869844,3575869844,0
2,825,17826,3575869844,3575869844,0
2,825,17827,3575869844,3575869844,0
2,825,17828,3575869844,3575869844,0
2,825,17829,3575869844,3575869844,0
2,825,17830,3575869844,3575869844,0
2,825,17831,3575869844,3575869844,0
2,825,17832,3575869844,3575869844,0
2,825,17833,3575869844,3575869844,0
2,825,17834,3575869844,3575869845,1
2,825,17835,3575869844,3575869845,1
2,825,17836,3575869844,3575869845,1
2,825,17837,3575869844,3575869849,5
2,825,17838,3575869844,3575869849,5
2,825,17839,3575869844,3575869851,7
2,825,17840,3575869844,3575869854,10
2,825,17841,3575869844,3575869854,10
2,825,17842,3575869844,3575869855,11
2,825,17843,3575869844,3575869856,12
2,825,17844,3575869844,3575869856,12
2,825,17845,3575869844,3575869857,13
2,825,17846,3575869844,3575869859,15
2,825,17847,3575869844,3575869862,18
2,825,17848,3575869844,3575869863,19
2,825,17849,3575869844,3575869863,19
2,825,17850,3575869844,3575869866,22
2,825,17851,3575869844,3575869866,22
2,825,17852,3575869844,3575869869,25
2,825,17853,3575869844,3575869871,27
2,825,17854,3575869844,3575869874,30
2,825,17855,3575869844,3575869875,31
2,825,17856,3575869844,3575869876,32
2,825,17857,3575869844,3575869877,33
2,825,17858,3575869844,3575869878,34
2,825,17859,3575869844,3575869878,34
2,825,17860,3575869844,3575869878,34
2,825,17861,3575869844,3575869880,36
2,825,17862,3575869844,3575869880,36
2,825,17863,3575869844,3575869881,37
2,825,17864,3575869844,3575869882,38
2,825,17865,3575869844,3575869882,38
2,825,17866,3575869844,3575869882,38
2,825,17867,3575869844,3575869883,39
2,825,17868,3575869844,3575869883,39
2,825,17869,3575869844,3575869884,40
2,825,17870,3575869844,3575869884,40
2,825,17871,3575869844,3575869884,40
2,825,17872,3575869844,3575869884,40
2,825,17873,3575869844,3575869885,41
2,825,17874,3575869844,3575869887,43
2,825,17875,3575869844,3575869887,43
2,825,17876,3575869844,3575869888,44
2,825,17877,3575869844,3575869888,44
2,825,17878,3575869844,3575869889,45
2,825,17879,3575869844,3575869891,47
2,825,17880,3575869844,3575869892,48
2,825,17881,3575869844,3575869893,49
2,826,17882,3575869904,3575869904,0
2,826,17883,3575869904,3575869904,0
2,826,17884,3575869904,3575869904,0
2,826,17885,3575869904,3575869904,0
2,826,17886,3575869904,3575869904,0
2,826,17887,3575869904,3575869904,0
2,826,17888,3575869904,3575869904,0
2,826,17889,3575869904,3575869904,0
2,826,17890,3575869904,3575869904,0
2,826,17891,3575869904,3575869904,0
2,826,17892,3575869904,3575869904,0
2,826,17893,3575869904,3575869904,0
2,826,17894,3575869904,3575869904,0
2,826,17895,3575869904,3575869905,1
2,826,17896,3575869904,3575869906,2
2,826,17897,3575869904,3575869907,3
2,826,17898,3575869904,3575869908,4
2,826,17899,3575869904,3575869908,4
2,826,17900,3575869904,3575869909,5
2,826,17901,3575869904,3575869910,6
2,826,17902,3575869904,3575869910,6
2,826,17903,3575869904,3575869911,7
2,826,17904,3575869904,3575869912,8
2,826,17905,3575869904,3575869915,11
2,826,17906,3575869904,3575869916,12
2,826,17907,3575869904,3575869918,14
2,826,17908,3575869904,3575869918,14
2,826,17909,3575869904,3575869919,15
2,826,17910,3575869904,3575869919,15
2,826,17911,3575869904,3575869923,19
2,826,17912,3575869904,3575869923,19
2,826,17913,3575869904,3575869923,19
2,826,17914,3575869904,3575869924,20
2,826,17915,3575869904,3575869927,23
2,826,17916,3575869904,3575869927,23
2,826,17917,3575869904,3575869928,24
2,826,17918,3575869904,3575869930,26
2,826,17919,3575869904,3575869931,27
2,826,17920,3575869904,3575869932,28
2,826,17921,3575869904,3575869932,28
2,826,17922,3575869904,3575869933,29
2,826,17923,3575869904,3575869934,30
2,826,17924,3575869904,3575869934,30
2,826,17925,3575869904,3575869934,30
2,826,17926,3575869904,3575869937,33
2,826,17927,3575869904,3575869939,35
2,826,17928,3575869904,3575869939,35
2,826,17929,3575869904,3575869941,37
2,826,17930,3575869904,3575869941,37
2,826,17931,3575869904,3575869944,40
2,826,17932,3575869904,3575869944,40
2,826,17933,3575869904,3575869944,40
2,826,17934,3575869904,3575869944,40
2,826,17935,3575869904,3575869945,41
2,826,17936,3575869904,3575869945,41
2,826,17937,3575869904,3575869946,42
2,826,17938,3575869904,3575869946,42
2,826,17939,3575869904,3575869947,43
2,826,17940,3575869904,3575869948,44
2,826,17941,3575869904,3575869948,44
2,826,17942,3575869904,3575869948,44
2,826,17943,3575869904,3575869949,45
2,826,17944,3575869904,3575869949,45
2,826,17945,3575869904,3575869950,46
2,826,17946,3575869904,3575869951,47
2,826,17947,3575869904,3575869953,49
2,826,17948,3575869904,3575869954,50
2,827,17949,3575869962,3575869962,0
2,827,17950,3575869962,3575869962,0
2,827,17951,3575869962,3575869962,0
2,827,17952,3575869962,3575869962,0
2,827,17953,3575869962,3575869962,0
2,827,17954,3575869962,3575869962,0
2,827,17955,3575869962,3575869963,1
2,827,17956,3575869962,3575869968,6
2,827,17957,3575869962,3575869969,7
2,827,17958,3575869962,3575869969,7
2,827,17959,3575869962,3575869969,7
2,827,17960,3575869962,3575869969,7
2,827,17961,3575869962,3575869973,11
2,827,17962,3575869962,3575869973,11
2,827,17963,3575869962,3575869976,14
2,827,17964,3575869962,3575869977,15
2,827,17965,3575869962,3575869977,15
2,827,17966,3575869962,3575869978,16
2,827,17967,3575869962,3575869980,18
2,827,17968,3575869962,3575869980,18
2,827,17969,3575869962,3575869981,19
2,827,17970,3575869962,3575869982,20
2,827,17971,3575869962,3575869982,20
2,827,17972,3575869962,3575869983,21
2,827,17973,3575869962,3575869984,22
2,827,17974,3575869962,3575869986,24
2,827,17975,3575869962,3575869987,25
2,827,17976,3575869962,3575869988,26
2,827,17977,3575869962,3575869990,28
2,827,17978,3575869962,3575869990,28
2,827,17979,3575869962,3575869993,31
2,827,17980,3575869962,3575869994,32
2,827,17981,3575869962,3575869995,33
2,827,17982,3575869962,3575869996,34
2,827,17983,3575869962,3575869998,36
2,827,17984,3575869962,3575869998,36
2,827,17985,3575869962,3575869999,37
2,827,17986,3575869962,3575870000,38
2,827,17987,3575869962,3575870004,42
2,827,17988,3575869962,3575870004,42
2,827,17989,3575869962,3575870004,42
2,827,17990,3575869962,3575870005,43
2,827,17991,3575869962,3575870007,45
2,827,17992,3575869962,3575870007,45
2,827,17993,3575869962,3575870009,47
2,827,17994,3575869962,3575870010,48
2,827,17995,3575869962,3575870011,49
2,827,17996,3575869962,3575870011,49
2,828,17997,3575870020,3575870020,0
2,828,17998,3575870020,3575870022,2
2,828,17999,3575870020,3575870023,3
2,828,18000,3575870020,3575870023,3
2,828,18001,3575870020,3575870024,4
2,828,18002,3575870020,3575870026,6
2,828,18003,3575870020,3575870027,7
2,828,18004,3575870020,3575870028,8
2,828,18005,3575870020,3575870030,10
2,828,18006,3575870020,3575870032,12
2,828,18007,3575870020,3575870034,14
2,828,18008,3575870020,3575870035,15
2,828,18009,3575870020,3575870036,16
2,828,18010,3575870020,3575870036,16
2,828,18011,3575870020,3575870037,17
2,828,18012,3575870020,3575870037,17
2,828,18013,3575870020,3575870037,17
2,828,18014,3575870020,3575870040,20
2,828,18015,3575870020,3575870041,21
2,828,18016,3575870020,3575870041,21
2,828,18017,3575870020,3575870043,23
2,828,18018,3575870020,3575870044,24
2,828,18019,3575870020,3575870045,25
2,828,18020,3575870020,3575870045,25
2,828,18021,3575870020,3575870045,25
2,828,18022,3575870020,3575870045,25
2,828,18023,3575870020,3575870049,29
2,828,18024,3575870020,3575870050,30
2,828,18025,3575870020,3575870051,31
2,828,18026,3575870020,3575870052,32
2,828,18027,3575870020,3575870053,33
2,828,18028,3575870020,3575870054,34
2,828,18029,3575870020,3575870055,35
2,828,18030,3575870020,3575870056,36
2,828,18031,3575870020,3575870057,37
2,828,18032,3575870020,3575870059,39
2,828,18033,3575870020,3575870062,42
2,828,18034,3575870020,3575870062,42
2,828,18035,3575870020,3575870062,42
2,828,18036,3575870020,3575870063,43
2,828,18037,3575870020,3575870066,46
2,828,18038,3575870020,3575870066,46
2,828,18039,3575870020,3575870069,49
2,829,18040,3575870078,3575870078,0
2,829,18041,3575870078,3575870078,0
2,829,18042,3575870078,3575870078,0
2,829,18043,3575870078,3575870078,0
2,829,18044,3575870078,3575870078,0
2,829,18045,3575870078,3575870079,1
2,829,18046,3575870078,3575870080,2
2,829,18047,3575870078,3575870080,2
2,829,18048,3575870078,3575870081,3
2,829,18049,3575870078,3575870082,4
2,829,18050,3575870078,3575870082,4
2,829,18051,3575870078,3575870082,4
2,829,18052,3575870078,3575870083,5
2,829,18053,3575870078,3575870083,5
2,829,18054,3575870078,3575870084,6
2,829,18055,3575870078,3575870084,6
2,829,18056,3575870078,3575870084,6
2,829,18057,3575870078,3575870084,6
2,829,18058,3575870078,3575870085,7
2,829,18059,3575870078,3575870085,7
2,829,18060,3575870078,3575870087,9
2,829,18061,3575870078,3575870087,9
2,829,18062,3575870078,3575870088,10
2,829,18063,3575870078,3575870089,11
2,829,18064,3575870078,3575870089,11
2,829,18065,3575870078,3575870092,14
2,829,18066,3575870078,3575870094,16
2,829,18067,3575870078,3575870096,18
2,829,18068,3575870078,3575870097,19
2,829,18069,3575870078,3575870098,20
2,829,18070,3575870078,3575870099,21
2,829,18071,3575870078,3575870100,22
2,829,18072,3575870078,3575870100,22
2,829,18073,3575870078,3575870101,23
2,829,18074,3575870078,3575870101,23
2,829,18075,3575870078,3575870102,24
2,829,18076,3575870078,3575870102,24
2,829,18077,3575870078,3575870102,24
2,829,18078,3575870078,3575870104,26
2,829,18079,3575870078,3575870105,27
2,829,18080,3575870078,3575870105,27
2,829,18081,3575870078,3575870107,29
2,829,18082,3575870078,3575870107,29
2,829,18083,3575870078,3575870108,30
2,829,18084,3575870078,3575870108,30
2,829,18085,3575870078,3575870109,31
2,829,18086,3575870078,3575870110,32
2,829,18087,3575870078,3575870110,32
2,829,18088,3575870078,3575870111,33
2,829,18089,3575870078,3575870115,37
2,829,18090,3575870078,3575870116,38
2,829,18091,3575870078,3575870116,38
2,829,18092,3575870078,3575870118,40
2,829,18093,3575870078,3575870118,40
2,829,18094,3575870078,3575870118,40
2,829,18095,3575870078,3575870119,41
2,829,18096,3575870078,3575870119,41
2,829,18097,3575870078,3575870120,42
2,829,18098,3575870078,3575870123,45
2,829,18099,3575870078,3575870123,45
2,829,18100,3575870078,3575870124,46
2,829,18101,3575870078,3575870125,47
2,829,18102,3575870078,3575870127,49
2,829,18103,3575870078,3575870127,49
2,829,18104,3575870078,3575870128,50
2,830,18105,3575870136,3575870136,0
2,830,18106,3575870136,3575870136,0
2,830,18107,3575870136,3575870136,0
2,830,18108,3575870136,3575870136,0
2,830,18109,3575870136,3575870136,0
2,830,18110,3575870136,3575870136,0
2,830,18111,3575870136,3575870136,0
2,830,18112,3575870136,3575870136,0
2,830,18113,3575870136,3575870136,0
2,830,18114,3575870136,3575870137,1
2,830,18115,3575870136,3575870139,3
2,830,18116,3575870136,3575870140,4
2,830,18117,3575870136,3575870141,5
2,830,18118,3575870136,3575870141,5
2,830,18119,3575870136,3575870143,7
2,830,18120,3575870136,3575870144,8
2,830,18121,3575870136,3575870144,8
2,830,18122,3575870136,3575870144,8
2,830,18123,3575870136,3575870145,9
2,830,18124,3575870136,3575870146,10
2,830,18125,3575870136,3575870146,10
2,830,18126,3575870136,3575870147,11
2,830,18127,3575870136,3575870147,11
2,830,18128,3575870136,3575870148,12
2,830,18129,3575870136,3575870149,13
2,830,18130,3575870136,3575870149,13
2,830,18131,3575870136,3575870151,15
2,830,18132,3575870136,3575870152,16
2,830,18133,3575870136,3575870154,18
2,830,18134,3575870136,3575870155,19
2,830,18135,3575870136,3575870156,20
2,830,18136,3575870136,3575870157,21
2,830,18137,3575870136,3575870160,24
2,830,18138,3575870136,3575870160,24
2,830,18139,3575870136,3575870160,24
2,830,18140,3575870136,3575870161,25
2,830,18141,3575870136,3575870164,28
2,830,18142,3575870136,3575870167,31
2,830,18143,3575870136,3575870168,32
2,830,18144,3575870136,3575870169,33
2,830,18145,3575870136,3575870170,34
2,830,18146,3575870136,3575870170,34
2,830,18147,3575870136,3575870172,36
2,830,18148,3575870136,3575870176,40
2,830,18149,3575870136,3575870177,41
2,830,18150,3575870136,3575870177,41
2,830,18151,3575870136,3575870178,42
2,830,18152,3575870136,3575870180,44
2,830,18153,3575870136,3575870180,44
2,830,18154,3575870136,3575870181,45
2,830,18155,3575870136,3575870181,45
2,830,18156,3575870136,3575870182,46
2,830,18157,3575870136,3575870183,47
2,830,18158,3575870136,3575870183,47
2,830,18159,3575870136,3575870185,49
2,831,18160,3575870198,3575870198,0
2,831,18161,3575870198,3575870198,0
2,831,18162,3575870198,3575870198,0
2,831,18163,3575870198,3575870198,0
2,831,18164,3575870198,3575870198,0
2,831,18165,3575870198,3575870198,0
2,831,18166,3575870198,3575870198,0
2,831,18167,3575870198,3575870198,0
2,831,18168,3575870198,3575870199,1
2,831,18169,3575870198,3575870199,1
2,831,18170,3575870198,3575870200,2
2,831,18171,3575870198,3575870204,6
2,831,18172,3575870198,3575870204,6
2,831,18173,3575870198,3575870204,6
2,831,18174,3575870198,3575870205,7
2,831,18175,3575870198,3575870207,9
2,831,18176,3575870198,3575870207,9
2,831,18177,3575870198,3575870209,11
2,831,18178,3575870198,3575870210,12
2,831,18179,3575870198,3575870211,13
2,831,18180,3575870198,3575870211,13
2,831,18181,3575870198,3575870213,15
2,831,18182,3575870198,3575870214,16
2,831,18183,3575870198,3575870222,24
2,831,18184,3575870198,3575870223,25
2,831,18185,3575870198,3575870223,25
2,831,18186,3575870198,3575870225,27
2,831,18187,3575870198,3575870227,29
2,831,18188,3575870198,3575870228,30
2,831,18189,3575870198,3575870230,32
2,831,18190,3575870198,3575870232,34
2,831,18191,3575870198,3575870233,35
2,831,18192,3575870198,3575870236,38
2,831,18193,3575870198,3575870236,38
2,831,18194,3575870198,3575870236,38
2,831,18195,3575870198,3575870237,39
2,831,18196,3575870198,3575870238,40
2,831,18197,3575870198,3575870240,42
2,831,18198,3575870198,3575870241,43
2,831,18199,3575870198,3575870241,43
2,831,18200,3575870198,3575870243,45
2,831,18201,3575870198,3575870244,46
2,831,18202,3575870198,3575870245,47
2,831,18203,3575870198,3575870245,47
2,831,18204,3575870198,3575870245,47
2,831,18205,3575870198,3575870245,47
2,832,18206,3575870255,3575870255,0
2,832,18207,3575870255,3575870255,0
2,832,18208,3575870255,3575870255,0
2,832,18209,3575870255,3575870255,0
2,832,18210,3575870255,3575870255,0
2,832,18211,3575870255,3575870256,1
2,832,18212,3575870255,3575870256,1
2,832,18213,3575870255,3575870257,2
2,832,18214,3575870255,3575870259,4
2,832,18215,3575870255,3575870262,7
2,832,18216,3575870255,3575870263,8
2,832,18217,3575870255,3575870266,11
2,832,18218,3575870255,3575870266,11
2,832,18219,3575870255,3575870270,15
2,832,18220,3575870255,3575870272,17
2,832,18221,3575870255,3575870273,18
2,832,18222,3575870255,3575870276,21
2,832,18223,3575870255,3575870277,22
2,832,18224,3575870255,3575870277,22
2,832,18225,3575870255,3575870278,23
2,832,18226,3575870255,3575870279,24
2,832,18227,3575870255,3575870280,25
2,832,18228,3575870255,3575870280,25
2,832,18229,3575870255,3575870280,25
2,832,18230,3575870255,3575870281,26
2,832,18231,3575870255,3575870282,27
2,832,18232,3575870255,3575870282,27
2,832,18233,3575870255,3575870282,27
2,832,18234,3575870255,3575870283,28
2,832,18235,3575870255,3575870284,29
2,832,18236,3575870255,3575870284,29
2,832,18237,3575870255,3575870285,30
2,832,18238,3575870255,3575870285,30
2,832,18239,3575870255,3575870285,30
2,832,18240,3575870255,3575870287,32
2,832,18241,3575870255,3575870287,32
2,832,18242,3575870255,3575870288,33
2,832,18243,3575870255,3575870289,34
2,832,18244,3575870255,3575870289,34
2,832,18245,3575870255,3575870290,35
2,832,18246,3575870255,3575870292,37
2,832,18247,3575870255,3575870294,39
2,832,18248,3575870255,3575870294,39
2,832,18249,3575870255,3575870296,41
2,832,18250,3575870255,3575870297,42
2,832,18251,3575870255,3575870297,42
2,832,18252,3575870255,3575870298,43
2,832,18253,3575870255,3575870299,44
2,832,18254,3575870255,3575870300,45
2,832,18255,3575870255,3575870300,45
2,832,18256,3575870255,3575870301,46
2,832,18257,3575870255,3575870302,47
2,832,18258,3575870255,3575870302,47
2,832,18259,3575870255,3575870302,47
2,832,18260,3575870255,3575870302,47
2,832,18261,3575870255,3575870303,48
2,832,18262,3575870255,3575870304,49
2,833,18263,3575870317,3575870317,0
2,833,18264,3575870317,3575870317,0
2,833,18265,3575870317,3575870317,0
2,833,18266,3575870317,3575870317,0
2,833,18267,3575870317,3575870317,0
2,833,18268,3575870317,3575870317,0
2,833,18269,3575870317,3575870317,0
2,833,18270,3575870317,3575870317,0
2,833,18271,3575870317,3575870317,0
2,833,18272,3575870317,3575870317,0
2,833,18273,3575870317,3575870317,0
2,833,18274,3575870317,3575870317,0
2,833,18275,3575870317,3575870317,0
2,833,18276,3575870317,3575870317,0
2,833,18277,3575870317,3575870318,1
2,833,18278,3575870317,3575870318,1
2,833,18279,3575870317,3575870319,2
2,833,18280,3575870317,3575870319,2
2,833,18281,3575870317,3575870320,3
2,833,18282,3575870317,3575870320,3
2,833,18283,3575870317,3575870322,5
2,833,18284,3575870317,3575870323,6
2,833,18285,3575870317,3575870324,7
2,833,18286,3575870317,3575870325,8
2,833,18287,3575870317,3575870326,9
2,833,18288,3575870317,3575870329,12
2,833,18289,3575870317,3575870329,12
2,833,18290,3575870317,3575870329,12
2,833,18291,3575870317,3575870330,13
2,833,18292,3575870317,3575870331,14
2,833,18293,3575870317,3575870332,15
2,833,18294,3575870317,3575870333,16
2,833,18295,3575870317,3575870333,16
2,833,18296,3575870317,3575870333,16
2,833,18297,3575870317,3575870334,17
2,833,18298,3575870317,3575870334,17
2,833,18299,3575870317,3575870335,18
2,833,18300,3575870317,3575870337,20
2,833,18301,3575870317,3575870339,22
2,833,18302,3575870317,3575870341,24
2,833,18303,3575870317,3575870341,24
2,833,18304,3575870317,3575870341,24
2,833,18305,3575870317,3575870344,27
2,833,18306,3575870317,3575870344,27
2,833,18307,3575870317,3575870345,28
2,833,18308,3575870317,3575870345,28
2,833,18309,3575870317,3575870346,29
2,833,18310,3575870317,3575870347,30
2,833,18311,3575870317,3575870347,30
2,833,18312,3575870317,3575870348,31
2,833,18313,3575870317,3575870349,32
2,833,18314,3575870317,3575870349,32
2,833,18315,3575870317,3575870350,33
2,833,18316,3575870317,3575870351,34
2,833,18317,3575870317,3575870352,35
2,833,18318,3575870317,3575870353,36
2,833,18319,3575870317,3575870354,37
2,833,18320,3575870317,3575870355,38
2,833,18321,3575870317,3575870356,39
2,833,18322,3575870317,3575870358,41
2,833,18323,3575870317,3575870358,41
2,833,18324,3575870317,3575870360,43
2,833,18325,3575870317,3575870361,44
2,833,18326,3575870317,3575870361,44
2,833,18327,3575870317,3575870363,46
2,834,18328,3575870374,3575870374,0
2,834,18329,3575870374,3575870374,0
2,834,18330,3575870374,3575870374,0
2,834,18331,3575870374,3575870375,1
2,834,18332,3575870374,3575870375,1
2,834,18333,3575870374,3575870375,1
2,834,18334,3575870374,3575870375,1
2,834,18335,3575870374,3575870376,2
2,834,18336,3575870374,3575870377,3
2,834,18337,3575870374,3575870377,3
2,834,18338,3575870374,3575870380,6
2,834,18339,3575870374,3575870380,6
2,834,18340,3575870374,3575870380,6
2,834,18341,3575870374,3575870381,7
2,834,18342,3575870374,3575870381,7
2,834,18343,3575870374,3575870383,9
2,834,18344,3575870374,3575870383,9
2,834,18345,3575870374,3575870384,10
2,834,18346,3575870374,3575870385,11
2,834,18347,3575870374,3575870386,12
2,834,18348,3575870374,3575870387,13
2,834,18349,3575870374,3575870387,13
2,834,18350,3575870374,3575870388,14
2,834,18351,3575870374,3575870388,14
2,834,18352,3575870374,3575870388,14
2,834,18353,3575870374,3575870391,17
2,834,18354,3575870374,3575870394,20
2,834,18355,3575870374,3575870395,21
2,834,18356,3575870374,3575870396,22
2,834,18357,3575870374,3575870396,22
2,834,18358,3575870374,3575870398,24
2,834,18359,3575870374,3575870399,25
2,834,18360,3575870374,3575870399,25
2,834,18361,3575870374,3575870400,26
2,834,18362,3575870374,3575870400,26
2,834,18363,3575870374,3575870404,30
2,834,18364,3575870374,3575870404,30
2,834,18365,3575870374,3575870404,30
2,834,18366,3575870374,3575870405,31
2,834,18367,3575870374,3575870407,33
2,834,18368,3575870374,3575870407,33
2,834,18369,3575870374,3575870409,35
2,834,18370,3575870374,3575870410,36
2,834,18371,3575870374,3575870411,37
2,834,18372,3575870374,3575870412,38
2,834,18373,3575870374,3575870413,39
2,834,18374,3575870374,3575870414,40
2,834,18375,3575870374,3575870422,48
2,834,18376,3575870374,3575870424,50
2,835,18377,3575870434,3575870434,0
2,835,18378,3575870434,3575870434,0
2,835,18379,3575870434,3575870434,0
2,835,18380,3575870434,3575870434,0
2,835,18381,3575870434,3575870434,0
2,835,18382,3575870434,3575870434,0
2,835,18383,3575870434,3575870434,0
2,835,18384,3575870434,3575870434,0
2,835,18385,3575870434,3575870435,1
2,835,18386,3575870434,3575870436,2
2,835,18387,3575870434,3575870436,2
2,835,18388,3575870434,3575870437,3
2,835,18389,3575870434,3575870437,3
2,835,18390,3575870434,3575870438,4
2,835,18391,3575870434,3575870441,7
2,835,18392,3575870434,3575870442,8
2,835,18393,3575870434,3575870444,10
2,835,18394,3575870434,3575870444,10
2,835,18395,3575870434,3575870445,11
2,835,18396,3575870434,3575870445,11
2,835,18397,3575870434,3575870446,12
2,835,18398,3575870434,3575870446,12
2,835,18399,3575870434,3575870449,15
2,835,18400,3575870434,3575870451,17
2,835,18401,3575870434,3575870453,19
2,835,18402,3575870434,3575870455,21
2,835,18403,3575870434,3575870456,22
2,835,18404,3575870434,3575870456,22
2,835,18405,3575870434,3575870457,23
2,835,18406,3575870434,3575870457,23
2,835,18407,3575870434,3575870459,25
2,835,18408,3575870434,3575870462,28
2,835,18409,3575870434,3575870462,28
2,835,18410,3575870434,3575870463,29
2,835,18411,3575870434,3575870466,32
2,835,18412,3575870434,3575870467,33
2,835,18413,3575870434,3575870471,37
2,835,18414,3575870434,3575870471,37
2,835,18415,3575870434,3575870473,39
2,835,18416,3575870434,3575870476,42
2,835,18417,3575870434,3575870477,43
2,835,18418,3575870434,3575870478,44
2,835,18419,3575870434,3575870478,44
2,835,18420,3575870434,3575870479,45
2,835,18421,3575870434,3575870480,46
2,835,18422,3575870434,3575870480,46
2,835,18423,3575870434,3575870481,47
2,835,18424,3575870434,3575870481,47
2,835,18425,3575870434,3575870482,48
2,835,18426,3575870434,3575870482,48
2,835,18427,3575870434,3575870482,48
2,835,18428,3575870434,3575870483,49
2,836,18429,3575870494,3575870494,0
2,836,18430,3575870494,3575870494,0
2,836,18431,3575870494,3575870494,0
2,836,18432,3575870494,3575870494,0
2,836,18433,3575870494,3575870494,0
2,836,18434,3575870494,3575870494,0
2,836,18435,3575870494,3575870494,0
2,836,18436,3575870494,3575870494,0
2,836,18437,3575870494,3575870494,0
2,836,18438,3575870494,3575870494,0
2,836,18439,3575870494,3575870494,0
2,836,18440,3575870494,3575870494,0
2,836,18441,3575870494,3575870494,0
2,836,18442,3575870494,3575870494,0
2,836,18443,3575870494,3575870494,0
2,836,18444,3575870494,3575870494,0
2,836,18445,3575870494,3575870495,1
2,836,18446,3575870494,3575870496,2
2,836,18447,3575870494,3575870497,3
2,836,18448,3575870494,3575870497,3
2,836,18449,3575870494,3575870498,4
2,836,18450,3575870494,3575870499,5
2,836,18451,3575870494,3575870499,5
2,836,18452,3575870494,3575870501,7
2,836,18453,3575870494,3575870501,7
2,836,18454,3575870494,3575870501,7
2,836,18455,3575870494,3575870502,8
2,836,18456,3575870494,3575870503,9
2,836,18457,3575870494,3575870504,10
2,836,18458,3575870494,3575870505,11
2,836,18459,3575870494,3575870506,12
2,836,18460,3575870494,3575870508,14
2,836,18461,3575870494,3575870508,14
2,836,18462,3575870494,3575870509,15
2,836,18463,3575870494,3575870509,15
2,836,18464,3575870494,3575870510,16
2,836,18465,3575870494,3575870511,17
2,836,18466,3575870494,3575870514,20
2,836,18467,3575870494,3575870515,21
2,836,18468,3575870494,3575870516,22
2,836,18469,3575870494,3575870516,22
2,836,18470,3575870494,3575870517,23
2,836,18471,3575870494,3575870517,23
2,836,18472,3575870494,3575870518,24
2,836,18473,3575870494,3575870519,25
2,836,18474,3575870494,3575870520,26
2,836,18475,3575870494,3575870521,27
2,836,18476,3575870494,3575870522,28
2,836,18477,3575870494,3575870523,29
2,836,18478,3575870494,3575870523,29
2,836,18479,3575870494,3575870525,31
2,836,18480,3575870494,3575870528,34
2,836,18481,3575870494,3575870528,34
2,836,18482,3575870494,3575870530,36
2,836,18483,3575870494,3575870531,37
2,836,18484,3575870494,3575870532,38
2,836,18485,3575870494,3575870532,38
2,836,18486,3575870494,3575870532,38
2,836,18487,3575870494,3575870533,39
2,836,18488,3575870494,3575870533,39
2,836,18489,3575870494,3575870533,39
2,836,18490,3575870494,3575870539,45
2,836,18491,3575870494,3575870540,46
2,836,18492,3575870494,3575870540,46
2,836,18493,3575870494,3575870540,46
2,836,18494,3575870494,3575870543,49
2,837,18495,3575870553,3575870553,0
2,837,18496,3575870553,3575870553,0
2,837,18497,3575870553,3575870553,0
2,837,18498,3575870553,3575870553,0
2,837,18499,3575870553,3575870553,0
2,837,18500,3575870553,3575870553,0
2,837,18501,3575870553,3575870553,0
2,837,18502,3575870553,3575870553,0
2,837,18503,3575870553,3575870553,0
2,837,18504,3575870553,3575870553,0
2,837,18505,3575870553,3575870553,0
2,837,18506,3575870553,3575870553,0
2,837,18507,3575870553,3575870553,0
2,837,18508,3575870553,3575870556,3
2,837,18509,3575870553,3575870556,3
2,837,18510,3575870553,3575870557,4
2,837,18511,3575870553,3575870558,5
2,837,18512,3575870553,3575870559,6
2,837,18513,3575870553,3575870560,7
2,837,18514,3575870553,3575870561,8
2,837,18515,3575870553,3575870561,8
2,837,18516,3575870553,3575870562,9
2,837,18517,3575870553,3575870567,14
2,837,18518,3575870553,3575870568,15
2,837,18519,3575870553,3575870568,15
2,837,18520,3575870553,3575870568,15
2,837,18521,3575870553,3575870569,16
2,837,18522,3575870553,3575870572,19
2,837,18523,3575870553,3575870573,20
2,837,18524,3575870553,3575870576,23
2,837,18525,3575870553,3575870576,23
2,837,18526,3575870553,3575870576,23
2,837,18527,3575870553,3575870580,27
2,837,18528,3575870553,3575870580,27
2,837,18529,3575870553,3575870580,27
2,837,18530,3575870553,3575870580,27
2,837,18531,3575870553,3575870581,28
2,837,18532,3575870553,3575870583,30
2,837,18533,3575870553,3575870583,30
2,837,18534,3575870553,3575870583,30
2,837,18535,3575870553,3575870584,31
2,837,18536,3575870553,3575870584,31
2,837,18537,3575870553,3575870585,32
2,837,18538,3575870553,3575870585,32
2,837,18539,3575870553,3575870586,33
2,837,18540,3575870553,3575870587,34
2,837,18541,3575870553,3575870588,35
2,837,18542,3575870553,3575870588,35
2,837,18543,3575870553,3575870590,37
2,837,18544,3575870553,3575870593,40
2,837,18545,3575870553,3575870594,41
2,837,18546,3575870553,3575870594,41
2,837,18547,3575870553,3575870596,43
2,837,18548,3575870553,3575870597,44
2,837,18549,3575870553,3575870597,44
2,837,18550,3575870553,3575870598,45
2,837,18551,3575870553,3575870598,45
2,837,18552,3575870553,3575870599,46
2,837,18553,3575870553,3575870599,46
2,837,18554,3575870553,3575870603,50
2,838,18555,3575870610,3575870610,0
2,838,18556,3575870610,3575870610,0
2,838,18557,3575870610,3575870610,0
2,838,18558,3575870610,3575870610,0
2,838,18559,3575870610,3575870610,0
2,838,18560,3575870610,3575870610,0
2,838,18561,3575870610,3575870610,0
2,838,18562,3575870610,3575870610,0
2,838,18563,3575870610,3575870610,0
2,838,18564,3575870610,3575870611,1
2,838,18565,3575870610,3575870611,1
2,838,18566,3575870610,3575870613,3
2,838,18567,3575870610,3575870621,11
2,838,18568,3575870610,3575870622,12
2,838,18569,3575870610,3575870622,12
2,838,18570,3575870610,3575870624,14
2,838,18571,3575870610,3575870626,16
2,838,18572,3575870610,3575870627,17
2,838,18573,3575870610,3575870627,17
2,838,18574,3575870610,3575870628,18
2,838,18575,3575870610,3575870628,18
2,838,18576,3575870610,3575870632,22
2,838,18577,3575870610,3575870634,24
2,838,18578,3575870610,3575870634,24
2,838,18579,3575870610,3575870635,25
2,838,18580,3575870610,3575870635,25
2,838,18581,3575870610,3575870637,27
2,838,18582,3575870610,3575870638,28
2,838,18583,3575870610,3575870640,30
2,838,18584,3575870610,3575870640,30
2,838,18585,3575870610,3575870642,32
2,838,18586,3575870610,3575870643,33
2,838,18587,3575870610,3575870644,34
2,838,18588,3575870610,3575870644,34
2,838,18589,3575870610,3575870644,34
2,838,18590,3575870610,3575870644,34
2,838,18591,3575870610,3575870645,35
2,838,18592,3575870610,3575870648,38
2,838,18593,3575870610,3575870651,41
2,838,18594,3575870610,3575870652,42
2,838,18595,3575870610,3575870652,42
2,838,18596,3575870610,3575870654,44
2,838,18597,3575870610,3575870655,45
2,838,18598,3575870610,3575870655,45
2,838,18599,3575870610,3575870655,45
2,838,18600,3575870610,3575870656,46
2,838,18601,3575870610,3575870657,47
2,838,18602,3575870610,3575870658,48
2,839,18603,3575870668,3575870668,0
2,839,18604,3575870668,3575870668,0
2,839,18605,3575870668,3575870668,0
2,839,18606,3575870668,3575870668,0
2,839,18607,3575870668,3575870668,0
2,839,18608,3575870668,3575870670,2
2,839,18609,3575870668,3575870674,6
2,839,18610,3575870668,3575870676,8
2,839,18611,3575870668,3575870677,9
2,839,18612,3575870668,3575870677,9
2,839,18613,3575870668,3575870678,10
2,839,18614,3575870668,3575870678,10
2,839,18615,3575870668,3575870679,11
2,839,18616,3575870668,3575870679,11
2,839,18617,3575870668,3575870680,12
2,839,18618,3575870668,3575870682,14
2,839,18619,3575870668,3575870682,14
2,839,18620,3575870668,3575870682,14
2,839,18621,3575870668,3575870682,14
2,839,18622,3575870668,3575870682,14
2,839,18623,3575870668,3575870683,15
2,839,18624,3575870668,3575870684,16
2,839,18625,3575870668,3575870685,17
2,839,18626,3575870668,3575870685,17
2,839,18627,3575870668,3575870686,18
2,839,18628,3575870668,3575870686,18
2,839,18629,3575870668,3575870687,19
2,839,18630,3575870668,3575870688,20
2,839,18631,3575870668,3575870688,20
2,839,18632,3575870668,3575870688,20
2,839,18633,3575870668,3575870689,21
2,839,18634,3575870668,3575870691,23
2,839,18635,3575870668,3575870691,23
2,839,18636,3575870668,3575870692,24
2,839,18637,3575870668,3575870694,26
2,839,18638,3575870668,3575870695,27
2,839,18639,3575870668,3575870697,29
2,839,18640,3575870668,3575870698,30
2,839,18641,3575870668,3575870699,31
2,839,18642,3575870668,3575870699,31
2,839,18643,3575870668,3575870700,32
2,839,18644,3575870668,3575870701,33
2,839,18645,3575870668,3575870701,33
2,839,18646,3575870668,3575870701,33
2,839,18647,3575870668,3575870701,33
2,839,18648,3575870668,3575870703,35
2,839,18649,3575870668,3575870703,35
2,839,18650,3575870668,3575870704,36
2,839,18651,3575870668,3575870705,37
2,839,18652,3575870668,3575870706,38
2,839,18653,3575870668,3575870707,39
2,839,18654,3575870668,3575870708,40
2,839,18655,3575870668,3575870709,41
2,839,18656,3575870668,3575870710,42
2,839,18657,3575870668,3575870710,42
2,839,18658,3575870668,3575870711,43
2,839,18659,3575870668,3575870711,43
2,839,18660,3575870668,3575870715,47
2,839,18661,3575870668,3575870715,47
2,839,18662,3575870668,3575870715,47
2,839,18663,3575870668,3575870717,49
2,839,18664,3575870668,3575870717,49
2,839,18665,3575870668,3575870717,49
2,839,18666,3575870668,3575870717,49
2,840,18667,3575870725,3575870725,0
2,840,18668,3575870725,3575870725,0
2,840,18669,3575870725,3575870725,0
2,840,18670,3575870725,3575870725,0
2,840,18671,3575870725,3575870725,0
2,840,18672,3575870725,3575870725,0
2,840,18673,3575870725,3575870726,1
2,840,18674,3575870725,3575870728,3
2,840,18675,3575870725,3575870728,3
2,840,18676,3575870725,3575870729,4
2,840,18677,3575870725,3575870729,4
2,840,18678,3575870725,3575870731,6
2,840,18679,3575870725,3575870731,6
2,840,18680,3575870725,3575870732,7
2,840,18681,3575870725,3575870732,7
2,840,18682,3575870725,3575870732,7
2,840,18683,3575870725,3575870733,8
2,840,18684,3575870725,3575870735,10
2,840,18685,3575870725,3575870736,11
2,840,18686,3575870725,3575870740,15
2,840,18687,3575870725,3575870740,15
2,840,18688,3575870725,3575870740,15
2,840,18689,3575870725,3575870740,15
2,840,18690,3575870725,3575870744,19
2,840,18691,3575870725,3575870744,19
2,840,18692,3575870725,3575870745,20
2,840,18693,3575870725,3575870746,21
2,840,18694,3575870725,3575870747,22
2,840,18695,3575870725,3575870748,23
2,840,18696,3575870725,3575870748,23
2,840,18697,3575870725,3575870748,23
2,840,18698,3575870725,3575870748,23
2,840,18699,3575870725,3575870749,24
2,840,18700,3575870725,3575870751,26
2,840,18701,3575870725,3575870752,27
2,840,18702,3575870725,3575870753,28
2,840,18703,3575870725,3575870756,31
2,840,18704,3575870725,3575870756,31
2,840,18705,3575870725,3575870757,32
2,840,18706,3575870725,3575870759,34
2,840,18707,3575870725,3575870760,35
2,840,18708,3575870725,3575870761,36
2,840,18709,3575870725,3575870761,36
2,840,18710,3575870725,3575870762,37
2,840,18711,3575870725,3575870767,42
2,840,18712,3575870725,3575870768,43
2,840,18713,3575870725,3575870769,44
2,840,18714,3575870725,3575870769,44
2,840,18715,3575870725,3575870769,44
2,840,18716,3575870725,3575870772,47
2,841,18717,3575870783,3575870783,0
2,841,18718,3575870783,3575870783,0
2,841,18719,3575870783,3575870783,0
2,841,18720,3575870783,3575870783,0
2,841,18721,3575870783,3575870783,0
2,841,18722,3575870783,3575870783,0
2,841,18723,3575870783,3575870783,0
2,841,18724,3575870783,3575870783,0
2,841,18725,3575870783,3575870783,0
2,841,18726,3575870783,3575870783,0
2,841,18727,3575870783,3575870783,0
2,841,18728,3575870783,3575870784,1
2,841,18729,3575870783,3575870785,2
2,841,18730,3575870783,3575870785,2
2,841,18731,3575870783,3575870786,3
2,841,18732,3575870783,3575870787,4
2,841,18733,3575870783,3575870787,4
2,841,18734,3575870783,3575870789,6
2,841,18735,3575870783,3575870790,7
2,841,18736,3575870783,3575870790,7
2,841,18737,3575870783,3575870794,11
2,841,18738,3575870783,3575870796,13
2,841,18739,3575870783,3575870796,13
2,841,18740,3575870783,3575870797,14
2,841,18741,3575870783,3575870797,14
2,841,18742,3575870783,3575870799,16
2,841,18743,3575870783,3575870799,16
2,841,18744,3575870783,3575870799,16
2,841,18745,3575870783,3575870803,20
2,841,18746,3575870783,3575870804,21
2,841,18747,3575870783,3575870804,21
2,841,18748,3575870783,3575870806,23
2,841,18749,3575870783,3575870806,23
2,841,18750,3575870783,3575870808,25
2,841,18751,3575870783,3575870809,26
2,841,18752,3575870783,3575870811,28
2,841,18753,3575870783,3575870811,28
2,841,18754,3575870783,3575870811,28
2,841,18755,3575870783,3575870813,30
2,841,18756,3575870783,3575870821,38
2,841,18757,3575870783,3575870822,39
2,841,18758,3575870783,3575870823,40
2,841,18759,3575870783,3575870824,41
2,841,18760,3575870783,3575870825,42
2,841,18761,3575870783,3575870826,43
2,841,18762,3575870783,3575870828,45
2,841,18763,3575870783,3575870828,45
2,841,18764,3575870783,3575870829,46
2,841,18765,3575870783,3575870832,49
2,842,18766,3575870842,3575870842,0
2,842,18767,3575870842,3575870842,0
2,842,18768,3575870842,3575870842,0
2,842,18769,3575870842,3575870842,0
2,842,18770,3575870842,3575870842,0
2,842,18771,3575870842,3575870842,0
2,842,18772,3575870842,3575870842,0
2,842,18773,3575870842,3575870842,0
2,842,18774,3575870842,3575870842,0
2,842,18775,3575870842,3575870844,2
2,842,18776,3575870842,3575870844,2
2,842,18777,3575870842,3575870845,3
2,842,18778,3575870842,3575870845,3
2,842,18779,3575870842,3575870845,3
2,842,18780,3575870842,3575870849,7
2,842,18781,3575870842,3575870851,9
2,842,18782,3575870842,3575870852,10
2,842,18783,3575870842,3575870853,11
2,842,18784,3575870842,3575870854,12
2,842,18785,3575870842,3575870855,13
2,842,18786,3575870842,3575870855,13
2,842,18787,3575870842,3575870856,14
2,842,18788,3575870842,3575870856,14
2,842,18789,3575870842,3575870856,14
2,842,18790,3575870842,3575870858,16
2,842,18791,3575870842,3575870861,19
2,842,18792,3575870842,3575870861,19
2,842,18793,3575870842,3575870861,19
2,842,18794,3575870842,3575870863,21
2,842,18795,3575870842,3575870866,24
2,842,18796,3575870842,3575870867,25
2,842,18797,3575870842,3575870870,28
2,842,18798,3575870842,3575870873,31
2,842,18799,3575870842,3575870876,34
2,842,18800,3575870842,3575870878,36
2,842,18801,3575870842,3575870878,36
2,842,18802,3575870842,3575870878,36
2,842,18803,3575870842,3575870878,36
2,842,18804,3575870842,3575870880,38
2,842,18805,3575870842,3575870880,38
2,842,18806,3575870842,3575870880,38
2,842,18807,3575870842,3575870882,40
2,842,18808,3575870842,3575870882,40
2,842,18809,3575870842,3575870882,40
2,842,18810,3575870842,3575870882,40
2,842,18811,3575870842,3575870883,41
2,842,18812,3575870842,3575870883,41
2,842,18813,3575870842,3575870884,42
2,842,18814,3575870842,3575870885,43
2,842,18815,3575870842,3575870885,43
2,842,18816,3575870842,3575870886,44
2,842,18817,3575870842,3575870887,45
2,842,18818,3575870842,3575870887,45
2,842,18819,3575870842,3575870888,46
2,842,18820,3575870842,3575870888,46
2,842,18821,3575870842,3575870889,47
2,842,18822,3575870842,3575870889,47
2,842,18823,3575870842,3575870890,48
2,842,18824,3575870842,3575870891,49
2,842,18825,3575870842,3575870892,50
2,843,18826,3575870902,3575870902,0
2,843,18827,3575870902,3575870902,0
2,843,18828,3575870902,3575870902,0
2,843,18829,3575870902,3575870902,0
2,843,18830,3575870902,3575870902,0
2,843,18831,3575870902,3575870902,0
2,843,18832,3575870902,3575870902,0
2,843,18833,3575870902,3575870902,0
2,843,18834,3575870902,3575870902,0
2,843,18835,3575870902,3575870902,0
2,843,18836,3575870902,3575870902,0
2,843,18837,3575870902,3575870902,0
2,843,18838,3575870902,3575870902,0
2,843,18839,3575870902,3575870902,0
2,843,18840,3575870902,3575870903,1
2,843,18841,3575870902,3575870903,1
2,843,18842,3575870902,3575870904,2
2,843,18843,3575870902,3575870904,2
2,843,18844,3575870902,3575870905,3
2,843,18845,3575870902,3575870907,5
2,843,18846,3575870902,3575870908,6
2,843,18847,3575870902,3575870908,6
2,843,18848,3575870902,3575870908,6
2,843,18849,3575870902,3575870909,7
2,843,18850,3575870902,3575870910,8
2,843,18851,3575870902,3575870910,8
2,843,18852,3575870902,3575870911,9
2,843,18853,3575870902,3575870915,13
2,843,18854,3575870902,3575870916,14
2,843,18855,3575870902,3575870916,14
2,843,18856,3575870902,3575870917,15
2,843,18857,3575870902,3575870917,15
2,843,18858,3575870902,3575870918,16
2,843,18859,3575870902,3575870919,17
2,843,18860,3575870902,3575870920,18
2,843,18861,3575870902,3575870921,19
2,843,18862,3575870902,3575870923,21
2,843,18863,3575870902,3575870923,21
2,843,18864,3575870902,3575870926,24
2,843,18865,3575870902,3575870926,24
2,843,18866,3575870902,3575870928,26
2,843,18867,3575870902,3575870928,26
2,843,18868,3575870902,3575870929,27
2,843,18869,3575870902,3575870930,28
2,843,18870,3575870902,3575870931,29
2,843,18871,3575870902,3575870932,30
2,843,18872,3575870902,3575870933,31
2,843,18873,3575870902,3575870933,31
2,843,18874,3575870902,3575870934,32
2,843,18875,3575870902,3575870935,33
2,843,18876,3575870902,3575870935,33
2,843,18877,3575870902,3575870936,34
2,843,18878,3575870902,3575870939,37
2,843,18879,3575870902,3575870940,38
2,843,18880,3575870902,3575870940,38
2,843,18881,3575870902,3575870940,38
2,843,18882,3575870902,3575870941,39
2,843,18883,3575870902,3575870944,42
2,843,18884,3575870902,3575870945,43
2,843,18885,3575870902,3575870946,44
2,843,18886,3575870902,3575870948,46
2,843,18887,3575870902,3575870948,46
2,843,18888,3575870902,3575870948,46
2,843,18889,3575870902,3575870948,46
2,843,18890,3575870902,3575870949,47
2,843,18891,3575870902,3575870949,47
2,843,18892,3575870902,3575870951,49
2,843,18893,3575870902,3575870952,50
2,844,18894,3575870961,3575870961,0
2,844,18895,3575870961,3575870961,0
2,844,18896,3575870961,3575870961,0
2,844,18897,3575870961,3575870961,0
2,844,18898,3575870961,3575870961,0
2,844,18899,3575870961,3575870961,0
2,844,18900,3575870961,3575870961,0
2,844,18901,3575870961,3575870961,0
2,844,18902,3575870961,3575870962,1
2,844,18903,3575870961,3575870967,6
2,844,18904,3575870961,3575870968,7
2,844,18905,3575870961,3575870968,7
2,844,18906,3575870961,3575870969,8
2,844,18907,3575870961,3575870969,8
2,844,18908,3575870961,3575870976,15
2,844,18909,3575870961,3575870979,18
2,844,18910,3575870961,3575870979,18
2,844,18911,3575870961,3575870980,19
2,844,18912,3575870961,3575870980,19
2,844,18913,3575870961,3575870981,20
2,844,18914,3575870961,3575870981,20
2,844,18915,3575870961,3575870981,20
2,844,18916,3575870961,3575870982,21
2,844,18917,3575870961,3575870983,22
2,844,18918,3575870961,3575870983,22
2,844,18919,3575870961,3575870985,24
2,844,18920,3575870961,3575870985,24
2,844,18921,3575870961,3575870985,24
2,844,18922,3575870961,3575870987,26
2,844,18923,3575870961,3575870987,26
2,844,18924,3575870961,3575870988,27
2,844,18925,3575870961,3575870990,29
2,844,18926,3575870961,3575870990,29
2,844,18927,3575870961,3575870994,33
2,844,18928,3575870961,3575870994,33
2,844,18929,3575870961,3575870995,34
2,844,18930,3575870961,3575870996,35
2,844,18931,3575870961,3575870998,37
2,844,18932,3575870961,3575870998,37
2,844,18933,3575870961,3575870998,37
2,844,18934,3575870961,3575870998,37
2,844,18935,3575870961,3575870999,38
2,844,18936,3575870961,3575870999,38
2,844,18937,3575870961,3575871000,39
2,844,18938,3575870961,3575871003,42
2,844,18939,3575870961,3575871004,43
2,844,18940,3575870961,3575871004,43
2,844,18941,3575870961,3575871007,46
2,844,18942,3575870961,3575871008,47
2,844,18943,3575870961,3575871009,48
2,844,18944,3575870961,3575871010,49
2,845,18945,3575871021,3575871022,1
2,845,18946,3575871021,3575871022,1
2,845,18947,3575871021,3575871022,1
2,845,18948,3575871021,3575871022,1
2,845,18949,3575871021,3575871023,2
2,845,18950,3575871021,3575871023,2
2,845,18951,3575871021,3575871023,2
2,845,18952,3575871021,3575871024,3
2,845,18953,3575871021,3575871025,4
2,845,18954,3575871021,3575871027,6
2,845,18955,3575871021,3575871028,7
2,845,18956,3575871021,3575871029,8
2,845,18957,3575871021,3575871029,8
2,845,18958,3575871021,3575871032,11
2,845,18959,3575871021,3575871035,14
2,845,18960,3575871021,3575871035,14
2,845,18961,3575871021,3575871036,15
2,845,18962,3575871021,3575871037,16
2,845,18963,3575871021,3575871038,17
2,845,18964,3575871021,3575871040,19
2,845,18965,3575871021,3575871040,19
2,845,18966,3575871021,3575871041,20
2,845,18967,3575871021,3575871044,23
2,845,18968,3575871021,3575871044,23
2,845,18969,3575871021,3575871044,23
2,845,18970,3575871021,3575871045,24
2,845,18971,3575871021,3575871045,24
2,845,18972,3575871021,3575871045,24
2,845,18973,3575871021,3575871049,28
2,845,18974,3575871021,3575871051,30
2,845,18975,3575871021,3575871052,31
2,845,18976,3575871021,3575871054,33
2,845,18977,3575871021,3575871054,33
2,845,18978,3575871021,3575871055,34
2,845,18979,3575871021,3575871056,35
2,845,18980,3575871021,3575871056,35
2,845,18981,3575871021,3575871056,35
2,845,18982,3575871021,3575871059,38
2,845,18983,3575871021,3575871061,40
2,845,18984,3575871021,3575871062,41
2,845,18985,3575871021,3575871062,41
2,845,18986,3575871021,3575871063,42
2,845,18987,3575871021,3575871066,45
2,845,18988,3575871021,3575871067,46
2,845,18989,3575871021,3575871069,48
2,845,18990,3575871021,3575871070,49
2,846,18991,3575871079,3575871079,0
2,846,18992,3575871079,3575871079,0
2,846,18993,3575871079,3575871079,0
2,846,18994,3575871079,3575871079,0
2,846,18995,3575871079,3575871079,0
2,846,18996,3575871079,3575871080,1
2,846,18997,3575871079,3575871080,1
2,846,18998,3575871079,3575871082,3
2,846,18999,3575871079,3575871082,3
2,846,19000,3575871079,3575871082,3
2,846,19001,3575871079,3575871083,4
2,846,19002,3575871079,3575871083,4
2,846,19003,3575871079,3575871083,4
2,846,19004,3575871079,3575871084,5
2,846,19005,3575871079,3575871085,6
2,846,19006,3575871079,3575871085,6
2,846,19007,3575871079,3575871086,7
2,846,19008,3575871079,3575871086,7
2,846,19009,3575871079,3575871087,8
2,846,19010,3575871079,3575871089,10
2,846,19011,3575871079,3575871089,10
2,846,19012,3575871079,3575871089,10
2,846,19013,3575871079,3575871091,12
2,846,19014,3575871079,3575871091,12
2,846,19015,3575871079,3575871091,12
2,846,19016,3575871079,3575871092,13
2,846,19017,3575871079,3575871094,15
2,846,19018,3575871079,3575871096,17
2,846,19019,3575871079,3575871096,17
2,846,19020,3575871079,3575871097,18
2,846,19021,3575871079,3575871097,18
2,846,19022,3575871079,3575871097,18
2,846,19023,3575871079,3575871100,21
2,846,19024,3575871079,3575871100,21
2,846,19025,3575871079,3575871100,21
2,846,19026,3575871079,3575871101,22
2,846,19027,3575871079,3575871102,23
2,846,19028,3575871079,3575871102,23
2,846,19029,3575871079,3575871102,23
2,846,19030,3575871079,3575871103,24
2,846,19031,3575871079,3575871104,25
2,846,19032,3575871079,3575871105,26
2,846,19033,3575871079,3575871105,26
2,846,19034,3575871079,3575871107,28
2,846,19035,3575871079,3575871108,29
2,846,19036,3575871079,3575871108,29
2,846,19037,3575871079,3575871108,29
2,846,19038,3575871079,3575871109,30
2,846,19039,3575871079,3575871110,31
2,846,19040,3575871079,3575871110,31
2,846,19041,3575871079,3575871111,32
2,846,19042,3575871079,3575871114,35
2,846,19043,3575871079,3575871115,36
2,846,19044,3575871079,3575871116,37
2,846,19045,3575871079,3575871118,39
2,846,19046,3575871079,3575871119,40
2,846,19047,3575871079,3575871120,41
2,846,19048,3575871079,3575871121,42
2,846,19049,3575871079,3575871121,42
2,846,19050,3575871079,3575871123,44
2,846,19051,3575871079,3575871123,44
2,846,19052,3575871079,3575871124,45
2,846,19053,3575871079,3575871126,47
2,846,19054,3575871079,3575871126,47
2,846,19055,3575871079,3575871127,48
2,846,19056,3575871079,3575871128,49
2,847,19057,3575871139,3575871139,0
2,847,19058,3575871139,3575871139,0
2,847,19059,3575871139,3575871139,0
2,847,19060,3575871139,3575871139,0
2,847,19061,3575871139,3575871139,0
2,847,19062,3575871139,3575871139,0
2,847,19063,3575871139,3575871139,0
2,847,19064,3575871139,3575871139,0
2,847,19065,3575871139,3575871139,0
2,847,19066,3575871139,3575871139,0
2,847,19067,3575871139,3575871139,0
2,847,19068,3575871139,3575871139,0
2,847,19069,3575871139,3575871139,0
2,847,19070,3575871139,3575871140,1
2,847,19071,3575871139,3575871141,2
2,847,19072,3575871139,3575871141,2
2,847,19073,3575871139,3575871144,5
2,847,19074,3575871139,3575871145,6
2,847,19075,3575871139,3575871145,6
2,847,19076,3575871139,3575871148,9
2,847,19077,3575871139,3575871148,9
2,847,19078,3575871139,3575871148,9
2,847,19079,3575871139,3575871148,9
2,847,19080,3575871139,3575871149,10
2,847,19081,3575871139,3575871149,10
2,847,19082,3575871139,3575871149,10
2,847,19083,3575871139,3575871150,11
2,847,19084,3575871139,3575871151,12
2,847,19085,3575871139,3575871152,13
2,847,19086,3575871139,3575871153,14
2,847,19087,3575871139,3575871154,15
2,847,19088,3575871139,3575871156,17
2,847,19089,3575871139,3575871156,17
2,847,19090,3575871139,3575871160,21
2,847,19091,3575871139,3575871160,21
2,847,19092,3575871139,3575871161,22
2,847,19093,3575871139,3575871162,23
2,847,19094,3575871139,3575871168,29
2,847,19095,3575871139,3575871168,29
2,847,19096,3575871139,3575871169,30
2,847,19097,3575871139,3575871170,31
2,847,19098,3575871139,3575871172,33
2,847,19099,3575871139,3575871174,35
2,847,19100,3575871139,3575871175,36
2,847,19101,3575871139,3575871179,40
2,847,19102,3575871139,3575871180,41
2,847,19103,3575871139,3575871180,41
2,847,19104,3575871139,3575871181,42
2,847,19105,3575871139,3575871181,42
2,847,19106,3575871139,3575871181,42
2,847,19107,3575871139,3575871182,43
2,847,19108,3575871139,3575871183,44
2,847,19109,3575871139,3575871184,45
2,847,19110,3575871139,3575871184,45
2,847,19111,3575871139,3575871185,46
2,847,19112,3575871139,3575871185,46
2,847,19113,3575871139,3575871187,48
2,847,19114,3575871139,3575871187,48
2,847,19115,3575871139,3575871188,49
2,847,19116,3575871139,3575871188,49
2,848,19117,3575871198,3575871198,0
2,848,19118,3575871198,3575871198,0
2,848,19119,3575871198,3575871198,0
2,848,19120,3575871198,3575871198,0
2,848,19121,3575871198,3575871198,0
2,848,19122,3575871198,3575871198,0
2,848,19123,3575871198,3575871198,0
2,848,19124,3575871198,3575871198,0
2,848,19125,3575871198,3575871199,1
2,848,19126,3575871198,3575871199,1
2,848,19127,3575871198,3575871200,2
2,848,19128,3575871198,3575871200,2
2,848,19129,3575871198,3575871200,2
2,848,19130,3575871198,3575871203,5
2,848,19131,3575871198,3575871205,7
2,848,19132,3575871198,3575871205,7
2,848,19133,3575871198,3575871205,7
2,848,19134,3575871198,3575871207,9
2,848,19135,3575871198,3575871208,10
2,848,19136,3575871198,3575871208,10
2,848,19137,3575871198,3575871210,12
2,848,19138,3575871198,3575871211,13
2,848,19139,3575871198,3575871212,14
2,848,19140,3575871198,3575871212,14
2,848,19141,3575871198,3575871214,16
2,848,19142,3575871198,3575871222,24
2,848,19143,3575871198,3575871222,24
2,848,19144,3575871198,3575871223,25
2,848,19145,3575871198,3575871223,25
2,848,19146,3575871198,3575871225,27
2,848,19147,3575871198,3575871227,29
2,848,19148,3575871198,3575871227,29
2,848,19149,3575871198,3575871229,31
2,848,19150,3575871198,3575871230,32
2,848,19151,3575871198,3575871232,34
2,848,19152,3575871198,3575871235,37
2,848,19153,3575871198,3575871236,38
2,848,19154,3575871198,3575871236,38
2,848,19155,3575871198,3575871237,39
2,848,19156,3575871198,3575871238,40
2,848,19157,3575871198,3575871240,42
2,848,19158,3575871198,3575871240,42
2,848,19159,3575871198,3575871242,44
2,848,19160,3575871198,3575871244,46
2,848,19161,3575871198,3575871244,46
2,848,19162,3575871198,3575871245,47
2,848,19163,3575871198,3575871245,47
2,848,19164,3575871198,3575871245,47
2,848,19165,3575871198,3575871245,47
2,849,19166,3575871261,3575871261,0
2,849,19167,3575871261,3575871261,0
2,849,19168,3575871261,3575871261,0
2,849,19169,3575871261,3575871261,0
2,849,19170,3575871261,3575871261,0
2,849,19171,3575871261,3575871261,0
2,849,19172,3575871261,3575871261,0
2,849,19173,3575871261,3575871261,0
2,849,19174,3575871261,3575871261,0
2,849,19175,3575871261,3575871261,0
2,849,19176,3575871261,3575871261,0
2,849,19177,3575871261,3575871261,0
2,849,19178,3575871261,3575871261,0
2,849,19179,3575871261,3575871262,1
2,849,19180,3575871261,3575871263,2
2,849,19181,3575871261,3575871267,6
2,849,19182,3575871261,3575871267,6
2,849,19183,3575871261,3575871270,9
2,849,19184,3575871261,3575871273,12
2,849,19185,3575871261,3575871276,15
2,849,19186,3575871261,3575871278,17
2,849,19187,3575871261,3575871279,18
2,849,19188,3575871261,3575871280,19
2,849,19189,3575871261,3575871280,19
2,849,19190,3575871261,3575871280,19
2,849,19191,3575871261,3575871282,21
2,849,19192,3575871261,3575871282,21
2,849,19193,3575871261,3575871282,21
2,849,19194,3575871261,3575871283,22
2,849,19195,3575871261,3575871283,22
2,849,19196,3575871261,3575871284,23
2,849,19197,3575871261,3575871285,24
2,849,19198,3575871261,3575871285,24
2,849,19199,3575871261,3575871286,25
2,849,19200,3575871261,3575871286,25
2,849,19201,3575871261,3575871287,26
2,849,19202,3575871261,3575871288,27
2,849,19203,3575871261,3575871289,28
2,849,19204,3575871261,3575871289,28
2,849,19205,3575871261,3575871290,29
2,849,19206,3575871261,3575871291,30
2,849,19207,3575871261,3575871292,31
2,849,19208,3575871261,3575871292,31
2,849,19209,3575871261,3575871293,32
2,849,19210,3575871261,3575871297,36
2,849,19211,3575871261,3575871297,36
2,849,19212,3575871261,3575871297,36
2,849,19213,3575871261,3575871297,36
2,849,19214,3575871261,3575871298,37
2,849,19215,3575871261,3575871299,38
2,849,19216,3575871261,3575871299,38
2,849,19217,3575871261,3575871300,39
2,849,19218,3575871261,3575871300,39
2,849,19219,3575871261,3575871301,40
2,849,19220,3575871261,3575871302,41
2,849,19221,3575871261,3575871302,41
2,849,19222,3575871261,3575871303,42
2,849,19223,3575871261,3575871304,43
2,849,19224,3575871261,3575871305,44
2,849,19225,3575871261,3575871306,45
2,849,19226,3575871261,3575871307,46
2,849,19227,3575871261,3575871308,47
2,849,19228,3575871261,3575871308,47
2,849,19229,3575871261,3575871310,49
2,849,19230,3575871261,3575871310,49
2,849,19231,3575871261,3575871311,50
2,850,19232,3575871321,3575871321,0
2,850,19233,3575871321,3575871321,0
2,850,19234,3575871321,3575871321,0
2,850,19235,3575871321,3575871321,0
2,850,19236,3575871321,3575871321,0
2,850,19237,3575871321,3575871321,0
2,850,19238,3575871321,3575871321,0
2,850,19239,3575871321,3575871321,0
2,850,19240,3575871321,3575871321,0
2,850,19241,3575871321,3575871321,0
2,850,19242,3575871321,3575871321,0
2,850,19243,3575871321,3575871322,1
2,850,19244,3575871321,3575871323,2
2,850,19245,3575871321,3575871324,3
2,850,19246,3575871321,3575871327,6
2,850,19247,3575871321,3575871327,6
2,850,19248,3575871321,3575871327,6
2,850,19249,3575871321,3575871328,7
2,850,19250,3575871321,3575871329,8
2,850,19251,3575871321,3575871331,10
2,850,19252,3575871321,3575871331,10
2,850,19253,3575871321,3575871331,10
2,850,19254,3575871321,3575871332,11
2,850,19255,3575871321,3575871332,11
2,850,19256,3575871321,3575871332,11
2,850,19257,3575871321,3575871333,12
2,850,19258,3575871321,3575871334,13
2,850,19259,3575871321,3575871334,13
2,850,19260,3575871321,3575871335,14
2,850,19261,3575871321,3575871336,15
2,850,19262,3575871321,3575871339,18
2,850,19263,3575871321,3575871339,18
2,850,19264,3575871321,3575871341,20
2,850,19265,3575871321,3575871341,20
2,850,19266,3575871321,3575871341,20
2,850,19267,3575871321,3575871345,24
2,850,19268,3575871321,3575871345,24
2,850,19269,3575871321,3575871345,24
2,850,19270,3575871321,3575871348,27
2,850,19271,3575871321,3575871348,27
2,850,19272,3575871321,3575871348,27
2,850,19273,3575871321,3575871348,27
2,850,19274,3575871321,3575871349,28
2,850,19275,3575871321,3575871349,28
2,850,19276,3575871321,3575871350,29
2,850,19277,3575871321,3575871352,31
2,850,19278,3575871321,3575871356,35
2,850,19279,3575871321,3575871357,36
2,850,19280,3575871321,3575871360,39
2,850,19281,3575871321,3575871361,40
2,850,19282,3575871321,3575871361,40
2,850,19283,3575871321,3575871361,40
2,850,19284,3575871321,3575871362,41
2,850,19285,3575871321,3575871362,41
2,850,19286,3575871321,3575871367,46
2,850,19287,3575871321,3575871367,46
2,850,19288,3575871321,3575871368,47
2,850,19289,3575871321,3575871368,47
2,850,19290,3575871321,3575871369,48
2,850,19291,3575871321,3575871370,49
2,851,19292,3575871380,3575871380,0
2,851,19293,3575871380,3575871380,0
2,851,19294,3575871380,3575871380,0
2,851,19295,3575871380,3575871380,0
2,851,19296,3575871380,3575871381,1
2,851,19297,3575871380,3575871381,1
2,851,19298,3575871380,3575871381,1
2,851,19299,3575871380,3575871381,1
2,851,19300,3575871380,3575871382,2
2,851,19301,3575871380,3575871383,3
2,851,19302,3575871380,3575871383,3
2,851,19303,3575871380,3575871384,4
2,851,19304,3575871380,3575871385,5
2,851,19305,3575871380,3575871385,5
2,851,19306,3575871380,3575871385,5
2,851,19307,3575871380,3575871388,8
2,851,19308,3575871380,3575871388,8
2,851,19309,3575871380,3575871392,12
2,851,19310,3575871380,3575871392,12
2,851,19311,3575871380,3575871393,13
2,851,19312,3575871380,3575871393,13
2,851,19313,3575871380,3575871395,15
2,851,19314,3575871380,3575871395,15
2,851,19315,3575871380,3575871396,16
2,851,19316,3575871380,3575871398,18
2,851,19317,3575871380,3575871398,18
2,851,19318,3575871380,3575871399,19
2,851,19319,3575871380,3575871399,19
2,851,19320,3575871380,3575871399,19
2,851,19321,3575871380,3575871400,20
2,851,19322,3575871380,3575871400,20
2,851,19323,3575871380,3575871404,24
2,851,19324,3575871380,3575871405,25
2,851,19325,3575871380,3575871405,25
2,851,19326,3575871380,3575871405,25
2,851,19327,3575871380,3575871407,27
2,851,19328,3575871380,3575871407,27
2,851,19329,3575871380,3575871408,28
2,851,19330,3575871380,3575871409,29
2,851,19331,3575871380,3575871409,29
2,851,19332,3575871380,3575871412,32
2,851,19333,3575871380,3575871412,32
2,851,19334,3575871380,3575871413,33
2,851,19335,3575871380,3575871414,34
2,851,19336,3575871380,3575871422,42
2,851,19337,3575871380,3575871423,43
2,851,19338,3575871380,3575871423,43
2,851,19339,3575871380,3575871423,43
2,851,19340,3575871380,3575871425,45
2,851,19341,3575871380,3575871426,46
2,851,19342,3575871380,3575871427,47
2,851,19343,3575871380,3575871427,47
2,851,19344,3575871380,3575871429,49
2,851,19345,3575871380,3575871430,50
2,852,19346,3575871439,3575871439,0
2,852,19347,3575871439,3575871439,0
2,852,19348,3575871439,3575871439,0
2,852,19349,3575871439,3575871439,0
2,852,19350,3575871439,3575871439,0
2,852,19351,3575871439,3575871439,0
2,852,19352,3575871439,3575871439,0
2,852,19353,3575871439,3575871440,1
2,852,19354,3575871439,3575871440,1
2,852,19355,3575871439,3575871444,5
2,852,19356,3575871439,3575871444,5
2,852,19357,3575871439,3575871445,6
2,852,19358,3575871439,3575871445,6
2,852,19359,3575871439,3575871445,6
2,852,19360,3575871439,3575871446,7
2,852,19361,3575871439,3575871450,11
2,852,19362,3575871439,3575871452,13
2,852,19363,3575871439,3575871453,14
2,852,19364,3575871439,3575871454,15
2,852,19365,3575871439,3575871454,15
2,852,19366,3575871439,3575871456,17
2,852,19367,3575871439,3575871456,17
2,852,19368,3575871439,3575871457,18
2,852,19369,3575871439,3575871457,18
2,852,19370,3575871439,3575871459,20
2,852,19371,3575871439,3575871461,22
2,852,19372,3575871439,3575871462,23
2,852,19373,3575871439,3575871462,23
2,852,19374,3575871439,3575871463,24
2,852,19375,3575871439,3575871467,28
2,852,19376,3575871439,3575871471,32
2,852,19377,3575871439,3575871474,35
2,852,19378,3575871439,3575871476,37
2,852,19379,3575871439,3575871478,39
2,852,19380,3575871439,3575871479,40
2,852,19381,3575871439,3575871480,41
2,852,19382,3575871439,3575871480,41
2,852,19383,3575871439,3575871480,41
2,852,19384,3575871439,3575871483,44
2,852,19385,3575871439,3575871483,44
2,852,19386,3575871439,3575871483,44
2,852,19387,3575871439,3575871483,44
2,852,19388,3575871439,3575871484,45
2,852,19389,3575871439,3575871484,45
2,852,19390,3575871439,3575871485,46
2,852,19391,3575871439,3575871485,46
2,852,19392,3575871439,3575871486,47
2,852,19393,3575871439,3575871486,47
2,852,19394,3575871439,3575871488,49
2,852,19395,3575871439,3575871489,50
2,852,19396,3575871439,3575871489,50
2,853,19397,3575871498,3575871498,0
2,853,19398,3575871498,3575871498,0
2,853,19399,3575871498,3575871498,0
2,853,19400,3575871498,3575871498,0
2,853,19401,3575871498,3575871498,0
2,853,19402,3575871498,3575871498,0
2,853,19403,3575871498,3575871498,0
2,853,19404,3575871498,3575871498,0
2,853,19405,3575871498,3575871498,0
2,853,19406,3575871498,3575871498,0
2,853,19407,3575871498,3575871498,0
2,853,19408,3575871498,3575871498,0
2,853,19409,3575871498,3575871499,1
2,853,19410,3575871498,3575871499,1
2,853,19411,3575871498,3575871500,2
2,853,19412,3575871498,3575871501,3
2,853,19413,3575871498,3575871501,3
2,853,19414,3575871498,3575871503,5
2,853,19415,3575871498,3575871504,6
2,853,19416,3575871498,3575871504,6
2,853,19417,3575871498,3575871505,7
2,853,19418,3575871498,3575871506,8
2,853,19419,3575871498,3575871507,9
2,853,19420,3575871498,3575871507,9
2,853,19421,3575871498,3575871508,10
2,853,19422,3575871498,3575871509,11
2,853,19423,3575871498,3575871511,13
2,853,19424,3575871498,3575871512,14
2,853,19425,3575871498,3575871513,15
2,853,19426,3575871498,3575871514,16
2,853,19427,3575871498,3575871514,16
2,853,19428,3575871498,3575871515,17
2,853,19429,3575871498,3575871517,19
2,853,19430,3575871498,3575871517,19
2,853,19431,3575871498,3575871518,20
2,853,19432,3575871498,3575871518,20
2,853,19433,3575871498,3575871519,21
2,853,19434,3575871498,3575871519,21
2,853,19435,3575871498,3575871522,24
2,853,19436,3575871498,3575871523,25
2,853,19437,3575871498,3575871523,25
2,853,19438,3575871498,3575871523,25
2,853,19439,3575871498,3575871525,27
2,853,19440,3575871498,3575871526,28
2,853,19441,3575871498,3575871527,29
2,853,19442,3575871498,3575871528,30
2,853,19443,3575871498,3575871530,32
2,853,19444,3575871498,3575871530,32
2,853,19445,3575871498,3575871530,32
2,853,19446,3575871498,3575871530,32
2,853,19447,3575871498,3575871531,33
2,853,19448,3575871498,3575871533,35
2,853,19449,3575871498,3575871533,35
2,853,19450,3575871498,3575871533,35
2,853,19451,3575871498,3575871533,35
2,853,19452,3575871498,3575871539,41
2,853,19453,3575871498,3575871540,42
2,853,19454,3575871498,3575871540,42
2,853,19455,3575871498,3575871540,42
2,853,19456,3575871498,3575871541,43
2,853,19457,3575871498,3575871544,46
2,853,19458,3575871498,3575871544,46
2,853,19459,3575871498,3575871544,46
2,853,19460,3575871498,3575871547,49
2,853,19461,3575871498,3575871547,49
2,853,19462,3575871498,3575871547,49
2,853,19463,3575871498,3575871548,50
2,854,19464,3575871558,3575871558,0
2,854,19465,3575871558,3575871558,0
2,854,19466,3575871558,3575871558,0
2,854,19467,3575871558,3575871558,0
2,854,19468,3575871558,3575871558,0
2,854,19469,3575871558,3575871558,0
2,854,19470,3575871558,3575871558,0
2,854,19471,3575871558,3575871558,0
2,854,19472,3575871558,3575871558,0
2,854,19473,3575871558,3575871559,1
2,854,19474,3575871558,3575871560,2
2,854,19475,3575871558,3575871562,4
2,854,19476,3575871558,3575871562,4
2,854,19477,3575871558,3575871567,9
2,854,19478,3575871558,3575871567,9
2,854,19479,3575871558,3575871567,9
2,854,19480,3575871558,3575871568,10
2,854,19481,3575871558,3575871568,10
2,854,19482,3575871558,3575871569,11
2,854,19483,3575871558,3575871572,14
2,854,19484,3575871558,3575871573,15
2,854,19485,3575871558,3575871578,20
2,854,19486,3575871558,3575871579,21
2,854,19487,3575871558,3575871580,22
2,854,19488,3575871558,3575871581,23
2,854,19489,3575871558,3575871582,24
2,854,19490,3575871558,3575871582,24
2,854,19491,3575871558,3575871582,24
2,854,19492,3575871558,3575871583,25
2,854,19493,3575871558,3575871584,26
2,854,19494,3575871558,3575871584,26
2,854,19495,3575871558,3575871586,28
2,854,19496,3575871558,3575871587,29
2,854,19497,3575871558,3575871587,29
2,854,19498,3575871558,3575871588,30
2,854,19499,3575871558,3575871588,30
2,854,19500,3575871558,3575871591,33
2,854,19501,3575871558,3575871592,34
2,854,19502,3575871558,3575871593,35
2,854,19503,3575871558,3575871594,36
2,854,19504,3575871558,3575871594,36
2,854,19505,3575871558,3575871596,38
2,854,19506,3575871558,3575871597,39
2,854,19507,3575871558,3575871597,39
2,854,19508,3575871558,3575871598,40
2,854,19509,3575871558,3575871599,41
2,854,19510,3575871558,3575871599,41
2,854,19511,3575871558,3575871600,42
2,854,19512,3575871558,3575871602,44
2,854,19513,3575871558,3575871604,46
2,854,19514,3575871558,3575871604,46
2,854,19515,3575871558,3575871606,48
2,854,19516,3575871558,3575871607,49
2,854,19517,3575871558,3575871607,49
2,854,19518,3575871558,3575871608,50
2,855,19519,3575871618,3575871618,0
2,855,19520,3575871618,3575871618,0
2,855,19521,3575871618,3575871618,0
2,855,19522,3575871618,3575871618,0
2,855,19523,3575871618,3575871620,2
2,855,19524,3575871618,3575871621,3
2,855,19525,3575871618,3575871622,4
2,855,19526,3575871618,3575871624,6
2,855,19527,3575871618,3575871625,7
2,855,19528,3575871618,3575871627,9
2,855,19529,3575871618,3575871627,9
2,855,19530,3575871618,3575871629,11
2,855,19531,3575871618,3575871629,11
2,855,19532,3575871618,3575871631,13
2,855,19533,3575871618,3575871634,16
2,855,19534,3575871618,3575871635,17
2,855,19535,3575871618,3575871636,18
2,855,19536,3575871618,3575871637,19
2,855,19537,3575871618,3575871637,19
2,855,19538,3575871618,3575871639,21
2,855,19539,3575871618,3575871639,21
2,855,19540,3575871618,3575871642,24
2,855,19541,3575871618,3575871643,25
2,855,19542,3575871618,3575871644,26
2,855,19543,3575871618,3575871645,27
2,855,19544,3575871618,3575871645,27
2,855,19545,3575871618,3575871645,27
2,855,19546,3575871618,3575871645,27
2,855,19547,3575871618,3575871649,31
2,855,19548,3575871618,3575871651,33
2,855,19549,3575871618,3575871652,34
2,855,19550,3575871618,3575871652,34
2,855,19551,3575871618,3575871654,36
2,855,19552,3575871618,3575871654,36
2,855,19553,3575871618,3575871655,37
2,855,19554,3575871618,3575871656,38
2,855,19555,3575871618,3575871656,38
2,855,19556,3575871618,3575871656,38
2,855,19557,3575871618,3575871659,41
2,855,19558,3575871618,3575871660,42
2,855,19559,3575871618,3575871661,43
2,855,19560,3575871618,3575871662,44
2,855,19561,3575871618,3575871662,44
2,855,19562,3575871618,3575871663,45
2,855,19563,3575871618,3575871665,47
2,855,19564,3575871618,3575871667,49
2,856,19565,3575871678,3575871678,0
2,856,19566,3575871678,3575871678,0
2,856,19567,3575871678,3575871678,0
2,856,19568,3575871678,3575871678,0
2,856,19569,3575871678,3575871678,0
2,856,19570,3575871678,3575871679,1
2,856,19571,3575871678,3575871679,1
2,856,19572,3575871678,3575871679,1
2,856,19573,3575871678,3575871680,2
2,856,19574,3575871678,3575871680,2
2,856,19575,3575871678,3575871681,3
2,856,19576,3575871678,3575871682,4
2,856,19577,3575871678,3575871682,4
2,856,19578,3575871678,3575871683,5
2,856,19579,3575871678,3575871684,6
2,856,19580,3575871678,3575871684,6
2,856,19581,3575871678,3575871685,7
2,856,19582,3575871678,3575871685,7
2,856,19583,3575871678,3575871685,7
2,856,19584,3575871678,3575871686,8
2,856,19585,3575871678,3575871687,9
2,856,19586,3575871678,3575871687,9
2,856,19587,3575871678,3575871688,10
2,856,19588,3575871678,3575871689,11
2,856,19589,3575871678,3575871689,11
2,856,19590,3575871678,3575871690,12
2,856,19591,3575871678,3575871691,13
2,856,19592,3575871678,3575871691,13
2,856,19593,3575871678,3575871692,14
2,856,19594,3575871678,3575871694,16
2,856,19595,3575871678,3575871695,17
2,856,19596,3575871678,3575871696,18
2,856,19597,3575871678,3575871696,18
2,856,19598,3575871678,3575871696,18
2,856,19599,3575871678,3575871697,19
2,856,19600,3575871678,3575871698,20
2,856,19601,3575871678,3575871698,20
2,856,19602,3575871678,3575871698,20
2,856,19603,3575871678,3575871699,21
2,856,19604,3575871678,3575871700,22
2,856,19605,3575871678,3575871700,22
2,856,19606,3575871678,3575871700,22
2,856,19607,3575871678,3575871701,23
2,856,19608,3575871678,3575871702,24
2,856,19609,3575871678,3575871703,25
2,856,19610,3575871678,3575871704,26
2,856,19611,3575871678,3575871705,27
2,856,19612,3575871678,3575871705,27
2,856,19613,3575871678,3575871706,28
2,856,19614,3575871678,3575871708,30
2,856,19615,3575871678,3575871708,30
2,856,19616,3575871678,3575871709,31
2,856,19617,3575871678,3575871709,31
2,856,19618,3575871678,3575871711,33
2,856,19619,3575871678,3575871713,35
2,856,19620,3575871678,3575871715,37
2,856,19621,3575871678,3575871715,37
2,856,19622,3575871678,3575871715,37
2,856,19623,3575871678,3575871716,38
2,856,19624,3575871678,3575871717,39
2,856,19625,3575871678,3575871717,39
2,856,19626,3575871678,3575871718,40
2,856,19627,3575871678,3575871719,41
2,856,19628,3575871678,3575871719,41
2,856,19629,3575871678,3575871720,42
2,856,19630,3575871678,3575871722,44
2,856,19631,3575871678,3575871723,45
2,856,19632,3575871678,3575871727,49
2,856,19633,3575871678,3575871727,49
2,856,19634,3575871678,3575871727,49
2,856,19635,3575871678,3575871727,49
2,857,19636,3575871738,3575871738,0
2,857,19637,3575871738,3575871738,0
2,857,19638,3575871738,3575871738,0
2,857,19639,3575871738,3575871738,0
2,857,19640,3575871738,3575871738,0
2,857,19641,3575871738,3575871738,0
2,857,19642,3575871738,3575871738,0
2,857,19643,3575871738,3575871738,0
2,857,19644,3575871738,3575871738,0
2,857,19645,3575871738,3575871739,1
2,857,19646,3575871738,3575871740,2
2,857,19647,3575871738,3575871740,2
2,857,19648,3575871738,3575871740,2
2,857,19649,3575871738,3575871741,3
2,857,19650,3575871738,3575871743,5
2,857,19651,3575871738,3575871744,6
2,857,19652,3575871738,3575871744,6
2,857,19653,3575871738,3575871747,9
2,857,19654,3575871738,3575871748,10
2,857,19655,3575871738,3575871749,11
2,857,19656,3575871738,3575871749,11
2,857,19657,3575871738,3575871749,11
2,857,19658,3575871738,3575871750,12
2,857,19659,3575871738,3575871751,13
2,857,19660,3575871738,3575871751,13
2,857,19661,3575871738,3575871753,15
2,857,19662,3575871738,3575871754,16
2,857,19663,3575871738,3575871756,18
2,857,19664,3575871738,3575871757,19
2,857,19665,3575871738,3575871758,20
2,857,19666,3575871738,3575871759,21
2,857,19667,3575871738,3575871760,22
2,857,19668,3575871738,3575871760,22
2,857,19669,3575871738,3575871762,24
2,857,19670,3575871738,3575871763,25
2,857,19671,3575871738,3575871766,28
2,857,19672,3575871738,3575871767,29
2,857,19673,3575871738,3575871767,29
2,857,19674,3575871738,3575871767,29
2,857,19675,3575871738,3575871768,30
2,857,19676,3575871738,3575871769,31
2,857,19677,3575871738,3575871774,36
2,857,19678,3575871738,3575871776,38
2,857,19679,3575871738,3575871778,40
2,857,19680,3575871738,3575871779,41
2,857,19681,3575871738,3575871780,42
2,857,19682,3575871738,3575871781,43
2,857,19683,3575871738,3575871782,44
2,857,19684,3575871738,3575871782,44
2,857,19685,3575871738,3575871782,44
2,857,19686,3575871738,3575871784,46
2,857,19687,3575871738,3575871785,47
2,857,19688,3575871738,3575871785,47
2,857,19689,3575871738,3575871785,47
2,857,19690,3575871738,3575871787,49
2,857,19691,3575871738,3575871787,49
2,857,19692,3575871738,3575871788,50
2,858,19693,3575871799,3575871799,0
2,858,19694,3575871799,3575871799,0
2,858,19695,3575871799,3575871799,0
2,858,19696,3575871799,3575871799,0
2,858,19697,3575871799,3575871799,0
2,858,19698,3575871799,3575871799,0
2,858,19699,3575871799,3575871799,0
2,858,19700,3575871799,3575871799,0
2,858,19701,3575871799,3575871799,0
2,858,19702,3575871799,3575871799,0
2,858,19703,3575871799,3575871799,0
2,858,19704,3575871799,3575871799,0
2,858,19705,3575871799,3575871799,0
2,858,19706,3575871799,3575871800,1
2,858,19707,3575871799,3575871803,4
2,858,19708,3575871799,3575871804,5
2,858,19709,3575871799,3575871804,5
2,858,19710,3575871799,3575871806,7
2,858,19711,3575871799,3575871806,7
2,858,19712,3575871799,3575871806,7
2,858,19713,3575871799,3575871809,10
2,858,19714,3575871799,3575871811,12
2,858,19715,3575871799,3575871812,13
2,858,19716,3575871799,3575871822,23
2,858,19717,3575871799,3575871822,23
2,858,19718,3575871799,3575871825,26
2,858,19719,3575871799,3575871826,27
2,858,19720,3575871799,3575871827,28
2,858,19721,3575871799,3575871827,28
2,858,19722,3575871799,3575871829,30
2,858,19723,3575871799,3575871830,31
2,858,19724,3575871799,3575871832,33
2,858,19725,3575871799,3575871835,36
2,858,19726,3575871799,3575871835,36
2,858,19727,3575871799,3575871837,38
2,858,19728,3575871799,3575871838,39
2,858,19729,3575871799,3575871839,40
2,858,19730,3575871799,3575871840,41
2,858,19731,3575871799,3575871841,42
2,858,19732,3575871799,3575871843,44
2,858,19733,3575871799,3575871843,44
2,858,19734,3575871799,3575871844,45
2,858,19735,3575871799,3575871844,45
2,858,19736,3575871799,3575871845,46
2,858,19737,3575871799,3575871845,46
2,859,19738,3575871857,3575871857,0
2,859,19739,3575871857,3575871857,0
2,859,19740,3575871857,3575871857,0
2,859,19741,3575871857,3575871857,0
2,859,19742,3575871857,3575871857,0
2,859,19743,3575871857,3575871857,0
2,859,19744,3575871857,3575871857,0
2,859,19745,3575871857,3575871857,0
2,859,19746,3575871857,3575871857,0
2,859,19747,3575871857,3575871859,2
2,859,19748,3575871857,3575871861,4
2,859,19749,3575871857,3575871862,5
2,859,19750,3575871857,3575871863,6
2,859,19751,3575871857,3575871863,6
2,859,19752,3575871857,3575871865,8
2,859,19753,3575871857,3575871867,10
2,859,19754,3575871857,3575871871,14
2,859,19755,3575871857,3575871872,15
2,859,19756,3575871857,3575871873,16
2,859,19757,3575871857,3575871876,19
2,859,19758,3575871857,3575871877,20
2,859,19759,3575871857,3575871879,22
2,859,19760,3575871857,3575871879,22
2,859,19761,3575871857,3575871880,23
2,859,19762,3575871857,3575871881,24
2,859,19763,3575871857,3575871882,25
2,859,19764,3575871857,3575871883,26
2,859,19765,3575871857,3575871883,26
2,859,19766,3575871857,3575871883,26
2,859,19767,3575871857,3575871884,27
2,859,19768,3575871857,3575871884,27
2,859,19769,3575871857,3575871885,28
2,859,19770,3575871857,3575871885,28
2,859,19771,3575871857,3575871886,29
2,859,19772,3575871857,3575871886,29
2,859,19773,3575871857,3575871886,29
2,859,19774,3575871857,3575871888,31
2,859,19775,3575871857,3575871888,31
2,859,19776,3575871857,3575871889,32
2,859,19777,3575871857,3575871890,33
2,859,19778,3575871857,3575871891,34
2,859,19779,3575871857,3575871891,34
2,859,19780,3575871857,3575871891,34
2,859,19781,3575871857,3575871892,35
2,859,19782,3575871857,3575871892,35
2,859,19783,3575871857,3575871894,37
2,859,19784,3575871857,3575871895,38
2,859,19785,3575871857,3575871896,39
2,859,19786,3575871857,3575871896,39
2,859,19787,3575871857,3575871898,41
2,859,19788,3575871857,3575871898,41
2,859,19789,3575871857,3575871898,41
2,859,19790,3575871857,3575871899,42
2,859,19791,3575871857,3575871900,43
2,859,19792,3575871857,3575871900,43
2,859,19793,3575871857,3575871900,43
2,859,19794,3575871857,3575871901,44
2,859,19795,3575871857,3575871902,45
2,859,19796,3575871857,3575871902,45
2,859,19797,3575871857,3575871903,46
2,859,19798,3575871857,3575871903,46
2,859,19799,3575871857,3575871904,47
2,859,19800,3575871857,3575871905,48
2,859,19801,3575871857,3575871905,48
2,859,19802,3575871857,3575871906,49
2,859,19803,3575871857,3575871906,49
2,859,19804,3575871857,3575871907,50
2,860,19805,3575871917,3575871917,0
2,860,19806,3575871917,3575871917,0
2,860,19807,3575871917,3575871917,0
2,860,19808,3575871917,3575871917,0
2,860,19809,3575871917,3575871917,0
2,860,19810,3575871917,3575871917,0
2,860,19811,3575871917,3575871917,0
2,860,19812,3575871917,3575871917,0
2,860,19813,3575871917,3575871917,0
2,860,19814,3575871917,3575871918,1
2,860,19815,3575871917,3575871919,2
2,860,19816,3575871917,3575871919,2
2,860,19817,3575871917,3575871919,2
2,860,19818,3575871917,3575871921,4
2,860,19819,3575871917,3575871922,5
2,860,19820,3575871917,3575871923,6
2,860,19821,3575871917,3575871924,7
2,860,19822,3575871917,3575871926,9
2,860,19823,3575871917,3575871927,10
2,860,19824,3575871917,3575871927,10
2,860,19825,3575871917,3575871928,11
2,860,19826,3575871917,3575871931,14
2,860,19827,3575871917,3575871931,14
2,860,19828,3575871917,3575871931,14
2,860,19829,3575871917,3575871931,14
2,860,19830,3575871917,3575871932,15
2,860,19831,3575871917,3575871933,16
2,860,19832,3575871917,3575871933,16
2,860,19833,3575871917,3575871935,18
2,860,19834,3575871917,3575871935,18
2,860,19835,3575871917,3575871936,19
2,860,19836,3575871917,3575871940,23
2,860,19837,3575871917,3575871940,23
2,860,19838,3575871917,3575871940,23
2,860,19839,3575871917,3575871940,23
2,860,19840,3575871917,3575871943,26
2,860,19841,3575871917,3575871944,27
2,860,19842,3575871917,3575871944,27
2,860,19843,3575871917,3575871945,28
2,860,19844,3575871917,3575871945,28
2,860,19845,3575871917,3575871947,30
2,860,19846,3575871917,3575871948,31
2,860,19847,3575871917,3575871948,31
2,860,19848,3575871917,3575871949,32
2,860,19849,3575871917,3575871949,32
2,860,19850,3575871917,3575871949,32
2,860,19851,3575871917,3575871952,35
2,860,19852,3575871917,3575871952,35
2,860,19853,3575871917,3575871953,36
2,860,19854,3575871917,3575871954,37
2,860,19855,3575871917,3575871954,37
2,860,19856,3575871917,3575871957,40
2,860,19857,3575871917,3575871958,41
2,860,19858,3575871917,3575871959,42
2,860,19859,3575871917,3575871959,42
2,860,19860,3575871917,3575871960,43
2,860,19861,3575871917,3575871961,44
2,860,19862,3575871917,3575871962,45
2,860,19863,3575871917,3575871962,45
2,860,19864,3575871917,3575871966,49
2,860,19865,3575871917,3575871967,50
2,861,19866,3575871977,3575871977,0
2,861,19867,3575871977,3575871977,0
2,861,19868,3575871977,3575871977,0
2,861,19869,3575871977,3575871977,0
2,861,19870,3575871977,3575871977,0
2,861,19871,3575871977,3575871977,0
2,861,19872,3575871977,3575871978,1
2,861,19873,3575871977,3575871979,2
2,861,19874,3575871977,3575871981,4
2,861,19875,3575871977,3575871981,4
2,861,19876,3575871977,3575871981,4
2,861,19877,3575871977,3575871982,5
2,861,19878,3575871977,3575871983,6
2,861,19879,3575871977,3575871983,6
2,861,19880,3575871977,3575871983,6
2,861,19881,3575871977,3575871985,8
2,861,19882,3575871977,3575871985,8
2,861,19883,3575871977,3575871986,9
2,861,19884,3575871977,3575871986,9
2,861,19885,3575871977,3575871987,10
2,861,19886,3575871977,3575871988,11
2,861,19887,3575871977,3575871991,14
2,861,19888,3575871977,3575871992,15
2,861,19889,3575871977,3575871993,16
2,861,19890,3575871977,3575871994,17
2,861,19891,3575871977,3575871996,19
2,861,19892,3575871977,3575871996,19
2,861,19893,3575871977,3575871998,21
2,861,19894,3575871977,3575871998,21
2,861,19895,3575871977,3575871998,21
2,861,19896,3575871977,3575871999,22
2,861,19897,3575871977,3575872000,23
2,861,19898,3575871977,3575872000,23
2,861,19899,3575871977,3575872003,26
2,861,19900,3575871977,3575872004,27
2,861,19901,3575871977,3575872004,27
2,861,19902,3575871977,3575872007,30
2,861,19903,3575871977,3575872007,30
2,861,19904,3575871977,3575872007,30
2,861,19905,3575871977,3575872009,32
2,861,19906,3575871977,3575872010,33
2,861,19907,3575871977,3575872012,35
2,861,19908,3575871977,3575872022,45
2,861,19909,3575871977,3575872022,45
2,861,19910,3575871977,3575872022,45
2,861,19911,3575871977,3575872022,45
2,861,19912,3575871977,3575872024,47
2,861,19913,3575871977,3575872026,49
2,861,19914,3575871977,3575872026,49
2,861,19915,3575871977,3575872027,50
2,862,19916,3575872036,3575872036,0
2,862,19917,3575872036,3575872036,0
2,862,19918,3575872036,3575872036,0
2,862,19919,3575872036,3575872036,0
2,862,19920,3575872036,3575872036,0
2,862,19921,3575872036,3575872037,1
2,862,19922,3575872036,3575872037,1
2,862,19923,3575872036,3575872037,1
2,862,19924,3575872036,3575872037,1
2,862,19925,3575872036,3575872039,3
2,862,19926,3575872036,3575872039,3
2,862,19927,3575872036,3575872040,4
2,862,19928,3575872036,3575872041,5
2,862,19929,3575872036,3575872043,7
2,862,19930,3575872036,3575872044,8
2,862,19931,3575872036,3575872044,8
2,862,19932,3575872036,3575872045,9
2,862,19933,3575872036,3575872045,9
2,862,19934,3575872036,3575872046,10
2,862,19935,3575872036,3575872049,13
2,862,19936,3575872036,3575872051,15
2,862,19937,3575872036,3575872053,17
2,862,19938,3575872036,3575872053,17
2,862,19939,3575872036,3575872053,17
2,862,19940,3575872036,3575872054,18
2,862,19941,3575872036,3575872055,19
2,862,19942,3575872036,3575872056,20
2,862,19943,3575872036,3575872057,21
2,862,19944,3575872036,3575872057,21
2,862,19945,3575872036,3575872059,23
2,862,19946,3575872036,3575872060,24
2,862,19947,3575872036,3575872063,27
2,862,19948,3575872036,3575872063,27
2,862,19949,3575872036,3575872065,29
2,862,19950,3575872036,3575872067,31
2,862,19951,3575872036,3575872072,36
2,862,19952,3575872036,3575872072,36
2,862,19953,3575872036,3575872074,38
2,862,19954,3575872036,3575872077,41
2,862,19955,3575872036,3575872077,41
2,862,19956,3575872036,3575872079,43
2,862,19957,3575872036,3575872079,43
2,862,19958,3575872036,3575872079,43
2,862,19959,3575872036,3575872080,44
2,862,19960,3575872036,3575872081,45
2,862,19961,3575872036,3575872081,45
2,862,19962,3575872036,3575872083,47
2,862,19963,3575872036,3575872083,47
2,862,19964,3575872036,3575872083,47
2,862,19965,3575872036,3575872083,47
2,862,19966,3575872036,3575872084,48
2,862,19967,3575872036,3575872084,48
2,862,19968,3575872036,3575872085,49
2,862,19969,3575872036,3575872086,50
2,863,19970,3575872095,3575872095,0
2,863,19971,3575872095,3575872095,0
2,863,19972,3575872095,3575872095,0
2,863,19973,3575872095,3575872095,0
2,863,19974,3575872095,3575872095,0
2,863,19975,3575872095,3575872095,0
2,863,19976,3575872095,3575872095,0
2,863,19977,3575872095,3575872095,0
2,863,19978,3575872095,3575872095,0
2,863,19979,3575872095,3575872095,0
2,863,19980,3575872095,3575872095,0
2,863,19981,3575872095,3575872095,0
2,863,19982,3575872095,3575872095,0
2,863,19983,3575872095,3575872096,1
2,863,19984,3575872095,3575872096,1
2,863,19985,3575872095,3575872098,3
2,863,19986,3575872095,3575872098,3
2,863,19987,3575872095,3575872098,3
2,863,19988,3575872095,3575872099,4
2,863,19989,3575872095,3575872099,4
2,863,19990,3575872095,3575872100,5
2,863,19991,3575872095,3575872100,5
2,863,19992,3575872095,3575872101,6
2,863,19993,3575872095,3575872102,7
2,863,19994,3575872095,3575872102,7
2,863,19995,3575872095,3575872103,8
2,863,19996,3575872095,3575872104,9
2,863,19997,3575872095,3575872104,9
2,863,19998,3575872095,3575872105,10
2,863,19999,3575872095,3575872106,11
2,863,20000,3575872095,3575872108,13
2,863,20001,3575872095,3575872110,15
2,863,20002,3575872095,3575872110,15
2,863,20003,3575872095,3575872110,15
2,863,20004,3575872095,3575872110,15
2,863,20005,3575872095,3575872113,18
2,863,20006,3575872095,3575872114,19
2,863,20007,3575872095,3575872116,21
2,863,20008,3575872095,3575872117,22
2,863,20009,3575872095,3575872117,22
2,863,20010,3575872095,3575872117,22
2,863,20011,3575872095,3575872117,22
2,863,20012,3575872095,3575872119,24
2,863,20013,3575872095,3575872120,25
2,863,20014,3575872095,3575872120,25
2,863,20015,3575872095,3575872121,26
2,863,20016,3575872095,3575872123,28
2,863,20017,3575872095,3575872123,28
2,863,20018,3575872095,3575872126,31
2,863,20019,3575872095,3575872127,32
2,863,20020,3575872095,3575872128,33
2,863,20021,3575872095,3575872128,33
2,863,20022,3575872095,3575872130,35
2,863,20023,3575872095,3575872130,35
2,863,20024,3575872095,3575872130,35
2,863,20025,3575872095,3575872131,36
2,863,20026,3575872095,3575872131,36
2,863,20027,3575872095,3575872132,37
2,863,20028,3575872095,3575872133,38
2,863,20029,3575872095,3575872134,39
2,863,20030,3575872095,3575872135,40
2,863,20031,3575872095,3575872135,40
2,863,20032,3575872095,3575872135,40
2,863,20033,3575872095,3575872136,41
2,863,20034,3575872095,3575872139,44
2,863,20035,3575872095,3575872140,45
2,863,20036,3575872095,3575872141,46
2,863,20037,3575872095,3575872141,46
2,863,20038,3575872095,3575872143,48
2,863,20039,3575872095,3575872144,49
2,863,20040,3575872095,3575872145,50
2,864,20041,3575872155,3575872155,0
2,864,20042,3575872155,3575872155,0
2,864,20043,3575872155,3575872155,0
2,864,20044,3575872155,3575872155,0
2,864,20045,3575872155,3575872155,0
2,864,20046,3575872155,3575872155,0
2,864,20047,3575872155,3575872155,0
2,864,20048,3575872155,3575872155,0
2,864,20049,3575872155,3575872155,0
2,864,20050,3575872155,3575872158,3
2,864,20051,3575872155,3575872158,3
2,864,20052,3575872155,3575872159,4
2,864,20053,3575872155,3575872160,5
2,864,20054,3575872155,3575872161,6
2,864,20055,3575872155,3575872162,7
2,864,20056,3575872155,3575872163,8
2,864,20057,3575872155,3575872167,12
2,864,20058,3575872155,3575872167,12
2,864,20059,3575872155,3575872167,12
2,864,20060,3575872155,3575872168,13
2,864,20061,3575872155,3575872168,13
2,864,20062,3575872155,3575872170,15
2,864,20063,3575872155,3575872172,17
2,864,20064,3575872155,3575872175,20
2,864,20065,3575872155,3575872177,22
2,864,20066,3575872155,3575872178,23
2,864,20067,3575872155,3575872179,24
2,864,20068,3575872155,3575872180,25
2,864,20069,3575872155,3575872181,26
2,864,20070,3575872155,3575872181,26
2,864,20071,3575872155,3575872183,28
2,864,20072,3575872155,3575872183,28
2,864,20073,3575872155,3575872183,28
2,864,20074,3575872155,3575872184,29
2,864,20075,3575872155,3575872185,30
2,864,20076,3575872155,3575872186,31
2,864,20077,3575872155,3575872186,31
2,864,20078,3575872155,3575872186,31
2,864,20079,3575872155,3575872187,32
2,864,20080,3575872155,3575872188,33
2,864,20081,3575872155,3575872191,36
2,864,20082,3575872155,3575872191,36
2,864,20083,3575872155,3575872193,38
2,864,20084,3575872155,3575872194,39
2,864,20085,3575872155,3575872195,40
2,864,20086,3575872155,3575872195,40
2,864,20087,3575872155,3575872196,41
2,864,20088,3575872155,3575872198,43
2,864,20089,3575872155,3575872199,44
2,864,20090,3575872155,3575872199,44
2,864,20091,3575872155,3575872199,44
2,864,20092,3575872155,3575872200,45
2,864,20093,3575872155,3575872200,45
2,864,20094,3575872155,3575872203,48
2,864,20095,3575872155,3575872204,49
2,864,20096,3575872155,3575872204,49
2,864,20097,3575872155,3575872205,50
2,865,20098,3575872214,3575872214,0
2,865,20099,3575872214,3575872214,0
2,865,20100,3575872214,3575872214,0
2,865,20101,3575872214,3575872214,0
2,865,20102,3575872214,3575872214,0
2,865,20103,3575872214,3575872214,0
2,865,20104,3575872214,3575872214,0
2,865,20105,3575872214,3575872214,0
2,865,20106,3575872214,3575872214,0
2,865,20107,3575872214,3575872214,0
2,865,20108,3575872214,3575872222,8
2,865,20109,3575872214,3575872223,9
2,865,20110,3575872214,3575872223,9
2,865,20111,3575872214,3575872225,11
2,865,20112,3575872214,3575872227,13
2,865,20113,3575872214,3575872228,14
2,865,20114,3575872214,3575872228,14
2,865,20115,3575872214,3575872232,18
2,865,20116,3575872214,3575872233,19
2,865,20117,3575872214,3575872236,22
2,865,20118,3575872214,3575872237,23
2,865,20119,3575872214,3575872237,23
2,865,20120,3575872214,3575872238,24
2,865,20121,3575872214,3575872238,24
2,865,20122,3575872214,3575872239,25
2,865,20123,3575872214,3575872240,26
2,865,20124,3575872214,3575872241,27
2,865,20125,3575872214,3575872243,29
2,865,20126,3575872214,3575872244,30
2,865,20127,3575872214,3575872245,31
2,865,20128,3575872214,3575872245,31
2,865,20129,3575872214,3575872245,31
2,865,20130,3575872214,3575872246,32
2,865,20131,3575872214,3575872250,36
2,865,20132,3575872214,3575872251,37
2,865,20133,3575872214,3575872253,39
2,865,20134,3575872214,3575872254,40
2,865,20135,3575872214,3575872254,40
2,865,20136,3575872214,3575872255,41
2,865,20137,3575872214,3575872256,42
2,865,20138,3575872214,3575872256,42
2,865,20139,3575872214,3575872257,43
2,865,20140,3575872214,3575872257,43
2,865,20141,3575872214,3575872259,45
2,865,20142,3575872214,3575872261,47
2,865,20143,3575872214,3575872263,49
2,865,20144,3575872214,3575872263,49
2,866,20145,3575872274,3575872274,0
2,866,20146,3575872274,3575872274,0
2,866,20147,3575872274,3575872274,0
2,866,20148,3575872274,3575872274,0
2,866,20149,3575872274,3575872274,0
2,866,20150,3575872274,3575872276,2
2,866,20151,3575872274,3575872277,3
2,866,20152,3575872274,3575872280,6
2,866,20153,3575872274,3575872280,6
2,866,20154,3575872274,3575872280,6
2,866,20155,3575872274,3575872280,6
2,866,20156,3575872274,3575872281,7
2,866,20157,3575872274,3575872283,9
2,866,20158,3575872274,3575872283,9
2,866,20159,3575872274,3575872283,9
2,866,20160,3575872274,3575872284,10
2,866,20161,3575872274,3575872284,10
2,866,20162,3575872274,3575872286,12
2,866,20163,3575872274,3575872286,12
2,866,20164,3575872274,3575872286,12
2,866,20165,3575872274,3575872288,14
2,866,20166,3575872274,3575872288,14
2,866,20167,3575872274,3575872289,15
2,866,20168,3575872274,3575872289,15
2,866,20169,3575872274,3575872290,16
2,866,20170,3575872274,3575872291,17
2,866,20171,3575872274,3575872291,17
2,866,20172,3575872274,3575872292,18
2,866,20173,3575872274,3575872292,18
2,866,20174,3575872274,3575872295,21
2,866,20175,3575872274,3575872296,22
2,866,20176,3575872274,3575872296,22
2,866,20177,3575872274,3575872296,22
2,866,20178,3575872274,3575872298,24
2,866,20179,3575872274,3575872298,24
2,866,20180,3575872274,3575872299,25
2,866,20181,3575872274,3575872299,25
2,866,20182,3575872274,3575872300,26
2,866,20183,3575872274,3575872300,26
2,866,20184,3575872274,3575872302,28
2,866,20185,3575872274,3575872303,29
2,866,20186,3575872274,3575872303,29
2,866,20187,3575872274,3575872304,30
2,866,20188,3575872274,3575872305,31
2,866,20189,3575872274,3575872305,31
2,866,20190,3575872274,3575872305,31
2,866,20191,3575872274,3575872308,34
2,866,20192,3575872274,3575872310,36
2,866,20193,3575872274,3575872310,36
2,866,20194,3575872274,3575872311,37
2,866,20195,3575872274,3575872311,37
2,866,20196,3575872274,3575872311,37
2,866,20197,3575872274,3575872313,39
2,866,20198,3575872274,3575872313,39
2,866,20199,3575872274,3575872315,41
2,866,20200,3575872274,3575872316,42
2,866,20201,3575872274,3575872317,43
2,866,20202,3575872274,3575872317,43
2,866,20203,3575872274,3575872318,44
2,866,20204,3575872274,3575872318,44
2,866,20205,3575872274,3575872320,46
2,866,20206,3575872274,3575872320,46
2,866,20207,3575872274,3575872320,46
2,866,20208,3575872274,3575872322,48
2,866,20209,3575872274,3575872322,48
2,866,20210,3575872274,3575872323,49
2,866,20211,3575872274,3575872323,49
2,867,20212,3575872337,3575872337,0
2,867,20213,3575872337,3575872337,0
2,867,20214,3575872337,3575872337,0
2,867,20215,3575872337,3575872338,1
2,867,20216,3575872337,3575872338,1
2,867,20217,3575872337,3575872338,1
2,867,20218,3575872337,3575872338,1
2,867,20219,3575872337,3575872338,1
2,867,20220,3575872337,3575872338,1
2,867,20221,3575872337,3575872338,1
2,867,20222,3575872337,3575872338,1
2,867,20223,3575872337,3575872339,2
2,867,20224,3575872337,3575872340,3
2,867,20225,3575872337,3575872340,3
2,867,20226,3575872337,3575872341,4
2,867,20227,3575872337,3575872343,6
2,867,20228,3575872337,3575872344,7
2,867,20229,3575872337,3575872344,7
2,867,20230,3575872337,3575872346,9
2,867,20231,3575872337,3575872346,9
2,867,20232,3575872337,3575872348,11
2,867,20233,3575872337,3575872349,12
2,867,20234,3575872337,3575872349,12
2,867,20235,3575872337,3575872349,12
2,867,20236,3575872337,3575872349,12
2,867,20237,3575872337,3575872350,13
2,867,20238,3575872337,3575872351,14
2,867,20239,3575872337,3575872352,15
2,867,20240,3575872337,3575872354,17
2,867,20241,3575872337,3575872354,17
2,867,20242,3575872337,3575872358,21
2,867,20243,3575872337,3575872360,23
2,867,20244,3575872337,3575872361,24
2,867,20245,3575872337,3575872363,26
2,867,20246,3575872337,3575872366,29
2,867,20247,3575872337,3575872367,30
2,867,20248,3575872337,3575872368,31
2,867,20249,3575872337,3575872368,31
2,867,20250,3575872337,3575872368,31
2,867,20251,3575872337,3575872370,33
2,867,20252,3575872337,3575872373,36
2,867,20253,3575872337,3575872373,36
2,867,20254,3575872337,3575872375,38
2,867,20255,3575872337,3575872377,40
2,867,20256,3575872337,3575872378,41
2,867,20257,3575872337,3575872379,42
2,867,20258,3575872337,3575872381,44
2,867,20259,3575872337,3575872381,44
2,867,20260,3575872337,3575872382,45
2,867,20261,3575872337,3575872383,46
2,867,20262,3575872337,3575872383,46
2,867,20263,3575872337,3575872384,47
2,867,20264,3575872337,3575872384,47
2,867,20265,3575872337,3575872384,47
2,867,20266,3575872337,3575872385,48
2,867,20267,3575872337,3575872386,49
2,867,20268,3575872337,3575872386,49
2,867,20269,3575872337,3575872386,49
2,868,20270,3575872398,3575872398,0
2,868,20271,3575872398,3575872398,0
2,868,20272,3575872398,3575872398,0
2,868,20273,3575872398,3575872398,0
2,868,20274,3575872398,3575872398,0
2,868,20275,3575872398,3575872398,0
2,868,20276,3575872398,3575872398,0
2,868,20277,3575872398,3575872398,0
2,868,20278,3575872398,3575872398,0
2,868,20279,3575872398,3575872398,0
2,868,20280,3575872398,3575872398,0
2,868,20281,3575872398,3575872399,1
2,868,20282,3575872398,3575872400,2
2,868,20283,3575872398,3575872400,2
2,868,20284,3575872398,3575872400,2
2,868,20285,3575872398,3575872401,3
2,868,20286,3575872398,3575872403,5
2,868,20287,3575872398,3575872404,6
2,868,20288,3575872398,3575872405,7
2,868,20289,3575872398,3575872406,8
2,868,20290,3575872398,3575872407,9
2,868,20291,3575872398,3575872409,11
2,868,20292,3575872398,3575872409,11
2,868,20293,3575872398,3575872410,12
2,868,20294,3575872398,3575872411,13
2,868,20295,3575872398,3575872412,14
2,868,20296,3575872398,3575872414,16
2,868,20297,3575872398,3575872422,24
2,868,20298,3575872398,3575872423,25
2,868,20299,3575872398,3575872423,25
2,868,20300,3575872398,3575872424,26
2,868,20301,3575872398,3575872425,27
2,868,20302,3575872398,3575872426,28
2,868,20303,3575872398,3575872427,29
2,868,20304,3575872398,3575872427,29
2,868,20305,3575872398,3575872428,30
2,868,20306,3575872398,3575872428,30
2,868,20307,3575872398,3575872432,34
2,868,20308,3575872398,3575872433,35
2,868,20309,3575872398,3575872436,38
2,868,20310,3575872398,3575872437,39
2,868,20311,3575872398,3575872438,40
2,868,20312,3575872398,3575872439,41
2,868,20313,3575872398,3575872440,42
2,868,20314,3575872398,3575872440,42
2,868,20315,3575872398,3575872441,43
2,868,20316,3575872398,3575872444,46
2,868,20317,3575872398,3575872444,46
2,868,20318,3575872398,3575872445,47
2,868,20319,3575872398,3575872445,47
2,868,20320,3575872398,3575872446,48
2,868,20321,3575872398,3575872446,48
2,869,20322,3575872460,3575872460,0
2,869,20323,3575872460,3575872460,0
2,869,20324,3575872460,3575872460,0
2,869,20325,3575872460,3575872460,0
2,869,20326,3575872460,3575872460,0
2,869,20327,3575872460,3575872460,0
2,869,20328,3575872460,3575872460,0
2,869,20329,3575872460,3575872460,0
2,869,20330,3575872460,3575872460,0
2,869,20331,3575872460,3575872460,0
2,869,20332,3575872460,3575872460,0
2,869,20333,3575872460,3575872460,0
2,869,20334,3575872460,3575872461,1
2,869,20335,3575872460,3575872462,2
2,869,20336,3575872460,3575872466,6
2,869,20337,3575872460,3575872467,7
2,869,20338,3575872460,3575872472,12
2,869,20339,3575872460,3575872473,13
2,869,20340,3575872460,3575872473,13
2,869,20341,3575872460,3575872478,18
2,869,20342,3575872460,3575872479,19
2,869,20343,3575872460,3575872479,19
2,869,20344,3575872460,3575872480,20
2,869,20345,3575872460,3575872481,21
2,869,20346,3575872460,3575872481,21
2,869,20347,3575872460,3575872483,23
2,869,20348,3575872460,3575872483,23
2,869,20349,3575872460,3575872483,23
2,869,20350,3575872460,3575872483,23
2,869,20351,3575872460,3575872484,24
2,869,20352,3575872460,3575872485,25
2,869,20353,3575872460,3575872485,25
2,869,20354,3575872460,3575872486,26
2,869,20355,3575872460,3575872487,27
2,869,20356,3575872460,3575872488,28
2,869,20357,3575872460,3575872488,28
2,869,20358,3575872460,3575872488,28
2,869,20359,3575872460,3575872489,29
2,869,20360,3575872460,3575872490,30
2,869,20361,3575872460,3575872490,30
2,869,20362,3575872460,3575872492,32
2,869,20363,3575872460,3575872492,32
2,869,20364,3575872460,3575872492,32
2,869,20365,3575872460,3575872494,34
2,869,20366,3575872460,3575872495,35
2,869,20367,3575872460,3575872496,36
2,869,20368,3575872460,3575872496,36
2,869,20369,3575872460,3575872498,38
2,869,20370,3575872460,3575872499,39
2,869,20371,3575872460,3575872500,40
2,869,20372,3575872460,3575872500,40
2,869,20373,3575872460,3575872500,40
2,869,20374,3575872460,3575872501,41
2,869,20375,3575872460,3575872501,41
2,869,20376,3575872460,3575872503,43
2,869,20377,3575872460,3575872503,43
2,869,20378,3575872460,3575872504,44
2,869,20379,3575872460,3575872504,44
2,869,20380,3575872460,3575872505,45
2,869,20381,3575872460,3575872506,46
2,869,20382,3575872460,3575872506,46
2,870,20383,3575872519,3575872519,0
2,870,20384,3575872519,3575872520,1
2,870,20385,3575872519,3575872520,1
2,870,20386,3575872519,3575872520,1
2,870,20387,3575872519,3575872520,1
2,870,20388,3575872519,3575872520,1
2,870,20389,3575872519,3575872520,1
2,870,20390,3575872519,3575872520,1
2,870,20391,3575872519,3575872520,1
2,870,20392,3575872519,3575872520,1
2,870,20393,3575872519,3575872520,1
2,870,20394,3575872519,3575872520,1
2,870,20395,3575872519,3575872520,1
2,870,20396,3575872519,3575872520,1
2,870,20397,3575872519,3575872520,1
2,870,20398,3575872519,3575872522,3
2,870,20399,3575872519,3575872522,3
2,870,20400,3575872519,3575872522,3
2,870,20401,3575872519,3575872524,5
2,870,20402,3575872519,3575872527,8
2,870,20403,3575872519,3575872527,8
2,870,20404,3575872519,3575872527,8
2,870,20405,3575872519,3575872530,11
2,870,20406,3575872519,3575872530,11
2,870,20407,3575872519,3575872530,11
2,870,20408,3575872519,3575872532,13
2,870,20409,3575872519,3575872533,14
2,870,20410,3575872519,3575872534,15
2,870,20411,3575872519,3575872534,15
2,870,20412,3575872519,3575872535,16
2,870,20413,3575872519,3575872539,20
2,870,20414,3575872519,3575872539,20
2,870,20415,3575872519,3575872540,21
2,870,20416,3575872519,3575872540,21
2,870,20417,3575872519,3575872543,24
2,870,20418,3575872519,3575872543,24
2,870,20419,3575872519,3575872545,26
2,870,20420,3575872519,3575872545,26
2,870,20421,3575872519,3575872547,28
2,870,20422,3575872519,3575872547,28
2,870,20423,3575872519,3575872547,28
2,870,20424,3575872519,3575872548,29
2,870,20425,3575872519,3575872548,29
2,870,20426,3575872519,3575872548,29
2,870,20427,3575872519,3575872550,31
2,870,20428,3575872519,3575872550,31
2,870,20429,3575872519,3575872551,32
2,870,20430,3575872519,3575872553,34
2,870,20431,3575872519,3575872554,35
2,870,20432,3575872519,3575872556,37
2,870,20433,3575872519,3575872557,38
2,870,20434,3575872519,3575872558,39
2,870,20435,3575872519,3575872559,40
2,870,20436,3575872519,3575872560,41
2,870,20437,3575872519,3575872561,42
2,870,20438,3575872519,3575872565,46
2,870,20439,3575872519,3575872566,47
2,870,20440,3575872519,3575872566,47
2,870,20441,3575872519,3575872567,48
2,871,20442,3575872581,3575872581,0
2,871,20443,3575872581,3575872581,0
2,871,20444,3575872581,3575872581,0
2,871,20445,3575872581,3575872581,0
2,871,20446,3575872581,3575872581,0
2,871,20447,3575872581,3575872581,0
2,871,20448,3575872581,3575872581,0
2,871,20449,3575872581,3575872581,0
2,871,20450,3575872581,3575872581,0
2,871,20451,3575872581,3575872582,1
2,871,20452,3575872581,3575872582,1
2,871,20453,3575872581,3575872583,2
2,871,20454,3575872581,3575872583,2
2,871,20455,3575872581,3575872583,2
2,871,20456,3575872581,3575872584,3
2,871,20457,3575872581,3575872585,4
2,871,20458,3575872581,3575872585,4
2,871,20459,3575872581,3575872585,4
2,871,20460,3575872581,3575872585,4
2,871,20461,3575872581,3575872588,7
2,871,20462,3575872581,3575872588,7
2,871,20463,3575872581,3575872589,8
2,871,20464,3575872581,3575872591,10
2,871,20465,3575872581,3575872592,11
2,871,20466,3575872581,3575872595,14
2,871,20467,3575872581,3575872595,14
2,871,20468,3575872581,3575872597,16
2,871,20469,3575872581,3575872597,16
2,871,20470,3575872581,3575872598,17
2,871,20471,3575872581,3575872600,19
2,871,20472,3575872581,3575872600,19
2,871,20473,3575872581,3575872600,19
2,871,20474,3575872581,3575872602,21
2,871,20475,3575872581,3575872603,22
2,871,20476,3575872581,3575872604,23
2,871,20477,3575872581,3575872605,24
2,871,20478,3575872581,3575872605,24
2,871,20479,3575872581,3575872607,26
2,871,20480,3575872581,3575872608,27
2,871,20481,3575872581,3575872610,29
2,871,20482,3575872581,3575872610,29
2,871,20483,3575872581,3575872611,30
2,871,20484,3575872581,3575872612,31
2,871,20485,3575872581,3575872613,32
2,871,20486,3575872581,3575872622,41
2,871,20487,3575872581,3575872622,41
2,871,20488,3575872581,3575872623,42
2,871,20489,3575872581,3575872623,42
2,871,20490,3575872581,3575872626,45
2,871,20491,3575872581,3575872627,46
2,871,20492,3575872581,3575872627,46
2,871,20493,3575872581,3575872628,47
2,871,20494,3575872581,3575872631,50
2,872,20495,3575872641,3575872641,0
2,872,20496,3575872641,3575872641,0
2,872,20497,3575872641,3575872641,0
2,872,20498,3575872641,3575872641,0
2,872,20499,3575872641,3575872641,0
2,872,20500,3575872641,3575872641,0
2,872,20501,3575872641,3575872641,0
2,872,20502,3575872641,3575872641,0
2,872,20503,3575872641,3575872641,0
2,872,20504,3575872641,3575872643,2
2,872,20505,3575872641,3575872644,3
2,872,20506,3575872641,3575872645,4
2,872,20507,3575872641,3575872645,4
2,872,20508,3575872641,3575872645,4
2,872,20509,3575872641,3575872649,8
2,872,20510,3575872641,3575872652,11
2,872,20511,3575872641,3575872653,12
2,872,20512,3575872641,3575872654,13
2,872,20513,3575872641,3575872654,13
2,872,20514,3575872641,3575872655,14
2,872,20515,3575872641,3575872655,14
2,872,20516,3575872641,3575872655,14
2,872,20517,3575872641,3575872656,15
2,872,20518,3575872641,3575872657,16
2,872,20519,3575872641,3575872659,18
2,872,20520,3575872641,3575872662,21
2,872,20521,3575872641,3575872663,22
2,872,20522,3575872641,3575872663,22
2,872,20523,3575872641,3575872665,24
2,872,20524,3575872641,3575872666,25
2,872,20525,3575872641,3575872673,32
2,872,20526,3575872641,3575872673,32
2,872,20527,3575872641,3575872674,33
2,872,20528,3575872641,3575872677,36
2,872,20529,3575872641,3575872680,39
2,872,20530,3575872641,3575872680,39
2,872,20531,3575872641,3575872680,39
2,872,20532,3575872641,3575872680,39
2,872,20533,3575872641,3575872682,41
2,872,20534,3575872641,3575872682,41
2,872,20535,3575872641,3575872682,41
2,872,20536,3575872641,3575872683,42
2,872,20537,3575872641,3575872683,42
2,872,20538,3575872641,3575872684,43
2,872,20539,3575872641,3575872685,44
2,872,20540,3575872641,3575872685,44
2,872,20541,3575872641,3575872686,45
2,872,20542,3575872641,3575872686,45
2,872,20543,3575872641,3575872687,46
2,872,20544,3575872641,3575872687,46
2,872,20545,3575872641,3575872688,47
2,872,20546,3575872641,3575872688,47
2,872,20547,3575872641,3575872691,50
2,873,20548,3575872704,3575872704,0
2,873,20549,3575872704,3575872704,0
2,873,20550,3575872704,3575872704,0
2,873,20551,3575872704,3575872704,0
2,873,20552,3575872704,3575872704,0
2,873,20553,3575872704,3575872704,0
2,873,20554,3575872704,3575872704,0
2,873,20555,3575872704,3575872704,0
2,873,20556,3575872704,3575872704,0
2,873,20557,3575872704,3575872704,0
2,873,20558,3575872704,3575872704,0
2,873,20559,3575872704,3575872704,0
2,873,20560,3575872704,3575872704,0
2,873,20561,3575872704,3575872704,0
2,873,20562,3575872704,3575872704,0
2,873,20563,3575872704,3575872704,0
2,873,20564,3575872704,3575872704,0
2,873,20565,3575872704,3575872704,0
2,873,20566,3575872704,3575872705,1
2,873,20567,3575872704,3575872705,1
2,873,20568,3575872704,3575872706,2
2,873,20569,3575872704,3575872706,2
2,873,20570,3575872704,3575872706,2
2,873,20571,3575872704,3575872710,6
2,873,20572,3575872704,3575872711,7
2,873,20573,3575872704,3575872711,7
2,873,20574,3575872704,3575872712,8
2,873,20575,3575872704,3575872713,9
2,873,20576,3575872704,3575872716,12
2,873,20577,3575872704,3575872716,12
2,873,20578,3575872704,3575872716,12
2,873,20579,3575872704,3575872717,13
2,873,20580,3575872704,3575872717,13
2,873,20581,3575872704,3575872718,14
2,873,20582,3575872704,3575872720,16
2,873,20583,3575872704,3575872720,16
2,873,20584,3575872704,3575872721,17
2,873,20585,3575872704,3575872721,17
2,873,20586,3575872704,3575872722,18
2,873,20587,3575872704,3575872723,19
2,873,20588,3575872704,3575872726,22
2,873,20589,3575872704,3575872727,23
2,873,20590,3575872704,3575872727,23
2,873,20591,3575872704,3575872728,24
2,873,20592,3575872704,3575872729,25
2,873,20593,3575872704,3575872730,26
2,873,20594,3575872704,3575872730,26
2,873,20595,3575872704,3575872731,27
2,873,20596,3575872704,3575872731,27
2,873,20597,3575872704,3575872732,28
2,873,20598,3575872704,3575872732,28
2,873,20599,3575872704,3575872733,29
2,873,20600,3575872704,3575872734,30
2,873,20601,3575872704,3575872734,30
2,873,20602,3575872704,3575872735,31
2,873,20603,3575872704,3575872739,35
2,873,20604,3575872704,3575872739,35
2,873,20605,3575872704,3575872739,35
2,873,20606,3575872704,3575872740,36
2,873,20607,3575872704,3575872740,36
2,873,20608,3575872704,3575872743,39
2,873,20609,3575872704,3575872743,39
2,873,20610,3575872704,3575872745,41
2,873,20611,3575872704,3575872746,42
2,873,20612,3575872704,3575872747,43
2,873,20613,3575872704,3575872747,43
2,873,20614,3575872704,3575872748,44
2,873,20615,3575872704,3575872748,44
2,873,20616,3575872704,3575872750,46
2,873,20617,3575872704,3575872751,47
2,873,20618,3575872704,3575872751,47
2,873,20619,3575872704,3575872753,49
2,873,20620,3575872704,3575872753,49
2,873,20621,3575872704,3575872754,50
2,874,20622,3575872765,3575872765,0
2,874,20623,3575872765,3575872765,0
2,874,20624,3575872765,3575872765,0
2,874,20625,3575872765,3575872765,0
2,874,20626,3575872765,3575872765,0
2,874,20627,3575872765,3575872765,0
2,874,20628,3575872765,3575872765,0
2,874,20629,3575872765,3575872765,0
2,874,20630,3575872765,3575872766,1
2,874,20631,3575872765,3575872766,1
2,874,20632,3575872765,3575872767,2
2,874,20633,3575872765,3575872767,2
2,874,20634,3575872765,3575872769,4
2,874,20635,3575872765,3575872772,7
2,874,20636,3575872765,3575872775,10
2,874,20637,3575872765,3575872777,12
2,874,20638,3575872765,3575872778,13
2,874,20639,3575872765,3575872778,13
2,874,20640,3575872765,3575872780,15
2,874,20641,3575872765,3575872780,15
2,874,20642,3575872765,3575872782,17
2,874,20643,3575872765,3575872782,17
2,874,20644,3575872765,3575872782,17
2,874,20645,3575872765,3575872783,18
2,874,20646,3575872765,3575872785,20
2,874,20647,3575872765,3575872785,20
2,874,20648,3575872765,3575872785,20
2,874,20649,3575872765,3575872785,20
2,874,20650,3575872765,3575872785,20
2,874,20651,3575872765,3575872786,21
2,874,20652,3575872765,3575872787,22
2,874,20653,3575872765,3575872788,23
2,874,20654,3575872765,3575872789,24
2,874,20655,3575872765,3575872791,26
2,874,20656,3575872765,3575872791,26
2,874,20657,3575872765,3575872792,27
2,874,20658,3575872765,3575872793,28
2,874,20659,3575872765,3575872795,30
2,874,20660,3575872765,3575872795,30
2,874,20661,3575872765,3575872796,31
2,874,20662,3575872765,3575872797,32
2,874,20663,3575872765,3575872798,33
2,874,20664,3575872765,3575872799,34
2,874,20665,3575872765,3575872799,34
2,874,20666,3575872765,3575872799,34
2,874,20667,3575872765,3575872800,35
2,874,20668,3575872765,3575872801,36
2,874,20669,3575872765,3575872802,37
2,874,20670,3575872765,3575872804,39
2,874,20671,3575872765,3575872805,40
2,874,20672,3575872765,3575872806,41
2,874,20673,3575872765,3575872806,41
2,874,20674,3575872765,3575872808,43
2,874,20675,3575872765,3575872808,43
2,874,20676,3575872765,3575872809,44
2,874,20677,3575872765,3575872811,46
2,874,20678,3575872765,3575872811,46
2,874,20679,3575872765,3575872811,46
2,874,20680,3575872765,3575872813,48
2,875,20681,3575872824,3575872825,1
2,875,20682,3575872824,3575872825,1
2,875,20683,3575872824,3575872825,1
2,875,20684,3575872824,3575872825,1
2,875,20685,3575872824,3575872825,1
2,875,20686,3575872824,3575872827,3
2,875,20687,3575872824,3575872827,3
2,875,20688,3575872824,3575872829,5
2,875,20689,3575872824,3575872830,6
2,875,20690,3575872824,3575872834,10
2,875,20691,3575872824,3575872836,12
2,875,20692,3575872824,3575872836,12
2,875,20693,3575872824,3575872837,13
2,875,20694,3575872824,3575872838,14
2,875,20695,3575872824,3575872839,15
2,875,20696,3575872824,3575872840,16
2,875,20697,3575872824,3575872840,16
2,875,20698,3575872824,3575872842,18
2,875,20699,3575872824,3575872843,19
2,875,20700,3575872824,3575872843,19
2,875,20701,3575872824,3575872844,20
2,875,20702,3575872824,3575872845,21
2,875,20703,3575872824,3575872845,21
2,875,20704,3575872824,3575872845,21
2,875,20705,3575872824,3575872848,24
2,875,20706,3575872824,3575872852,28
2,875,20707,3575872824,3575872853,29
2,875,20708,3575872824,3575872853,29
2,875,20709,3575872824,3575872854,30
2,875,20710,3575872824,3575872855,31
2,875,20711,3575872824,3575872855,31
2,875,20712,3575872824,3575872855,31
2,875,20713,3575872824,3575872857,33
2,875,20714,3575872824,3575872857,33
2,875,20715,3575872824,3575872859,35
2,875,20716,3575872824,3575872861,37
2,875,20717,3575872824,3575872861,37
2,875,20718,3575872824,3575872861,37
2,875,20719,3575872824,3575872863,39
2,875,20720,3575872824,3575872863,39
2,875,20721,3575872824,3575872865,41
2,875,20722,3575872824,3575872866,42
2,875,20723,3575872824,3575872872,48
2,875,20724,3575872824,3575872874,50
2,875,20725,3575872824,3575872874,50
2,876,20726,3575872881,3575872881,0
2,876,20727,3575872881,3575872881,0
2,876,20728,3575872881,3575872881,0
2,876,20729,3575872881,3575872881,0
2,876,20730,3575872881,3575872881,0
2,876,20731,3575872881,3575872881,0
2,876,20732,3575872881,3575872882,1
2,876,20733,3575872881,3575872882,1
2,876,20734,3575872881,3575872884,3
2,876,20735,3575872881,3575872884,3
2,876,20736,3575872881,3575872885,4
2,876,20737,3575872881,3575872885,4
2,876,20738,3575872881,3575872886,5
2,876,20739,3575872881,3575872887,6
2,876,20740,3575872881,3575872887,6
2,876,20741,3575872881,3575872888,7
2,876,20742,3575872881,3575872888,7
2,876,20743,3575872881,3575872888,7
2,876,20744,3575872881,3575872888,7
2,876,20745,3575872881,3575872891,10
2,876,20746,3575872881,3575872891,10
2,876,20747,3575872881,3575872892,11
2,876,20748,3575872881,3575872892,11
2,876,20749,3575872881,3575872892,11
2,876,20750,3575872881,3575872894,13
2,876,20751,3575872881,3575872895,14
2,876,20752,3575872881,3575872896,15
2,876,20753,3575872881,3575872896,15
2,876,20754,3575872881,3575872897,16
2,876,20755,3575872881,3575872898,17
2,876,20756,3575872881,3575872898,17
2,876,20757,3575872881,3575872899,18
2,876,20758,3575872881,3575872900,19
2,876,20759,3575872881,3575872900,19
2,876,20760,3575872881,3575872901,20
2,876,20761,3575872881,3575872901,20
2,876,20762,3575872881,3575872902,21
2,876,20763,3575872881,3575872903,22
2,876,20764,3575872881,3575872904,23
2,876,20765,3575872881,3575872904,23
2,876,20766,3575872881,3575872905,24
2,876,20767,3575872881,3575872906,25
2,876,20768,3575872881,3575872906,25
2,876,20769,3575872881,3575872906,25
2,876,20770,3575872881,3575872906,25
2,876,20771,3575872881,3575872911,30
2,876,20772,3575872881,3575872911,30
2,876,20773,3575872881,3575872913,32
2,876,20774,3575872881,3575872916,35
2,876,20775,3575872881,3575872916,35
2,876,20776,3575872881,3575872917,36
2,876,20777,3575872881,3575872917,36
2,876,20778,3575872881,3575872919,38
2,876,20779,3575872881,3575872920,39
2,876,20780,3575872881,3575872920,39
2,876,20781,3575872881,3575872921,40
2,876,20782,3575872881,3575872923,42
2,876,20783,3575872881,3575872924,43
2,876,20784,3575872881,3575872926,45
2,876,20785,3575872881,3575872927,46
2,876,20786,3575872881,3575872927,46
2,876,20787,3575872881,3575872927,46
2,876,20788,3575872881,3575872927,46
2,876,20789,3575872881,3575872929,48
2,876,20790,3575872881,3575872930,49
2,876,20791,3575872881,3575872931,50
2,877,20792,3575872938,3575872938,0
2,877,20793,3575872938,3575872938,0
2,877,20794,3575872938,3575872938,0
2,877,20795,3575872938,3575872938,0
2,877,20796,3575872938,3575872938,0
2,877,20797,3575872938,3575872938,0
2,877,20798,3575872938,3575872939,1
2,877,20799,3575872938,3575872939,1
2,877,20800,3575872938,3575872939,1
2,877,20801,3575872938,3575872940,2
2,877,20802,3575872938,3575872940,2
2,877,20803,3575872938,3575872943,5
2,877,20804,3575872938,3575872943,5
2,877,20805,3575872938,3575872944,6
2,877,20806,3575872938,3575872945,7
2,877,20807,3575872938,3575872947,9
2,877,20808,3575872938,3575872947,9
2,877,20809,3575872938,3575872948,10
2,877,20810,3575872938,3575872949,11
2,877,20811,3575872938,3575872950,12
2,877,20812,3575872938,3575872952,14
2,877,20813,3575872938,3575872953,15
2,877,20814,3575872938,3575872953,15
2,877,20815,3575872938,3575872955,17
2,877,20816,3575872938,3575872957,19
2,877,20817,3575872938,3575872959,21
2,877,20818,3575872938,3575872959,21
2,877,20819,3575872938,3575872961,23
2,877,20820,3575872938,3575872961,23
2,877,20821,3575872938,3575872962,24
2,877,20822,3575872938,3575872966,28
2,877,20823,3575872938,3575872967,29
2,877,20824,3575872938,3575872967,29
2,877,20825,3575872938,3575872968,30
2,877,20826,3575872938,3575872969,31
2,877,20827,3575872938,3575872972,34
2,877,20828,3575872938,3575872975,37
2,877,20829,3575872938,3575872978,40
2,877,20830,3575872938,3575872978,40
2,877,20831,3575872938,3575872981,43
2,877,20832,3575872938,3575872981,43
2,877,20833,3575872938,3575872982,44
2,877,20834,3575872938,3575872982,44
2,877,20835,3575872938,3575872984,46
2,877,20836,3575872938,3575872984,46
2,877,20837,3575872938,3575872984,46
2,877,20838,3575872938,3575872985,47
2,877,20839,3575872938,3575872985,47
2,877,20840,3575872938,3575872986,48
2,877,20841,3575872938,3575872986,48
2,877,20842,3575872938,3575872987,49
2,878,20843,3575872996,3575872996,0
2,878,20844,3575872996,3575872996,0
2,878,20845,3575872996,3575872996,0
2,878,20846,3575872996,3575872996,0
2,878,20847,3575872996,3575872996,0
2,878,20848,3575872996,3575872996,0
2,878,20849,3575872996,3575872996,0
2,878,20850,3575872996,3575872996,0
2,878,20851,3575872996,3575872996,0
2,878,20852,3575872996,3575872998,2
2,878,20853,3575872996,3575872998,2
2,878,20854,3575872996,3575872999,3
2,878,20855,3575872996,3575872999,3
2,878,20856,3575872996,3575872999,3
2,878,20857,3575872996,3575873000,4
2,878,20858,3575872996,3575873001,5
2,878,20859,3575872996,3575873002,6
2,878,20860,3575872996,3575873005,9
2,878,20861,3575872996,3575873005,9
2,878,20862,3575872996,3575873006,10
2,878,20863,3575872996,3575873007,11
2,878,20864,3575872996,3575873008,12
2,878,20865,3575872996,3575873010,14
2,878,20866,3575872996,3575873011,15
2,878,20867,3575872996,3575873011,15
2,878,20868,3575872996,3575873013,17
2,878,20869,3575872996,3575873023,27
2,878,20870,3575872996,3575873023,27
2,878,20871,3575872996,3575873025,29
2,878,20872,3575872996,3575873027,31
2,878,20873,3575872996,3575873027,31
2,878,20874,3575872996,3575873027,31
2,878,20875,3575872996,3575873028,32
2,878,20876,3575872996,3575873030,34
2,878,20877,3575872996,3575873034,38
2,878,20878,3575872996,3575873035,39
2,878,20879,3575872996,3575873035,39
2,878,20880,3575872996,3575873037,41
2,878,20881,3575872996,3575873038,42
2,878,20882,3575872996,3575873039,43
2,878,20883,3575872996,3575873039,43
2,878,20884,3575872996,3575873040,44
2,878,20885,3575872996,3575873041,45
2,878,20886,3575872996,3575873043,47
2,878,20887,3575872996,3575873044,48
2,878,20888,3575872996,3575873044,48
2,878,20889,3575872996,3575873045,49
2,878,20890,3575872996,3575873045,49
2,879,20891,3575873058,3575873058,0
2,879,20892,3575873058,3575873058,0
2,879,20893,3575873058,3575873058,0
2,879,20894,3575873058,3575873058,0
2,879,20895,3575873058,3575873058,0
2,879,20896,3575873058,3575873058,0
2,879,20897,3575873058,3575873058,0
2,879,20898,3575873058,3575873058,0
2,879,20899,3575873058,3575873058,0
2,879,20900,3575873058,3575873058,0
2,879,20901,3575873058,3575873061,3
2,879,20902,3575873058,3575873061,3
2,879,20903,3575873058,3575873061,3
2,879,20904,3575873058,3575873063,5
2,879,20905,3575873058,3575873063,5
2,879,20906,3575873058,3575873066,8
2,879,20907,3575873058,3575873073,15
2,879,20908,3575873058,3575873074,16
2,879,20909,3575873058,3575873077,19
2,879,20910,3575873058,3575873077,19
2,879,20911,3575873058,3575873079,21
2,879,20912,3575873058,3575873080,22
2,879,20913,3575873058,3575873080,22
2,879,20914,3575873058,3575873080,22
2,879,20915,3575873058,3575873081,23
2,879,20916,3575873058,3575873082,24
2,879,20917,3575873058,3575873082,24
2,879,20918,3575873058,3575873083,25
2,879,20919,3575873058,3575873084,26
2,879,20920,3575873058,3575873084,26
2,879,20921,3575873058,3575873085,27
2,879,20922,3575873058,3575873086,28
2,879,20923,3575873058,3575873087,29
2,879,20924,3575873058,3575873087,29
2,879,20925,3575873058,3575873087,29
2,879,20926,3575873058,3575873087,29
2,879,20927,3575873058,3575873088,30
2,879,20928,3575873058,3575873088,30
2,879,20929,3575873058,3575873089,31
2,879,20930,3575873058,3575873091,33
2,879,20931,3575873058,3575873091,33
2,879,20932,3575873058,3575873092,34
2,879,20933,3575873058,3575873092,34
2,879,20934,3575873058,3575873092,34
2,879,20935,3575873058,3575873094,36
2,879,20936,3575873058,3575873096,38
2,879,20937,3575873058,3575873096,38
2,879,20938,3575873058,3575873097,39
2,879,20939,3575873058,3575873097,39
2,879,20940,3575873058,3575873098,40
2,879,20941,3575873058,3575873099,41
2,879,20942,3575873058,3575873100,42
2,879,20943,3575873058,3575873100,42
2,879,20944,3575873058,3575873100,42
2,879,20945,3575873058,3575873100,42
2,879,20946,3575873058,3575873101,43
2,879,20947,3575873058,3575873101,43
2,879,20948,3575873058,3575873101,43
2,879,20949,3575873058,3575873102,44
2,879,20950,3575873058,3575873104,46
2,879,20951,3575873058,3575873105,47
2,879,20952,3575873058,3575873105,47
2,879,20953,3575873058,3575873105,47
2,879,20954,3575873058,3575873105,47
2,879,20955,3575873058,3575873106,48
2,879,20956,3575873058,3575873106,48
2,880,20957,3575873121,3575873121,0
2,880,20958,3575873121,3575873121,0
2,880,20959,3575873121,3575873121,0
2,880,20960,3575873121,3575873121,0
2,880,20961,3575873121,3575873121,0
2,880,20962,3575873121,3575873121,0
2,880,20963,3575873121,3575873121,0
2,880,20964,3575873121,3575873121,0
2,880,20965,3575873121,3575873121,0
2,880,20966,3575873121,3575873121,0
2,880,20967,3575873121,3575873121,0
2,880,20968,3575873121,3575873121,0
2,880,20969,3575873121,3575873121,0
2,880,20970,3575873121,3575873121,0
2,880,20971,3575873121,3575873121,0
2,880,20972,3575873121,3575873121,0
2,880,20973,3575873121,3575873122,1
2,880,20974,3575873121,3575873122,1
2,880,20975,3575873121,3575873126,5
2,880,20976,3575873121,3575873127,6
2,880,20977,3575873121,3575873128,7
2,880,20978,3575873121,3575873128,7
2,880,20979,3575873121,3575873130,9
2,880,20980,3575873121,3575873130,9
2,880,20981,3575873121,3575873130,9
2,880,20982,3575873121,3575873131,10
2,880,20983,3575873121,3575873133,12
2,880,20984,3575873121,3575873134,13
2,880,20985,3575873121,3575873136,15
2,880,20986,3575873121,3575873136,15
2,880,20987,3575873121,3575873139,18
2,880,20988,3575873121,3575873140,19
2,880,20989,3575873121,3575873140,19
2,880,20990,3575873121,3575873141,20
2,880,20991,3575873121,3575873143,22
2,880,20992,3575873121,3575873143,22
2,880,20993,3575873121,3575873143,22
2,880,20994,3575873121,3575873145,24
2,880,20995,3575873121,3575873146,25
2,880,20996,3575873121,3575873148,27
2,880,20997,3575873121,3575873148,27
2,880,20998,3575873121,3575873148,27
2,880,20999,3575873121,3575873149,28
2,880,21000,3575873121,3575873149,28
2,880,21001,3575873121,3575873149,28
2,880,21002,3575873121,3575873150,29
2,880,21003,3575873121,3575873152,31
2,880,21004,3575873121,3575873153,32
2,880,21005,3575873121,3575873154,33
2,880,21006,3575873121,3575873159,38
2,880,21007,3575873121,3575873160,39
2,880,21008,3575873121,3575873161,40
2,880,21009,3575873121,3575873162,41
2,880,21010,3575873121,3575873162,41
2,880,21011,3575873121,3575873166,45
2,880,21012,3575873121,3575873166,45
2,880,21013,3575873121,3575873166,45
2,880,21014,3575873121,3575873168,47
2,880,21015,3575873121,3575873168,47
2,880,21016,3575873121,3575873170,49
2,881,21017,3575873180,3575873180,0
2,881,21018,3575873180,3575873180,0
2,881,21019,3575873180,3575873180,0
2,881,21020,3575873180,3575873180,0
2,881,21021,3575873180,3575873180,0
2,881,21022,3575873180,3575873181,1
2,881,21023,3575873180,3575873181,1
2,881,21024,3575873180,3575873182,2
2,881,21025,3575873180,3575873183,3
2,881,21026,3575873180,3575873184,4
2,881,21027,3575873180,3575873184,4
2,881,21028,3575873180,3575873185,5
2,881,21029,3575873180,3575873185,5
2,881,21030,3575873180,3575873185,5
2,881,21031,3575873180,3575873186,6
2,881,21032,3575873180,3575873186,6
2,881,21033,3575873180,3575873186,6
2,881,21034,3575873180,3575873188,8
2,881,21035,3575873180,3575873189,9
2,881,21036,3575873180,3575873191,11
2,881,21037,3575873180,3575873191,11
2,881,21038,3575873180,3575873192,12
2,881,21039,3575873180,3575873192,12
2,881,21040,3575873180,3575873196,16
2,881,21041,3575873180,3575873197,17
2,881,21042,3575873180,3575873198,18
2,881,21043,3575873180,3575873199,19
2,881,21044,3575873180,3575873199,19
2,881,21045,3575873180,3575873200,20
2,881,21046,3575873180,3575873200,20
2,881,21047,3575873180,3575873201,21
2,881,21048,3575873180,3575873203,23
2,881,21049,3575873180,3575873205,25
2,881,21050,3575873180,3575873206,26
2,881,21051,3575873180,3575873206,26
2,881,21052,3575873180,3575873207,27
2,881,21053,3575873180,3575873207,27
2,881,21054,3575873180,3575873209,29
2,881,21055,3575873180,3575873211,31
2,881,21056,3575873180,3575873211,31
2,881,21057,3575873180,3575873213,33
2,881,21058,3575873180,3575873214,34
2,881,21059,3575873180,3575873222,42
2,881,21060,3575873180,3575873222,42
2,881,21061,3575873180,3575873222,42
2,881,21062,3575873180,3575873223,43
2,881,21063,3575873180,3575873225,45
2,881,21064,3575873180,3575873226,46
2,881,21065,3575873180,3575873227,47
2,881,21066,3575873180,3575873227,47
2,881,21067,3575873180,3575873228,48
2,881,21068,3575873180,3575873229,49
2,882,21069,3575873241,3575873241,0
2,882,21070,3575873241,3575873241,0
2,882,21071,3575873241,3575873241,0
2,882,21072,3575873241,3575873241,0
2,882,21073,3575873241,3575873241,0
2,882,21074,3575873241,3575873241,0
2,882,21075,3575873241,3575873241,0
2,882,21076,3575873241,3575873241,0
2,882,21077,3575873241,3575873241,0
2,882,21078,3575873241,3575873242,1
2,882,21079,3575873241,3575873243,2
2,882,21080,3575873241,3575873244,3
2,882,21081,3575873241,3575873244,3
2,882,21082,3575873241,3575873245,4
2,882,21083,3575873241,3575873245,4
2,882,21084,3575873241,3575873245,4
2,882,21085,3575873241,3575873249,8
2,882,21086,3575873241,3575873252,11
2,882,21087,3575873241,3575873253,12
2,882,21088,3575873241,3575873255,14
2,882,21089,3575873241,3575873255,14
2,882,21090,3575873241,3575873256,15
2,882,21091,3575873241,3575873256,15
2,882,21092,3575873241,3575873257,16
2,882,21093,3575873241,3575873257,16
2,882,21094,3575873241,3575873259,18
2,882,21095,3575873241,3575873261,20
2,882,21096,3575873241,3575873262,21
2,882,21097,3575873241,3575873262,21
2,882,21098,3575873241,3575873263,22
2,882,21099,3575873241,3575873263,22
2,882,21100,3575873241,3575873266,25
2,882,21101,3575873241,3575873272,31
2,882,21102,3575873241,3575873273,32
2,882,21103,3575873241,3575873274,33
2,882,21104,3575873241,3575873277,36
2,882,21105,3575873241,3575873277,36
2,882,21106,3575873241,3575873279,38
2,882,21107,3575873241,3575873280,39
2,882,21108,3575873241,3575873280,39
2,882,21109,3575873241,3575873281,40
2,882,21110,3575873241,3575873283,42
2,882,21111,3575873241,3575873283,42
2,882,21112,3575873241,3575873284,43
2,882,21113,3575873241,3575873285,44
2,882,21114,3575873241,3575873285,44
2,882,21115,3575873241,3575873287,46
2,882,21116,3575873241,3575873287,46
2,882,21117,3575873241,3575873287,46
2,882,21118,3575873241,3575873287,46
2,882,21119,3575873241,3575873288,47
2,882,21120,3575873241,3575873288,47
2,882,21121,3575873241,3575873288,47
2,882,21122,3575873241,3575873289,48
2,883,21123,3575873300,3575873300,0
2,883,21124,3575873300,3575873300,0
2,883,21125,3575873300,3575873300,0
2,883,21126,3575873300,3575873300,0
2,883,21127,3575873300,3575873300,0
2,883,21128,3575873300,3575873300,0
2,883,21129,3575873300,3575873300,0
2,883,21130,3575873300,3575873300,0
2,883,21131,3575873300,3575873300,0
2,883,21132,3575873300,3575873300,0
2,883,21133,3575873300,3575873300,0
2,883,21134,3575873300,3575873300,0
2,883,21135,3575873300,3575873300,0
2,883,21136,3575873300,3575873300,0
2,883,21137,3575873300,3575873300,0
2,883,21138,3575873300,3575873301,1
2,883,21139,3575873300,3575873302,2
2,883,21140,3575873300,3575873302,2
2,883,21141,3575873300,3575873303,3
2,883,21142,3575873300,3575873305,5
2,883,21143,3575873300,3575873305,5
2,883,21144,3575873300,3575873306,6
2,883,21145,3575873300,3575873306,6
2,883,21146,3575873300,3575873306,6
2,883,21147,3575873300,3575873306,6
2,883,21148,3575873300,3575873311,11
2,883,21149,3575873300,3575873312,12
2,883,21150,3575873300,3575873313,13
2,883,21151,3575873300,3575873313,13
2,883,21152,3575873300,3575873315,15
2,883,21153,3575873300,3575873316,16
2,883,21154,3575873300,3575873316,16
2,883,21155,3575873300,3575873317,17
2,883,21156,3575873300,3575873318,18
2,883,21157,3575873300,3575873318,18
2,883,21158,3575873300,3575873321,21
2,883,21159,3575873300,3575873321,21
2,883,21160,3575873300,3575873322,22
2,883,21161,3575873300,3575873323,23
2,883,21162,3575873300,3575873324,24
2,883,21163,3575873300,3575873326,26
2,883,21164,3575873300,3575873327,27
2,883,21165,3575873300,3575873328,28
2,883,21166,3575873300,3575873331,31
2,883,21167,3575873300,3575873331,31
2,883,21168,3575873300,3575873331,31
2,883,21169,3575873300,3575873332,32
2,883,21170,3575873300,3575873334,34
2,883,21171,3575873300,3575873334,34
2,883,21172,3575873300,3575873335,35
2,883,21173,3575873300,3575873336,36
2,883,21174,3575873300,3575873336,36
2,883,21175,3575873300,3575873339,39
2,883,21176,3575873300,3575873340,40
2,883,21177,3575873300,3575873341,41
2,883,21178,3575873300,3575873341,41
2,883,21179,3575873300,3575873344,44
2,883,21180,3575873300,3575873344,44
2,883,21181,3575873300,3575873344,44
2,883,21182,3575873300,3575873345,45
2,883,21183,3575873300,3575873346,46
2,883,21184,3575873300,3575873348,48
2,883,21185,3575873300,3575873348,48
2,883,21186,3575873300,3575873349,49
2,883,21187,3575873300,3575873349,49
2,883,21188,3575873300,3575873349,49
2,884,21189,3575873361,3575873361,0
2,884,21190,3575873361,3575873361,0
2,884,21191,3575873361,3575873361,0
2,884,21192,3575873361,3575873361,0
2,884,21193,3575873361,3575873361,0
2,884,21194,3575873361,3575873361,0
2,884,21195,3575873361,3575873361,0
2,884,21196,3575873361,3575873361,0
2,884,21197,3575873361,3575873361,0
2,884,21198,3575873361,3575873362,1
2,884,21199,3575873361,3575873366,5
2,884,21200,3575873361,3575873366,5
2,884,21201,3575873361,3575873367,6
2,884,21202,3575873361,3575873368,7
2,884,21203,3575873361,3575873368,7
2,884,21204,3575873361,3575873370,9
2,884,21205,3575873361,3575873372,11
2,884,21206,3575873361,3575873373,12
2,884,21207,3575873361,3575873377,16
2,884,21208,3575873361,3575873377,16
2,884,21209,3575873361,3575873378,17
2,884,21210,3575873361,3575873380,19
2,884,21211,3575873361,3575873381,20
2,884,21212,3575873361,3575873382,21
2,884,21213,3575873361,3575873382,21
2,884,21214,3575873361,3575873384,23
2,884,21215,3575873361,3575873384,23
2,884,21216,3575873361,3575873385,24
2,884,21217,3575873361,3575873385,24
2,884,21218,3575873361,3575873386,25
2,884,21219,3575873361,3575873386,25
2,884,21220,3575873361,3575873386,25
2,884,21221,3575873361,3575873387,26
2,884,21222,3575873361,3575873389,28
2,884,21223,3575873361,3575873391,30
2,884,21224,3575873361,3575873392,31
2,884,21225,3575873361,3575873392,31
2,884,21226,3575873361,3575873392,31
2,884,21227,3575873361,3575873395,34
2,884,21228,3575873361,3575873395,34
2,884,21229,3575873361,3575873396,35
2,884,21230,3575873361,3575873398,37
2,884,21231,3575873361,3575873398,37
2,884,21232,3575873361,3575873399,38
2,884,21233,3575873361,3575873399,38
2,884,21234,3575873361,3575873400,39
2,884,21235,3575873361,3575873400,39
2,884,21236,3575873361,3575873400,39
2,884,21237,3575873361,3575873401,40
2,884,21238,3575873361,3575873403,42
2,884,21239,3575873361,3575873405,44
2,884,21240,3575873361,3575873405,44
2,884,21241,3575873361,3575873406,45
2,884,21242,3575873361,3575873406,45
2,884,21243,3575873361,3575873408,47
2,884,21244,3575873361,3575873408,47
2,884,21245,3575873361,3575873409,48
2,884,21246,3575873361,3575873410,49
2,884,21247,3575873361,3575873411,50
2,885,21248,3575873422,3575873422,0
2,885,21249,3575873422,3575873422,0
2,885,21250,3575873422,3575873422,0
2,885,21251,3575873422,3575873423,1
2,885,21252,3575873422,3575873423,1
2,885,21253,3575873422,3575873424,2
2,885,21254,3575873422,3575873425,3
2,885,21255,3575873422,3575873426,4
2,885,21256,3575873422,3575873426,4
2,885,21257,3575873422,3575873427,5
2,885,21258,3575873422,3575873428,6
2,885,21259,3575873422,3575873428,6
2,885,21260,3575873422,3575873430,8
2,885,21261,3575873422,3575873436,14
2,885,21262,3575873422,3575873436,14
2,885,21263,3575873422,3575873436,14
2,885,21264,3575873422,3575873438,16
2,885,21265,3575873422,3575873439,17
2,885,21266,3575873422,3575873439,17
2,885,21267,3575873422,3575873440,18
2,885,21268,3575873422,3575873440,18
2,885,21269,3575873422,3575873440,18
2,885,21270,3575873422,3575873442,20
2,885,21271,3575873422,3575873443,21
2,885,21272,3575873422,3575873444,22
2,885,21273,3575873422,3575873444,22
2,885,21274,3575873422,3575873445,23
2,885,21275,3575873422,3575873445,23
2,885,21276,3575873422,3575873446,24
2,885,21277,3575873422,3575873450,28
2,885,21278,3575873422,3575873453,31
2,885,21279,3575873422,3575873455,33
2,885,21280,3575873422,3575873456,34
2,885,21281,3575873422,3575873456,34
2,885,21282,3575873422,3575873457,35
2,885,21283,3575873422,3575873457,35
2,885,21284,3575873422,3575873458,36
2,885,21285,3575873422,3575873458,36
2,885,21286,3575873422,3575873461,39
2,885,21287,3575873422,3575873461,39
2,885,21288,3575873422,3575873463,41
2,885,21289,3575873422,3575873463,41
2,885,21290,3575873422,3575873472,50
2,886,21291,3575873483,3575873483,0
2,886,21292,3575873483,3575873483,0
2,886,21293,3575873483,3575873483,0
2,886,21294,3575873483,3575873483,0
2,886,21295,3575873483,3575873483,0
2,886,21296,3575873483,3575873483,0
2,886,21297,3575873483,3575873483,0
2,886,21298,3575873483,3575873483,0
2,886,21299,3575873483,3575873483,0
2,886,21300,3575873483,3575873483,0
2,886,21301,3575873483,3575873483,0
2,886,21302,3575873483,3575873483,0
2,886,21303,3575873483,3575873484,1
2,886,21304,3575873483,3575873484,1
2,886,21305,3575873483,3575873486,3
2,886,21306,3575873483,3575873486,3
2,886,21307,3575873483,3575873486,3
2,886,21308,3575873483,3575873486,3
2,886,21309,3575873483,3575873487,4
2,886,21310,3575873483,3575873488,5
2,886,21311,3575873483,3575873488,5
2,886,21312,3575873483,3575873490,7
2,886,21313,3575873483,3575873491,8
2,886,21314,3575873483,3575873491,8
2,886,21315,3575873483,3575873491,8
2,886,21316,3575873483,3575873491,8
2,886,21317,3575873483,3575873493,10
2,886,21318,3575873483,3575873495,12
2,886,21319,3575873483,3575873495,12
2,886,21320,3575873483,3575873495,12
2,886,21321,3575873483,3575873497,14
2,886,21322,3575873483,3575873498,15
2,886,21323,3575873483,3575873498,15
2,886,21324,3575873483,3575873499,16
2,886,21325,3575873483,3575873499,16
2,886,21326,3575873483,3575873500,17
2,886,21327,3575873483,3575873500,17
2,886,21328,3575873483,3575873501,18
2,886,21329,3575873483,3575873502,19
2,886,21330,3575873483,3575873502,19
2,886,21331,3575873483,3575873503,20
2,886,21332,3575873483,3575873504,21
2,886,21333,3575873483,3575873504,21
2,886,21334,3575873483,3575873505,22
2,886,21335,3575873483,3575873505,22
2,886,21336,3575873483,3575873505,22
2,886,21337,3575873483,3575873505,22
2,886,21338,3575873483,3575873510,27
2,886,21339,3575873483,3575873510,27
2,886,21340,3575873483,3575873512,29
2,886,21341,3575873483,3575873513,30
2,886,21342,3575873483,3575873514,31
2,886,21343,3575873483,3575873515,32
2,886,21344,3575873483,3575873515,32
2,886,21345,3575873483,3575873516,33
2,886,21346,3575873483,3575873516,33
2,886,21347,3575873483,3575873518,35
2,886,21348,3575873483,3575873520,37
2,886,21349,3575873483,3575873520,37
2,886,21350,3575873483,3575873521,38
2,886,21351,3575873483,3575873522,39
2,886,21352,3575873483,3575873522,39
2,886,21353,3575873483,3575873524,41
2,886,21354,3575873483,3575873525,42
2,886,21355,3575873483,3575873526,43
2,886,21356,3575873483,3575873527,44
2,886,21357,3575873483,3575873530,47
2,886,21358,3575873483,3575873530,47
2,886,21359,3575873483,3575873531,48
2,886,21360,3575873483,3575873531,48
2,886,21361,3575873483,3575873532,49
2,886,21362,3575873483,3575873533,50
2,887,21363,3575873544,3575873544,0
2,887,21364,3575873544,3575873544,0
2,887,21365,3575873544,3575873544,0
2,887,21366,3575873544,3575873544,0
2,887,21367,3575873544,3575873544,0
2,887,21368,3575873544,3575873544,0
2,887,21369,3575873544,3575873544,0
2,887,21370,3575873544,3575873544,0
2,887,21371,3575873544,3575873544,0
2,887,21372,3575873544,3575873544,0
2,887,21373,3575873544,3575873545,1
2,887,21374,3575873544,3575873546,2
2,887,21375,3575873544,3575873546,2
2,887,21376,3575873544,3575873548,4
2,887,21377,3575873544,3575873548,4
2,887,21378,3575873544,3575873550,6
2,887,21379,3575873544,3575873551,7
2,887,21380,3575873544,3575873552,8
2,887,21381,3575873544,3575873553,9
2,887,21382,3575873544,3575873554,10
2,887,21383,3575873544,3575873556,12
2,887,21384,3575873544,3575873557,13
2,887,21385,3575873544,3575873558,14
2,887,21386,3575873544,3575873560,16
2,887,21387,3575873544,3575873560,16
2,887,21388,3575873544,3575873561,17
2,887,21389,3575873544,3575873562,18
2,887,21390,3575873544,3575873565,21
2,887,21391,3575873544,3575873565,21
2,887,21392,3575873544,3575873566,22
2,887,21393,3575873544,3575873567,23
2,887,21394,3575873544,3575873567,23
2,887,21395,3575873544,3575873569,25
2,887,21396,3575873544,3575873571,27
2,887,21397,3575873544,3575873572,28
2,887,21398,3575873544,3575873576,32
2,887,21399,3575873544,3575873576,32
2,887,21400,3575873544,3575873577,33
2,887,21401,3575873544,3575873578,34
2,887,21402,3575873544,3575873580,36
2,887,21403,3575873544,3575873580,36
2,887,21404,3575873544,3575873581,37
2,887,21405,3575873544,3575873582,38
2,887,21406,3575873544,3575873583,39
2,887,21407,3575873544,3575873583,39
2,887,21408,3575873544,3575873584,40
2,887,21409,3575873544,3575873584,40
2,887,21410,3575873544,3575873584,40
2,887,21411,3575873544,3575873585,41
2,887,21412,3575873544,3575873585,41
2,887,21413,3575873544,3575873586,42
2,887,21414,3575873544,3575873587,43
2,887,21415,3575873544,3575873589,45
2,887,21416,3575873544,3575873591,47
2,887,21417,3575873544,3575873591,47
2,887,21418,3575873544,3575873592,48
2,888,21419,3575873605,3575873605,0
2,888,21420,3575873605,3575873605,0
2,888,21421,3575873605,3575873605,0
2,888,21422,3575873605,3575873605,0
2,888,21423,3575873605,3575873605,0
2,888,21424,3575873605,3575873605,0
2,888,21425,3575873605,3575873605,0
2,888,21426,3575873605,3575873605,0
2,888,21427,3575873605,3575873605,0
2,888,21428,3575873605,3575873605,0
2,888,21429,3575873605,3575873605,0
2,888,21430,3575873605,3575873605,0
2,888,21431,3575873605,3575873605,0
2,888,21432,3575873605,3575873606,1
2,888,21433,3575873605,3575873607,2
2,888,21434,3575873605,3575873607,2
2,888,21435,3575873605,3575873610,5
2,888,21436,3575873605,3575873613,8
2,888,21437,3575873605,3575873615,10
2,888,21438,3575873605,3575873621,16
2,888,21439,3575873605,3575873622,17
2,888,21440,3575873605,3575873623,18
2,888,21441,3575873605,3575873623,18
2,888,21442,3575873605,3575873623,18
2,888,21443,3575873605,3575873625,20
2,888,21444,3575873605,3575873626,21
2,888,21445,3575873605,3575873626,21
2,888,21446,3575873605,3575873627,22
2,888,21447,3575873605,3575873628,23
2,888,21448,3575873605,3575873630,25
2,888,21449,3575873605,3575873634,29
2,888,21450,3575873605,3575873635,30
2,888,21451,3575873605,3575873636,31
2,888,21452,3575873605,3575873637,32
2,888,21453,3575873605,3575873639,34
2,888,21454,3575873605,3575873639,34
2,888,21455,3575873605,3575873639,34
2,888,21456,3575873605,3575873639,34
2,888,21457,3575873605,3575873640,35
2,888,21458,3575873605,3575873641,36
2,888,21459,3575873605,3575873642,37
2,888,21460,3575873605,3575873643,38
2,888,21461,3575873605,3575873644,39
2,888,21462,3575873605,3575873644,39
2,888,21463,3575873605,3575873644,39
2,888,21464,3575873605,3575873645,40
2,888,21465,3575873605,3575873649,44
2,888,21466,3575873605,3575873651,46
2,888,21467,3575873605,3575873652,47
2,888,21468,3575873605,3575873654,49
2,888,21469,3575873605,3575873654,49
2,888,21470,3575873605,3575873655,50
2,889,21471,3575873663,3575873663,0
2,889,21472,3575873663,3575873663,0
2,889,21473,3575873663,3575873663,0
2,889,21474,3575873663,3575873663,0
2,889,21475,3575873663,3575873663,0
2,889,21476,3575873663,3575873663,0
2,889,21477,3575873663,3575873663,0
2,889,21478,3575873663,3575873663,0
2,889,21479,3575873663,3575873663,0
2,889,21480,3575873663,3575873663,0
2,889,21481,3575873663,3575873666,3
2,889,21482,3575873663,3575873672,9
2,889,21483,3575873663,3575873675,12
2,889,21484,3575873663,3575873676,13
2,889,21485,3575873663,3575873678,15
2,889,21486,3575873663,3575873679,16
2,889,21487,3575873663,3575873679,16
2,889,21488,3575873663,3575873680,17
2,889,21489,3575873663,3575873680,17
2,889,21490,3575873663,3575873680,17
2,889,21491,3575873663,3575873681,18
2,889,21492,3575873663,3575873682,19
2,889,21493,3575873663,3575873682,19
2,889,21494,3575873663,3575873683,20
2,889,21495,3575873663,3575873684,21
2,889,21496,3575873663,3575873686,23
2,889,21497,3575873663,3575873686,23
2,889,21498,3575873663,3575873686,23
2,889,21499,3575873663,3575873687,24
2,889,21500,3575873663,3575873687,24
2,889,21501,3575873663,3575873687,24
2,889,21502,3575873663,3575873688,25
2,889,21503,3575873663,3575873690,27
2,889,21504,3575873663,3575873690,27
2,889,21505,3575873663,3575873691,28
2,889,21506,3575873663,3575873691,28
2,889,21507,3575873663,3575873691,28
2,889,21508,3575873663,3575873694,31
2,889,21509,3575873663,3575873695,32
2,889,21510,3575873663,3575873696,33
2,889,21511,3575873663,3575873696,33
2,889,21512,3575873663,3575873698,35
2,889,21513,3575873663,3575873698,35
2,889,21514,3575873663,3575873699,36
2,889,21515,3575873663,3575873699,36
2,889,21516,3575873663,3575873699,36
2,889,21517,3575873663,3575873700,37
2,889,21518,3575873663,3575873700,37
2,889,21519,3575873663,3575873701,38
2,889,21520,3575873663,3575873701,38
2,889,21521,3575873663,3575873703,40
2,889,21522,3575873663,3575873703,40
2,889,21523,3575873663,3575873704,41
2,889,21524,3575873663,3575873705,42
2,889,21525,3575873663,3575873705,42
2,889,21526,3575873663,3575873705,42
2,889,21527,3575873663,3575873705,42
2,889,21528,3575873663,3575873706,43
2,889,21529,3575873663,3575873710,47
2,889,21530,3575873663,3575873712,49
2,889,21531,3575873663,3575873713,50
2,890,21532,3575873723,3575873723,0
2,890,21533,3575873723,3575873723,0
2,890,21534,3575873723,3575873723,0
2,890,21535,3575873723,3575873723,0
2,890,21536,3575873723,3575873723,0
2,890,21537,3575873723,3575873723,0
2,890,21538,3575873723,3575873723,0
2,890,21539,3575873723,3575873723,0
2,890,21540,3575873723,3575873723,0
2,890,21541,3575873723,3575873723,0
2,890,21542,3575873723,3575873723,0
2,890,21543,3575873723,3575873723,0
2,890,21544,3575873723,3575873723,0
2,890,21545,3575873723,3575873723,0
2,890,21546,3575873723,3575873726,3
2,890,21547,3575873723,3575873727,4
2,890,21548,3575873723,3575873727,4
2,890,21549,3575873723,3575873727,4
2,890,21550,3575873723,3575873728,5
2,890,21551,3575873723,3575873730,7
2,890,21552,3575873723,3575873731,8
2,890,21553,3575873723,3575873731,8
2,890,21554,3575873723,3575873731,8
2,890,21555,3575873723,3575873731,8
2,890,21556,3575873723,3575873733,10
2,890,21557,3575873723,3575873733,10
2,890,21558,3575873723,3575873733,10
2,890,21559,3575873723,3575873734,11
2,890,21560,3575873723,3575873735,12
2,890,21561,3575873723,3575873735,12
2,890,21562,3575873723,3575873735,12
2,890,21563,3575873723,3575873738,15
2,890,21564,3575873723,3575873739,16
2,890,21565,3575873723,3575873740,17
2,890,21566,3575873723,3575873741,18
2,890,21567,3575873723,3575873743,20
2,890,21568,3575873723,3575873743,20
2,890,21569,3575873723,3575873744,21
2,890,21570,3575873723,3575873745,22
2,890,21571,3575873723,3575873745,22
2,890,21572,3575873723,3575873746,23
2,890,21573,3575873723,3575873746,23
2,890,21574,3575873723,3575873748,25
2,890,21575,3575873723,3575873749,26
2,890,21576,3575873723,3575873750,27
2,890,21577,3575873723,3575873750,27
2,890,21578,3575873723,3575873751,28
2,890,21579,3575873723,3575873751,28
2,890,21580,3575873723,3575873753,30
2,890,21581,3575873723,3575873754,31
2,890,21582,3575873723,3575873756,33
2,890,21583,3575873723,3575873757,34
2,890,21584,3575873723,3575873758,35
2,890,21585,3575873723,3575873760,37
2,890,21586,3575873723,3575873760,37
2,890,21587,3575873723,3575873761,38
2,890,21588,3575873723,3575873763,40
2,890,21589,3575873723,3575873765,42
2,890,21590,3575873723,3575873765,42
2,890,21591,3575873723,3575873766,43
2,890,21592,3575873723,3575873767,44
2,890,21593,3575873723,3575873767,44
2,890,21594,3575873723,3575873769,46
2,890,21595,3575873723,3575873772,49
2,890,21596,3575873723,3575873772,49
2,891,21597,3575873783,3575873783,0
2,891,21598,3575873783,3575873783,0
2,891,21599,3575873783,3575873783,0
2,891,21600,3575873783,3575873783,0
2,891,21601,3575873783,3575873783,0
2,891,21602,3575873783,3575873783,0
2,891,21603,3575873783,3575873783,0
2,891,21604,3575873783,3575873783,0
2,891,21605,3575873783,3575873783,0
2,891,21606,3575873783,3575873784,1
2,891,21607,3575873783,3575873784,1
2,891,21608,3575873783,3575873785,2
2,891,21609,3575873783,3575873787,4
2,891,21610,3575873783,3575873788,5
2,891,21611,3575873783,3575873790,7
2,891,21612,3575873783,3575873792,9
2,891,21613,3575873783,3575873792,9
2,891,21614,3575873783,3575873793,10
2,891,21615,3575873783,3575873795,12
2,891,21616,3575873783,3575873796,13
2,891,21617,3575873783,3575873798,15
2,891,21618,3575873783,3575873798,15
2,891,21619,3575873783,3575873799,16
2,891,21620,3575873783,3575873799,16
2,891,21621,3575873783,3575873800,17
2,891,21622,3575873783,3575873800,17
2,891,21623,3575873783,3575873802,19
2,891,21624,3575873783,3575873804,21
2,891,21625,3575873783,3575873804,21
2,891,21626,3575873783,3575873804,21
2,891,21627,3575873783,3575873805,22
2,891,21628,3575873783,3575873806,23
2,891,21629,3575873783,3575873806,23
2,891,21630,3575873783,3575873807,24
2,891,21631,3575873783,3575873809,26
2,891,21632,3575873783,3575873810,27
2,891,21633,3575873783,3575873810,27
2,891,21634,3575873783,3575873813,30
2,891,21635,3575873783,3575873814,31
2,891,21636,3575873783,3575873815,32
2,891,21637,3575873783,3575873822,39
2,891,21638,3575873783,3575873822,39
2,891,21639,3575873783,3575873823,40
2,891,21640,3575873783,3575873824,41
2,891,21641,3575873783,3575873825,42
2,891,21642,3575873783,3575873827,44
2,891,21643,3575873783,3575873829,46
2,892,21644,3575873844,3575873844,0
2,892,21645,3575873844,3575873844,0
2,892,21646,3575873844,3575873844,0
2,892,21647,3575873844,3575873844,0
2,892,21648,3575873844,3575873844,0
2,892,21649,3575873844,3575873844,0
2,892,21650,3575873844,3575873844,0
2,892,21651,3575873844,3575873844,0
2,892,21652,3575873844,3575873844,0
2,892,21653,3575873844,3575873844,0
2,892,21654,3575873844,3575873844,0
2,892,21655,3575873844,3575873844,0
2,892,21656,3575873844,3575873844,0
2,892,21657,3575873844,3575873844,0
2,892,21658,3575873844,3575873845,1
2,892,21659,3575873844,3575873845,1
2,892,21660,3575873844,3575873848,4
2,892,21661,3575873844,3575873852,8
2,892,21662,3575873844,3575873852,8
2,892,21663,3575873844,3575873855,11
2,892,21664,3575873844,3575873855,11
2,892,21665,3575873844,3575873855,11
2,892,21666,3575873844,3575873856,12
2,892,21667,3575873844,3575873856,12
2,892,21668,3575873844,3575873858,14
2,892,21669,3575873844,3575873858,14
2,892,21670,3575873844,3575873859,15
2,892,21671,3575873844,3575873860,16
2,892,21672,3575873844,3575873861,17
2,892,21673,3575873844,3575873862,18
2,892,21674,3575873844,3575873862,18
2,892,21675,3575873844,3575873865,21
2,892,21676,3575873844,3575873872,28
2,892,21677,3575873844,3575873874,30
2,892,21678,3575873844,3575873875,31
2,892,21679,3575873844,3575873876,32
2,892,21680,3575873844,3575873878,34
2,892,21681,3575873844,3575873878,34
2,892,21682,3575873844,3575873879,35
2,892,21683,3575873844,3575873879,35
2,892,21684,3575873844,3575873880,36
2,892,21685,3575873844,3575873881,37
2,892,21686,3575873844,3575873882,38
2,892,21687,3575873844,3575873882,38
2,892,21688,3575873844,3575873883,39
2,892,21689,3575873844,3575873884,40
2,892,21690,3575873844,3575873884,40
2,892,21691,3575873844,3575873886,42
2,892,21692,3575873844,3575873886,42
2,892,21693,3575873844,3575873886,42
2,892,21694,3575873844,3575873886,42
2,892,21695,3575873844,3575873887,43
2,892,21696,3575873844,3575873887,43
2,892,21697,3575873844,3575873888,44
2,892,21698,3575873844,3575873889,45
2,892,21699,3575873844,3575873891,47
2,892,21700,3575873844,3575873891,47
2,892,21701,3575873844,3575873891,47
2,892,21702,3575873844,3575873892,48
2,893,21703,3575873904,3575873905,1
2,893,21704,3575873904,3575873905,1
2,893,21705,3575873904,3575873905,1
2,893,21706,3575873904,3575873905,1
2,893,21707,3575873904,3575873905,1
2,893,21708,3575873904,3575873905,1
2,893,21709,3575873904,3575873905,1
2,893,21710,3575873904,3575873905,1
2,893,21711,3575873904,3575873905,1
2,893,21712,3575873904,3575873905,1
2,893,21713,3575873904,3575873905,1
2,893,21714,3575873904,3575873905,1
2,893,21715,3575873904,3575873905,1
2,893,21716,3575873904,3575873905,1
2,893,21717,3575873904,3575873905,1
2,893,21718,3575873904,3575873905,1
2,893,21719,3575873904,3575873905,1
2,893,21720,3575873904,3575873905,1
2,893,21721,3575873904,3575873905,1
2,893,21722,3575873904,3575873906,2
2,893,21723,3575873904,3575873906,2
2,893,21724,3575873904,3575873910,6
2,893,21725,3575873904,3575873912,8
2,893,21726,3575873904,3575873912,8
2,893,21727,3575873904,3575873913,9
2,893,21728,3575873904,3575873915,11
2,893,21729,3575873904,3575873915,11
2,893,21730,3575873904,3575873916,12
2,893,21731,3575873904,3575873917,13
2,893,21732,3575873904,3575873918,14
2,893,21733,3575873904,3575873919,15
2,893,21734,3575873904,3575873920,16
2,893,21735,3575873904,3575873920,16
2,893,21736,3575873904,3575873920,16
2,893,21737,3575873904,3575873921,17
2,893,21738,3575873904,3575873922,18
2,893,21739,3575873904,3575873923,19
2,893,21740,3575873904,3575873923,19
2,893,21741,3575873904,3575873923,19
2,893,21742,3575873904,3575873923,19
2,893,21743,3575873904,3575873926,22
2,893,21744,3575873904,3575873927,23
2,893,21745,3575873904,3575873927,23
2,893,21746,3575873904,3575873930,26
2,893,21747,3575873904,3575873930,26
2,893,21748,3575873904,3575873931,27
2,893,21749,3575873904,3575873931,27
2,893,21750,3575873904,3575873931,27
2,893,21751,3575873904,3575873933,29
2,893,21752,3575873904,3575873934,30
2,893,21753,3575873904,3575873934,30
2,893,21754,3575873904,3575873935,31
2,893,21755,3575873904,3575873935,31
2,893,21756,3575873904,3575873935,31
2,893,21757,3575873904,3575873939,35
2,893,21758,3575873904,3575873939,35
2,893,21759,3575873904,3575873940,36
2,893,21760,3575873904,3575873940,36
2,893,21761,3575873904,3575873943,39
2,893,21762,3575873904,3575873944,40
2,893,21763,3575873904,3575873944,40
2,893,21764,3575873904,3575873945,41
2,893,21765,3575873904,3575873946,42
2,893,21766,3575873904,3575873946,42
2,893,21767,3575873904,3575873949,45
2,893,21768,3575873904,3575873949,45
2,893,21769,3575873904,3575873951,47
2,893,21770,3575873904,3575873952,48
2,893,21771,3575873904,3575873952,48
2,894,21772,3575873964,3575873964,0
2,894,21773,3575873964,3575873964,0
2,894,21774,3575873964,3575873965,1
2,894,21775,3575873964,3575873965,1
2,894,21776,3575873964,3575873965,1
2,894,21777,3575873964,3575873965,1
2,894,21778,3575873964,3575873965,1
2,894,21779,3575873964,3575873965,1
2,894,21780,3575873964,3575873966,2
2,894,21781,3575873964,3575873967,3
2,894,21782,3575873964,3575873969,5
2,894,21783,3575873964,3575873970,6
2,894,21784,3575873964,3575873972,8
2,894,21785,3575873964,3575873976,12
2,894,21786,3575873964,3575873977,13
2,894,21787,3575873964,3575873978,14
2,894,21788,3575873964,3575873979,15
2,894,21789,3575873964,3575873980,16
2,894,21790,3575873964,3575873981,17
2,894,21791,3575873964,3575873981,17
2,894,21792,3575873964,3575873982,18
2,894,21793,3575873964,3575873983,19
2,894,21794,3575873964,3575873983,19
2,894,21795,3575873964,3575873984,20
2,894,21796,3575873964,3575873985,21
2,894,21797,3575873964,3575873985,21
2,894,21798,3575873964,3575873986,22
2,894,21799,3575873964,3575873987,23
2,894,21800,3575873964,3575873988,24
2,894,21801,3575873964,3575873989,25
2,894,21802,3575873964,3575873990,26
2,894,21803,3575873964,3575873991,27
2,894,21804,3575873964,3575873992,28
2,894,21805,3575873964,3575873993,29
2,894,21806,3575873964,3575873995,31
2,894,21807,3575873964,3575873996,32
2,894,21808,3575873964,3575873998,34
2,894,21809,3575873964,3575873998,34
2,894,21810,3575873964,3575873998,34
2,894,21811,3575873964,3575873999,35
2,894,21812,3575873964,3575873999,35
2,894,21813,3575873964,3575873999,35
2,894,21814,3575873964,3575874000,36
2,894,21815,3575873964,3575874003,39
2,894,21816,3575873964,3575874003,39
2,894,21817,3575873964,3575874004,40
2,894,21818,3575873964,3575874006,42
2,894,21819,3575873964,3575874006,42
2,894,21820,3575873964,3575874006,42
2,894,21821,3575873964,3575874007,43
2,894,21822,3575873964,3575874009,45
2,894,21823,3575873964,3575874010,46
2,894,21824,3575873964,3575874011,47
2,894,21825,3575873964,3575874012,48
2,895,21826,3575874027,3575874027,0
2,895,21827,3575874027,3575874027,0
2,895,21828,3575874027,3575874027,0
2,895,21829,3575874027,3575874027,0
2,895,21830,3575874027,3575874027,0
2,895,21831,3575874027,3575874027,0
2,895,21832,3575874027,3575874027,0
2,895,21833,3575874027,3575874027,0
2,895,21834,3575874027,3575874028,1
2,895,21835,3575874027,3575874028,1
2,895,21836,3575874027,3575874031,4
2,895,21837,3575874027,3575874035,8
2,895,21838,3575874027,3575874036,9
2,895,21839,3575874027,3575874039,12
2,895,21840,3575874027,3575874039,12
2,895,21841,3575874027,3575874040,13
2,895,21842,3575874027,3575874040,13
2,895,21843,3575874027,3575874040,13
2,895,21844,3575874027,3575874041,14
2,895,21845,3575874027,3575874044,17
2,895,21846,3575874027,3575874044,17
2,895,21847,3575874027,3575874044,17
2,895,21848,3575874027,3575874045,18
2,895,21849,3575874027,3575874046,19
2,895,21850,3575874027,3575874046,19
2,895,21851,3575874027,3575874048,21
2,895,21852,3575874027,3575874052,25
2,895,21853,3575874027,3575874053,26
2,895,21854,3575874027,3575874054,27
2,895,21855,3575874027,3575874054,27
2,895,21856,3575874027,3575874055,28
2,895,21857,3575874027,3575874056,29
2,895,21858,3575874027,3575874056,29
2,895,21859,3575874027,3575874058,31
2,895,21860,3575874027,3575874058,31
2,895,21861,3575874027,3575874060,33
2,895,21862,3575874027,3575874061,34
2,895,21863,3575874027,3575874061,34
2,895,21864,3575874027,3575874062,35
2,895,21865,3575874027,3575874062,35
2,895,21866,3575874027,3575874064,37
2,895,21867,3575874027,3575874065,38
2,895,21868,3575874027,3575874071,44
2,895,21869,3575874027,3575874073,46
2,895,21870,3575874027,3575874077,50
2,895,21871,3575874027,3575874077,50
2,896,21872,3575874088,3575874088,0
2,896,21873,3575874088,3575874088,0
2,896,21874,3575874088,3575874088,0
2,896,21875,3575874088,3575874088,0
2,896,21876,3575874088,3575874088,0
2,896,21877,3575874088,3575874088,0
2,896,21878,3575874088,3575874088,0
2,896,21879,3575874088,3575874088,0
2,896,21880,3575874088,3575874088,0
2,896,21881,3575874088,3575874088,0
2,896,21882,3575874088,3575874088,0
2,896,21883,3575874088,3575874088,0
2,896,21884,3575874088,3575874088,0
2,896,21885,3575874088,3575874088,0
2,896,21886,3575874088,3575874088,0
2,896,21887,3575874088,3575874088,0
2,896,21888,3575874088,3575874089,1
2,896,21889,3575874088,3575874090,2
2,896,21890,3575874088,3575874090,2
2,896,21891,3575874088,3575874091,3
2,896,21892,3575874088,3575874091,3
2,896,21893,3575874088,3575874095,7
2,896,21894,3575874088,3575874096,8
2,896,21895,3575874088,3575874098,10
2,896,21896,3575874088,3575874099,11
2,896,21897,3575874088,3575874099,11
2,896,21898,3575874088,3575874099,11
2,896,21899,3575874088,3575874100,12
2,896,21900,3575874088,3575874101,13
2,896,21901,3575874088,3575874102,14
2,896,21902,3575874088,3575874103,15
2,896,21903,3575874088,3575874104,16
2,896,21904,3575874088,3575874105,17
2,896,21905,3575874088,3575874105,17
2,896,21906,3575874088,3575874106,18
2,896,21907,3575874088,3575874106,18
2,896,21908,3575874088,3575874106,18
2,896,21909,3575874088,3575874106,18
2,896,21910,3575874088,3575874113,25
2,896,21911,3575874088,3575874114,26
2,896,21912,3575874088,3575874115,27
2,896,21913,3575874088,3575874115,27
2,896,21914,3575874088,3575874116,28
2,896,21915,3575874088,3575874117,29
2,896,21916,3575874088,3575874118,30
2,896,21917,3575874088,3575874118,30
2,896,21918,3575874088,3575874120,32
2,896,21919,3575874088,3575874120,32
2,896,21920,3575874088,3575874120,32
2,896,21921,3575874088,3575874121,33
2,896,21922,3575874088,3575874122,34
2,896,21923,3575874088,3575874123,35
2,896,21924,3575874088,3575874123,35
2,896,21925,3575874088,3575874123,35
2,896,21926,3575874088,3575874124,36
2,896,21927,3575874088,3575874127,39
2,896,21928,3575874088,3575874127,39
2,896,21929,3575874088,3575874128,40
2,896,21930,3575874088,3575874128,40
2,896,21931,3575874088,3575874130,42
2,896,21932,3575874088,3575874131,43
2,896,21933,3575874088,3575874131,43
2,896,21934,3575874088,3575874132,44
2,896,21935,3575874088,3575874133,45
2,896,21936,3575874088,3575874134,46
2,896,21937,3575874088,3575874135,47
2,896,21938,3575874088,3575874135,47
2,896,21939,3575874088,3575874135,47
2,896,21940,3575874088,3575874135,47
2,896,21941,3575874088,3575874138,50
2,897,21942,3575874152,3575874152,0
2,897,21943,3575874152,3575874152,0
2,897,21944,3575874152,3575874152,0
2,897,21945,3575874152,3575874152,0
2,897,21946,3575874152,3575874152,0
2,897,21947,3575874152,3575874152,0
2,897,21948,3575874152,3575874152,0
2,897,21949,3575874152,3575874152,0
2,897,21950,3575874152,3575874152,0
2,897,21951,3575874152,3575874152,0
2,897,21952,3575874152,3575874152,0
2,897,21953,3575874152,3575874152,0
2,897,21954,3575874152,3575874152,0
2,897,21955,3575874152,3575874155,3
2,897,21956,3575874152,3575874158,6
2,897,21957,3575874152,3575874158,6
2,897,21958,3575874152,3575874160,8
2,897,21959,3575874152,3575874161,9
2,897,21960,3575874152,3575874161,9
2,897,21961,3575874152,3575874162,10
2,897,21962,3575874152,3575874165,13
2,897,21963,3575874152,3575874166,14
2,897,21964,3575874152,3575874167,15
2,897,21965,3575874152,3575874168,16
2,897,21966,3575874152,3575874169,17
2,897,21967,3575874152,3575874170,18
2,897,21968,3575874152,3575874172,20
2,897,21969,3575874152,3575874176,24
2,897,21970,3575874152,3575874177,25
2,897,21971,3575874152,3575874178,26
2,897,21972,3575874152,3575874178,26
2,897,21973,3575874152,3575874181,29
2,897,21974,3575874152,3575874181,29
2,897,21975,3575874152,3575874181,29
2,897,21976,3575874152,3575874182,30
2,897,21977,3575874152,3575874183,31
2,897,21978,3575874152,3575874183,31
2,897,21979,3575874152,3575874184,32
2,897,21980,3575874152,3575874185,33
2,897,21981,3575874152,3575874185,33
2,897,21982,3575874152,3575874186,34
2,897,21983,3575874152,3575874187,35
2,897,21984,3575874152,3575874189,37
2,897,21985,3575874152,3575874189,37
2,897,21986,3575874152,3575874192,40
2,897,21987,3575874152,3575874192,40
2,897,21988,3575874152,3575874193,41
2,897,21989,3575874152,3575874193,41
2,897,21990,3575874152,3575874196,44
2,897,21991,3575874152,3575874196,44
2,897,21992,3575874152,3575874198,46
2,897,21993,3575874152,3575874198,46
2,897,21994,3575874152,3575874199,47
2,897,21995,3575874152,3575874199,47
2,897,21996,3575874152,3575874199,47
2,897,21997,3575874152,3575874199,47
2,897,21998,3575874152,3575874199,47
2,897,21999,3575874152,3575874200,48
2,898,22000,3575874210,3575874210,0
2,898,22001,3575874210,3575874210,0
2,898,22002,3575874210,3575874210,0
2,898,22003,3575874210,3575874210,0
2,898,22004,3575874210,3575874210,0
2,898,22005,3575874210,3575874210,0
2,898,22006,3575874210,3575874210,0
2,898,22007,3575874210,3575874210,0
2,898,22008,3575874210,3575874211,1
2,898,22009,3575874210,3575874214,4
2,898,22010,3575874210,3575874214,4
2,898,22011,3575874210,3575874216,6
2,898,22012,3575874210,3575874223,13
2,898,22013,3575874210,3575874224,14
2,898,22014,3575874210,3575874225,15
2,898,22015,3575874210,3575874226,16
2,898,22016,3575874210,3575874226,16
2,898,22017,3575874210,3575874228,18
2,898,22018,3575874210,3575874230,20
2,898,22019,3575874210,3575874232,22
2,898,22020,3575874210,3575874233,23
2,898,22021,3575874210,3575874235,25
2,898,22022,3575874210,3575874237,27
2,898,22023,3575874210,3575874239,29
2,898,22024,3575874210,3575874240,30
2,898,22025,3575874210,3575874240,30
2,898,22026,3575874210,3575874240,30
2,898,22027,3575874210,3575874240,30
2,898,22028,3575874210,3575874240,30
2,898,22029,3575874210,3575874241,31
2,898,22030,3575874210,3575874242,32
2,898,22031,3575874210,3575874243,33
2,898,22032,3575874210,3575874244,34
2,898,22033,3575874210,3575874245,35
2,898,22034,3575874210,3575874245,35
2,898,22035,3575874210,3575874245,35
2,898,22036,3575874210,3575874246,36
2,898,22037,3575874210,3575874249,39
2,898,22038,3575874210,3575874252,42
2,898,22039,3575874210,3575874253,43
2,898,22040,3575874210,3575874255,45
2,898,22041,3575874210,3575874255,45
2,898,22042,3575874210,3575874255,45
2,898,22043,3575874210,3575874256,46
2,898,22044,3575874210,3575874256,46
2,898,22045,3575874210,3575874258,48
2,898,22046,3575874210,3575874258,48
2,899,22047,3575874269,3575874269,0
2,899,22048,3575874269,3575874269,0
2,899,22049,3575874269,3575874269,0
2,899,22050,3575874269,3575874269,0
2,899,22051,3575874269,3575874269,0
2,899,22052,3575874269,3575874269,0
2,899,22053,3575874269,3575874269,0
2,899,22054,3575874269,3575874271,2
2,899,22055,3575874269,3575874272,3
2,899,22056,3575874269,3575874273,4
2,899,22057,3575874269,3575874276,7
2,899,22058,3575874269,3575874278,9
2,899,22059,3575874269,3575874278,9
2,899,22060,3575874269,3575874281,12
2,899,22061,3575874269,3575874281,12
2,899,22062,3575874269,3575874282,13
2,899,22063,3575874269,3575874282,13
2,899,22064,3575874269,3575874282,13
2,899,22065,3575874269,3575874282,13
2,899,22066,3575874269,3575874282,13
2,899,22067,3575874269,3575874282,13
2,899,22068,3575874269,3575874283,14
2,899,22069,3575874269,3575874284,15
2,899,22070,3575874269,3575874285,16
2,899,22071,3575874269,3575874287,18
2,899,22072,3575874269,3575874287,18
2,899,22073,3575874269,3575874287,18
2,899,22074,3575874269,3575874287,18
2,899,22075,3575874269,3575874287,18
2,899,22076,3575874269,3575874288,19
2,899,22077,3575874269,3575874289,20
2,899,22078,3575874269,3575874290,21
2,899,22079,3575874269,3575874290,21
2,899,22080,3575874269,3575874291,22
2,899,22081,3575874269,3575874291,22
2,899,22082,3575874269,3575874292,23
2,899,22083,3575874269,3575874294,25
2,899,22084,3575874269,3575874295,26
2,899,22085,3575874269,3575874296,27
2,899,22086,3575874269,3575874297,28
2,899,22087,3575874269,3575874298,29
2,899,22088,3575874269,3575874298,29
2,899,22089,3575874269,3575874299,30
2,899,22090,3575874269,3575874300,31
2,899,22091,3575874269,3575874300,31
2,899,22092,3575874269,3575874300,31
2,899,22093,3575874269,3575874301,32
2,899,22094,3575874269,3575874302,33
2,899,22095,3575874269,3575874302,33
2,899,22096,3575874269,3575874303,34
2,899,22097,3575874269,3575874304,35
2,899,22098,3575874269,3575874304,35
2,899,22099,3575874269,3575874305,36
2,899,22100,3575874269,3575874306,37
2,899,22101,3575874269,3575874306,37
2,899,22102,3575874269,3575874306,37
2,899,22103,3575874269,3575874307,38
2,899,22104,3575874269,3575874310,41
2,899,22105,3575874269,3575874311,42
2,899,22106,3575874269,3575874314,45
2,899,22107,3575874269,3575874315,46
2,899,22108,3575874269,3575874316,47
2,899,22109,3575874269,3575874317,48
2,899,22110,3575874269,3575874318,49
2,899,22111,3575874269,3575874318,49
2,900,22112,3575874328,3575874328,0
2,900,22113,3575874328,3575874328,0
2,900,22114,3575874328,3575874328,0
2,900,22115,3575874328,3575874328,0
2,900,22116,3575874328,3575874328,0
2,900,22117,3575874328,3575874328,0
2,900,22118,3575874328,3575874328,0
2,900,22119,3575874328,3575874328,0
2,900,22120,3575874328,3575874328,0
2,900,22121,3575874328,3575874328,0
2,900,22122,3575874328,3575874328,0
2,900,22123,3575874328,3575874331,3
2,900,22124,3575874328,3575874331,3
2,900,22125,3575874328,3575874332,4
2,900,22126,3575874328,3575874332,4
2,900,22127,3575874328,3575874332,4
2,900,22128,3575874328,3575874333,5
2,900,22129,3575874328,3575874334,6
2,900,22130,3575874328,3575874335,7
2,900,22131,3575874328,3575874335,7
2,900,22132,3575874328,3575874336,8
2,900,22133,3575874328,3575874336,8
2,900,22134,3575874328,3575874339,11
2,900,22135,3575874328,3575874339,11
2,900,22136,3575874328,3575874340,12
2,900,22137,3575874328,3575874341,13
2,900,22138,3575874328,3575874344,16
2,900,22139,3575874328,3575874344,16
2,900,22140,3575874328,3575874344,16
2,900,22141,3575874328,3575874345,17
2,900,22142,3575874328,3575874345,17
2,900,22143,3575874328,3575874345,17
2,900,22144,3575874328,3575874347,19
2,900,22145,3575874328,3575874348,20
2,900,22146,3575874328,3575874348,20
2,900,22147,3575874328,3575874349,21
2,900,22148,3575874328,3575874351,23
2,900,22149,3575874328,3575874353,25
2,900,22150,3575874328,3575874353,25
2,900,22151,3575874328,3575874354,26
2,900,22152,3575874328,3575874354,26
2,900,22153,3575874328,3575874358,30
2,900,22154,3575874328,3575874359,31
2,900,22155,3575874328,3575874360,32
2,900,22156,3575874328,3575874360,32
2,900,22157,3575874328,3575874360,32
2,900,22158,3575874328,3575874365,37
2,900,22159,3575874328,3575874366,38
2,900,22160,3575874328,3575874366,38
2,900,22161,3575874328,3575874368,40
2,900,22162,3575874328,3575874369,41
2,900,22163,3575874328,3575874370,42
2,900,22164,3575874328,3575874373,45
2,900,22165,3575874328,3575874376,48
2,901,22166,3575874388,3575874388,0
2,901,22167,3575874388,3575874388,0
2,901,22168,3575874388,3575874388,0
2,901,22169,3575874388,3575874388,0
2,901,22170,3575874388,3575874388,0
2,901,22171,3575874388,3575874388,0
2,901,22172,3575874388,3575874388,0
2,901,22173,3575874388,3575874388,0
2,901,22174,3575874388,3575874388,0
2,901,22175,3575874388,3575874388,0
2,901,22176,3575874388,3575874388,0
2,901,22177,3575874388,3575874388,0
2,901,22178,3575874388,3575874388,0
2,901,22179,3575874388,3575874389,1
2,901,22180,3575874388,3575874390,2
2,901,22181,3575874388,3575874390,2
2,901,22182,3575874388,3575874391,3
2,901,22183,3575874388,3575874392,4
2,901,22184,3575874388,3575874393,5
2,901,22185,3575874388,3575874394,6
2,901,22186,3575874388,3575874396,8
2,901,22187,3575874388,3575874397,9
2,901,22188,3575874388,3575874398,10
2,901,22189,3575874388,3575874399,11
2,901,22190,3575874388,3575874399,11
2,901,22191,3575874388,3575874399,11
2,901,22192,3575874388,3575874400,12
2,901,22193,3575874388,3575874400,12
2,901,22194,3575874388,3575874400,12
2,901,22195,3575874388,3575874404,16
2,901,22196,3575874388,3575874405,17
2,901,22197,3575874388,3575874405,17
2,901,22198,3575874388,3575874407,19
2,901,22199,3575874388,3575874407,19
2,901,22200,3575874388,3575874408,20
2,901,22201,3575874388,3575874409,21
2,901,22202,3575874388,3575874410,22
2,901,22203,3575874388,3575874411,23
2,901,22204,3575874388,3575874414,26
2,901,22205,3575874388,3575874414,26
2,901,22206,3575874388,3575874417,29
2,901,22207,3575874388,3575874422,34
2,901,22208,3575874388,3575874423,35
2,901,22209,3575874388,3575874424,36
2,901,22210,3575874388,3575874426,38
2,901,22211,3575874388,3575874426,38
2,901,22212,3575874388,3575874426,38
2,901,22213,3575874388,3575874428,40
2,901,22214,3575874388,3575874428,40
2,901,22215,3575874388,3575874429,41
2,901,22216,3575874388,3575874433,45
2,901,22217,3575874388,3575874436,48
2,901,22218,3575874388,3575874438,50
2,902,22219,3575874450,3575874450,0
2,902,22220,3575874450,3575874450,0
2,902,22221,3575874450,3575874450,0
2,902,22222,3575874450,3575874450,0
2,902,22223,3575874450,3575874450,0
2,902,22224,3575874450,3575874450,0
2,902,22225,3575874450,3575874450,0
2,902,22226,3575874450,3575874450,0
2,902,22227,3575874450,3575874450,0
2,902,22228,3575874450,3575874450,0
2,902,22229,3575874450,3575874450,0
2,902,22230,3575874450,3575874450,0
2,902,22231,3575874450,3575874450,0
2,902,22232,3575874450,3575874450,0
2,902,22233,3575874450,3575874450,0
2,902,22234,3575874450,3575874452,2
2,902,22235,3575874450,3575874453,3
2,902,22236,3575874450,3575874454,4
2,902,22237,3575874450,3575874455,5
2,902,22238,3575874450,3575874456,6
2,902,22239,3575874450,3575874456,6
2,902,22240,3575874450,3575874458,8
2,902,22241,3575874450,3575874458,8
2,902,22242,3575874450,3575874461,11
2,902,22243,3575874450,3575874462,12
2,902,22244,3575874450,3575874462,12
2,902,22245,3575874450,3575874463,13
2,902,22246,3575874450,3575874463,13
2,902,22247,3575874450,3575874466,16
2,902,22248,3575874450,3575874472,22
2,902,22249,3575874450,3575874472,22
2,902,22250,3575874450,3575874474,24
2,902,22251,3575874450,3575874477,27
2,902,22252,3575874450,3575874477,27
2,902,22253,3575874450,3575874478,28
2,902,22254,3575874450,3575874480,30
2,902,22255,3575874450,3575874481,31
2,902,22256,3575874450,3575874481,31
2,902,22257,3575874450,3575874481,31
2,902,22258,3575874450,3575874482,32
2,902,22259,3575874450,3575874482,32
2,902,22260,3575874450,3575874482,32
2,902,22261,3575874450,3575874483,33
2,902,22262,3575874450,3575874483,33
2,902,22263,3575874450,3575874485,35
2,902,22264,3575874450,3575874485,35
2,902,22265,3575874450,3575874486,36
2,902,22266,3575874450,3575874486,36
2,902,22267,3575874450,3575874486,36
2,902,22268,3575874450,3575874487,37
2,902,22269,3575874450,3575874487,37
2,902,22270,3575874450,3575874487,37
2,902,22271,3575874450,3575874488,38
2,902,22272,3575874450,3575874488,38
2,902,22273,3575874450,3575874490,40
2,902,22274,3575874450,3575874491,41
2,902,22275,3575874450,3575874491,41
2,902,22276,3575874450,3575874492,42
2,902,22277,3575874450,3575874492,42
2,902,22278,3575874450,3575874494,44
2,902,22279,3575874450,3575874495,45
2,902,22280,3575874450,3575874497,47
2,902,22281,3575874450,3575874498,48
2,902,22282,3575874450,3575874499,49
2,902,22283,3575874450,3575874499,49
2,902,22284,3575874450,3575874500,50
2,903,22285,3575874509,3575874509,0
2,903,22286,3575874509,3575874509,0
2,903,22287,3575874509,3575874509,0
2,903,22288,3575874509,3575874509,0
2,903,22289,3575874509,3575874509,0
2,903,22290,3575874509,3575874509,0
2,903,22291,3575874509,3575874509,0
2,903,22292,3575874509,3575874509,0
2,903,22293,3575874509,3575874509,0
2,903,22294,3575874509,3575874509,0
2,903,22295,3575874509,3575874509,0
2,903,22296,3575874509,3575874509,0
2,903,22297,3575874509,3575874509,0
2,903,22298,3575874509,3575874509,0
2,903,22299,3575874509,3575874512,3
2,903,22300,3575874509,3575874513,4
2,903,22301,3575874509,3575874515,6
2,903,22302,3575874509,3575874515,6
2,903,22303,3575874509,3575874516,7
2,903,22304,3575874509,3575874516,7
2,903,22305,3575874509,3575874517,8
2,903,22306,3575874509,3575874517,8
2,903,22307,3575874509,3575874519,10
2,903,22308,3575874509,3575874519,10
2,903,22309,3575874509,3575874522,13
2,903,22310,3575874509,3575874522,13
2,903,22311,3575874509,3575874522,13
2,903,22312,3575874509,3575874523,14
2,903,22313,3575874509,3575874524,15
2,903,22314,3575874509,3575874524,15
2,903,22315,3575874509,3575874525,16
2,903,22316,3575874509,3575874526,17
2,903,22317,3575874509,3575874527,18
2,903,22318,3575874509,3575874527,18
2,903,22319,3575874509,3575874530,21
2,903,22320,3575874509,3575874530,21
2,903,22321,3575874509,3575874531,22
2,903,22322,3575874509,3575874532,23
2,903,22323,3575874509,3575874534,25
2,903,22324,3575874509,3575874534,25
2,903,22325,3575874509,3575874535,26
2,903,22326,3575874509,3575874537,28
2,903,22327,3575874509,3575874538,29
2,903,22328,3575874509,3575874539,30
2,903,22329,3575874509,3575874540,31
2,903,22330,3575874509,3575874543,34
2,903,22331,3575874509,3575874543,34
2,903,22332,3575874509,3575874544,35
2,903,22333,3575874509,3575874544,35
2,903,22334,3575874509,3575874544,35
2,903,22335,3575874509,3575874545,36
2,903,22336,3575874509,3575874546,37
2,903,22337,3575874509,3575874547,38
2,903,22338,3575874509,3575874548,39
2,903,22339,3575874509,3575874548,39
2,903,22340,3575874509,3575874550,41
2,903,22341,3575874509,3575874551,42
2,903,22342,3575874509,3575874552,43
2,903,22343,3575874509,3575874552,43
2,903,22344,3575874509,3575874553,44
2,903,22345,3575874509,3575874553,44
2,903,22346,3575874509,3575874556,47
2,903,22347,3575874509,3575874557,48
2,903,22348,3575874509,3575874558,49
2,904,22349,3575874572,3575874572,0
2,904,22350,3575874572,3575874572,0
2,904,22351,3575874572,3575874572,0
2,904,22352,3575874572,3575874572,0
2,904,22353,3575874572,3575874572,0
2,904,22354,3575874572,3575874572,0
2,904,22355,3575874572,3575874572,0
2,904,22356,3575874572,3575874572,0
2,904,22357,3575874572,3575874572,0
2,904,22358,3575874572,3575874573,1
2,904,22359,3575874572,3575874575,3
2,904,22360,3575874572,3575874578,6
2,904,22361,3575874572,3575874578,6
2,904,22362,3575874572,3575874580,8
2,904,22363,3575874572,3575874581,9
2,904,22364,3575874572,3575874581,9
2,904,22365,3575874572,3575874581,9
2,904,22366,3575874572,3575874582,10
2,904,22367,3575874572,3575874583,11
2,904,22368,3575874572,3575874583,11
2,904,22369,3575874572,3575874584,12
2,904,22370,3575874572,3575874584,12
2,904,22371,3575874572,3575874585,13
2,904,22372,3575874572,3575874587,15
2,904,22373,3575874572,3575874588,16
2,904,22374,3575874572,3575874590,18
2,904,22375,3575874572,3575874590,18
2,904,22376,3575874572,3575874591,19
2,904,22377,3575874572,3575874595,23
2,904,22378,3575874572,3575874596,24
2,904,22379,3575874572,3575874598,26
2,904,22380,3575874572,3575874598,26
2,904,22381,3575874572,3575874598,26
2,904,22382,3575874572,3575874598,26
2,904,22383,3575874572,3575874599,27
2,904,22384,3575874572,3575874600,28
2,904,22385,3575874572,3575874604,32
2,904,22386,3575874572,3575874604,32
2,904,22387,3575874572,3575874605,33
2,904,22388,3575874572,3575874606,34
2,904,22389,3575874572,3575874606,34
2,904,22390,3575874572,3575874607,35
2,904,22391,3575874572,3575874608,36
2,904,22392,3575874572,3575874609,37
2,904,22393,3575874572,3575874610,38
2,904,22394,3575874572,3575874613,41
2,904,22395,3575874572,3575874614,42
2,905,22396,3575874631,3575874631,0
2,905,22397,3575874631,3575874631,0
2,905,22398,3575874631,3575874631,0
2,905,22399,3575874631,3575874631,0
2,905,22400,3575874631,3575874631,0
2,905,22401,3575874631,3575874631,0
2,905,22402,3575874631,3575874631,0
2,905,22403,3575874631,3575874631,0
2,905,22404,3575874631,3575874631,0
2,905,22405,3575874631,3575874633,2
2,905,22406,3575874631,3575874635,4
2,905,22407,3575874631,3575874637,6
2,905,22408,3575874631,3575874639,8
2,905,22409,3575874631,3575874639,8
2,905,22410,3575874631,3575874640,9
2,905,22411,3575874631,3575874641,10
2,905,22412,3575874631,3575874641,10
2,905,22413,3575874631,3575874642,11
2,905,22414,3575874631,3575874642,11
2,905,22415,3575874631,3575874642,11
2,905,22416,3575874631,3575874643,12
2,905,22417,3575874631,3575874644,13
2,905,22418,3575874631,3575874645,14
2,905,22419,3575874631,3575874645,14
2,905,22420,3575874631,3575874645,14
2,905,22421,3575874631,3575874648,17
2,905,22422,3575874631,3575874651,20
2,905,22423,3575874631,3575874653,22
2,905,22424,3575874631,3575874653,22
2,905,22425,3575874631,3575874654,23
2,905,22426,3575874631,3575874655,24
2,905,22427,3575874631,3575874655,24
2,905,22428,3575874631,3575874655,24
2,905,22429,3575874631,3575874658,27
2,905,22430,3575874631,3575874658,27
2,905,22431,3575874631,3575874660,29
2,905,22432,3575874631,3575874661,30
2,905,22433,3575874631,3575874661,30
2,905,22434,3575874631,3575874663,32
2,905,22435,3575874631,3575874664,33
2,905,22436,3575874631,3575874666,35
2,905,22437,3575874631,3575874671,40
2,905,22438,3575874631,3575874672,41
2,905,22439,3575874631,3575874673,42
2,905,22440,3575874631,3575874677,46
2,905,22441,3575874631,3575874678,47
2,905,22442,3575874631,3575874678,47
2,905,22443,3575874631,3575874679,48
2,905,22444,3575874631,3575874681,50
2,906,22445,3575874694,3575874694,0
2,906,22446,3575874694,3575874694,0
2,906,22447,3575874694,3575874694,0
2,906,22448,3575874694,3575874694,0
2,906,22449,3575874694,3575874694,0
2,906,22450,3575874694,3575874694,0
2,906,22451,3575874694,3575874694,0
2,906,22452,3575874694,3575874694,0
2,906,22453,3575874694,3575874694,0
2,906,22454,3575874694,3575874694,0
2,906,22455,3575874694,3575874694,0
2,906,22456,3575874694,3575874694,0
2,906,22457,3575874694,3575874694,0
2,906,22458,3575874694,3575874694,0
2,906,22459,3575874694,3575874694,0
2,906,22460,3575874694,3575874694,0
2,906,22461,3575874694,3575874694,0
2,906,22462,3575874694,3575874694,0
2,906,22463,3575874694,3575874694,0
2,906,22464,3575874694,3575874695,1
2,906,22465,3575874694,3575874696,2
2,906,22466,3575874694,3575874698,4
2,906,22467,3575874694,3575874700,6
2,906,22468,3575874694,3575874700,6
2,906,22469,3575874694,3575874700,6
2,906,22470,3575874694,3575874701,7
2,906,22471,3575874694,3575874702,8
2,906,22472,3575874694,3575874703,9
2,906,22473,3575874694,3575874704,10
2,906,22474,3575874694,3575874704,10
2,906,22475,3575874694,3575874704,10
2,906,22476,3575874694,3575874705,11
2,906,22477,3575874694,3575874705,11
2,906,22478,3575874694,3575874705,11
2,906,22479,3575874694,3575874705,11
2,906,22480,3575874694,3575874706,12
2,906,22481,3575874694,3575874707,13
2,906,22482,3575874694,3575874709,15
2,906,22483,3575874694,3575874712,18
2,906,22484,3575874694,3575874713,19
2,906,22485,3575874694,3575874713,19
2,906,22486,3575874694,3575874715,21
2,906,22487,3575874694,3575874715,21
2,906,22488,3575874694,3575874715,21
2,906,22489,3575874694,3575874716,22
2,906,22490,3575874694,3575874718,24
2,906,22491,3575874694,3575874719,25
2,906,22492,3575874694,3575874719,25
2,906,22493,3575874694,3575874721,27
2,906,22494,3575874694,3575874722,28
2,906,22495,3575874694,3575874723,29
2,906,22496,3575874694,3575874724,30
2,906,22497,3575874694,3575874725,31
2,906,22498,3575874694,3575874727,33
2,906,22499,3575874694,3575874727,33
2,906,22500,3575874694,3575874727,33
2,906,22501,3575874694,3575874730,36
2,906,22502,3575874694,3575874730,36
2,906,22503,3575874694,3575874731,37
2,906,22504,3575874694,3575874731,37
2,906,22505,3575874694,3575874731,37
2,906,22506,3575874694,3575874731,37
2,906,22507,3575874694,3575874732,38
2,906,22508,3575874694,3575874732,38
2,906,22509,3575874694,3575874733,39
2,906,22510,3575874694,3575874734,40
2,906,22511,3575874694,3575874734,40
2,906,22512,3575874694,3575874734,40
2,906,22513,3575874694,3575874735,41
2,906,22514,3575874694,3575874737,43
2,906,22515,3575874694,3575874738,44
2,906,22516,3575874694,3575874739,45
2,906,22517,3575874694,3575874740,46
2,906,22518,3575874694,3575874740,46
2,906,22519,3575874694,3575874743,49
2,906,22520,3575874694,3575874743,49
2,906,22521,3575874694,3575874744,50
2,907,22522,3575874754,3575874754,0
2,907,22523,3575874754,3575874754,0
2,907,22524,3575874754,3575874754,0
2,907,22525,3575874754,3575874754,0
2,907,22526,3575874754,3575874754,0
2,907,22527,3575874754,3575874754,0
2,907,22528,3575874754,3575874754,0
2,907,22529,3575874754,3575874754,0
2,907,22530,3575874754,3575874754,0
2,907,22531,3575874754,3575874754,0
2,907,22532,3575874754,3575874754,0
2,907,22533,3575874754,3575874757,3
2,907,22534,3575874754,3575874757,3
2,907,22535,3575874754,3575874759,5
2,907,22536,3575874754,3575874760,6
2,907,22537,3575874754,3575874760,6
2,907,22538,3575874754,3575874762,8
2,907,22539,3575874754,3575874765,11
2,907,22540,3575874754,3575874766,12
2,907,22541,3575874754,3575874766,12
2,907,22542,3575874754,3575874766,12
2,907,22543,3575874754,3575874767,13
2,907,22544,3575874754,3575874769,15
2,907,22545,3575874754,3575874769,15
2,907,22546,3575874754,3575874772,18
2,907,22547,3575874754,3575874773,19
2,907,22548,3575874754,3575874775,21
2,907,22549,3575874754,3575874778,24
2,907,22550,3575874754,3575874780,26
2,907,22551,3575874754,3575874781,27
2,907,22552,3575874754,3575874781,27
2,907,22553,3575874754,3575874782,28
2,907,22554,3575874754,3575874782,28
2,907,22555,3575874754,3575874783,29
2,907,22556,3575874754,3575874784,30
2,907,22557,3575874754,3575874784,30
2,907,22558,3575874754,3575874785,31
2,907,22559,3575874754,3575874785,31
2,907,22560,3575874754,3575874786,32
2,907,22561,3575874754,3575874787,33
2,907,22562,3575874754,3575874788,34
2,907,22563,3575874754,3575874790,36
2,907,22564,3575874754,3575874791,37
2,907,22565,3575874754,3575874791,37
2,907,22566,3575874754,3575874793,39
2,907,22567,3575874754,3575874795,41
2,907,22568,3575874754,3575874796,42
2,907,22569,3575874754,3575874797,43
2,907,22570,3575874754,3575874798,44
2,907,22571,3575874754,3575874798,44
2,907,22572,3575874754,3575874798,44
2,907,22573,3575874754,3575874799,45
2,907,22574,3575874754,3575874799,45
2,907,22575,3575874754,3575874800,46
2,907,22576,3575874754,3575874804,50
2,907,22577,3575874754,3575874804,50
2,908,22578,3575874817,3575874817,0
2,908,22579,3575874817,3575874817,0
2,908,22580,3575874817,3575874817,0
2,908,22581,3575874817,3575874817,0
2,908,22582,3575874817,3575874817,0
2,908,22583,3575874817,3575874817,0
2,908,22584,3575874817,3575874817,0
2,908,22585,3575874817,3575874817,0
2,908,22586,3575874817,3575874817,0
2,908,22587,3575874817,3575874821,4
2,908,22588,3575874817,3575874822,5
2,908,22589,3575874817,3575874822,5
2,908,22590,3575874817,3575874825,8
2,908,22591,3575874817,3575874825,8
2,908,22592,3575874817,3575874826,9
2,908,22593,3575874817,3575874826,9
2,908,22594,3575874817,3575874827,10
2,908,22595,3575874817,3575874828,11
2,908,22596,3575874817,3575874829,12
2,908,22597,3575874817,3575874833,16
2,908,22598,3575874817,3575874835,18
2,908,22599,3575874817,3575874836,19
2,908,22600,3575874817,3575874839,22
2,908,22601,3575874817,3575874840,23
2,908,22602,3575874817,3575874840,23
2,908,22603,3575874817,3575874842,25
2,908,22604,3575874817,3575874842,25
2,908,22605,3575874817,3575874842,25
2,908,22606,3575874817,3575874842,25
2,908,22607,3575874817,3575874843,26
2,908,22608,3575874817,3575874843,26
2,908,22609,3575874817,3575874843,26
2,908,22610,3575874817,3575874845,28
2,908,22611,3575874817,3575874845,28
2,908,22612,3575874817,3575874845,28
2,908,22613,3575874817,3575874849,32
2,908,22614,3575874817,3575874851,34
2,908,22615,3575874817,3575874853,36
2,908,22616,3575874817,3575874854,37
2,908,22617,3575874817,3575874854,37
2,908,22618,3575874817,3575874855,38
2,908,22619,3575874817,3575874855,38
2,908,22620,3575874817,3575874858,41
2,908,22621,3575874817,3575874858,41
2,908,22622,3575874817,3575874860,43
2,908,22623,3575874817,3575874860,43
2,908,22624,3575874817,3575874861,44
2,908,22625,3575874817,3575874863,46
2,908,22626,3575874817,3575874864,47
2,908,22627,3575874817,3575874867,50
2,909,22628,3575874877,3575874877,0
2,909,22629,3575874877,3575874877,0
2,909,22630,3575874877,3575874877,0
2,909,22631,3575874877,3575874877,0
2,909,22632,3575874877,3575874878,1
2,909,22633,3575874877,3575874879,2
2,909,22634,3575874877,3575874880,3
2,909,22635,3575874877,3575874881,4
2,909,22636,3575874877,3575874881,4
2,909,22637,3575874877,3575874881,4
2,909,22638,3575874877,3575874882,5
2,909,22639,3575874877,3575874882,5
2,909,22640,3575874877,3575874883,6
2,909,22641,3575874877,3575874884,7
2,909,22642,3575874877,3575874885,8
2,909,22643,3575874877,3575874886,9
2,909,22644,3575874877,3575874886,9
2,909,22645,3575874877,3575874887,10
2,909,22646,3575874877,3575874889,12
2,909,22647,3575874877,3575874889,12
2,909,22648,3575874877,3575874890,13
2,909,22649,3575874877,3575874891,14
2,909,22650,3575874877,3575874892,15
2,909,22651,3575874877,3575874893,16
2,909,22652,3575874877,3575874894,17
2,909,22653,3575874877,3575874895,18
2,909,22654,3575874877,3575874896,19
2,909,22655,3575874877,3575874897,20
2,909,22656,3575874877,3575874898,21
2,909,22657,3575874877,3575874899,22
2,909,22658,3575874877,3575874900,23
2,909,22659,3575874877,3575874900,23
2,909,22660,3575874877,3575874900,23
2,909,22661,3575874877,3575874901,24
2,909,22662,3575874877,3575874903,26
2,909,22663,3575874877,3575874904,27
2,909,22664,3575874877,3575874904,27
2,909,22665,3575874877,3575874905,28
2,909,22666,3575874877,3575874905,28
2,909,22667,3575874877,3575874905,28
2,909,22668,3575874877,3575874905,28
2,909,22669,3575874877,3575874905,28
2,909,22670,3575874877,3575874905,28
2,909,22671,3575874877,3575874906,29
2,909,22672,3575874877,3575874907,30
2,909,22673,3575874877,3575874910,33
2,909,22674,3575874877,3575874912,35
2,909,22675,3575874877,3575874913,36
2,909,22676,3575874877,3575874915,38
2,909,22677,3575874877,3575874916,39
2,909,22678,3575874877,3575874916,39
2,909,22679,3575874877,3575874918,41
2,909,22680,3575874877,3575874919,42
2,909,22681,3575874877,3575874922,45
2,909,22682,3575874877,3575874923,46
2,909,22683,3575874877,3575874923,46
2,909,22684,3575874877,3575874925,48
2,909,22685,3575874877,3575874925,48
2,909,22686,3575874877,3575874926,49
2,909,22687,3575874877,3575874927,50
2,910,22688,3575874939,3575874939,0
2,910,22689,3575874939,3575874939,0
2,910,22690,3575874939,3575874939,0
2,910,22691,3575874939,3575874939,0
2,910,22692,3575874939,3575874939,0
2,910,22693,3575874939,3575874939,0
2,910,22694,3575874939,3575874939,0
2,910,22695,3575874939,3575874939,0
2,910,22696,3575874939,3575874939,0
2,910,22697,3575874939,3575874939,0
2,910,22698,3575874939,3575874939,0
2,910,22699,3575874939,3575874939,0
2,910,22700,3575874939,3575874939,0
2,910,22701,3575874939,3575874939,0
2,910,22702,3575874939,3575874939,0
2,910,22703,3575874939,3575874939,0
2,910,22704,3575874939,3575874940,1
2,910,22705,3575874939,3575874943,4
2,910,22706,3575874939,3575874943,4
2,910,22707,3575874939,3575874944,5
2,910,22708,3575874939,3575874945,6
2,910,22709,3575874939,3575874945,6
2,910,22710,3575874939,3575874945,6
2,910,22711,3575874939,3575874946,7
2,910,22712,3575874939,3575874949,10
2,910,22713,3575874939,3575874949,10
2,910,22714,3575874939,3575874949,10
2,910,22715,3575874939,3575874950,11
2,910,22716,3575874939,3575874952,13
2,910,22717,3575874939,3575874952,13
2,910,22718,3575874939,3575874952,13
2,910,22719,3575874939,3575874953,14
2,910,22720,3575874939,3575874953,14
2,910,22721,3575874939,3575874957,18
2,910,22722,3575874939,3575874957,18
2,910,22723,3575874939,3575874958,19
2,910,22724,3575874939,3575874960,21
2,910,22725,3575874939,3575874960,21
2,910,22726,3575874939,3575874963,24
2,910,22727,3575874939,3575874966,27
2,910,22728,3575874939,3575874967,28
2,910,22729,3575874939,3575874968,29
2,910,22730,3575874939,3575874969,30
2,910,22731,3575874939,3575874969,30
2,910,22732,3575874939,3575874973,34
2,910,22733,3575874939,3575874974,35
2,910,22734,3575874939,3575874981,42
2,910,22735,3575874939,3575874981,42
2,910,22736,3575874939,3575874981,42
2,910,22737,3575874939,3575874982,43
2,910,22738,3575874939,3575874983,44
2,910,22739,3575874939,3575874983,44
2,910,22740,3575874939,3575874984,45
2,910,22741,3575874939,3575874984,45
2,910,22742,3575874939,3575874985,46
2,910,22743,3575874939,3575874985,46
2,910,22744,3575874939,3575874986,47
2,910,22745,3575874939,3575874988,49
2,910,22746,3575874939,3575874988,49
2,911,22747,3575875000,3575875000,0
2,911,22748,3575875000,3575875000,0
2,911,22749,3575875000,3575875000,0
2,911,22750,3575875000,3575875000,0
2,911,22751,3575875000,3575875000,0
2,911,22752,3575875000,3575875000,0
2,911,22753,3575875000,3575875000,0
2,911,22754,3575875000,3575875000,0
2,911,22755,3575875000,3575875000,0
2,911,22756,3575875000,3575875000,0
2,911,22757,3575875000,3575875000,0
2,911,22758,3575875000,3575875001,1
2,911,22759,3575875000,3575875004,4
2,911,22760,3575875000,3575875004,4
2,911,22761,3575875000,3575875004,4
2,911,22762,3575875000,3575875005,5
2,911,22763,3575875000,3575875006,6
2,911,22764,3575875000,3575875007,7
2,911,22765,3575875000,3575875007,7
2,911,22766,3575875000,3575875007,7
2,911,22767,3575875000,3575875010,10
2,911,22768,3575875000,3575875011,11
2,911,22769,3575875000,3575875012,12
2,911,22770,3575875000,3575875014,14
2,911,22771,3575875000,3575875016,16
2,911,22772,3575875000,3575875022,22
2,911,22773,3575875000,3575875022,22
2,911,22774,3575875000,3575875025,25
2,911,22775,3575875000,3575875026,26
2,911,22776,3575875000,3575875027,27
2,911,22777,3575875000,3575875027,27
2,911,22778,3575875000,3575875027,27
2,911,22779,3575875000,3575875028,28
2,911,22780,3575875000,3575875036,36
2,911,22781,3575875000,3575875037,37
2,911,22782,3575875000,3575875040,40
2,911,22783,3575875000,3575875040,40
2,911,22784,3575875000,3575875041,41
2,911,22785,3575875000,3575875042,42
2,911,22786,3575875000,3575875042,42
2,911,22787,3575875000,3575875042,42
2,911,22788,3575875000,3575875042,42
2,911,22789,3575875000,3575875044,44
2,911,22790,3575875000,3575875045,45
2,911,22791,3575875000,3575875045,45
2,911,22792,3575875000,3575875050,50
2,912,22793,3575875064,3575875065,1
2,912,22794,3575875064,3575875065,1
2,912,22795,3575875064,3575875065,1
2,912,22796,3575875064,3575875065,1
2,912,22797,3575875064,3575875065,1
2,912,22798,3575875064,3575875065,1
2,912,22799,3575875064,3575875065,1
2,912,22800,3575875064,3575875065,1
2,912,22801,3575875064,3575875065,1
2,912,22802,3575875064,3575875065,1
2,912,22803,3575875064,3575875065,1
2,912,22804,3575875064,3575875065,1
2,912,22805,3575875064,3575875065,1
2,912,22806,3575875064,3575875065,1
2,912,22807,3575875064,3575875065,1
2,912,22808,3575875064,3575875066,2
2,912,22809,3575875064,3575875070,6
2,912,22810,3575875064,3575875072,8
2,912,22811,3575875064,3575875073,9
2,912,22812,3575875064,3575875078,14
2,912,22813,3575875064,3575875078,14
2,912,22814,3575875064,3575875078,14
2,912,22815,3575875064,3575875080,16
2,912,22816,3575875064,3575875081,17
2,912,22817,3575875064,3575875081,17
2,912,22818,3575875064,3575875082,18
2,912,22819,3575875064,3575875082,18
2,912,22820,3575875064,3575875082,18
2,912,22821,3575875064,3575875082,18
2,912,22822,3575875064,3575875084,20
2,912,22823,3575875064,3575875085,21
2,912,22824,3575875064,3575875085,21
2,912,22825,3575875064,3575875086,22
2,912,22826,3575875064,3575875087,23
2,912,22827,3575875064,3575875087,23
2,912,22828,3575875064,3575875087,23
2,912,22829,3575875064,3575875088,24
2,912,22830,3575875064,3575875089,25
2,912,22831,3575875064,3575875090,26
2,912,22832,3575875064,3575875091,27
2,912,22833,3575875064,3575875091,27
2,912,22834,3575875064,3575875091,27
2,912,22835,3575875064,3575875092,28
2,912,22836,3575875064,3575875094,30
2,912,22837,3575875064,3575875095,31
2,912,22838,3575875064,3575875096,32
2,912,22839,3575875064,3575875096,32
2,912,22840,3575875064,3575875098,34
2,912,22841,3575875064,3575875100,36
2,912,22842,3575875064,3575875100,36
2,912,22843,3575875064,3575875100,36
2,912,22844,3575875064,3575875101,37
2,912,22845,3575875064,3575875101,37
2,912,22846,3575875064,3575875103,39
2,912,22847,3575875064,3575875104,40
2,912,22848,3575875064,3575875104,40
2,912,22849,3575875064,3575875104,40
2,912,22850,3575875064,3575875105,41
2,912,22851,3575875064,3575875105,41
2,912,22852,3575875064,3575875105,41
2,912,22853,3575875064,3575875105,41
2,912,22854,3575875064,3575875106,42
2,912,22855,3575875064,3575875106,42
2,912,22856,3575875064,3575875106,42
2,912,22857,3575875064,3575875106,42
2,912,22858,3575875064,3575875107,43
2,912,22859,3575875064,3575875110,46
2,912,22860,3575875064,3575875110,46
2,912,22861,3575875064,3575875112,48
2,912,22862,3575875064,3575875113,49
2,913,22863,3575875128,3575875128,0
2,913,22864,3575875128,3575875128,0
2,913,22865,3575875128,3575875128,0
2,913,22866,3575875128,3575875128,0
2,913,22867,3575875128,3575875128,0
2,913,22868,3575875128,3575875128,0
2,913,22869,3575875128,3575875128,0
2,913,22870,3575875128,3575875128,0
2,913,22871,3575875128,3575875128,0
2,913,22872,3575875128,3575875128,0
2,913,22873,3575875128,3575875128,0
2,913,22874,3575875128,3575875128,0
2,913,22875,3575875128,3575875128,0
2,913,22876,3575875128,3575875128,0
2,913,22877,3575875128,3575875128,0
2,913,22878,3575875128,3575875131,3
2,913,22879,3575875128,3575875131,3
2,913,22880,3575875128,3575875132,4
2,913,22881,3575875128,3575875132,4
2,913,22882,3575875128,3575875132,4
2,913,22883,3575875128,3575875132,4
2,913,22884,3575875128,3575875133,5
2,913,22885,3575875128,3575875133,5
2,913,22886,3575875128,3575875134,6
2,913,22887,3575875128,3575875135,7
2,913,22888,3575875128,3575875135,7
2,913,22889,3575875128,3575875135,7
2,913,22890,3575875128,3575875138,10
2,913,22891,3575875128,3575875138,10
2,913,22892,3575875128,3575875138,10
2,913,22893,3575875128,3575875139,11
2,913,22894,3575875128,3575875140,12
2,913,22895,3575875128,3575875144,16
2,913,22896,3575875128,3575875144,16
2,913,22897,3575875128,3575875144,16
2,913,22898,3575875128,3575875144,16
2,913,22899,3575875128,3575875144,16
2,913,22900,3575875128,3575875145,17
2,913,22901,3575875128,3575875146,18
2,913,22902,3575875128,3575875146,18
2,913,22903,3575875128,3575875148,20
2,913,22904,3575875128,3575875149,21
2,913,22905,3575875128,3575875149,21
2,913,22906,3575875128,3575875150,22
2,913,22907,3575875128,3575875152,24
2,913,22908,3575875128,3575875153,25
2,913,22909,3575875128,3575875153,25
2,913,22910,3575875128,3575875154,26
2,913,22911,3575875128,3575875154,26
2,913,22912,3575875128,3575875157,29
2,913,22913,3575875128,3575875158,30
2,913,22914,3575875128,3575875161,33
2,913,22915,3575875128,3575875161,33
2,913,22916,3575875128,3575875161,33
2,913,22917,3575875128,3575875162,34
2,913,22918,3575875128,3575875167,39
2,913,22919,3575875128,3575875167,39
2,913,22920,3575875128,3575875168,40
2,913,22921,3575875128,3575875168,40
2,913,22922,3575875128,3575875169,41
2,913,22923,3575875128,3575875170,42
2,913,22924,3575875128,3575875173,45
2,913,22925,3575875128,3575875175,47
2,914,22926,3575875191,3575875191,0
2,914,22927,3575875191,3575875191,0
2,914,22928,3575875191,3575875191,0
2,914,22929,3575875191,3575875191,0
2,914,22930,3575875191,3575875191,0
2,914,22931,3575875191,3575875191,0
2,914,22932,3575875191,3575875191,0
2,914,22933,3575875191,3575875191,0
2,914,22934,3575875191,3575875191,0
2,914,22935,3575875191,3575875191,0
2,914,22936,3575875191,3575875191,0
2,914,22937,3575875191,3575875191,0
2,914,22938,3575875191,3575875191,0
2,914,22939,3575875191,3575875191,0
2,914,22940,3575875191,3575875192,1
2,914,22941,3575875191,3575875192,1
2,914,22942,3575875191,3575875195,4
2,914,22943,3575875191,3575875196,5
2,914,22944,3575875191,3575875199,8
2,914,22945,3575875191,3575875199,8
2,914,22946,3575875191,3575875199,8
2,914,22947,3575875191,3575875199,8
2,914,22948,3575875191,3575875200,9
2,914,22949,3575875191,3575875202,11
2,914,22950,3575875191,3575875203,12
2,914,22951,3575875191,3575875204,13
2,914,22952,3575875191,3575875205,14
2,914,22953,3575875191,3575875206,15
2,914,22954,3575875191,3575875206,15
2,914,22955,3575875191,3575875207,16
2,914,22956,3575875191,3575875207,16
2,914,22957,3575875191,3575875208,17
2,914,22958,3575875191,3575875211,20
2,914,22959,3575875191,3575875214,23
2,914,22960,3575875191,3575875214,23
2,914,22961,3575875191,3575875215,24
2,914,22962,3575875191,3575875222,31
2,914,22963,3575875191,3575875222,31
2,914,22964,3575875191,3575875223,32
2,914,22965,3575875191,3575875226,35
2,914,22966,3575875191,3575875226,35
2,914,22967,3575875191,3575875227,36
2,914,22968,3575875191,3575875227,36
2,914,22969,3575875191,3575875228,37
2,914,22970,3575875191,3575875228,37
2,914,22971,3575875191,3575875235,44
2,914,22972,3575875191,3575875239,48
2,914,22973,3575875191,3575875240,49
2,914,22974,3575875191,3575875240,49
2,914,22975,3575875191,3575875241,50
2,915,22976,3575875250,3575875250,0
2,915,22977,3575875250,3575875250,0
2,915,22978,3575875250,3575875250,0
2,915,22979,3575875250,3575875250,0
2,915,22980,3575875250,3575875250,0
2,915,22981,3575875250,3575875250,0
2,915,22982,3575875250,3575875250,0
2,915,22983,3575875250,3575875250,0
2,915,22984,3575875250,3575875250,0
2,915,22985,3575875250,3575875254,4
2,915,22986,3575875250,3575875254,4
2,915,22987,3575875250,3575875254,4
2,915,22988,3575875250,3575875255,5
2,915,22989,3575875250,3575875255,5
2,915,22990,3575875250,3575875256,6
2,915,22991,3575875250,3575875258,8
2,915,22992,3575875250,3575875260,10
2,915,22993,3575875250,3575875260,10
2,915,22994,3575875250,3575875261,11
2,915,22995,3575875250,3575875261,11
2,915,22996,3575875250,3575875262,12
2,915,22997,3575875250,3575875264,14
2,915,22998,3575875250,3575875264,14
2,915,22999,3575875250,3575875266,16
2,915,23000,3575875250,3575875271,21
2,915,23001,3575875250,3575875273,23
2,915,23002,3575875250,3575875273,23
2,915,23003,3575875250,3575875277,27
2,915,23004,3575875250,3575875278,28
2,915,23005,3575875250,3575875278,28
2,915,23006,3575875250,3575875280,30
2,915,23007,3575875250,3575875281,31
2,915,23008,3575875250,3575875281,31
2,915,23009,3575875250,3575875282,32
2,915,23010,3575875250,3575875283,33
2,915,23011,3575875250,3575875283,33
2,915,23012,3575875250,3575875285,35
2,915,23013,3575875250,3575875285,35
2,915,23014,3575875250,3575875285,35
2,915,23015,3575875250,3575875286,36
2,915,23016,3575875250,3575875286,36
2,915,23017,3575875250,3575875287,37
2,915,23018,3575875250,3575875287,37
2,915,23019,3575875250,3575875287,37
2,915,23020,3575875250,3575875288,38
2,915,23021,3575875250,3575875290,40
2,915,23022,3575875250,3575875290,40
2,915,23023,3575875250,3575875290,40
2,915,23024,3575875250,3575875290,40
2,915,23025,3575875250,3575875291,41
2,915,23026,3575875250,3575875291,41
2,915,23027,3575875250,3575875291,41
2,915,23028,3575875250,3575875292,42
2,915,23029,3575875250,3575875295,45
2,915,23030,3575875250,3575875296,46
2,915,23031,3575875250,3575875296,46
2,915,23032,3575875250,3575875296,46
2,915,23033,3575875250,3575875298,48
2,916,23034,3575875314,3575875314,0
2,916,23035,3575875314,3575875314,0
2,916,23036,3575875314,3575875314,0
2,916,23037,3575875314,3575875314,0
2,916,23038,3575875314,3575875314,0
2,916,23039,3575875314,3575875314,0
2,916,23040,3575875314,3575875314,0
2,916,23041,3575875314,3575875314,0
2,916,23042,3575875314,3575875314,0
2,916,23043,3575875314,3575875314,0
2,916,23044,3575875314,3575875314,0
2,916,23045,3575875314,3575875314,0
2,916,23046,3575875314,3575875314,0
2,916,23047,3575875314,3575875314,0
2,916,23048,3575875314,3575875314,0
2,916,23049,3575875314,3575875314,0
2,916,23050,3575875314,3575875314,0
2,916,23051,3575875314,3575875314,0
2,916,23052,3575875314,3575875314,0
2,916,23053,3575875314,3575875315,1
2,916,23054,3575875314,3575875315,1
2,916,23055,3575875314,3575875315,1
2,916,23056,3575875314,3575875316,2
2,916,23057,3575875314,3575875316,2
2,916,23058,3575875314,3575875319,5
2,916,23059,3575875314,3575875320,6
2,916,23060,3575875314,3575875322,8
2,916,23061,3575875314,3575875323,9
2,916,23062,3575875314,3575875323,9
2,916,23063,3575875314,3575875323,9
2,916,23064,3575875314,3575875326,12
2,916,23065,3575875314,3575875327,13
2,916,23066,3575875314,3575875327,13
2,916,23067,3575875314,3575875328,14
2,916,23068,3575875314,3575875329,15
2,916,23069,3575875314,3575875329,15
2,916,23070,3575875314,3575875331,17
2,916,23071,3575875314,3575875331,17
2,916,23072,3575875314,3575875332,18
2,916,23073,3575875314,3575875332,18
2,916,23074,3575875314,3575875333,19
2,916,23075,3575875314,3575875333,19
2,916,23076,3575875314,3575875333,19
2,916,23077,3575875314,3575875334,20
2,916,23078,3575875314,3575875334,20
2,916,23079,3575875314,3575875335,21
2,916,23080,3575875314,3575875335,21
2,916,23081,3575875314,3575875337,23
2,916,23082,3575875314,3575875338,24
2,916,23083,3575875314,3575875339,25
2,916,23084,3575875314,3575875340,26
2,916,23085,3575875314,3575875340,26
2,916,23086,3575875314,3575875344,30
2,916,23087,3575875314,3575875344,30
2,916,23088,3575875314,3575875344,30
2,916,23089,3575875314,3575875345,31
2,916,23090,3575875314,3575875345,31
2,916,23091,3575875314,3575875345,31
2,916,23092,3575875314,3575875347,33
2,916,23093,3575875314,3575875349,35
2,916,23094,3575875314,3575875349,35
2,916,23095,3575875314,3575875349,35
2,916,23096,3575875314,3575875349,35
2,916,23097,3575875314,3575875350,36
2,916,23098,3575875314,3575875353,39
2,916,23099,3575875314,3575875353,39
2,916,23100,3575875314,3575875354,40
2,916,23101,3575875314,3575875354,40
2,916,23102,3575875314,3575875354,40
2,916,23103,3575875314,3575875358,44
2,916,23104,3575875314,3575875361,47
2,916,23105,3575875314,3575875361,47
2,916,23106,3575875314,3575875361,47
2,917,23107,3575875375,3575875375,0
2,917,23108,3575875375,3575875375,0
2,917,23109,3575875375,3575875375,0
2,917,23110,3575875375,3575875375,0
2,917,23111,3575875375,3575875375,0
2,917,23112,3575875375,3575875375,0
2,917,23113,3575875375,3575875377,2
2,917,23114,3575875375,3575875379,4
2,917,23115,3575875375,3575875381,6
2,917,23116,3575875375,3575875381,6
2,917,23117,3575875375,3575875382,7
2,917,23118,3575875375,3575875383,8
2,917,23119,3575875375,3575875383,8
2,917,23120,3575875375,3575875384,9
2,917,23121,3575875375,3575875385,10
2,917,23122,3575875375,3575875385,10
2,917,23123,3575875375,3575875385,10
2,917,23124,3575875375,3575875387,12
2,917,23125,3575875375,3575875387,12
2,917,23126,3575875375,3575875389,14
2,917,23127,3575875375,3575875391,16
2,917,23128,3575875375,3575875391,16
2,917,23129,3575875375,3575875393,18
2,917,23130,3575875375,3575875394,19
2,917,23131,3575875375,3575875395,20
2,917,23132,3575875375,3575875397,22
2,917,23133,3575875375,3575875398,23
2,917,23134,3575875375,3575875399,24
2,917,23135,3575875375,3575875399,24
2,917,23136,3575875375,3575875400,25
2,917,23137,3575875375,3575875400,25
2,917,23138,3575875375,3575875400,25
2,917,23139,3575875375,3575875401,26
2,917,23140,3575875375,3575875403,28
2,917,23141,3575875375,3575875404,29
2,917,23142,3575875375,3575875405,30
2,917,23143,3575875375,3575875405,30
2,917,23144,3575875375,3575875406,31
2,917,23145,3575875375,3575875407,32
2,917,23146,3575875375,3575875408,33
2,917,23147,3575875375,3575875408,33
2,917,23148,3575875375,3575875410,35
2,917,23149,3575875375,3575875410,35
2,917,23150,3575875375,3575875413,38
2,917,23151,3575875375,3575875414,39
2,917,23152,3575875375,3575875416,41
2,917,23153,3575875375,3575875423,48
2,917,23154,3575875375,3575875423,48
2,918,23155,3575875439,3575875440,1
2,918,23156,3575875439,3575875440,1
2,918,23157,3575875439,3575875440,1
2,918,23158,3575875439,3575875440,1
2,918,23159,3575875439,3575875440,1
2,918,23160,3575875439,3575875440,1
2,918,23161,3575875439,3575875440,1
2,918,23162,3575875439,3575875440,1
2,918,23163,3575875439,3575875440,1
2,918,23164,3575875439,3575875441,2
2,918,23165,3575875439,3575875442,3
2,918,23166,3575875439,3575875442,3
2,918,23167,3575875439,3575875442,3
2,918,23168,3575875439,3575875442,3
2,918,23169,3575875439,3575875442,3
2,918,23170,3575875439,3575875444,5
2,918,23171,3575875439,3575875446,7
2,918,23172,3575875439,3575875449,10
2,918,23173,3575875439,3575875451,12
2,918,23174,3575875439,3575875454,15
2,918,23175,3575875439,3575875455,16
2,918,23176,3575875439,3575875455,16
2,918,23177,3575875439,3575875456,17
2,918,23178,3575875439,3575875456,17
2,918,23179,3575875439,3575875458,19
2,918,23180,3575875439,3575875460,21
2,918,23181,3575875439,3575875461,22
2,918,23182,3575875439,3575875461,22
2,918,23183,3575875439,3575875462,23
2,918,23184,3575875439,3575875462,23
2,918,23185,3575875439,3575875463,24
2,918,23186,3575875439,3575875465,26
2,918,23187,3575875439,3575875465,26
2,918,23188,3575875439,3575875466,27
2,918,23189,3575875439,3575875471,32
2,918,23190,3575875439,3575875473,34
2,918,23191,3575875439,3575875473,34
2,918,23192,3575875439,3575875477,38
2,918,23193,3575875439,3575875478,39
2,918,23194,3575875439,3575875479,40
2,918,23195,3575875439,3575875479,40
2,918,23196,3575875439,3575875480,41
2,918,23197,3575875439,3575875481,42
2,918,23198,3575875439,3575875482,43
2,918,23199,3575875439,3575875482,43
2,918,23200,3575875439,3575875482,43
2,918,23201,3575875439,3575875483,44
2,918,23202,3575875439,3575875483,44
2,918,23203,3575875439,3575875485,46
2,918,23204,3575875439,3575875485,46
2,918,23205,3575875439,3575875485,46
2,918,23206,3575875439,3575875486,47
2,918,23207,3575875439,3575875487,48
2,918,23208,3575875439,3575875487,48
2,918,23209,3575875439,3575875487,48
2,918,23210,3575875439,3575875488,49
2,918,23211,3575875439,3575875488,49
2,918,23212,3575875439,3575875489,50
2,919,23213,3575875499,3575875499,0
2,919,23214,3575875499,3575875499,0
2,919,23215,3575875499,3575875499,0
2,919,23216,3575875499,3575875499,0
2,919,23217,3575875499,3575875499,0
2,919,23218,3575875499,3575875499,0
2,919,23219,3575875499,3575875499,0
2,919,23220,3575875499,3575875499,0
2,919,23221,3575875499,3575875499,0
2,919,23222,3575875499,3575875499,0
2,919,23223,3575875499,3575875499,0
2,919,23224,3575875499,3575875499,0
2,919,23225,3575875499,3575875499,0
2,919,23226,3575875499,3575875499,0
2,919,23227,3575875499,3575875500,1
2,919,23228,3575875499,3575875500,1
2,919,23229,3575875499,3575875500,1
2,919,23230,3575875499,3575875503,4
2,919,23231,3575875499,3575875503,4
2,919,23232,3575875499,3575875504,5
2,919,23233,3575875499,3575875504,5
2,919,23234,3575875499,3575875504,5
2,919,23235,3575875499,3575875505,6
2,919,23236,3575875499,3575875506,7
2,919,23237,3575875499,3575875506,7
2,919,23238,3575875499,3575875507,8
2,919,23239,3575875499,3575875507,8
2,919,23240,3575875499,3575875507,8
2,919,23241,3575875499,3575875507,8
2,919,23242,3575875499,3575875510,11
2,919,23243,3575875499,3575875512,13
2,919,23244,3575875499,3575875512,13
2,919,23245,3575875499,3575875512,13
2,919,23246,3575875499,3575875514,15
2,919,23247,3575875499,3575875515,16
2,919,23248,3575875499,3575875515,16
2,919,23249,3575875499,3575875516,17
2,919,23250,3575875499,3575875516,17
2,919,23251,3575875499,3575875518,19
2,919,23252,3575875499,3575875518,19
2,919,23253,3575875499,3575875519,20
2,919,23254,3575875499,3575875521,22
2,919,23255,3575875499,3575875522,23
2,919,23256,3575875499,3575875522,23
2,919,23257,3575875499,3575875522,23
2,919,23258,3575875499,3575875526,27
2,919,23259,3575875499,3575875526,27
2,919,23260,3575875499,3575875526,27
2,919,23261,3575875499,3575875526,27
2,919,23262,3575875499,3575875527,28
2,919,23263,3575875499,3575875530,31
2,919,23264,3575875499,3575875530,31
2,919,23265,3575875499,3575875531,32
2,919,23266,3575875499,3575875531,32
2,919,23267,3575875499,3575875531,32
2,919,23268,3575875499,3575875531,32
2,919,23269,3575875499,3575875531,32
2,919,23270,3575875499,3575875532,33
2,919,23271,3575875499,3575875533,34
2,919,23272,3575875499,3575875534,35
2,919,23273,3575875499,3575875536,37
2,919,23274,3575875499,3575875537,38
2,919,23275,3575875499,3575875539,40
2,919,23276,3575875499,3575875539,40
2,919,23277,3575875499,3575875539,40
2,919,23278,3575875499,3575875539,40
2,919,23279,3575875499,3575875543,44
2,919,23280,3575875499,3575875543,44
2,919,23281,3575875499,3575875544,45
2,919,23282,3575875499,3575875544,45
2,919,23283,3575875499,3575875544,45
2,919,23284,3575875499,3575875544,45
2,919,23285,3575875499,3575875544,45
2,919,23286,3575875499,3575875546,47
2,919,23287,3575875499,3575875547,48
2,919,23288,3575875499,3575875548,49
2,919,23289,3575875499,3575875548,49
2,920,23290,3575875559,3575875559,0
2,920,23291,3575875559,3575875559,0
2,920,23292,3575875559,3575875559,0
2,920,23293,3575875559,3575875559,0
2,920,23294,3575875559,3575875559,0
2,920,23295,3575875559,3575875559,0
2,920,23296,3575875559,3575875559,0
2,920,23297,3575875559,3575875559,0
2,920,23298,3575875559,3575875559,0
2,920,23299,3575875559,3575875559,0
2,920,23300,3575875559,3575875560,1
2,920,23301,3575875559,3575875560,1
2,920,23302,3575875559,3575875561,2
2,920,23303,3575875559,3575875565,6
2,920,23304,3575875559,3575875566,7
2,920,23305,3575875559,3575875568,9
2,920,23306,3575875559,3575875569,10
2,920,23307,3575875559,3575875570,11
2,920,23308,3575875559,3575875572,13
2,920,23309,3575875559,3575875572,13
2,920,23310,3575875559,3575875574,15
2,920,23311,3575875559,3575875576,17
2,920,23312,3575875559,3575875578,19
2,920,23313,3575875559,3575875580,21
2,920,23314,3575875559,3575875580,21
2,920,23315,3575875559,3575875581,22
2,920,23316,3575875559,3575875582,23
2,920,23317,3575875559,3575875582,23
2,920,23318,3575875559,3575875583,24
2,920,23319,3575875559,3575875584,25
2,920,23320,3575875559,3575875584,25
2,920,23321,3575875559,3575875585,26
2,920,23322,3575875559,3575875586,27
2,920,23323,3575875559,3575875588,29
2,920,23324,3575875559,3575875590,31
2,920,23325,3575875559,3575875590,31
2,920,23326,3575875559,3575875590,31
2,920,23327,3575875559,3575875591,32
2,920,23328,3575875559,3575875592,33
2,920,23329,3575875559,3575875595,36
2,920,23330,3575875559,3575875595,36
2,920,23331,3575875559,3575875598,39
2,920,23332,3575875559,3575875598,39
2,920,23333,3575875559,3575875598,39
2,920,23334,3575875559,3575875599,40
2,920,23335,3575875559,3575875599,40
2,920,23336,3575875559,3575875600,41
2,920,23337,3575875559,3575875602,43
2,920,23338,3575875559,3575875603,44
2,920,23339,3575875559,3575875604,45
2,920,23340,3575875559,3575875604,45
2,920,23341,3575875559,3575875605,46
2,920,23342,3575875559,3575875606,47
2,920,23343,3575875559,3575875607,48
2,920,23344,3575875559,3575875607,48
2,921,23345,3575875619,3575875619,0
2,921,23346,3575875619,3575875619,0
2,921,23347,3575875619,3575875619,0
2,921,23348,3575875619,3575875619,0
2,921,23349,3575875619,3575875619,0
2,921,23350,3575875619,3575875621,2
2,921,23351,3575875619,3575875622,3
2,921,23352,3575875619,3575875623,4
2,921,23353,3575875619,3575875625,6
2,921,23354,3575875619,3575875626,7
2,921,23355,3575875619,3575875626,7
2,921,23356,3575875619,3575875627,8
2,921,23357,3575875619,3575875627,8
2,921,23358,3575875619,3575875627,8
2,921,23359,3575875619,3575875627,8
2,921,23360,3575875619,3575875634,15
2,921,23361,3575875619,3575875636,17
2,921,23362,3575875619,3575875639,20
2,921,23363,3575875619,3575875640,21
2,921,23364,3575875619,3575875640,21
2,921,23365,3575875619,3575875641,22
2,921,23366,3575875619,3575875642,23
2,921,23367,3575875619,3575875642,23
2,921,23368,3575875619,3575875642,23
2,921,23369,3575875619,3575875642,23
2,921,23370,3575875619,3575875643,24
2,921,23371,3575875619,3575875644,25
2,921,23372,3575875619,3575875644,25
2,921,23373,3575875619,3575875645,26
2,921,23374,3575875619,3575875647,28
2,921,23375,3575875619,3575875650,31
2,921,23376,3575875619,3575875654,35
2,921,23377,3575875619,3575875654,35
2,921,23378,3575875619,3575875655,36
2,921,23379,3575875619,3575875655,36
2,921,23380,3575875619,3575875658,39
2,921,23381,3575875619,3575875660,41
2,921,23382,3575875619,3575875660,41
2,921,23383,3575875619,3575875660,41
2,921,23384,3575875619,3575875661,42
2,921,23385,3575875619,3575875662,43
2,921,23386,3575875619,3575875664,45
2,921,23387,3575875619,3575875664,45
2,921,23388,3575875619,3575875666,47
2,922,23389,3575875682,3575875682,0
2,922,23390,3575875682,3575875682,0
2,922,23391,3575875682,3575875682,0
2,922,23392,3575875682,3575875682,0
2,922,23393,3575875682,3575875682,0
2,922,23394,3575875682,3575875682,0
2,922,23395,3575875682,3575875682,0
2,922,23396,3575875682,3575875682,0
2,922,23397,3575875682,3575875682,0
2,922,23398,3575875682,3575875682,0
2,922,23399,3575875682,3575875682,0
2,922,23400,3575875682,3575875682,0
2,922,23401,3575875682,3575875683,1
2,922,23402,3575875682,3575875684,2
2,922,23403,3575875682,3575875684,2
2,922,23404,3575875682,3575875685,3
2,922,23405,3575875682,3575875686,4
2,922,23406,3575875682,3575875687,5
2,922,23407,3575875682,3575875687,5
2,922,23408,3575875682,3575875687,5
2,922,23409,3575875682,3575875687,5
2,922,23410,3575875682,3575875689,7
2,922,23411,3575875682,3575875689,7
2,922,23412,3575875682,3575875689,7
2,922,23413,3575875682,3575875690,8
2,922,23414,3575875682,3575875690,8
2,922,23415,3575875682,3575875690,8
2,922,23416,3575875682,3575875691,9
2,922,23417,3575875682,3575875691,9
2,922,23418,3575875682,3575875691,9
2,922,23419,3575875682,3575875692,10
2,922,23420,3575875682,3575875693,11
2,922,23421,3575875682,3575875695,13
2,922,23422,3575875682,3575875696,14
2,922,23423,3575875682,3575875697,15
2,922,23424,3575875682,3575875698,16
2,922,23425,3575875682,3575875699,17
2,922,23426,3575875682,3575875700,18
2,922,23427,3575875682,3575875700,18
2,922,23428,3575875682,3575875700,18
2,922,23429,3575875682,3575875701,19
2,922,23430,3575875682,3575875703,21
2,922,23431,3575875682,3575875703,21
2,922,23432,3575875682,3575875704,22
2,922,23433,3575875682,3575875704,22
2,922,23434,3575875682,3575875704,22
2,922,23435,3575875682,3575875705,23
2,922,23436,3575875682,3575875706,24
2,922,23437,3575875682,3575875706,24
2,922,23438,3575875682,3575875706,24
2,922,23439,3575875682,3575875707,25
2,922,23440,3575875682,3575875707,25
2,922,23441,3575875682,3575875709,27
2,922,23442,3575875682,3575875712,30
2,922,23443,3575875682,3575875713,31
2,922,23444,3575875682,3575875714,32
2,922,23445,3575875682,3575875715,33
2,922,23446,3575875682,3575875715,33
2,922,23447,3575875682,3575875715,33
2,922,23448,3575875682,3575875716,34
2,922,23449,3575875682,3575875718,36
2,922,23450,3575875682,3575875718,36
2,922,23451,3575875682,3575875719,37
2,922,23452,3575875682,3575875721,39
2,922,23453,3575875682,3575875722,40
2,922,23454,3575875682,3575875722,40
2,922,23455,3575875682,3575875722,40
2,922,23456,3575875682,3575875726,44
2,922,23457,3575875682,3575875727,45
2,922,23458,3575875682,3575875727,45
2,922,23459,3575875682,3575875727,45
2,922,23460,3575875682,3575875727,45
2,922,23461,3575875682,3575875727,45
2,922,23462,3575875682,3575875728,46
2,922,23463,3575875682,3575875730,48
2,922,23464,3575875682,3575875730,48
2,922,23465,3575875682,3575875731,49
2,922,23466,3575875682,3575875731,49
2,922,23467,3575875682,3575875732,50
2,922,23468,3575875682,3575875732,50
2,923,23469,3575875745,3575875745,0
2,923,23470,3575875745,3575875745,0
2,923,23471,3575875745,3575875745,0
2,923,23472,3575875745,3575875745,0
2,923,23473,3575875745,3575875745,0
2,923,23474,3575875745,3575875745,0
2,923,23475,3575875745,3575875745,0
2,923,23476,3575875745,3575875745,0
2,923,23477,3575875745,3575875745,0
2,923,23478,3575875745,3575875745,0
2,923,23479,3575875745,3575875745,0
2,923,23480,3575875745,3575875745,0
2,923,23481,3575875745,3575875745,0
2,923,23482,3575875745,3575875745,0
2,923,23483,3575875745,3575875745,0
2,923,23484,3575875745,3575875745,0
2,923,23485,3575875745,3575875745,0
2,923,23486,3575875745,3575875748,3
2,923,23487,3575875745,3575875748,3
2,923,23488,3575875745,3575875748,3
2,923,23489,3575875745,3575875751,6
2,923,23490,3575875745,3575875751,6
2,923,23491,3575875745,3575875752,7
2,923,23492,3575875745,3575875752,7
2,923,23493,3575875745,3575875753,8
2,923,23494,3575875745,3575875753,8
2,923,23495,3575875745,3575875754,9
2,923,23496,3575875745,3575875757,12
2,923,23497,3575875745,3575875757,12
2,923,23498,3575875745,3575875758,13
2,923,23499,3575875745,3575875759,14
2,923,23500,3575875745,3575875760,15
2,923,23501,3575875745,3575875760,15
2,923,23502,3575875745,3575875760,15
2,923,23503,3575875745,3575875762,17
2,923,23504,3575875745,3575875765,20
2,923,23505,3575875745,3575875767,22
2,923,23506,3575875745,3575875769,24
2,923,23507,3575875745,3575875769,24
2,923,23508,3575875745,3575875770,25
2,923,23509,3575875745,3575875772,27
2,923,23510,3575875745,3575875772,27
2,923,23511,3575875745,3575875774,29
2,923,23512,3575875745,3575875777,32
2,923,23513,3575875745,3575875778,33
2,923,23514,3575875745,3575875780,35
2,923,23515,3575875745,3575875780,35
2,923,23516,3575875745,3575875781,36
2,923,23517,3575875745,3575875782,37
2,923,23518,3575875745,3575875782,37
2,923,23519,3575875745,3575875784,39
2,923,23520,3575875745,3575875784,39
2,923,23521,3575875745,3575875785,40
2,923,23522,3575875745,3575875786,41
2,923,23523,3575875745,3575875787,42
2,923,23524,3575875745,3575875790,45
2,923,23525,3575875745,3575875790,45
2,923,23526,3575875745,3575875791,46
2,923,23527,3575875745,3575875791,46
2,923,23528,3575875745,3575875792,47
2,923,23529,3575875745,3575875793,48
2,924,23530,3575875808,3575875808,0
2,924,23531,3575875808,3575875808,0
2,924,23532,3575875808,3575875808,0
2,924,23533,3575875808,3575875808,0
2,924,23534,3575875808,3575875808,0
2,924,23535,3575875808,3575875808,0
2,924,23536,3575875808,3575875808,0
2,924,23537,3575875808,3575875808,0
2,924,23538,3575875808,3575875808,0
2,924,23539,3575875808,3575875808,0
2,924,23540,3575875808,3575875808,0
2,924,23541,3575875808,3575875808,0
2,924,23542,3575875808,3575875808,0
2,924,23543,3575875808,3575875808,0
2,924,23544,3575875808,3575875808,0
2,924,23545,3575875808,3575875809,1
2,924,23546,3575875808,3575875810,2
2,924,23547,3575875808,3575875810,2
2,924,23548,3575875808,3575875813,5
2,924,23549,3575875808,3575875813,5
2,924,23550,3575875808,3575875815,7
2,924,23551,3575875808,3575875822,14
2,924,23552,3575875808,3575875822,14
2,924,23553,3575875808,3575875823,15
2,924,23554,3575875808,3575875825,17
2,924,23555,3575875808,3575875825,17
2,924,23556,3575875808,3575875825,17
2,924,23557,3575875808,3575875826,18
2,924,23558,3575875808,3575875827,19
2,924,23559,3575875808,3575875827,19
2,924,23560,3575875808,3575875827,19
2,924,23561,3575875808,3575875828,20
2,924,23562,3575875808,3575875835,27
2,924,23563,3575875808,3575875836,28
2,924,23564,3575875808,3575875837,29
2,924,23565,3575875808,3575875839,31
2,924,23566,3575875808,3575875840,32
2,924,23567,3575875808,3575875840,32
2,924,23568,3575875808,3575875840,32
2,924,23569,3575875808,3575875841,33
2,924,23570,3575875808,3575875842,34
2,924,23571,3575875808,3575875842,34
2,924,23572,3575875808,3575875842,34
2,924,23573,3575875808,3575875843,35
2,924,23574,3575875808,3575875845,37
2,924,23575,3575875808,3575875845,37
2,924,23576,3575875808,3575875848,40
2,924,23577,3575875808,3575875850,42
2,924,23578,3575875808,3575875853,45
2,924,23579,3575875808,3575875854,46
2,924,23580,3575875808,3575875854,46
2,924,23581,3575875808,3575875855,47
2,924,23582,3575875808,3575875855,47
2,924,23583,3575875808,3575875858,50
2,925,23584,3575875868,3575875868,0
2,925,23585,3575875868,3575875868,0
2,925,23586,3575875868,3575875868,0
2,925,23587,3575875868,3575875868,0
2,925,23588,3575875868,3575875868,0
2,925,23589,3575875868,3575875868,0
2,925,23590,3575875868,3575875868,0
2,925,23591,3575875868,3575875873,5
2,925,23592,3575875868,3575875874,6
2,925,23593,3575875868,3575875878,10
2,925,23594,3575875868,3575875878,10
2,925,23595,3575875868,3575875880,12
2,925,23596,3575875868,3575875880,12
2,925,23597,3575875868,3575875881,13
2,925,23598,3575875868,3575875881,13
2,925,23599,3575875868,3575875882,14
2,925,23600,3575875868,3575875883,15
2,925,23601,3575875868,3575875883,15
2,925,23602,3575875868,3575875883,15
2,925,23603,3575875868,3575875884,16
2,925,23604,3575875868,3575875885,17
2,925,23605,3575875868,3575875885,17
2,925,23606,3575875868,3575875887,19
2,925,23607,3575875868,3575875887,19
2,925,23608,3575875868,3575875887,19
2,925,23609,3575875868,3575875888,20
2,925,23610,3575875868,3575875888,20
2,925,23611,3575875868,3575875888,20
2,925,23612,3575875868,3575875889,21
2,925,23613,3575875868,3575875890,22
2,925,23614,3575875868,3575875890,22
2,925,23615,3575875868,3575875890,22
2,925,23616,3575875868,3575875891,23
2,925,23617,3575875868,3575875891,23
2,925,23618,3575875868,3575875891,23
2,925,23619,3575875868,3575875892,24
2,925,23620,3575875868,3575875892,24
2,925,23621,3575875868,3575875893,25
2,925,23622,3575875868,3575875895,27
2,925,23623,3575875868,3575875896,28
2,925,23624,3575875868,3575875897,29
2,925,23625,3575875868,3575875900,32
2,925,23626,3575875868,3575875900,32
2,925,23627,3575875868,3575875900,32
2,925,23628,3575875868,3575875900,32
2,925,23629,3575875868,3575875901,33
2,925,23630,3575875868,3575875903,35
2,925,23631,3575875868,3575875903,35
2,925,23632,3575875868,3575875904,36
2,925,23633,3575875868,3575875904,36
2,925,23634,3575875868,3575875904,36
2,925,23635,3575875868,3575875904,36
2,925,23636,3575875868,3575875905,37
2,925,23637,3575875868,3575875906,38
2,925,23638,3575875868,3575875906,38
2,925,23639,3575875868,3575875906,38
2,925,23640,3575875868,3575875907,39
2,925,23641,3575875868,3575875907,39
2,925,23642,3575875868,3575875909,41
2,925,23643,3575875868,3575875910,42
2,925,23644,3575875868,3575875913,45
2,925,23645,3575875868,3575875913,45
2,925,23646,3575875868,3575875914,46
2,925,23647,3575875868,3575875914,46
2,925,23648,3575875868,3575875914,46
2,925,23649,3575875868,3575875915,47
2,925,23650,3575875868,3575875916,48
2,925,23651,3575875868,3575875916,48
2,925,23652,3575875868,3575875918,50
2,926,23653,3575875931,3575875931,0
2,926,23654,3575875931,3575875931,0
2,926,23655,3575875931,3575875931,0
2,926,23656,3575875931,3575875931,0
2,926,23657,3575875931,3575875931,0
2,926,23658,3575875931,3575875931,0
2,926,23659,3575875931,3575875931,0
2,926,23660,3575875931,3575875931,0
2,926,23661,3575875931,3575875931,0
2,926,23662,3575875931,3575875931,0
2,926,23663,3575875931,3575875931,0
2,926,23664,3575875931,3575875931,0
2,926,23665,3575875931,3575875931,0
2,926,23666,3575875931,3575875931,0
2,926,23667,3575875931,3575875932,1
2,926,23668,3575875931,3575875932,1
2,926,23669,3575875931,3575875933,2
2,926,23670,3575875931,3575875933,2
2,926,23671,3575875931,3575875934,3
2,926,23672,3575875931,3575875934,3
2,926,23673,3575875931,3575875934,3
2,926,23674,3575875931,3575875935,4
2,926,23675,3575875931,3575875937,6
2,926,23676,3575875931,3575875937,6
2,926,23677,3575875931,3575875938,7
2,926,23678,3575875931,3575875940,9
2,926,23679,3575875931,3575875940,9
2,926,23680,3575875931,3575875944,13
2,926,23681,3575875931,3575875944,13
2,926,23682,3575875931,3575875944,13
2,926,23683,3575875931,3575875944,13
2,926,23684,3575875931,3575875945,14
2,926,23685,3575875931,3575875945,14
2,926,23686,3575875931,3575875947,16
2,926,23687,3575875931,3575875948,17
2,926,23688,3575875931,3575875949,18
2,926,23689,3575875931,3575875949,18
2,926,23690,3575875931,3575875951,20
2,926,23691,3575875931,3575875951,20
2,926,23692,3575875931,3575875952,21
2,926,23693,3575875931,3575875952,21
2,926,23694,3575875931,3575875953,22
2,926,23695,3575875931,3575875953,22
2,926,23696,3575875931,3575875954,23
2,926,23697,3575875931,3575875957,26
2,926,23698,3575875931,3575875957,26
2,926,23699,3575875931,3575875958,27
2,926,23700,3575875931,3575875960,29
2,926,23701,3575875931,3575875960,29
2,926,23702,3575875931,3575875961,30
2,926,23703,3575875931,3575875961,30
2,926,23704,3575875931,3575875962,31
2,926,23705,3575875931,3575875966,35
2,926,23706,3575875931,3575875966,35
2,926,23707,3575875931,3575875969,38
2,926,23708,3575875931,3575875969,38
2,926,23709,3575875931,3575875970,39
2,926,23710,3575875931,3575875970,39
2,926,23711,3575875931,3575875972,41
2,926,23712,3575875931,3575875973,42
2,926,23713,3575875931,3575875974,43
2,926,23714,3575875931,3575875977,46
2,926,23715,3575875931,3575875978,47
2,927,23716,3575875994,3575875994,0
2,927,23717,3575875994,3575875994,0
2,927,23718,3575875994,3575875994,0
2,927,23719,3575875994,3575875994,0
2,927,23720,3575875994,3575875994,0
2,927,23721,3575875994,3575875994,0
2,927,23722,3575875994,3575875994,0
2,927,23723,3575875994,3575875994,0
2,927,23724,3575875994,3575875994,0
2,927,23725,3575875994,3575875994,0
2,927,23726,3575875994,3575875994,0
2,927,23727,3575875994,3575875994,0
2,927,23728,3575875994,3575875994,0
2,927,23729,3575875994,3575875994,0
2,927,23730,3575875994,3575875994,0
2,927,23731,3575875994,3575875996,2
2,927,23732,3575875994,3575875996,2
2,927,23733,3575875994,3575875998,4
2,927,23734,3575875994,3575875998,4
2,927,23735,3575875994,3575875999,5
2,927,23736,3575875994,3575875999,5
2,927,23737,3575875994,3575876001,7
2,927,23738,3575875994,3575876003,9
2,927,23739,3575875994,3575876005,11
2,927,23740,3575875994,3575876005,11
2,927,23741,3575875994,3575876005,11
2,927,23742,3575875994,3575876007,13
2,927,23743,3575875994,3575876007,13
2,927,23744,3575875994,3575876008,14
2,927,23745,3575875994,3575876010,16
2,927,23746,3575875994,3575876011,17
2,927,23747,3575875994,3575876011,17
2,927,23748,3575875994,3575876012,18
2,927,23749,3575875994,3575876013,19
2,927,23750,3575875994,3575876022,28
2,927,23751,3575875994,3575876022,28
2,927,23752,3575875994,3575876023,29
2,927,23753,3575875994,3575876023,29
2,927,23754,3575875994,3575876025,31
2,927,23755,3575875994,3575876025,31
2,927,23756,3575875994,3575876025,31
2,927,23757,3575875994,3575876026,32
2,927,23758,3575875994,3575876027,33
2,927,23759,3575875994,3575876027,33
2,927,23760,3575875994,3575876028,34
2,927,23761,3575875994,3575876029,35
2,927,23762,3575875994,3575876035,41
2,927,23763,3575875994,3575876036,42
2,927,23764,3575875994,3575876037,43
2,927,23765,3575875994,3575876039,45
2,927,23766,3575875994,3575876040,46
2,927,23767,3575875994,3575876040,46
2,927,23768,3575875994,3575876041,47
2,927,23769,3575875994,3575876042,48
2,927,23770,3575875994,3575876042,48
2,927,23771,3575875994,3575876042,48
2,927,23772,3575875994,3575876043,49
2,927,23773,3575875994,3575876044,50
2,928,23774,3575876056,3575876056,0
2,928,23775,3575876056,3575876056,0
2,928,23776,3575876056,3575876056,0
2,928,23777,3575876056,3575876056,0
2,928,23778,3575876056,3575876056,0
2,928,23779,3575876056,3575876056,0
2,928,23780,3575876056,3575876056,0
2,928,23781,3575876056,3575876058,2
2,928,23782,3575876056,3575876060,4
2,928,23783,3575876056,3575876060,4
2,928,23784,3575876056,3575876063,7
2,928,23785,3575876056,3575876063,7
2,928,23786,3575876056,3575876064,8
2,928,23787,3575876056,3575876065,9
2,928,23788,3575876056,3575876066,10
2,928,23789,3575876056,3575876071,15
2,928,23790,3575876056,3575876073,17
2,928,23791,3575876056,3575876074,18
2,928,23792,3575876056,3575876077,21
2,928,23793,3575876056,3575876078,22
2,928,23794,3575876056,3575876080,24
2,928,23795,3575876056,3575876080,24
2,928,23796,3575876056,3575876081,25
2,928,23797,3575876056,3575876082,26
2,928,23798,3575876056,3575876083,27
2,928,23799,3575876056,3575876083,27
2,928,23800,3575876056,3575876084,28
2,928,23801,3575876056,3575876085,29
2,928,23802,3575876056,3575876087,31
2,928,23803,3575876056,3575876087,31
2,928,23804,3575876056,3575876087,31
2,928,23805,3575876056,3575876087,31
2,928,23806,3575876056,3575876087,31
2,928,23807,3575876056,3575876087,31
2,928,23808,3575876056,3575876089,33
2,928,23809,3575876056,3575876090,34
2,928,23810,3575876056,3575876090,34
2,928,23811,3575876056,3575876090,34
2,928,23812,3575876056,3575876090,34
2,928,23813,3575876056,3575876091,35
2,928,23814,3575876056,3575876091,35
2,928,23815,3575876056,3575876092,36
2,928,23816,3575876056,3575876092,36
2,928,23817,3575876056,3575876093,37
2,928,23818,3575876056,3575876093,37
2,928,23819,3575876056,3575876095,39
2,928,23820,3575876056,3575876097,41
2,928,23821,3575876056,3575876098,42
2,928,23822,3575876056,3575876098,42
2,928,23823,3575876056,3575876100,44
2,928,23824,3575876056,3575876100,44
2,928,23825,3575876056,3575876100,44
2,928,23826,3575876056,3575876101,45
2,928,23827,3575876056,3575876103,47
2,928,23828,3575876056,3575876104,48
2,928,23829,3575876056,3575876104,48
2,928,23830,3575876056,3575876105,49
2,928,23831,3575876056,3575876105,49
2,928,23832,3575876056,3575876105,49
2,928,23833,3575876056,3575876106,50
2,929,23834,3575876117,3575876117,0
2,929,23835,3575876117,3575876117,0
2,929,23836,3575876117,3575876117,0
2,929,23837,3575876117,3575876117,0
2,929,23838,3575876117,3575876118,1
2,929,23839,3575876117,3575876118,1
2,929,23840,3575876117,3575876118,1
2,929,23841,3575876117,3575876118,1
2,929,23842,3575876117,3575876118,1
2,929,23843,3575876117,3575876118,1
2,929,23844,3575876117,3575876118,1
2,929,23845,3575876117,3575876118,1
2,929,23846,3575876117,3575876118,1
2,929,23847,3575876117,3575876118,1
2,929,23848,3575876117,3575876118,1
2,929,23849,3575876117,3575876118,1
2,929,23850,3575876117,3575876119,2
2,929,23851,3575876117,3575876119,2
2,929,23852,3575876117,3575876122,5
2,929,23853,3575876117,3575876123,6
2,929,23854,3575876117,3575876125,8
2,929,23855,3575876117,3575876126,9
2,929,23856,3575876117,3575876127,10
2,929,23857,3575876117,3575876127,10
2,929,23858,3575876117,3575876127,10
2,929,23859,3575876117,3575876128,11
2,929,23860,3575876117,3575876128,11
2,929,23861,3575876117,3575876131,14
2,929,23862,3575876117,3575876131,14
2,929,23863,3575876117,3575876131,14
2,929,23864,3575876117,3575876131,14
2,929,23865,3575876117,3575876132,15
2,929,23866,3575876117,3575876133,16
2,929,23867,3575876117,3575876134,17
2,929,23868,3575876117,3575876134,17
2,929,23869,3575876117,3575876135,18
2,929,23870,3575876117,3575876137,20
2,929,23871,3575876117,3575876137,20
2,929,23872,3575876117,3575876138,21
2,929,23873,3575876117,3575876139,22
2,929,23874,3575876117,3575876139,22
2,929,23875,3575876117,3575876140,23
2,929,23876,3575876117,3575876144,27
2,929,23877,3575876117,3575876144,27
2,929,23878,3575876117,3575876144,27
2,929,23879,3575876117,3575876145,28
2,929,23880,3575876117,3575876146,29
2,929,23881,3575876117,3575876147,30
2,929,23882,3575876117,3575876149,32
2,929,23883,3575876117,3575876149,32
2,929,23884,3575876117,3575876149,32
2,929,23885,3575876117,3575876152,35
2,929,23886,3575876117,3575876152,35
2,929,23887,3575876117,3575876152,35
2,929,23888,3575876117,3575876153,36
2,929,23889,3575876117,3575876154,37
2,929,23890,3575876117,3575876155,38
2,929,23891,3575876117,3575876156,39
2,929,23892,3575876117,3575876158,41
2,929,23893,3575876117,3575876158,41
2,929,23894,3575876117,3575876159,42
2,929,23895,3575876117,3575876160,43
2,929,23896,3575876117,3575876160,43
2,929,23897,3575876117,3575876161,44
2,929,23898,3575876117,3575876165,48
2,929,23899,3575876117,3575876167,50
2,930,23900,3575876177,3575876177,0
2,930,23901,3575876177,3575876177,0
2,930,23902,3575876177,3575876177,0
2,930,23903,3575876177,3575876177,0
2,930,23904,3575876177,3575876177,0
2,930,23905,3575876177,3575876177,0
2,930,23906,3575876177,3575876177,0
2,930,23907,3575876177,3575876177,0
2,930,23908,3575876177,3575876177,0
2,930,23909,3575876177,3575876178,1
2,930,23910,3575876177,3575876180,3
2,930,23911,3575876177,3575876181,4
2,930,23912,3575876177,3575876183,6
2,930,23913,3575876177,3575876183,6
2,930,23914,3575876177,3575876183,6
2,930,23915,3575876177,3575876185,8
2,930,23916,3575876177,3575876185,8
2,930,23917,3575876177,3575876185,8
2,930,23918,3575876177,3575876185,8
2,930,23919,3575876177,3575876186,9
2,930,23920,3575876177,3575876187,10
2,930,23921,3575876177,3575876187,10
2,930,23922,3575876177,3575876191,14
2,930,23923,3575876177,3575876192,15
2,930,23924,3575876177,3575876192,15
2,930,23925,3575876177,3575876195,18
2,930,23926,3575876177,3575876196,19
2,930,23927,3575876177,3575876198,21
2,930,23928,3575876177,3575876199,22
2,930,23929,3575876177,3575876200,23
2,930,23930,3575876177,3575876200,23
2,930,23931,3575876177,3575876200,23
2,930,23932,3575876177,3575876201,24
2,930,23933,3575876177,3575876201,24
2,930,23934,3575876177,3575876202,25
2,930,23935,3575876177,3575876205,28
2,930,23936,3575876177,3575876205,28
2,930,23937,3575876177,3575876205,28
2,930,23938,3575876177,3575876205,28
2,930,23939,3575876177,3575876207,30
2,930,23940,3575876177,3575876207,30
2,930,23941,3575876177,3575876208,31
2,930,23942,3575876177,3575876209,32
2,930,23943,3575876177,3575876211,34
2,930,23944,3575876177,3575876211,34
2,930,23945,3575876177,3575876212,35
2,930,23946,3575876177,3575876214,37
2,930,23947,3575876177,3575876215,38
2,930,23948,3575876177,3575876222,45
2,930,23949,3575876177,3575876223,46
2,930,23950,3575876177,3575876226,49
2,930,23951,3575876177,3575876226,49
2,930,23952,3575876177,3575876226,49
2,931,23953,3575876237,3575876237,0
2,931,23954,3575876237,3575876237,0
2,931,23955,3575876237,3575876237,0
2,931,23956,3575876237,3575876237,0
2,931,23957,3575876237,3575876238,1
2,931,23958,3575876237,3575876241,4
2,931,23959,3575876237,3575876241,4
2,931,23960,3575876237,3575876241,4
2,931,23961,3575876237,3575876241,4
2,931,23962,3575876237,3575876243,6
2,931,23963,3575876237,3575876244,7
2,931,23964,3575876237,3575876244,7
2,931,23965,3575876237,3575876245,8
2,931,23966,3575876237,3575876249,12
2,931,23967,3575876237,3575876250,13
2,931,23968,3575876237,3575876254,17
2,931,23969,3575876237,3575876255,18
2,931,23970,3575876237,3575876255,18
2,931,23971,3575876237,3575876255,18
2,931,23972,3575876237,3575876255,18
2,931,23973,3575876237,3575876256,19
2,931,23974,3575876237,3575876258,21
2,931,23975,3575876237,3575876260,23
2,931,23976,3575876237,3575876260,23
2,931,23977,3575876237,3575876263,26
2,931,23978,3575876237,3575876264,27
2,931,23979,3575876237,3575876264,27
2,931,23980,3575876237,3575876266,29
2,931,23981,3575876237,3575876266,29
2,931,23982,3575876237,3575876271,34
2,931,23983,3575876237,3575876273,36
2,931,23984,3575876237,3575876274,37
2,931,23985,3575876237,3575876278,41
2,931,23986,3575876237,3575876279,42
2,931,23987,3575876237,3575876281,44
2,931,23988,3575876237,3575876282,45
2,931,23989,3575876237,3575876283,46
2,931,23990,3575876237,3575876283,46
2,931,23991,3575876237,3575876284,47
2,931,23992,3575876237,3575876285,48
2,931,23993,3575876237,3575876287,50
2,932,23994,3575876300,3575876300,0
2,932,23995,3575876300,3575876300,0
2,932,23996,3575876300,3575876300,0
2,932,23997,3575876300,3575876300,0
2,932,23998,3575876300,3575876300,0
2,932,23999,3575876300,3575876300,0
2,932,24000,3575876300,3575876300,0
2,932,24001,3575876300,3575876300,0
2,932,24002,3575876300,3575876300,0
2,932,24003,3575876300,3575876300,0
2,932,24004,3575876300,3575876300,0
2,932,24005,3575876300,3575876300,0
2,932,24006,3575876300,3575876300,0
2,932,24007,3575876300,3575876300,0
2,932,24008,3575876300,3575876300,0
2,932,24009,3575876300,3575876300,0
2,932,24010,3575876300,3575876300,0
2,932,24011,3575876300,3575876300,0
2,932,24012,3575876300,3575876300,0
2,932,24013,3575876300,3575876300,0
2,932,24014,3575876300,3575876300,0
2,932,24015,3575876300,3575876300,0
2,932,24016,3575876300,3575876300,0
2,932,24017,3575876300,3575876300,0
2,932,24018,3575876300,3575876300,0
2,932,24019,3575876300,3575876301,1
2,932,24020,3575876300,3575876303,3
2,932,24021,3575876300,3575876304,4
2,932,24022,3575876300,3575876305,5
2,932,24023,3575876300,3575876305,5
2,932,24024,3575876300,3575876305,5
2,932,24025,3575876300,3575876306,6
2,932,24026,3575876300,3575876306,6
2,932,24027,3575876300,3575876306,6
2,932,24028,3575876300,3575876307,7
2,932,24029,3575876300,3575876307,7
2,932,24030,3575876300,3575876308,8
2,932,24031,3575876300,3575876308,8
2,932,24032,3575876300,3575876309,9
2,932,24033,3575876300,3575876313,13
2,932,24034,3575876300,3575876313,13
2,932,24035,3575876300,3575876313,13
2,932,24036,3575876300,3575876314,14
2,932,24037,3575876300,3575876315,15
2,932,24038,3575876300,3575876315,15
2,932,24039,3575876300,3575876316,16
2,932,24040,3575876300,3575876316,16
2,932,24041,3575876300,3575876316,16
2,932,24042,3575876300,3575876318,18
2,932,24043,3575876300,3575876320,20
2,932,24044,3575876300,3575876322,22
2,932,24045,3575876300,3575876323,23
2,932,24046,3575876300,3575876325,25
2,932,24047,3575876300,3575876327,27
2,932,24048,3575876300,3575876327,27
2,932,24049,3575876300,3575876328,28
2,932,24050,3575876300,3575876329,29
2,932,24051,3575876300,3575876330,30
2,932,24052,3575876300,3575876331,31
2,932,24053,3575876300,3575876331,31
2,932,24054,3575876300,3575876331,31
2,932,24055,3575876300,3575876332,32
2,932,24056,3575876300,3575876332,32
2,932,24057,3575876300,3575876333,33
2,932,24058,3575876300,3575876334,34
2,932,24059,3575876300,3575876335,35
2,932,24060,3575876300,3575876335,35
2,932,24061,3575876300,3575876337,37
2,932,24062,3575876300,3575876338,38
2,932,24063,3575876300,3575876340,40
2,932,24064,3575876300,3575876340,40
2,932,24065,3575876300,3575876344,44
2,932,24066,3575876300,3575876344,44
2,932,24067,3575876300,3575876344,44
2,932,24068,3575876300,3575876344,44
2,932,24069,3575876300,3575876344,44
2,932,24070,3575876300,3575876345,45
2,932,24071,3575876300,3575876346,46
2,932,24072,3575876300,3575876346,46
2,932,24073,3575876300,3575876347,47
2,932,24074,3575876300,3575876348,48
2,932,24075,3575876300,3575876349,49
2,933,24076,3575876362,3575876362,0
2,933,24077,3575876362,3575876362,0
2,933,24078,3575876362,3575876362,0
2,933,24079,3575876362,3575876362,0
2,933,24080,3575876362,3575876362,0
2,933,24081,3575876362,3575876362,0
2,933,24082,3575876362,3575876362,0
2,933,24083,3575876362,3575876362,0
2,933,24084,3575876362,3575876362,0
2,933,24085,3575876362,3575876362,0
2,933,24086,3575876362,3575876362,0
2,933,24087,3575876362,3575876366,4
2,933,24088,3575876362,3575876366,4
2,933,24089,3575876362,3575876368,6
2,933,24090,3575876362,3575876368,6
2,933,24091,3575876362,3575876369,7
2,933,24092,3575876362,3575876370,8
2,933,24093,3575876362,3575876370,8
2,933,24094,3575876362,3575876372,10
2,933,24095,3575876362,3575876373,11
2,933,24096,3575876362,3575876373,11
2,933,24097,3575876362,3575876374,12
2,933,24098,3575876362,3575876377,15
2,933,24099,3575876362,3575876378,16
2,933,24100,3575876362,3575876379,17
2,933,24101,3575876362,3575876381,19
2,933,24102,3575876362,3575876381,19
2,933,24103,3575876362,3575876382,20
2,933,24104,3575876362,3575876383,21
2,933,24105,3575876362,3575876383,21
2,933,24106,3575876362,3575876385,23
2,933,24107,3575876362,3575876385,23
2,933,24108,3575876362,3575876386,24
2,933,24109,3575876362,3575876386,24
2,933,24110,3575876362,3575876386,24
2,933,24111,3575876362,3575876386,24
2,933,24112,3575876362,3575876390,28
2,933,24113,3575876362,3575876391,29
2,933,24114,3575876362,3575876391,29
2,933,24115,3575876362,3575876392,30
2,933,24116,3575876362,3575876393,31
2,933,24117,3575876362,3575876395,33
2,933,24118,3575876362,3575876397,35
2,933,24119,3575876362,3575876398,36
2,933,24120,3575876362,3575876399,37
2,933,24121,3575876362,3575876400,38
2,933,24122,3575876362,3575876402,40
2,933,24123,3575876362,3575876403,41
2,933,24124,3575876362,3575876404,42
2,933,24125,3575876362,3575876405,43
2,933,24126,3575876362,3575876405,43
2,933,24127,3575876362,3575876406,44
2,933,24128,3575876362,3575876408,46
2,933,24129,3575876362,3575876408,46
2,933,24130,3575876362,3575876409,47
2,933,24131,3575876362,3575876411,49
2,933,24132,3575876362,3575876411,49
2,934,24133,3575876422,3575876422,0
2,934,24134,3575876422,3575876422,0
2,934,24135,3575876422,3575876422,0
2,934,24136,3575876422,3575876423,1
2,934,24137,3575876422,3575876423,1
2,934,24138,3575876422,3575876424,2
2,934,24139,3575876422,3575876426,4
2,934,24140,3575876422,3575876426,4
2,934,24141,3575876422,3575876427,5
2,934,24142,3575876422,3575876428,6
2,934,24143,3575876422,3575876428,6
2,934,24144,3575876422,3575876429,7
2,934,24145,3575876422,3575876429,7
2,934,24146,3575876422,3575876435,13
2,934,24147,3575876422,3575876440,18
2,934,24148,3575876422,3575876440,18
2,934,24149,3575876422,3575876442,20
2,934,24150,3575876422,3575876442,20
2,934,24151,3575876422,3575876442,20
2,934,24152,3575876422,3575876444,22
2,934,24153,3575876422,3575876444,22
2,934,24154,3575876422,3575876446,24
2,934,24155,3575876422,3575876449,27
2,934,24156,3575876422,3575876450,28
2,934,24157,3575876422,3575876451,29
2,934,24158,3575876422,3575876454,32
2,934,24159,3575876422,3575876455,33
2,934,24160,3575876422,3575876455,33
2,934,24161,3575876422,3575876455,33
2,934,24162,3575876422,3575876456,34
2,934,24163,3575876422,3575876456,34
2,934,24164,3575876422,3575876457,35
2,934,24165,3575876422,3575876460,38
2,934,24166,3575876422,3575876460,38
2,934,24167,3575876422,3575876462,40
2,934,24168,3575876422,3575876464,42
2,934,24169,3575876422,3575876465,43
2,934,24170,3575876422,3575876466,44
2,934,24171,3575876422,3575876466,44
2,934,24172,3575876422,3575876471,49
2,935,24173,3575876482,3575876482,0
2,935,24174,3575876482,3575876482,0
2,935,24175,3575876482,3575876482,0
2,935,24176,3575876482,3575876482,0
2,935,24177,3575876482,3575876482,0
2,935,24178,3575876482,3575876482,0
2,935,24179,3575876482,3575876482,0
2,935,24180,3575876482,3575876482,0
2,935,24181,3575876482,3575876482,0
2,935,24182,3575876482,3575876482,0
2,935,24183,3575876482,3575876482,0
2,935,24184,3575876482,3575876484,2
2,935,24185,3575876482,3575876484,2
2,935,24186,3575876482,3575876484,2
2,935,24187,3575876482,3575876486,4
2,935,24188,3575876482,3575876486,4
2,935,24189,3575876482,3575876487,5
2,935,24190,3575876482,3575876488,6
2,935,24191,3575876482,3575876490,8
2,935,24192,3575876482,3575876490,8
2,935,24193,3575876482,3575876490,8
2,935,24194,3575876482,3575876491,9
2,935,24195,3575876482,3575876491,9
2,935,24196,3575876482,3575876491,9
2,935,24197,3575876482,3575876491,9
2,935,24198,3575876482,3575876493,11
2,935,24199,3575876482,3575876493,11
2,935,24200,3575876482,3575876495,13
2,935,24201,3575876482,3575876495,13
2,935,24202,3575876482,3575876496,14
2,935,24203,3575876482,3575876496,14
2,935,24204,3575876482,3575876497,15
2,935,24205,3575876482,3575876498,16
2,935,24206,3575876482,3575876498,16
2,935,24207,3575876482,3575876499,17
2,935,24208,3575876482,3575876499,17
2,935,24209,3575876482,3575876499,17
2,935,24210,3575876482,3575876500,18
2,935,24211,3575876482,3575876502,20
2,935,24212,3575876482,3575876503,21
2,935,24213,3575876482,3575876503,21
2,935,24214,3575876482,3575876504,22
2,935,24215,3575876482,3575876505,23
2,935,24216,3575876482,3575876505,23
2,935,24217,3575876482,3575876505,23
2,935,24218,3575876482,3575876505,23
2,935,24219,3575876482,3575876505,23
2,935,24220,3575876482,3575876506,24
2,935,24221,3575876482,3575876506,24
2,935,24222,3575876482,3575876508,26
2,935,24223,3575876482,3575876508,26
2,935,24224,3575876482,3575876511,29
2,935,24225,3575876482,3575876511,29
2,935,24226,3575876482,3575876513,31
2,935,24227,3575876482,3575876514,32
2,935,24228,3575876482,3575876514,32
2,935,24229,3575876482,3575876514,32
2,935,24230,3575876482,3575876516,34
2,935,24231,3575876482,3575876518,36
2,935,24232,3575876482,3575876518,36
2,935,24233,3575876482,3575876520,38
2,935,24234,3575876482,3575876520,38
2,935,24235,3575876482,3575876521,39
2,935,24236,3575876482,3575876522,40
2,935,24237,3575876482,3575876525,43
2,935,24238,3575876482,3575876525,43
2,935,24239,3575876482,3575876526,44
2,935,24240,3575876482,3575876526,44
2,935,24241,3575876482,3575876527,45
2,935,24242,3575876482,3575876527,45
2,935,24243,3575876482,3575876530,48
2,935,24244,3575876482,3575876530,48
2,935,24245,3575876482,3575876530,48
2,935,24246,3575876482,3575876531,49
2,935,24247,3575876482,3575876531,49
2,935,24248,3575876482,3575876532,50
2,936,24249,3575876546,3575876546,0
2,936,24250,3575876546,3575876546,0
2,936,24251,3575876546,3575876546,0
2,936,24252,3575876546,3575876546,0
2,936,24253,3575876546,3575876546,0
2,936,24254,3575876546,3575876546,0
2,936,24255,3575876546,3575876546,0
2,936,24256,3575876546,3575876546,0
2,936,24257,3575876546,3575876546,0
2,936,24258,3575876546,3575876546,0
2,936,24259,3575876546,3575876546,0
2,936,24260,3575876546,3575876546,0
2,936,24261,3575876546,3575876546,0
2,936,24262,3575876546,3575876546,0
2,936,24263,3575876546,3575876546,0
2,936,24264,3575876546,3575876546,0
2,936,24265,3575876546,3575876547,1
2,936,24266,3575876546,3575876548,2
2,936,24267,3575876546,3575876550,4
2,936,24268,3575876546,3575876551,5
2,936,24269,3575876546,3575876552,6
2,936,24270,3575876546,3575876555,9
2,936,24271,3575876546,3575876557,11
2,936,24272,3575876546,3575876558,12
2,936,24273,3575876546,3575876560,14
2,936,24274,3575876546,3575876560,14
2,936,24275,3575876546,3575876560,14
2,936,24276,3575876546,3575876561,15
2,936,24277,3575876546,3575876565,19
2,936,24278,3575876546,3575876566,20
2,936,24279,3575876546,3575876567,21
2,936,24280,3575876546,3575876568,22
2,936,24281,3575876546,3575876569,23
2,936,24282,3575876546,3575876571,25
2,936,24283,3575876546,3575876572,26
2,936,24284,3575876546,3575876573,27
2,936,24285,3575876546,3575876575,29
2,936,24286,3575876546,3575876577,31
2,936,24287,3575876546,3575876580,34
2,936,24288,3575876546,3575876580,34
2,936,24289,3575876546,3575876582,36
2,936,24290,3575876546,3575876582,36
2,936,24291,3575876546,3575876584,38
2,936,24292,3575876546,3575876584,38
2,936,24293,3575876546,3575876584,38
2,936,24294,3575876546,3575876585,39
2,936,24295,3575876546,3575876585,39
2,936,24296,3575876546,3575876586,40
2,936,24297,3575876546,3575876589,43
2,936,24298,3575876546,3575876590,44
2,936,24299,3575876546,3575876590,44
2,936,24300,3575876546,3575876591,45
2,936,24301,3575876546,3575876592,46
2,936,24302,3575876546,3575876593,47
2,936,24303,3575876546,3575876594,48
2,936,24304,3575876546,3575876596,50
2,937,24305,3575876611,3575876611,0
2,937,24306,3575876611,3575876611,0
2,937,24307,3575876611,3575876611,0
2,937,24308,3575876611,3575876611,0
2,937,24309,3575876611,3575876611,0
2,937,24310,3575876611,3575876611,0
2,937,24311,3575876611,3575876611,0
2,937,24312,3575876611,3575876611,0
2,937,24313,3575876611,3575876611,0
2,937,24314,3575876611,3575876611,0
2,937,24315,3575876611,3575876611,0
2,937,24316,3575876611,3575876611,0
2,937,24317,3575876611,3575876611,0
2,937,24318,3575876611,3575876611,0
2,937,24319,3575876611,3575876611,0
2,937,24320,3575876611,3575876613,2
2,937,24321,3575876611,3575876615,4
2,937,24322,3575876611,3575876621,10
2,937,24323,3575876611,3575876621,10
2,937,24324,3575876611,3575876623,12
2,937,24325,3575876611,3575876625,14
2,937,24326,3575876611,3575876625,14
2,937,24327,3575876611,3575876626,15
2,937,24328,3575876611,3575876626,15
2,937,24329,3575876611,3575876627,16
2,937,24330,3575876611,3575876628,17
2,937,24331,3575876611,3575876634,23
2,937,24332,3575876611,3575876636,25
2,937,24333,3575876611,3575876639,28
2,937,24334,3575876611,3575876640,29
2,937,24335,3575876611,3575876640,29
2,937,24336,3575876611,3575876641,30
2,937,24337,3575876611,3575876641,30
2,937,24338,3575876611,3575876642,31
2,937,24339,3575876611,3575876643,32
2,937,24340,3575876611,3575876643,32
2,937,24341,3575876611,3575876645,34
2,937,24342,3575876611,3575876645,34
2,937,24343,3575876611,3575876648,37
2,937,24344,3575876611,3575876649,38
2,937,24345,3575876611,3575876650,39
2,937,24346,3575876611,3575876654,43
2,937,24347,3575876611,3575876654,43
2,937,24348,3575876611,3575876654,43
2,937,24349,3575876611,3575876655,44
2,937,24350,3575876611,3575876655,44
2,937,24351,3575876611,3575876656,45
2,937,24352,3575876611,3575876657,46
2,937,24353,3575876611,3575876660,49
2,937,24354,3575876611,3575876660,49
2,938,24355,3575876673,3575876673,0
2,938,24356,3575876673,3575876673,0
2,938,24357,3575876673,3575876673,0
2,938,24358,3575876673,3575876673,0
2,938,24359,3575876673,3575876673,0
2,938,24360,3575876673,3575876673,0
2,938,24361,3575876673,3575876674,1
2,938,24362,3575876673,3575876675,2
2,938,24363,3575876673,3575876677,4
2,938,24364,3575876673,3575876677,4
2,938,24365,3575876673,3575876679,6
2,938,24366,3575876673,3575876680,7
2,938,24367,3575876673,3575876680,7
2,938,24368,3575876673,3575876680,7
2,938,24369,3575876673,3575876681,8
2,938,24370,3575876673,3575876681,8
2,938,24371,3575876673,3575876682,9
2,938,24372,3575876673,3575876682,9
2,938,24373,3575876673,3575876683,10
2,938,24374,3575876673,3575876683,10
2,938,24375,3575876673,3575876684,11
2,938,24376,3575876673,3575876684,11
2,938,24377,3575876673,3575876686,13
2,938,24378,3575876673,3575876686,13
2,938,24379,3575876673,3575876686,13
2,938,24380,3575876673,3575876687,14
2,938,24381,3575876673,3575876688,15
2,938,24382,3575876673,3575876689,16
2,938,24383,3575876673,3575876689,16
2,938,24384,3575876673,3575876690,17
2,938,24385,3575876673,3575876690,17
2,938,24386,3575876673,3575876691,18
2,938,24387,3575876673,3575876692,19
2,938,24388,3575876673,3575876692,19
2,938,24389,3575876673,3575876693,20
2,938,24390,3575876673,3575876693,20
2,938,24391,3575876673,3575876695,22
2,938,24392,3575876673,3575876695,22
2,938,24393,3575876673,3575876698,25
2,938,24394,3575876673,3575876698,25
2,938,24395,3575876673,3575876698,25
2,938,24396,3575876673,3575876699,26
2,938,24397,3575876673,3575876699,26
2,938,24398,3575876673,3575876699,26
2,938,24399,3575876673,3575876701,28
2,938,24400,3575876673,3575876702,29
2,938,24401,3575876673,3575876704,31
2,938,24402,3575876673,3575876704,31
2,938,24403,3575876673,3575876704,31
2,938,24404,3575876673,3575876705,32
2,938,24405,3575876673,3575876705,32
2,938,24406,3575876673,3575876705,32
2,938,24407,3575876673,3575876706,33
2,938,24408,3575876673,3575876706,33
2,938,24409,3575876673,3575876707,34
2,938,24410,3575876673,3575876708,35
2,938,24411,3575876673,3575876708,35
2,938,24412,3575876673,3575876710,37
2,938,24413,3575876673,3575876712,39
2,938,24414,3575876673,3575876712,39
2,938,24415,3575876673,3575876714,41
2,938,24416,3575876673,3575876714,41
2,938,24417,3575876673,3575876715,42
2,938,24418,3575876673,3575876715,42
2,938,24419,3575876673,3575876715,42
2,938,24420,3575876673,3575876718,45
2,938,24421,3575876673,3575876719,46
2,938,24422,3575876673,3575876720,47
2,938,24423,3575876673,3575876721,48
2,938,24424,3575876673,3575876722,49
2,938,24425,3575876673,3575876722,49
2,939,24426,3575876733,3575876733,0
2,939,24427,3575876733,3575876733,0
2,939,24428,3575876733,3575876733,0
2,939,24429,3575876733,3575876733,0
2,939,24430,3575876733,3575876733,0
2,939,24431,3575876733,3575876733,0
2,939,24432,3575876733,3575876733,0
2,939,24433,3575876733,3575876733,0
2,939,24434,3575876733,3575876733,0
2,939,24435,3575876733,3575876733,0
2,939,24436,3575876733,3575876733,0
2,939,24437,3575876733,3575876733,0
2,939,24438,3575876733,3575876734,1
2,939,24439,3575876733,3575876734,1
2,939,24440,3575876733,3575876734,1
2,939,24441,3575876733,3575876735,2
2,939,24442,3575876733,3575876736,3
2,939,24443,3575876733,3575876737,4
2,939,24444,3575876733,3575876739,6
2,939,24445,3575876733,3575876740,7
2,939,24446,3575876733,3575876743,10
2,939,24447,3575876733,3575876744,11
2,939,24448,3575876733,3575876744,11
2,939,24449,3575876733,3575876744,11
2,939,24450,3575876733,3575876744,11
2,939,24451,3575876733,3575876745,12
2,939,24452,3575876733,3575876746,13
2,939,24453,3575876733,3575876746,13
2,939,24454,3575876733,3575876748,15
2,939,24455,3575876733,3575876748,15
2,939,24456,3575876733,3575876749,16
2,939,24457,3575876733,3575876751,18
2,939,24458,3575876733,3575876751,18
2,939,24459,3575876733,3575876751,18
2,939,24460,3575876733,3575876753,20
2,939,24461,3575876733,3575876756,23
2,939,24462,3575876733,3575876756,23
2,939,24463,3575876733,3575876757,24
2,939,24464,3575876733,3575876758,25
2,939,24465,3575876733,3575876760,27
2,939,24466,3575876733,3575876760,27
2,939,24467,3575876733,3575876761,28
2,939,24468,3575876733,3575876762,29
2,939,24469,3575876733,3575876762,29
2,939,24470,3575876733,3575876765,32
2,939,24471,3575876733,3575876767,34
2,939,24472,3575876733,3575876769,36
2,939,24473,3575876733,3575876769,36
2,939,24474,3575876733,3575876769,36
2,939,24475,3575876733,3575876771,38
2,939,24476,3575876733,3575876772,39
2,939,24477,3575876733,3575876773,40
2,939,24478,3575876733,3575876776,43
2,939,24479,3575876733,3575876778,45
2,939,24480,3575876733,3575876779,46
2,939,24481,3575876733,3575876780,47
2,939,24482,3575876733,3575876781,48
2,939,24483,3575876733,3575876782,49
2,939,24484,3575876733,3575876783,50
2,940,24485,3575876795,3575876795,0
2,940,24486,3575876795,3575876795,0
2,940,24487,3575876795,3575876795,0
2,940,24488,3575876795,3575876795,0
2,940,24489,3575876795,3575876795,0
2,940,24490,3575876795,3575876795,0
2,940,24491,3575876795,3575876795,0
2,940,24492,3575876795,3575876795,0
2,940,24493,3575876795,3575876795,0
2,940,24494,3575876795,3575876795,0
2,940,24495,3575876795,3575876795,0
2,940,24496,3575876795,3575876795,0
2,940,24497,3575876795,3575876795,0
2,940,24498,3575876795,3575876795,0
2,940,24499,3575876795,3575876796,1
2,940,24500,3575876795,3575876797,2
2,940,24501,3575876795,3575876799,4
2,940,24502,3575876795,3575876799,4
2,940,24503,3575876795,3575876800,5
2,940,24504,3575876795,3575876802,7
2,940,24505,3575876795,3575876803,8
2,940,24506,3575876795,3575876803,8
2,940,24507,3575876795,3575876803,8
2,940,24508,3575876795,3575876804,9
2,940,24509,3575876795,3575876805,10
2,940,24510,3575876795,3575876806,11
2,940,24511,3575876795,3575876807,12
2,940,24512,3575876795,3575876807,12
2,940,24513,3575876795,3575876809,14
2,940,24514,3575876795,3575876810,15
2,940,24515,3575876795,3575876810,15
2,940,24516,3575876795,3575876811,16
2,940,24517,3575876795,3575876814,19
2,940,24518,3575876795,3575876814,19
2,940,24519,3575876795,3575876822,27
2,940,24520,3575876795,3575876822,27
2,940,24521,3575876795,3575876823,28
2,940,24522,3575876795,3575876823,28
2,940,24523,3575876795,3575876825,30
2,940,24524,3575876795,3575876826,31
2,940,24525,3575876795,3575876827,32
2,940,24526,3575876795,3575876827,32
2,940,24527,3575876795,3575876827,32
2,940,24528,3575876795,3575876827,32
2,940,24529,3575876795,3575876828,33
2,940,24530,3575876795,3575876835,40
2,940,24531,3575876795,3575876836,41
2,940,24532,3575876795,3575876839,44
2,940,24533,3575876795,3575876840,45
2,940,24534,3575876795,3575876840,45
2,940,24535,3575876795,3575876841,46
2,940,24536,3575876795,3575876842,47
2,940,24537,3575876795,3575876842,47
2,940,24538,3575876795,3575876843,48
2,940,24539,3575876795,3575876843,48
2,940,24540,3575876795,3575876845,50
2,941,24541,3575876859,3575876859,0
2,941,24542,3575876859,3575876859,0
2,941,24543,3575876859,3575876859,0
2,941,24544,3575876859,3575876859,0
2,941,24545,3575876859,3575876859,0
2,941,24546,3575876859,3575876859,0
2,941,24547,3575876859,3575876859,0
2,941,24548,3575876859,3575876859,0
2,941,24549,3575876859,3575876859,0
2,941,24550,3575876859,3575876859,0
2,941,24551,3575876859,3575876859,0
2,941,24552,3575876859,3575876860,1
2,941,24553,3575876859,3575876862,3
2,941,24554,3575876859,3575876864,5
2,941,24555,3575876859,3575876865,6
2,941,24556,3575876859,3575876866,7
2,941,24557,3575876859,3575876870,11
2,941,24558,3575876859,3575876874,15
2,941,24559,3575876859,3575876875,16
2,941,24560,3575876859,3575876877,18
2,941,24561,3575876859,3575876877,18
2,941,24562,3575876859,3575876879,20
2,941,24563,3575876859,3575876880,21
2,941,24564,3575876859,3575876881,22
2,941,24565,3575876859,3575876881,22
2,941,24566,3575876859,3575876882,23
2,941,24567,3575876859,3575876882,23
2,941,24568,3575876859,3575876883,24
2,941,24569,3575876859,3575876883,24
2,941,24570,3575876859,3575876883,24
2,941,24571,3575876859,3575876884,25
2,941,24572,3575876859,3575876884,25
2,941,24573,3575876859,3575876886,27
2,941,24574,3575876859,3575876886,27
2,941,24575,3575876859,3575876886,27
2,941,24576,3575876859,3575876887,28
2,941,24577,3575876859,3575876887,28
2,941,24578,3575876859,3575876888,29
2,941,24579,3575876859,3575876889,30
2,941,24580,3575876859,3575876890,31
2,941,24581,3575876859,3575876890,31
2,941,24582,3575876859,3575876890,31
2,941,24583,3575876859,3575876891,32
2,941,24584,3575876859,3575876891,32
2,941,24585,3575876859,3575876891,32
2,941,24586,3575876859,3575876892,33
2,941,24587,3575876859,3575876893,34
2,941,24588,3575876859,3575876893,34
2,941,24589,3575876859,3575876895,36
2,941,24590,3575876859,3575876896,37
2,941,24591,3575876859,3575876898,39
2,941,24592,3575876859,3575876898,39
2,941,24593,3575876859,3575876899,40
2,941,24594,3575876859,3575876900,41
2,941,24595,3575876859,3575876900,41
2,941,24596,3575876859,3575876902,43
2,941,24597,3575876859,3575876902,43
2,941,24598,3575876859,3575876903,44
2,941,24599,3575876859,3575876904,45
2,941,24600,3575876859,3575876904,45
2,941,24601,3575876859,3575876904,45
2,941,24602,3575876859,3575876905,46
2,941,24603,3575876859,3575876905,46
2,941,24604,3575876859,3575876905,46
2,941,24605,3575876859,3575876906,47
2,941,24606,3575876859,3575876906,47
2,941,24607,3575876859,3575876906,47
2,941,24608,3575876859,3575876908,49
2,941,24609,3575876859,3575876908,49
2,942,24610,3575876923,3575876923,0
2,942,24611,3575876923,3575876923,0
2,942,24612,3575876923,3575876923,0
2,942,24613,3575876923,3575876923,0
2,942,24614,3575876923,3575876923,0
2,942,24615,3575876923,3575876923,0
2,942,24616,3575876923,3575876923,0
2,942,24617,3575876923,3575876924,1
2,942,24618,3575876923,3575876924,1
2,942,24619,3575876923,3575876924,1
2,942,24620,3575876923,3575876924,1
2,942,24621,3575876923,3575876924,1
2,942,24622,3575876923,3575876924,1
2,942,24623,3575876923,3575876924,1
2,942,24624,3575876923,3575876924,1
2,942,24625,3575876923,3575876925,2
2,942,24626,3575876923,3575876926,3
2,942,24627,3575876923,3575876927,4
2,942,24628,3575876923,3575876928,5
2,942,24629,3575876923,3575876928,5
2,942,24630,3575876923,3575876930,7
2,942,24631,3575876923,3575876930,7
2,942,24632,3575876923,3575876931,8
2,942,24633,3575876923,3575876931,8
2,942,24634,3575876923,3575876931,8
2,942,24635,3575876923,3575876932,9
2,942,24636,3575876923,3575876932,9
2,942,24637,3575876923,3575876934,11
2,942,24638,3575876923,3575876934,11
2,942,24639,3575876923,3575876934,11
2,942,24640,3575876923,3575876937,14
2,942,24641,3575876923,3575876938,15
2,942,24642,3575876923,3575876939,16
2,942,24643,3575876923,3575876940,17
2,942,24644,3575876923,3575876943,20
2,942,24645,3575876923,3575876944,21
2,942,24646,3575876923,3575876944,21
2,942,24647,3575876923,3575876944,21
2,942,24648,3575876923,3575876944,21
2,942,24649,3575876923,3575876945,22
2,942,24650,3575876923,3575876947,24
2,942,24651,3575876923,3575876947,24
2,942,24652,3575876923,3575876949,26
2,942,24653,3575876923,3575876949,26
2,942,24654,3575876923,3575876951,28
2,942,24655,3575876923,3575876952,29
2,942,24656,3575876923,3575876952,29
2,942,24657,3575876923,3575876953,30
2,942,24658,3575876923,3575876955,32
2,942,24659,3575876923,3575876957,34
2,942,24660,3575876923,3575876957,34
2,942,24661,3575876923,3575876960,37
2,942,24662,3575876923,3575876961,38
2,942,24663,3575876923,3575876963,40
2,942,24664,3575876923,3575876966,43
2,942,24665,3575876923,3575876968,45
2,942,24666,3575876923,3575876968,45
2,942,24667,3575876923,3575876969,46
2,942,24668,3575876923,3575876969,46
2,942,24669,3575876923,3575876971,48
2,942,24670,3575876923,3575876972,49
2,942,24671,3575876923,3575876973,50
2,943,24672,3575876984,3575876984,0
2,943,24673,3575876984,3575876984,0
2,943,24674,3575876984,3575876984,0
2,943,24675,3575876984,3575876984,0
2,943,24676,3575876984,3575876984,0
2,943,24677,3575876984,3575876984,0
2,943,24678,3575876984,3575876984,0
2,943,24679,3575876984,3575876984,0
2,943,24680,3575876984,3575876985,1
2,943,24681,3575876984,3575876985,1
2,943,24682,3575876984,3575876986,2
2,943,24683,3575876984,3575876988,4
2,943,24684,3575876984,3575876989,5
2,943,24685,3575876984,3575876990,6
2,943,24686,3575876984,3575876990,6
2,943,24687,3575876984,3575876991,7
2,943,24688,3575876984,3575876992,8
2,943,24689,3575876984,3575876993,9
2,943,24690,3575876984,3575876995,11
2,943,24691,3575876984,3575876996,12
2,943,24692,3575876984,3575876999,15
2,943,24693,3575876984,3575877000,16
2,943,24694,3575876984,3575877000,16
2,943,24695,3575876984,3575877000,16
2,943,24696,3575876984,3575877001,17
2,943,24697,3575876984,3575877003,19
2,943,24698,3575876984,3575877003,19
2,943,24699,3575876984,3575877003,19
2,943,24700,3575876984,3575877004,20
2,943,24701,3575876984,3575877004,20
2,943,24702,3575876984,3575877005,21
2,943,24703,3575876984,3575877007,23
2,943,24704,3575876984,3575877007,23
2,943,24705,3575876984,3575877007,23
2,943,24706,3575876984,3575877009,25
2,943,24707,3575876984,3575877009,25
2,943,24708,3575876984,3575877010,26
2,943,24709,3575876984,3575877011,27
2,943,24710,3575876984,3575877011,27
2,943,24711,3575876984,3575877013,29
2,943,24712,3575876984,3575877015,31
2,943,24713,3575876984,3575877021,37
2,943,24714,3575876984,3575877022,38
2,943,24715,3575876984,3575877023,39
2,943,24716,3575876984,3575877024,40
2,943,24717,3575876984,3575877026,42
2,943,24718,3575876984,3575877027,43
2,943,24719,3575876984,3575877027,43
2,943,24720,3575876984,3575877027,43
2,943,24721,3575876984,3575877027,43
2,943,24722,3575876984,3575877028,44
2,944,24723,3575877046,3575877046,0
2,944,24724,3575877046,3575877046,0
2,944,24725,3575877046,3575877046,0
2,944,24726,3575877046,3575877046,0
2,944,24727,3575877046,3575877046,0
2,944,24728,3575877046,3575877046,0
2,944,24729,3575877046,3575877046,0
2,944,24730,3575877046,3575877046,0
2,944,24731,3575877046,3575877046,0
2,944,24732,3575877046,3575877046,0
2,944,24733,3575877046,3575877046,0
2,944,24734,3575877046,3575877046,0
2,944,24735,3575877046,3575877046,0
2,944,24736,3575877046,3575877046,0
2,944,24737,3575877046,3575877047,1
2,944,24738,3575877046,3575877049,3
2,944,24739,3575877046,3575877049,3
2,944,24740,3575877046,3575877054,8
2,944,24741,3575877046,3575877054,8
2,944,24742,3575877046,3575877055,9
2,944,24743,3575877046,3575877055,9
2,944,24744,3575877046,3575877056,10
2,944,24745,3575877046,3575877056,10
2,944,24746,3575877046,3575877058,12
2,944,24747,3575877046,3575877060,14
2,944,24748,3575877046,3575877062,16
2,944,24749,3575877046,3575877063,17
2,944,24750,3575877046,3575877065,19
2,944,24751,3575877046,3575877066,20
2,944,24752,3575877046,3575877067,21
2,944,24753,3575877046,3575877071,25
2,944,24754,3575877046,3575877073,27
2,944,24755,3575877046,3575877075,29
2,944,24756,3575877046,3575877077,31
2,944,24757,3575877046,3575877077,31
2,944,24758,3575877046,3575877080,34
2,944,24759,3575877046,3575877080,34
2,944,24760,3575877046,3575877080,34
2,944,24761,3575877046,3575877081,35
2,944,24762,3575877046,3575877081,35
2,944,24763,3575877046,3575877083,37
2,944,24764,3575877046,3575877084,38
2,944,24765,3575877046,3575877084,38
2,944,24766,3575877046,3575877085,39
2,944,24767,3575877046,3575877085,39
2,944,24768,3575877046,3575877086,40
2,944,24769,3575877046,3575877086,40
2,944,24770,3575877046,3575877087,41
2,944,24771,3575877046,3575877088,42
2,944,24772,3575877046,3575877088,42
2,944,24773,3575877046,3575877088,42
2,944,24774,3575877046,3575877090,44
2,944,24775,3575877046,3575877090,44
2,944,24776,3575877046,3575877091,45
2,944,24777,3575877046,3575877091,45
2,944,24778,3575877046,3575877091,45
2,944,24779,3575877046,3575877092,46
2,944,24780,3575877046,3575877093,47
2,944,24781,3575877046,3575877094,48
2,944,24782,3575877046,3575877095,49
2,944,24783,3575877046,3575877095,49
2,944,24784,3575877046,3575877096,50
2,945,24785,3575877104,3575877104,0
2,945,24786,3575877104,3575877104,0
2,945,24787,3575877104,3575877104,0
2,945,24788,3575877104,3575877104,0
2,945,24789,3575877104,3575877104,0
2,945,24790,3575877104,3575877104,0
2,945,24791,3575877104,3575877104,0
2,945,24792,3575877104,3575877104,0
2,945,24793,3575877104,3575877104,0
2,945,24794,3575877104,3575877104,0
2,945,24795,3575877104,3575877104,0
2,945,24796,3575877104,3575877104,0
2,945,24797,3575877104,3575877105,1
2,945,24798,3575877104,3575877105,1
2,945,24799,3575877104,3575877105,1
2,945,24800,3575877104,3575877105,1
2,945,24801,3575877104,3575877106,2
2,945,24802,3575877104,3575877108,4
2,945,24803,3575877104,3575877108,4
2,945,24804,3575877104,3575877112,8
2,945,24805,3575877104,3575877112,8
2,945,24806,3575877104,3575877113,9
2,945,24807,3575877104,3575877114,10
2,945,24808,3575877104,3575877114,10
2,945,24809,3575877104,3575877116,12
2,945,24810,3575877104,3575877116,12
2,945,24811,3575877104,3575877119,15
2,945,24812,3575877104,3575877119,15
2,945,24813,3575877104,3575877119,15
2,945,24814,3575877104,3575877121,17
2,945,24815,3575877104,3575877122,18
2,945,24816,3575877104,3575877122,18
2,945,24817,3575877104,3575877123,19
2,945,24818,3575877104,3575877126,22
2,945,24819,3575877104,3575877126,22
2,945,24820,3575877104,3575877127,23
2,945,24821,3575877104,3575877127,23
2,945,24822,3575877104,3575877128,24
2,945,24823,3575877104,3575877130,26
2,945,24824,3575877104,3575877130,26
2,945,24825,3575877104,3575877130,26
2,945,24826,3575877104,3575877131,27
2,945,24827,3575877104,3575877132,28
2,945,24828,3575877104,3575877132,28
2,945,24829,3575877104,3575877132,28
2,945,24830,3575877104,3575877133,29
2,945,24831,3575877104,3575877134,30
2,945,24832,3575877104,3575877134,30
2,945,24833,3575877104,3575877134,30
2,945,24834,3575877104,3575877137,33
2,945,24835,3575877104,3575877137,33
2,945,24836,3575877104,3575877138,34
2,945,24837,3575877104,3575877140,36
2,945,24838,3575877104,3575877140,36
2,945,24839,3575877104,3575877140,36
2,945,24840,3575877104,3575877143,39
2,945,24841,3575877104,3575877143,39
2,945,24842,3575877104,3575877144,40
2,945,24843,3575877104,3575877145,41
2,945,24844,3575877104,3575877145,41
2,945,24845,3575877104,3575877145,41
2,945,24846,3575877104,3575877146,42
2,945,24847,3575877104,3575877147,43
2,945,24848,3575877104,3575877148,44
2,945,24849,3575877104,3575877149,45
2,945,24850,3575877104,3575877149,45
2,945,24851,3575877104,3575877151,47
2,945,24852,3575877104,3575877152,48
2,945,24853,3575877104,3575877152,48
2,945,24854,3575877104,3575877153,49
2,945,24855,3575877104,3575877154,50
2,946,24856,3575877168,3575877168,0
2,946,24857,3575877168,3575877168,0
2,946,24858,3575877168,3575877168,0
2,946,24859,3575877168,3575877168,0
2,946,24860,3575877168,3575877168,0
2,946,24861,3575877168,3575877168,0
2,946,24862,3575877168,3575877168,0
2,946,24863,3575877168,3575877168,0
2,946,24864,3575877168,3575877168,0
2,946,24865,3575877168,3575877168,0
2,946,24866,3575877168,3575877168,0
2,946,24867,3575877168,3575877170,2
2,946,24868,3575877168,3575877170,2
2,946,24869,3575877168,3575877171,3
2,946,24870,3575877168,3575877172,4
2,946,24871,3575877168,3575877174,6
2,946,24872,3575877168,3575877178,10
2,946,24873,3575877168,3575877178,10
2,946,24874,3575877168,3575877181,13
2,946,24875,3575877168,3575877181,13
2,946,24876,3575877168,3575877183,15
2,946,24877,3575877168,3575877184,16
2,946,24878,3575877168,3575877184,16
2,946,24879,3575877168,3575877185,17
2,946,24880,3575877168,3575877185,17
2,946,24881,3575877168,3575877186,18
2,946,24882,3575877168,3575877186,18
2,946,24883,3575877168,3575877189,21
2,946,24884,3575877168,3575877190,22
2,946,24885,3575877168,3575877190,22
2,946,24886,3575877168,3575877190,22
2,946,24887,3575877168,3575877191,23
2,946,24888,3575877168,3575877192,24
2,946,24889,3575877168,3575877194,26
2,946,24890,3575877168,3575877196,28
2,946,24891,3575877168,3575877197,29
2,946,24892,3575877168,3575877199,31
2,946,24893,3575877168,3575877199,31
2,946,24894,3575877168,3575877200,32
2,946,24895,3575877168,3575877202,34
2,946,24896,3575877168,3575877203,35
2,946,24897,3575877168,3575877205,37
2,946,24898,3575877168,3575877205,37
2,946,24899,3575877168,3575877205,37
2,946,24900,3575877168,3575877205,37
2,946,24901,3575877168,3575877207,39
2,946,24902,3575877168,3575877210,42
2,946,24903,3575877168,3575877210,42
2,946,24904,3575877168,3575877211,43
2,946,24905,3575877168,3575877215,47
2,947,24906,3575877232,3575877232,0
2,947,24907,3575877232,3575877232,0
2,947,24908,3575877232,3575877232,0
2,947,24909,3575877232,3575877232,0
2,947,24910,3575877232,3575877232,0
2,947,24911,3575877232,3575877232,0
2,947,24912,3575877232,3575877232,0
2,947,24913,3575877232,3575877232,0
2,947,24914,3575877232,3575877232,0
2,947,24915,3575877232,3575877232,0
2,947,24916,3575877232,3575877235,3
2,947,24917,3575877232,3575877236,4
2,947,24918,3575877232,3575877237,5
2,947,24919,3575877232,3575877239,7
2,947,24920,3575877232,3575877239,7
2,947,24921,3575877232,3575877240,8
2,947,24922,3575877232,3575877242,10
2,947,24923,3575877232,3575877243,11
2,947,24924,3575877232,3575877243,11
2,947,24925,3575877232,3575877245,13
2,947,24926,3575877232,3575877245,13
2,947,24927,3575877232,3575877246,14
2,947,24928,3575877232,3575877248,16
2,947,24929,3575877232,3575877250,18
2,947,24930,3575877232,3575877250,18
2,947,24931,3575877232,3575877254,22
2,947,24932,3575877232,3575877254,22
2,947,24933,3575877232,3575877255,23
2,947,24934,3575877232,3575877256,24
2,947,24935,3575877232,3575877256,24
2,947,24936,3575877232,3575877257,25
2,947,24937,3575877232,3575877258,26
2,947,24938,3575877232,3575877259,27
2,947,24939,3575877232,3575877263,31
2,947,24940,3575877232,3575877263,31
2,947,24941,3575877232,3575877266,34
2,947,24942,3575877232,3575877267,35
2,947,24943,3575877232,3575877271,39
2,947,24944,3575877232,3575877273,41
2,947,24945,3575877232,3575877276,44
2,947,24946,3575877232,3575877277,45
2,947,24947,3575877232,3575877277,45
2,947,24948,3575877232,3575877280,48
2,947,24949,3575877232,3575877280,48
2,947,24950,3575877232,3575877281,49
2,947,24951,3575877232,3575877282,50
2,948,24952,3575877296,3575877296,0
2,948,24953,3575877296,3575877296,0
2,948,24954,3575877296,3575877296,0
2,948,24955,3575877296,3575877296,0
2,948,24956,3575877296,3575877296,0
2,948,24957,3575877296,3575877296,0
2,948,24958,3575877296,3575877296,0
2,948,24959,3575877296,3575877296,0
2,948,24960,3575877296,3575877296,0
2,948,24961,3575877296,3575877296,0
2,948,24962,3575877296,3575877296,0
2,948,24963,3575877296,3575877296,0
2,948,24964,3575877296,3575877296,0
2,948,24965,3575877296,3575877296,0
2,948,24966,3575877296,3575877296,0
2,948,24967,3575877296,3575877296,0
2,948,24968,3575877296,3575877296,0
2,948,24969,3575877296,3575877296,0
2,948,24970,3575877296,3575877296,0
2,948,24971,3575877296,3575877296,0
2,948,24972,3575877296,3575877296,0
2,948,24973,3575877296,3575877297,1
2,948,24974,3575877296,3575877300,4
2,948,24975,3575877296,3575877300,4
2,948,24976,3575877296,3575877300,4
2,948,24977,3575877296,3575877301,5
2,948,24978,3575877296,3575877301,5
2,948,24979,3575877296,3575877301,5
2,948,24980,3575877296,3575877302,6
2,948,24981,3575877296,3575877302,6
2,948,24982,3575877296,3575877303,7
2,948,24983,3575877296,3575877304,8
2,948,24984,3575877296,3575877304,8
2,948,24985,3575877296,3575877305,9
2,948,24986,3575877296,3575877305,9
2,948,24987,3575877296,3575877306,10
2,948,24988,3575877296,3575877306,10
2,948,24989,3575877296,3575877306,10
2,948,24990,3575877296,3575877306,10
2,948,24991,3575877296,3575877306,10
2,948,24992,3575877296,3575877308,12
2,948,24993,3575877296,3575877308,12
2,948,24994,3575877296,3575877308,12
2,948,24995,3575877296,3575877309,13
2,948,24996,3575877296,3575877312,16
2,948,24997,3575877296,3575877313,17
2,948,24998,3575877296,3575877313,17
2,948,24999,3575877296,3575877315,19
2,948,25000,3575877296,3575877317,21
2,948,25001,3575877296,3575877318,22
2,948,25002,3575877296,3575877319,23
2,948,25003,3575877296,3575877320,24
2,948,25004,3575877296,3575877321,25
2,948,25005,3575877296,3575877321,25
2,948,25006,3575877296,3575877322,26
2,948,25007,3575877296,3575877324,28
2,948,25008,3575877296,3575877324,28
2,948,25009,3575877296,3575877326,30
2,948,25010,3575877296,3575877326,30
2,948,25011,3575877296,3575877327,31
2,948,25012,3575877296,3575877328,32
2,948,25013,3575877296,3575877328,32
2,948,25014,3575877296,3575877330,34
2,948,25015,3575877296,3575877330,34
2,948,25016,3575877296,3575877331,35
2,948,25017,3575877296,3575877331,35
2,948,25018,3575877296,3575877331,35
2,948,25019,3575877296,3575877332,36
2,948,25020,3575877296,3575877332,36
2,948,25021,3575877296,3575877334,38
2,948,25022,3575877296,3575877334,38
2,948,25023,3575877296,3575877335,39
2,948,25024,3575877296,3575877335,39
2,948,25025,3575877296,3575877337,41
2,948,25026,3575877296,3575877338,42
2,948,25027,3575877296,3575877338,42
2,948,25028,3575877296,3575877339,43
2,948,25029,3575877296,3575877339,43
2,948,25030,3575877296,3575877340,44
2,948,25031,3575877296,3575877343,47
2,948,25032,3575877296,3575877344,48
2,948,25033,3575877296,3575877344,48
2,948,25034,3575877296,3575877344,48
2,948,25035,3575877296,3575877344,48
2,948,25036,3575877296,3575877345,49
2,948,25037,3575877296,3575877345,49
2,949,25038,3575877356,3575877356,0
2,949,25039,3575877356,3575877356,0
2,949,25040,3575877356,3575877356,0
2,949,25041,3575877356,3575877356,0
2,949,25042,3575877356,3575877356,0
2,949,25043,3575877356,3575877356,0
2,949,25044,3575877356,3575877356,0
2,949,25045,3575877356,3575877356,0
2,949,25046,3575877356,3575877357,1
2,949,25047,3575877356,3575877357,1
2,949,25048,3575877356,3575877358,2
2,949,25049,3575877356,3575877361,5
2,949,25050,3575877356,3575877361,5
2,949,25051,3575877356,3575877362,6
2,949,25052,3575877356,3575877366,10
2,949,25053,3575877356,3575877367,11
2,949,25054,3575877356,3575877367,11
2,949,25055,3575877356,3575877368,12
2,949,25056,3575877356,3575877369,13
2,949,25057,3575877356,3575877370,14
2,949,25058,3575877356,3575877370,14
2,949,25059,3575877356,3575877371,15
2,949,25060,3575877356,3575877373,17
2,949,25061,3575877356,3575877374,18
2,949,25062,3575877356,3575877377,21
2,949,25063,3575877356,3575877379,23
2,949,25064,3575877356,3575877379,23
2,949,25065,3575877356,3575877380,24
2,949,25066,3575877356,3575877381,25
2,949,25067,3575877356,3575877382,26
2,949,25068,3575877356,3575877384,28
2,949,25069,3575877356,3575877384,28
2,949,25070,3575877356,3575877384,28
2,949,25071,3575877356,3575877385,29
2,949,25072,3575877356,3575877386,30
2,949,25073,3575877356,3575877386,30
2,949,25074,3575877356,3575877386,30
2,949,25075,3575877356,3575877387,31
2,949,25076,3575877356,3575877389,33
2,949,25077,3575877356,3575877390,34
2,949,25078,3575877356,3575877390,34
2,949,25079,3575877356,3575877391,35
2,949,25080,3575877356,3575877391,35
2,949,25081,3575877356,3575877392,36
2,949,25082,3575877356,3575877393,37
2,949,25083,3575877356,3575877394,38
2,949,25084,3575877356,3575877396,40
2,949,25085,3575877356,3575877397,41
2,949,25086,3575877356,3575877398,42
2,949,25087,3575877356,3575877399,43
2,949,25088,3575877356,3575877401,45
2,949,25089,3575877356,3575877401,45
2,949,25090,3575877356,3575877403,47
2,949,25091,3575877356,3575877404,48
2,949,25092,3575877356,3575877404,48
2,949,25093,3575877356,3575877405,49
2,950,25094,3575877420,3575877420,0
2,950,25095,3575877420,3575877420,0
2,950,25096,3575877420,3575877420,0
2,950,25097,3575877420,3575877420,0
2,950,25098,3575877420,3575877420,0
2,950,25099,3575877420,3575877420,0
2,950,25100,3575877420,3575877420,0
2,950,25101,3575877420,3575877422,2
2,950,25102,3575877420,3575877423,3
2,950,25103,3575877420,3575877424,4
2,950,25104,3575877420,3575877426,6
2,950,25105,3575877420,3575877427,7
2,950,25106,3575877420,3575877428,8
2,950,25107,3575877420,3575877428,8
2,950,25108,3575877420,3575877429,9
2,950,25109,3575877420,3575877430,10
2,950,25110,3575877420,3575877435,15
2,950,25111,3575877420,3575877437,17
2,950,25112,3575877420,3575877438,18
2,950,25113,3575877420,3575877440,20
2,950,25114,3575877420,3575877440,20
2,950,25115,3575877420,3575877441,21
2,950,25116,3575877420,3575877442,22
2,950,25117,3575877420,3575877442,22
2,950,25118,3575877420,3575877443,23
2,950,25119,3575877420,3575877444,24
2,950,25120,3575877420,3575877444,24
2,950,25121,3575877420,3575877444,24
2,950,25122,3575877420,3575877445,25
2,950,25123,3575877420,3575877447,27
2,950,25124,3575877420,3575877448,28
2,950,25125,3575877420,3575877450,30
2,950,25126,3575877420,3575877451,31
2,950,25127,3575877420,3575877454,34
2,950,25128,3575877420,3575877455,35
2,950,25129,3575877420,3575877455,35
2,950,25130,3575877420,3575877457,37
2,950,25131,3575877420,3575877457,37
2,950,25132,3575877420,3575877458,38
2,950,25133,3575877420,3575877460,40
2,950,25134,3575877420,3575877463,43
2,950,25135,3575877420,3575877463,43
2,950,25136,3575877420,3575877466,46
2,950,25137,3575877420,3575877467,47
2,950,25138,3575877420,3575877470,50
2,951,25139,3575877482,3575877482,0
2,951,25140,3575877482,3575877482,0
2,951,25141,3575877482,3575877482,0
2,951,25142,3575877482,3575877482,0
2,951,25143,3575877482,3575877482,0
2,951,25144,3575877482,3575877482,0
2,951,25145,3575877482,3575877482,0
2,951,25146,3575877482,3575877482,0
2,951,25147,3575877482,3575877482,0
2,951,25148,3575877482,3575877482,0
2,951,25149,3575877482,3575877485,3
2,951,25150,3575877482,3575877485,3
2,951,25151,3575877482,3575877485,3
2,951,25152,3575877482,3575877486,4
2,951,25153,3575877482,3575877487,5
2,951,25154,3575877482,3575877487,5
2,951,25155,3575877482,3575877488,6
2,951,25156,3575877482,3575877489,7
2,951,25157,3575877482,3575877489,7
2,951,25158,3575877482,3575877489,7
2,951,25159,3575877482,3575877490,8
2,951,25160,3575877482,3575877490,8
2,951,25161,3575877482,3575877490,8
2,951,25162,3575877482,3575877492,10
2,951,25163,3575877482,3575877492,10
2,951,25164,3575877482,3575877493,11
2,951,25165,3575877482,3575877494,12
2,951,25166,3575877482,3575877497,15
2,951,25167,3575877482,3575877499,17
2,951,25168,3575877482,3575877499,17
2,951,25169,3575877482,3575877500,18
2,951,25170,3575877482,3575877501,19
2,951,25171,3575877482,3575877501,19
2,951,25172,3575877482,3575877501,19
2,951,25173,3575877482,3575877501,19
2,951,25174,3575877482,3575877502,20
2,951,25175,3575877482,3575877503,21
2,951,25176,3575877482,3575877503,21
2,951,25177,3575877482,3575877503,21
2,951,25178,3575877482,3575877504,22
2,951,25179,3575877482,3575877504,22
2,951,25180,3575877482,3575877505,23
2,951,25181,3575877482,3575877505,23
2,951,25182,3575877482,3575877506,24
2,951,25183,3575877482,3575877506,24
2,951,25184,3575877482,3575877508,26
2,951,25185,3575877482,3575877508,26
2,951,25186,3575877482,3575877508,26
2,951,25187,3575877482,3575877511,29
2,951,25188,3575877482,3575877512,30
2,951,25189,3575877482,3575877512,30
2,951,25190,3575877482,3575877512,30
2,951,25191,3575877482,3575877513,31
2,951,25192,3575877482,3575877515,33
2,951,25193,3575877482,3575877515,33
2,951,25194,3575877482,3575877515,33
2,951,25195,3575877482,3575877517,35
2,951,25196,3575877482,3575877518,36
2,951,25197,3575877482,3575877519,37
2,951,25198,3575877482,3575877521,39
2,951,25199,3575877482,3575877521,39
2,951,25200,3575877482,3575877521,39
2,951,25201,3575877482,3575877523,41
2,951,25202,3575877482,3575877524,42
2,951,25203,3575877482,3575877525,43
2,951,25204,3575877482,3575877526,44
2,951,25205,3575877482,3575877527,45
2,951,25206,3575877482,3575877528,46
2,951,25207,3575877482,3575877528,46
2,951,25208,3575877482,3575877529,47
2,951,25209,3575877482,3575877529,47
2,951,25210,3575877482,3575877529,47
2,951,25211,3575877482,3575877530,48
2,951,25212,3575877482,3575877530,48
2,951,25213,3575877482,3575877531,49
2,951,25214,3575877482,3575877531,49
2,951,25215,3575877482,3575877532,50
2,952,25216,3575877543,3575877543,0
2,952,25217,3575877543,3575877543,0
2,952,25218,3575877543,3575877543,0
2,952,25219,3575877543,3575877543,0
2,952,25220,3575877543,3575877543,0
2,952,25221,3575877543,3575877543,0
2,952,25222,3575877543,3575877543,0
2,952,25223,3575877543,3575877543,0
2,952,25224,3575877543,3575877543,0
2,952,25225,3575877543,3575877543,0
2,952,25226,3575877543,3575877543,0
2,952,25227,3575877543,3575877543,0
2,952,25228,3575877543,3575877543,0
2,952,25229,3575877543,3575877544,1
2,952,25230,3575877543,3575877544,1
2,952,25231,3575877543,3575877544,1
2,952,25232,3575877543,3575877546,3
2,952,25233,3575877543,3575877547,4
2,952,25234,3575877543,3575877547,4
2,952,25235,3575877543,3575877548,5
2,952,25236,3575877543,3575877548,5
2,952,25237,3575877543,3575877549,6
2,952,25238,3575877543,3575877550,7
2,952,25239,3575877543,3575877551,8
2,952,25240,3575877543,3575877551,8
2,952,25241,3575877543,3575877553,10
2,952,25242,3575877543,3575877553,10
2,952,25243,3575877543,3575877555,12
2,952,25244,3575877543,3575877557,14
2,952,25245,3575877543,3575877557,14
2,952,25246,3575877543,3575877559,16
2,952,25247,3575877543,3575877559,16
2,952,25248,3575877543,3575877560,17
2,952,25249,3575877543,3575877561,18
2,952,25250,3575877543,3575877561,18
2,952,25251,3575877543,3575877561,18
2,952,25252,3575877543,3575877565,22
2,952,25253,3575877543,3575877566,23
2,952,25254,3575877543,3575877566,23
2,952,25255,3575877543,3575877567,24
2,952,25256,3575877543,3575877567,24
2,952,25257,3575877543,3575877567,24
2,952,25258,3575877543,3575877569,26
2,952,25259,3575877543,3575877570,27
2,952,25260,3575877543,3575877570,27
2,952,25261,3575877543,3575877572,29
2,952,25262,3575877543,3575877573,30
2,952,25263,3575877543,3575877575,32
2,952,25264,3575877543,3575877578,35
2,952,25265,3575877543,3575877578,35
2,952,25266,3575877543,3575877580,37
2,952,25267,3575877543,3575877581,38
2,952,25268,3575877543,3575877581,38
2,952,25269,3575877543,3575877582,39
2,952,25270,3575877543,3575877584,41
2,952,25271,3575877543,3575877584,41
2,952,25272,3575877543,3575877584,41
2,952,25273,3575877543,3575877585,42
2,952,25274,3575877543,3575877585,42
2,952,25275,3575877543,3575877585,42
2,952,25276,3575877543,3575877587,44
2,952,25277,3575877543,3575877589,46
2,952,25278,3575877543,3575877589,46
2,952,25279,3575877543,3575877590,47
2,952,25280,3575877543,3575877590,47
2,952,25281,3575877543,3575877590,47
2,952,25282,3575877543,3575877591,48
2,953,25283,3575877606,3575877606,0
2,953,25284,3575877606,3575877606,0
2,953,25285,3575877606,3575877606,0
2,953,25286,3575877606,3575877606,0
2,953,25287,3575877606,3575877606,0
2,953,25288,3575877606,3575877606,0
2,953,25289,3575877606,3575877606,0
2,953,25290,3575877606,3575877606,0
2,953,25291,3575877606,3575877606,0
2,953,25292,3575877606,3575877606,0
2,953,25293,3575877606,3575877606,0
2,953,25294,3575877606,3575877606,0
2,953,25295,3575877606,3575877606,0
2,953,25296,3575877606,3575877607,1
2,953,25297,3575877606,3575877607,1
2,953,25298,3575877606,3575877608,2
2,953,25299,3575877606,3575877609,3
2,953,25300,3575877606,3575877609,3
2,953,25301,3575877606,3575877612,6
2,953,25302,3575877606,3575877613,7
2,953,25303,3575877606,3575877614,8
2,953,25304,3575877606,3575877621,15
2,953,25305,3575877606,3575877621,15
2,953,25306,3575877606,3575877622,16
2,953,25307,3575877606,3575877623,17
2,953,25308,3575877606,3575877623,17
2,953,25309,3575877606,3575877625,19
2,953,25310,3575877606,3575877626,20
2,953,25311,3575877606,3575877626,20
2,953,25312,3575877606,3575877626,20
2,953,25313,3575877606,3575877628,22
2,953,25314,3575877606,3575877629,23
2,953,25315,3575877606,3575877635,29
2,953,25316,3575877606,3575877636,30
2,953,25317,3575877606,3575877639,33
2,953,25318,3575877606,3575877640,34
2,953,25319,3575877606,3575877641,35
2,953,25320,3575877606,3575877642,36
2,953,25321,3575877606,3575877642,36
2,953,25322,3575877606,3575877643,37
2,953,25323,3575877606,3575877644,38
2,953,25324,3575877606,3575877644,38
2,953,25325,3575877606,3575877645,39
2,953,25326,3575877606,3575877645,39
2,953,25327,3575877606,3575877647,41
2,953,25328,3575877606,3575877649,43
2,953,25329,3575877606,3575877650,44
2,953,25330,3575877606,3575877653,47
2,953,25331,3575877606,3575877655,49
2,953,25332,3575877606,3575877655,49
2,953,25333,3575877606,3575877656,50
2,954,25334,3575877666,3575877667,1
2,954,25335,3575877666,3575877667,1
2,954,25336,3575877666,3575877667,1
2,954,25337,3575877666,3575877667,1
2,954,25338,3575877666,3575877667,1
2,954,25339,3575877666,3575877667,1
2,954,25340,3575877666,3575877667,1
2,954,25341,3575877666,3575877667,1
2,954,25342,3575877666,3575877670,4
2,954,25343,3575877666,3575877673,7
2,954,25344,3575877666,3575877677,11
2,954,25345,3575877666,3575877679,13
2,954,25346,3575877666,3575877680,14
2,954,25347,3575877666,3575877680,14
2,954,25348,3575877666,3575877680,14
2,954,25349,3575877666,3575877680,14
2,954,25350,3575877666,3575877682,16
2,954,25351,3575877666,3575877682,16
2,954,25352,3575877666,3575877683,17
2,954,25353,3575877666,3575877685,19
2,954,25354,3575877666,3575877685,19
2,954,25355,3575877666,3575877685,19
2,954,25356,3575877666,3575877686,20
2,954,25357,3575877666,3575877686,20
2,954,25358,3575877666,3575877687,21
2,954,25359,3575877666,3575877687,21
2,954,25360,3575877666,3575877688,22
2,954,25361,3575877666,3575877688,22
2,954,25362,3575877666,3575877689,23
2,954,25363,3575877666,3575877689,23
2,954,25364,3575877666,3575877690,24
2,954,25365,3575877666,3575877692,26
2,954,25366,3575877666,3575877693,27
2,954,25367,3575877666,3575877693,27
2,954,25368,3575877666,3575877695,29
2,954,25369,3575877666,3575877696,30
2,954,25370,3575877666,3575877697,31
2,954,25371,3575877666,3575877699,33
2,954,25372,3575877666,3575877700,34
2,954,25373,3575877666,3575877700,34
2,954,25374,3575877666,3575877700,34
2,954,25375,3575877666,3575877700,34
2,954,25376,3575877666,3575877701,35
2,954,25377,3575877666,3575877701,35
2,954,25378,3575877666,3575877702,36
2,954,25379,3575877666,3575877702,36
2,954,25380,3575877666,3575877703,37
2,954,25381,3575877666,3575877704,38
2,954,25382,3575877666,3575877704,38
2,954,25383,3575877666,3575877704,38
2,954,25384,3575877666,3575877705,39
2,954,25385,3575877666,3575877705,39
2,954,25386,3575877666,3575877705,39
2,954,25387,3575877666,3575877706,40
2,954,25388,3575877666,3575877708,42
2,954,25389,3575877666,3575877708,42
2,954,25390,3575877666,3575877708,42
2,954,25391,3575877666,3575877710,44
2,954,25392,3575877666,3575877711,45
2,954,25393,3575877666,3575877711,45
2,954,25394,3575877666,3575877712,46
2,954,25395,3575877666,3575877713,47
2,954,25396,3575877666,3575877714,48
2,954,25397,3575877666,3575877714,48
2,954,25398,3575877666,3575877715,49
2,954,25399,3575877666,3575877715,49
2,955,25400,3575877727,3575877727,0
2,955,25401,3575877727,3575877727,0
2,955,25402,3575877727,3575877727,0
2,955,25403,3575877727,3575877727,0
2,955,25404,3575877727,3575877727,0
2,955,25405,3575877727,3575877727,0
2,955,25406,3575877727,3575877727,0
2,955,25407,3575877727,3575877727,0
2,955,25408,3575877727,3575877727,0
2,955,25409,3575877727,3575877727,0
2,955,25410,3575877727,3575877728,1
2,955,25411,3575877727,3575877728,1
2,955,25412,3575877727,3575877729,2
2,955,25413,3575877727,3575877729,2
2,955,25414,3575877727,3575877730,3
2,955,25415,3575877727,3575877730,3
2,955,25416,3575877727,3575877730,3
2,955,25417,3575877727,3575877731,4
2,955,25418,3575877727,3575877731,4
2,955,25419,3575877727,3575877732,5
2,955,25420,3575877727,3575877732,5
2,955,25421,3575877727,3575877733,6
2,955,25422,3575877727,3575877733,6
2,955,25423,3575877727,3575877734,7
2,955,25424,3575877727,3575877736,9
2,955,25425,3575877727,3575877736,9
2,955,25426,3575877727,3575877736,9
2,955,25427,3575877727,3575877736,9
2,955,25428,3575877727,3575877737,10
2,955,25429,3575877727,3575877738,11
2,955,25430,3575877727,3575877739,12
2,955,25431,3575877727,3575877743,16
2,955,25432,3575877727,3575877743,16
2,955,25433,3575877727,3575877744,17
2,955,25434,3575877727,3575877744,17
2,955,25435,3575877727,3575877744,17
2,955,25436,3575877727,3575877746,19
2,955,25437,3575877727,3575877746,19
2,955,25438,3575877727,3575877748,21
2,955,25439,3575877727,3575877748,21
2,955,25440,3575877727,3575877749,22
2,955,25441,3575877727,3575877749,22
2,955,25442,3575877727,3575877750,23
2,955,25443,3575877727,3575877750,23
2,955,25444,3575877727,3575877752,25
2,955,25445,3575877727,3575877753,26
2,955,25446,3575877727,3575877754,27
2,955,25447,3575877727,3575877756,29
2,955,25448,3575877727,3575877757,30
2,955,25449,3575877727,3575877757,30
2,955,25450,3575877727,3575877759,32
2,955,25451,3575877727,3575877759,32
2,955,25452,3575877727,3575877761,34
2,955,25453,3575877727,3575877761,34
2,955,25454,3575877727,3575877765,38
2,955,25455,3575877727,3575877766,39
2,955,25456,3575877727,3575877766,39
2,955,25457,3575877727,3575877766,39
2,955,25458,3575877727,3575877767,40
2,955,25459,3575877727,3575877768,41
2,955,25460,3575877727,3575877769,42
2,955,25461,3575877727,3575877770,43
2,955,25462,3575877727,3575877770,43
2,955,25463,3575877727,3575877770,43
2,955,25464,3575877727,3575877772,45
2,955,25465,3575877727,3575877772,45
2,955,25466,3575877727,3575877773,46
2,955,25467,3575877727,3575877776,49
2,956,25468,3575877789,3575877789,0
2,956,25469,3575877789,3575877789,0
2,956,25470,3575877789,3575877789,0
2,956,25471,3575877789,3575877789,0
2,956,25472,3575877789,3575877789,0
2,956,25473,3575877789,3575877789,0
2,956,25474,3575877789,3575877789,0
2,956,25475,3575877789,3575877789,0
2,956,25476,3575877789,3575877789,0
2,956,25477,3575877789,3575877789,0
2,956,25478,3575877789,3575877789,0
2,956,25479,3575877789,3575877789,0
2,956,25480,3575877789,3575877789,0
2,956,25481,3575877789,3575877789,0
2,956,25482,3575877789,3575877789,0
2,956,25483,3575877789,3575877790,1
2,956,25484,3575877789,3575877791,2
2,956,25485,3575877789,3575877792,3
2,956,25486,3575877789,3575877793,4
2,956,25487,3575877789,3575877793,4
2,956,25488,3575877789,3575877796,7
2,956,25489,3575877789,3575877798,9
2,956,25490,3575877789,3575877798,9
2,956,25491,3575877789,3575877798,9
2,956,25492,3575877789,3575877800,11
2,956,25493,3575877789,3575877803,14
2,956,25494,3575877789,3575877803,14
2,956,25495,3575877789,3575877806,17
2,956,25496,3575877789,3575877806,17
2,956,25497,3575877789,3575877806,17
2,956,25498,3575877789,3575877806,17
2,956,25499,3575877789,3575877807,18
2,956,25500,3575877789,3575877807,18
2,956,25501,3575877789,3575877808,19
2,956,25502,3575877789,3575877810,21
2,956,25503,3575877789,3575877810,21
2,956,25504,3575877789,3575877811,22
2,956,25505,3575877789,3575877813,24
2,956,25506,3575877789,3575877814,25
2,956,25507,3575877789,3575877816,27
2,956,25508,3575877789,3575877820,31
2,956,25509,3575877789,3575877822,33
2,956,25510,3575877789,3575877822,33
2,956,25511,3575877789,3575877823,34
2,956,25512,3575877789,3575877824,35
2,956,25513,3575877789,3575877825,36
2,956,25514,3575877789,3575877826,37
2,956,25515,3575877789,3575877826,37
2,956,25516,3575877789,3575877827,38
2,956,25517,3575877789,3575877829,40
2,956,25518,3575877789,3575877835,46
2,956,25519,3575877789,3575877835,46
2,956,25520,3575877789,3575877837,48
2,957,25521,3575877851,3575877851,0
2,957,25522,3575877851,3575877851,0
2,957,25523,3575877851,3575877851,0
2,957,25524,3575877851,3575877851,0
2,957,25525,3575877851,3575877851,0
2,957,25526,3575877851,3575877851,0
2,957,25527,3575877851,3575877851,0
2,957,25528,3575877851,3575877851,0
2,957,25529,3575877851,3575877851,0
2,957,25530,3575877851,3575877851,0
2,957,25531,3575877851,3575877851,0
2,957,25532,3575877851,3575877851,0
2,957,25533,3575877851,3575877853,2
2,957,25534,3575877851,3575877853,2
2,957,25535,3575877851,3575877854,3
2,957,25536,3575877851,3575877855,4
2,957,25537,3575877851,3575877856,5
2,957,25538,3575877851,3575877856,5
2,957,25539,3575877851,3575877857,6
2,957,25540,3575877851,3575877860,9
2,957,25541,3575877851,3575877860,9
2,957,25542,3575877851,3575877861,10
2,957,25543,3575877851,3575877862,11
2,957,25544,3575877851,3575877865,14
2,957,25545,3575877851,3575877865,14
2,957,25546,3575877851,3575877866,15
2,957,25547,3575877851,3575877871,20
2,957,25548,3575877851,3575877874,23
2,957,25549,3575877851,3575877877,26
2,957,25550,3575877851,3575877879,28
2,957,25551,3575877851,3575877879,28
2,957,25552,3575877851,3575877880,29
2,957,25553,3575877851,3575877880,29
2,957,25554,3575877851,3575877881,30
2,957,25555,3575877851,3575877881,30
2,957,25556,3575877851,3575877882,31
2,957,25557,3575877851,3575877883,32
2,957,25558,3575877851,3575877883,32
2,957,25559,3575877851,3575877885,34
2,957,25560,3575877851,3575877885,34
2,957,25561,3575877851,3575877885,34
2,957,25562,3575877851,3575877885,34
2,957,25563,3575877851,3575877886,35
2,957,25564,3575877851,3575877887,36
2,957,25565,3575877851,3575877887,36
2,957,25566,3575877851,3575877888,37
2,957,25567,3575877851,3575877889,38
2,957,25568,3575877851,3575877889,38
2,957,25569,3575877851,3575877890,39
2,957,25570,3575877851,3575877891,40
2,957,25571,3575877851,3575877891,40
2,957,25572,3575877851,3575877893,42
2,957,25573,3575877851,3575877893,42
2,957,25574,3575877851,3575877895,44
2,957,25575,3575877851,3575877896,45
2,957,25576,3575877851,3575877897,46
2,957,25577,3575877851,3575877899,48
2,957,25578,3575877851,3575877900,49
2,957,25579,3575877851,3575877900,49
2,957,25580,3575877851,3575877900,49
2,957,25581,3575877851,3575877900,49
2,957,25582,3575877851,3575877901,50
2,958,25583,3575877911,3575877911,0
2,958,25584,3575877911,3575877911,0
2,958,25585,3575877911,3575877911,0
2,958,25586,3575877911,3575877911,0
2,958,25587,3575877911,3575877911,0
2,958,25588,3575877911,3575877911,0
2,958,25589,3575877911,3575877911,0
2,958,25590,3575877911,3575877911,0
2,958,25591,3575877911,3575877911,0
2,958,25592,3575877911,3575877911,0
2,958,25593,3575877911,3575877911,0
2,958,25594,3575877911,3575877911,0
2,958,25595,3575877911,3575877911,0
2,958,25596,3575877911,3575877911,0
2,958,25597,3575877911,3575877912,1
2,958,25598,3575877911,3575877912,1
2,958,25599,3575877911,3575877914,3
2,958,25600,3575877911,3575877914,3
2,958,25601,3575877911,3575877915,4
2,958,25602,3575877911,3575877915,4
2,958,25603,3575877911,3575877916,5
2,958,25604,3575877911,3575877918,7
2,958,25605,3575877911,3575877919,8
2,958,25606,3575877911,3575877920,9
2,958,25607,3575877911,3575877921,10
2,958,25608,3575877911,3575877921,10
2,958,25609,3575877911,3575877923,12
2,958,25610,3575877911,3575877924,13
2,958,25611,3575877911,3575877927,16
2,958,25612,3575877911,3575877928,17
2,958,25613,3575877911,3575877928,17
2,958,25614,3575877911,3575877928,17
2,958,25615,3575877911,3575877929,18
2,958,25616,3575877911,3575877930,19
2,958,25617,3575877911,3575877930,19
2,958,25618,3575877911,3575877930,19
2,958,25619,3575877911,3575877931,20
2,958,25620,3575877911,3575877931,20
2,958,25621,3575877911,3575877932,21
2,958,25622,3575877911,3575877933,22
2,958,25623,3575877911,3575877933,22
2,958,25624,3575877911,3575877934,23
2,958,25625,3575877911,3575877934,23
2,958,25626,3575877911,3575877936,25
2,958,25627,3575877911,3575877936,25
2,958,25628,3575877911,3575877936,25
2,958,25629,3575877911,3575877936,25
2,958,25630,3575877911,3575877937,26
2,958,25631,3575877911,3575877939,28
2,958,25632,3575877911,3575877940,29
2,958,25633,3575877911,3575877943,32
2,958,25634,3575877911,3575877944,33
2,958,25635,3575877911,3575877944,33
2,958,25636,3575877911,3575877945,34
2,958,25637,3575877911,3575877945,34
2,958,25638,3575877911,3575877945,34
2,958,25639,3575877911,3575877946,35
2,958,25640,3575877911,3575877947,36
2,958,25641,3575877911,3575877948,37
2,958,25642,3575877911,3575877948,37
2,958,25643,3575877911,3575877949,38
2,958,25644,3575877911,3575877949,38
2,958,25645,3575877911,3575877950,39
2,958,25646,3575877911,3575877951,40
2,958,25647,3575877911,3575877951,40
2,958,25648,3575877911,3575877953,42
2,958,25649,3575877911,3575877954,43
2,958,25650,3575877911,3575877955,44
2,958,25651,3575877911,3575877957,46
2,958,25652,3575877911,3575877958,47
2,958,25653,3575877911,3575877959,48
2,958,25654,3575877911,3575877960,49
2,958,25655,3575877911,3575877961,50
2,959,25656,3575877971,3575877971,0
2,959,25657,3575877971,3575877971,0
2,959,25658,3575877971,3575877971,0
2,959,25659,3575877971,3575877971,0
2,959,25660,3575877971,3575877971,0
2,959,25661,3575877971,3575877971,0
2,959,25662,3575877971,3575877971,0
2,959,25663,3575877971,3575877971,0
2,959,25664,3575877971,3575877971,0
2,959,25665,3575877971,3575877971,0
2,959,25666,3575877971,3575877972,1
2,959,25667,3575877971,3575877973,2
2,959,25668,3575877971,3575877973,2
2,959,25669,3575877971,3575877976,5
2,959,25670,3575877971,3575877978,7
2,959,25671,3575877971,3575877979,8
2,959,25672,3575877971,3575877981,10
2,959,25673,3575877971,3575877981,10
2,959,25674,3575877971,3575877981,10
2,959,25675,3575877971,3575877982,11
2,959,25676,3575877971,3575877984,13
2,959,25677,3575877971,3575877985,14
2,959,25678,3575877971,3575877985,14
2,959,25679,3575877971,3575877985,14
2,959,25680,3575877971,3575877986,15
2,959,25681,3575877971,3575877987,16
2,959,25682,3575877971,3575877988,17
2,959,25683,3575877971,3575877990,19
2,959,25684,3575877971,3575877990,19
2,959,25685,3575877971,3575877990,19
2,959,25686,3575877971,3575877992,21
2,959,25687,3575877971,3575877993,22
2,959,25688,3575877971,3575877993,22
2,959,25689,3575877971,3575877997,26
2,959,25690,3575877971,3575877998,27
2,959,25691,3575877971,3575877998,27
2,959,25692,3575877971,3575878000,29
2,959,25693,3575877971,3575878000,29
2,959,25694,3575877971,3575878004,33
2,959,25695,3575877971,3575878004,33
2,959,25696,3575877971,3575878004,33
2,959,25697,3575877971,3575878004,33
2,959,25698,3575877971,3575878004,33
2,959,25699,3575877971,3575878004,33
2,959,25700,3575877971,3575878007,36
2,959,25701,3575877971,3575878007,36
2,959,25702,3575877971,3575878008,37
2,959,25703,3575877971,3575878010,39
2,959,25704,3575877971,3575878010,39
2,959,25705,3575877971,3575878011,40
2,959,25706,3575877971,3575878013,42
2,959,25707,3575877971,3575878014,43
2,959,25708,3575877971,3575878018,47
2,960,25709,3575878033,3575878033,0
2,960,25710,3575878033,3575878033,0
2,960,25711,3575878033,3575878033,0
2,960,25712,3575878033,3575878033,0
2,960,25713,3575878033,3575878033,0
2,960,25714,3575878033,3575878033,0
2,960,25715,3575878033,3575878033,0
2,960,25716,3575878033,3575878033,0
2,960,25717,3575878033,3575878033,0
2,960,25718,3575878033,3575878033,0
2,960,25719,3575878033,3575878033,0
2,960,25720,3575878033,3575878033,0
2,960,25721,3575878033,3575878033,0
2,960,25722,3575878033,3575878034,1
2,960,25723,3575878033,3575878035,2
2,960,25724,3575878033,3575878037,4
2,960,25725,3575878033,3575878039,6
2,960,25726,3575878033,3575878039,6
2,960,25727,3575878033,3575878041,8
2,960,25728,3575878033,3575878042,9
2,960,25729,3575878033,3575878043,10
2,960,25730,3575878033,3575878043,10
2,960,25731,3575878033,3575878044,11
2,960,25732,3575878033,3575878044,11
2,960,25733,3575878033,3575878045,12
2,960,25734,3575878033,3575878047,14
2,960,25735,3575878033,3575878052,19
2,960,25736,3575878033,3575878053,20
2,960,25737,3575878033,3575878053,20
2,960,25738,3575878033,3575878056,23
2,960,25739,3575878033,3575878056,23
2,960,25740,3575878033,3575878056,23
2,960,25741,3575878033,3575878056,23
2,960,25742,3575878033,3575878056,23
2,960,25743,3575878033,3575878057,24
2,960,25744,3575878033,3575878061,28
2,960,25745,3575878033,3575878062,29
2,960,25746,3575878033,3575878063,30
2,960,25747,3575878033,3575878065,32
2,960,25748,3575878033,3575878065,32
2,960,25749,3575878033,3575878066,33
2,960,25750,3575878033,3575878070,37
2,960,25751,3575878033,3575878074,41
2,960,25752,3575878033,3575878076,43
2,960,25753,3575878033,3575878077,44
2,960,25754,3575878033,3575878078,45
2,960,25755,3575878033,3575878079,46
2,960,25756,3575878033,3575878080,47
2,960,25757,3575878033,3575878080,47
2,960,25758,3575878033,3575878080,47
2,960,25759,3575878033,3575878080,47
2,960,25760,3575878033,3575878081,48
2,960,25761,3575878033,3575878082,49
2,960,25762,3575878033,3575878082,49
2,960,25763,3575878033,3575878083,50
2,961,25764,3575878096,3575878096,0
2,961,25765,3575878096,3575878096,0
2,961,25766,3575878096,3575878096,0
2,961,25767,3575878096,3575878096,0
2,961,25768,3575878096,3575878096,0
2,961,25769,3575878096,3575878096,0
2,961,25770,3575878096,3575878096,0
2,961,25771,3575878096,3575878096,0
2,961,25772,3575878096,3575878096,0
2,961,25773,3575878096,3575878096,0
2,961,25774,3575878096,3575878096,0
2,961,25775,3575878096,3575878096,0
2,961,25776,3575878096,3575878096,0
2,961,25777,3575878096,3575878096,0
2,961,25778,3575878096,3575878096,0
2,961,25779,3575878096,3575878096,0
2,961,25780,3575878096,3575878096,0
2,961,25781,3575878096,3575878096,0
2,961,25782,3575878096,3575878097,1
2,961,25783,3575878096,3575878098,2
2,961,25784,3575878096,3575878100,4
2,961,25785,3575878096,3575878100,4
2,961,25786,3575878096,3575878100,4
2,961,25787,3575878096,3575878101,5
2,961,25788,3575878096,3575878101,5
2,961,25789,3575878096,3575878103,7
2,961,25790,3575878096,3575878104,8
2,961,25791,3575878096,3575878105,9
2,961,25792,3575878096,3575878105,9
2,961,25793,3575878096,3575878105,9
2,961,25794,3575878096,3575878106,10
2,961,25795,3575878096,3575878106,10
2,961,25796,3575878096,3575878106,10
2,961,25797,3575878096,3575878106,10
2,961,25798,3575878096,3575878106,10
2,961,25799,3575878096,3575878106,10
2,961,25800,3575878096,3575878107,11
2,961,25801,3575878096,3575878108,12
2,961,25802,3575878096,3575878109,13
2,961,25803,3575878096,3575878110,14
2,961,25804,3575878096,3575878111,15
2,961,25805,3575878096,3575878112,16
2,961,25806,3575878096,3575878112,16
2,961,25807,3575878096,3575878113,17
2,961,25808,3575878096,3575878114,18
2,961,25809,3575878096,3575878114,18
2,961,25810,3575878096,3575878114,18
2,961,25811,3575878096,3575878115,19
2,961,25812,3575878096,3575878115,19
2,961,25813,3575878096,3575878118,22
2,961,25814,3575878096,3575878119,23
2,961,25815,3575878096,3575878119,23
2,961,25816,3575878096,3575878121,25
2,961,25817,3575878096,3575878121,25
2,961,25818,3575878096,3575878121,25
2,961,25819,3575878096,3575878123,27
2,961,25820,3575878096,3575878124,28
2,961,25821,3575878096,3575878126,30
2,961,25822,3575878096,3575878128,32
2,961,25823,3575878096,3575878128,32
2,961,25824,3575878096,3575878130,34
2,961,25825,3575878096,3575878130,34
2,961,25826,3575878096,3575878131,35
2,961,25827,3575878096,3575878131,35
2,961,25828,3575878096,3575878132,36
2,961,25829,3575878096,3575878132,36
2,961,25830,3575878096,3575878132,36
2,961,25831,3575878096,3575878132,36
2,961,25832,3575878096,3575878133,37
2,961,25833,3575878096,3575878134,38
2,961,25834,3575878096,3575878134,38
2,961,25835,3575878096,3575878135,39
2,961,25836,3575878096,3575878136,40
2,961,25837,3575878096,3575878136,40
2,961,25838,3575878096,3575878137,41
2,961,25839,3575878096,3575878137,41
2,961,25840,3575878096,3575878139,43
2,961,25841,3575878096,3575878140,44
2,961,25842,3575878096,3575878140,44
2,961,25843,3575878096,3575878142,46
2,961,25844,3575878096,3575878143,47
2,961,25845,3575878096,3575878144,48
2,961,25846,3575878096,3575878144,48
2,961,25847,3575878096,3575878144,48
2,961,25848,3575878096,3575878145,49
2,961,25849,3575878096,3575878146,50
2,962,25850,3575878161,3575878161,0
2,962,25851,3575878161,3575878161,0
2,962,25852,3575878161,3575878161,0
2,962,25853,3575878161,3575878161,0
2,962,25854,3575878161,3575878161,0
2,962,25855,3575878161,3575878161,0
2,962,25856,3575878161,3575878161,0
2,962,25857,3575878161,3575878161,0
2,962,25858,3575878161,3575878161,0
2,962,25859,3575878161,3575878161,0
2,962,25860,3575878161,3575878161,0
2,962,25861,3575878161,3575878161,0
2,962,25862,3575878161,3575878161,0
2,962,25863,3575878161,3575878161,0
2,962,25864,3575878161,3575878161,0
2,962,25865,3575878161,3575878161,0
2,962,25866,3575878161,3575878161,0
2,962,25867,3575878161,3575878162,1
2,962,25868,3575878161,3575878165,4
2,962,25869,3575878161,3575878165,4
2,962,25870,3575878161,3575878167,6
2,962,25871,3575878161,3575878168,7
2,962,25872,3575878161,3575878168,7
2,962,25873,3575878161,3575878168,7
2,962,25874,3575878161,3575878169,8
2,962,25875,3575878161,3575878169,8
2,962,25876,3575878161,3575878171,10
2,962,25877,3575878161,3575878171,10
2,962,25878,3575878161,3575878172,11
2,962,25879,3575878161,3575878173,12
2,962,25880,3575878161,3575878174,13
2,962,25881,3575878161,3575878176,15
2,962,25882,3575878161,3575878179,18
2,962,25883,3575878161,3575878180,19
2,962,25884,3575878161,3575878180,19
2,962,25885,3575878161,3575878181,20
2,962,25886,3575878161,3575878181,20
2,962,25887,3575878161,3575878183,22
2,962,25888,3575878161,3575878184,23
2,962,25889,3575878161,3575878185,24
2,962,25890,3575878161,3575878185,24
2,962,25891,3575878161,3575878186,25
2,962,25892,3575878161,3575878186,25
2,962,25893,3575878161,3575878187,26
2,962,25894,3575878161,3575878188,27
2,962,25895,3575878161,3575878189,28
2,962,25896,3575878161,3575878189,28
2,962,25897,3575878161,3575878190,29
2,962,25898,3575878161,3575878191,30
2,962,25899,3575878161,3575878192,31
2,962,25900,3575878161,3575878193,32
2,962,25901,3575878161,3575878193,32
2,962,25902,3575878161,3575878196,35
2,962,25903,3575878161,3575878198,37
2,962,25904,3575878161,3575878199,38
2,962,25905,3575878161,3575878200,39
2,962,25906,3575878161,3575878201,40
2,962,25907,3575878161,3575878203,42
2,962,25908,3575878161,3575878204,43
2,962,25909,3575878161,3575878205,44
2,962,25910,3575878161,3575878205,44
2,962,25911,3575878161,3575878205,44
2,962,25912,3575878161,3575878205,44
2,962,25913,3575878161,3575878205,44
2,962,25914,3575878161,3575878207,46
2,962,25915,3575878161,3575878207,46
2,962,25916,3575878161,3575878208,47
2,962,25917,3575878161,3575878209,48
2,962,25918,3575878161,3575878209,48
2,963,25919,3575878226,3575878226,0
2,963,25920,3575878226,3575878226,0
2,963,25921,3575878226,3575878226,0
2,963,25922,3575878226,3575878226,0
2,963,25923,3575878226,3575878226,0
2,963,25924,3575878226,3575878226,0
2,963,25925,3575878226,3575878226,0
2,963,25926,3575878226,3575878226,0
2,963,25927,3575878226,3575878226,0
2,963,25928,3575878226,3575878226,0
2,963,25929,3575878226,3575878226,0
2,963,25930,3575878226,3575878226,0
2,963,25931,3575878226,3575878227,1
2,963,25932,3575878226,3575878228,2
2,963,25933,3575878226,3575878229,3
2,963,25934,3575878226,3575878231,5
2,963,25935,3575878226,3575878235,9
2,963,25936,3575878226,3575878236,10
2,963,25937,3575878226,3575878239,13
2,963,25938,3575878226,3575878240,14
2,963,25939,3575878226,3575878240,14
2,963,25940,3575878226,3575878242,16
2,963,25941,3575878226,3575878243,17
2,963,25942,3575878226,3575878243,17
2,963,25943,3575878226,3575878243,17
2,963,25944,3575878226,3575878244,18
2,963,25945,3575878226,3575878245,19
2,963,25946,3575878226,3575878248,22
2,963,25947,3575878226,3575878251,25
2,963,25948,3575878226,3575878253,27
2,963,25949,3575878226,3575878254,28
2,963,25950,3575878226,3575878254,28
2,963,25951,3575878226,3575878255,29
2,963,25952,3575878226,3575878256,30
2,963,25953,3575878226,3575878256,30
2,963,25954,3575878226,3575878256,30
2,963,25955,3575878226,3575878257,31
2,963,25956,3575878226,3575878261,35
2,963,25957,3575878226,3575878261,35
2,963,25958,3575878226,3575878261,35
2,963,25959,3575878226,3575878263,37
2,963,25960,3575878226,3575878265,39
2,963,25961,3575878226,3575878265,39
2,963,25962,3575878226,3575878267,41
2,963,25963,3575878226,3575878271,45
2,963,25964,3575878226,3575878275,49
2,963,25965,3575878226,3575878275,49
2,964,25966,3575878287,3575878287,0
2,964,25967,3575878287,3575878287,0
2,964,25968,3575878287,3575878287,0
2,964,25969,3575878287,3575878287,0
2,964,25970,3575878287,3575878287,0
2,964,25971,3575878287,3575878287,0
2,964,25972,3575878287,3575878287,0
2,964,25973,3575878287,3575878287,0
2,964,25974,3575878287,3575878287,0
2,964,25975,3575878287,3575878287,0
2,964,25976,3575878287,3575878287,0
2,964,25977,3575878287,3575878287,0
2,964,25978,3575878287,3575878287,0
2,964,25979,3575878287,3575878287,0
2,964,25980,3575878287,3575878287,0
2,964,25981,3575878287,3575878287,0
2,964,25982,3575878287,3575878287,0
2,964,25983,3575878287,3575878289,2
2,964,25984,3575878287,3575878289,2
2,964,25985,3575878287,3575878290,3
2,964,25986,3575878287,3575878290,3
2,964,25987,3575878287,3575878290,3
2,964,25988,3575878287,3575878290,3
2,964,25989,3575878287,3575878291,4
2,964,25990,3575878287,3575878291,4
2,964,25991,3575878287,3575878292,5
2,964,25992,3575878287,3575878292,5
2,964,25993,3575878287,3575878293,6
2,964,25994,3575878287,3575878296,9
2,964,25995,3575878287,3575878297,10
2,964,25996,3575878287,3575878299,12
2,964,25997,3575878287,3575878300,13
2,964,25998,3575878287,3575878300,13
2,964,25999,3575878287,3575878300,13
2,964,26000,3575878287,3575878301,14
2,964,26001,3575878287,3575878301,14
2,964,26002,3575878287,3575878303,16
2,964,26003,3575878287,3575878304,17
2,964,26004,3575878287,3575878304,17
2,964,26005,3575878287,3575878305,18
2,964,26006,3575878287,3575878305,18
2,964,26007,3575878287,3575878305,18
2,964,26008,3575878287,3575878306,19
2,964,26009,3575878287,3575878306,19
2,964,26010,3575878287,3575878306,19
2,964,26011,3575878287,3575878306,19
2,964,26012,3575878287,3575878306,19
2,964,26013,3575878287,3575878307,20
2,964,26014,3575878287,3575878309,22
2,964,26015,3575878287,3575878309,22
2,964,26016,3575878287,3575878309,22
2,964,26017,3575878287,3575878311,24
2,964,26018,3575878287,3575878312,25
2,964,26019,3575878287,3575878312,25
2,964,26020,3575878287,3575878313,26
2,964,26021,3575878287,3575878314,27
2,964,26022,3575878287,3575878314,27
2,964,26023,3575878287,3575878315,28
2,964,26024,3575878287,3575878315,28
2,964,26025,3575878287,3575878318,31
2,964,26026,3575878287,3575878318,31
2,964,26027,3575878287,3575878320,33
2,964,26028,3575878287,3575878321,34
2,964,26029,3575878287,3575878321,34
2,964,26030,3575878287,3575878321,34
2,964,26031,3575878287,3575878324,37
2,964,26032,3575878287,3575878324,37
2,964,26033,3575878287,3575878326,39
2,964,26034,3575878287,3575878327,40
2,964,26035,3575878287,3575878328,41
2,964,26036,3575878287,3575878329,42
2,964,26037,3575878287,3575878329,42
2,964,26038,3575878287,3575878330,43
2,964,26039,3575878287,3575878331,44
2,964,26040,3575878287,3575878331,44
2,964,26041,3575878287,3575878331,44
2,964,26042,3575878287,3575878331,44
2,964,26043,3575878287,3575878332,45
2,964,26044,3575878287,3575878333,46
2,964,26045,3575878287,3575878333,46
2,964,26046,3575878287,3575878334,47
2,964,26047,3575878287,3575878334,47
2,964,26048,3575878287,3575878334,47
2,964,26049,3575878287,3575878336,49
2,964,26050,3575878287,3575878336,49
2,964,26051,3575878287,3575878336,49
2,964,26052,3575878287,3575878337,50
2,965,26053,3575878349,3575878350,1
2,965,26054,3575878349,3575878350,1
2,965,26055,3575878349,3575878350,1
2,965,26056,3575878349,3575878350,1
2,965,26057,3575878349,3575878350,1
2,965,26058,3575878349,3575878350,1
2,965,26059,3575878349,3575878350,1
2,965,26060,3575878349,3575878350,1
2,965,26061,3575878349,3575878350,1
2,965,26062,3575878349,3575878350,1
2,965,26063,3575878349,3575878350,1
2,965,26064,3575878349,3575878350,1
2,965,26065,3575878349,3575878350,1
2,965,26066,3575878349,3575878350,1
2,965,26067,3575878349,3575878350,1
2,965,26068,3575878349,3575878350,1
2,965,26069,3575878349,3575878350,1
2,965,26070,3575878349,3575878352,3
2,965,26071,3575878349,3575878352,3
2,965,26072,3575878349,3575878352,3
2,965,26073,3575878349,3575878354,5
2,965,26074,3575878349,3575878355,6
2,965,26075,3575878349,3575878357,8
2,965,26076,3575878349,3575878358,9
2,965,26077,3575878349,3575878358,9
2,965,26078,3575878349,3575878358,9
2,965,26079,3575878349,3575878360,11
2,965,26080,3575878349,3575878361,12
2,965,26081,3575878349,3575878362,13
2,965,26082,3575878349,3575878362,13
2,965,26083,3575878349,3575878363,14
2,965,26084,3575878349,3575878365,16
2,965,26085,3575878349,3575878365,16
2,965,26086,3575878349,3575878366,17
2,965,26087,3575878349,3575878368,19
2,965,26088,3575878349,3575878368,19
2,965,26089,3575878349,3575878368,19
2,965,26090,3575878349,3575878369,20
2,965,26091,3575878349,3575878369,20
2,965,26092,3575878349,3575878370,21
2,965,26093,3575878349,3575878371,22
2,965,26094,3575878349,3575878373,24
2,965,26095,3575878349,3575878374,25
2,965,26096,3575878349,3575878375,26
2,965,26097,3575878349,3575878379,30
2,965,26098,3575878349,3575878380,31
2,965,26099,3575878349,3575878381,32
2,965,26100,3575878349,3575878381,32
2,965,26101,3575878349,3575878383,34
2,965,26102,3575878349,3575878383,34
2,965,26103,3575878349,3575878385,36
2,965,26104,3575878349,3575878385,36
2,965,26105,3575878349,3575878386,37
2,965,26106,3575878349,3575878386,37
2,965,26107,3575878349,3575878387,38
2,965,26108,3575878349,3575878388,39
2,965,26109,3575878349,3575878388,39
2,965,26110,3575878349,3575878389,40
2,965,26111,3575878349,3575878389,40
2,965,26112,3575878349,3575878389,40
2,965,26113,3575878349,3575878391,42
2,965,26114,3575878349,3575878391,42
2,965,26115,3575878349,3575878393,44
2,965,26116,3575878349,3575878393,44
2,965,26117,3575878349,3575878397,48
2,965,26118,3575878349,3575878398,49
2,965,26119,3575878349,3575878399,50
2,966,26120,3575878408,3575878408,0
2,966,26121,3575878408,3575878408,0
2,966,26122,3575878408,3575878408,0
2,966,26123,3575878408,3575878408,0
2,966,26124,3575878408,3575878408,0
2,966,26125,3575878408,3575878408,0
2,966,26126,3575878408,3575878408,0
2,966,26127,3575878408,3575878408,0
2,966,26128,3575878408,3575878408,0
2,966,26129,3575878408,3575878408,0
2,966,26130,3575878408,3575878408,0
2,966,26131,3575878408,3575878409,1
2,966,26132,3575878408,3575878410,2
2,966,26133,3575878408,3575878411,3
2,966,26134,3575878408,3575878412,4
2,966,26135,3575878408,3575878416,8
2,966,26136,3575878408,3575878417,9
2,966,26137,3575878408,3575878422,14
2,966,26138,3575878408,3575878422,14
2,966,26139,3575878408,3575878423,15
2,966,26140,3575878408,3575878424,16
2,966,26141,3575878408,3575878426,18
2,966,26142,3575878408,3575878427,19
2,966,26143,3575878408,3575878428,20
2,966,26144,3575878408,3575878428,20
2,966,26145,3575878408,3575878429,21
2,966,26146,3575878408,3575878429,21
2,966,26147,3575878408,3575878430,22
2,966,26148,3575878408,3575878435,27
2,966,26149,3575878408,3575878436,28
2,966,26150,3575878408,3575878440,32
2,966,26151,3575878408,3575878440,32
2,966,26152,3575878408,3575878440,32
2,966,26153,3575878408,3575878441,33
2,966,26154,3575878408,3575878442,34
2,966,26155,3575878408,3575878443,35
2,966,26156,3575878408,3575878443,35
2,966,26157,3575878408,3575878444,36
2,966,26158,3575878408,3575878444,36
2,966,26159,3575878408,3575878448,40
2,966,26160,3575878408,3575878451,43
2,966,26161,3575878408,3575878454,46
2,966,26162,3575878408,3575878454,46
2,966,26163,3575878408,3575878454,46
2,966,26164,3575878408,3575878455,47
2,966,26165,3575878408,3575878455,47
2,966,26166,3575878408,3575878456,48
2,966,26167,3575878408,3575878456,48
2,966,26168,3575878408,3575878458,50
2,967,26169,3575878469,3575878469,0
2,967,26170,3575878469,3575878469,0
2,967,26171,3575878469,3575878469,0
2,967,26172,3575878469,3575878469,0
2,967,26173,3575878469,3575878469,0
2,967,26174,3575878469,3575878469,0
2,967,26175,3575878469,3575878469,0
2,967,26176,3575878469,3575878470,1
2,967,26177,3575878469,3575878476,7
2,967,26178,3575878469,3575878477,8
2,967,26179,3575878469,3575878479,10
2,967,26180,3575878469,3575878479,10
2,967,26181,3575878469,3575878480,11
2,967,26182,3575878469,3575878481,12
2,967,26183,3575878469,3575878481,12
2,967,26184,3575878469,3575878482,13
2,967,26185,3575878469,3575878483,14
2,967,26186,3575878469,3575878483,14
2,967,26187,3575878469,3575878485,16
2,967,26188,3575878469,3575878485,16
2,967,26189,3575878469,3575878485,16
2,967,26190,3575878469,3575878486,17
2,967,26191,3575878469,3575878486,17
2,967,26192,3575878469,3575878487,18
2,967,26193,3575878469,3575878487,18
2,967,26194,3575878469,3575878489,20
2,967,26195,3575878469,3575878489,20
2,967,26196,3575878469,3575878489,20
2,967,26197,3575878469,3575878490,21
2,967,26198,3575878469,3575878490,21
2,967,26199,3575878469,3575878490,21
2,967,26200,3575878469,3575878491,22
2,967,26201,3575878469,3575878492,23
2,967,26202,3575878469,3575878492,23
2,967,26203,3575878469,3575878492,23
2,967,26204,3575878469,3575878496,27
2,967,26205,3575878469,3575878496,27
2,967,26206,3575878469,3575878497,28
2,967,26207,3575878469,3575878498,29
2,967,26208,3575878469,3575878500,31
2,967,26209,3575878469,3575878500,31
2,967,26210,3575878469,3575878500,31
2,967,26211,3575878469,3575878501,32
2,967,26212,3575878469,3575878501,32
2,967,26213,3575878469,3575878503,34
2,967,26214,3575878469,3575878504,35
2,967,26215,3575878469,3575878505,36
2,967,26216,3575878469,3575878505,36
2,967,26217,3575878469,3575878505,36
2,967,26218,3575878469,3575878505,36
2,967,26219,3575878469,3575878506,37
2,967,26220,3575878469,3575878506,37
2,967,26221,3575878469,3575878507,38
2,967,26222,3575878469,3575878507,38
2,967,26223,3575878469,3575878507,38
2,967,26224,3575878469,3575878509,40
2,967,26225,3575878469,3575878510,41
2,967,26226,3575878469,3575878510,41
2,967,26227,3575878469,3575878511,42
2,967,26228,3575878469,3575878512,43
2,967,26229,3575878469,3575878512,43
2,967,26230,3575878469,3575878513,44
2,967,26231,3575878469,3575878514,45
2,967,26232,3575878469,3575878515,46
2,967,26233,3575878469,3575878515,46
2,967,26234,3575878469,3575878516,47
2,967,26235,3575878469,3575878516,47
2,967,26236,3575878469,3575878518,49
2,967,26237,3575878469,3575878518,49
2,968,26238,3575878533,3575878533,0
2,968,26239,3575878533,3575878533,0
2,968,26240,3575878533,3575878533,0
2,968,26241,3575878533,3575878533,0
2,968,26242,3575878533,3575878533,0
2,968,26243,3575878533,3575878533,0
2,968,26244,3575878533,3575878533,0
2,968,26245,3575878533,3575878533,0
2,968,26246,3575878533,3575878533,0
2,968,26247,3575878533,3575878533,0
2,968,26248,3575878533,3575878533,0
2,968,26249,3575878533,3575878533,0
2,968,26250,3575878533,3575878533,0
2,968,26251,3575878533,3575878533,0
2,968,26252,3575878533,3575878533,0
2,968,26253,3575878533,3575878533,0
2,968,26254,3575878533,3575878533,0
2,968,26255,3575878533,3575878533,0
2,968,26256,3575878533,3575878533,0
2,968,26257,3575878533,3575878533,0
2,968,26258,3575878533,3575878533,0
2,968,26259,3575878533,3575878533,0
2,968,26260,3575878533,3575878533,0
2,968,26261,3575878533,3575878535,2
2,968,26262,3575878533,3575878535,2
2,968,26263,3575878533,3575878536,3
2,968,26264,3575878533,3575878536,3
2,968,26265,3575878533,3575878537,4
2,968,26266,3575878533,3575878537,4
2,968,26267,3575878533,3575878537,4
2,968,26268,3575878533,3575878539,6
2,968,26269,3575878533,3575878540,7
2,968,26270,3575878533,3575878541,8
2,968,26271,3575878533,3575878543,10
2,968,26272,3575878533,3575878543,10
2,968,26273,3575878533,3575878543,10
2,968,26274,3575878533,3575878544,11
2,968,26275,3575878533,3575878544,11
2,968,26276,3575878533,3575878545,12
2,968,26277,3575878533,3575878547,14
2,968,26278,3575878533,3575878547,14
2,968,26279,3575878533,3575878547,14
2,968,26280,3575878533,3575878548,15
2,968,26281,3575878533,3575878548,15
2,968,26282,3575878533,3575878549,16
2,968,26283,3575878533,3575878550,17
2,968,26284,3575878533,3575878551,18
2,968,26285,3575878533,3575878552,19
2,968,26286,3575878533,3575878554,21
2,968,26287,3575878533,3575878554,21
2,968,26288,3575878533,3575878557,24
2,968,26289,3575878533,3575878557,24
2,968,26290,3575878533,3575878558,25
2,968,26291,3575878533,3575878560,27
2,968,26292,3575878533,3575878560,27
2,968,26293,3575878533,3575878560,27
2,968,26294,3575878533,3575878561,28
2,968,26295,3575878533,3575878561,28
2,968,26296,3575878533,3575878565,32
2,968,26297,3575878533,3575878565,32
2,968,26298,3575878533,3575878566,33
2,968,26299,3575878533,3575878567,34
2,968,26300,3575878533,3575878567,34
2,968,26301,3575878533,3575878567,34
2,968,26302,3575878533,3575878569,36
2,968,26303,3575878533,3575878569,36
2,968,26304,3575878533,3575878569,36
2,968,26305,3575878533,3575878569,36
2,968,26306,3575878533,3575878572,39
2,968,26307,3575878533,3575878572,39
2,968,26308,3575878533,3575878574,41
2,968,26309,3575878533,3575878578,45
2,968,26310,3575878533,3575878580,47
2,968,26311,3575878533,3575878580,47
2,968,26312,3575878533,3575878581,48
2,968,26313,3575878533,3575878582,49
2,969,26314,3575878594,3575878594,0
2,969,26315,3575878594,3575878594,0
2,969,26316,3575878594,3575878594,0
2,969,26317,3575878594,3575878594,0
2,969,26318,3575878594,3575878594,0
2,969,26319,3575878594,3575878594,0
2,969,26320,3575878594,3575878594,0
2,969,26321,3575878594,3575878594,0
2,969,26322,3575878594,3575878594,0
2,969,26323,3575878594,3575878594,0
2,969,26324,3575878594,3575878594,0
2,969,26325,3575878594,3575878594,0
2,969,26326,3575878594,3575878594,0
2,969,26327,3575878594,3575878594,0
2,969,26328,3575878594,3575878594,0
2,969,26329,3575878594,3575878594,0
2,969,26330,3575878594,3575878594,0
2,969,26331,3575878594,3575878595,1
2,969,26332,3575878594,3575878596,2
2,969,26333,3575878594,3575878598,4
2,969,26334,3575878594,3575878598,4
2,969,26335,3575878594,3575878600,6
2,969,26336,3575878594,3575878603,9
2,969,26337,3575878594,3575878603,9
2,969,26338,3575878594,3575878603,9
2,969,26339,3575878594,3575878604,10
2,969,26340,3575878594,3575878604,10
2,969,26341,3575878594,3575878604,10
2,969,26342,3575878594,3575878605,11
2,969,26343,3575878594,3575878605,11
2,969,26344,3575878594,3575878607,13
2,969,26345,3575878594,3575878609,15
2,969,26346,3575878594,3575878609,15
2,969,26347,3575878594,3575878611,17
2,969,26348,3575878594,3575878612,18
2,969,26349,3575878594,3575878615,21
2,969,26350,3575878594,3575878616,22
2,969,26351,3575878594,3575878621,27
2,969,26352,3575878594,3575878621,27
2,969,26353,3575878594,3575878622,28
2,969,26354,3575878594,3575878623,29
2,969,26355,3575878594,3575878624,30
2,969,26356,3575878594,3575878625,31
2,969,26357,3575878594,3575878625,31
2,969,26358,3575878594,3575878627,33
2,969,26359,3575878594,3575878628,34
2,969,26360,3575878594,3575878628,34
2,969,26361,3575878594,3575878628,34
2,969,26362,3575878594,3575878629,35
2,969,26363,3575878594,3575878631,37
2,969,26364,3575878594,3575878634,40
2,969,26365,3575878594,3575878634,40
2,969,26366,3575878594,3575878639,45
2,969,26367,3575878594,3575878639,45
2,969,26368,3575878594,3575878639,45
2,969,26369,3575878594,3575878639,45
2,969,26370,3575878594,3575878641,47
2,969,26371,3575878594,3575878642,48
2,969,26372,3575878594,3575878643,49
2,969,26373,3575878594,3575878644,50
2,970,26374,3575878656,3575878656,0
2,970,26375,3575878656,3575878656,0
2,970,26376,3575878656,3575878656,0
2,970,26377,3575878656,3575878656,0
2,970,26378,3575878656,3575878656,0
2,970,26379,3575878656,3575878656,0
2,970,26380,3575878656,3575878656,0
2,970,26381,3575878656,3575878656,0
2,970,26382,3575878656,3575878656,0
2,970,26383,3575878656,3575878656,0
2,970,26384,3575878656,3575878656,0
2,970,26385,3575878656,3575878657,1
2,970,26386,3575878656,3575878659,3
2,970,26387,3575878656,3575878661,5
2,970,26388,3575878656,3575878661,5
2,970,26389,3575878656,3575878662,6
2,970,26390,3575878656,3575878664,8
2,970,26391,3575878656,3575878665,9
2,970,26392,3575878656,3575878665,9
2,970,26393,3575878656,3575878670,14
2,970,26394,3575878656,3575878676,20
2,970,26395,3575878656,3575878679,23
2,970,26396,3575878656,3575878679,23
2,970,26397,3575878656,3575878680,24
2,970,26398,3575878656,3575878681,25
2,970,26399,3575878656,3575878682,26
2,970,26400,3575878656,3575878683,27
2,970,26401,3575878656,3575878683,27
2,970,26402,3575878656,3575878684,28
2,970,26403,3575878656,3575878685,29
2,970,26404,3575878656,3575878686,30
2,970,26405,3575878656,3575878687,31
2,970,26406,3575878656,3575878687,31
2,970,26407,3575878656,3575878687,31
2,970,26408,3575878656,3575878689,33
2,970,26409,3575878656,3575878690,34
2,970,26410,3575878656,3575878690,34
2,970,26411,3575878656,3575878690,34
2,970,26412,3575878656,3575878690,34
2,970,26413,3575878656,3575878690,34
2,970,26414,3575878656,3575878691,35
2,970,26415,3575878656,3575878692,36
2,970,26416,3575878656,3575878693,37
2,970,26417,3575878656,3575878693,37
2,970,26418,3575878656,3575878696,40
2,970,26419,3575878656,3575878697,41
2,970,26420,3575878656,3575878697,41
2,970,26421,3575878656,3575878699,43
2,970,26422,3575878656,3575878700,44
2,970,26423,3575878656,3575878701,45
2,970,26424,3575878656,3575878701,45
2,970,26425,3575878656,3575878701,45
2,970,26426,3575878656,3575878703,47
2,970,26427,3575878656,3575878705,49
2,970,26428,3575878656,3575878705,49
2,970,26429,3575878656,3575878705,49
2,970,26430,3575878656,3575878705,49
2,970,26431,3575878656,3575878705,49
2,970,26432,3575878656,3575878706,50
2,971,26433,3575878718,3575878718,0
2,971,26434,3575878718,3575878718,0
2,971,26435,3575878718,3575878718,0
2,971,26436,3575878718,3575878718,0
2,971,26437,3575878718,3575878718,0
2,971,26438,3575878718,3575878718,0
2,971,26439,3575878718,3575878718,0
2,971,26440,3575878718,3575878718,0
2,971,26441,3575878718,3575878718,0
2,971,26442,3575878718,3575878718,0
2,971,26443,3575878718,3575878718,0
2,971,26444,3575878718,3575878718,0
2,971,26445,3575878718,3575878718,0
2,971,26446,3575878718,3575878718,0
2,971,26447,3575878718,3575878718,0
2,971,26448,3575878718,3575878718,0
2,971,26449,3575878718,3575878718,0
2,971,26450,3575878718,3575878720,2
2,971,26451,3575878718,3575878721,3
2,971,26452,3575878718,3575878721,3
2,971,26453,3575878718,3575878722,4
2,971,26454,3575878718,3575878723,5
2,971,26455,3575878718,3575878723,5
2,971,26456,3575878718,3575878725,7
2,971,26457,3575878718,3575878725,7
2,971,26458,3575878718,3575878726,8
2,971,26459,3575878718,3575878727,9
2,971,26460,3575878718,3575878728,10
2,971,26461,3575878718,3575878729,11
2,971,26462,3575878718,3575878729,11
2,971,26463,3575878718,3575878729,11
2,971,26464,3575878718,3575878729,11
2,971,26465,3575878718,3575878730,12
2,971,26466,3575878718,3575878730,12
2,971,26467,3575878718,3575878730,12
2,971,26468,3575878718,3575878731,13
2,971,26469,3575878718,3575878733,15
2,971,26470,3575878718,3575878734,16
2,971,26471,3575878718,3575878734,16
2,971,26472,3575878718,3575878734,16
2,971,26473,3575878718,3575878735,17
2,971,26474,3575878718,3575878735,17
2,971,26475,3575878718,3575878735,17
2,971,26476,3575878718,3575878737,19
2,971,26477,3575878718,3575878737,19
2,971,26478,3575878718,3575878739,21
2,971,26479,3575878718,3575878739,21
2,971,26480,3575878718,3575878740,22
2,971,26481,3575878718,3575878742,24
2,971,26482,3575878718,3575878743,25
2,971,26483,3575878718,3575878743,25
2,971,26484,3575878718,3575878744,26
2,971,26485,3575878718,3575878744,26
2,971,26486,3575878718,3575878744,26
2,971,26487,3575878718,3575878744,26
2,971,26488,3575878718,3575878745,27
2,971,26489,3575878718,3575878747,29
2,971,26490,3575878718,3575878747,29
2,971,26491,3575878718,3575878748,30
2,971,26492,3575878718,3575878748,30
2,971,26493,3575878718,3575878748,30
2,971,26494,3575878718,3575878749,31
2,971,26495,3575878718,3575878751,33
2,971,26496,3575878718,3575878751,33
2,971,26497,3575878718,3575878752,34
2,971,26498,3575878718,3575878753,35
2,971,26499,3575878718,3575878754,36
2,971,26500,3575878718,3575878757,39
2,971,26501,3575878718,3575878757,39
2,971,26502,3575878718,3575878757,39
2,971,26503,3575878718,3575878758,40
2,971,26504,3575878718,3575878759,41
2,971,26505,3575878718,3575878759,41
2,971,26506,3575878718,3575878760,42
2,971,26507,3575878718,3575878760,42
2,971,26508,3575878718,3575878762,44
2,971,26509,3575878718,3575878765,47
2,971,26510,3575878718,3575878765,47
2,971,26511,3575878718,3575878765,47
2,971,26512,3575878718,3575878767,49
2,971,26513,3575878718,3575878767,49
2,971,26514,3575878718,3575878767,49
2,971,26515,3575878718,3575878768,50
2,972,26516,3575878778,3575878778,0
2,972,26517,3575878778,3575878778,0
2,972,26518,3575878778,3575878778,0
2,972,26519,3575878778,3575878778,0
2,972,26520,3575878778,3575878778,0
2,972,26521,3575878778,3575878778,0
2,972,26522,3575878778,3575878778,0
2,972,26523,3575878778,3575878780,2
2,972,26524,3575878778,3575878782,4
2,972,26525,3575878778,3575878784,6
2,972,26526,3575878778,3575878784,6
2,972,26527,3575878778,3575878784,6
2,972,26528,3575878778,3575878786,8
2,972,26529,3575878778,3575878786,8
2,972,26530,3575878778,3575878787,9
2,972,26531,3575878778,3575878787,9
2,972,26532,3575878778,3575878788,10
2,972,26533,3575878778,3575878788,10
2,972,26534,3575878778,3575878788,10
2,972,26535,3575878778,3575878789,11
2,972,26536,3575878778,3575878790,12
2,972,26537,3575878778,3575878790,12
2,972,26538,3575878778,3575878791,13
2,972,26539,3575878778,3575878792,14
2,972,26540,3575878778,3575878793,15
2,972,26541,3575878778,3575878795,17
2,972,26542,3575878778,3575878796,18
2,972,26543,3575878778,3575878798,20
2,972,26544,3575878778,3575878799,21
2,972,26545,3575878778,3575878800,22
2,972,26546,3575878778,3575878803,25
2,972,26547,3575878778,3575878803,25
2,972,26548,3575878778,3575878803,25
2,972,26549,3575878778,3575878804,26
2,972,26550,3575878778,3575878804,26
2,972,26551,3575878778,3575878804,26
2,972,26552,3575878778,3575878805,27
2,972,26553,3575878778,3575878806,28
2,972,26554,3575878778,3575878806,28
2,972,26555,3575878778,3575878809,31
2,972,26556,3575878778,3575878810,32
2,972,26557,3575878778,3575878811,33
2,972,26558,3575878778,3575878812,34
2,972,26559,3575878778,3575878815,37
2,972,26560,3575878778,3575878816,38
2,972,26561,3575878778,3575878820,42
2,972,26562,3575878778,3575878822,44
2,972,26563,3575878778,3575878823,45
2,972,26564,3575878778,3575878824,46
2,972,26565,3575878778,3575878825,47
2,972,26566,3575878778,3575878825,47
2,972,26567,3575878778,3575878826,48
2,972,26568,3575878778,3575878827,49
2,972,26569,3575878778,3575878827,49
2,972,26570,3575878778,3575878828,50
2,973,26571,3575878843,3575878843,0
2,973,26572,3575878843,3575878843,0
2,973,26573,3575878843,3575878843,0
2,973,26574,3575878843,3575878843,0
2,973,26575,3575878843,3575878843,0
2,973,26576,3575878843,3575878843,0
2,973,26577,3575878843,3575878843,0
2,973,26578,3575878843,3575878843,0
2,973,26579,3575878843,3575878843,0
2,973,26580,3575878843,3575878843,0
2,973,26581,3575878843,3575878843,0
2,973,26582,3575878843,3575878843,0
2,973,26583,3575878843,3575878843,0
2,973,26584,3575878843,3575878843,0
2,973,26585,3575878843,3575878844,1
2,973,26586,3575878843,3575878844,1
2,973,26587,3575878843,3575878844,1
2,973,26588,3575878843,3575878849,6
2,973,26589,3575878843,3575878850,7
2,973,26590,3575878843,3575878854,11
2,973,26591,3575878843,3575878854,11
2,973,26592,3575878843,3575878855,12
2,973,26593,3575878843,3575878855,12
2,973,26594,3575878843,3575878855,12
2,973,26595,3575878843,3575878855,12
2,973,26596,3575878843,3575878857,14
2,973,26597,3575878843,3575878860,17
2,973,26598,3575878843,3575878861,18
2,973,26599,3575878843,3575878861,18
2,973,26600,3575878843,3575878863,20
2,973,26601,3575878843,3575878864,21
2,973,26602,3575878843,3575878865,22
2,973,26603,3575878843,3575878865,22
2,973,26604,3575878843,3575878870,27
2,973,26605,3575878843,3575878875,32
2,973,26606,3575878843,3575878875,32
2,973,26607,3575878843,3575878877,34
2,973,26608,3575878843,3575878878,35
2,973,26609,3575878843,3575878879,36
2,973,26610,3575878843,3575878880,37
2,973,26611,3575878843,3575878880,37
2,973,26612,3575878843,3575878880,37
2,973,26613,3575878843,3575878882,39
2,973,26614,3575878843,3575878882,39
2,973,26615,3575878843,3575878883,40
2,973,26616,3575878843,3575878883,40
2,973,26617,3575878843,3575878884,41
2,973,26618,3575878843,3575878885,42
2,973,26619,3575878843,3575878886,43
2,973,26620,3575878843,3575878886,43
2,973,26621,3575878843,3575878888,45
2,973,26622,3575878843,3575878888,45
2,973,26623,3575878843,3575878889,46
2,973,26624,3575878843,3575878890,47
2,973,26625,3575878843,3575878890,47
2,973,26626,3575878843,3575878890,47
2,973,26627,3575878843,3575878890,47
2,973,26628,3575878843,3575878890,47
2,973,26629,3575878843,3575878891,48
2,973,26630,3575878843,3575878891,48
2,973,26631,3575878843,3575878892,49
2,973,26632,3575878843,3575878892,49
2,973,26633,3575878843,3575878893,50
2,974,26634,3575878904,3575878904,0
2,974,26635,3575878904,3575878904,0
2,974,26636,3575878904,3575878904,0
2,974,26637,3575878904,3575878904,0
2,974,26638,3575878904,3575878904,0
2,974,26639,3575878904,3575878904,0
2,974,26640,3575878904,3575878904,0
2,974,26641,3575878904,3575878904,0
2,974,26642,3575878904,3575878904,0
2,974,26643,3575878904,3575878904,0
2,974,26644,3575878904,3575878904,0
2,974,26645,3575878904,3575878905,1
2,974,26646,3575878904,3575878905,1
2,974,26647,3575878904,3575878906,2
2,974,26648,3575878904,3575878906,2
2,974,26649,3575878904,3575878906,2
2,974,26650,3575878904,3575878907,3
2,974,26651,3575878904,3575878907,3
2,974,26652,3575878904,3575878907,3
2,974,26653,3575878904,3575878907,3
2,974,26654,3575878904,3575878909,5
2,974,26655,3575878904,3575878910,6
2,974,26656,3575878904,3575878911,7
2,974,26657,3575878904,3575878911,7
2,974,26658,3575878904,3575878911,7
2,974,26659,3575878904,3575878912,8
2,974,26660,3575878904,3575878912,8
2,974,26661,3575878904,3575878914,10
2,974,26662,3575878904,3575878914,10
2,974,26663,3575878904,3575878915,11
2,974,26664,3575878904,3575878916,12
2,974,26665,3575878904,3575878916,12
2,974,26666,3575878904,3575878916,12
2,974,26667,3575878904,3575878919,15
2,974,26668,3575878904,3575878920,16
2,974,26669,3575878904,3575878920,16
2,974,26670,3575878904,3575878921,17
2,974,26671,3575878904,3575878922,18
2,974,26672,3575878904,3575878924,20
2,974,26673,3575878904,3575878925,21
2,974,26674,3575878904,3575878925,21
2,974,26675,3575878904,3575878926,22
2,974,26676,3575878904,3575878927,23
2,974,26677,3575878904,3575878928,24
2,974,26678,3575878904,3575878929,25
2,974,26679,3575878904,3575878929,25
2,974,26680,3575878904,3575878929,25
2,974,26681,3575878904,3575878930,26
2,974,26682,3575878904,3575878930,26
2,974,26683,3575878904,3575878930,26
2,974,26684,3575878904,3575878931,27
2,974,26685,3575878904,3575878931,27
2,974,26686,3575878904,3575878931,27
2,974,26687,3575878904,3575878931,27
2,974,26688,3575878904,3575878933,29
2,974,26689,3575878904,3575878933,29
2,974,26690,3575878904,3575878934,30
2,974,26691,3575878904,3575878934,30
2,974,26692,3575878904,3575878934,30
2,974,26693,3575878904,3575878935,31
2,974,26694,3575878904,3575878935,31
2,974,26695,3575878904,3575878935,31
2,974,26696,3575878904,3575878937,33
2,974,26697,3575878904,3575878937,33
2,974,26698,3575878904,3575878938,34
2,974,26699,3575878904,3575878940,36
2,974,26700,3575878904,3575878940,36
2,974,26701,3575878904,3575878942,38
2,974,26702,3575878904,3575878943,39
2,974,26703,3575878904,3575878943,39
2,974,26704,3575878904,3575878944,40
2,974,26705,3575878904,3575878944,40
2,974,26706,3575878904,3575878945,41
2,974,26707,3575878904,3575878945,41
2,974,26708,3575878904,3575878946,42
2,974,26709,3575878904,3575878947,43
2,974,26710,3575878904,3575878948,44
2,974,26711,3575878904,3575878948,44
2,974,26712,3575878904,3575878948,44
2,974,26713,3575878904,3575878949,45
2,974,26714,3575878904,3575878950,46
2,974,26715,3575878904,3575878950,46
2,974,26716,3575878904,3575878950,46
2,974,26717,3575878904,3575878953,49
2,974,26718,3575878904,3575878954,50
2,975,26719,3575878964,3575878964,0
2,975,26720,3575878964,3575878964,0
2,975,26721,3575878964,3575878964,0
2,975,26722,3575878964,3575878964,0
2,975,26723,3575878964,3575878964,0
2,975,26724,3575878964,3575878964,0
2,975,26725,3575878964,3575878964,0
2,975,26726,3575878964,3575878964,0
2,975,26727,3575878964,3575878964,0
2,975,26728,3575878964,3575878965,1
2,975,26729,3575878964,3575878966,2
2,975,26730,3575878964,3575878967,3
2,975,26731,3575878964,3575878968,4
2,975,26732,3575878964,3575878969,5
2,975,26733,3575878964,3575878970,6
2,975,26734,3575878964,3575878970,6
2,975,26735,3575878964,3575878971,7
2,975,26736,3575878964,3575878972,8
2,975,26737,3575878964,3575878972,8
2,975,26738,3575878964,3575878972,8
2,975,26739,3575878964,3575878975,11
2,975,26740,3575878964,3575878978,14
2,975,26741,3575878964,3575878978,14
2,975,26742,3575878964,3575878980,16
2,975,26743,3575878964,3575878981,17
2,975,26744,3575878964,3575878982,18
2,975,26745,3575878964,3575878984,20
2,975,26746,3575878964,3575878984,20
2,975,26747,3575878964,3575878985,21
2,975,26748,3575878964,3575878986,22
2,975,26749,3575878964,3575878987,23
2,975,26750,3575878964,3575878987,23
2,975,26751,3575878964,3575878988,24
2,975,26752,3575878964,3575878988,24
2,975,26753,3575878964,3575878988,24
2,975,26754,3575878964,3575878988,24
2,975,26755,3575878964,3575878989,25
2,975,26756,3575878964,3575878989,25
2,975,26757,3575878964,3575878990,26
2,975,26758,3575878964,3575878991,27
2,975,26759,3575878964,3575878992,28
2,975,26760,3575878964,3575878992,28
2,975,26761,3575878964,3575878992,28
2,975,26762,3575878964,3575878994,30
2,975,26763,3575878964,3575878995,31
2,975,26764,3575878964,3575878997,33
2,975,26765,3575878964,3575878998,34
2,975,26766,3575878964,3575878999,35
2,975,26767,3575878964,3575879000,36
2,975,26768,3575878964,3575879003,39
2,975,26769,3575878964,3575879003,39
2,975,26770,3575878964,3575879003,39
2,975,26771,3575878964,3575879004,40
2,975,26772,3575878964,3575879004,40
2,975,26773,3575878964,3575879004,40
2,975,26774,3575878964,3575879004,40
2,975,26775,3575878964,3575879006,42
2,975,26776,3575878964,3575879007,43
2,975,26777,3575878964,3575879008,44
2,975,26778,3575878964,3575879011,47
2,975,26779,3575878964,3575879011,47
2,975,26780,3575878964,3575879013,49
2,976,26781,3575879026,3575879026,0
2,976,26782,3575879026,3575879026,0
2,976,26783,3575879026,3575879026,0
2,976,26784,3575879026,3575879026,0
2,976,26785,3575879026,3575879026,0
2,976,26786,3575879026,3575879026,0
2,976,26787,3575879026,3575879026,0
2,976,26788,3575879026,3575879026,0
2,976,26789,3575879026,3575879028,2
2,976,26790,3575879026,3575879028,2
2,976,26791,3575879026,3575879029,3
2,976,26792,3575879026,3575879031,5
2,976,26793,3575879026,3575879034,8
2,976,26794,3575879026,3575879035,9
2,976,26795,3575879026,3575879037,11
2,976,26796,3575879026,3575879039,13
2,976,26797,3575879026,3575879039,13
2,976,26798,3575879026,3575879040,14
2,976,26799,3575879026,3575879041,15
2,976,26800,3575879026,3575879042,16
2,976,26801,3575879026,3575879043,17
2,976,26802,3575879026,3575879043,17
2,976,26803,3575879026,3575879043,17
2,976,26804,3575879026,3575879044,18
2,976,26805,3575879026,3575879045,19
2,976,26806,3575879026,3575879045,19
2,976,26807,3575879026,3575879049,23
2,976,26808,3575879026,3575879050,24
2,976,26809,3575879026,3575879053,27
2,976,26810,3575879026,3575879053,27
2,976,26811,3575879026,3575879054,28
2,976,26812,3575879026,3575879055,29
2,976,26813,3575879026,3575879055,29
2,976,26814,3575879026,3575879055,29
2,976,26815,3575879026,3575879057,31
2,976,26816,3575879026,3575879060,34
2,976,26817,3575879026,3575879061,35
2,976,26818,3575879026,3575879062,36
2,976,26819,3575879026,3575879062,36
2,976,26820,3575879026,3575879063,37
2,976,26821,3575879026,3575879064,38
2,976,26822,3575879026,3575879065,39
2,976,26823,3575879026,3575879065,39
2,976,26824,3575879026,3575879070,44
2,976,26825,3575879026,3575879075,49
2,977,26826,3575879090,3575879090,0
2,977,26827,3575879090,3575879090,0
2,977,26828,3575879090,3575879090,0
2,977,26829,3575879090,3575879090,0
2,977,26830,3575879090,3575879090,0
2,977,26831,3575879090,3575879090,0
2,977,26832,3575879090,3575879090,0
2,977,26833,3575879090,3575879090,0
2,977,26834,3575879090,3575879090,0
2,977,26835,3575879090,3575879090,0
2,977,26836,3575879090,3575879090,0
2,977,26837,3575879090,3575879090,0
2,977,26838,3575879090,3575879090,0
2,977,26839,3575879090,3575879090,0
2,977,26840,3575879090,3575879090,0
2,977,26841,3575879090,3575879090,0
2,977,26842,3575879090,3575879090,0
2,977,26843,3575879090,3575879090,0
2,977,26844,3575879090,3575879090,0
2,977,26845,3575879090,3575879090,0
2,977,26846,3575879090,3575879090,0
2,977,26847,3575879090,3575879090,0
2,977,26848,3575879090,3575879090,0
2,977,26849,3575879090,3575879091,1
2,977,26850,3575879090,3575879093,3
2,977,26851,3575879090,3575879093,3
2,977,26852,3575879090,3575879093,3
2,977,26853,3575879090,3575879097,7
2,977,26854,3575879090,3575879097,7
2,977,26855,3575879090,3575879098,8
2,977,26856,3575879090,3575879098,8
2,977,26857,3575879090,3575879100,10
2,977,26858,3575879090,3575879101,11
2,977,26859,3575879090,3575879101,11
2,977,26860,3575879090,3575879101,11
2,977,26861,3575879090,3575879101,11
2,977,26862,3575879090,3575879103,13
2,977,26863,3575879090,3575879105,15
2,977,26864,3575879090,3575879105,15
2,977,26865,3575879090,3575879105,15
2,977,26866,3575879090,3575879105,15
2,977,26867,3575879090,3575879106,16
2,977,26868,3575879090,3575879106,16
2,977,26869,3575879090,3575879107,17
2,977,26870,3575879090,3575879107,17
2,977,26871,3575879090,3575879107,17
2,977,26872,3575879090,3575879107,17
2,977,26873,3575879090,3575879107,17
2,977,26874,3575879090,3575879109,19
2,977,26875,3575879090,3575879110,20
2,977,26876,3575879090,3575879110,20
2,977,26877,3575879090,3575879111,21
2,977,26878,3575879090,3575879112,22
2,977,26879,3575879090,3575879112,22
2,977,26880,3575879090,3575879113,23
2,977,26881,3575879090,3575879113,23
2,977,26882,3575879090,3575879115,25
2,977,26883,3575879090,3575879115,25
2,977,26884,3575879090,3575879115,25
2,977,26885,3575879090,3575879116,26
2,977,26886,3575879090,3575879117,27
2,977,26887,3575879090,3575879119,29
2,977,26888,3575879090,3575879120,30
2,977,26889,3575879090,3575879121,31
2,977,26890,3575879090,3575879121,31
2,977,26891,3575879090,3575879121,31
2,977,26892,3575879090,3575879122,32
2,977,26893,3575879090,3575879123,33
2,977,26894,3575879090,3575879125,35
2,977,26895,3575879090,3575879126,36
2,977,26896,3575879090,3575879126,36
2,977,26897,3575879090,3575879127,37
2,977,26898,3575879090,3575879128,38
2,977,26899,3575879090,3575879129,39
2,977,26900,3575879090,3575879129,39
2,977,26901,3575879090,3575879129,39
2,977,26902,3575879090,3575879130,40
2,977,26903,3575879090,3575879130,40
2,977,26904,3575879090,3575879131,41
2,977,26905,3575879090,3575879131,41
2,977,26906,3575879090,3575879131,41
2,977,26907,3575879090,3575879132,42
2,977,26908,3575879090,3575879133,43
2,977,26909,3575879090,3575879133,43
2,977,26910,3575879090,3575879134,44
2,977,26911,3575879090,3575879134,44
2,977,26912,3575879090,3575879134,44
2,977,26913,3575879090,3575879135,45
2,977,26914,3575879090,3575879135,45
2,977,26915,3575879090,3575879135,45
2,977,26916,3575879090,3575879136,46
2,977,26917,3575879090,3575879137,47
2,977,26918,3575879090,3575879137,47
2,977,26919,3575879090,3575879138,48
2,977,26920,3575879090,3575879139,49
2,977,26921,3575879090,3575879140,50
2,978,26922,3575879154,3575879154,0
2,978,26923,3575879154,3575879154,0
2,978,26924,3575879154,3575879154,0
2,978,26925,3575879154,3575879154,0
2,978,26926,3575879154,3575879154,0
2,978,26927,3575879154,3575879154,0
2,978,26928,3575879154,3575879154,0
2,978,26929,3575879154,3575879154,0
2,978,26930,3575879154,3575879154,0
2,978,26931,3575879154,3575879154,0
2,978,26932,3575879154,3575879154,0
2,978,26933,3575879154,3575879154,0
2,978,26934,3575879154,3575879154,0
2,978,26935,3575879154,3575879154,0
2,978,26936,3575879154,3575879154,0
2,978,26937,3575879154,3575879158,4
2,978,26938,3575879154,3575879158,4
2,978,26939,3575879154,3575879158,4
2,978,26940,3575879154,3575879158,4
2,978,26941,3575879154,3575879159,5
2,978,26942,3575879154,3575879160,6
2,978,26943,3575879154,3575879161,7
2,978,26944,3575879154,3575879161,7
2,978,26945,3575879154,3575879162,8
2,978,26946,3575879154,3575879166,12
2,978,26947,3575879154,3575879167,13
2,978,26948,3575879154,3575879167,13
2,978,26949,3575879154,3575879168,14
2,978,26950,3575879154,3575879169,15
2,978,26951,3575879154,3575879170,16
2,978,26952,3575879154,3575879170,16
2,978,26953,3575879154,3575879171,17
2,978,26954,3575879154,3575879172,18
2,978,26955,3575879154,3575879174,20
2,978,26956,3575879154,3575879174,20
2,978,26957,3575879154,3575879175,21
2,978,26958,3575879154,3575879177,23
2,978,26959,3575879154,3575879178,24
2,978,26960,3575879154,3575879180,26
2,978,26961,3575879154,3575879180,26
2,978,26962,3575879154,3575879181,27
2,978,26963,3575879154,3575879183,29
2,978,26964,3575879154,3575879184,30
2,978,26965,3575879154,3575879185,31
2,978,26966,3575879154,3575879185,31
2,978,26967,3575879154,3575879187,33
2,978,26968,3575879154,3575879187,33
2,978,26969,3575879154,3575879187,33
2,978,26970,3575879154,3575879188,34
2,978,26971,3575879154,3575879188,34
2,978,26972,3575879154,3575879188,34
2,978,26973,3575879154,3575879188,34
2,978,26974,3575879154,3575879189,35
2,978,26975,3575879154,3575879190,36
2,978,26976,3575879154,3575879191,37
2,978,26977,3575879154,3575879192,38
2,978,26978,3575879154,3575879192,38
2,978,26979,3575879154,3575879193,39
2,978,26980,3575879154,3575879193,39
2,978,26981,3575879154,3575879196,42
2,978,26982,3575879154,3575879199,45
2,978,26983,3575879154,3575879199,45
2,978,26984,3575879154,3575879201,47
2,978,26985,3575879154,3575879203,49
2,978,26986,3575879154,3575879203,49
2,978,26987,3575879154,3575879203,49
2,978,26988,3575879154,3575879204,50
2,979,26989,3575879217,3575879217,0
2,979,26990,3575879217,3575879217,0
2,979,26991,3575879217,3575879217,0
2,979,26992,3575879217,3575879217,0
2,979,26993,3575879217,3575879217,0
2,979,26994,3575879217,3575879217,0
2,979,26995,3575879217,3575879217,0
2,979,26996,3575879217,3575879217,0
2,979,26997,3575879217,3575879217,0
2,979,26998,3575879217,3575879217,0
2,979,26999,3575879217,3575879217,0
2,979,27000,3575879217,3575879217,0
2,979,27001,3575879217,3575879219,2
2,979,27002,3575879217,3575879222,5
2,979,27003,3575879217,3575879222,5
2,979,27004,3575879217,3575879222,5
2,979,27005,3575879217,3575879225,8
2,979,27006,3575879217,3575879226,9
2,979,27007,3575879217,3575879228,11
2,979,27008,3575879217,3575879228,11
2,979,27009,3575879217,3575879228,11
2,979,27010,3575879217,3575879229,12
2,979,27011,3575879217,3575879229,12
2,979,27012,3575879217,3575879232,15
2,979,27013,3575879217,3575879234,17
2,979,27014,3575879217,3575879235,18
2,979,27015,3575879217,3575879236,19
2,979,27016,3575879217,3575879239,22
2,979,27017,3575879217,3575879239,22
2,979,27018,3575879217,3575879240,23
2,979,27019,3575879217,3575879240,23
2,979,27020,3575879217,3575879241,24
2,979,27021,3575879217,3575879242,25
2,979,27022,3575879217,3575879242,25
2,979,27023,3575879217,3575879243,26
2,979,27024,3575879217,3575879244,27
2,979,27025,3575879217,3575879244,27
2,979,27026,3575879217,3575879246,29
2,979,27027,3575879217,3575879249,32
2,979,27028,3575879217,3575879250,33
2,979,27029,3575879217,3575879254,37
2,979,27030,3575879217,3575879255,38
2,979,27031,3575879217,3575879255,38
2,979,27032,3575879217,3575879255,38
2,979,27033,3575879217,3575879256,39
2,979,27034,3575879217,3575879257,40
2,979,27035,3575879217,3575879260,43
2,979,27036,3575879217,3575879261,44
2,979,27037,3575879217,3575879262,45
2,979,27038,3575879217,3575879262,45
2,979,27039,3575879217,3575879263,46
2,979,27040,3575879217,3575879264,47
2,979,27041,3575879217,3575879265,48
2,979,27042,3575879217,3575879265,48
2,980,27043,3575879277,3575879277,0
2,980,27044,3575879277,3575879277,0
2,980,27045,3575879277,3575879277,0
2,980,27046,3575879277,3575879278,1
2,980,27047,3575879277,3575879280,3
2,980,27048,3575879277,3575879280,3
2,980,27049,3575879277,3575879281,4
2,980,27050,3575879277,3575879281,4
2,980,27051,3575879277,3575879283,6
2,980,27052,3575879277,3575879283,6
2,980,27053,3575879277,3575879283,6
2,980,27054,3575879277,3575879284,7
2,980,27055,3575879277,3575879285,8
2,980,27056,3575879277,3575879285,8
2,980,27057,3575879277,3575879285,8
2,980,27058,3575879277,3575879286,9
2,980,27059,3575879277,3575879286,9
2,980,27060,3575879277,3575879286,9
2,980,27061,3575879277,3575879287,10
2,980,27062,3575879277,3575879289,12
2,980,27063,3575879277,3575879289,12
2,980,27064,3575879277,3575879290,13
2,980,27065,3575879277,3575879290,13
2,980,27066,3575879277,3575879290,13
2,980,27067,3575879277,3575879290,13
2,980,27068,3575879277,3575879291,14
2,980,27069,3575879277,3575879291,14
2,980,27070,3575879277,3575879291,14
2,980,27071,3575879277,3575879292,15
2,980,27072,3575879277,3575879293,16
2,980,27073,3575879277,3575879293,16
2,980,27074,3575879277,3575879296,19
2,980,27075,3575879277,3575879297,20
2,980,27076,3575879277,3575879297,20
2,980,27077,3575879277,3575879299,22
2,980,27078,3575879277,3575879300,23
2,980,27079,3575879277,3575879301,24
2,980,27080,3575879277,3575879301,24
2,980,27081,3575879277,3575879302,25
2,980,27082,3575879277,3575879303,26
2,980,27083,3575879277,3575879305,28
2,980,27084,3575879277,3575879305,28
2,980,27085,3575879277,3575879305,28
2,980,27086,3575879277,3575879305,28
2,980,27087,3575879277,3575879306,29
2,980,27088,3575879277,3575879306,29
2,980,27089,3575879277,3575879306,29
2,980,27090,3575879277,3575879307,30
2,980,27091,3575879277,3575879307,30
2,980,27092,3575879277,3575879307,30
2,980,27093,3575879277,3575879307,30
2,980,27094,3575879277,3575879309,32
2,980,27095,3575879277,3575879309,32
2,980,27096,3575879277,3575879310,33
2,980,27097,3575879277,3575879311,34
2,980,27098,3575879277,3575879311,34
2,980,27099,3575879277,3575879312,35
2,980,27100,3575879277,3575879313,36
2,980,27101,3575879277,3575879314,37
2,980,27102,3575879277,3575879315,38
2,980,27103,3575879277,3575879315,38
2,980,27104,3575879277,3575879315,38
2,980,27105,3575879277,3575879315,38
2,980,27106,3575879277,3575879317,40
2,980,27107,3575879277,3575879319,42
2,980,27108,3575879277,3575879320,43
2,980,27109,3575879277,3575879320,43
2,980,27110,3575879277,3575879320,43
2,980,27111,3575879277,3575879321,44
2,980,27112,3575879277,3575879322,45
2,980,27113,3575879277,3575879325,48
2,980,27114,3575879277,3575879326,49
2,980,27115,3575879277,3575879326,49
2,980,27116,3575879277,3575879327,50
2,981,27117,3575879341,3575879342,1
2,981,27118,3575879341,3575879342,1
2,981,27119,3575879341,3575879342,1
2,981,27120,3575879341,3575879342,1
2,981,27121,3575879341,3575879342,1
2,981,27122,3575879341,3575879342,1
2,981,27123,3575879341,3575879342,1
2,981,27124,3575879341,3575879342,1
2,981,27125,3575879341,3575879342,1
2,981,27126,3575879341,3575879342,1
2,981,27127,3575879341,3575879342,1
2,981,27128,3575879341,3575879342,1
2,981,27129,3575879341,3575879342,1
2,981,27130,3575879341,3575879342,1
2,981,27131,3575879341,3575879342,1
2,981,27132,3575879341,3575879342,1
2,981,27133,3575879341,3575879342,1
2,981,27134,3575879341,3575879342,1
2,981,27135,3575879341,3575879342,1
2,981,27136,3575879341,3575879342,1
2,981,27137,3575879341,3575879342,1
2,981,27138,3575879341,3575879342,1
2,981,27139,3575879341,3575879342,1
2,981,27140,3575879341,3575879342,1
2,981,27141,3575879341,3575879344,3
2,981,27142,3575879341,3575879344,3
2,981,27143,3575879341,3575879344,3
2,981,27144,3575879341,3575879345,4
2,981,27145,3575879341,3575879345,4
2,981,27146,3575879341,3575879347,6
2,981,27147,3575879341,3575879347,6
2,981,27148,3575879341,3575879348,7
2,981,27149,3575879341,3575879348,7
2,981,27150,3575879341,3575879349,8
2,981,27151,3575879341,3575879349,8
2,981,27152,3575879341,3575879349,8
2,981,27153,3575879341,3575879349,8
2,981,27154,3575879341,3575879350,9
2,981,27155,3575879341,3575879352,11
2,981,27156,3575879341,3575879353,12
2,981,27157,3575879341,3575879354,13
2,981,27158,3575879341,3575879354,13
2,981,27159,3575879341,3575879358,17
2,981,27160,3575879341,3575879358,17
2,981,27161,3575879341,3575879358,17
2,981,27162,3575879341,3575879359,18
2,981,27163,3575879341,3575879360,19
2,981,27164,3575879341,3575879360,19
2,981,27165,3575879341,3575879361,20
2,981,27166,3575879341,3575879362,21
2,981,27167,3575879341,3575879362,21
2,981,27168,3575879341,3575879365,24
2,981,27169,3575879341,3575879367,26
2,981,27170,3575879341,3575879368,27
2,981,27171,3575879341,3575879368,27
2,981,27172,3575879341,3575879369,28
2,981,27173,3575879341,3575879371,30
2,981,27174,3575879341,3575879371,30
2,981,27175,3575879341,3575879371,30
2,981,27176,3575879341,3575879373,32
2,981,27177,3575879341,3575879373,32
2,981,27178,3575879341,3575879374,33
2,981,27179,3575879341,3575879375,34
2,981,27180,3575879341,3575879375,34
2,981,27181,3575879341,3575879377,36
2,981,27182,3575879341,3575879378,37
2,981,27183,3575879341,3575879380,39
2,981,27184,3575879341,3575879380,39
2,981,27185,3575879341,3575879381,40
2,981,27186,3575879341,3575879383,42
2,981,27187,3575879341,3575879384,43
2,981,27188,3575879341,3575879385,44
2,981,27189,3575879341,3575879386,45
2,981,27190,3575879341,3575879387,46
2,981,27191,3575879341,3575879387,46
2,981,27192,3575879341,3575879388,47
2,981,27193,3575879341,3575879388,47
2,981,27194,3575879341,3575879388,47
2,981,27195,3575879341,3575879388,47
2,981,27196,3575879341,3575879388,47
2,981,27197,3575879341,3575879389,48
2,981,27198,3575879341,3575879391,50
2,982,27199,3575879402,3575879402,0
2,982,27200,3575879402,3575879402,0
2,982,27201,3575879402,3575879402,0
2,982,27202,3575879402,3575879402,0
2,982,27203,3575879402,3575879402,0
2,982,27204,3575879402,3575879402,0
2,982,27205,3575879402,3575879402,0
2,982,27206,3575879402,3575879402,0
2,982,27207,3575879402,3575879403,1
2,982,27208,3575879402,3575879403,1
2,982,27209,3575879402,3575879403,1
2,982,27210,3575879402,3575879403,1
2,982,27211,3575879402,3575879404,2
2,982,27212,3575879402,3575879404,2
2,982,27213,3575879402,3575879405,3
2,982,27214,3575879402,3575879407,5
2,982,27215,3575879402,3575879407,5
2,982,27216,3575879402,3575879410,8
2,982,27217,3575879402,3575879412,10
2,982,27218,3575879402,3575879412,10
2,982,27219,3575879402,3575879413,11
2,982,27220,3575879402,3575879413,11
2,982,27221,3575879402,3575879415,13
2,982,27222,3575879402,3575879421,19
2,982,27223,3575879402,3575879422,20
2,982,27224,3575879402,3575879422,20
2,982,27225,3575879402,3575879424,22
2,982,27226,3575879402,3575879425,23
2,982,27227,3575879402,3575879426,24
2,982,27228,3575879402,3575879426,24
2,982,27229,3575879402,3575879426,24
2,982,27230,3575879402,3575879428,26
2,982,27231,3575879402,3575879428,26
2,982,27232,3575879402,3575879428,26
2,982,27233,3575879402,3575879429,27
2,982,27234,3575879402,3575879432,30
2,982,27235,3575879402,3575879435,33
2,982,27236,3575879402,3575879435,33
2,982,27237,3575879402,3575879437,35
2,982,27238,3575879402,3575879438,36
2,982,27239,3575879402,3575879439,37
2,982,27240,3575879402,3575879440,38
2,982,27241,3575879402,3575879440,38
2,982,27242,3575879402,3575879442,40
2,982,27243,3575879402,3575879442,40
2,982,27244,3575879402,3575879443,41
2,982,27245,3575879402,3575879443,41
2,982,27246,3575879402,3575879443,41
2,982,27247,3575879402,3575879444,42
2,982,27248,3575879402,3575879446,44
2,982,27249,3575879402,3575879449,47
2,982,27250,3575879402,3575879450,48
2,983,27251,3575879465,3575879465,0
2,983,27252,3575879465,3575879465,0
2,983,27253,3575879465,3575879465,0
2,983,27254,3575879465,3575879465,0
2,983,27255,3575879465,3575879465,0
2,983,27256,3575879465,3575879466,1
2,983,27257,3575879465,3575879466,1
2,983,27258,3575879465,3575879466,1
2,983,27259,3575879465,3575879466,1
2,983,27260,3575879465,3575879466,1
2,983,27261,3575879465,3575879466,1
2,983,27262,3575879465,3575879466,1
2,983,27263,3575879465,3575879466,1
2,983,27264,3575879465,3575879471,6
2,983,27265,3575879465,3575879476,11
2,983,27266,3575879465,3575879477,12
2,983,27267,3575879465,3575879479,14
2,983,27268,3575879465,3575879480,15
2,983,27269,3575879465,3575879480,15
2,983,27270,3575879465,3575879481,16
2,983,27271,3575879465,3575879481,16
2,983,27272,3575879465,3575879482,17
2,983,27273,3575879465,3575879482,17
2,983,27274,3575879465,3575879483,18
2,983,27275,3575879465,3575879484,19
2,983,27276,3575879465,3575879485,20
2,983,27277,3575879465,3575879486,21
2,983,27278,3575879465,3575879486,21
2,983,27279,3575879465,3575879486,21
2,983,27280,3575879465,3575879486,21
2,983,27281,3575879465,3575879488,23
2,983,27282,3575879465,3575879489,24
2,983,27283,3575879465,3575879489,24
2,983,27284,3575879465,3575879489,24
2,983,27285,3575879465,3575879489,24
2,983,27286,3575879465,3575879490,25
2,983,27287,3575879465,3575879490,25
2,983,27288,3575879465,3575879491,26
2,983,27289,3575879465,3575879491,26
2,983,27290,3575879465,3575879491,26
2,983,27291,3575879465,3575879493,28
2,983,27292,3575879465,3575879494,29
2,983,27293,3575879465,3575879496,31
2,983,27294,3575879465,3575879497,32
2,983,27295,3575879465,3575879497,32
2,983,27296,3575879465,3575879499,34
2,983,27297,3575879465,3575879500,35
2,983,27298,3575879465,3575879501,36
2,983,27299,3575879465,3575879501,36
2,983,27300,3575879465,3575879502,37
2,983,27301,3575879465,3575879502,37
2,983,27302,3575879465,3575879503,38
2,983,27303,3575879465,3575879505,40
2,983,27304,3575879465,3575879505,40
2,983,27305,3575879465,3575879505,40
2,983,27306,3575879465,3575879505,40
2,983,27307,3575879465,3575879506,41
2,983,27308,3575879465,3575879506,41
2,983,27309,3575879465,3575879506,41
2,983,27310,3575879465,3575879506,41
2,983,27311,3575879465,3575879507,42
2,983,27312,3575879465,3575879507,42
2,983,27313,3575879465,3575879507,42
2,983,27314,3575879465,3575879507,42
2,983,27315,3575879465,3575879508,43
2,983,27316,3575879465,3575879509,44
2,983,27317,3575879465,3575879511,46
2,983,27318,3575879465,3575879511,46
2,983,27319,3575879465,3575879511,46
2,983,27320,3575879465,3575879511,46
2,983,27321,3575879465,3575879512,47
2,983,27322,3575879465,3575879513,48
2,983,27323,3575879465,3575879514,49
2,984,27324,3575879526,3575879526,0
2,984,27325,3575879526,3575879526,0
2,984,27326,3575879526,3575879526,0
2,984,27327,3575879526,3575879526,0
2,984,27328,3575879526,3575879526,0
2,984,27329,3575879526,3575879526,0
2,984,27330,3575879526,3575879526,0
2,984,27331,3575879526,3575879526,0
2,984,27332,3575879526,3575879526,0
2,984,27333,3575879526,3575879526,0
2,984,27334,3575879526,3575879526,0
2,984,27335,3575879526,3575879526,0
2,984,27336,3575879526,3575879526,0
2,984,27337,3575879526,3575879526,0
2,984,27338,3575879526,3575879528,2
2,984,27339,3575879526,3575879528,2
2,984,27340,3575879526,3575879530,4
2,984,27341,3575879526,3575879530,4
2,984,27342,3575879526,3575879530,4
2,984,27343,3575879526,3575879530,4
2,984,27344,3575879526,3575879531,5
2,984,27345,3575879526,3575879531,5
2,984,27346,3575879526,3575879532,6
2,984,27347,3575879526,3575879533,7
2,984,27348,3575879526,3575879533,7
2,984,27349,3575879526,3575879533,7
2,984,27350,3575879526,3575879534,8
2,984,27351,3575879526,3575879534,8
2,984,27352,3575879526,3575879535,9
2,984,27353,3575879526,3575879535,9
2,984,27354,3575879526,3575879536,10
2,984,27355,3575879526,3575879537,11
2,984,27356,3575879526,3575879538,12
2,984,27357,3575879526,3575879539,13
2,984,27358,3575879526,3575879540,14
2,984,27359,3575879526,3575879541,15
2,984,27360,3575879526,3575879543,17
2,984,27361,3575879526,3575879543,17
2,984,27362,3575879526,3575879544,18
2,984,27363,3575879526,3575879545,19
2,984,27364,3575879526,3575879545,19
2,984,27365,3575879526,3575879546,20
2,984,27366,3575879526,3575879547,21
2,984,27367,3575879526,3575879547,21
2,984,27368,3575879526,3575879548,22
2,984,27369,3575879526,3575879548,22
2,984,27370,3575879526,3575879548,22
2,984,27371,3575879526,3575879548,22
2,984,27372,3575879526,3575879549,23
2,984,27373,3575879526,3575879550,24
2,984,27374,3575879526,3575879551,25
2,984,27375,3575879526,3575879552,26
2,984,27376,3575879526,3575879553,27
2,984,27377,3575879526,3575879553,27
2,984,27378,3575879526,3575879557,31
2,984,27379,3575879526,3575879557,31
2,984,27380,3575879526,3575879557,31
2,984,27381,3575879526,3575879558,32
2,984,27382,3575879526,3575879559,33
2,984,27383,3575879526,3575879560,34
2,984,27384,3575879526,3575879561,35
2,984,27385,3575879526,3575879561,35
2,984,27386,3575879526,3575879562,36
2,984,27387,3575879526,3575879564,38
2,984,27388,3575879526,3575879566,40
2,984,27389,3575879526,3575879566,40
2,984,27390,3575879526,3575879567,41
2,984,27391,3575879526,3575879568,42
2,984,27392,3575879526,3575879569,43
2,984,27393,3575879526,3575879570,44
2,984,27394,3575879526,3575879570,44
2,984,27395,3575879526,3575879571,45
2,984,27396,3575879526,3575879572,46
2,984,27397,3575879526,3575879572,46
2,984,27398,3575879526,3575879575,49
2,985,27399,3575879588,3575879588,0
2,985,27400,3575879588,3575879588,0
2,985,27401,3575879588,3575879588,0
2,985,27402,3575879588,3575879588,0
2,985,27403,3575879588,3575879588,0
2,985,27404,3575879588,3575879588,0
2,985,27405,3575879588,3575879588,0
2,985,27406,3575879588,3575879588,0
2,985,27407,3575879588,3575879588,0
2,985,27408,3575879588,3575879588,0
2,985,27409,3575879588,3575879588,0
2,985,27410,3575879588,3575879588,0
2,985,27411,3575879588,3575879588,0
2,985,27412,3575879588,3575879588,0
2,985,27413,3575879588,3575879588,0
2,985,27414,3575879588,3575879588,0
2,985,27415,3575879588,3575879588,0
2,985,27416,3575879588,3575879589,1
2,985,27417,3575879588,3575879590,2
2,985,27418,3575879588,3575879591,3
2,985,27419,3575879588,3575879591,3
2,985,27420,3575879588,3575879592,4
2,985,27421,3575879588,3575879596,8
2,985,27422,3575879588,3575879598,10
2,985,27423,3575879588,3575879598,10
2,985,27424,3575879588,3575879600,12
2,985,27425,3575879588,3575879601,13
2,985,27426,3575879588,3575879602,14
2,985,27427,3575879588,3575879604,16
2,985,27428,3575879588,3575879604,16
2,985,27429,3575879588,3575879604,16
2,985,27430,3575879588,3575879604,16
2,985,27431,3575879588,3575879606,18
2,985,27432,3575879588,3575879606,18
2,985,27433,3575879588,3575879609,21
2,985,27434,3575879588,3575879611,23
2,985,27435,3575879588,3575879611,23
2,985,27436,3575879588,3575879612,24
2,985,27437,3575879588,3575879612,24
2,985,27438,3575879588,3575879614,26
2,985,27439,3575879588,3575879618,30
2,985,27440,3575879588,3575879621,33
2,985,27441,3575879588,3575879621,33
2,985,27442,3575879588,3575879623,35
2,985,27443,3575879588,3575879625,37
2,985,27444,3575879588,3575879625,37
2,985,27445,3575879588,3575879626,38
2,985,27446,3575879588,3575879626,38
2,985,27447,3575879588,3575879627,39
2,985,27448,3575879588,3575879627,39
2,985,27449,3575879588,3575879627,39
2,985,27450,3575879588,3575879628,40
2,985,27451,3575879588,3575879629,41
2,985,27452,3575879588,3575879634,46
2,985,27453,3575879588,3575879634,46
2,985,27454,3575879588,3575879637,49
2,985,27455,3575879588,3575879637,49
2,985,27456,3575879588,3575879638,50
2,986,27457,3575879649,3575879649,0
2,986,27458,3575879649,3575879649,0
2,986,27459,3575879649,3575879649,0
2,986,27460,3575879649,3575879649,0
2,986,27461,3575879649,3575879649,0
2,986,27462,3575879649,3575879649,0
2,986,27463,3575879649,3575879649,0
2,986,27464,3575879649,3575879649,0
2,986,27465,3575879649,3575879649,0
2,986,27466,3575879649,3575879649,0
2,986,27467,3575879649,3575879654,5
2,986,27468,3575879649,3575879655,6
2,986,27469,3575879649,3575879655,6
2,986,27470,3575879649,3575879656,7
2,986,27471,3575879649,3575879657,8
2,986,27472,3575879649,3575879657,8
2,986,27473,3575879649,3575879659,10
2,986,27474,3575879649,3575879661,12
2,986,27475,3575879649,3575879663,14
2,986,27476,3575879649,3575879664,15
2,986,27477,3575879649,3575879664,15
2,986,27478,3575879649,3575879667,18
2,986,27479,3575879649,3575879671,22
2,986,27480,3575879649,3575879676,27
2,986,27481,3575879649,3575879676,27
2,986,27482,3575879649,3575879677,28
2,986,27483,3575879649,3575879679,30
2,986,27484,3575879649,3575879680,31
2,986,27485,3575879649,3575879680,31
2,986,27486,3575879649,3575879681,32
2,986,27487,3575879649,3575879681,32
2,986,27488,3575879649,3575879682,33
2,986,27489,3575879649,3575879683,34
2,986,27490,3575879649,3575879684,35
2,986,27491,3575879649,3575879684,35
2,986,27492,3575879649,3575879685,36
2,986,27493,3575879649,3575879686,37
2,986,27494,3575879649,3575879686,37
2,986,27495,3575879649,3575879686,37
2,986,27496,3575879649,3575879686,37
2,986,27497,3575879649,3575879687,38
2,986,27498,3575879649,3575879689,40
2,986,27499,3575879649,3575879689,40
2,986,27500,3575879649,3575879689,40
2,986,27501,3575879649,3575879690,41
2,986,27502,3575879649,3575879690,41
2,986,27503,3575879649,3575879690,41
2,986,27504,3575879649,3575879691,42
2,986,27505,3575879649,3575879691,42
2,986,27506,3575879649,3575879692,43
2,986,27507,3575879649,3575879693,44
2,986,27508,3575879649,3575879694,45
2,986,27509,3575879649,3575879694,45
2,986,27510,3575879649,3575879697,48
2,986,27511,3575879649,3575879697,48
2,986,27512,3575879649,3575879697,48
2,986,27513,3575879649,3575879698,49
2,987,27514,3575879711,3575879711,0
2,987,27515,3575879711,3575879711,0
2,987,27516,3575879711,3575879711,0
2,987,27517,3575879711,3575879711,0
2,987,27518,3575879711,3575879711,0
2,987,27519,3575879711,3575879711,0
2,987,27520,3575879711,3575879711,0
2,987,27521,3575879711,3575879711,0
2,987,27522,3575879711,3575879711,0
2,987,27523,3575879711,3575879711,0
2,987,27524,3575879711,3575879711,0
2,987,27525,3575879711,3575879711,0
2,987,27526,3575879711,3575879711,0
2,987,27527,3575879711,3575879711,0
2,987,27528,3575879711,3575879711,0
2,987,27529,3575879711,3575879711,0
2,987,27530,3575879711,3575879711,0
2,987,27531,3575879711,3575879711,0
2,987,27532,3575879711,3575879711,0
2,987,27533,3575879711,3575879711,0
2,987,27534,3575879711,3575879711,0
2,987,27535,3575879711,3575879711,0
2,987,27536,3575879711,3575879712,1
2,987,27537,3575879711,3575879712,1
2,987,27538,3575879711,3575879713,2
2,987,27539,3575879711,3575879714,3
2,987,27540,3575879711,3575879715,4
2,987,27541,3575879711,3575879715,4
2,987,27542,3575879711,3575879716,5
2,987,27543,3575879711,3575879717,6
2,987,27544,3575879711,3575879720,9
2,987,27545,3575879711,3575879720,9
2,987,27546,3575879711,3575879721,10
2,987,27547,3575879711,3575879721,10
2,987,27548,3575879711,3575879721,10
2,987,27549,3575879711,3575879724,13
2,987,27550,3575879711,3575879724,13
2,987,27551,3575879711,3575879726,15
2,987,27552,3575879711,3575879726,15
2,987,27553,3575879711,3575879726,15
2,987,27554,3575879711,3575879728,17
2,987,27555,3575879711,3575879728,17
2,987,27556,3575879711,3575879730,19
2,987,27557,3575879711,3575879730,19
2,987,27558,3575879711,3575879730,19
2,987,27559,3575879711,3575879730,19
2,987,27560,3575879711,3575879731,20
2,987,27561,3575879711,3575879731,20
2,987,27562,3575879711,3575879732,21
2,987,27563,3575879711,3575879733,22
2,987,27564,3575879711,3575879733,22
2,987,27565,3575879711,3575879733,22
2,987,27566,3575879711,3575879734,23
2,987,27567,3575879711,3575879735,24
2,987,27568,3575879711,3575879735,24
2,987,27569,3575879711,3575879736,25
2,987,27570,3575879711,3575879737,26
2,987,27571,3575879711,3575879739,28
2,987,27572,3575879711,3575879740,29
2,987,27573,3575879711,3575879740,29
2,987,27574,3575879711,3575879742,31
2,987,27575,3575879711,3575879743,32
2,987,27576,3575879711,3575879744,33
2,987,27577,3575879711,3575879744,33
2,987,27578,3575879711,3575879745,34
2,987,27579,3575879711,3575879745,34
2,987,27580,3575879711,3575879745,34
2,987,27581,3575879711,3575879746,35
2,987,27582,3575879711,3575879747,36
2,987,27583,3575879711,3575879748,37
2,987,27584,3575879711,3575879748,37
2,987,27585,3575879711,3575879748,37
2,987,27586,3575879711,3575879749,38
2,987,27587,3575879711,3575879749,38
2,987,27588,3575879711,3575879751,40
2,987,27589,3575879711,3575879751,40
2,987,27590,3575879711,3575879752,41
2,987,27591,3575879711,3575879753,42
2,987,27592,3575879711,3575879757,46
2,987,27593,3575879711,3575879757,46
2,987,27594,3575879711,3575879757,46
2,987,27595,3575879711,3575879758,47
2,987,27596,3575879711,3575879758,47
2,987,27597,3575879711,3575879759,48
2,987,27598,3575879711,3575879759,48
2,987,27599,3575879711,3575879760,49
2,988,27600,3575879776,3575879776,0
2,988,27601,3575879776,3575879776,0
2,988,27602,3575879776,3575879776,0
2,988,27603,3575879776,3575879776,0
2,988,27604,3575879776,3575879776,0
2,988,27605,3575879776,3575879776,0
2,988,27606,3575879776,3575879776,0
2,988,27607,3575879776,3575879776,0
2,988,27608,3575879776,3575879776,0
2,988,27609,3575879776,3575879776,0
2,988,27610,3575879776,3575879776,0
2,988,27611,3575879776,3575879776,0
2,988,27612,3575879776,3575879776,0
2,988,27613,3575879776,3575879776,0
2,988,27614,3575879776,3575879778,2
2,988,27615,3575879776,3575879779,3
2,988,27616,3575879776,3575879780,4
2,988,27617,3575879776,3575879781,5
2,988,27618,3575879776,3575879783,7
2,988,27619,3575879776,3575879783,7
2,988,27620,3575879776,3575879785,9
2,988,27621,3575879776,3575879785,9
2,988,27622,3575879776,3575879785,9
2,988,27623,3575879776,3575879786,10
2,988,27624,3575879776,3575879786,10
2,988,27625,3575879776,3575879787,11
2,988,27626,3575879776,3575879788,12
2,988,27627,3575879776,3575879788,12
2,988,27628,3575879776,3575879788,12
2,988,27629,3575879776,3575879789,13
2,988,27630,3575879776,3575879790,14
2,988,27631,3575879776,3575879790,14
2,988,27632,3575879776,3575879790,14
2,988,27633,3575879776,3575879791,15
2,988,27634,3575879776,3575879792,16
2,988,27635,3575879776,3575879792,16
2,988,27636,3575879776,3575879795,19
2,988,27637,3575879776,3575879797,21
2,988,27638,3575879776,3575879798,22
2,988,27639,3575879776,3575879798,22
2,988,27640,3575879776,3575879802,26
2,988,27641,3575879776,3575879803,27
2,988,27642,3575879776,3575879803,27
2,988,27643,3575879776,3575879803,27
2,988,27644,3575879776,3575879803,27
2,988,27645,3575879776,3575879804,28
2,988,27646,3575879776,3575879804,28
2,988,27647,3575879776,3575879805,29
2,988,27648,3575879776,3575879806,30
2,988,27649,3575879776,3575879807,31
2,988,27650,3575879776,3575879808,32
2,988,27651,3575879776,3575879811,35
2,988,27652,3575879776,3575879811,35
2,988,27653,3575879776,3575879811,35
2,988,27654,3575879776,3575879812,36
2,988,27655,3575879776,3575879814,38
2,988,27656,3575879776,3575879819,43
2,988,27657,3575879776,3575879822,46
2,988,27658,3575879776,3575879822,46
2,988,27659,3575879776,3575879824,48
2,988,27660,3575879776,3575879826,50
2,989,27661,3575879838,3575879838,0
2,989,27662,3575879838,3575879838,0
2,989,27663,3575879838,3575879838,0
2,989,27664,3575879838,3575879838,0
2,989,27665,3575879838,3575879838,0
2,989,27666,3575879838,3575879838,0
2,989,27667,3575879838,3575879838,0
2,989,27668,3575879838,3575879838,0
2,989,27669,3575879838,3575879838,0
2,989,27670,3575879838,3575879838,0
2,989,27671,3575879838,3575879838,0
2,989,27672,3575879838,3575879839,1
2,989,27673,3575879838,3575879839,1
2,989,27674,3575879838,3575879841,3
2,989,27675,3575879838,3575879841,3
2,989,27676,3575879838,3575879841,3
2,989,27677,3575879838,3575879843,5
2,989,27678,3575879838,3575879843,5
2,989,27679,3575879838,3575879845,7
2,989,27680,3575879838,3575879849,11
2,989,27681,3575879838,3575879849,11
2,989,27682,3575879838,3575879854,16
2,989,27683,3575879838,3575879855,17
2,989,27684,3575879838,3575879855,17
2,989,27685,3575879838,3575879856,18
2,989,27686,3575879838,3575879856,18
2,989,27687,3575879838,3575879857,19
2,989,27688,3575879838,3575879860,22
2,989,27689,3575879838,3575879861,23
2,989,27690,3575879838,3575879862,24
2,989,27691,3575879838,3575879864,26
2,989,27692,3575879838,3575879864,26
2,989,27693,3575879838,3575879870,32
2,989,27694,3575879838,3575879875,37
2,989,27695,3575879838,3575879876,38
2,989,27696,3575879838,3575879877,39
2,989,27697,3575879838,3575879879,41
2,989,27698,3575879838,3575879881,43
2,989,27699,3575879838,3575879881,43
2,989,27700,3575879838,3575879881,43
2,989,27701,3575879838,3575879883,45
2,989,27702,3575879838,3575879883,45
2,989,27703,3575879838,3575879884,46
2,989,27704,3575879838,3575879884,46
2,989,27705,3575879838,3575879885,47
2,989,27706,3575879838,3575879886,48
2,989,27707,3575879838,3575879886,48
2,989,27708,3575879838,3575879886,48
2,989,27709,3575879838,3575879887,49
2,990,27710,3575879900,3575879900,0
2,990,27711,3575879900,3575879900,0
2,990,27712,3575879900,3575879900,0
2,990,27713,3575879900,3575879900,0
2,990,27714,3575879900,3575879900,0
2,990,27715,3575879900,3575879900,0
2,990,27716,3575879900,3575879900,0
2,990,27717,3575879900,3575879900,0
2,990,27718,3575879900,3575879900,0
2,990,27719,3575879900,3575879900,0
2,990,27720,3575879900,3575879900,0
2,990,27721,3575879900,3575879900,0
2,990,27722,3575879900,3575879900,0
2,990,27723,3575879900,3575879900,0
2,990,27724,3575879900,3575879900,0
2,990,27725,3575879900,3575879901,1
2,990,27726,3575879900,3575879902,2
2,990,27727,3575879900,3575879902,2
2,990,27728,3575879900,3575879902,2
2,990,27729,3575879900,3575879903,3
2,990,27730,3575879900,3575879906,6
2,990,27731,3575879900,3575879906,6
2,990,27732,3575879900,3575879906,6
2,990,27733,3575879900,3575879906,6
2,990,27734,3575879900,3575879906,6
2,990,27735,3575879900,3575879906,6
2,990,27736,3575879900,3575879906,6
2,990,27737,3575879900,3575879907,7
2,990,27738,3575879900,3575879907,7
2,990,27739,3575879900,3575879907,7
2,990,27740,3575879900,3575879908,8
2,990,27741,3575879900,3575879908,8
2,990,27742,3575879900,3575879909,9
2,990,27743,3575879900,3575879911,11
2,990,27744,3575879900,3575879911,11
2,990,27745,3575879900,3575879912,12
2,990,27746,3575879900,3575879912,12
2,990,27747,3575879900,3575879913,13
2,990,27748,3575879900,3575879915,15
2,990,27749,3575879900,3575879915,15
2,990,27750,3575879900,3575879915,15
2,990,27751,3575879900,3575879916,16
2,990,27752,3575879900,3575879918,18
2,990,27753,3575879900,3575879920,20
2,990,27754,3575879900,3575879920,20
2,990,27755,3575879900,3575879921,21
2,990,27756,3575879900,3575879921,21
2,990,27757,3575879900,3575879921,21
2,990,27758,3575879900,3575879925,25
2,990,27759,3575879900,3575879925,25
2,990,27760,3575879900,3575879926,26
2,990,27761,3575879900,3575879926,26
2,990,27762,3575879900,3575879926,26
2,990,27763,3575879900,3575879928,28
2,990,27764,3575879900,3575879929,29
2,990,27765,3575879900,3575879930,30
2,990,27766,3575879900,3575879930,30
2,990,27767,3575879900,3575879930,30
2,990,27768,3575879900,3575879931,31
2,990,27769,3575879900,3575879931,31
2,990,27770,3575879900,3575879931,31
2,990,27771,3575879900,3575879932,32
2,990,27772,3575879900,3575879933,33
2,990,27773,3575879900,3575879934,34
2,990,27774,3575879900,3575879934,34
2,990,27775,3575879900,3575879934,34
2,990,27776,3575879900,3575879935,35
2,990,27777,3575879900,3575879936,36
2,990,27778,3575879900,3575879936,36
2,990,27779,3575879900,3575879937,37
2,990,27780,3575879900,3575879938,38
2,990,27781,3575879900,3575879939,39
2,990,27782,3575879900,3575879939,39
2,990,27783,3575879900,3575879942,42
2,990,27784,3575879900,3575879942,42
2,990,27785,3575879900,3575879944,44
2,990,27786,3575879900,3575879944,44
2,990,27787,3575879900,3575879945,45
2,990,27788,3575879900,3575879945,45
2,990,27789,3575879900,3575879945,45
2,990,27790,3575879900,3575879946,46
2,990,27791,3575879900,3575879946,46
2,990,27792,3575879900,3575879948,48
2,990,27793,3575879900,3575879948,48
2,990,27794,3575879900,3575879949,49
2,990,27795,3575879900,3575879949,49
2,990,27796,3575879900,3575879949,49
2,991,27797,3575879962,3575879962,0
2,991,27798,3575879962,3575879962,0
2,991,27799,3575879962,3575879962,0
2,991,27800,3575879962,3575879962,0
2,991,27801,3575879962,3575879962,0
2,991,27802,3575879962,3575879962,0
2,991,27803,3575879962,3575879962,0
2,991,27804,3575879962,3575879962,0
2,991,27805,3575879962,3575879962,0
2,991,27806,3575879962,3575879962,0
2,991,27807,3575879962,3575879962,0
2,991,27808,3575879962,3575879962,0
2,991,27809,3575879962,3575879962,0
2,991,27810,3575879962,3575879962,0
2,991,27811,3575879962,3575879965,3
2,991,27812,3575879962,3575879967,5
2,991,27813,3575879962,3575879967,5
2,991,27814,3575879962,3575879968,6
2,991,27815,3575879962,3575879969,7
2,991,27816,3575879962,3575879969,7
2,991,27817,3575879962,3575879969,7
2,991,27818,3575879962,3575879972,10
2,991,27819,3575879962,3575879972,10
2,991,27820,3575879962,3575879973,11
2,991,27821,3575879962,3575879975,13
2,991,27822,3575879962,3575879975,13
2,991,27823,3575879962,3575879976,14
2,991,27824,3575879962,3575879979,17
2,991,27825,3575879962,3575879981,19
2,991,27826,3575879962,3575879981,19
2,991,27827,3575879962,3575879982,20
2,991,27828,3575879962,3575879984,22
2,991,27829,3575879962,3575879985,23
2,991,27830,3575879962,3575879985,23
2,991,27831,3575879962,3575879985,23
2,991,27832,3575879962,3575879985,23
2,991,27833,3575879962,3575879986,24
2,991,27834,3575879962,3575879986,24
2,991,27835,3575879962,3575879987,25
2,991,27836,3575879962,3575879988,26
2,991,27837,3575879962,3575879988,26
2,991,27838,3575879962,3575879988,26
2,991,27839,3575879962,3575879988,26
2,991,27840,3575879962,3575879989,27
2,991,27841,3575879962,3575879990,28
2,991,27842,3575879962,3575879992,30
2,991,27843,3575879962,3575879993,31
2,991,27844,3575879962,3575879993,31
2,991,27845,3575879962,3575879996,34
2,991,27846,3575879962,3575879996,34
2,991,27847,3575879962,3575879998,36
2,991,27848,3575879962,3575880000,38
2,991,27849,3575879962,3575880002,40
2,991,27850,3575879962,3575880003,41
2,991,27851,3575879962,3575880003,41
2,991,27852,3575879962,3575880004,42
2,991,27853,3575879962,3575880004,42
2,991,27854,3575879962,3575880004,42
2,991,27855,3575879962,3575880004,42
2,991,27856,3575879962,3575880006,44
2,991,27857,3575879962,3575880007,45
2,991,27858,3575879962,3575880008,46
2,991,27859,3575879962,3575880009,47
2,991,27860,3575879962,3575880011,49
2,991,27861,3575879962,3575880011,49
2,991,27862,3575879962,3575880012,50
2,992,27863,3575880028,3575880028,0
2,992,27864,3575880028,3575880028,0
2,992,27865,3575880028,3575880028,0
2,992,27866,3575880028,3575880028,0
2,992,27867,3575880028,3575880028,0
2,992,27868,3575880028,3575880028,0
2,992,27869,3575880028,3575880028,0
2,992,27870,3575880028,3575880029,1
2,992,27871,3575880028,3575880029,1
2,992,27872,3575880028,3575880029,1
2,992,27873,3575880028,3575880030,2
2,992,27874,3575880028,3575880030,2
2,992,27875,3575880028,3575880034,6
2,992,27876,3575880028,3575880035,7
2,992,27877,3575880028,3575880037,9
2,992,27878,3575880028,3575880038,10
2,992,27879,3575880028,3575880038,10
2,992,27880,3575880028,3575880040,12
2,992,27881,3575880028,3575880041,13
2,992,27882,3575880028,3575880041,13
2,992,27883,3575880028,3575880042,14
2,992,27884,3575880028,3575880042,14
2,992,27885,3575880028,3575880045,17
2,992,27886,3575880028,3575880049,21
2,992,27887,3575880028,3575880050,22
2,992,27888,3575880028,3575880055,27
2,992,27889,3575880028,3575880055,27
2,992,27890,3575880028,3575880055,27
2,992,27891,3575880028,3575880056,28
2,992,27892,3575880028,3575880056,28
2,992,27893,3575880028,3575880057,29
2,992,27894,3575880028,3575880060,32
2,992,27895,3575880028,3575880061,33
2,992,27896,3575880028,3575880061,33
2,992,27897,3575880028,3575880062,34
2,992,27898,3575880028,3575880064,36
2,992,27899,3575880028,3575880064,36
2,992,27900,3575880028,3575880068,40
2,992,27901,3575880028,3575880071,43
2,992,27902,3575880028,3575880075,47
2,992,27903,3575880028,3575880076,48
2,992,27904,3575880028,3575880077,49
2,993,27905,3575880091,3575880091,0
2,993,27906,3575880091,3575880092,1
2,993,27907,3575880091,3575880092,1
2,993,27908,3575880091,3575880092,1
2,993,27909,3575880091,3575880092,1
2,993,27910,3575880091,3575880092,1
2,993,27911,3575880091,3575880092,1
2,993,27912,3575880091,3575880092,1
2,993,27913,3575880091,3575880092,1
2,993,27914,3575880091,3575880092,1
2,993,27915,3575880091,3575880092,1
2,993,27916,3575880091,3575880092,1
2,993,27917,3575880091,3575880092,1
2,993,27918,3575880091,3575880092,1
2,993,27919,3575880091,3575880092,1
2,993,27920,3575880091,3575880092,1
2,993,27921,3575880091,3575880092,1
2,993,27922,3575880091,3575880092,1
2,993,27923,3575880091,3575880092,1
2,993,27924,3575880091,3575880092,1
2,993,27925,3575880091,3575880092,1
2,993,27926,3575880091,3575880092,1
2,993,27927,3575880091,3575880093,2
2,993,27928,3575880091,3575880094,3
2,993,27929,3575880091,3575880095,4
2,993,27930,3575880091,3575880096,5
2,993,27931,3575880091,3575880097,6
2,993,27932,3575880091,3575880098,7
2,993,27933,3575880091,3575880100,9
2,993,27934,3575880091,3575880101,10
2,993,27935,3575880091,3575880102,11
2,993,27936,3575880091,3575880102,11
2,993,27937,3575880091,3575880102,11
2,993,27938,3575880091,3575880103,12
2,993,27939,3575880091,3575880105,14
2,993,27940,3575880091,3575880106,15
2,993,27941,3575880091,3575880106,15
2,993,27942,3575880091,3575880106,15
2,993,27943,3575880091,3575880106,15
2,993,27944,3575880091,3575880106,15
2,993,27945,3575880091,3575880107,16
2,993,27946,3575880091,3575880107,16
2,993,27947,3575880091,3575880107,16
2,993,27948,3575880091,3575880107,16
2,993,27949,3575880091,3575880108,17
2,993,27950,3575880091,3575880109,18
2,993,27951,3575880091,3575880111,20
2,993,27952,3575880091,3575880111,20
2,993,27953,3575880091,3575880112,21
2,993,27954,3575880091,3575880112,21
2,993,27955,3575880091,3575880112,21
2,993,27956,3575880091,3575880112,21
2,993,27957,3575880091,3575880113,22
2,993,27958,3575880091,3575880114,23
2,993,27959,3575880091,3575880115,24
2,993,27960,3575880091,3575880115,24
2,993,27961,3575880091,3575880115,24
2,993,27962,3575880091,3575880116,25
2,993,27963,3575880091,3575880117,26
2,993,27964,3575880091,3575880118,27
2,993,27965,3575880091,3575880120,29
2,993,27966,3575880091,3575880121,30
2,993,27967,3575880091,3575880121,30
2,993,27968,3575880091,3575880121,30
2,993,27969,3575880091,3575880122,31
2,993,27970,3575880091,3575880124,33
2,993,27971,3575880091,3575880124,33
2,993,27972,3575880091,3575880126,35
2,993,27973,3575880091,3575880126,35
2,993,27974,3575880091,3575880126,35
2,993,27975,3575880091,3575880128,37
2,993,27976,3575880091,3575880129,38
2,993,27977,3575880091,3575880129,38
2,993,27978,3575880091,3575880130,39
2,993,27979,3575880091,3575880130,39
2,993,27980,3575880091,3575880130,39
2,993,27981,3575880091,3575880131,40
2,993,27982,3575880091,3575880131,40
2,993,27983,3575880091,3575880131,40
2,993,27984,3575880091,3575880132,41
2,993,27985,3575880091,3575880132,41
2,993,27986,3575880091,3575880132,41
2,993,27987,3575880091,3575880134,43
2,993,27988,3575880091,3575880134,43
2,993,27989,3575880091,3575880135,44
2,993,27990,3575880091,3575880135,44
2,993,27991,3575880091,3575880136,45
2,993,27992,3575880091,3575880136,45
2,993,27993,3575880091,3575880137,46
2,993,27994,3575880091,3575880137,46
2,993,27995,3575880091,3575880139,48
2,993,27996,3575880091,3575880139,48
2,993,27997,3575880091,3575880140,49
2,994,27998,3575880155,3575880155,0
2,994,27999,3575880155,3575880155,0
2,994,28000,3575880155,3575880155,0
2,994,28001,3575880155,3575880155,0
2,994,28002,3575880155,3575880155,0
2,994,28003,3575880155,3575880155,0
2,994,28004,3575880155,3575880155,0
2,994,28005,3575880155,3575880155,0
2,994,28006,3575880155,3575880155,0
2,994,28007,3575880155,3575880155,0
2,994,28008,3575880155,3575880155,0
2,994,28009,3575880155,3575880155,0
2,994,28010,3575880155,3575880155,0
2,994,28011,3575880155,3575880155,0
2,994,28012,3575880155,3575880155,0
2,994,28013,3575880155,3575880155,0
2,994,28014,3575880155,3575880155,0
2,994,28015,3575880155,3575880155,0
2,994,28016,3575880155,3575880155,0
2,994,28017,3575880155,3575880157,2
2,994,28018,3575880155,3575880157,2
2,994,28019,3575880155,3575880158,3
2,994,28020,3575880155,3575880158,3
2,994,28021,3575880155,3575880160,5
2,994,28022,3575880155,3575880160,5
2,994,28023,3575880155,3575880161,6
2,994,28024,3575880155,3575880161,6
2,994,28025,3575880155,3575880162,7
2,994,28026,3575880155,3575880166,11
2,994,28027,3575880155,3575880168,13
2,994,28028,3575880155,3575880168,13
2,994,28029,3575880155,3575880168,13
2,994,28030,3575880155,3575880169,14
2,994,28031,3575880155,3575880169,14
2,994,28032,3575880155,3575880169,14
2,994,28033,3575880155,3575880170,15
2,994,28034,3575880155,3575880171,16
2,994,28035,3575880155,3575880172,17
2,994,28036,3575880155,3575880172,17
2,994,28037,3575880155,3575880174,19
2,994,28038,3575880155,3575880175,20
2,994,28039,3575880155,3575880176,21
2,994,28040,3575880155,3575880176,21
2,994,28041,3575880155,3575880176,21
2,994,28042,3575880155,3575880179,24
2,994,28043,3575880155,3575880181,26
2,994,28044,3575880155,3575880182,27
2,994,28045,3575880155,3575880183,28
2,994,28046,3575880155,3575880184,29
2,994,28047,3575880155,3575880184,29
2,994,28048,3575880155,3575880185,30
2,994,28049,3575880155,3575880185,30
2,994,28050,3575880155,3575880185,30
2,994,28051,3575880155,3575880185,30
2,994,28052,3575880155,3575880186,31
2,994,28053,3575880155,3575880187,32
2,994,28054,3575880155,3575880188,33
2,994,28055,3575880155,3575880188,33
2,994,28056,3575880155,3575880188,33
2,994,28057,3575880155,3575880188,33
2,994,28058,3575880155,3575880189,34
2,994,28059,3575880155,3575880190,35
2,994,28060,3575880155,3575880191,36
2,994,28061,3575880155,3575880192,37
2,994,28062,3575880155,3575880193,38
2,994,28063,3575880155,3575880193,38
2,994,28064,3575880155,3575880196,41
2,994,28065,3575880155,3575880196,41
2,994,28066,3575880155,3575880198,43
2,994,28067,3575880155,3575880200,45
2,994,28068,3575880155,3575880200,45
2,994,28069,3575880155,3575880201,46
2,994,28070,3575880155,3575880202,47
2,994,28071,3575880155,3575880203,48
2,994,28072,3575880155,3575880204,49
2,994,28073,3575880155,3575880204,49
2,994,28074,3575880155,3575880205,50
2,995,28075,3575880219,3575880219,0
2,995,28076,3575880219,3575880219,0
2,995,28077,3575880219,3575880219,0
2,995,28078,3575880219,3575880219,0
2,995,28079,3575880219,3575880219,0
2,995,28080,3575880219,3575880219,0
2,995,28081,3575880219,3575880219,0
2,995,28082,3575880219,3575880219,0
2,995,28083,3575880219,3575880219,0
2,995,28084,3575880219,3575880219,0
2,995,28085,3575880219,3575880222,3
2,995,28086,3575880219,3575880223,4
2,995,28087,3575880219,3575880225,6
2,995,28088,3575880219,3575880226,7
2,995,28089,3575880219,3575880226,7
2,995,28090,3575880219,3575880228,9
2,995,28091,3575880219,3575880228,9
2,995,28092,3575880219,3575880231,12
2,995,28093,3575880219,3575880231,12
2,995,28094,3575880219,3575880231,12
2,995,28095,3575880219,3575880234,15
2,995,28096,3575880219,3575880235,16
2,995,28097,3575880219,3575880237,18
2,995,28098,3575880219,3575880239,20
2,995,28099,3575880219,3575880240,21
2,995,28100,3575880219,3575880240,21
2,995,28101,3575880219,3575880241,22
2,995,28102,3575880219,3575880241,22
2,995,28103,3575880219,3575880242,23
2,995,28104,3575880219,3575880243,24
2,995,28105,3575880219,3575880244,25
2,995,28106,3575880219,3575880246,27
2,995,28107,3575880219,3575880249,30
2,995,28108,3575880219,3575880250,31
2,995,28109,3575880219,3575880254,35
2,995,28110,3575880219,3575880255,36
2,995,28111,3575880219,3575880256,37
2,995,28112,3575880219,3575880256,37
2,995,28113,3575880219,3575880256,37
2,995,28114,3575880219,3575880257,38
2,995,28115,3575880219,3575880257,38
2,995,28116,3575880219,3575880257,38
2,995,28117,3575880219,3575880260,41
2,995,28118,3575880219,3575880261,42
2,995,28119,3575880219,3575880261,42
2,995,28120,3575880219,3575880263,44
2,995,28121,3575880219,3575880263,44
2,995,28122,3575880219,3575880264,45
2,995,28123,3575880219,3575880268,49
2,996,28124,3575880279,3575880279,0
2,996,28125,3575880279,3575880279,0
2,996,28126,3575880279,3575880279,0
2,996,28127,3575880279,3575880279,0
2,996,28128,3575880279,3575880280,1
2,996,28129,3575880279,3575880281,2
2,996,28130,3575880279,3575880281,2
2,996,28131,3575880279,3575880282,3
2,996,28132,3575880279,3575880283,4
2,996,28133,3575880279,3575880284,5
2,996,28134,3575880279,3575880284,5
2,996,28135,3575880279,3575880285,6
2,996,28136,3575880279,3575880285,6
2,996,28137,3575880279,3575880286,7
2,996,28138,3575880279,3575880286,7
2,996,28139,3575880279,3575880287,8
2,996,28140,3575880279,3575880287,8
2,996,28141,3575880279,3575880289,10
2,996,28142,3575880279,3575880289,10
2,996,28143,3575880279,3575880289,10
2,996,28144,3575880279,3575880290,11
2,996,28145,3575880279,3575880290,11
2,996,28146,3575880279,3575880291,12
2,996,28147,3575880279,3575880291,12
2,996,28148,3575880279,3575880291,12
2,996,28149,3575880279,3575880294,15
2,996,28150,3575880279,3575880295,16
2,996,28151,3575880279,3575880297,18
2,996,28152,3575880279,3575880297,18
2,996,28153,3575880279,3575880297,18
2,996,28154,3575880279,3575880299,20
2,996,28155,3575880279,3575880300,21
2,996,28156,3575880279,3575880302,23
2,996,28157,3575880279,3575880302,23
2,996,28158,3575880279,3575880302,23
2,996,28159,3575880279,3575880303,24
2,996,28160,3575880279,3575880303,24
2,996,28161,3575880279,3575880305,26
2,996,28162,3575880279,3575880306,27
2,996,28163,3575880279,3575880306,27
2,996,28164,3575880279,3575880306,27
2,996,28165,3575880279,3575880306,27
2,996,28166,3575880279,3575880306,27
2,996,28167,3575880279,3575880307,28
2,996,28168,3575880279,3575880307,28
2,996,28169,3575880279,3575880307,28
2,996,28170,3575880279,3575880307,28
2,996,28171,3575880279,3575880307,28
2,996,28172,3575880279,3575880308,29
2,996,28173,3575880279,3575880309,30
2,996,28174,3575880279,3575880309,30
2,996,28175,3575880279,3575880311,32
2,996,28176,3575880279,3575880311,32
2,996,28177,3575880279,3575880312,33
2,996,28178,3575880279,3575880312,33
2,996,28179,3575880279,3575880312,33
2,996,28180,3575880279,3575880313,34
2,996,28181,3575880279,3575880313,34
2,996,28182,3575880279,3575880314,35
2,996,28183,3575880279,3575880315,36
2,996,28184,3575880279,3575880315,36
2,996,28185,3575880279,3575880316,37
2,996,28186,3575880279,3575880316,37
2,996,28187,3575880279,3575880317,38
2,996,28188,3575880279,3575880319,40
2,996,28189,3575880279,3575880320,41
2,996,28190,3575880279,3575880321,42
2,996,28191,3575880279,3575880321,42
2,996,28192,3575880279,3575880322,43
2,996,28193,3575880279,3575880322,43
2,996,28194,3575880279,3575880323,44
2,996,28195,3575880279,3575880324,45
2,996,28196,3575880279,3575880326,47
2,996,28197,3575880279,3575880326,47
2,996,28198,3575880279,3575880327,48
2,996,28199,3575880279,3575880328,49
2,996,28200,3575880279,3575880328,49
2,997,28201,3575880348,3575880348,0
2,997,28202,3575880348,3575880348,0
2,997,28203,3575880348,3575880348,0
2,997,28204,3575880348,3575880348,0
2,997,28205,3575880348,3575880348,0
2,997,28206,3575880348,3575880348,0
2,997,28207,3575880348,3575880348,0
2,997,28208,3575880348,3575880348,0
2,997,28209,3575880348,3575880348,0
2,997,28210,3575880348,3575880348,0
2,997,28211,3575880348,3575880348,0
2,997,28212,3575880348,3575880348,0
2,997,28213,3575880348,3575880348,0
2,997,28214,3575880348,3575880348,0
2,997,28215,3575880348,3575880348,0
2,997,28216,3575880348,3575880348,0
2,997,28217,3575880348,3575880348,0
2,997,28218,3575880348,3575880348,0
2,997,28219,3575880348,3575880348,0
2,997,28220,3575880348,3575880348,0
2,997,28221,3575880348,3575880348,0
2,997,28222,3575880348,3575880348,0
2,997,28223,3575880348,3575880348,0
2,997,28224,3575880348,3575880348,0
2,997,28225,3575880348,3575880348,0
2,997,28226,3575880348,3575880348,0
2,997,28227,3575880348,3575880348,0
2,997,28228,3575880348,3575880348,0
2,997,28229,3575880348,3575880348,0
2,997,28230,3575880348,3575880348,0
2,997,28231,3575880348,3575880349,1
2,997,28232,3575880348,3575880349,1
2,997,28233,3575880348,3575880349,1
2,997,28234,3575880348,3575880349,1
2,997,28235,3575880348,3575880350,2
2,997,28236,3575880348,3575880351,3
2,997,28237,3575880348,3575880352,4
2,997,28238,3575880348,3575880352,4
2,997,28239,3575880348,3575880352,4
2,997,28240,3575880348,3575880355,7
2,997,28241,3575880348,3575880356,8
2,997,28242,3575880348,3575880357,9
2,997,28243,3575880348,3575880358,10
2,997,28244,3575880348,3575880360,12
2,997,28245,3575880348,3575880360,12
2,997,28246,3575880348,3575880360,12
2,997,28247,3575880348,3575880361,13
2,997,28248,3575880348,3575880362,14
2,997,28249,3575880348,3575880366,18
2,997,28250,3575880348,3575880366,18
2,997,28251,3575880348,3575880367,19
2,997,28252,3575880348,3575880368,20
2,997,28253,3575880348,3575880369,21
2,997,28254,3575880348,3575880369,21
2,997,28255,3575880348,3575880370,22
2,997,28256,3575880348,3575880370,22
2,997,28257,3575880348,3575880371,23
2,997,28258,3575880348,3575880371,23
2,997,28259,3575880348,3575880373,25
2,997,28260,3575880348,3575880373,25
2,997,28261,3575880348,3575880374,26
2,997,28262,3575880348,3575880378,30
2,997,28263,3575880348,3575880378,30
2,997,28264,3575880348,3575880378,30
2,997,28265,3575880348,3575880378,30
2,997,28266,3575880348,3575880379,31
2,997,28267,3575880348,3575880380,32
2,997,28268,3575880348,3575880381,33
2,997,28269,3575880348,3575880382,34
2,997,28270,3575880348,3575880383,35
2,997,28271,3575880348,3575880384,36
2,997,28272,3575880348,3575880384,36
2,997,28273,3575880348,3575880385,37
2,997,28274,3575880348,3575880386,38
2,997,28275,3575880348,3575880386,38
2,997,28276,3575880348,3575880388,40
2,997,28277,3575880348,3575880388,40
2,997,28278,3575880348,3575880388,40
2,997,28279,3575880348,3575880388,40
2,997,28280,3575880348,3575880388,40
2,997,28281,3575880348,3575880389,41
2,997,28282,3575880348,3575880390,42
2,997,28283,3575880348,3575880391,43
2,997,28284,3575880348,3575880392,44
2,997,28285,3575880348,3575880392,44
2,997,28286,3575880348,3575880393,45
2,997,28287,3575880348,3575880396,48
2,997,28288,3575880348,3575880396,48
2,998,28289,3575880414,3575880414,0
2,998,28290,3575880414,3575880414,0
2,998,28291,3575880414,3575880414,0
2,998,28292,3575880414,3575880414,0
2,998,28293,3575880414,3575880414,0
2,998,28294,3575880414,3575880414,0
2,998,28295,3575880414,3575880414,0
2,998,28296,3575880414,3575880414,0
2,998,28297,3575880414,3575880414,0
2,998,28298,3575880414,3575880414,0
2,998,28299,3575880414,3575880414,0
2,998,28300,3575880414,3575880414,0
2,998,28301,3575880414,3575880414,0
2,998,28302,3575880414,3575880414,0
2,998,28303,3575880414,3575880414,0
2,998,28304,3575880414,3575880414,0
2,998,28305,3575880414,3575880414,0
2,998,28306,3575880414,3575880414,0
2,998,28307,3575880414,3575880416,2
2,998,28308,3575880414,3575880422,8
2,998,28309,3575880414,3575880423,9
2,998,28310,3575880414,3575880424,10
2,998,28311,3575880414,3575880425,11
2,998,28312,3575880414,3575880426,12
2,998,28313,3575880414,3575880426,12
2,998,28314,3575880414,3575880426,12
2,998,28315,3575880414,3575880428,14
2,998,28316,3575880414,3575880429,15
2,998,28317,3575880414,3575880430,16
2,998,28318,3575880414,3575880431,17
2,998,28319,3575880414,3575880431,17
2,998,28320,3575880414,3575880434,20
2,998,28321,3575880414,3575880435,21
2,998,28322,3575880414,3575880438,24
2,998,28323,3575880414,3575880439,25
2,998,28324,3575880414,3575880440,26
2,998,28325,3575880414,3575880441,27
2,998,28326,3575880414,3575880441,27
2,998,28327,3575880414,3575880441,27
2,998,28328,3575880414,3575880443,29
2,998,28329,3575880414,3575880443,29
2,998,28330,3575880414,3575880444,30
2,998,28331,3575880414,3575880446,32
2,998,28332,3575880414,3575880449,35
2,998,28333,3575880414,3575880450,36
2,998,28334,3575880414,3575880455,41
2,998,28335,3575880414,3575880455,41
2,998,28336,3575880414,3575880456,42
2,998,28337,3575880414,3575880456,42
2,998,28338,3575880414,3575880456,42
2,998,28339,3575880414,3575880457,43
2,998,28340,3575880414,3575880457,43
2,998,28341,3575880414,3575880457,43
2,998,28342,3575880414,3575880457,43
2,998,28343,3575880414,3575880460,46
2,998,28344,3575880414,3575880461,47
2,998,28345,3575880414,3575880462,48
2,998,28346,3575880414,3575880463,49
2,998,28347,3575880414,3575880463,49
2,999,28348,3575880477,3575880477,0
2,999,28349,3575880477,3575880477,0
2,999,28350,3575880477,3575880477,0
2,999,28351,3575880477,3575880477,0
2,999,28352,3575880477,3575880477,0
2,999,28353,3575880477,3575880477,0
2,999,28354,3575880477,3575880477,0
2,999,28355,3575880477,3575880481,4
2,999,28356,3575880477,3575880481,4
2,999,28357,3575880477,3575880481,4
2,999,28358,3575880477,3575880482,5
2,999,28359,3575880477,3575880483,6
2,999,28360,3575880477,3575880483,6
2,999,28361,3575880477,3575880484,7
2,999,28362,3575880477,3575880484,7
2,999,28363,3575880477,3575880486,9
2,999,28364,3575880477,3575880486,9
2,999,28365,3575880477,3575880486,9
2,999,28366,3575880477,3575880487,10
2,999,28367,3575880477,3575880488,11
2,999,28368,3575880477,3575880489,12
2,999,28369,3575880477,3575880489,12
2,999,28370,3575880477,3575880490,13
2,999,28371,3575880477,3575880490,13
2,999,28372,3575880477,3575880490,13
2,999,28373,3575880477,3575880491,14
2,999,28374,3575880477,3575880491,14
2,999,28375,3575880477,3575880491,14
2,999,28376,3575880477,3575880493,16
2,999,28377,3575880477,3575880495,18
2,999,28378,3575880477,3575880496,19
2,999,28379,3575880477,3575880498,21
2,999,28380,3575880477,3575880499,22
2,999,28381,3575880477,3575880500,23
2,999,28382,3575880477,3575880501,24
2,999,28383,3575880477,3575880502,25
2,999,28384,3575880477,3575880502,25
2,999,28385,3575880477,3575880503,26
2,999,28386,3575880477,3575880503,26
2,999,28387,3575880477,3575880506,29
2,999,28388,3575880477,3575880506,29
2,999,28389,3575880477,3575880506,29
2,999,28390,3575880477,3575880506,29
2,999,28391,3575880477,3575880506,29
2,999,28392,3575880477,3575880506,29
2,999,28393,3575880477,3575880506,29
2,999,28394,3575880477,3575880507,30
2,999,28395,3575880477,3575880507,30
2,999,28396,3575880477,3575880507,30
2,999,28397,3575880477,3575880508,31
2,999,28398,3575880477,3575880509,32
2,999,28399,3575880477,3575880509,32
2,999,28400,3575880477,3575880511,34
2,999,28401,3575880477,3575880511,34
2,999,28402,3575880477,3575880512,35
2,999,28403,3575880477,3575880513,36
2,999,28404,3575880477,3575880513,36
2,999,28405,3575880477,3575880513,36
2,999,28406,3575880477,3575880513,36
2,999,28407,3575880477,3575880514,37
2,999,28408,3575880477,3575880515,38
2,999,28409,3575880477,3575880515,38
2,999,28410,3575880477,3575880515,38
2,999,28411,3575880477,3575880516,39
2,999,28412,3575880477,3575880517,40
2,999,28413,3575880477,3575880519,42
2,999,28414,3575880477,3575880520,43
2,999,28415,3575880477,3575880521,44
2,999,28416,3575880477,3575880521,44
2,999,28417,3575880477,3575880522,45
2,999,28418,3575880477,3575880522,45
2,999,28419,3575880477,3575880523,46
2,999,28420,3575880477,3575880525,48
2,999,28421,3575880477,3575880526,49
2,999,28422,3575880477,3575880526,49
2,999,28423,3575880477,3575880526,49
2,1000,28424,3575880538,3575880538,0
2,1000,28425,3575880538,3575880538,0
2,1000,28426,3575880538,3575880538,0
2,1000,28427,3575880538,3575880538,0
2,1000,28428,3575880538,3575880538,0
2,1000,28429,3575880538,3575880538,0
2,1000,28430,3575880538,3575880538,0
2,1000,28431,3575880538,3575880538,0
2,1000,28432,3575880538,3575880538,0
2,1000,28433,3575880538,3575880538,0
2,1000,28434,3575880538,3575880538,0
2,1000,28435,3575880538,3575880538,0
2,1000,28436,3575880538,3575880538,0
2,1000,28437,3575880538,3575880538,0
2,1000,28438,3575880538,3575880538,0
2,1000,28439,3575880538,3575880538,0
2,1000,28440,3575880538,3575880538,0
2,1000,28441,3575880538,3575880538,0
2,1000,28442,3575880538,3575880538,0
2,1000,28443,3575880538,3575880538,0
2,1000,28444,3575880538,3575880538,0
2,1000,28445,3575880538,3575880539,1
2,1000,28446,3575880538,3575880540,2
2,1000,28447,3575880538,3575880540,2
2,1000,28448,3575880538,3575880541,3
2,1000,28449,3575880538,3575880542,4
2,1000,28450,3575880538,3575880543,5
2,1000,28451,3575880538,3575880543,5
2,1000,28452,3575880538,3575880544,6
2,1000,28453,3575880538,3575880544,6
2,1000,28454,3575880538,3575880544,6
2,1000,28455,3575880538,3575880546,8
2,1000,28456,3575880538,3575880547,9
2,1000,28457,3575880538,3575880547,9
2,1000,28458,3575880538,3575880548,10
2,1000,28459,3575880538,3575880548,10
2,1000,28460,3575880538,3575880548,10
2,1000,28461,3575880538,3575880548,10
2,1000,28462,3575880538,3575880549,11
2,1000,28463,3575880538,3575880551,13
2,1000,28464,3575880538,3575880551,13
2,1000,28465,3575880538,3575880551,13
2,1000,28466,3575880538,3575880552,14
2,1000,28467,3575880538,3575880555,17
2,1000,28468,3575880538,3575880555,17
2,1000,28469,3575880538,3575880556,18
2,1000,28470,3575880538,3575880557,19
2,1000,28471,3575880538,3575880558,20
2,1000,28472,3575880538,3575880559,21
2,1000,28473,3575880538,3575880559,21
2,1000,28474,3575880538,3575880560,22
2,1000,28475,3575880538,3575880560,22
2,1000,28476,3575880538,3575880561,23
2,1000,28477,3575880538,3575880561,23
2,1000,28478,3575880538,3575880565,27
2,1000,28479,3575880538,3575880566,28
2,1000,28480,3575880538,3575880566,28
2,1000,28481,3575880538,3575880567,29
2,1000,28482,3575880538,3575880568,30
2,1000,28483,3575880538,3575880568,30
2,1000,28484,3575880538,3575880568,30
2,1000,28485,3575880538,3575880569,31
2,1000,28486,3575880538,3575880569,31
2,1000,28487,3575880538,3575880570,32
2,1000,28488,3575880538,3575880572,34
2,1000,28489,3575880538,3575880572,34
2,1000,28490,3575880538,3575880573,35
2,1000,28491,3575880538,3575880574,36
2,1000,28492,3575880538,3575880575,37
2,1000,28493,3575880538,3575880576,38
2,1000,28494,3575880538,3575880576,38
2,1000,28495,3575880538,3575880577,39
2,1000,28496,3575880538,3575880578,40
2,1000,28497,3575880538,3575880581,43
2,1000,28498,3575880538,3575880581,43
2,1000,28499,3575880538,3575880582,44
2,1000,28500,3575880538,3575880583,45
2,1000,28501,3575880538,3575880584,46
2,1000,28502,3575880538,3575880584,46
2,1000,28503,3575880538,3575880584,46
2,1000,28504,3575880538,3575880584,46
2,1000,28505,3575880538,3575880584,46
2,1000,28506,3575880538,3575880585,47
2,1000,28507,3575880538,3575880586,48
2,1000,28508,3575880538,3575880587,49
2,1000,28509,3575880538,3575880588,50
2,1000,28510,3575880538,3575880588,50
2,1001,28511,3575880602,3575880602,0
2,1001,28512,3575880602,3575880602,0
2,1001,28513,3575880602,3575880602,0
2,1001,28514,3575880602,3575880602,0
2,1001,28515,3575880602,3575880602,0
2,1001,28516,3575880602,3575880602,0
2,1001,28517,3575880602,3575880602,0
2,1001,28518,3575880602,3575880602,0
2,1001,28519,3575880602,3575880602,0
2,1001,28520,3575880602,3575880602,0
2,1001,28521,3575880602,3575880602,0
2,1001,28522,3575880602,3575880602,0
2,1001,28523,3575880602,3575880602,0
2,1001,28524,3575880602,3575880602,0
2,1001,28525,3575880602,3575880603,1
2,1001,28526,3575880602,3575880603,1
2,1001,28527,3575880602,3575880604,2
2,1001,28528,3575880602,3575880606,4
2,1001,28529,3575880602,3575880606,4
2,1001,28530,3575880602,3575880607,5
2,1001,28531,3575880602,3575880608,6
2,1001,28532,3575880602,3575880611,9
2,1001,28533,3575880602,3575880611,9
2,1001,28534,3575880602,3575880611,9
2,1001,28535,3575880602,3575880612,10
2,1001,28536,3575880602,3575880615,13
2,1001,28537,3575880602,3575880622,20
2,1001,28538,3575880602,3575880623,21
2,1001,28539,3575880602,3575880625,23
2,1001,28540,3575880602,3575880625,23
2,1001,28541,3575880602,3575880625,23
2,1001,28542,3575880602,3575880625,23
2,1001,28543,3575880602,3575880627,25
2,1001,28544,3575880602,3575880628,26
2,1001,28545,3575880602,3575880630,28
2,1001,28546,3575880602,3575880631,29
2,1001,28547,3575880602,3575880633,31
2,1001,28548,3575880602,3575880634,32
2,1001,28549,3575880602,3575880637,35
2,1001,28550,3575880602,3575880638,36
2,1001,28551,3575880602,3575880639,37
2,1001,28552,3575880602,3575880640,38
2,1001,28553,3575880602,3575880640,38
2,1001,28554,3575880602,3575880641,39
2,1001,28555,3575880602,3575880642,40
2,1001,28556,3575880602,3575880642,40
2,1001,28557,3575880602,3575880642,40
2,1001,28558,3575880602,3575880645,43
2,1001,28559,3575880602,3575880648,46
2,1001,28560,3575880602,3575880649,47
2,1002,28561,3575880666,3575880666,0
2,1002,28562,3575880666,3575880666,0
2,1002,28563,3575880666,3575880666,0
2,1002,28564,3575880666,3575880666,0
2,1002,28565,3575880666,3575880666,0
2,1002,28566,3575880666,3575880666,0
2,1002,28567,3575880666,3575880666,0
2,1002,28568,3575880666,3575880666,0
2,1002,28569,3575880666,3575880666,0
2,1002,28570,3575880666,3575880666,0
2,1002,28571,3575880666,3575880666,0
2,1002,28572,3575880666,3575880666,0
2,1002,28573,3575880666,3575880666,0
2,1002,28574,3575880666,3575880666,0
2,1002,28575,3575880666,3575880666,0
2,1002,28576,3575880666,3575880667,1
2,1002,28577,3575880666,3575880672,6
2,1002,28578,3575880666,3575880676,10
2,1002,28579,3575880666,3575880676,10
2,1002,28580,3575880666,3575880677,11
2,1002,28581,3575880666,3575880680,14
2,1002,28582,3575880666,3575880681,15
2,1002,28583,3575880666,3575880681,15
2,1002,28584,3575880666,3575880682,16
2,1002,28585,3575880666,3575880683,17
2,1002,28586,3575880666,3575880683,17
2,1002,28587,3575880666,3575880684,18
2,1002,28588,3575880666,3575880684,18
2,1002,28589,3575880666,3575880685,19
2,1002,28590,3575880666,3575880686,20
2,1002,28591,3575880666,3575880686,20
2,1002,28592,3575880666,3575880686,20
2,1002,28593,3575880666,3575880687,21
2,1002,28594,3575880666,3575880688,22
2,1002,28595,3575880666,3575880688,22
2,1002,28596,3575880666,3575880689,23
2,1002,28597,3575880666,3575880689,23
2,1002,28598,3575880666,3575880689,23
2,1002,28599,3575880666,3575880690,24
2,1002,28600,3575880666,3575880690,24
2,1002,28601,3575880666,3575880690,24
2,1002,28602,3575880666,3575880691,25
2,1002,28603,3575880666,3575880691,25
2,1002,28604,3575880666,3575880693,27
2,1002,28605,3575880666,3575880694,28
2,1002,28606,3575880666,3575880696,30
2,1002,28607,3575880666,3575880699,33
2,1002,28608,3575880666,3575880699,33
2,1002,28609,3575880666,3575880701,35
2,1002,28610,3575880666,3575880701,35
2,1002,28611,3575880666,3575880702,36
2,1002,28612,3575880666,3575880702,36
2,1002,28613,3575880666,3575880702,36
2,1002,28614,3575880666,3575880703,37
2,1002,28615,3575880666,3575880705,39
2,1002,28616,3575880666,3575880706,40
2,1002,28617,3575880666,3575880706,40
2,1002,28618,3575880666,3575880706,40
2,1002,28619,3575880666,3575880706,40
2,1002,28620,3575880666,3575880706,40
2,1002,28621,3575880666,3575880707,41
2,1002,28622,3575880666,3575880707,41
2,1002,28623,3575880666,3575880707,41
2,1002,28624,3575880666,3575880707,41
2,1002,28625,3575880666,3575880709,43
2,1002,28626,3575880666,3575880709,43
2,1002,28627,3575880666,3575880709,43
2,1002,28628,3575880666,3575880710,44
2,1002,28629,3575880666,3575880711,45
2,1002,28630,3575880666,3575880712,46
2,1002,28631,3575880666,3575880712,46
2,1002,28632,3575880666,3575880712,46
2,1002,28633,3575880666,3575880713,47
2,1002,28634,3575880666,3575880713,47
2,1002,28635,3575880666,3575880715,49
2,1002,28636,3575880666,3575880715,49
2,1002,28637,3575880666,3575880716,50
2,1003,28638,3575880730,3575880730,0
2,1003,28639,3575880730,3575880730,0
2,1003,28640,3575880730,3575880730,0
2,1003,28641,3575880730,3575880730,0
2,1003,28642,3575880730,3575880730,0
2,1003,28643,3575880730,3575880730,0
2,1003,28644,3575880730,3575880730,0
2,1003,28645,3575880730,3575880730,0
2,1003,28646,3575880730,3575880730,0
2,1003,28647,3575880730,3575880730,0
2,1003,28648,3575880730,3575880730,0
2,1003,28649,3575880730,3575880730,0
2,1003,28650,3575880730,3575880730,0
2,1003,28651,3575880730,3575880730,0
2,1003,28652,3575880730,3575880730,0
2,1003,28653,3575880730,3575880730,0
2,1003,28654,3575880730,3575880730,0
2,1003,28655,3575880730,3575880730,0
2,1003,28656,3575880730,3575880730,0
2,1003,28657,3575880730,3575880731,1
2,1003,28658,3575880730,3575880731,1
2,1003,28659,3575880730,3575880731,1
2,1003,28660,3575880730,3575880732,2
2,1003,28661,3575880730,3575880732,2
2,1003,28662,3575880730,3575880732,2
2,1003,28663,3575880730,3575880732,2
2,1003,28664,3575880730,3575880733,3
2,1003,28665,3575880730,3575880734,4
2,1003,28666,3575880730,3575880734,4
2,1003,28667,3575880730,3575880734,4
2,1003,28668,3575880730,3575880735,5
2,1003,28669,3575880730,3575880735,5
2,1003,28670,3575880730,3575880736,6
2,1003,28671,3575880730,3575880736,6
2,1003,28672,3575880730,3575880737,7
2,1003,28673,3575880730,3575880738,8
2,1003,28674,3575880730,3575880740,10
2,1003,28675,3575880730,3575880740,10
2,1003,28676,3575880730,3575880740,10
2,1003,28677,3575880730,3575880742,12
2,1003,28678,3575880730,3575880742,12
2,1003,28679,3575880730,3575880743,13
2,1003,28680,3575880730,3575880743,13
2,1003,28681,3575880730,3575880744,14
2,1003,28682,3575880730,3575880744,14
2,1003,28683,3575880730,3575880745,15
2,1003,28684,3575880730,3575880745,15
2,1003,28685,3575880730,3575880747,17
2,1003,28686,3575880730,3575880748,18
2,1003,28687,3575880730,3575880748,18
2,1003,28688,3575880730,3575880748,18
2,1003,28689,3575880730,3575880749,19
2,1003,28690,3575880730,3575880749,19
2,1003,28691,3575880730,3575880749,19
2,1003,28692,3575880730,3575880751,21
2,1003,28693,3575880730,3575880751,21
2,1003,28694,3575880730,3575880752,22
2,1003,28695,3575880730,3575880752,22
2,1003,28696,3575880730,3575880754,24
2,1003,28697,3575880730,3575880755,25
2,1003,28698,3575880730,3575880756,26
2,1003,28699,3575880730,3575880757,27
2,1003,28700,3575880730,3575880758,28
2,1003,28701,3575880730,3575880759,29
2,1003,28702,3575880730,3575880760,30
2,1003,28703,3575880730,3575880760,30
2,1003,28704,3575880730,3575880761,31
2,1003,28705,3575880730,3575880761,31
2,1003,28706,3575880730,3575880762,32
2,1003,28707,3575880730,3575880765,35
2,1003,28708,3575880730,3575880766,36
2,1003,28709,3575880730,3575880766,36
2,1003,28710,3575880730,3575880767,37
2,1003,28711,3575880730,3575880768,38
2,1003,28712,3575880730,3575880768,38
2,1003,28713,3575880730,3575880768,38
2,1003,28714,3575880730,3575880769,39
2,1003,28715,3575880730,3575880769,39
2,1003,28716,3575880730,3575880770,40
2,1003,28717,3575880730,3575880772,42
2,1003,28718,3575880730,3575880773,43
2,1003,28719,3575880730,3575880775,45
2,1003,28720,3575880730,3575880775,45
2,1003,28721,3575880730,3575880776,46
2,1003,28722,3575880730,3575880776,46
2,1003,28723,3575880730,3575880778,48
2,1003,28724,3575880730,3575880778,48
2,1004,28725,3575880794,3575880794,0
2,1004,28726,3575880794,3575880794,0
2,1004,28727,3575880794,3575880794,0
2,1004,28728,3575880794,3575880794,0
2,1004,28729,3575880794,3575880794,0
2,1004,28730,3575880794,3575880794,0
2,1004,28731,3575880794,3575880794,0
2,1004,28732,3575880794,3575880794,0
2,1004,28733,3575880794,3575880794,0
2,1004,28734,3575880794,3575880794,0
2,1004,28735,3575880794,3575880794,0
2,1004,28736,3575880794,3575880794,0
2,1004,28737,3575880794,3575880794,0
2,1004,28738,3575880794,3575880794,0
2,1004,28739,3575880794,3575880794,0
2,1004,28740,3575880794,3575880794,0
2,1004,28741,3575880794,3575880794,0
2,1004,28742,3575880794,3575880794,0
2,1004,28743,3575880794,3575880794,0
2,1004,28744,3575880794,3575880795,1
2,1004,28745,3575880794,3575880796,2
2,1004,28746,3575880794,3575880798,4
2,1004,28747,3575880794,3575880799,5
2,1004,28748,3575880794,3575880800,6
2,1004,28749,3575880794,3575880803,9
2,1004,28750,3575880794,3575880803,9
2,1004,28751,3575880794,3575880804,10
2,1004,28752,3575880794,3575880804,10
2,1004,28753,3575880794,3575880806,12
2,1004,28754,3575880794,3575880807,13
2,1004,28755,3575880794,3575880807,13
2,1004,28756,3575880794,3575880811,17
2,1004,28757,3575880794,3575880812,18
2,1004,28758,3575880794,3575880812,18
2,1004,28759,3575880794,3575880812,18
2,1004,28760,3575880794,3575880815,21
2,1004,28761,3575880794,3575880821,27
2,1004,28762,3575880794,3575880823,29
2,1004,28763,3575880794,3575880824,30
2,1004,28764,3575880794,3575880825,31
2,1004,28765,3575880794,3575880825,31
2,1004,28766,3575880794,3575880825,31
2,1004,28767,3575880794,3575880826,32
2,1004,28768,3575880794,3575880829,35
2,1004,28769,3575880794,3575880829,35
2,1004,28770,3575880794,3575880830,36
2,1004,28771,3575880794,3575880832,38
2,1004,28772,3575880794,3575880836,42
2,1004,28773,3575880794,3575880837,43
2,1004,28774,3575880794,3575880838,44
2,1004,28775,3575880794,3575880840,46
2,1004,28776,3575880794,3575880840,46
2,1004,28777,3575880794,3575880840,46
2,1004,28778,3575880794,3575880841,47
2,1004,28779,3575880794,3575880841,47
2,1004,28780,3575880794,3575880842,48
2,1004,28781,3575880794,3575880843,49
2,1005,28782,3575880855,3575880855,0
2,1005,28783,3575880855,3575880855,0
2,1005,28784,3575880855,3575880855,0
2,1005,28785,3575880855,3575880855,0
2,1005,28786,3575880855,3575880855,0
2,1005,28787,3575880855,3575880855,0
2,1005,28788,3575880855,3575880855,0
2,1005,28789,3575880855,3575880855,0
2,1005,28790,3575880855,3575880855,0
2,1005,28791,3575880855,3575880856,1
2,1005,28792,3575880855,3575880856,1
2,1005,28793,3575880855,3575880857,2
2,1005,28794,3575880855,3575880859,4
2,1005,28795,3575880855,3575880861,6
2,1005,28796,3575880855,3575880861,6
2,1005,28797,3575880855,3575880862,7
2,1005,28798,3575880855,3575880863,8
2,1005,28799,3575880855,3575880863,8
2,1005,28800,3575880855,3575880864,9
2,1005,28801,3575880855,3575880865,10
2,1005,28802,3575880855,3575880867,12
2,1005,28803,3575880855,3575880875,20
2,1005,28804,3575880855,3575880876,21
2,1005,28805,3575880855,3575880877,22
2,1005,28806,3575880855,3575880880,25
2,1005,28807,3575880855,3575880881,26
2,1005,28808,3575880855,3575880882,27
2,1005,28809,3575880855,3575880883,28
2,1005,28810,3575880855,3575880883,28
2,1005,28811,3575880855,3575880883,28
2,1005,28812,3575880855,3575880884,29
2,1005,28813,3575880855,3575880884,29
2,1005,28814,3575880855,3575880885,30
2,1005,28815,3575880855,3575880886,31
2,1005,28816,3575880855,3575880887,32
2,1005,28817,3575880855,3575880887,32
2,1005,28818,3575880855,3575880887,32
2,1005,28819,3575880855,3575880888,33
2,1005,28820,3575880855,3575880888,33
2,1005,28821,3575880855,3575880889,34
2,1005,28822,3575880855,3575880889,34
2,1005,28823,3575880855,3575880889,34
2,1005,28824,3575880855,3575880890,35
2,1005,28825,3575880855,3575880890,35
2,1005,28826,3575880855,3575880890,35
2,1005,28827,3575880855,3575880891,36
2,1005,28828,3575880855,3575880892,37
2,1005,28829,3575880855,3575880893,38
2,1005,28830,3575880855,3575880893,38
2,1005,28831,3575880855,3575880895,40
2,1005,28832,3575880855,3575880897,42
2,1005,28833,3575880855,3575880899,44
2,1005,28834,3575880855,3575880899,44
2,1005,28835,3575880855,3575880901,46
2,1005,28836,3575880855,3575880901,46
2,1005,28837,3575880855,3575880901,46
2,1005,28838,3575880855,3575880902,47
2,1005,28839,3575880855,3575880902,47
2,1006,28840,3575880920,3575880920,0
2,1006,28841,3575880920,3575880920,0
2,1006,28842,3575880920,3575880920,0
2,1006,28843,3575880920,3575880920,0
2,1006,28844,3575880920,3575880920,0
2,1006,28845,3575880920,3575880920,0
2,1006,28846,3575880920,3575880920,0
2,1006,28847,3575880920,3575880920,0
2,1006,28848,3575880920,3575880920,0
2,1006,28849,3575880920,3575880920,0
2,1006,28850,3575880920,3575880920,0
2,1006,28851,3575880920,3575880920,0
2,1006,28852,3575880920,3575880920,0
2,1006,28853,3575880920,3575880920,0
2,1006,28854,3575880920,3575880920,0
2,1006,28855,3575880920,3575880920,0
2,1006,28856,3575880920,3575880920,0
2,1006,28857,3575880920,3575880920,0
2,1006,28858,3575880920,3575880920,0
2,1006,28859,3575880920,3575880920,0
2,1006,28860,3575880920,3575880920,0
2,1006,28861,3575880920,3575880920,0
2,1006,28862,3575880920,3575880920,0
2,1006,28863,3575880920,3575880920,0
2,1006,28864,3575880920,3575880920,0
2,1006,28865,3575880920,3575880920,0
2,1006,28866,3575880920,3575880920,0
2,1006,28867,3575880920,3575880920,0
2,1006,28868,3575880920,3575880921,1
2,1006,28869,3575880920,3575880921,1
2,1006,28870,3575880920,3575880922,2
2,1006,28871,3575880920,3575880923,3
2,1006,28872,3575880920,3575880925,5
2,1006,28873,3575880920,3575880926,6
2,1006,28874,3575880920,3575880926,6
2,1006,28875,3575880920,3575880927,7
2,1006,28876,3575880920,3575880928,8
2,1006,28877,3575880920,3575880928,8
2,1006,28878,3575880920,3575880930,10
2,1006,28879,3575880920,3575880930,10
2,1006,28880,3575880920,3575880930,10
2,1006,28881,3575880920,3575880931,11
2,1006,28882,3575880920,3575880931,11
2,1006,28883,3575880920,3575880932,12
2,1006,28884,3575880920,3575880932,12
2,1006,28885,3575880920,3575880932,12
2,1006,28886,3575880920,3575880932,12
2,1006,28887,3575880920,3575880932,12
2,1006,28888,3575880920,3575880934,14
2,1006,28889,3575880920,3575880934,14
2,1006,28890,3575880920,3575880935,15
2,1006,28891,3575880920,3575880935,15
2,1006,28892,3575880920,3575880935,15
2,1006,28893,3575880920,3575880936,16
2,1006,28894,3575880920,3575880936,16
2,1006,28895,3575880920,3575880937,17
2,1006,28896,3575880920,3575880938,18
2,1006,28897,3575880920,3575880939,19
2,1006,28898,3575880920,3575880940,20
2,1006,28899,3575880920,3575880942,22
2,1006,28900,3575880920,3575880942,22
2,1006,28901,3575880920,3575880944,24
2,1006,28902,3575880920,3575880945,25
2,1006,28903,3575880920,3575880945,25
2,1006,28904,3575880920,3575880945,25
2,1006,28905,3575880920,3575880946,26
2,1006,28906,3575880920,3575880946,26
2,1006,28907,3575880920,3575880947,27
2,1006,28908,3575880920,3575880948,28
2,1006,28909,3575880920,3575880948,28
2,1006,28910,3575880920,3575880949,29
2,1006,28911,3575880920,3575880949,29
2,1006,28912,3575880920,3575880949,29
2,1006,28913,3575880920,3575880949,29
2,1006,28914,3575880920,3575880950,30
2,1006,28915,3575880920,3575880951,31
2,1006,28916,3575880920,3575880952,32
2,1006,28917,3575880920,3575880952,32
2,1006,28918,3575880920,3575880955,35
2,1006,28919,3575880920,3575880956,36
2,1006,28920,3575880920,3575880957,37
2,1006,28921,3575880920,3575880957,37
2,1006,28922,3575880920,3575880959,39
2,1006,28923,3575880920,3575880960,40
2,1006,28924,3575880920,3575880960,40
2,1006,28925,3575880920,3575880960,40
2,1006,28926,3575880920,3575880962,42
2,1006,28927,3575880920,3575880963,43
2,1006,28928,3575880920,3575880964,44
2,1006,28929,3575880920,3575880966,46
2,1006,28930,3575880920,3575880966,46
2,1006,28931,3575880920,3575880967,47
2,1006,28932,3575880920,3575880967,47
2,1006,28933,3575880920,3575880967,47
2,1006,28934,3575880920,3575880968,48
2,1006,28935,3575880920,3575880968,48
2,1006,28936,3575880920,3575880969,49
2,1006,28937,3575880920,3575880969,49
2,1006,28938,3575880920,3575880970,50
2,1007,28939,3575880987,3575880987,0
2,1007,28940,3575880987,3575880987,0
2,1007,28941,3575880987,3575880987,0
2,1007,28942,3575880987,3575880987,0
2,1007,28943,3575880987,3575880987,0
2,1007,28944,3575880987,3575880987,0
2,1007,28945,3575880987,3575880987,0
2,1007,28946,3575880987,3575880987,0
2,1007,28947,3575880987,3575880987,0
2,1007,28948,3575880987,3575880987,0
2,1007,28949,3575880987,3575880987,0
2,1007,28950,3575880987,3575880988,1
2,1007,28951,3575880987,3575880988,1
2,1007,28952,3575880987,3575880988,1
2,1007,28953,3575880987,3575880988,1
2,1007,28954,3575880987,3575880988,1
2,1007,28955,3575880987,3575880988,1
2,1007,28956,3575880987,3575880988,1
2,1007,28957,3575880987,3575880988,1
2,1007,28958,3575880987,3575880988,1
2,1007,28959,3575880987,3575880988,1
2,1007,28960,3575880987,3575880988,1
2,1007,28961,3575880987,3575880989,2
2,1007,28962,3575880987,3575880989,2
2,1007,28963,3575880987,3575880991,4
2,1007,28964,3575880987,3575880992,5
2,1007,28965,3575880987,3575880993,6
2,1007,28966,3575880987,3575880996,9
2,1007,28967,3575880987,3575880997,10
2,1007,28968,3575880987,3575880998,11
2,1007,28969,3575880987,3575880999,12
2,1007,28970,3575880987,3575881000,13
2,1007,28971,3575880987,3575881001,14
2,1007,28972,3575880987,3575881003,16
2,1007,28973,3575880987,3575881003,16
2,1007,28974,3575880987,3575881003,16
2,1007,28975,3575880987,3575881003,16
2,1007,28976,3575880987,3575881004,17
2,1007,28977,3575880987,3575881005,18
2,1007,28978,3575880987,3575881007,20
2,1007,28979,3575880987,3575881011,24
2,1007,28980,3575880987,3575881012,25
2,1007,28981,3575880987,3575881012,25
2,1007,28982,3575880987,3575881012,25
2,1007,28983,3575880987,3575881015,28
2,1007,28984,3575880987,3575881022,35
2,1007,28985,3575880987,3575881024,37
2,1007,28986,3575880987,3575881024,37
2,1007,28987,3575880987,3575881025,38
2,1007,28988,3575880987,3575881026,39
2,1007,28989,3575880987,3575881026,39
2,1007,28990,3575880987,3575881027,40
2,1007,28991,3575880987,3575881029,42
2,1007,28992,3575880987,3575881029,42
2,1007,28993,3575880987,3575881030,43
2,1007,28994,3575880987,3575881031,44
2,1007,28995,3575880987,3575881033,46
2,1007,28996,3575880987,3575881036,49
2,1008,28997,3575881049,3575881049,0
2,1008,28998,3575881049,3575881049,0
2,1008,28999,3575881049,3575881049,0
2,1008,29000,3575881049,3575881049,0
2,1008,29001,3575881049,3575881049,0
2,1008,29002,3575881049,3575881049,0
2,1008,29003,3575881049,3575881049,0
2,1008,29004,3575881049,3575881049,0
2,1008,29005,3575881049,3575881049,0
2,1008,29006,3575881049,3575881049,0
2,1008,29007,3575881049,3575881049,0
2,1008,29008,3575881049,3575881049,0
2,1008,29009,3575881049,3575881049,0
2,1008,29010,3575881049,3575881049,0
2,1008,29011,3575881049,3575881050,1
2,1008,29012,3575881049,3575881054,5
2,1008,29013,3575881049,3575881055,6
2,1008,29014,3575881049,3575881055,6
2,1008,29015,3575881049,3575881055,6
2,1008,29016,3575881049,3575881055,6
2,1008,29017,3575881049,3575881056,7
2,1008,29018,3575881049,3575881056,7
2,1008,29019,3575881049,3575881057,8
2,1008,29020,3575881049,3575881059,10
2,1008,29021,3575881049,3575881061,12
2,1008,29022,3575881049,3575881062,13
2,1008,29023,3575881049,3575881063,14
2,1008,29024,3575881049,3575881063,14
2,1008,29025,3575881049,3575881064,15
2,1008,29026,3575881049,3575881066,17
2,1008,29027,3575881049,3575881067,18
2,1008,29028,3575881049,3575881075,26
2,1008,29029,3575881049,3575881077,28
2,1008,29030,3575881049,3575881078,29
2,1008,29031,3575881049,3575881080,31
2,1008,29032,3575881049,3575881081,32
2,1008,29033,3575881049,3575881081,32
2,1008,29034,3575881049,3575881082,33
2,1008,29035,3575881049,3575881083,34
2,1008,29036,3575881049,3575881083,34
2,1008,29037,3575881049,3575881084,35
2,1008,29038,3575881049,3575881084,35
2,1008,29039,3575881049,3575881085,36
2,1008,29040,3575881049,3575881086,37
2,1008,29041,3575881049,3575881087,38
2,1008,29042,3575881049,3575881087,38
2,1008,29043,3575881049,3575881088,39
2,1008,29044,3575881049,3575881088,39
2,1008,29045,3575881049,3575881089,40
2,1008,29046,3575881049,3575881089,40
2,1008,29047,3575881049,3575881090,41
2,1008,29048,3575881049,3575881090,41
2,1008,29049,3575881049,3575881090,41
2,1008,29050,3575881049,3575881090,41
2,1008,29051,3575881049,3575881091,42
2,1008,29052,3575881049,3575881093,44
2,1008,29053,3575881049,3575881094,45
2,1008,29054,3575881049,3575881094,45
2,1008,29055,3575881049,3575881095,46
2,1008,29056,3575881049,3575881097,48
2,1008,29057,3575881049,3575881097,48
2,1008,29058,3575881049,3575881098,49
2,1008,29059,3575881049,3575881099,50
2,1009,29060,3575881117,3575881117,0
2,1009,29061,3575881117,3575881117,0
2,1009,29062,3575881117,3575881117,0
2,1009,29063,3575881117,3575881117,0
2,1009,29064,3575881117,3575881117,0
2,1009,29065,3575881117,3575881117,0
2,1009,29066,3575881117,3575881117,0
2,1009,29067,3575881117,3575881117,0
2,1009,29068,3575881117,3575881117,0
2,1009,29069,3575881117,3575881117,0
2,1009,29070,3575881117,3575881117,0
2,1009,29071,3575881117,3575881117,0
2,1009,29072,3575881117,3575881117,0
2,1009,29073,3575881117,3575881117,0
2,1009,29074,3575881117,3575881117,0
2,1009,29075,3575881117,3575881117,0
2,1009,29076,3575881117,3575881117,0
2,1009,29077,3575881117,3575881117,0
2,1009,29078,3575881117,3575881117,0
2,1009,29079,3575881117,3575881117,0
2,1009,29080,3575881117,3575881117,0
2,1009,29081,3575881117,3575881117,0
2,1009,29082,3575881117,3575881117,0
2,1009,29083,3575881117,3575881117,0
2,1009,29084,3575881117,3575881117,0
2,1009,29085,3575881117,3575881117,0
2,1009,29086,3575881117,3575881117,0
2,1009,29087,3575881117,3575881117,0
2,1009,29088,3575881117,3575881117,0
2,1009,29089,3575881117,3575881118,1
2,1009,29090,3575881117,3575881118,1
2,1009,29091,3575881117,3575881118,1
2,1009,29092,3575881117,3575881118,1
2,1009,29093,3575881117,3575881118,1
2,1009,29094,3575881117,3575881120,3
2,1009,29095,3575881117,3575881121,4
2,1009,29096,3575881117,3575881121,4
2,1009,29097,3575881117,3575881121,4
2,1009,29098,3575881117,3575881123,6
2,1009,29099,3575881117,3575881127,10
2,1009,29100,3575881117,3575881127,10
2,1009,29101,3575881117,3575881127,10
2,1009,29102,3575881117,3575881129,12
2,1009,29103,3575881117,3575881130,13
2,1009,29104,3575881117,3575881130,13
2,1009,29105,3575881117,3575881130,13
2,1009,29106,3575881117,3575881130,13
2,1009,29107,3575881117,3575881131,14
2,1009,29108,3575881117,3575881132,15
2,1009,29109,3575881117,3575881132,15
2,1009,29110,3575881117,3575881132,15
2,1009,29111,3575881117,3575881132,15
2,1009,29112,3575881117,3575881133,16
2,1009,29113,3575881117,3575881134,17
2,1009,29114,3575881117,3575881134,17
2,1009,29115,3575881117,3575881134,17
2,1009,29116,3575881117,3575881135,18
2,1009,29117,3575881117,3575881135,18
2,1009,29118,3575881117,3575881136,19
2,1009,29119,3575881117,3575881136,19
2,1009,29120,3575881117,3575881137,20
2,1009,29121,3575881117,3575881137,20
2,1009,29122,3575881117,3575881139,22
2,1009,29123,3575881117,3575881140,23
2,1009,29124,3575881117,3575881140,23
2,1009,29125,3575881117,3575881142,25
2,1009,29126,3575881117,3575881142,25
2,1009,29127,3575881117,3575881144,27
2,1009,29128,3575881117,3575881145,28
2,1009,29129,3575881117,3575881145,28
2,1009,29130,3575881117,3575881145,28
2,1009,29131,3575881117,3575881145,28
2,1009,29132,3575881117,3575881146,29
2,1009,29133,3575881117,3575881148,31
2,1009,29134,3575881117,3575881149,32
2,1009,29135,3575881117,3575881149,32
2,1009,29136,3575881117,3575881149,32
2,1009,29137,3575881117,3575881149,32
2,1009,29138,3575881117,3575881149,32
2,1009,29139,3575881117,3575881151,34
2,1009,29140,3575881117,3575881152,35
2,1009,29141,3575881117,3575881152,35
2,1009,29142,3575881117,3575881152,35
2,1009,29143,3575881117,3575881156,39
2,1009,29144,3575881117,3575881157,40
2,1009,29145,3575881117,3575881157,40
2,1009,29146,3575881117,3575881159,42
2,1009,29147,3575881117,3575881159,42
2,1009,29148,3575881117,3575881160,43
2,1009,29149,3575881117,3575881160,43
2,1009,29150,3575881117,3575881160,43
2,1009,29151,3575881117,3575881161,44
2,1009,29152,3575881117,3575881164,47
2,1009,29153,3575881117,3575881164,47
2,1009,29154,3575881117,3575881165,48
2,1009,29155,3575881117,3575881165,48
2,1009,29156,3575881117,3575881166,49
2,1009,29157,3575881117,3575881167,50
2,1010,29158,3575881184,3575881184,0
2,1010,29159,3575881184,3575881184,0
2,1010,29160,3575881184,3575881184,0
2,1010,29161,3575881184,3575881184,0
2,1010,29162,3575881184,3575881184,0
2,1010,29163,3575881184,3575881184,0
2,1010,29164,3575881184,3575881184,0
2,1010,29165,3575881184,3575881184,0
2,1010,29166,3575881184,3575881184,0
2,1010,29167,3575881184,3575881184,0
2,1010,29168,3575881184,3575881184,0
2,1010,29169,3575881184,3575881184,0
2,1010,29170,3575881184,3575881184,0
2,1010,29171,3575881184,3575881184,0
2,1010,29172,3575881184,3575881184,0
2,1010,29173,3575881184,3575881184,0
2,1010,29174,3575881184,3575881184,0
2,1010,29175,3575881184,3575881184,0
2,1010,29176,3575881184,3575881184,0
2,1010,29177,3575881184,3575881184,0
2,1010,29178,3575881184,3575881184,0
2,1010,29179,3575881184,3575881185,1
2,1010,29180,3575881184,3575881185,1
2,1010,29181,3575881184,3575881185,1
2,1010,29182,3575881184,3575881186,2
2,1010,29183,3575881184,3575881186,2
2,1010,29184,3575881184,3575881186,2
2,1010,29185,3575881184,3575881186,2
2,1010,29186,3575881184,3575881188,4
2,1010,29187,3575881184,3575881189,5
2,1010,29188,3575881184,3575881189,5
2,1010,29189,3575881184,3575881189,5
2,1010,29190,3575881184,3575881191,7
2,1010,29191,3575881184,3575881192,8
2,1010,29192,3575881184,3575881193,9
2,1010,29193,3575881184,3575881195,11
2,1010,29194,3575881184,3575881196,12
2,1010,29195,3575881184,3575881196,12
2,1010,29196,3575881184,3575881199,15
2,1010,29197,3575881184,3575881199,15
2,1010,29198,3575881184,3575881200,16
2,1010,29199,3575881184,3575881202,18
2,1010,29200,3575881184,3575881203,19
2,1010,29201,3575881184,3575881204,20
2,1010,29202,3575881184,3575881204,20
2,1010,29203,3575881184,3575881205,21
2,1010,29204,3575881184,3575881206,22
2,1010,29205,3575881184,3575881207,23
2,1010,29206,3575881184,3575881210,26
2,1010,29207,3575881184,3575881211,27
2,1010,29208,3575881184,3575881212,28
2,1010,29209,3575881184,3575881212,28
2,1010,29210,3575881184,3575881215,31
2,1010,29211,3575881184,3575881222,38
2,1010,29212,3575881184,3575881222,38
2,1010,29213,3575881184,3575881223,39
2,1010,29214,3575881184,3575881225,41
2,1010,29215,3575881184,3575881226,42
2,1010,29216,3575881184,3575881226,42
2,1010,29217,3575881184,3575881227,43
2,1010,29218,3575881184,3575881228,44
2,1010,29219,3575881184,3575881229,45
2,1010,29220,3575881184,3575881229,45
2,1010,29221,3575881184,3575881230,46
2,1010,29222,3575881184,3575881232,48
2,1011,29223,3575881250,3575881250,0
2,1011,29224,3575881250,3575881250,0
2,1011,29225,3575881250,3575881250,0
2,1011,29226,3575881250,3575881250,0
2,1011,29227,3575881250,3575881250,0
2,1011,29228,3575881250,3575881250,0
2,1011,29229,3575881250,3575881250,0
2,1011,29230,3575881250,3575881250,0
2,1011,29231,3575881250,3575881250,0
2,1011,29232,3575881250,3575881250,0
2,1011,29233,3575881250,3575881250,0
2,1011,29234,3575881250,3575881250,0
2,1011,29235,3575881250,3575881250,0
2,1011,29236,3575881250,3575881250,0
2,1011,29237,3575881250,3575881250,0
2,1011,29238,3575881250,3575881250,0
2,1011,29239,3575881250,3575881255,5
2,1011,29240,3575881250,3575881255,5
2,1011,29241,3575881250,3575881255,5
2,1011,29242,3575881250,3575881256,6
2,1011,29243,3575881250,3575881256,6
2,1011,29244,3575881250,3575881256,6
2,1011,29245,3575881250,3575881257,7
2,1011,29246,3575881250,3575881257,7
2,1011,29247,3575881250,3575881259,9
2,1011,29248,3575881250,3575881261,11
2,1011,29249,3575881250,3575881262,12
2,1011,29250,3575881250,3575881263,13
2,1011,29251,3575881250,3575881263,13
2,1011,29252,3575881250,3575881263,13
2,1011,29253,3575881250,3575881266,16
2,1011,29254,3575881250,3575881267,17
2,1011,29255,3575881250,3575881275,25
2,1011,29256,3575881250,3575881276,26
2,1011,29257,3575881250,3575881278,28
2,1011,29258,3575881250,3575881281,31
2,1011,29259,3575881250,3575881281,31
2,1011,29260,3575881250,3575881281,31
2,1011,29261,3575881250,3575881283,33
2,1011,29262,3575881250,3575881283,33
2,1011,29263,3575881250,3575881283,33
2,1011,29264,3575881250,3575881284,34
2,1011,29265,3575881250,3575881284,34
2,1011,29266,3575881250,3575881285,35
2,1011,29267,3575881250,3575881286,36
2,1011,29268,3575881250,3575881286,36
2,1011,29269,3575881250,3575881287,37
2,1011,29270,3575881250,3575881288,38
2,1011,29271,3575881250,3575881289,39
2,1011,29272,3575881250,3575881289,39
2,1011,29273,3575881250,3575881289,39
2,1011,29274,3575881250,3575881290,40
2,1011,29275,3575881250,3575881290,40
2,1011,29276,3575881250,3575881290,40
2,1011,29277,3575881250,3575881291,41
2,1011,29278,3575881250,3575881291,41
2,1011,29279,3575881250,3575881291,41
2,1011,29280,3575881250,3575881293,43
2,1011,29281,3575881250,3575881294,44
2,1011,29282,3575881250,3575881295,45
2,1011,29283,3575881250,3575881297,47
2,1011,29284,3575881250,3575881298,48
2,1011,29285,3575881250,3575881299,49
2,1011,29286,3575881250,3575881299,49
2,1012,29287,3575881311,3575881311,0
2,1012,29288,3575881311,3575881311,0
2,1012,29289,3575881311,3575881311,0
2,1012,29290,3575881311,3575881311,0
2,1012,29291,3575881311,3575881311,0
2,1012,29292,3575881311,3575881311,0
2,1012,29293,3575881311,3575881311,0
2,1012,29294,3575881311,3575881311,0
2,1012,29295,3575881311,3575881311,0
2,1012,29296,3575881311,3575881311,0
2,1012,29297,3575881311,3575881311,0
2,1012,29298,3575881311,3575881311,0
2,1012,29299,3575881311,3575881311,0
2,1012,29300,3575881311,3575881311,0
2,1012,29301,3575881311,3575881311,0
2,1012,29302,3575881311,3575881311,0
2,1012,29303,3575881311,3575881311,0
2,1012,29304,3575881311,3575881311,0
2,1012,29305,3575881311,3575881311,0
2,1012,29306,3575881311,3575881312,1
2,1012,29307,3575881311,3575881312,1
2,1012,29308,3575881311,3575881313,2
2,1012,29309,3575881311,3575881313,2
2,1012,29310,3575881311,3575881313,2
2,1012,29311,3575881311,3575881314,3
2,1012,29312,3575881311,3575881314,3
2,1012,29313,3575881311,3575881314,3
2,1012,29314,3575881311,3575881316,5
2,1012,29315,3575881311,3575881316,5
2,1012,29316,3575881311,3575881317,6
2,1012,29317,3575881311,3575881317,6
2,1012,29318,3575881311,3575881317,6
2,1012,29319,3575881311,3575881318,7
2,1012,29320,3575881311,3575881320,9
2,1012,29321,3575881311,3575881321,10
2,1012,29322,3575881311,3575881321,10
2,1012,29323,3575881311,3575881322,11
2,1012,29324,3575881311,3575881323,12
2,1012,29325,3575881311,3575881326,15
2,1012,29326,3575881311,3575881327,16
2,1012,29327,3575881311,3575881327,16
2,1012,29328,3575881311,3575881328,17
2,1012,29329,3575881311,3575881329,18
2,1012,29330,3575881311,3575881330,19
2,1012,29331,3575881311,3575881330,19
2,1012,29332,3575881311,3575881331,20
2,1012,29333,3575881311,3575881331,20
2,1012,29334,3575881311,3575881332,21
2,1012,29335,3575881311,3575881332,21
2,1012,29336,3575881311,3575881332,21
2,1012,29337,3575881311,3575881332,21
2,1012,29338,3575881311,3575881333,22
2,1012,29339,3575881311,3575881334,23
2,1012,29340,3575881311,3575881334,23
2,1012,29341,3575881311,3575881334,23
2,1012,29342,3575881311,3575881336,25
2,1012,29343,3575881311,3575881336,25
2,1012,29344,3575881311,3575881336,25
2,1012,29345,3575881311,3575881336,25
2,1012,29346,3575881311,3575881337,26
2,1012,29347,3575881311,3575881338,27
2,1012,29348,3575881311,3575881340,29
2,1012,29349,3575881311,3575881340,29
2,1012,29350,3575881311,3575881341,30
2,1012,29351,3575881311,3575881342,31
2,1012,29352,3575881311,3575881343,32
2,1012,29353,3575881311,3575881344,33
2,1012,29354,3575881311,3575881344,33
2,1012,29355,3575881311,3575881344,33
2,1012,29356,3575881311,3575881345,34
2,1012,29357,3575881311,3575881345,34
2,1012,29358,3575881311,3575881347,36
2,1012,29359,3575881311,3575881348,37
2,1012,29360,3575881311,3575881348,37
2,1012,29361,3575881311,3575881349,38
2,1012,29362,3575881311,3575881349,38
2,1012,29363,3575881311,3575881349,38
2,1012,29364,3575881311,3575881349,38
2,1012,29365,3575881311,3575881349,38
2,1012,29366,3575881311,3575881349,38
2,1012,29367,3575881311,3575881352,41
2,1012,29368,3575881311,3575881352,41
2,1012,29369,3575881311,3575881352,41
2,1012,29370,3575881311,3575881356,45
2,1012,29371,3575881311,3575881356,45
2,1012,29372,3575881311,3575881358,47
2,1012,29373,3575881311,3575881360,49
2,1012,29374,3575881311,3575881360,49
2,1012,29375,3575881311,3575881360,49
2,1012,29376,3575881311,3575881360,49
2,1012,29377,3575881311,3575881361,50
2,1013,29378,3575881374,3575881374,0
2,1013,29379,3575881374,3575881374,0
2,1013,29380,3575881374,3575881374,0
2,1013,29381,3575881374,3575881374,0
2,1013,29382,3575881374,3575881374,0
2,1013,29383,3575881374,3575881374,0
2,1013,29384,3575881374,3575881374,0
2,1013,29385,3575881374,3575881374,0
2,1013,29386,3575881374,3575881374,0
2,1013,29387,3575881374,3575881374,0
2,1013,29388,3575881374,3575881374,0
2,1013,29389,3575881374,3575881374,0
2,1013,29390,3575881374,3575881374,0
2,1013,29391,3575881374,3575881374,0
2,1013,29392,3575881374,3575881374,0
2,1013,29393,3575881374,3575881374,0
2,1013,29394,3575881374,3575881374,0
2,1013,29395,3575881374,3575881375,1
2,1013,29396,3575881374,3575881376,2
2,1013,29397,3575881374,3575881376,2
2,1013,29398,3575881374,3575881378,4
2,1013,29399,3575881374,3575881379,5
2,1013,29400,3575881374,3575881380,6
2,1013,29401,3575881374,3575881380,6
2,1013,29402,3575881374,3575881381,7
2,1013,29403,3575881374,3575881384,10
2,1013,29404,3575881374,3575881384,10
2,1013,29405,3575881374,3575881385,11
2,1013,29406,3575881374,3575881385,11
2,1013,29407,3575881374,3575881385,11
2,1013,29408,3575881374,3575881386,12
2,1013,29409,3575881374,3575881386,12
2,1013,29410,3575881374,3575881386,12
2,1013,29411,3575881374,3575881387,13
2,1013,29412,3575881374,3575881387,13
2,1013,29413,3575881374,3575881388,14
2,1013,29414,3575881374,3575881388,14
2,1013,29415,3575881374,3575881389,15
2,1013,29416,3575881374,3575881390,16
2,1013,29417,3575881374,3575881392,18
2,1013,29418,3575881374,3575881392,18
2,1013,29419,3575881374,3575881392,18
2,1013,29420,3575881374,3575881392,18
2,1013,29421,3575881374,3575881394,20
2,1013,29422,3575881374,3575881395,21
2,1013,29423,3575881374,3575881396,22
2,1013,29424,3575881374,3575881397,23
2,1013,29425,3575881374,3575881398,24
2,1013,29426,3575881374,3575881399,25
2,1013,29427,3575881374,3575881400,26
2,1013,29428,3575881374,3575881401,27
2,1013,29429,3575881374,3575881403,29
2,1013,29430,3575881374,3575881403,29
2,1013,29431,3575881374,3575881403,29
2,1013,29432,3575881374,3575881404,30
2,1013,29433,3575881374,3575881406,32
2,1013,29434,3575881374,3575881407,33
2,1013,29435,3575881374,3575881408,34
2,1013,29436,3575881374,3575881410,36
2,1013,29437,3575881374,3575881411,37
2,1013,29438,3575881374,3575881412,38
2,1013,29439,3575881374,3575881412,38
2,1013,29440,3575881374,3575881415,41
2,1013,29441,3575881374,3575881421,47
2,1013,29442,3575881374,3575881422,48
2,1013,29443,3575881374,3575881424,50
2,1014,29444,3575881443,3575881443,0
2,1014,29445,3575881443,3575881443,0
2,1014,29446,3575881443,3575881444,1
2,1014,29447,3575881443,3575881444,1
2,1014,29448,3575881443,3575881444,1
2,1014,29449,3575881443,3575881444,1
2,1014,29450,3575881443,3575881444,1
2,1014,29451,3575881443,3575881444,1
2,1014,29452,3575881443,3575881444,1
2,1014,29453,3575881443,3575881444,1
2,1014,29454,3575881443,3575881444,1
2,1014,29455,3575881443,3575881444,1
2,1014,29456,3575881443,3575881444,1
2,1014,29457,3575881443,3575881444,1
2,1014,29458,3575881443,3575881444,1
2,1014,29459,3575881443,3575881444,1
2,1014,29460,3575881443,3575881444,1
2,1014,29461,3575881443,3575881444,1
2,1014,29462,3575881443,3575881444,1
2,1014,29463,3575881443,3575881444,1
2,1014,29464,3575881443,3575881445,2
2,1014,29465,3575881443,3575881446,3
2,1014,29466,3575881443,3575881448,5
2,1014,29467,3575881443,3575881449,6
2,1014,29468,3575881443,3575881450,7
2,1014,29469,3575881443,3575881454,11
2,1014,29470,3575881443,3575881455,12
2,1014,29471,3575881443,3575881456,13
2,1014,29472,3575881443,3575881456,13
2,1014,29473,3575881443,3575881457,14
2,1014,29474,3575881443,3575881458,15
2,1014,29475,3575881443,3575881459,16
2,1014,29476,3575881443,3575881461,18
2,1014,29477,3575881443,3575881462,19
2,1014,29478,3575881443,3575881462,19
2,1014,29479,3575881443,3575881463,20
2,1014,29480,3575881443,3575881463,20
2,1014,29481,3575881443,3575881466,23
2,1014,29482,3575881443,3575881467,24
2,1014,29483,3575881443,3575881472,29
2,1014,29484,3575881443,3575881475,32
2,1014,29485,3575881443,3575881476,33
2,1014,29486,3575881443,3575881478,35
2,1014,29487,3575881443,3575881480,37
2,1014,29488,3575881443,3575881481,38
2,1014,29489,3575881443,3575881482,39
2,1014,29490,3575881443,3575881483,40
2,1014,29491,3575881443,3575881483,40
2,1014,29492,3575881443,3575881484,41
2,1014,29493,3575881443,3575881484,41
2,1014,29494,3575881443,3575881486,43
2,1014,29495,3575881443,3575881487,44
2,1014,29496,3575881443,3575881487,44
2,1014,29497,3575881443,3575881488,45
2,1014,29498,3575881443,3575881488,45
2,1014,29499,3575881443,3575881489,46
2,1014,29500,3575881443,3575881490,47
2,1014,29501,3575881443,3575881490,47
2,1014,29502,3575881443,3575881490,47
2,1014,29503,3575881443,3575881491,48
2,1014,29504,3575881443,3575881491,48
2,1014,29505,3575881443,3575881491,48
2,1014,29506,3575881443,3575881491,48
2,1015,29507,3575881508,3575881508,0
2,1015,29508,3575881508,3575881508,0
2,1015,29509,3575881508,3575881508,0
2,1015,29510,3575881508,3575881508,0
2,1015,29511,3575881508,3575881508,0
2,1015,29512,3575881508,3575881508,0
2,1015,29513,3575881508,3575881509,1
2,1015,29514,3575881508,3575881509,1
2,1015,29515,3575881508,3575881509,1
2,1015,29516,3575881508,3575881509,1
2,1015,29517,3575881508,3575881509,1
2,1015,29518,3575881508,3575881509,1
2,1015,29519,3575881508,3575881509,1
2,1015,29520,3575881508,3575881509,1
2,1015,29521,3575881508,3575881509,1
2,1015,29522,3575881508,3575881509,1
2,1015,29523,3575881508,3575881509,1
2,1015,29524,3575881508,3575881509,1
2,1015,29525,3575881508,3575881509,1
2,1015,29526,3575881508,3575881509,1
2,1015,29527,3575881508,3575881509,1
2,1015,29528,3575881508,3575881509,1
2,1015,29529,3575881508,3575881509,1
2,1015,29530,3575881508,3575881509,1
2,1015,29531,3575881508,3575881509,1
2,1015,29532,3575881508,3575881510,2
2,1015,29533,3575881508,3575881511,3
2,1015,29534,3575881508,3575881512,4
2,1015,29535,3575881508,3575881512,4
2,1015,29536,3575881508,3575881512,4
2,1015,29537,3575881508,3575881513,5
2,1015,29538,3575881508,3575881513,5
2,1015,29539,3575881508,3575881513,5
2,1015,29540,3575881508,3575881514,6
2,1015,29541,3575881508,3575881515,7
2,1015,29542,3575881508,3575881516,8
2,1015,29543,3575881508,3575881516,8
2,1015,29544,3575881508,3575881516,8
2,1015,29545,3575881508,3575881516,8
2,1015,29546,3575881508,3575881517,9
2,1015,29547,3575881508,3575881519,11
2,1015,29548,3575881508,3575881521,13
2,1015,29549,3575881508,3575881521,13
2,1015,29550,3575881508,3575881521,13
2,1015,29551,3575881508,3575881523,15
2,1015,29552,3575881508,3575881524,16
2,1015,29553,3575881508,3575881525,17
2,1015,29554,3575881508,3575881526,18
2,1015,29555,3575881508,3575881526,18
2,1015,29556,3575881508,3575881527,19
2,1015,29557,3575881508,3575881528,20
2,1015,29558,3575881508,3575881529,21
2,1015,29559,3575881508,3575881529,21
2,1015,29560,3575881508,3575881530,22
2,1015,29561,3575881508,3575881531,23
2,1015,29562,3575881508,3575881531,23
2,1015,29563,3575881508,3575881531,23
2,1015,29564,3575881508,3575881531,23
2,1015,29565,3575881508,3575881531,23
2,1015,29566,3575881508,3575881532,24
2,1015,29567,3575881508,3575881533,25
2,1015,29568,3575881508,3575881533,25
2,1015,29569,3575881508,3575881533,25
2,1015,29570,3575881508,3575881534,26
2,1015,29571,3575881508,3575881535,27
2,1015,29572,3575881508,3575881535,27
2,1015,29573,3575881508,3575881535,27
2,1015,29574,3575881508,3575881537,29
2,1015,29575,3575881508,3575881537,29
2,1015,29576,3575881508,3575881539,31
2,1015,29577,3575881508,3575881539,31
2,1015,29578,3575881508,3575881539,31
2,1015,29579,3575881508,3575881540,32
2,1015,29580,3575881508,3575881541,33
2,1015,29581,3575881508,3575881542,34
2,1015,29582,3575881508,3575881543,35
2,1015,29583,3575881508,3575881544,36
2,1015,29584,3575881508,3575881544,36
2,1015,29585,3575881508,3575881544,36
2,1015,29586,3575881508,3575881544,36
2,1015,29587,3575881508,3575881545,37
2,1015,29588,3575881508,3575881547,39
2,1015,29589,3575881508,3575881547,39
2,1015,29590,3575881508,3575881548,40
2,1015,29591,3575881508,3575881548,40
2,1015,29592,3575881508,3575881548,40
2,1015,29593,3575881508,3575881548,40
2,1015,29594,3575881508,3575881548,40
2,1015,29595,3575881508,3575881549,41
2,1015,29596,3575881508,3575881550,42
2,1015,29597,3575881508,3575881551,43
2,1015,29598,3575881508,3575881551,43
2,1015,29599,3575881508,3575881553,45
2,1015,29600,3575881508,3575881555,47
2,1015,29601,3575881508,3575881555,47
2,1015,29602,3575881508,3575881556,48
2,1015,29603,3575881508,3575881558,50
2,1016,29604,3575881576,3575881576,0
2,1016,29605,3575881576,3575881576,0
2,1016,29606,3575881576,3575881576,0
2,1016,29607,3575881576,3575881576,0
2,1016,29608,3575881576,3575881576,0
2,1016,29609,3575881576,3575881576,0
2,1016,29610,3575881576,3575881576,0
2,1016,29611,3575881576,3575881576,0
2,1016,29612,3575881576,3575881576,0
2,1016,29613,3575881576,3575881576,0
2,1016,29614,3575881576,3575881576,0
2,1016,29615,3575881576,3575881576,0
2,1016,29616,3575881576,3575881576,0
2,1016,29617,3575881576,3575881576,0
2,1016,29618,3575881576,3575881576,0
2,1016,29619,3575881576,3575881576,0
2,1016,29620,3575881576,3575881576,0
2,1016,29621,3575881576,3575881576,0
2,1016,29622,3575881576,3575881576,0
2,1016,29623,3575881576,3575881576,0
2,1016,29624,3575881576,3575881576,0
2,1016,29625,3575881576,3575881576,0
2,1016,29626,3575881576,3575881576,0
2,1016,29627,3575881576,3575881576,0
2,1016,29628,3575881576,3575881577,1
2,1016,29629,3575881576,3575881579,3
2,1016,29630,3575881576,3575881579,3
2,1016,29631,3575881576,3575881580,4
2,1016,29632,3575881576,3575881581,5
2,1016,29633,3575881576,3575881582,6
2,1016,29634,3575881576,3575881582,6
2,1016,29635,3575881576,3575881583,7
2,1016,29636,3575881576,3575881584,8
2,1016,29637,3575881576,3575881584,8
2,1016,29638,3575881576,3575881585,9
2,1016,29639,3575881576,3575881585,9
2,1016,29640,3575881576,3575881585,9
2,1016,29641,3575881576,3575881585,9
2,1016,29642,3575881576,3575881586,10
2,1016,29643,3575881576,3575881587,11
2,1016,29644,3575881576,3575881587,11
2,1016,29645,3575881576,3575881588,12
2,1016,29646,3575881576,3575881588,12
2,1016,29647,3575881576,3575881588,12
2,1016,29648,3575881576,3575881590,14
2,1016,29649,3575881576,3575881591,15
2,1016,29650,3575881576,3575881591,15
2,1016,29651,3575881576,3575881591,15
2,1016,29652,3575881576,3575881591,15
2,1016,29653,3575881576,3575881593,17
2,1016,29654,3575881576,3575881593,17
2,1016,29655,3575881576,3575881595,19
2,1016,29656,3575881576,3575881595,19
2,1016,29657,3575881576,3575881597,21
2,1016,29658,3575881576,3575881598,22
2,1016,29659,3575881576,3575881600,24
2,1016,29660,3575881576,3575881602,26
2,1016,29661,3575881576,3575881603,27
2,1016,29662,3575881576,3575881603,27
2,1016,29663,3575881576,3575881604,28
2,1016,29664,3575881576,3575881605,29
2,1016,29665,3575881576,3575881606,30
2,1016,29666,3575881576,3575881607,31
2,1016,29667,3575881576,3575881609,33
2,1016,29668,3575881576,3575881610,34
2,1016,29669,3575881576,3575881611,35
2,1016,29670,3575881576,3575881612,36
2,1016,29671,3575881576,3575881614,38
2,1016,29672,3575881576,3575881621,45
2,1016,29673,3575881576,3575881621,45
2,1016,29674,3575881576,3575881621,45
2,1016,29675,3575881576,3575881622,46
2,1016,29676,3575881576,3575881625,49
2,1016,29677,3575881576,3575881625,49
2,1016,29678,3575881576,3575881626,50
2,1017,29679,3575881637,3575881637,0
2,1017,29680,3575881637,3575881637,0
2,1017,29681,3575881637,3575881637,0
2,1017,29682,3575881637,3575881637,0
2,1017,29683,3575881637,3575881637,0
2,1017,29684,3575881637,3575881637,0
2,1017,29685,3575881637,3575881637,0
2,1017,29686,3575881637,3575881637,0
2,1017,29687,3575881637,3575881637,0
2,1017,29688,3575881637,3575881637,0
2,1017,29689,3575881637,3575881639,2
2,1017,29690,3575881637,3575881639,2
2,1017,29691,3575881637,3575881639,2
2,1017,29692,3575881637,3575881640,3
2,1017,29693,3575881637,3575881640,3
2,1017,29694,3575881637,3575881641,4
2,1017,29695,3575881637,3575881641,4
2,1017,29696,3575881637,3575881642,5
2,1017,29697,3575881637,3575881644,7
2,1017,29698,3575881637,3575881646,9
2,1017,29699,3575881637,3575881649,12
2,1017,29700,3575881637,3575881649,12
2,1017,29701,3575881637,3575881654,17
2,1017,29702,3575881637,3575881654,17
2,1017,29703,3575881637,3575881655,18
2,1017,29704,3575881637,3575881655,18
2,1017,29705,3575881637,3575881655,18
2,1017,29706,3575881637,3575881656,19
2,1017,29707,3575881637,3575881658,21
2,1017,29708,3575881637,3575881661,24
2,1017,29709,3575881637,3575881661,24
2,1017,29710,3575881637,3575881662,25
2,1017,29711,3575881637,3575881662,25
2,1017,29712,3575881637,3575881663,26
2,1017,29713,3575881637,3575881665,28
2,1017,29714,3575881637,3575881666,29
2,1017,29715,3575881637,3575881672,35
2,1017,29716,3575881637,3575881675,38
2,1017,29717,3575881637,3575881676,39
2,1017,29718,3575881637,3575881677,40
2,1017,29719,3575881637,3575881680,43
2,1017,29720,3575881637,3575881681,44
2,1017,29721,3575881637,3575881683,46
2,1017,29722,3575881637,3575881683,46
2,1017,29723,3575881637,3575881684,47
2,1017,29724,3575881637,3575881684,47
2,1017,29725,3575881637,3575881684,47
2,1017,29726,3575881637,3575881685,48
2,1017,29727,3575881637,3575881686,49
2,1017,29728,3575881637,3575881687,50
2,1018,29729,3575881702,3575881702,0
2,1018,29730,3575881702,3575881702,0
2,1018,29731,3575881702,3575881702,0
2,1018,29732,3575881702,3575881702,0
2,1018,29733,3575881702,3575881702,0
2,1018,29734,3575881702,3575881702,0
2,1018,29735,3575881702,3575881702,0
2,1018,29736,3575881702,3575881702,0
2,1018,29737,3575881702,3575881702,0
2,1018,29738,3575881702,3575881702,0
2,1018,29739,3575881702,3575881702,0
2,1018,29740,3575881702,3575881702,0
2,1018,29741,3575881702,3575881702,0
2,1018,29742,3575881702,3575881702,0
2,1018,29743,3575881702,3575881702,0
2,1018,29744,3575881702,3575881702,0
2,1018,29745,3575881702,3575881702,0
2,1018,29746,3575881702,3575881702,0
2,1018,29747,3575881702,3575881702,0
2,1018,29748,3575881702,3575881703,1
2,1018,29749,3575881702,3575881703,1
2,1018,29750,3575881702,3575881705,3
2,1018,29751,3575881702,3575881705,3
2,1018,29752,3575881702,3575881706,4
2,1018,29753,3575881702,3575881706,4
2,1018,29754,3575881702,3575881706,4
2,1018,29755,3575881702,3575881706,4
2,1018,29756,3575881702,3575881707,5
2,1018,29757,3575881702,3575881707,5
2,1018,29758,3575881702,3575881707,5
2,1018,29759,3575881702,3575881707,5
2,1018,29760,3575881702,3575881708,6
2,1018,29761,3575881702,3575881708,6
2,1018,29762,3575881702,3575881708,6
2,1018,29763,3575881702,3575881710,8
2,1018,29764,3575881702,3575881711,9
2,1018,29765,3575881702,3575881712,10
2,1018,29766,3575881702,3575881712,10
2,1018,29767,3575881702,3575881712,10
2,1018,29768,3575881702,3575881713,11
2,1018,29769,3575881702,3575881713,11
2,1018,29770,3575881702,3575881713,11
2,1018,29771,3575881702,3575881715,13
2,1018,29772,3575881702,3575881715,13
2,1018,29773,3575881702,3575881715,13
2,1018,29774,3575881702,3575881715,13
2,1018,29775,3575881702,3575881715,13
2,1018,29776,3575881702,3575881716,14
2,1018,29777,3575881702,3575881717,15
2,1018,29778,3575881702,3575881718,16
2,1018,29779,3575881702,3575881719,17
2,1018,29780,3575881702,3575881720,18
2,1018,29781,3575881702,3575881721,19
2,1018,29782,3575881702,3575881721,19
2,1018,29783,3575881702,3575881724,22
2,1018,29784,3575881702,3575881724,22
2,1018,29785,3575881702,3575881724,22
2,1018,29786,3575881702,3575881726,24
2,1018,29787,3575881702,3575881726,24
2,1018,29788,3575881702,3575881726,24
2,1018,29789,3575881702,3575881727,25
2,1018,29790,3575881702,3575881728,26
2,1018,29791,3575881702,3575881728,26
2,1018,29792,3575881702,3575881730,28
2,1018,29793,3575881702,3575881731,29
2,1018,29794,3575881702,3575881731,29
2,1018,29795,3575881702,3575881731,29
2,1018,29796,3575881702,3575881732,30
2,1018,29797,3575881702,3575881732,30
2,1018,29798,3575881702,3575881732,30
2,1018,29799,3575881702,3575881733,31
2,1018,29800,3575881702,3575881733,31
2,1018,29801,3575881702,3575881734,32
2,1018,29802,3575881702,3575881734,32
2,1018,29803,3575881702,3575881735,33
2,1018,29804,3575881702,3575881735,33
2,1018,29805,3575881702,3575881735,33
2,1018,29806,3575881702,3575881737,35
2,1018,29807,3575881702,3575881739,37
2,1018,29808,3575881702,3575881739,37
2,1018,29809,3575881702,3575881739,37
2,1018,29810,3575881702,3575881740,38
2,1018,29811,3575881702,3575881740,38
2,1018,29812,3575881702,3575881741,39
2,1018,29813,3575881702,3575881742,40
2,1018,29814,3575881702,3575881743,41
2,1018,29815,3575881702,3575881744,42
2,1018,29816,3575881702,3575881744,42
2,1018,29817,3575881702,3575881744,42
2,1018,29818,3575881702,3575881745,43
2,1018,29819,3575881702,3575881745,43
2,1018,29820,3575881702,3575881747,45
2,1018,29821,3575881702,3575881748,46
2,1018,29822,3575881702,3575881748,46
2,1018,29823,3575881702,3575881748,46
2,1018,29824,3575881702,3575881748,46
2,1018,29825,3575881702,3575881749,47
2,1018,29826,3575881702,3575881750,48
2,1018,29827,3575881702,3575881750,48
2,1018,29828,3575881702,3575881750,48
2,1018,29829,3575881702,3575881751,49
2,1019,29830,3575881768,3575881768,0
2,1019,29831,3575881768,3575881768,0
2,1019,29832,3575881768,3575881768,0
2,1019,29833,3575881768,3575881768,0
2,1019,29834,3575881768,3575881768,0
2,1019,29835,3575881768,3575881768,0
2,1019,29836,3575881768,3575881768,0
2,1019,29837,3575881768,3575881768,0
2,1019,29838,3575881768,3575881768,0
2,1019,29839,3575881768,3575881768,0
2,1019,29840,3575881768,3575881768,0
2,1019,29841,3575881768,3575881768,0
2,1019,29842,3575881768,3575881768,0
2,1019,29843,3575881768,3575881768,0
2,1019,29844,3575881768,3575881768,0
2,1019,29845,3575881768,3575881768,0
2,1019,29846,3575881768,3575881768,0
2,1019,29847,3575881768,3575881768,0
2,1019,29848,3575881768,3575881768,0
2,1019,29849,3575881768,3575881769,1
2,1019,29850,3575881768,3575881770,2
2,1019,29851,3575881768,3575881772,4
2,1019,29852,3575881768,3575881773,5
2,1019,29853,3575881768,3575881774,6
2,1019,29854,3575881768,3575881775,7
2,1019,29855,3575881768,3575881775,7
2,1019,29856,3575881768,3575881778,10
2,1019,29857,3575881768,3575881778,10
2,1019,29858,3575881768,3575881778,10
2,1019,29859,3575881768,3575881778,10
2,1019,29860,3575881768,3575881780,12
2,1019,29861,3575881768,3575881780,12
2,1019,29862,3575881768,3575881781,13
2,1019,29863,3575881768,3575881783,15
2,1019,29864,3575881768,3575881783,15
2,1019,29865,3575881768,3575881783,15
2,1019,29866,3575881768,3575881784,16
2,1019,29867,3575881768,3575881784,16
2,1019,29868,3575881768,3575881784,16
2,1019,29869,3575881768,3575881785,17
2,1019,29870,3575881768,3575881785,17
2,1019,29871,3575881768,3575881786,18
2,1019,29872,3575881768,3575881787,19
2,1019,29873,3575881768,3575881787,19
2,1019,29874,3575881768,3575881788,20
2,1019,29875,3575881768,3575881788,20
2,1019,29876,3575881768,3575881788,20
2,1019,29877,3575881768,3575881790,22
2,1019,29878,3575881768,3575881791,23
2,1019,29879,3575881768,3575881791,23
2,1019,29880,3575881768,3575881791,23
2,1019,29881,3575881768,3575881792,24
2,1019,29882,3575881768,3575881793,25
2,1019,29883,3575881768,3575881794,26
2,1019,29884,3575881768,3575881795,27
2,1019,29885,3575881768,3575881797,29
2,1019,29886,3575881768,3575881798,30
2,1019,29887,3575881768,3575881800,32
2,1019,29888,3575881768,3575881802,34
2,1019,29889,3575881768,3575881802,34
2,1019,29890,3575881768,3575881802,34
2,1019,29891,3575881768,3575881803,35
2,1019,29892,3575881768,3575881804,36
2,1019,29893,3575881768,3575881804,36
2,1019,29894,3575881768,3575881806,38
2,1019,29895,3575881768,3575881807,39
2,1019,29896,3575881768,3575881809,41
2,1019,29897,3575881768,3575881811,43
2,1019,29898,3575881768,3575881811,43
2,1019,29899,3575881768,3575881812,44
2,1019,29900,3575881768,3575881812,44
2,1019,29901,3575881768,3575881814,46
2,1020,29902,3575881832,3575881832,0
2,1020,29903,3575881832,3575881832,0
2,1020,29904,3575881832,3575881832,0
2,1020,29905,3575881832,3575881832,0
2,1020,29906,3575881832,3575881832,0
2,1020,29907,3575881832,3575881832,0
2,1020,29908,3575881832,3575881832,0
2,1020,29909,3575881832,3575881832,0
2,1020,29910,3575881832,3575881832,0
2,1020,29911,3575881832,3575881832,0
2,1020,29912,3575881832,3575881832,0
2,1020,29913,3575881832,3575881832,0
2,1020,29914,3575881832,3575881832,0
2,1020,29915,3575881832,3575881832,0
2,1020,29916,3575881832,3575881837,5
2,1020,29917,3575881832,3575881837,5
2,1020,29918,3575881832,3575881837,5
2,1020,29919,3575881832,3575881839,7
2,1020,29920,3575881832,3575881839,7
2,1020,29921,3575881832,3575881839,7
2,1020,29922,3575881832,3575881840,8
2,1020,29923,3575881832,3575881840,8
2,1020,29924,3575881832,3575881841,9
2,1020,29925,3575881832,3575881842,10
2,1020,29926,3575881832,3575881842,10
2,1020,29927,3575881832,3575881844,12
2,1020,29928,3575881832,3575881845,13
2,1020,29929,3575881832,3575881847,15
2,1020,29930,3575881832,3575881849,17
2,1020,29931,3575881832,3575881849,17
2,1020,29932,3575881832,3575881854,22
2,1020,29933,3575881832,3575881854,22
2,1020,29934,3575881832,3575881854,22
2,1020,29935,3575881832,3575881854,22
2,1020,29936,3575881832,3575881856,24
2,1020,29937,3575881832,3575881857,25
2,1020,29938,3575881832,3575881858,26
2,1020,29939,3575881832,3575881861,29
2,1020,29940,3575881832,3575881861,29
2,1020,29941,3575881832,3575881862,30
2,1020,29942,3575881832,3575881862,30
2,1020,29943,3575881832,3575881862,30
2,1020,29944,3575881832,3575881863,31
2,1020,29945,3575881832,3575881864,32
2,1020,29946,3575881832,3575881865,33
2,1020,29947,3575881832,3575881866,34
2,1020,29948,3575881832,3575881871,39
2,1020,29949,3575881832,3575881875,43
2,1020,29950,3575881832,3575881876,44
2,1020,29951,3575881832,3575881878,46
2,1020,29952,3575881832,3575881880,48
2,1020,29953,3575881832,3575881882,50
2,1021,29954,3575881897,3575881897,0
2,1021,29955,3575881897,3575881897,0
2,1021,29956,3575881897,3575881897,0
2,1021,29957,3575881897,3575881897,0
2,1021,29958,3575881897,3575881897,0
2,1021,29959,3575881897,3575881897,0
2,1021,29960,3575881897,3575881897,0
2,1021,29961,3575881897,3575881897,0
2,1021,29962,3575881897,3575881897,0
2,1021,29963,3575881897,3575881897,0
2,1021,29964,3575881897,3575881897,0
2,1021,29965,3575881897,3575881897,0
2,1021,29966,3575881897,3575881897,0
2,1021,29967,3575881897,3575881897,0
2,1021,29968,3575881897,3575881897,0
2,1021,29969,3575881897,3575881897,0
2,1021,29970,3575881897,3575881897,0
2,1021,29971,3575881897,3575881897,0
2,1021,29972,3575881897,3575881897,0
2,1021,29973,3575881897,3575881897,0
2,1021,29974,3575881897,3575881897,0
2,1021,29975,3575881897,3575881897,0
2,1021,29976,3575881897,3575881898,1
2,1021,29977,3575881897,3575881898,1
2,1021,29978,3575881897,3575881898,1
2,1021,29979,3575881897,3575881900,3
2,1021,29980,3575881897,3575881901,4
2,1021,29981,3575881897,3575881902,5
2,1021,29982,3575881897,3575881903,6
2,1021,29983,3575881897,3575881903,6
2,1021,29984,3575881897,3575881903,6
2,1021,29985,3575881897,3575881905,8
2,1021,29986,3575881897,3575881905,8
2,1021,29987,3575881897,3575881906,9
2,1021,29988,3575881897,3575881906,9
2,1021,29989,3575881897,3575881906,9
2,1021,29990,3575881897,3575881906,9
2,1021,29991,3575881897,3575881906,9
2,1021,29992,3575881897,3575881907,10
2,1021,29993,3575881897,3575881907,10
2,1021,29994,3575881897,3575881907,10
2,1021,29995,3575881897,3575881907,10
2,1021,29996,3575881897,3575881908,11
2,1021,29997,3575881897,3575881909,12
2,1021,29998,3575881897,3575881910,13
2,1021,29999,3575881897,3575881910,13
2,1021,30000,3575881897,3575881912,15
2,1021,30001,3575881897,3575881912,15
2,1021,30002,3575881897,3575881913,16
2,1021,30003,3575881897,3575881913,16
2,1021,30004,3575881897,3575881913,16
2,1021,30005,3575881897,3575881913,16
2,1021,30006,3575881897,3575881915,18
2,1021,30007,3575881897,3575881915,18
2,1021,30008,3575881897,3575881915,18
2,1021,30009,3575881897,3575881915,18
2,1021,30010,3575881897,3575881916,19
2,1021,30011,3575881897,3575881916,19
2,1021,30012,3575881897,3575881917,20
2,1021,30013,3575881897,3575881919,22
2,1021,30014,3575881897,3575881919,22
2,1021,30015,3575881897,3575881920,23
2,1021,30016,3575881897,3575881921,24
2,1021,30017,3575881897,3575881921,24
2,1021,30018,3575881897,3575881924,27
2,1021,30019,3575881897,3575881924,27
2,1021,30020,3575881897,3575881925,28
2,1021,30021,3575881897,3575881926,29
2,1021,30022,3575881897,3575881926,29
2,1021,30023,3575881897,3575881926,29
2,1021,30024,3575881897,3575881929,32
2,1021,30025,3575881897,3575881930,33
2,1021,30026,3575881897,3575881931,34
2,1021,30027,3575881897,3575881931,34
2,1021,30028,3575881897,3575881931,34
2,1021,30029,3575881897,3575881931,34
2,1021,30030,3575881897,3575881932,35
2,1021,30031,3575881897,3575881932,35
2,1021,30032,3575881897,3575881933,36
2,1021,30033,3575881897,3575881934,37
2,1021,30034,3575881897,3575881934,37
2,1021,30035,3575881897,3575881934,37
2,1021,30036,3575881897,3575881935,38
2,1021,30037,3575881897,3575881935,38
2,1021,30038,3575881897,3575881938,41
2,1021,30039,3575881897,3575881938,41
2,1021,30040,3575881897,3575881938,41
2,1021,30041,3575881897,3575881938,41
2,1021,30042,3575881897,3575881940,43
2,1021,30043,3575881897,3575881940,43
2,1021,30044,3575881897,3575881940,43
2,1021,30045,3575881897,3575881941,44
2,1021,30046,3575881897,3575881942,45
2,1021,30047,3575881897,3575881943,46
2,1021,30048,3575881897,3575881944,47
2,1021,30049,3575881897,3575881945,48
2,1021,30050,3575881897,3575881945,48
2,1021,30051,3575881897,3575881945,48
2,1021,30052,3575881897,3575881947,50
2,1022,30053,3575881960,3575881960,0
2,1022,30054,3575881960,3575881960,0
2,1022,30055,3575881960,3575881960,0
2,1022,30056,3575881960,3575881960,0
2,1022,30057,3575881960,3575881960,0
2,1022,30058,3575881960,3575881960,0
2,1022,30059,3575881960,3575881960,0
2,1022,30060,3575881960,3575881960,0
2,1022,30061,3575881960,3575881960,0
2,1022,30062,3575881960,3575881960,0
2,1022,30063,3575881960,3575881960,0
2,1022,30064,3575881960,3575881961,1
2,1022,30065,3575881960,3575881961,1
2,1022,30066,3575881960,3575881961,1
2,1022,30067,3575881960,3575881961,1
2,1022,30068,3575881960,3575881961,1
2,1022,30069,3575881960,3575881961,1
2,1022,30070,3575881960,3575881961,1
2,1022,30071,3575881960,3575881961,1
2,1022,30072,3575881960,3575881961,1
2,1022,30073,3575881960,3575881962,2
2,1022,30074,3575881960,3575881965,5
2,1022,30075,3575881960,3575881965,5
2,1022,30076,3575881960,3575881966,6
2,1022,30077,3575881960,3575881968,8
2,1022,30078,3575881960,3575881968,8
2,1022,30079,3575881960,3575881968,8
2,1022,30080,3575881960,3575881968,8
2,1022,30081,3575881960,3575881969,9
2,1022,30082,3575881960,3575881970,10
2,1022,30083,3575881960,3575881970,10
2,1022,30084,3575881960,3575881972,12
2,1022,30085,3575881960,3575881975,15
2,1022,30086,3575881960,3575881975,15
2,1022,30087,3575881960,3575881975,15
2,1022,30088,3575881960,3575881975,15
2,1022,30089,3575881960,3575881978,18
2,1022,30090,3575881960,3575881978,18
2,1022,30091,3575881960,3575881979,19
2,1022,30092,3575881960,3575881981,21
2,1022,30093,3575881960,3575881981,21
2,1022,30094,3575881960,3575881981,21
2,1022,30095,3575881960,3575881982,22
2,1022,30096,3575881960,3575881983,23
2,1022,30097,3575881960,3575881983,23
2,1022,30098,3575881960,3575881985,25
2,1022,30099,3575881960,3575881985,25
2,1022,30100,3575881960,3575881985,25
2,1022,30101,3575881960,3575881985,25
2,1022,30102,3575881960,3575881986,26
2,1022,30103,3575881960,3575881986,26
2,1022,30104,3575881960,3575881987,27
2,1022,30105,3575881960,3575881987,27
2,1022,30106,3575881960,3575881987,27
2,1022,30107,3575881960,3575881988,28
2,1022,30108,3575881960,3575881989,29
2,1022,30109,3575881960,3575881990,30
2,1022,30110,3575881960,3575881991,31
2,1022,30111,3575881960,3575881992,32
2,1022,30112,3575881960,3575881992,32
2,1022,30113,3575881960,3575881992,32
2,1022,30114,3575881960,3575881993,33
2,1022,30115,3575881960,3575881994,34
2,1022,30116,3575881960,3575881996,36
2,1022,30117,3575881960,3575881998,38
2,1022,30118,3575881960,3575881998,38
2,1022,30119,3575881960,3575882000,40
2,1022,30120,3575881960,3575882003,43
2,1022,30121,3575881960,3575882003,43
2,1022,30122,3575881960,3575882004,44
2,1022,30123,3575881960,3575882004,44
2,1022,30124,3575881960,3575882007,47
2,1022,30125,3575881960,3575882007,47
2,1022,30126,3575881960,3575882008,48
2,1023,30127,3575882029,3575882029,0
2,1023,30128,3575882029,3575882029,0
2,1023,30129,3575882029,3575882029,0
2,1023,30130,3575882029,3575882029,0
2,1023,30131,3575882029,3575882029,0
2,1023,30132,3575882029,3575882029,0
2,1023,30133,3575882029,3575882029,0
2,1023,30134,3575882029,3575882029,0
2,1023,30135,3575882029,3575882029,0
2,1023,30136,3575882029,3575882029,0
2,1023,30137,3575882029,3575882029,0
2,1023,30138,3575882029,3575882029,0
2,1023,30139,3575882029,3575882029,0
2,1023,30140,3575882029,3575882029,0
2,1023,30141,3575882029,3575882029,0
2,1023,30142,3575882029,3575882029,0
2,1023,30143,3575882029,3575882032,3
2,1023,30144,3575882029,3575882032,3
2,1023,30145,3575882029,3575882036,7
2,1023,30146,3575882029,3575882037,8
2,1023,30147,3575882029,3575882037,8
2,1023,30148,3575882029,3575882038,9
2,1023,30149,3575882029,3575882039,10
2,1023,30150,3575882029,3575882040,11
2,1023,30151,3575882029,3575882040,11
2,1023,30152,3575882029,3575882041,12
2,1023,30153,3575882029,3575882041,12
2,1023,30154,3575882029,3575882043,14
2,1023,30155,3575882029,3575882045,16
2,1023,30156,3575882029,3575882047,18
2,1023,30157,3575882029,3575882049,20
2,1023,30158,3575882029,3575882049,20
2,1023,30159,3575882029,3575882054,25
2,1023,30160,3575882029,3575882054,25
2,1023,30161,3575882029,3575882054,25
2,1023,30162,3575882029,3575882054,25
2,1023,30163,3575882029,3575882056,27
2,1023,30164,3575882029,3575882056,27
2,1023,30165,3575882029,3575882056,27
2,1023,30166,3575882029,3575882057,28
2,1023,30167,3575882029,3575882058,29
2,1023,30168,3575882029,3575882061,32
2,1023,30169,3575882029,3575882061,32
2,1023,30170,3575882029,3575882062,33
2,1023,30171,3575882029,3575882062,33
2,1023,30172,3575882029,3575882063,34
2,1023,30173,3575882029,3575882063,34
2,1023,30174,3575882029,3575882065,36
2,1023,30175,3575882029,3575882065,36
2,1023,30176,3575882029,3575882066,37
2,1023,30177,3575882029,3575882067,38
2,1023,30178,3575882029,3575882071,42
2,1023,30179,3575882029,3575882075,46
2,1023,30180,3575882029,3575882077,48
2,1023,30181,3575882029,3575882077,48
2,1024,30182,3575882092,3575882092,0
2,1024,30183,3575882092,3575882092,0
2,1024,30184,3575882092,3575882092,0
2,1024,30185,3575882092,3575882092,0
2,1024,30186,3575882092,3575882092,0
2,1024,30187,3575882092,3575882092,0
2,1024,30188,3575882092,3575882092,0
2,1024,30189,3575882092,3575882092,0
2,1024,30190,3575882092,3575882092,0
2,1024,30191,3575882092,3575882092,0
2,1024,30192,3575882092,3575882092,0
2,1024,30193,3575882092,3575882092,0
2,1024,30194,3575882092,3575882092,0
2,1024,30195,3575882092,3575882092,0
2,1024,30196,3575882092,3575882092,0
2,1024,30197,3575882092,3575882092,0
2,1024,30198,3575882092,3575882092,0
2,1024,30199,3575882092,3575882092,0
2,1024,30200,3575882092,3575882092,0
2,1024,30201,3575882092,3575882092,0
2,1024,30202,3575882092,3575882093,1
2,1024,30203,3575882092,3575882093,1
2,1024,30204,3575882092,3575882093,1
2,1024,30205,3575882092,3575882093,1
2,1024,30206,3575882092,3575882093,1
2,1024,30207,3575882092,3575882093,1
2,1024,30208,3575882092,3575882093,1
2,1024,30209,3575882092,3575882094,2
2,1024,30210,3575882092,3575882096,4
2,1024,30211,3575882092,3575882098,6
2,1024,30212,3575882092,3575882099,7
2,1024,30213,3575882092,3575882100,8
2,1024,30214,3575882092,3575882101,9
2,1024,30215,3575882092,3575882102,10
2,1024,30216,3575882092,3575882103,11
2,1024,30217,3575882092,3575882103,11
2,1024,30218,3575882092,3575882104,12
2,1024,30219,3575882092,3575882105,13
2,1024,30220,3575882092,3575882106,14
2,1024,30221,3575882092,3575882106,14
2,1024,30222,3575882092,3575882107,15
2,1024,30223,3575882092,3575882107,15
2,1024,30224,3575882092,3575882107,15
2,1024,30225,3575882092,3575882107,15
2,1024,30226,3575882092,3575882107,15
2,1024,30227,3575882092,3575882107,15
2,1024,30228,3575882092,3575882108,16
2,1024,30229,3575882092,3575882109,17
2,1024,30230,3575882092,3575882110,18
2,1024,30231,3575882092,3575882111,19
2,1024,30232,3575882092,3575882111,19
2,1024,30233,3575882092,3575882112,20
2,1024,30234,3575882092,3575882112,20
2,1024,30235,3575882092,3575882112,20
2,1024,30236,3575882092,3575882112,20
2,1024,30237,3575882092,3575882113,21
2,1024,30238,3575882092,3575882113,21
2,1024,30239,3575882092,3575882115,23
2,1024,30240,3575882092,3575882115,23
2,1024,30241,3575882092,3575882116,24
2,1024,30242,3575882092,3575882116,24
2,1024,30243,3575882092,3575882116,24
2,1024,30244,3575882092,3575882116,24
2,1024,30245,3575882092,3575882116,24
2,1024,30246,3575882092,3575882118,26
2,1024,30247,3575882092,3575882119,27
2,1024,30248,3575882092,3575882120,28
2,1024,30249,3575882092,3575882120,28
2,1024,30250,3575882092,3575882122,30
2,1024,30251,3575882092,3575882124,32
2,1024,30252,3575882092,3575882124,32
2,1024,30253,3575882092,3575882125,33
2,1024,30254,3575882092,3575882126,34
2,1024,30255,3575882092,3575882127,35
2,1024,30256,3575882092,3575882127,35
2,1024,30257,3575882092,3575882128,36
2,1024,30258,3575882092,3575882129,37
2,1024,30259,3575882092,3575882131,39
2,1024,30260,3575882092,3575882131,39
2,1024,30261,3575882092,3575882131,39
2,1024,30262,3575882092,3575882131,39
2,1024,30263,3575882092,3575882132,40
2,1024,30264,3575882092,3575882132,40
2,1024,30265,3575882092,3575882133,41
2,1024,30266,3575882092,3575882134,42
2,1024,30267,3575882092,3575882134,42
2,1024,30268,3575882092,3575882134,42
2,1024,30269,3575882092,3575882135,43
2,1024,30270,3575882092,3575882135,43
2,1024,30271,3575882092,3575882137,45
2,1024,30272,3575882092,3575882138,46
2,1024,30273,3575882092,3575882138,46
2,1024,30274,3575882092,3575882139,47
2,1024,30275,3575882092,3575882140,48
2,1024,30276,3575882092,3575882140,48
2,1024,30277,3575882092,3575882140,48
2,1024,30278,3575882092,3575882141,49
2,1025,30279,3575882156,3575882156,0
2,1025,30280,3575882156,3575882156,0
2,1025,30281,3575882156,3575882156,0
2,1025,30282,3575882156,3575882156,0
2,1025,30283,3575882156,3575882156,0
2,1025,30284,3575882156,3575882156,0
2,1025,30285,3575882156,3575882156,0
2,1025,30286,3575882156,3575882156,0
2,1025,30287,3575882156,3575882156,0
2,1025,30288,3575882156,3575882156,0
2,1025,30289,3575882156,3575882156,0
2,1025,30290,3575882156,3575882156,0
2,1025,30291,3575882156,3575882156,0
2,1025,30292,3575882156,3575882156,0
2,1025,30293,3575882156,3575882156,0
2,1025,30294,3575882156,3575882156,0
2,1025,30295,3575882156,3575882156,0
2,1025,30296,3575882156,3575882156,0
2,1025,30297,3575882156,3575882157,1
2,1025,30298,3575882156,3575882157,1
2,1025,30299,3575882156,3575882157,1
2,1025,30300,3575882156,3575882157,1
2,1025,30301,3575882156,3575882158,2
2,1025,30302,3575882156,3575882159,3
2,1025,30303,3575882156,3575882160,4
2,1025,30304,3575882156,3575882160,4
2,1025,30305,3575882156,3575882160,4
2,1025,30306,3575882156,3575882161,5
2,1025,30307,3575882156,3575882162,6
2,1025,30308,3575882156,3575882164,8
2,1025,30309,3575882156,3575882166,10
2,1025,30310,3575882156,3575882166,10
2,1025,30311,3575882156,3575882166,10
2,1025,30312,3575882156,3575882167,11
2,1025,30313,3575882156,3575882167,11
2,1025,30314,3575882156,3575882168,12
2,1025,30315,3575882156,3575882169,13
2,1025,30316,3575882156,3575882169,13
2,1025,30317,3575882156,3575882170,14
2,1025,30318,3575882156,3575882170,14
2,1025,30319,3575882156,3575882171,15
2,1025,30320,3575882156,3575882171,15
2,1025,30321,3575882156,3575882173,17
2,1025,30322,3575882156,3575882175,19
2,1025,30323,3575882156,3575882175,19
2,1025,30324,3575882156,3575882175,19
2,1025,30325,3575882156,3575882176,20
2,1025,30326,3575882156,3575882178,22
2,1025,30327,3575882156,3575882178,22
2,1025,30328,3575882156,3575882178,22
2,1025,30329,3575882156,3575882181,25
2,1025,30330,3575882156,3575882183,27
2,1025,30331,3575882156,3575882184,28
2,1025,30332,3575882156,3575882184,28
2,1025,30333,3575882156,3575882184,28
2,1025,30334,3575882156,3575882185,29
2,1025,30335,3575882156,3575882185,29
2,1025,30336,3575882156,3575882185,29
2,1025,30337,3575882156,3575882186,30
2,1025,30338,3575882156,3575882187,31
2,1025,30339,3575882156,3575882188,32
2,1025,30340,3575882156,3575882188,32
2,1025,30341,3575882156,3575882188,32
2,1025,30342,3575882156,3575882189,33
2,1025,30343,3575882156,3575882191,35
2,1025,30344,3575882156,3575882191,35
2,1025,30345,3575882156,3575882192,36
2,1025,30346,3575882156,3575882193,37
2,1025,30347,3575882156,3575882194,38
2,1025,30348,3575882156,3575882195,39
2,1025,30349,3575882156,3575882197,41
2,1025,30350,3575882156,3575882198,42
2,1025,30351,3575882156,3575882199,43
2,1025,30352,3575882156,3575882201,45
2,1025,30353,3575882156,3575882201,45
2,1025,30354,3575882156,3575882202,46
2,1025,30355,3575882156,3575882203,47
2,1025,30356,3575882156,3575882204,48
2,1025,30357,3575882156,3575882204,48
2,1026,30358,3575882219,3575882219,0
2,1026,30359,3575882219,3575882219,0
2,1026,30360,3575882219,3575882219,0
2,1026,30361,3575882219,3575882219,0
2,1026,30362,3575882219,3575882219,0
2,1026,30363,3575882219,3575882219,0
2,1026,30364,3575882219,3575882219,0
2,1026,30365,3575882219,3575882221,2
2,1026,30366,3575882219,3575882222,3
2,1026,30367,3575882219,3575882222,3
2,1026,30368,3575882219,3575882222,3
2,1026,30369,3575882219,3575882224,5
2,1026,30370,3575882219,3575882225,6
2,1026,30371,3575882219,3575882225,6
2,1026,30372,3575882219,3575882226,7
2,1026,30373,3575882219,3575882226,7
2,1026,30374,3575882219,3575882229,10
2,1026,30375,3575882219,3575882230,11
2,1026,30376,3575882219,3575882230,11
2,1026,30377,3575882219,3575882232,13
2,1026,30378,3575882219,3575882237,18
2,1026,30379,3575882219,3575882237,18
2,1026,30380,3575882219,3575882238,19
2,1026,30381,3575882219,3575882239,20
2,1026,30382,3575882219,3575882240,21
2,1026,30383,3575882219,3575882241,22
2,1026,30384,3575882219,3575882241,22
2,1026,30385,3575882219,3575882244,25
2,1026,30386,3575882219,3575882245,26
2,1026,30387,3575882219,3575882247,28
2,1026,30388,3575882219,3575882249,30
2,1026,30389,3575882219,3575882249,30
2,1026,30390,3575882219,3575882254,35
2,1026,30391,3575882219,3575882254,35
2,1026,30392,3575882219,3575882255,36
2,1026,30393,3575882219,3575882255,36
2,1026,30394,3575882219,3575882255,36
2,1026,30395,3575882219,3575882255,36
2,1026,30396,3575882219,3575882256,37
2,1026,30397,3575882219,3575882257,38
2,1026,30398,3575882219,3575882259,40
2,1026,30399,3575882219,3575882260,41
2,1026,30400,3575882219,3575882261,42
2,1026,30401,3575882219,3575882261,42
2,1026,30402,3575882219,3575882262,43
2,1026,30403,3575882219,3575882263,44
2,1026,30404,3575882219,3575882263,44
2,1026,30405,3575882219,3575882264,45
2,1026,30406,3575882219,3575882265,46
2,1026,30407,3575882219,3575882267,48
2,1026,30408,3575882219,3575882268,49
2,1027,30409,3575882288,3575882288,0
2,1027,30410,3575882288,3575882288,0
2,1027,30411,3575882288,3575882288,0
2,1027,30412,3575882288,3575882288,0
2,1027,30413,3575882288,3575882289,1
2,1027,30414,3575882288,3575882289,1
2,1027,30415,3575882288,3575882289,1
2,1027,30416,3575882288,3575882289,1
2,1027,30417,3575882288,3575882289,1
2,1027,30418,3575882288,3575882289,1
2,1027,30419,3575882288,3575882289,1
2,1027,30420,3575882288,3575882289,1
2,1027,30421,3575882288,3575882289,1
2,1027,30422,3575882288,3575882289,1
2,1027,30423,3575882288,3575882289,1
2,1027,30424,3575882288,3575882289,1
2,1027,30425,3575882288,3575882289,1
2,1027,30426,3575882288,3575882289,1
2,1027,30427,3575882288,3575882289,1
2,1027,30428,3575882288,3575882290,2
2,1027,30429,3575882288,3575882290,2
2,1027,30430,3575882288,3575882290,2
2,1027,30431,3575882288,3575882290,2
2,1027,30432,3575882288,3575882291,3
2,1027,30433,3575882288,3575882291,3
2,1027,30434,3575882288,3575882292,4
2,1027,30435,3575882288,3575882292,4
2,1027,30436,3575882288,3575882292,4
2,1027,30437,3575882288,3575882293,5
2,1027,30438,3575882288,3575882294,6
2,1027,30439,3575882288,3575882294,6
2,1027,30440,3575882288,3575882295,7
2,1027,30441,3575882288,3575882297,9
2,1027,30442,3575882288,3575882298,10
2,1027,30443,3575882288,3575882300,12
2,1027,30444,3575882288,3575882300,12
2,1027,30445,3575882288,3575882301,13
2,1027,30446,3575882288,3575882302,14
2,1027,30447,3575882288,3575882302,14
2,1027,30448,3575882288,3575882303,15
2,1027,30449,3575882288,3575882304,16
2,1027,30450,3575882288,3575882306,18
2,1027,30451,3575882288,3575882306,18
2,1027,30452,3575882288,3575882306,18
2,1027,30453,3575882288,3575882306,18
2,1027,30454,3575882288,3575882306,18
2,1027,30455,3575882288,3575882307,19
2,1027,30456,3575882288,3575882307,19
2,1027,30457,3575882288,3575882307,19
2,1027,30458,3575882288,3575882308,20
2,1027,30459,3575882288,3575882308,20
2,1027,30460,3575882288,3575882308,20
2,1027,30461,3575882288,3575882308,20
2,1027,30462,3575882288,3575882309,21
2,1027,30463,3575882288,3575882311,23
2,1027,30464,3575882288,3575882311,23
2,1027,30465,3575882288,3575882312,24
2,1027,30466,3575882288,3575882312,24
2,1027,30467,3575882288,3575882312,24
2,1027,30468,3575882288,3575882313,25
2,1027,30469,3575882288,3575882314,26
2,1027,30470,3575882288,3575882315,27
2,1027,30471,3575882288,3575882315,27
2,1027,30472,3575882288,3575882315,27
2,1027,30473,3575882288,3575882315,27
2,1027,30474,3575882288,3575882315,27
2,1027,30475,3575882288,3575882316,28
2,1027,30476,3575882288,3575882317,29
2,1027,30477,3575882288,3575882318,30
2,1027,30478,3575882288,3575882319,31
2,1027,30479,3575882288,3575882320,32
2,1027,30480,3575882288,3575882321,33
2,1027,30481,3575882288,3575882322,34
2,1027,30482,3575882288,3575882324,36
2,1027,30483,3575882288,3575882325,37
2,1027,30484,3575882288,3575882326,38
2,1027,30485,3575882288,3575882327,39
2,1027,30486,3575882288,3575882329,41
2,1027,30487,3575882288,3575882329,41
2,1027,30488,3575882288,3575882330,42
2,1027,30489,3575882288,3575882331,43
2,1027,30490,3575882288,3575882331,43
2,1027,30491,3575882288,3575882331,43
2,1027,30492,3575882288,3575882331,43
2,1027,30493,3575882288,3575882332,44
2,1027,30494,3575882288,3575882332,44
2,1027,30495,3575882288,3575882334,46
2,1027,30496,3575882288,3575882334,46
2,1027,30497,3575882288,3575882334,46
2,1027,30498,3575882288,3575882334,46
2,1027,30499,3575882288,3575882335,47
2,1027,30500,3575882288,3575882335,47
2,1027,30501,3575882288,3575882338,50
2,1028,30502,3575882351,3575882351,0
2,1028,30503,3575882351,3575882351,0
2,1028,30504,3575882351,3575882351,0
2,1028,30505,3575882351,3575882351,0
2,1028,30506,3575882351,3575882351,0
2,1028,30507,3575882351,3575882351,0
2,1028,30508,3575882351,3575882351,0
2,1028,30509,3575882351,3575882351,0
2,1028,30510,3575882351,3575882351,0
2,1028,30511,3575882351,3575882351,0
2,1028,30512,3575882351,3575882351,0
2,1028,30513,3575882351,3575882351,0
2,1028,30514,3575882351,3575882351,0
2,1028,30515,3575882351,3575882351,0
2,1028,30516,3575882351,3575882351,0
2,1028,30517,3575882351,3575882351,0
2,1028,30518,3575882351,3575882351,0
2,1028,30519,3575882351,3575882351,0
2,1028,30520,3575882351,3575882351,0
2,1028,30521,3575882351,3575882351,0
2,1028,30522,3575882351,3575882352,1
2,1028,30523,3575882351,3575882352,1
2,1028,30524,3575882351,3575882352,1
2,1028,30525,3575882351,3575882354,3
2,1028,30526,3575882351,3575882357,6
2,1028,30527,3575882351,3575882357,6
2,1028,30528,3575882351,3575882358,7
2,1028,30529,3575882351,3575882359,8
2,1028,30530,3575882351,3575882360,9
2,1028,30531,3575882351,3575882360,9
2,1028,30532,3575882351,3575882361,10
2,1028,30533,3575882351,3575882361,10
2,1028,30534,3575882351,3575882362,11
2,1028,30535,3575882351,3575882363,12
2,1028,30536,3575882351,3575882364,13
2,1028,30537,3575882351,3575882365,14
2,1028,30538,3575882351,3575882366,15
2,1028,30539,3575882351,3575882366,15
2,1028,30540,3575882351,3575882367,16
2,1028,30541,3575882351,3575882368,17
2,1028,30542,3575882351,3575882368,17
2,1028,30543,3575882351,3575882368,17
2,1028,30544,3575882351,3575882368,17
2,1028,30545,3575882351,3575882369,18
2,1028,30546,3575882351,3575882370,19
2,1028,30547,3575882351,3575882371,20
2,1028,30548,3575882351,3575882371,20
2,1028,30549,3575882351,3575882374,23
2,1028,30550,3575882351,3575882375,24
2,1028,30551,3575882351,3575882376,25
2,1028,30552,3575882351,3575882376,25
2,1028,30553,3575882351,3575882378,27
2,1028,30554,3575882351,3575882378,27
2,1028,30555,3575882351,3575882379,28
2,1028,30556,3575882351,3575882381,30
2,1028,30557,3575882351,3575882382,31
2,1028,30558,3575882351,3575882383,32
2,1028,30559,3575882351,3575882383,32
2,1028,30560,3575882351,3575882383,32
2,1028,30561,3575882351,3575882385,34
2,1028,30562,3575882351,3575882385,34
2,1028,30563,3575882351,3575882385,34
2,1028,30564,3575882351,3575882386,35
2,1028,30565,3575882351,3575882386,35
2,1028,30566,3575882351,3575882386,35
2,1028,30567,3575882351,3575882387,36
2,1028,30568,3575882351,3575882388,37
2,1028,30569,3575882351,3575882388,37
2,1028,30570,3575882351,3575882388,37
2,1028,30571,3575882351,3575882388,37
2,1028,30572,3575882351,3575882389,38
2,1028,30573,3575882351,3575882392,41
2,1028,30574,3575882351,3575882392,41
2,1028,30575,3575882351,3575882392,41
2,1028,30576,3575882351,3575882393,42
2,1028,30577,3575882351,3575882394,43
2,1028,30578,3575882351,3575882396,45
2,1028,30579,3575882351,3575882396,45
2,1028,30580,3575882351,3575882397,46
2,1028,30581,3575882351,3575882398,47
2,1028,30582,3575882351,3575882399,48
2,1028,30583,3575882351,3575882401,50
2,1029,30584,3575882413,3575882413,0
2,1029,30585,3575882413,3575882413,0
2,1029,30586,3575882413,3575882413,0
2,1029,30587,3575882413,3575882413,0
2,1029,30588,3575882413,3575882413,0
2,1029,30589,3575882413,3575882413,0
2,1029,30590,3575882413,3575882413,0
2,1029,30591,3575882413,3575882413,0
2,1029,30592,3575882413,3575882413,0
2,1029,30593,3575882413,3575882413,0
2,1029,30594,3575882413,3575882414,1
2,1029,30595,3575882413,3575882414,1
2,1029,30596,3575882413,3575882422,9
2,1029,30597,3575882413,3575882422,9
2,1029,30598,3575882413,3575882422,9
2,1029,30599,3575882413,3575882423,10
2,1029,30600,3575882413,3575882423,10
2,1029,30601,3575882413,3575882425,12
2,1029,30602,3575882413,3575882425,12
2,1029,30603,3575882413,3575882425,12
2,1029,30604,3575882413,3575882426,13
2,1029,30605,3575882413,3575882427,14
2,1029,30606,3575882413,3575882429,16
2,1029,30607,3575882413,3575882429,16
2,1029,30608,3575882413,3575882430,17
2,1029,30609,3575882413,3575882430,17
2,1029,30610,3575882413,3575882431,18
2,1029,30611,3575882413,3575882437,24
2,1029,30612,3575882413,3575882437,24
2,1029,30613,3575882413,3575882438,25
2,1029,30614,3575882413,3575882438,25
2,1029,30615,3575882413,3575882439,26
2,1029,30616,3575882413,3575882439,26
2,1029,30617,3575882413,3575882440,27
2,1029,30618,3575882413,3575882441,28
2,1029,30619,3575882413,3575882442,29
2,1029,30620,3575882413,3575882444,31
2,1029,30621,3575882413,3575882446,33
2,1029,30622,3575882413,3575882447,34
2,1029,30623,3575882413,3575882449,36
2,1029,30624,3575882413,3575882454,41
2,1029,30625,3575882413,3575882454,41
2,1029,30626,3575882413,3575882454,41
2,1029,30627,3575882413,3575882454,41
2,1029,30628,3575882413,3575882456,43
2,1029,30629,3575882413,3575882456,43
2,1029,30630,3575882413,3575882457,44
2,1029,30631,3575882413,3575882457,44
2,1029,30632,3575882413,3575882458,45
2,1029,30633,3575882413,3575882461,48
2,1029,30634,3575882413,3575882461,48
2,1029,30635,3575882413,3575882461,48
2,1029,30636,3575882413,3575882462,49
2,1029,30637,3575882413,3575882463,50
2,1030,30638,3575882478,3575882478,0
2,1030,30639,3575882478,3575882478,0
2,1030,30640,3575882478,3575882478,0
2,1030,30641,3575882478,3575882478,0
2,1030,30642,3575882478,3575882478,0
2,1030,30643,3575882478,3575882478,0
2,1030,30644,3575882478,3575882478,0
2,1030,30645,3575882478,3575882478,0
2,1030,30646,3575882478,3575882478,0
2,1030,30647,3575882478,3575882480,2
2,1030,30648,3575882478,3575882480,2
2,1030,30649,3575882478,3575882481,3
2,1030,30650,3575882478,3575882483,5
2,1030,30651,3575882478,3575882483,5
2,1030,30652,3575882478,3575882485,7
2,1030,30653,3575882478,3575882485,7
2,1030,30654,3575882478,3575882485,7
2,1030,30655,3575882478,3575882486,8
2,1030,30656,3575882478,3575882486,8
2,1030,30657,3575882478,3575882486,8
2,1030,30658,3575882478,3575882486,8
2,1030,30659,3575882478,3575882487,9
2,1030,30660,3575882478,3575882488,10
2,1030,30661,3575882478,3575882488,10
2,1030,30662,3575882478,3575882488,10
2,1030,30663,3575882478,3575882489,11
2,1030,30664,3575882478,3575882490,12
2,1030,30665,3575882478,3575882490,12
2,1030,30666,3575882478,3575882490,12
2,1030,30667,3575882478,3575882491,13
2,1030,30668,3575882478,3575882491,13
2,1030,30669,3575882478,3575882492,14
2,1030,30670,3575882478,3575882492,14
2,1030,30671,3575882478,3575882492,14
2,1030,30672,3575882478,3575882494,16
2,1030,30673,3575882478,3575882494,16
2,1030,30674,3575882478,3575882494,16
2,1030,30675,3575882478,3575882495,17
2,1030,30676,3575882478,3575882496,18
2,1030,30677,3575882478,3575882497,19
2,1030,30678,3575882478,3575882498,20
2,1030,30679,3575882478,3575882500,22
2,1030,30680,3575882478,3575882500,22
2,1030,30681,3575882478,3575882501,23
2,1030,30682,3575882478,3575882501,23
2,1030,30683,3575882478,3575882503,25
2,1030,30684,3575882478,3575882503,25
2,1030,30685,3575882478,3575882504,26
2,1030,30686,3575882478,3575882505,27
2,1030,30687,3575882478,3575882506,28
2,1030,30688,3575882478,3575882507,29
2,1030,30689,3575882478,3575882507,29
2,1030,30690,3575882478,3575882507,29
2,1030,30691,3575882478,3575882507,29
2,1030,30692,3575882478,3575882507,29
2,1030,30693,3575882478,3575882508,30
2,1030,30694,3575882478,3575882508,30
2,1030,30695,3575882478,3575882508,30
2,1030,30696,3575882478,3575882509,31
2,1030,30697,3575882478,3575882510,32
2,1030,30698,3575882478,3575882510,32
2,1030,30699,3575882478,3575882511,33
2,1030,30700,3575882478,3575882512,34
2,1030,30701,3575882478,3575882512,34
2,1030,30702,3575882478,3575882512,34
2,1030,30703,3575882478,3575882513,35
2,1030,30704,3575882478,3575882513,35
2,1030,30705,3575882478,3575882514,36
2,1030,30706,3575882478,3575882515,37
2,1030,30707,3575882478,3575882515,37
2,1030,30708,3575882478,3575882515,37
2,1030,30709,3575882478,3575882515,37
2,1030,30710,3575882478,3575882515,37
2,1030,30711,3575882478,3575882516,38
2,1030,30712,3575882478,3575882516,38
2,1030,30713,3575882478,3575882518,40
2,1030,30714,3575882478,3575882519,41
2,1030,30715,3575882478,3575882519,41
2,1030,30716,3575882478,3575882521,43
2,1030,30717,3575882478,3575882521,43
2,1030,30718,3575882478,3575882523,45
2,1030,30719,3575882478,3575882524,46
2,1030,30720,3575882478,3575882525,47
2,1030,30721,3575882478,3575882526,48
2,1030,30722,3575882478,3575882526,48
2,1030,30723,3575882478,3575882527,49
2,1031,30724,3575882544,3575882544,0
2,1031,30725,3575882544,3575882544,0
2,1031,30726,3575882544,3575882544,0
2,1031,30727,3575882544,3575882544,0
2,1031,30728,3575882544,3575882544,0
2,1031,30729,3575882544,3575882544,0
2,1031,30730,3575882544,3575882544,0
2,1031,30731,3575882544,3575882544,0
2,1031,30732,3575882544,3575882544,0
2,1031,30733,3575882544,3575882544,0
2,1031,30734,3575882544,3575882544,0
2,1031,30735,3575882544,3575882544,0
2,1031,30736,3575882544,3575882544,0
2,1031,30737,3575882544,3575882544,0
2,1031,30738,3575882544,3575882544,0
2,1031,30739,3575882544,3575882544,0
2,1031,30740,3575882544,3575882544,0
2,1031,30741,3575882544,3575882544,0
2,1031,30742,3575882544,3575882544,0
2,1031,30743,3575882544,3575882544,0
2,1031,30744,3575882544,3575882544,0
2,1031,30745,3575882544,3575882544,0
2,1031,30746,3575882544,3575882544,0
2,1031,30747,3575882544,3575882544,0
2,1031,30748,3575882544,3575882544,0
2,1031,30749,3575882544,3575882544,0
2,1031,30750,3575882544,3575882544,0
2,1031,30751,3575882544,3575882544,0
2,1031,30752,3575882544,3575882544,0
2,1031,30753,3575882544,3575882545,1
2,1031,30754,3575882544,3575882546,2
2,1031,30755,3575882544,3575882547,3
2,1031,30756,3575882544,3575882548,4
2,1031,30757,3575882544,3575882548,4
2,1031,30758,3575882544,3575882548,4
2,1031,30759,3575882544,3575882548,4
2,1031,30760,3575882544,3575882550,6
2,1031,30761,3575882544,3575882550,6
2,1031,30762,3575882544,3575882550,6
2,1031,30763,3575882544,3575882551,7
2,1031,30764,3575882544,3575882551,7
2,1031,30765,3575882544,3575882553,9
2,1031,30766,3575882544,3575882555,11
2,1031,30767,3575882544,3575882556,12
2,1031,30768,3575882544,3575882556,12
2,1031,30769,3575882544,3575882558,14
2,1031,30770,3575882544,3575882560,16
2,1031,30771,3575882544,3575882560,16
2,1031,30772,3575882544,3575882560,16
2,1031,30773,3575882544,3575882560,16
2,1031,30774,3575882544,3575882561,17
2,1031,30775,3575882544,3575882562,18
2,1031,30776,3575882544,3575882564,20
2,1031,30777,3575882544,3575882564,20
2,1031,30778,3575882544,3575882565,21
2,1031,30779,3575882544,3575882566,22
2,1031,30780,3575882544,3575882566,22
2,1031,30781,3575882544,3575882567,23
2,1031,30782,3575882544,3575882567,23
2,1031,30783,3575882544,3575882568,24
2,1031,30784,3575882544,3575882568,24
2,1031,30785,3575882544,3575882569,25
2,1031,30786,3575882544,3575882570,26
2,1031,30787,3575882544,3575882571,27
2,1031,30788,3575882544,3575882573,29
2,1031,30789,3575882544,3575882573,29
2,1031,30790,3575882544,3575882574,30
2,1031,30791,3575882544,3575882574,30
2,1031,30792,3575882544,3575882575,31
2,1031,30793,3575882544,3575882575,31
2,1031,30794,3575882544,3575882577,33
2,1031,30795,3575882544,3575882578,34
2,1031,30796,3575882544,3575882579,35
2,1031,30797,3575882544,3575882579,35
2,1031,30798,3575882544,3575882581,37
2,1031,30799,3575882544,3575882582,38
2,1031,30800,3575882544,3575882582,38
2,1031,30801,3575882544,3575882583,39
2,1031,30802,3575882544,3575882584,40
2,1031,30803,3575882544,3575882584,40
2,1031,30804,3575882544,3575882585,41
2,1031,30805,3575882544,3575882585,41
2,1031,30806,3575882544,3575882586,42
2,1031,30807,3575882544,3575882587,43
2,1031,30808,3575882544,3575882588,44
2,1031,30809,3575882544,3575882588,44
2,1031,30810,3575882544,3575882588,44
2,1031,30811,3575882544,3575882589,45
2,1031,30812,3575882544,3575882591,47
2,1031,30813,3575882544,3575882591,47
2,1031,30814,3575882544,3575882592,48
2,1031,30815,3575882544,3575882593,49
2,1032,30816,3575882615,3575882615,0
2,1032,30817,3575882615,3575882615,0
2,1032,30818,3575882615,3575882615,0
2,1032,30819,3575882615,3575882615,0
2,1032,30820,3575882615,3575882615,0
2,1032,30821,3575882615,3575882615,0
2,1032,30822,3575882615,3575882615,0
2,1032,30823,3575882615,3575882615,0
2,1032,30824,3575882615,3575882615,0
2,1032,30825,3575882615,3575882615,0
2,1032,30826,3575882615,3575882615,0
2,1032,30827,3575882615,3575882615,0
2,1032,30828,3575882615,3575882615,0
2,1032,30829,3575882615,3575882615,0
2,1032,30830,3575882615,3575882615,0
2,1032,30831,3575882615,3575882615,0
2,1032,30832,3575882615,3575882615,0
2,1032,30833,3575882615,3575882615,0
2,1032,30834,3575882615,3575882621,6
2,1032,30835,3575882615,3575882621,6
2,1032,30836,3575882615,3575882622,7
2,1032,30837,3575882615,3575882622,7
2,1032,30838,3575882615,3575882623,8
2,1032,30839,3575882615,3575882625,10
2,1032,30840,3575882615,3575882625,10
2,1032,30841,3575882615,3575882625,10
2,1032,30842,3575882615,3575882625,10
2,1032,30843,3575882615,3575882628,13
2,1032,30844,3575882615,3575882629,14
2,1032,30845,3575882615,3575882629,14
2,1032,30846,3575882615,3575882630,15
2,1032,30847,3575882615,3575882636,21
2,1032,30848,3575882615,3575882636,21
2,1032,30849,3575882615,3575882637,22
2,1032,30850,3575882615,3575882637,22
2,1032,30851,3575882615,3575882638,23
2,1032,30852,3575882615,3575882638,23
2,1032,30853,3575882615,3575882639,24
2,1032,30854,3575882615,3575882639,24
2,1032,30855,3575882615,3575882640,25
2,1032,30856,3575882615,3575882640,25
2,1032,30857,3575882615,3575882640,25
2,1032,30858,3575882615,3575882642,27
2,1032,30859,3575882615,3575882642,27
2,1032,30860,3575882615,3575882643,28
2,1032,30861,3575882615,3575882645,30
2,1032,30862,3575882615,3575882646,31
2,1032,30863,3575882615,3575882648,33
2,1032,30864,3575882615,3575882653,38
2,1032,30865,3575882615,3575882654,39
2,1032,30866,3575882615,3575882654,39
2,1032,30867,3575882615,3575882654,39
2,1032,30868,3575882615,3575882655,40
2,1032,30869,3575882615,3575882655,40
2,1032,30870,3575882615,3575882655,40
2,1032,30871,3575882615,3575882657,42
2,1032,30872,3575882615,3575882658,43
2,1032,30873,3575882615,3575882659,44
2,1032,30874,3575882615,3575882661,46
2,1032,30875,3575882615,3575882661,46
2,1032,30876,3575882615,3575882662,47
2,1033,30877,3575882680,3575882680,0
2,1033,30878,3575882680,3575882680,0
2,1033,30879,3575882680,3575882680,0
2,1033,30880,3575882680,3575882680,0
2,1033,30881,3575882680,3575882680,0
2,1033,30882,3575882680,3575882680,0
2,1033,30883,3575882680,3575882680,0
2,1033,30884,3575882680,3575882680,0
2,1033,30885,3575882680,3575882680,0
2,1033,30886,3575882680,3575882680,0
2,1033,30887,3575882680,3575882683,3
2,1033,30888,3575882680,3575882684,4
2,1033,30889,3575882680,3575882685,5
2,1033,30890,3575882680,3575882685,5
2,1033,30891,3575882680,3575882685,5
2,1033,30892,3575882680,3575882685,5
2,1033,30893,3575882680,3575882685,5
2,1033,30894,3575882680,3575882686,6
2,1033,30895,3575882680,3575882686,6
2,1033,30896,3575882680,3575882688,8
2,1033,30897,3575882680,3575882688,8
2,1033,30898,3575882680,3575882688,8
2,1033,30899,3575882680,3575882689,9
2,1033,30900,3575882680,3575882689,9
2,1033,30901,3575882680,3575882690,10
2,1033,30902,3575882680,3575882690,10
2,1033,30903,3575882680,3575882690,10
2,1033,30904,3575882680,3575882691,11
2,1033,30905,3575882680,3575882691,11
2,1033,30906,3575882680,3575882692,12
2,1033,30907,3575882680,3575882692,12
2,1033,30908,3575882680,3575882692,12
2,1033,30909,3575882680,3575882693,13
2,1033,30910,3575882680,3575882694,14
2,1033,30911,3575882680,3575882694,14
2,1033,30912,3575882680,3575882697,17
2,1033,30913,3575882680,3575882697,17
2,1033,30914,3575882680,3575882698,18
2,1033,30915,3575882680,3575882700,20
2,1033,30916,3575882680,3575882700,20
2,1033,30917,3575882680,3575882700,20
2,1033,30918,3575882680,3575882703,23
2,1033,30919,3575882680,3575882703,23
2,1033,30920,3575882680,3575882705,25
2,1033,30921,3575882680,3575882706,26
2,1033,30922,3575882680,3575882706,26
2,1033,30923,3575882680,3575882706,26
2,1033,30924,3575882680,3575882706,26
2,1033,30925,3575882680,3575882707,27
2,1033,30926,3575882680,3575882707,27
2,1033,30927,3575882680,3575882707,27
2,1033,30928,3575882680,3575882708,28
2,1033,30929,3575882680,3575882708,28
2,1033,30930,3575882680,3575882709,29
2,1033,30931,3575882680,3575882709,29
2,1033,30932,3575882680,3575882710,30
2,1033,30933,3575882680,3575882711,31
2,1033,30934,3575882680,3575882711,31
2,1033,30935,3575882680,3575882712,32
2,1033,30936,3575882680,3575882712,32
2,1033,30937,3575882680,3575882712,32
2,1033,30938,3575882680,3575882712,32
2,1033,30939,3575882680,3575882713,33
2,1033,30940,3575882680,3575882714,34
2,1033,30941,3575882680,3575882715,35
2,1033,30942,3575882680,3575882715,35
2,1033,30943,3575882680,3575882716,36
2,1033,30944,3575882680,3575882716,36
2,1033,30945,3575882680,3575882716,36
2,1033,30946,3575882680,3575882716,36
2,1033,30947,3575882680,3575882720,40
2,1033,30948,3575882680,3575882721,41
2,1033,30949,3575882680,3575882721,41
2,1033,30950,3575882680,3575882721,41
2,1033,30951,3575882680,3575882722,42
2,1033,30952,3575882680,3575882723,43
2,1033,30953,3575882680,3575882725,45
2,1033,30954,3575882680,3575882726,46
2,1033,30955,3575882680,3575882726,46
2,1033,30956,3575882680,3575882727,47
2,1033,30957,3575882680,3575882727,47
2,1033,30958,3575882680,3575882730,50
2,1034,30959,3575882747,3575882747,0
2,1034,30960,3575882747,3575882747,0
2,1034,30961,3575882747,3575882747,0
2,1034,30962,3575882747,3575882747,0
2,1034,30963,3575882747,3575882747,0
2,1034,30964,3575882747,3575882747,0
2,1034,30965,3575882747,3575882747,0
2,1034,30966,3575882747,3575882747,0
2,1034,30967,3575882747,3575882747,0
2,1034,30968,3575882747,3575882747,0
2,1034,30969,3575882747,3575882747,0
2,1034,30970,3575882747,3575882747,0
2,1034,30971,3575882747,3575882747,0
2,1034,30972,3575882747,3575882747,0
2,1034,30973,3575882747,3575882747,0
2,1034,30974,3575882747,3575882747,0
2,1034,30975,3575882747,3575882747,0
2,1034,30976,3575882747,3575882747,0
2,1034,30977,3575882747,3575882747,0
2,1034,30978,3575882747,3575882747,0
2,1034,30979,3575882747,3575882747,0
2,1034,30980,3575882747,3575882747,0
2,1034,30981,3575882747,3575882747,0
2,1034,30982,3575882747,3575882748,1
2,1034,30983,3575882747,3575882748,1
2,1034,30984,3575882747,3575882748,1
2,1034,30985,3575882747,3575882748,1
2,1034,30986,3575882747,3575882748,1
2,1034,30987,3575882747,3575882748,1
2,1034,30988,3575882747,3575882749,2
2,1034,30989,3575882747,3575882750,3
2,1034,30990,3575882747,3575882750,3
2,1034,30991,3575882747,3575882751,4
2,1034,30992,3575882747,3575882751,4
2,1034,30993,3575882747,3575882751,4
2,1034,30994,3575882747,3575882753,6
2,1034,30995,3575882747,3575882756,9
2,1034,30996,3575882747,3575882756,9
2,1034,30997,3575882747,3575882758,11
2,1034,30998,3575882747,3575882760,13
2,1034,30999,3575882747,3575882760,13
2,1034,31000,3575882747,3575882761,14
2,1034,31001,3575882747,3575882761,14
2,1034,31002,3575882747,3575882762,15
2,1034,31003,3575882747,3575882763,16
2,1034,31004,3575882747,3575882764,17
2,1034,31005,3575882747,3575882765,18
2,1034,31006,3575882747,3575882765,18
2,1034,31007,3575882747,3575882765,18
2,1034,31008,3575882747,3575882767,20
2,1034,31009,3575882747,3575882767,20
2,1034,31010,3575882747,3575882767,20
2,1034,31011,3575882747,3575882767,20
2,1034,31012,3575882747,3575882768,21
2,1034,31013,3575882747,3575882769,22
2,1034,31014,3575882747,3575882769,22
2,1034,31015,3575882747,3575882771,24
2,1034,31016,3575882747,3575882773,26
2,1034,31017,3575882747,3575882773,26
2,1034,31018,3575882747,3575882773,26
2,1034,31019,3575882747,3575882774,27
2,1034,31020,3575882747,3575882775,28
2,1034,31021,3575882747,3575882775,28
2,1034,31022,3575882747,3575882777,30
2,1034,31023,3575882747,3575882778,31
2,1034,31024,3575882747,3575882778,31
2,1034,31025,3575882747,3575882779,32
2,1034,31026,3575882747,3575882780,33
2,1034,31027,3575882747,3575882780,33
2,1034,31028,3575882747,3575882781,34
2,1034,31029,3575882747,3575882782,35
2,1034,31030,3575882747,3575882783,36
2,1034,31031,3575882747,3575882784,37
2,1034,31032,3575882747,3575882784,37
2,1034,31033,3575882747,3575882784,37
2,1034,31034,3575882747,3575882785,38
2,1034,31035,3575882747,3575882785,38
2,1034,31036,3575882747,3575882786,39
2,1034,31037,3575882747,3575882787,40
2,1034,31038,3575882747,3575882787,40
2,1034,31039,3575882747,3575882788,41
2,1034,31040,3575882747,3575882788,41
2,1034,31041,3575882747,3575882788,41
2,1034,31042,3575882747,3575882788,41
2,1034,31043,3575882747,3575882791,44
2,1034,31044,3575882747,3575882791,44
2,1034,31045,3575882747,3575882791,44
2,1034,31046,3575882747,3575882792,45
2,1034,31047,3575882747,3575882792,45
2,1034,31048,3575882747,3575882795,48
2,1034,31049,3575882747,3575882796,49
2,1034,31050,3575882747,3575882797,50
2,1035,31051,3575882816,3575882816,0
2,1035,31052,3575882816,3575882816,0
2,1035,31053,3575882816,3575882816,0
2,1035,31054,3575882816,3575882816,0
2,1035,31055,3575882816,3575882816,0
2,1035,31056,3575882816,3575882816,0
2,1035,31057,3575882816,3575882816,0
2,1035,31058,3575882816,3575882816,0
2,1035,31059,3575882816,3575882816,0
2,1035,31060,3575882816,3575882816,0
2,1035,31061,3575882816,3575882816,0
2,1035,31062,3575882816,3575882816,0
2,1035,31063,3575882816,3575882816,0
2,1035,31064,3575882816,3575882816,0
2,1035,31065,3575882816,3575882816,0
2,1035,31066,3575882816,3575882821,5
2,1035,31067,3575882816,3575882821,5
2,1035,31068,3575882816,3575882822,6
2,1035,31069,3575882816,3575882823,7
2,1035,31070,3575882816,3575882823,7
2,1035,31071,3575882816,3575882825,9
2,1035,31072,3575882816,3575882825,9
2,1035,31073,3575882816,3575882826,10
2,1035,31074,3575882816,3575882828,12
2,1035,31075,3575882816,3575882829,13
2,1035,31076,3575882816,3575882829,13
2,1035,31077,3575882816,3575882831,15
2,1035,31078,3575882816,3575882831,15
2,1035,31079,3575882816,3575882836,20
2,1035,31080,3575882816,3575882836,20
2,1035,31081,3575882816,3575882838,22
2,1035,31082,3575882816,3575882838,22
2,1035,31083,3575882816,3575882838,22
2,1035,31084,3575882816,3575882839,23
2,1035,31085,3575882816,3575882839,23
2,1035,31086,3575882816,3575882839,23
2,1035,31087,3575882816,3575882840,24
2,1035,31088,3575882816,3575882840,24
2,1035,31089,3575882816,3575882840,24
2,1035,31090,3575882816,3575882841,25
2,1035,31091,3575882816,3575882843,27
2,1035,31092,3575882816,3575882843,27
2,1035,31093,3575882816,3575882845,29
2,1035,31094,3575882816,3575882846,30
2,1035,31095,3575882816,3575882848,32
2,1035,31096,3575882816,3575882852,36
2,1035,31097,3575882816,3575882854,38
2,1035,31098,3575882816,3575882854,38
2,1035,31099,3575882816,3575882854,38
2,1035,31100,3575882816,3575882854,38
2,1035,31101,3575882816,3575882856,40
2,1035,31102,3575882816,3575882856,40
2,1035,31103,3575882816,3575882858,42
2,1035,31104,3575882816,3575882860,44
2,1035,31105,3575882816,3575882861,45
2,1035,31106,3575882816,3575882861,45
2,1035,31107,3575882816,3575882862,46
2,1035,31108,3575882816,3575882864,48
2,1035,31109,3575882816,3575882866,50
2,1036,31110,3575882879,3575882879,0
2,1036,31111,3575882879,3575882879,0
2,1036,31112,3575882879,3575882879,0
2,1036,31113,3575882879,3575882879,0
2,1036,31114,3575882879,3575882879,0
2,1036,31115,3575882879,3575882879,0
2,1036,31116,3575882879,3575882879,0
2,1036,31117,3575882879,3575882880,1
2,1036,31118,3575882879,3575882881,2
2,1036,31119,3575882879,3575882883,4
2,1036,31120,3575882879,3575882884,5
2,1036,31121,3575882879,3575882885,6
2,1036,31122,3575882879,3575882885,6
2,1036,31123,3575882879,3575882885,6
2,1036,31124,3575882879,3575882886,7
2,1036,31125,3575882879,3575882886,7
2,1036,31126,3575882879,3575882886,7
2,1036,31127,3575882879,3575882886,7
2,1036,31128,3575882879,3575882887,8
2,1036,31129,3575882879,3575882888,9
2,1036,31130,3575882879,3575882888,9
2,1036,31131,3575882879,3575882889,10
2,1036,31132,3575882879,3575882890,11
2,1036,31133,3575882879,3575882890,11
2,1036,31134,3575882879,3575882891,12
2,1036,31135,3575882879,3575882891,12
2,1036,31136,3575882879,3575882892,13
2,1036,31137,3575882879,3575882892,13
2,1036,31138,3575882879,3575882892,13
2,1036,31139,3575882879,3575882892,13
2,1036,31140,3575882879,3575882893,14
2,1036,31141,3575882879,3575882893,14
2,1036,31142,3575882879,3575882895,16
2,1036,31143,3575882879,3575882896,17
2,1036,31144,3575882879,3575882897,18
2,1036,31145,3575882879,3575882898,19
2,1036,31146,3575882879,3575882900,21
2,1036,31147,3575882879,3575882900,21
2,1036,31148,3575882879,3575882901,22
2,1036,31149,3575882879,3575882903,24
2,1036,31150,3575882879,3575882903,24
2,1036,31151,3575882879,3575882905,26
2,1036,31152,3575882879,3575882906,27
2,1036,31153,3575882879,3575882907,28
2,1036,31154,3575882879,3575882907,28
2,1036,31155,3575882879,3575882907,28
2,1036,31156,3575882879,3575882907,28
2,1036,31157,3575882879,3575882907,28
2,1036,31158,3575882879,3575882907,28
2,1036,31159,3575882879,3575882908,29
2,1036,31160,3575882879,3575882908,29
2,1036,31161,3575882879,3575882908,29
2,1036,31162,3575882879,3575882908,29
2,1036,31163,3575882879,3575882910,31
2,1036,31164,3575882879,3575882910,31
2,1036,31165,3575882879,3575882911,32
2,1036,31166,3575882879,3575882911,32
2,1036,31167,3575882879,3575882912,33
2,1036,31168,3575882879,3575882913,34
2,1036,31169,3575882879,3575882913,34
2,1036,31170,3575882879,3575882915,36
2,1036,31171,3575882879,3575882915,36
2,1036,31172,3575882879,3575882915,36
2,1036,31173,3575882879,3575882915,36
2,1036,31174,3575882879,3575882916,37
2,1036,31175,3575882879,3575882916,37
2,1036,31176,3575882879,3575882916,37
2,1036,31177,3575882879,3575882917,38
2,1036,31178,3575882879,3575882920,41
2,1036,31179,3575882879,3575882921,42
2,1036,31180,3575882879,3575882921,42
2,1036,31181,3575882879,3575882921,42
2,1036,31182,3575882879,3575882923,44
2,1036,31183,3575882879,3575882923,44
2,1036,31184,3575882879,3575882926,47
2,1036,31185,3575882879,3575882926,47
2,1036,31186,3575882879,3575882926,47
2,1036,31187,3575882879,3575882926,47
2,1036,31188,3575882879,3575882927,48
2,1037,31189,3575882944,3575882944,0
2,1037,31190,3575882944,3575882944,0
2,1037,31191,3575882944,3575882944,0
2,1037,31192,3575882944,3575882944,0
2,1037,31193,3575882944,3575882944,0
2,1037,31194,3575882944,3575882944,0
2,1037,31195,3575882944,3575882944,0
2,1037,31196,3575882944,3575882944,0
2,1037,31197,3575882944,3575882944,0
2,1037,31198,3575882944,3575882944,0
2,1037,31199,3575882944,3575882944,0
2,1037,31200,3575882944,3575882944,0
2,1037,31201,3575882944,3575882944,0
2,1037,31202,3575882944,3575882944,0
2,1037,31203,3575882944,3575882944,0
2,1037,31204,3575882944,3575882944,0
2,1037,31205,3575882944,3575882944,0
2,1037,31206,3575882944,3575882944,0
2,1037,31207,3575882944,3575882944,0
2,1037,31208,3575882944,3575882944,0
2,1037,31209,3575882944,3575882944,0
2,1037,31210,3575882944,3575882944,0
2,1037,31211,3575882944,3575882944,0
2,1037,31212,3575882944,3575882944,0
2,1037,31213,3575882944,3575882944,0
2,1037,31214,3575882944,3575882945,1
2,1037,31215,3575882944,3575882945,1
2,1037,31216,3575882944,3575882947,3
2,1037,31217,3575882944,3575882948,4
2,1037,31218,3575882944,3575882949,5
2,1037,31219,3575882944,3575882949,5
2,1037,31220,3575882944,3575882950,6
2,1037,31221,3575882944,3575882950,6
2,1037,31222,3575882944,3575882950,6
2,1037,31223,3575882944,3575882950,6
2,1037,31224,3575882944,3575882951,7
2,1037,31225,3575882944,3575882952,8
2,1037,31226,3575882944,3575882955,11
2,1037,31227,3575882944,3575882955,11
2,1037,31228,3575882944,3575882957,13
2,1037,31229,3575882944,3575882958,14
2,1037,31230,3575882944,3575882960,16
2,1037,31231,3575882944,3575882960,16
2,1037,31232,3575882944,3575882960,16
2,1037,31233,3575882944,3575882961,17
2,1037,31234,3575882944,3575882961,17
2,1037,31235,3575882944,3575882961,17
2,1037,31236,3575882944,3575882963,19
2,1037,31237,3575882944,3575882964,20
2,1037,31238,3575882944,3575882965,21
2,1037,31239,3575882944,3575882965,21
2,1037,31240,3575882944,3575882965,21
2,1037,31241,3575882944,3575882966,22
2,1037,31242,3575882944,3575882967,23
2,1037,31243,3575882944,3575882968,24
2,1037,31244,3575882944,3575882968,24
2,1037,31245,3575882944,3575882969,25
2,1037,31246,3575882944,3575882970,26
2,1037,31247,3575882944,3575882972,28
2,1037,31248,3575882944,3575882973,29
2,1037,31249,3575882944,3575882973,29
2,1037,31250,3575882944,3575882974,30
2,1037,31251,3575882944,3575882974,30
2,1037,31252,3575882944,3575882975,31
2,1037,31253,3575882944,3575882976,32
2,1037,31254,3575882944,3575882977,33
2,1037,31255,3575882944,3575882978,34
2,1037,31256,3575882944,3575882978,34
2,1037,31257,3575882944,3575882980,36
2,1037,31258,3575882944,3575882981,37
2,1037,31259,3575882944,3575882981,37
2,1037,31260,3575882944,3575882981,37
2,1037,31261,3575882944,3575882983,39
2,1037,31262,3575882944,3575882984,40
2,1037,31263,3575882944,3575882984,40
2,1037,31264,3575882944,3575882984,40
2,1037,31265,3575882944,3575882985,41
2,1037,31266,3575882944,3575882985,41
2,1037,31267,3575882944,3575882985,41
2,1037,31268,3575882944,3575882986,42
2,1037,31269,3575882944,3575882987,43
2,1037,31270,3575882944,3575882987,43
2,1037,31271,3575882944,3575882987,43
2,1037,31272,3575882944,3575882988,44
2,1037,31273,3575882944,3575882988,44
2,1037,31274,3575882944,3575882990,46
2,1037,31275,3575882944,3575882991,47
2,1037,31276,3575882944,3575882991,47
2,1037,31277,3575882944,3575882992,48
2,1037,31278,3575882944,3575882993,49
2,1038,31279,3575883007,3575883007,0
2,1038,31280,3575883007,3575883007,0
2,1038,31281,3575883007,3575883007,0
2,1038,31282,3575883007,3575883007,0
2,1038,31283,3575883007,3575883007,0
2,1038,31284,3575883007,3575883007,0
2,1038,31285,3575883007,3575883007,0
2,1038,31286,3575883007,3575883007,0
2,1038,31287,3575883007,3575883007,0
2,1038,31288,3575883007,3575883007,0
2,1038,31289,3575883007,3575883007,0
2,1038,31290,3575883007,3575883007,0
2,1038,31291,3575883007,3575883007,0
2,1038,31292,3575883007,3575883010,3
2,1038,31293,3575883007,3575883011,4
2,1038,31294,3575883007,3575883011,4
2,1038,31295,3575883007,3575883012,5
2,1038,31296,3575883007,3575883012,5
2,1038,31297,3575883007,3575883013,6
2,1038,31298,3575883007,3575883014,7
2,1038,31299,3575883007,3575883021,14
2,1038,31300,3575883007,3575883021,14
2,1038,31301,3575883007,3575883022,15
2,1038,31302,3575883007,3575883022,15
2,1038,31303,3575883007,3575883024,17
2,1038,31304,3575883007,3575883025,18
2,1038,31305,3575883007,3575883025,18
2,1038,31306,3575883007,3575883026,19
2,1038,31307,3575883007,3575883026,19
2,1038,31308,3575883007,3575883028,21
2,1038,31309,3575883007,3575883029,22
2,1038,31310,3575883007,3575883029,22
2,1038,31311,3575883007,3575883030,23
2,1038,31312,3575883007,3575883031,24
2,1038,31313,3575883007,3575883036,29
2,1038,31314,3575883007,3575883036,29
2,1038,31315,3575883007,3575883038,31
2,1038,31316,3575883007,3575883038,31
2,1038,31317,3575883007,3575883038,31
2,1038,31318,3575883007,3575883039,32
2,1038,31319,3575883007,3575883039,32
2,1038,31320,3575883007,3575883040,33
2,1038,31321,3575883007,3575883040,33
2,1038,31322,3575883007,3575883041,34
2,1038,31323,3575883007,3575883042,35
2,1038,31324,3575883007,3575883043,36
2,1038,31325,3575883007,3575883043,36
2,1038,31326,3575883007,3575883045,38
2,1038,31327,3575883007,3575883047,40
2,1038,31328,3575883007,3575883048,41
2,1038,31329,3575883007,3575883049,42
2,1038,31330,3575883007,3575883053,46
2,1038,31331,3575883007,3575883053,46
2,1038,31332,3575883007,3575883054,47
2,1038,31333,3575883007,3575883054,47
2,1038,31334,3575883007,3575883055,48
2,1038,31335,3575883007,3575883056,49
2,1038,31336,3575883007,3575883056,49
2,1038,31337,3575883007,3575883057,50
2,1039,31338,3575883071,3575883071,0
2,1039,31339,3575883071,3575883071,0
2,1039,31340,3575883071,3575883071,0
2,1039,31341,3575883071,3575883071,0
2,1039,31342,3575883071,3575883071,0
2,1039,31343,3575883071,3575883071,0
2,1039,31344,3575883071,3575883071,0
2,1039,31345,3575883071,3575883071,0
2,1039,31346,3575883071,3575883071,0
2,1039,31347,3575883071,3575883074,3
2,1039,31348,3575883071,3575883076,5
2,1039,31349,3575883071,3575883078,7
2,1039,31350,3575883071,3575883078,7
2,1039,31351,3575883071,3575883081,10
2,1039,31352,3575883071,3575883081,10
2,1039,31353,3575883071,3575883084,13
2,1039,31354,3575883071,3575883084,13
2,1039,31355,3575883071,3575883085,14
2,1039,31356,3575883071,3575883085,14
2,1039,31357,3575883071,3575883086,15
2,1039,31358,3575883071,3575883086,15
2,1039,31359,3575883071,3575883086,15
2,1039,31360,3575883071,3575883086,15
2,1039,31361,3575883071,3575883086,15
2,1039,31362,3575883071,3575883087,16
2,1039,31363,3575883071,3575883088,17
2,1039,31364,3575883071,3575883088,17
2,1039,31365,3575883071,3575883088,17
2,1039,31366,3575883071,3575883089,18
2,1039,31367,3575883071,3575883091,20
2,1039,31368,3575883071,3575883092,21
2,1039,31369,3575883071,3575883092,21
2,1039,31370,3575883071,3575883092,21
2,1039,31371,3575883071,3575883092,21
2,1039,31372,3575883071,3575883093,22
2,1039,31373,3575883071,3575883094,23
2,1039,31374,3575883071,3575883094,23
2,1039,31375,3575883071,3575883095,24
2,1039,31376,3575883071,3575883096,25
2,1039,31377,3575883071,3575883097,26
2,1039,31378,3575883071,3575883098,27
2,1039,31379,3575883071,3575883099,28
2,1039,31380,3575883071,3575883100,29
2,1039,31381,3575883071,3575883101,30
2,1039,31382,3575883071,3575883103,32
2,1039,31383,3575883071,3575883103,32
2,1039,31384,3575883071,3575883105,34
2,1039,31385,3575883071,3575883106,35
2,1039,31386,3575883071,3575883106,35
2,1039,31387,3575883071,3575883106,35
2,1039,31388,3575883071,3575883107,36
2,1039,31389,3575883071,3575883107,36
2,1039,31390,3575883071,3575883107,36
2,1039,31391,3575883071,3575883108,37
2,1039,31392,3575883071,3575883108,37
2,1039,31393,3575883071,3575883108,37
2,1039,31394,3575883071,3575883108,37
2,1039,31395,3575883071,3575883108,37
2,1039,31396,3575883071,3575883109,38
2,1039,31397,3575883071,3575883110,39
2,1039,31398,3575883071,3575883110,39
2,1039,31399,3575883071,3575883111,40
2,1039,31400,3575883071,3575883112,41
2,1039,31401,3575883071,3575883113,42
2,1039,31402,3575883071,3575883113,42
2,1039,31403,3575883071,3575883113,42
2,1039,31404,3575883071,3575883115,44
2,1039,31405,3575883071,3575883115,44
2,1039,31406,3575883071,3575883115,44
2,1039,31407,3575883071,3575883116,45
2,1039,31408,3575883071,3575883117,46
2,1039,31409,3575883071,3575883117,46
2,1039,31410,3575883071,3575883118,47
2,1039,31411,3575883071,3575883120,49
2,1039,31412,3575883071,3575883120,49
2,1039,31413,3575883071,3575883121,50
2,1040,31414,3575883134,3575883134,0
2,1040,31415,3575883134,3575883134,0
2,1040,31416,3575883134,3575883134,0
2,1040,31417,3575883134,3575883134,0
2,1040,31418,3575883134,3575883134,0
2,1040,31419,3575883134,3575883134,0
2,1040,31420,3575883134,3575883134,0
2,1040,31421,3575883134,3575883134,0
2,1040,31422,3575883134,3575883134,0
2,1040,31423,3575883134,3575883134,0
2,1040,31424,3575883134,3575883134,0
2,1040,31425,3575883134,3575883134,0
2,1040,31426,3575883134,3575883134,0
2,1040,31427,3575883134,3575883134,0
2,1040,31428,3575883134,3575883134,0
2,1040,31429,3575883134,3575883134,0
2,1040,31430,3575883134,3575883135,1
2,1040,31431,3575883134,3575883135,1
2,1040,31432,3575883134,3575883135,1
2,1040,31433,3575883134,3575883135,1
2,1040,31434,3575883134,3575883135,1
2,1040,31435,3575883134,3575883135,1
2,1040,31436,3575883134,3575883136,2
2,1040,31437,3575883134,3575883138,4
2,1040,31438,3575883134,3575883138,4
2,1040,31439,3575883134,3575883139,5
2,1040,31440,3575883134,3575883139,5
2,1040,31441,3575883134,3575883140,6
2,1040,31442,3575883134,3575883140,6
2,1040,31443,3575883134,3575883142,8
2,1040,31444,3575883134,3575883142,8
2,1040,31445,3575883134,3575883143,9
2,1040,31446,3575883134,3575883144,10
2,1040,31447,3575883134,3575883144,10
2,1040,31448,3575883134,3575883145,11
2,1040,31449,3575883134,3575883145,11
2,1040,31450,3575883134,3575883146,12
2,1040,31451,3575883134,3575883147,13
2,1040,31452,3575883134,3575883147,13
2,1040,31453,3575883134,3575883149,15
2,1040,31454,3575883134,3575883149,15
2,1040,31455,3575883134,3575883149,15
2,1040,31456,3575883134,3575883150,16
2,1040,31457,3575883134,3575883150,16
2,1040,31458,3575883134,3575883151,17
2,1040,31459,3575883134,3575883151,17
2,1040,31460,3575883134,3575883152,18
2,1040,31461,3575883134,3575883155,21
2,1040,31462,3575883134,3575883157,23
2,1040,31463,3575883134,3575883157,23
2,1040,31464,3575883134,3575883158,24
2,1040,31465,3575883134,3575883159,25
2,1040,31466,3575883134,3575883159,25
2,1040,31467,3575883134,3575883160,26
2,1040,31468,3575883134,3575883160,26
2,1040,31469,3575883134,3575883161,27
2,1040,31470,3575883134,3575883161,27
2,1040,31471,3575883134,3575883162,28
2,1040,31472,3575883134,3575883163,29
2,1040,31473,3575883134,3575883165,31
2,1040,31474,3575883134,3575883165,31
2,1040,31475,3575883134,3575883165,31
2,1040,31476,3575883134,3575883166,32
2,1040,31477,3575883134,3575883167,33
2,1040,31478,3575883134,3575883167,33
2,1040,31479,3575883134,3575883168,34
2,1040,31480,3575883134,3575883168,34
2,1040,31481,3575883134,3575883169,35
2,1040,31482,3575883134,3575883170,36
2,1040,31483,3575883134,3575883170,36
2,1040,31484,3575883134,3575883170,36
2,1040,31485,3575883134,3575883171,37
2,1040,31486,3575883134,3575883173,39
2,1040,31487,3575883134,3575883173,39
2,1040,31488,3575883134,3575883174,40
2,1040,31489,3575883134,3575883175,41
2,1040,31490,3575883134,3575883176,42
2,1040,31491,3575883134,3575883177,43
2,1040,31492,3575883134,3575883178,44
2,1040,31493,3575883134,3575883178,44
2,1040,31494,3575883134,3575883180,46
2,1040,31495,3575883134,3575883181,47
2,1040,31496,3575883134,3575883181,47
2,1040,31497,3575883134,3575883182,48
2,1040,31498,3575883134,3575883183,49
2,1040,31499,3575883134,3575883183,49
2,1040,31500,3575883134,3575883184,50
2,1041,31501,3575883198,3575883198,0
2,1041,31502,3575883198,3575883198,0
2,1041,31503,3575883198,3575883198,0
2,1041,31504,3575883198,3575883198,0
2,1041,31505,3575883198,3575883198,0
2,1041,31506,3575883198,3575883198,0
2,1041,31507,3575883198,3575883198,0
2,1041,31508,3575883198,3575883198,0
2,1041,31509,3575883198,3575883198,0
2,1041,31510,3575883198,3575883198,0
2,1041,31511,3575883198,3575883198,0
2,1041,31512,3575883198,3575883198,0
2,1041,31513,3575883198,3575883198,0
2,1041,31514,3575883198,3575883198,0
2,1041,31515,3575883198,3575883198,0
2,1041,31516,3575883198,3575883198,0
2,1041,31517,3575883198,3575883198,0
2,1041,31518,3575883198,3575883198,0
2,1041,31519,3575883198,3575883198,0
2,1041,31520,3575883198,3575883199,1
2,1041,31521,3575883198,3575883201,3
2,1041,31522,3575883198,3575883201,3
2,1041,31523,3575883198,3575883204,6
2,1041,31524,3575883198,3575883204,6
2,1041,31525,3575883198,3575883204,6
2,1041,31526,3575883198,3575883205,7
2,1041,31527,3575883198,3575883205,7
2,1041,31528,3575883198,3575883207,9
2,1041,31529,3575883198,3575883208,10
2,1041,31530,3575883198,3575883208,10
2,1041,31531,3575883198,3575883210,12
2,1041,31532,3575883198,3575883212,14
2,1041,31533,3575883198,3575883212,14
2,1041,31534,3575883198,3575883212,14
2,1041,31535,3575883198,3575883213,15
2,1041,31536,3575883198,3575883214,16
2,1041,31537,3575883198,3575883214,16
2,1041,31538,3575883198,3575883221,23
2,1041,31539,3575883198,3575883221,23
2,1041,31540,3575883198,3575883223,25
2,1041,31541,3575883198,3575883223,25
2,1041,31542,3575883198,3575883224,26
2,1041,31543,3575883198,3575883225,27
2,1041,31544,3575883198,3575883226,28
2,1041,31545,3575883198,3575883227,29
2,1041,31546,3575883198,3575883227,29
2,1041,31547,3575883198,3575883229,31
2,1041,31548,3575883198,3575883229,31
2,1041,31549,3575883198,3575883229,31
2,1041,31550,3575883198,3575883229,31
2,1041,31551,3575883198,3575883231,33
2,1041,31552,3575883198,3575883235,37
2,1041,31553,3575883198,3575883237,39
2,1041,31554,3575883198,3575883237,39
2,1041,31555,3575883198,3575883237,39
2,1041,31556,3575883198,3575883238,40
2,1041,31557,3575883198,3575883238,40
2,1041,31558,3575883198,3575883238,40
2,1041,31559,3575883198,3575883239,41
2,1041,31560,3575883198,3575883240,42
2,1041,31561,3575883198,3575883240,42
2,1041,31562,3575883198,3575883240,42
2,1041,31563,3575883198,3575883241,43
2,1041,31564,3575883198,3575883242,44
2,1041,31565,3575883198,3575883243,45
2,1041,31566,3575883198,3575883243,45
2,1041,31567,3575883198,3575883245,47
2,1041,31568,3575883198,3575883247,49
2,1042,31569,3575883262,3575883262,0
2,1042,31570,3575883262,3575883262,0
2,1042,31571,3575883262,3575883262,0
2,1042,31572,3575883262,3575883262,0
2,1042,31573,3575883262,3575883262,0
2,1042,31574,3575883262,3575883262,0
2,1042,31575,3575883262,3575883262,0
2,1042,31576,3575883262,3575883262,0
2,1042,31577,3575883262,3575883262,0
2,1042,31578,3575883262,3575883262,0
2,1042,31579,3575883262,3575883262,0
2,1042,31580,3575883262,3575883262,0
2,1042,31581,3575883262,3575883262,0
2,1042,31582,3575883262,3575883262,0
2,1042,31583,3575883262,3575883263,1
2,1042,31584,3575883262,3575883264,2
2,1042,31585,3575883262,3575883266,4
2,1042,31586,3575883262,3575883268,6
2,1042,31587,3575883262,3575883269,7
2,1042,31588,3575883262,3575883269,7
2,1042,31589,3575883262,3575883274,12
2,1042,31590,3575883262,3575883276,14
2,1042,31591,3575883262,3575883277,15
2,1042,31592,3575883262,3575883278,16
2,1042,31593,3575883262,3575883281,19
2,1042,31594,3575883262,3575883281,19
2,1042,31595,3575883262,3575883284,22
2,1042,31596,3575883262,3575883284,22
2,1042,31597,3575883262,3575883285,23
2,1042,31598,3575883262,3575883285,23
2,1042,31599,3575883262,3575883285,23
2,1042,31600,3575883262,3575883286,24
2,1042,31601,3575883262,3575883286,24
2,1042,31602,3575883262,3575883286,24
2,1042,31603,3575883262,3575883287,25
2,1042,31604,3575883262,3575883287,25
2,1042,31605,3575883262,3575883288,26
2,1042,31606,3575883262,3575883289,27
2,1042,31607,3575883262,3575883289,27
2,1042,31608,3575883262,3575883290,28
2,1042,31609,3575883262,3575883291,29
2,1042,31610,3575883262,3575883291,29
2,1042,31611,3575883262,3575883292,30
2,1042,31612,3575883262,3575883292,30
2,1042,31613,3575883262,3575883292,30
2,1042,31614,3575883262,3575883294,32
2,1042,31615,3575883262,3575883294,32
2,1042,31616,3575883262,3575883295,33
2,1042,31617,3575883262,3575883296,34
2,1042,31618,3575883262,3575883297,35
2,1042,31619,3575883262,3575883298,36
2,1042,31620,3575883262,3575883300,38
2,1042,31621,3575883262,3575883300,38
2,1042,31622,3575883262,3575883303,41
2,1042,31623,3575883262,3575883305,43
2,1042,31624,3575883262,3575883306,44
2,1042,31625,3575883262,3575883306,44
2,1042,31626,3575883262,3575883307,45
2,1042,31627,3575883262,3575883307,45
2,1042,31628,3575883262,3575883307,45
2,1042,31629,3575883262,3575883307,45
2,1042,31630,3575883262,3575883308,46
2,1042,31631,3575883262,3575883308,46
2,1042,31632,3575883262,3575883308,46
2,1042,31633,3575883262,3575883308,46
2,1042,31634,3575883262,3575883309,47
2,1042,31635,3575883262,3575883310,48
2,1042,31636,3575883262,3575883311,49
2,1042,31637,3575883262,3575883311,49
2,1043,31638,3575883325,3575883325,0
2,1043,31639,3575883325,3575883325,0
2,1043,31640,3575883325,3575883325,0
2,1043,31641,3575883325,3575883325,0
2,1043,31642,3575883325,3575883325,0
2,1043,31643,3575883325,3575883325,0
2,1043,31644,3575883325,3575883325,0
2,1043,31645,3575883325,3575883325,0
2,1043,31646,3575883325,3575883325,0
2,1043,31647,3575883325,3575883325,0
2,1043,31648,3575883325,3575883325,0
2,1043,31649,3575883325,3575883325,0
2,1043,31650,3575883325,3575883325,0
2,1043,31651,3575883325,3575883325,0
2,1043,31652,3575883325,3575883325,0
2,1043,31653,3575883325,3575883325,0
2,1043,31654,3575883325,3575883325,0
2,1043,31655,3575883325,3575883326,1
2,1043,31656,3575883325,3575883327,2
2,1043,31657,3575883325,3575883327,2
2,1043,31658,3575883325,3575883327,2
2,1043,31659,3575883325,3575883329,4
2,1043,31660,3575883325,3575883330,5
2,1043,31661,3575883325,3575883331,6
2,1043,31662,3575883325,3575883331,6
2,1043,31663,3575883325,3575883332,7
2,1043,31664,3575883325,3575883332,7
2,1043,31665,3575883325,3575883333,8
2,1043,31666,3575883325,3575883334,9
2,1043,31667,3575883325,3575883334,9
2,1043,31668,3575883325,3575883334,9
2,1043,31669,3575883325,3575883334,9
2,1043,31670,3575883325,3575883334,9
2,1043,31671,3575883325,3575883335,10
2,1043,31672,3575883325,3575883335,10
2,1043,31673,3575883325,3575883336,11
2,1043,31674,3575883325,3575883338,13
2,1043,31675,3575883325,3575883339,14
2,1043,31676,3575883325,3575883339,14
2,1043,31677,3575883325,3575883339,14
2,1043,31678,3575883325,3575883340,15
2,1043,31679,3575883325,3575883342,17
2,1043,31680,3575883325,3575883342,17
2,1043,31681,3575883325,3575883344,19
2,1043,31682,3575883325,3575883344,19
2,1043,31683,3575883325,3575883344,19
2,1043,31684,3575883325,3575883345,20
2,1043,31685,3575883325,3575883345,20
2,1043,31686,3575883325,3575883347,22
2,1043,31687,3575883325,3575883348,23
2,1043,31688,3575883325,3575883348,23
2,1043,31689,3575883325,3575883349,24
2,1043,31690,3575883325,3575883349,24
2,1043,31691,3575883325,3575883350,25
2,1043,31692,3575883325,3575883351,26
2,1043,31693,3575883325,3575883351,26
2,1043,31694,3575883325,3575883352,27
2,1043,31695,3575883325,3575883352,27
2,1043,31696,3575883325,3575883352,27
2,1043,31697,3575883325,3575883355,30
2,1043,31698,3575883325,3575883357,32
2,1043,31699,3575883325,3575883357,32
2,1043,31700,3575883325,3575883357,32
2,1043,31701,3575883325,3575883359,34
2,1043,31702,3575883325,3575883360,35
2,1043,31703,3575883325,3575883360,35
2,1043,31704,3575883325,3575883361,36
2,1043,31705,3575883325,3575883361,36
2,1043,31706,3575883325,3575883361,36
2,1043,31707,3575883325,3575883363,38
2,1043,31708,3575883325,3575883365,40
2,1043,31709,3575883325,3575883365,40
2,1043,31710,3575883325,3575883365,40
2,1043,31711,3575883325,3575883366,41
2,1043,31712,3575883325,3575883367,42
2,1043,31713,3575883325,3575883367,42
2,1043,31714,3575883325,3575883368,43
2,1043,31715,3575883325,3575883368,43
2,1043,31716,3575883325,3575883369,44
2,1043,31717,3575883325,3575883370,45
2,1043,31718,3575883325,3575883370,45
2,1043,31719,3575883325,3575883372,47
2,1043,31720,3575883325,3575883373,48
2,1043,31721,3575883325,3575883374,49
2,1043,31722,3575883325,3575883375,50
2,1044,31723,3575883392,3575883392,0
2,1044,31724,3575883392,3575883392,0
2,1044,31725,3575883392,3575883392,0
2,1044,31726,3575883392,3575883392,0
2,1044,31727,3575883392,3575883392,0
2,1044,31728,3575883392,3575883392,0
2,1044,31729,3575883392,3575883392,0
2,1044,31730,3575883392,3575883392,0
2,1044,31731,3575883392,3575883392,0
2,1044,31732,3575883392,3575883392,0
2,1044,31733,3575883392,3575883392,0
2,1044,31734,3575883392,3575883392,0
2,1044,31735,3575883392,3575883392,0
2,1044,31736,3575883392,3575883392,0
2,1044,31737,3575883392,3575883392,0
2,1044,31738,3575883392,3575883392,0
2,1044,31739,3575883392,3575883392,0
2,1044,31740,3575883392,3575883392,0
2,1044,31741,3575883392,3575883392,0
2,1044,31742,3575883392,3575883392,0
2,1044,31743,3575883392,3575883392,0
2,1044,31744,3575883392,3575883392,0
2,1044,31745,3575883392,3575883392,0
2,1044,31746,3575883392,3575883392,0
2,1044,31747,3575883392,3575883392,0
2,1044,31748,3575883392,3575883393,1
2,1044,31749,3575883392,3575883396,4
2,1044,31750,3575883392,3575883397,5
2,1044,31751,3575883392,3575883398,6
2,1044,31752,3575883392,3575883398,6
2,1044,31753,3575883392,3575883399,7
2,1044,31754,3575883392,3575883402,10
2,1044,31755,3575883392,3575883402,10
2,1044,31756,3575883392,3575883403,11
2,1044,31757,3575883392,3575883404,12
2,1044,31758,3575883392,3575883404,12
2,1044,31759,3575883392,3575883404,12
2,1044,31760,3575883392,3575883405,13
2,1044,31761,3575883392,3575883405,13
2,1044,31762,3575883392,3575883408,16
2,1044,31763,3575883392,3575883408,16
2,1044,31764,3575883392,3575883409,17
2,1044,31765,3575883392,3575883410,18
2,1044,31766,3575883392,3575883411,19
2,1044,31767,3575883392,3575883412,20
2,1044,31768,3575883392,3575883412,20
2,1044,31769,3575883392,3575883413,21
2,1044,31770,3575883392,3575883414,22
2,1044,31771,3575883392,3575883421,29
2,1044,31772,3575883392,3575883421,29
2,1044,31773,3575883392,3575883423,31
2,1044,31774,3575883392,3575883424,32
2,1044,31775,3575883392,3575883424,32
2,1044,31776,3575883392,3575883425,33
2,1044,31777,3575883392,3575883426,34
2,1044,31778,3575883392,3575883427,35
2,1044,31779,3575883392,3575883427,35
2,1044,31780,3575883392,3575883429,37
2,1044,31781,3575883392,3575883429,37
2,1044,31782,3575883392,3575883430,38
2,1044,31783,3575883392,3575883430,38
2,1044,31784,3575883392,3575883431,39
2,1044,31785,3575883392,3575883435,43
2,1044,31786,3575883392,3575883437,45
2,1044,31787,3575883392,3575883437,45
2,1044,31788,3575883392,3575883438,46
2,1044,31789,3575883392,3575883438,46
2,1044,31790,3575883392,3575883438,46
2,1044,31791,3575883392,3575883439,47
2,1044,31792,3575883392,3575883440,48
2,1044,31793,3575883392,3575883440,48
2,1044,31794,3575883392,3575883441,49
2,1045,31795,3575883456,3575883456,0
2,1045,31796,3575883456,3575883456,0
2,1045,31797,3575883456,3575883456,0
2,1045,31798,3575883456,3575883456,0
2,1045,31799,3575883456,3575883456,0
2,1045,31800,3575883456,3575883456,0
2,1045,31801,3575883456,3575883456,0
2,1045,31802,3575883456,3575883456,0
2,1045,31803,3575883456,3575883456,0
2,1045,31804,3575883456,3575883456,0
2,1045,31805,3575883456,3575883457,1
2,1045,31806,3575883456,3575883458,2
2,1045,31807,3575883456,3575883460,4
2,1045,31808,3575883456,3575883461,5
2,1045,31809,3575883456,3575883461,5
2,1045,31810,3575883456,3575883462,6
2,1045,31811,3575883456,3575883464,8
2,1045,31812,3575883456,3575883467,11
2,1045,31813,3575883456,3575883468,12
2,1045,31814,3575883456,3575883470,14
2,1045,31815,3575883456,3575883473,17
2,1045,31816,3575883456,3575883477,21
2,1045,31817,3575883456,3575883478,22
2,1045,31818,3575883456,3575883481,25
2,1045,31819,3575883456,3575883481,25
2,1045,31820,3575883456,3575883484,28
2,1045,31821,3575883456,3575883484,28
2,1045,31822,3575883456,3575883484,28
2,1045,31823,3575883456,3575883485,29
2,1045,31824,3575883456,3575883486,30
2,1045,31825,3575883456,3575883486,30
2,1045,31826,3575883456,3575883486,30
2,1045,31827,3575883456,3575883486,30
2,1045,31828,3575883456,3575883487,31
2,1045,31829,3575883456,3575883488,32
2,1045,31830,3575883456,3575883488,32
2,1045,31831,3575883456,3575883488,32
2,1045,31832,3575883456,3575883489,33
2,1045,31833,3575883456,3575883490,34
2,1045,31834,3575883456,3575883491,35
2,1045,31835,3575883456,3575883491,35
2,1045,31836,3575883456,3575883491,35
2,1045,31837,3575883456,3575883492,36
2,1045,31838,3575883456,3575883492,36
2,1045,31839,3575883456,3575883493,37
2,1045,31840,3575883456,3575883493,37
2,1045,31841,3575883456,3575883493,37
2,1045,31842,3575883456,3575883494,38
2,1045,31843,3575883456,3575883497,41
2,1045,31844,3575883456,3575883498,42
2,1045,31845,3575883456,3575883498,42
2,1045,31846,3575883456,3575883500,44
2,1045,31847,3575883456,3575883500,44
2,1045,31848,3575883456,3575883503,47
2,1045,31849,3575883456,3575883505,49
2,1045,31850,3575883456,3575883505,49
2,1045,31851,3575883456,3575883506,50
2,1046,31852,3575883519,3575883519,0
2,1046,31853,3575883519,3575883519,0
2,1046,31854,3575883519,3575883519,0
2,1046,31855,3575883519,3575883519,0
2,1046,31856,3575883519,3575883519,0
2,1046,31857,3575883519,3575883519,0
2,1046,31858,3575883519,3575883519,0
2,1046,31859,3575883519,3575883519,0
2,1046,31860,3575883519,3575883519,0
2,1046,31861,3575883519,3575883519,0
2,1046,31862,3575883519,3575883519,0
2,1046,31863,3575883519,3575883519,0
2,1046,31864,3575883519,3575883519,0
2,1046,31865,3575883519,3575883519,0
2,1046,31866,3575883519,3575883519,0
2,1046,31867,3575883519,3575883519,0
2,1046,31868,3575883519,3575883519,0
2,1046,31869,3575883519,3575883519,0
2,1046,31870,3575883519,3575883519,0
2,1046,31871,3575883519,3575883519,0
2,1046,31872,3575883519,3575883519,0
2,1046,31873,3575883519,3575883519,0
2,1046,31874,3575883519,3575883519,0
2,1046,31875,3575883519,3575883519,0
2,1046,31876,3575883519,3575883519,0
2,1046,31877,3575883519,3575883520,1
2,1046,31878,3575883519,3575883521,2
2,1046,31879,3575883519,3575883522,3
2,1046,31880,3575883519,3575883522,3
2,1046,31881,3575883519,3575883522,3
2,1046,31882,3575883519,3575883525,6
2,1046,31883,3575883519,3575883525,6
2,1046,31884,3575883519,3575883526,7
2,1046,31885,3575883519,3575883526,7
2,1046,31886,3575883519,3575883526,7
2,1046,31887,3575883519,3575883527,8
2,1046,31888,3575883519,3575883528,9
2,1046,31889,3575883519,3575883530,11
2,1046,31890,3575883519,3575883530,11
2,1046,31891,3575883519,3575883530,11
2,1046,31892,3575883519,3575883531,12
2,1046,31893,3575883519,3575883531,12
2,1046,31894,3575883519,3575883531,12
2,1046,31895,3575883519,3575883532,13
2,1046,31896,3575883519,3575883532,13
2,1046,31897,3575883519,3575883533,14
2,1046,31898,3575883519,3575883533,14
2,1046,31899,3575883519,3575883533,14
2,1046,31900,3575883519,3575883533,14
2,1046,31901,3575883519,3575883534,15
2,1046,31902,3575883519,3575883535,16
2,1046,31903,3575883519,3575883535,16
2,1046,31904,3575883519,3575883538,19
2,1046,31905,3575883519,3575883538,19
2,1046,31906,3575883519,3575883538,19
2,1046,31907,3575883519,3575883539,20
2,1046,31908,3575883519,3575883539,20
2,1046,31909,3575883519,3575883539,20
2,1046,31910,3575883519,3575883541,22
2,1046,31911,3575883519,3575883542,23
2,1046,31912,3575883519,3575883543,24
2,1046,31913,3575883519,3575883543,24
2,1046,31914,3575883519,3575883544,25
2,1046,31915,3575883519,3575883544,25
2,1046,31916,3575883519,3575883545,26
2,1046,31917,3575883519,3575883547,28
2,1046,31918,3575883519,3575883547,28
2,1046,31919,3575883519,3575883548,29
2,1046,31920,3575883519,3575883548,29
2,1046,31921,3575883519,3575883548,29
2,1046,31922,3575883519,3575883549,30
2,1046,31923,3575883519,3575883549,30
2,1046,31924,3575883519,3575883550,31
2,1046,31925,3575883519,3575883551,32
2,1046,31926,3575883519,3575883551,32
2,1046,31927,3575883519,3575883551,32
2,1046,31928,3575883519,3575883553,34
2,1046,31929,3575883519,3575883554,35
2,1046,31930,3575883519,3575883556,37
2,1046,31931,3575883519,3575883556,37
2,1046,31932,3575883519,3575883557,38
2,1046,31933,3575883519,3575883558,39
2,1046,31934,3575883519,3575883559,40
2,1046,31935,3575883519,3575883560,41
2,1046,31936,3575883519,3575883560,41
2,1046,31937,3575883519,3575883560,41
2,1046,31938,3575883519,3575883560,41
2,1046,31939,3575883519,3575883562,43
2,1046,31940,3575883519,3575883563,44
2,1046,31941,3575883519,3575883564,45
2,1046,31942,3575883519,3575883566,47
2,1046,31943,3575883519,3575883566,47
2,1046,31944,3575883519,3575883566,47
2,1046,31945,3575883519,3575883566,47
2,1046,31946,3575883519,3575883567,48
2,1046,31947,3575883519,3575883568,49
2,1047,31948,3575883583,3575883583,0
2,1047,31949,3575883583,3575883583,0
2,1047,31950,3575883583,3575883583,0
2,1047,31951,3575883583,3575883583,0
2,1047,31952,3575883583,3575883584,1
2,1047,31953,3575883583,3575883584,1
2,1047,31954,3575883583,3575883584,1
2,1047,31955,3575883583,3575883584,1
2,1047,31956,3575883583,3575883584,1
2,1047,31957,3575883583,3575883584,1
2,1047,31958,3575883583,3575883584,1
2,1047,31959,3575883583,3575883584,1
2,1047,31960,3575883583,3575883584,1
2,1047,31961,3575883583,3575883584,1
2,1047,31962,3575883583,3575883584,1
2,1047,31963,3575883583,3575883584,1
2,1047,31964,3575883583,3575883584,1
2,1047,31965,3575883583,3575883584,1
2,1047,31966,3575883583,3575883584,1
2,1047,31967,3575883583,3575883585,2
2,1047,31968,3575883583,3575883585,2
2,1047,31969,3575883583,3575883588,5
2,1047,31970,3575883583,3575883588,5
2,1047,31971,3575883583,3575883588,5
2,1047,31972,3575883583,3575883590,7
2,1047,31973,3575883583,3575883590,7
2,1047,31974,3575883583,3575883591,8
2,1047,31975,3575883583,3575883591,8
2,1047,31976,3575883583,3575883592,9
2,1047,31977,3575883583,3575883592,9
2,1047,31978,3575883583,3575883592,9
2,1047,31979,3575883583,3575883596,13
2,1047,31980,3575883583,3575883596,13
2,1047,31981,3575883583,3575883597,14
2,1047,31982,3575883583,3575883597,14
2,1047,31983,3575883583,3575883598,15
2,1047,31984,3575883583,3575883601,18
2,1047,31985,3575883583,3575883601,18
2,1047,31986,3575883583,3575883602,19
2,1047,31987,3575883583,3575883603,20
2,1047,31988,3575883583,3575883604,21
2,1047,31989,3575883583,3575883604,21
2,1047,31990,3575883583,3575883604,21
2,1047,31991,3575883583,3575883605,22
2,1047,31992,3575883583,3575883607,24
2,1047,31993,3575883583,3575883607,24
2,1047,31994,3575883583,3575883607,24
2,1047,31995,3575883583,3575883609,26
2,1047,31996,3575883583,3575883610,27
2,1047,31997,3575883583,3575883611,28
2,1047,31998,3575883583,3575883611,28
2,1047,31999,3575883583,3575883612,29
2,1047,32000,3575883583,3575883613,30
2,1047,32001,3575883583,3575883613,30
2,1047,32002,3575883583,3575883620,37
2,1047,32003,3575883583,3575883621,38
2,1047,32004,3575883583,3575883621,38
2,1047,32005,3575883583,3575883622,39
2,1047,32006,3575883583,3575883623,40
2,1047,32007,3575883583,3575883624,41
2,1047,32008,3575883583,3575883625,42
2,1047,32009,3575883583,3575883626,43
2,1047,32010,3575883583,3575883626,43
2,1047,32011,3575883583,3575883628,45
2,1047,32012,3575883583,3575883628,45
2,1047,32013,3575883583,3575883629,46
2,1047,32014,3575883583,3575883630,47
2,1048,32015,3575883647,3575883647,0
2,1048,32016,3575883647,3575883647,0
2,1048,32017,3575883647,3575883647,0
2,1048,32018,3575883647,3575883647,0
2,1048,32019,3575883647,3575883647,0
2,1048,32020,3575883647,3575883647,0
2,1048,32021,3575883647,3575883647,0
2,1048,32022,3575883647,3575883647,0
2,1048,32023,3575883647,3575883647,0
2,1048,32024,3575883647,3575883647,0
2,1048,32025,3575883647,3575883647,0
2,1048,32026,3575883647,3575883647,0
2,1048,32027,3575883647,3575883647,0
2,1048,32028,3575883647,3575883647,0
2,1048,32029,3575883647,3575883647,0
2,1048,32030,3575883647,3575883647,0
2,1048,32031,3575883647,3575883649,2
2,1048,32032,3575883647,3575883652,5
2,1048,32033,3575883647,3575883653,6
2,1048,32034,3575883647,3575883655,8
2,1048,32035,3575883647,3575883655,8
2,1048,32036,3575883647,3575883655,8
2,1048,32037,3575883647,3575883655,8
2,1048,32038,3575883647,3575883655,8
2,1048,32039,3575883647,3575883656,9
2,1048,32040,3575883647,3575883660,13
2,1048,32041,3575883647,3575883660,13
2,1048,32042,3575883647,3575883661,14
2,1048,32043,3575883647,3575883662,15
2,1048,32044,3575883647,3575883664,17
2,1048,32045,3575883647,3575883667,20
2,1048,32046,3575883647,3575883669,22
2,1048,32047,3575883647,3575883674,27
2,1048,32048,3575883647,3575883675,28
2,1048,32049,3575883647,3575883677,30
2,1048,32050,3575883647,3575883678,31
2,1048,32051,3575883647,3575883680,33
2,1048,32052,3575883647,3575883681,34
2,1048,32053,3575883647,3575883684,37
2,1048,32054,3575883647,3575883684,37
2,1048,32055,3575883647,3575883685,38
2,1048,32056,3575883647,3575883685,38
2,1048,32057,3575883647,3575883686,39
2,1048,32058,3575883647,3575883686,39
2,1048,32059,3575883647,3575883686,39
2,1048,32060,3575883647,3575883686,39
2,1048,32061,3575883647,3575883687,40
2,1048,32062,3575883647,3575883687,40
2,1048,32063,3575883647,3575883688,41
2,1048,32064,3575883647,3575883689,42
2,1048,32065,3575883647,3575883689,42
2,1048,32066,3575883647,3575883690,43
2,1048,32067,3575883647,3575883691,44
2,1048,32068,3575883647,3575883691,44
2,1048,32069,3575883647,3575883691,44
2,1048,32070,3575883647,3575883691,44
2,1048,32071,3575883647,3575883691,44
2,1048,32072,3575883647,3575883692,45
2,1048,32073,3575883647,3575883692,45
2,1048,32074,3575883647,3575883693,46
2,1048,32075,3575883647,3575883693,46
2,1048,32076,3575883647,3575883694,47
2,1048,32077,3575883647,3575883697,50
2,1049,32078,3575883711,3575883711,0
2,1049,32079,3575883711,3575883711,0
2,1049,32080,3575883711,3575883711,0
2,1049,32081,3575883711,3575883711,0
2,1049,32082,3575883711,3575883711,0
2,1049,32083,3575883711,3575883711,0
2,1049,32084,3575883711,3575883711,0
2,1049,32085,3575883711,3575883711,0
2,1049,32086,3575883711,3575883711,0
2,1049,32087,3575883711,3575883711,0
2,1049,32088,3575883711,3575883711,0
2,1049,32089,3575883711,3575883711,0
2,1049,32090,3575883711,3575883711,0
2,1049,32091,3575883711,3575883711,0
2,1049,32092,3575883711,3575883711,0
2,1049,32093,3575883711,3575883711,0
2,1049,32094,3575883711,3575883711,0
2,1049,32095,3575883711,3575883711,0
2,1049,32096,3575883711,3575883711,0
2,1049,32097,3575883711,3575883712,1
2,1049,32098,3575883711,3575883712,1
2,1049,32099,3575883711,3575883713,2
2,1049,32100,3575883711,3575883713,2
2,1049,32101,3575883711,3575883713,2
2,1049,32102,3575883711,3575883714,3
2,1049,32103,3575883711,3575883714,3
2,1049,32104,3575883711,3575883715,4
2,1049,32105,3575883711,3575883715,4
2,1049,32106,3575883711,3575883715,4
2,1049,32107,3575883711,3575883715,4
2,1049,32108,3575883711,3575883717,6
2,1049,32109,3575883711,3575883718,7
2,1049,32110,3575883711,3575883718,7
2,1049,32111,3575883711,3575883719,8
2,1049,32112,3575883711,3575883720,9
2,1049,32113,3575883711,3575883720,9
2,1049,32114,3575883711,3575883721,10
2,1049,32115,3575883711,3575883721,10
2,1049,32116,3575883711,3575883723,12
2,1049,32117,3575883711,3575883723,12
2,1049,32118,3575883711,3575883726,15
2,1049,32119,3575883711,3575883726,15
2,1049,32120,3575883711,3575883726,15
2,1049,32121,3575883711,3575883726,15
2,1049,32122,3575883711,3575883726,15
2,1049,32123,3575883711,3575883728,17
2,1049,32124,3575883711,3575883729,18
2,1049,32125,3575883711,3575883730,19
2,1049,32126,3575883711,3575883731,20
2,1049,32127,3575883711,3575883731,20
2,1049,32128,3575883711,3575883732,21
2,1049,32129,3575883711,3575883732,21
2,1049,32130,3575883711,3575883733,22
2,1049,32131,3575883711,3575883733,22
2,1049,32132,3575883711,3575883733,22
2,1049,32133,3575883711,3575883734,23
2,1049,32134,3575883711,3575883734,23
2,1049,32135,3575883711,3575883734,23
2,1049,32136,3575883711,3575883735,24
2,1049,32137,3575883711,3575883735,24
2,1049,32138,3575883711,3575883738,27
2,1049,32139,3575883711,3575883738,27
2,1049,32140,3575883711,3575883739,28
2,1049,32141,3575883711,3575883739,28
2,1049,32142,3575883711,3575883740,29
2,1049,32143,3575883711,3575883740,29
2,1049,32144,3575883711,3575883741,30
2,1049,32145,3575883711,3575883742,31
2,1049,32146,3575883711,3575883743,32
2,1049,32147,3575883711,3575883744,33
2,1049,32148,3575883711,3575883744,33
2,1049,32149,3575883711,3575883744,33
2,1049,32150,3575883711,3575883744,33
2,1049,32151,3575883711,3575883745,34
2,1049,32152,3575883711,3575883746,35
2,1049,32153,3575883711,3575883747,36
2,1049,32154,3575883711,3575883748,37
2,1049,32155,3575883711,3575883749,38
2,1049,32156,3575883711,3575883749,38
2,1049,32157,3575883711,3575883749,38
2,1049,32158,3575883711,3575883750,39
2,1049,32159,3575883711,3575883751,40
2,1049,32160,3575883711,3575883751,40
2,1049,32161,3575883711,3575883751,40
2,1049,32162,3575883711,3575883753,42
2,1049,32163,3575883711,3575883754,43
2,1049,32164,3575883711,3575883756,45
2,1049,32165,3575883711,3575883756,45
2,1049,32166,3575883711,3575883757,46
2,1049,32167,3575883711,3575883758,47
2,1049,32168,3575883711,3575883759,48
2,1049,32169,3575883711,3575883760,49
2,1049,32170,3575883711,3575883760,49
2,1049,32171,3575883711,3575883760,49
2,1049,32172,3575883711,3575883761,50
2,1050,32173,3575883773,3575883773,0
2,1050,32174,3575883773,3575883773,0
2,1050,32175,3575883773,3575883773,0
2,1050,32176,3575883773,3575883773,0
2,1050,32177,3575883773,3575883773,0
2,1050,32178,3575883773,3575883773,0
2,1050,32179,3575883773,3575883773,0
2,1050,32180,3575883773,3575883773,0
2,1050,32181,3575883773,3575883773,0
2,1050,32182,3575883773,3575883773,0
2,1050,32183,3575883773,3575883773,0
2,1050,32184,3575883773,3575883773,0
2,1050,32185,3575883773,3575883773,0
2,1050,32186,3575883773,3575883774,1
2,1050,32187,3575883773,3575883774,1
2,1050,32188,3575883773,3575883775,2
2,1050,32189,3575883773,3575883775,2
2,1050,32190,3575883773,3575883776,3
2,1050,32191,3575883773,3575883778,5
2,1050,32192,3575883773,3575883778,5
2,1050,32193,3575883773,3575883779,6
2,1050,32194,3575883773,3575883780,7
2,1050,32195,3575883773,3575883780,7
2,1050,32196,3575883773,3575883781,8
2,1050,32197,3575883773,3575883782,9
2,1050,32198,3575883773,3575883782,9
2,1050,32199,3575883773,3575883782,9
2,1050,32200,3575883773,3575883783,10
2,1050,32201,3575883773,3575883784,11
2,1050,32202,3575883773,3575883784,11
2,1050,32203,3575883773,3575883785,12
2,1050,32204,3575883773,3575883785,12
2,1050,32205,3575883773,3575883785,12
2,1050,32206,3575883773,3575883786,13
2,1050,32207,3575883773,3575883787,14
2,1050,32208,3575883773,3575883787,14
2,1050,32209,3575883773,3575883787,14
2,1050,32210,3575883773,3575883788,15
2,1050,32211,3575883773,3575883789,16
2,1050,32212,3575883773,3575883790,17
2,1050,32213,3575883773,3575883790,17
2,1050,32214,3575883773,3575883791,18
2,1050,32215,3575883773,3575883792,19
2,1050,32216,3575883773,3575883792,19
2,1050,32217,3575883773,3575883793,20
2,1050,32218,3575883773,3575883796,23
2,1050,32219,3575883773,3575883796,23
2,1050,32220,3575883773,3575883797,24
2,1050,32221,3575883773,3575883797,24
2,1050,32222,3575883773,3575883798,25
2,1050,32223,3575883773,3575883801,28
2,1050,32224,3575883773,3575883801,28
2,1050,32225,3575883773,3575883803,30
2,1050,32226,3575883773,3575883804,31
2,1050,32227,3575883773,3575883804,31
2,1050,32228,3575883773,3575883804,31
2,1050,32229,3575883773,3575883805,32
2,1050,32230,3575883773,3575883807,34
2,1050,32231,3575883773,3575883808,35
2,1050,32232,3575883773,3575883809,36
2,1050,32233,3575883773,3575883809,36
2,1050,32234,3575883773,3575883811,38
2,1050,32235,3575883773,3575883811,38
2,1050,32236,3575883773,3575883812,39
2,1050,32237,3575883773,3575883812,39
2,1050,32238,3575883773,3575883813,40
2,1050,32239,3575883773,3575883814,41
2,1050,32240,3575883773,3575883820,47
2,1050,32241,3575883773,3575883821,48
2,1050,32242,3575883773,3575883822,49
2,1050,32243,3575883773,3575883822,49
2,1050,32244,3575883773,3575883823,50
2,1051,32245,3575883840,3575883840,0
2,1051,32246,3575883840,3575883840,0
2,1051,32247,3575883840,3575883840,0
2,1051,32248,3575883840,3575883840,0
2,1051,32249,3575883840,3575883840,0
2,1051,32250,3575883840,3575883840,0
2,1051,32251,3575883840,3575883840,0
2,1051,32252,3575883840,3575883840,0
2,1051,32253,3575883840,3575883840,0
2,1051,32254,3575883840,3575883840,0
2,1051,32255,3575883840,3575883840,0
2,1051,32256,3575883840,3575883840,0
2,1051,32257,3575883840,3575883840,0
2,1051,32258,3575883840,3575883842,2
2,1051,32259,3575883840,3575883842,2
2,1051,32260,3575883840,3575883845,5
2,1051,32261,3575883840,3575883847,7
2,1051,32262,3575883840,3575883847,7
2,1051,32263,3575883840,3575883852,12
2,1051,32264,3575883840,3575883853,13
2,1051,32265,3575883840,3575883854,14
2,1051,32266,3575883840,3575883855,15
2,1051,32267,3575883840,3575883855,15
2,1051,32268,3575883840,3575883855,15
2,1051,32269,3575883840,3575883856,16
2,1051,32270,3575883840,3575883856,16
2,1051,32271,3575883840,3575883856,16
2,1051,32272,3575883840,3575883857,17
2,1051,32273,3575883840,3575883860,20
2,1051,32274,3575883840,3575883860,20
2,1051,32275,3575883840,3575883861,21
2,1051,32276,3575883840,3575883861,21
2,1051,32277,3575883840,3575883864,24
2,1051,32278,3575883840,3575883866,26
2,1051,32279,3575883840,3575883867,27
2,1051,32280,3575883840,3575883869,29
2,1051,32281,3575883840,3575883874,34
2,1051,32282,3575883840,3575883875,35
2,1051,32283,3575883840,3575883877,37
2,1051,32284,3575883840,3575883878,38
2,1051,32285,3575883840,3575883881,41
2,1051,32286,3575883840,3575883881,41
2,1051,32287,3575883840,3575883884,44
2,1051,32288,3575883840,3575883884,44
2,1051,32289,3575883840,3575883885,45
2,1051,32290,3575883840,3575883886,46
2,1051,32291,3575883840,3575883886,46
2,1051,32292,3575883840,3575883886,46
2,1051,32293,3575883840,3575883886,46
2,1051,32294,3575883840,3575883887,47
2,1051,32295,3575883840,3575883887,47
2,1051,32296,3575883840,3575883888,48
2,1051,32297,3575883840,3575883889,49
2,1051,32298,3575883840,3575883889,49
2,1052,32299,3575883902,3575883902,0
2,1052,32300,3575883902,3575883902,0
2,1052,32301,3575883902,3575883902,0
2,1052,32302,3575883902,3575883902,0
2,1052,32303,3575883902,3575883902,0
2,1052,32304,3575883902,3575883902,0
2,1052,32305,3575883902,3575883902,0
2,1052,32306,3575883902,3575883902,0
2,1052,32307,3575883902,3575883902,0
2,1052,32308,3575883902,3575883902,0
2,1052,32309,3575883902,3575883902,0
2,1052,32310,3575883902,3575883902,0
2,1052,32311,3575883902,3575883902,0
2,1052,32312,3575883902,3575883902,0
2,1052,32313,3575883902,3575883902,0
2,1052,32314,3575883902,3575883902,0
2,1052,32315,3575883902,3575883902,0
2,1052,32316,3575883902,3575883903,1
2,1052,32317,3575883902,3575883903,1
2,1052,32318,3575883902,3575883905,3
2,1052,32319,3575883902,3575883906,4
2,1052,32320,3575883902,3575883907,5
2,1052,32321,3575883902,3575883907,5
2,1052,32322,3575883902,3575883907,5
2,1052,32323,3575883902,3575883907,5
2,1052,32324,3575883902,3575883908,6
2,1052,32325,3575883902,3575883908,6
2,1052,32326,3575883902,3575883908,6
2,1052,32327,3575883902,3575883909,7
2,1052,32328,3575883902,3575883909,7
2,1052,32329,3575883902,3575883910,8
2,1052,32330,3575883902,3575883910,8
2,1052,32331,3575883902,3575883911,9
2,1052,32332,3575883902,3575883911,9
2,1052,32333,3575883902,3575883912,10
2,1052,32334,3575883902,3575883912,10
2,1052,32335,3575883902,3575883913,11
2,1052,32336,3575883902,3575883913,11
2,1052,32337,3575883902,3575883914,12
2,1052,32338,3575883902,3575883915,13
2,1052,32339,3575883902,3575883915,13
2,1052,32340,3575883902,3575883915,13
2,1052,32341,3575883902,3575883915,13
2,1052,32342,3575883902,3575883916,14
2,1052,32343,3575883902,3575883917,15
2,1052,32344,3575883902,3575883918,16
2,1052,32345,3575883902,3575883918,16
2,1052,32346,3575883902,3575883918,16
2,1052,32347,3575883902,3575883920,18
2,1052,32348,3575883902,3575883920,18
2,1052,32349,3575883902,3575883920,18
2,1052,32350,3575883902,3575883921,19
2,1052,32351,3575883902,3575883921,19
2,1052,32352,3575883902,3575883922,20
2,1052,32353,3575883902,3575883923,21
2,1052,32354,3575883902,3575883926,24
2,1052,32355,3575883902,3575883926,24
2,1052,32356,3575883902,3575883926,24
2,1052,32357,3575883902,3575883926,24
2,1052,32358,3575883902,3575883926,24
2,1052,32359,3575883902,3575883928,26
2,1052,32360,3575883902,3575883929,27
2,1052,32361,3575883902,3575883930,28
2,1052,32362,3575883902,3575883930,28
2,1052,32363,3575883902,3575883931,29
2,1052,32364,3575883902,3575883931,29
2,1052,32365,3575883902,3575883932,30
2,1052,32366,3575883902,3575883932,30
2,1052,32367,3575883902,3575883933,31
2,1052,32368,3575883902,3575883933,31
2,1052,32369,3575883902,3575883934,32
2,1052,32370,3575883902,3575883934,32
2,1052,32371,3575883902,3575883934,32
2,1052,32372,3575883902,3575883934,32
2,1052,32373,3575883902,3575883935,33
2,1052,32374,3575883902,3575883936,34
2,1052,32375,3575883902,3575883938,36
2,1052,32376,3575883902,3575883938,36
2,1052,32377,3575883902,3575883939,37
2,1052,32378,3575883902,3575883939,37
2,1052,32379,3575883902,3575883940,38
2,1052,32380,3575883902,3575883940,38
2,1052,32381,3575883902,3575883942,40
2,1052,32382,3575883902,3575883943,41
2,1052,32383,3575883902,3575883944,42
2,1052,32384,3575883902,3575883944,42
2,1052,32385,3575883902,3575883944,42
2,1052,32386,3575883902,3575883945,43
2,1052,32387,3575883902,3575883945,43
2,1052,32388,3575883902,3575883947,45
2,1052,32389,3575883902,3575883947,45
2,1052,32390,3575883902,3575883947,45
2,1052,32391,3575883902,3575883947,45
2,1052,32392,3575883902,3575883948,46
2,1052,32393,3575883902,3575883949,47
2,1052,32394,3575883902,3575883949,47
2,1052,32395,3575883902,3575883950,48
2,1052,32396,3575883902,3575883951,49
2,1052,32397,3575883902,3575883951,49
2,1052,32398,3575883902,3575883951,49
2,1053,32399,3575883968,3575883968,0
2,1053,32400,3575883968,3575883968,0
2,1053,32401,3575883968,3575883968,0
2,1053,32402,3575883968,3575883968,0
2,1053,32403,3575883968,3575883968,0
2,1053,32404,3575883968,3575883968,0
2,1053,32405,3575883968,3575883968,0
2,1053,32406,3575883968,3575883968,0
2,1053,32407,3575883968,3575883968,0
2,1053,32408,3575883968,3575883968,0
2,1053,32409,3575883968,3575883968,0
2,1053,32410,3575883968,3575883968,0
2,1053,32411,3575883968,3575883968,0
2,1053,32412,3575883968,3575883968,0
2,1053,32413,3575883968,3575883968,0
2,1053,32414,3575883968,3575883968,0
2,1053,32415,3575883968,3575883968,0
2,1053,32416,3575883968,3575883968,0
2,1053,32417,3575883968,3575883968,0
2,1053,32418,3575883968,3575883968,0
2,1053,32419,3575883968,3575883968,0
2,1053,32420,3575883968,3575883969,1
2,1053,32421,3575883968,3575883969,1
2,1053,32422,3575883968,3575883969,1
2,1053,32423,3575883968,3575883970,2
2,1053,32424,3575883968,3575883971,3
2,1053,32425,3575883968,3575883972,4
2,1053,32426,3575883968,3575883972,4
2,1053,32427,3575883968,3575883974,6
2,1053,32428,3575883968,3575883974,6
2,1053,32429,3575883968,3575883975,7
2,1053,32430,3575883968,3575883976,8
2,1053,32431,3575883968,3575883976,8
2,1053,32432,3575883968,3575883978,10
2,1053,32433,3575883968,3575883979,11
2,1053,32434,3575883968,3575883979,11
2,1053,32435,3575883968,3575883980,12
2,1053,32436,3575883968,3575883981,13
2,1053,32437,3575883968,3575883981,13
2,1053,32438,3575883968,3575883982,14
2,1053,32439,3575883968,3575883982,14
2,1053,32440,3575883968,3575883984,16
2,1053,32441,3575883968,3575883984,16
2,1053,32442,3575883968,3575883984,16
2,1053,32443,3575883968,3575883984,16
2,1053,32444,3575883968,3575883985,17
2,1053,32445,3575883968,3575883986,18
2,1053,32446,3575883968,3575883986,18
2,1053,32447,3575883968,3575883987,19
2,1053,32448,3575883968,3575883987,19
2,1053,32449,3575883968,3575883988,20
2,1053,32450,3575883968,3575883988,20
2,1053,32451,3575883968,3575883989,21
2,1053,32452,3575883968,3575883990,22
2,1053,32453,3575883968,3575883992,24
2,1053,32454,3575883968,3575883992,24
2,1053,32455,3575883968,3575883992,24
2,1053,32456,3575883968,3575883994,26
2,1053,32457,3575883968,3575883995,27
2,1053,32458,3575883968,3575883996,28
2,1053,32459,3575883968,3575883998,30
2,1053,32460,3575883968,3575883998,30
2,1053,32461,3575883968,3575883999,31
2,1053,32462,3575883968,3575884002,34
2,1053,32463,3575883968,3575884002,34
2,1053,32464,3575883968,3575884004,36
2,1053,32465,3575883968,3575884004,36
2,1053,32466,3575883968,3575884004,36
2,1053,32467,3575883968,3575884004,36
2,1053,32468,3575883968,3575884005,37
2,1053,32469,3575883968,3575884007,39
2,1053,32470,3575883968,3575884008,40
2,1053,32471,3575883968,3575884010,42
2,1053,32472,3575883968,3575884011,43
2,1053,32473,3575883968,3575884012,44
2,1053,32474,3575883968,3575884012,44
2,1053,32475,3575883968,3575884013,45
2,1053,32476,3575883968,3575884013,45
2,1054,32477,3575884033,3575884033,0
2,1054,32478,3575884033,3575884033,0
2,1054,32479,3575884033,3575884033,0
2,1054,32480,3575884033,3575884033,0
2,1054,32481,3575884033,3575884033,0
2,1054,32482,3575884033,3575884033,0
2,1054,32483,3575884033,3575884033,0
2,1054,32484,3575884033,3575884033,0
2,1054,32485,3575884033,3575884033,0
2,1054,32486,3575884033,3575884033,0
2,1054,32487,3575884033,3575884033,0
2,1054,32488,3575884033,3575884036,3
2,1054,32489,3575884033,3575884036,3
2,1054,32490,3575884033,3575884036,3
2,1054,32491,3575884033,3575884037,4
2,1054,32492,3575884033,3575884037,4
2,1054,32493,3575884033,3575884039,6
2,1054,32494,3575884033,3575884039,6
2,1054,32495,3575884033,3575884040,7
2,1054,32496,3575884033,3575884040,7
2,1054,32497,3575884033,3575884042,9
2,1054,32498,3575884033,3575884042,9
2,1054,32499,3575884033,3575884043,10
2,1054,32500,3575884033,3575884045,12
2,1054,32501,3575884033,3575884047,14
2,1054,32502,3575884033,3575884047,14
2,1054,32503,3575884033,3575884049,16
2,1054,32504,3575884033,3575884053,20
2,1054,32505,3575884033,3575884054,21
2,1054,32506,3575884033,3575884055,22
2,1054,32507,3575884033,3575884055,22
2,1054,32508,3575884033,3575884055,22
2,1054,32509,3575884033,3575884055,22
2,1054,32510,3575884033,3575884055,22
2,1054,32511,3575884033,3575884056,23
2,1054,32512,3575884033,3575884056,23
2,1054,32513,3575884033,3575884057,24
2,1054,32514,3575884033,3575884060,27
2,1054,32515,3575884033,3575884060,27
2,1054,32516,3575884033,3575884061,28
2,1054,32517,3575884033,3575884062,29
2,1054,32518,3575884033,3575884064,31
2,1054,32519,3575884033,3575884066,33
2,1054,32520,3575884033,3575884067,34
2,1054,32521,3575884033,3575884069,36
2,1054,32522,3575884033,3575884073,40
2,1054,32523,3575884033,3575884075,42
2,1054,32524,3575884033,3575884078,45
2,1054,32525,3575884033,3575884079,46
2,1054,32526,3575884033,3575884081,48
2,1054,32527,3575884033,3575884081,48
2,1055,32528,3575884096,3575884096,0
2,1055,32529,3575884096,3575884096,0
2,1055,32530,3575884096,3575884096,0
2,1055,32531,3575884096,3575884096,0
2,1055,32532,3575884096,3575884096,0
2,1055,32533,3575884096,3575884096,0
2,1055,32534,3575884096,3575884096,0
2,1055,32535,3575884096,3575884096,0
2,1055,32536,3575884096,3575884096,0
2,1055,32537,3575884096,3575884096,0
2,1055,32538,3575884096,3575884096,0
2,1055,32539,3575884096,3575884096,0
2,1055,32540,3575884096,3575884096,0
2,1055,32541,3575884096,3575884096,0
2,1055,32542,3575884096,3575884096,0
2,1055,32543,3575884096,3575884096,0
2,1055,32544,3575884096,3575884096,0
2,1055,32545,3575884096,3575884096,0
2,1055,32546,3575884096,3575884096,0
2,1055,32547,3575884096,3575884096,0
2,1055,32548,3575884096,3575884096,0
2,1055,32549,3575884096,3575884098,2
2,1055,32550,3575884096,3575884098,2
2,1055,32551,3575884096,3575884100,4
2,1055,32552,3575884096,3575884100,4
2,1055,32553,3575884096,3575884100,4
2,1055,32554,3575884096,3575884103,7
2,1055,32555,3575884096,3575884105,9
2,1055,32556,3575884096,3575884106,10
2,1055,32557,3575884096,3575884106,10
2,1055,32558,3575884096,3575884107,11
2,1055,32559,3575884096,3575884107,11
2,1055,32560,3575884096,3575884107,11
2,1055,32561,3575884096,3575884108,12
2,1055,32562,3575884096,3575884108,12
2,1055,32563,3575884096,3575884109,13
2,1055,32564,3575884096,3575884110,14
2,1055,32565,3575884096,3575884111,15
2,1055,32566,3575884096,3575884111,15
2,1055,32567,3575884096,3575884112,16
2,1055,32568,3575884096,3575884112,16
2,1055,32569,3575884096,3575884113,17
2,1055,32570,3575884096,3575884113,17
2,1055,32571,3575884096,3575884113,17
2,1055,32572,3575884096,3575884114,18
2,1055,32573,3575884096,3575884115,19
2,1055,32574,3575884096,3575884115,19
2,1055,32575,3575884096,3575884115,19
2,1055,32576,3575884096,3575884116,20
2,1055,32577,3575884096,3575884117,21
2,1055,32578,3575884096,3575884117,21
2,1055,32579,3575884096,3575884118,22
2,1055,32580,3575884096,3575884119,23
2,1055,32581,3575884096,3575884120,24
2,1055,32582,3575884096,3575884120,24
2,1055,32583,3575884096,3575884121,25
2,1055,32584,3575884096,3575884121,25
2,1055,32585,3575884096,3575884122,26
2,1055,32586,3575884096,3575884122,26
2,1055,32587,3575884096,3575884126,30
2,1055,32588,3575884096,3575884126,30
2,1055,32589,3575884096,3575884126,30
2,1055,32590,3575884096,3575884127,31
2,1055,32591,3575884096,3575884127,31
2,1055,32592,3575884096,3575884128,32
2,1055,32593,3575884096,3575884130,34
2,1055,32594,3575884096,3575884130,34
2,1055,32595,3575884096,3575884131,35
2,1055,32596,3575884096,3575884131,35
2,1055,32597,3575884096,3575884132,36
2,1055,32598,3575884096,3575884132,36
2,1055,32599,3575884096,3575884133,37
2,1055,32600,3575884096,3575884133,37
2,1055,32601,3575884096,3575884134,38
2,1055,32602,3575884096,3575884134,38
2,1055,32603,3575884096,3575884135,39
2,1055,32604,3575884096,3575884135,39
2,1055,32605,3575884096,3575884136,40
2,1055,32606,3575884096,3575884136,40
2,1055,32607,3575884096,3575884139,43
2,1055,32608,3575884096,3575884139,43
2,1055,32609,3575884096,3575884139,43
2,1055,32610,3575884096,3575884139,43
2,1055,32611,3575884096,3575884141,45
2,1055,32612,3575884096,3575884142,46
2,1055,32613,3575884096,3575884142,46
2,1055,32614,3575884096,3575884143,47
2,1055,32615,3575884096,3575884144,48
2,1055,32616,3575884096,3575884144,48
2,1055,32617,3575884096,3575884144,48
2,1055,32618,3575884096,3575884144,48
2,1055,32619,3575884096,3575884146,50
2,1056,32620,3575884163,3575884163,0
2,1056,32621,3575884163,3575884163,0
2,1056,32622,3575884163,3575884163,0
2,1056,32623,3575884163,3575884163,0
2,1056,32624,3575884163,3575884163,0
2,1056,32625,3575884163,3575884163,0
2,1056,32626,3575884163,3575884163,0
2,1056,32627,3575884163,3575884163,0
2,1056,32628,3575884163,3575884163,0
2,1056,32629,3575884163,3575884163,0
2,1056,32630,3575884163,3575884163,0
2,1056,32631,3575884163,3575884163,0
2,1056,32632,3575884163,3575884163,0
2,1056,32633,3575884163,3575884163,0
2,1056,32634,3575884163,3575884163,0
2,1056,32635,3575884163,3575884163,0
2,1056,32636,3575884163,3575884163,0
2,1056,32637,3575884163,3575884163,0
2,1056,32638,3575884163,3575884163,0
2,1056,32639,3575884163,3575884163,0
2,1056,32640,3575884163,3575884163,0
2,1056,32641,3575884163,3575884163,0
2,1056,32642,3575884163,3575884163,0
2,1056,32643,3575884163,3575884163,0
2,1056,32644,3575884163,3575884163,0
2,1056,32645,3575884163,3575884164,1
2,1056,32646,3575884163,3575884165,2
2,1056,32647,3575884163,3575884165,2
2,1056,32648,3575884163,3575884166,3
2,1056,32649,3575884163,3575884167,4
2,1056,32650,3575884163,3575884168,5
2,1056,32651,3575884163,3575884168,5
2,1056,32652,3575884163,3575884168,5
2,1056,32653,3575884163,3575884169,6
2,1056,32654,3575884163,3575884170,7
2,1056,32655,3575884163,3575884170,7
2,1056,32656,3575884163,3575884170,7
2,1056,32657,3575884163,3575884171,8
2,1056,32658,3575884163,3575884172,9
2,1056,32659,3575884163,3575884174,11
2,1056,32660,3575884163,3575884175,12
2,1056,32661,3575884163,3575884175,12
2,1056,32662,3575884163,3575884175,12
2,1056,32663,3575884163,3575884177,14
2,1056,32664,3575884163,3575884178,15
2,1056,32665,3575884163,3575884178,15
2,1056,32666,3575884163,3575884179,16
2,1056,32667,3575884163,3575884181,18
2,1056,32668,3575884163,3575884181,18
2,1056,32669,3575884163,3575884181,18
2,1056,32670,3575884163,3575884182,19
2,1056,32671,3575884163,3575884183,20
2,1056,32672,3575884163,3575884184,21
2,1056,32673,3575884163,3575884184,21
2,1056,32674,3575884163,3575884185,22
2,1056,32675,3575884163,3575884185,22
2,1056,32676,3575884163,3575884185,22
2,1056,32677,3575884163,3575884186,23
2,1056,32678,3575884163,3575884186,23
2,1056,32679,3575884163,3575884186,23
2,1056,32680,3575884163,3575884187,24
2,1056,32681,3575884163,3575884188,25
2,1056,32682,3575884163,3575884189,26
2,1056,32683,3575884163,3575884190,27
2,1056,32684,3575884163,3575884190,27
2,1056,32685,3575884163,3575884191,28
2,1056,32686,3575884163,3575884192,29
2,1056,32687,3575884163,3575884192,29
2,1056,32688,3575884163,3575884192,29
2,1056,32689,3575884163,3575884197,34
2,1056,32690,3575884163,3575884197,34
2,1056,32691,3575884163,3575884198,35
2,1056,32692,3575884163,3575884199,36
2,1056,32693,3575884163,3575884199,36
2,1056,32694,3575884163,3575884201,38
2,1056,32695,3575884163,3575884202,39
2,1056,32696,3575884163,3575884203,40
2,1056,32697,3575884163,3575884203,40
2,1056,32698,3575884163,3575884204,41
2,1056,32699,3575884163,3575884204,41
2,1056,32700,3575884163,3575884205,42
2,1056,32701,3575884163,3575884207,44
2,1056,32702,3575884163,3575884208,45
2,1056,32703,3575884163,3575884210,47
2,1056,32704,3575884163,3575884211,48
2,1056,32705,3575884163,3575884212,49
2,1056,32706,3575884163,3575884212,49
2,1057,32707,3575884227,3575884227,0
2,1057,32708,3575884227,3575884227,0
2,1057,32709,3575884227,3575884227,0
2,1057,32710,3575884227,3575884227,0
2,1057,32711,3575884227,3575884227,0
2,1057,32712,3575884227,3575884227,0
2,1057,32713,3575884227,3575884227,0
2,1057,32714,3575884227,3575884227,0
2,1057,32715,3575884227,3575884227,0
2,1057,32716,3575884227,3575884227,0
2,1057,32717,3575884227,3575884227,0
2,1057,32718,3575884227,3575884228,1
2,1057,32719,3575884227,3575884229,2
2,1057,32720,3575884227,3575884230,3
2,1057,32721,3575884227,3575884235,8
2,1057,32722,3575884227,3575884237,10
2,1057,32723,3575884227,3575884237,10
2,1057,32724,3575884227,3575884237,10
2,1057,32725,3575884227,3575884238,11
2,1057,32726,3575884227,3575884239,12
2,1057,32727,3575884227,3575884240,13
2,1057,32728,3575884227,3575884240,13
2,1057,32729,3575884227,3575884240,13
2,1057,32730,3575884227,3575884242,15
2,1057,32731,3575884227,3575884243,16
2,1057,32732,3575884227,3575884243,16
2,1057,32733,3575884227,3575884245,18
2,1057,32734,3575884227,3575884247,20
2,1057,32735,3575884227,3575884247,20
2,1057,32736,3575884227,3575884249,22
2,1057,32737,3575884227,3575884253,26
2,1057,32738,3575884227,3575884253,26
2,1057,32739,3575884227,3575884254,27
2,1057,32740,3575884227,3575884255,28
2,1057,32741,3575884227,3575884255,28
2,1057,32742,3575884227,3575884255,28
2,1057,32743,3575884227,3575884256,29
2,1057,32744,3575884227,3575884256,29
2,1057,32745,3575884227,3575884256,29
2,1057,32746,3575884227,3575884257,30
2,1057,32747,3575884227,3575884260,33
2,1057,32748,3575884227,3575884260,33
2,1057,32749,3575884227,3575884261,34
2,1057,32750,3575884227,3575884262,35
2,1057,32751,3575884227,3575884264,37
2,1057,32752,3575884227,3575884267,40
2,1057,32753,3575884227,3575884269,42
2,1057,32754,3575884227,3575884273,46
2,1057,32755,3575884227,3575884275,48
2,1058,32756,3575884292,3575884292,0
2,1058,32757,3575884292,3575884292,0
2,1058,32758,3575884292,3575884292,0
2,1058,32759,3575884292,3575884292,0
2,1058,32760,3575884292,3575884292,0
2,1058,32761,3575884292,3575884292,0
2,1058,32762,3575884292,3575884292,0
2,1058,32763,3575884292,3575884292,0
2,1058,32764,3575884292,3575884292,0
2,1058,32765,3575884292,3575884293,1
2,1058,32766,3575884292,3575884293,1
2,1058,32767,3575884292,3575884293,1
2,1058,32768,3575884292,3575884293,1
2,1058,32769,3575884292,3575884293,1
2,1058,32770,3575884292,3575884293,1
2,1058,32771,3575884292,3575884293,1
2,1058,32772,3575884292,3575884293,1
2,1058,32773,3575884292,3575884293,1
2,1058,32774,3575884292,3575884293,1
2,1058,32775,3575884292,3575884293,1
2,1058,32776,3575884292,3575884293,1
2,1058,32777,3575884292,3575884293,1
2,1058,32778,3575884292,3575884294,2
2,1058,32779,3575884292,3575884295,3
2,1058,32780,3575884292,3575884297,5
2,1058,32781,3575884292,3575884298,6
2,1058,32782,3575884292,3575884298,6
2,1058,32783,3575884292,3575884300,8
2,1058,32784,3575884292,3575884300,8
2,1058,32785,3575884292,3575884301,9
2,1058,32786,3575884292,3575884304,12
2,1058,32787,3575884292,3575884305,13
2,1058,32788,3575884292,3575884307,15
2,1058,32789,3575884292,3575884307,15
2,1058,32790,3575884292,3575884307,15
2,1058,32791,3575884292,3575884307,15
2,1058,32792,3575884292,3575884307,15
2,1058,32793,3575884292,3575884308,16
2,1058,32794,3575884292,3575884308,16
2,1058,32795,3575884292,3575884309,17
2,1058,32796,3575884292,3575884311,19
2,1058,32797,3575884292,3575884311,19
2,1058,32798,3575884292,3575884312,20
2,1058,32799,3575884292,3575884312,20
2,1058,32800,3575884292,3575884312,20
2,1058,32801,3575884292,3575884313,21
2,1058,32802,3575884292,3575884313,21
2,1058,32803,3575884292,3575884314,22
2,1058,32804,3575884292,3575884314,22
2,1058,32805,3575884292,3575884314,22
2,1058,32806,3575884292,3575884315,23
2,1058,32807,3575884292,3575884316,24
2,1058,32808,3575884292,3575884316,24
2,1058,32809,3575884292,3575884318,26
2,1058,32810,3575884292,3575884318,26
2,1058,32811,3575884292,3575884319,27
2,1058,32812,3575884292,3575884320,28
2,1058,32813,3575884292,3575884321,29
2,1058,32814,3575884292,3575884321,29
2,1058,32815,3575884292,3575884322,30
2,1058,32816,3575884292,3575884322,30
2,1058,32817,3575884292,3575884323,31
2,1058,32818,3575884292,3575884326,34
2,1058,32819,3575884292,3575884326,34
2,1058,32820,3575884292,3575884326,34
2,1058,32821,3575884292,3575884327,35
2,1058,32822,3575884292,3575884327,35
2,1058,32823,3575884292,3575884328,36
2,1058,32824,3575884292,3575884330,38
2,1058,32825,3575884292,3575884330,38
2,1058,32826,3575884292,3575884331,39
2,1058,32827,3575884292,3575884331,39
2,1058,32828,3575884292,3575884332,40
2,1058,32829,3575884292,3575884332,40
2,1058,32830,3575884292,3575884332,40
2,1058,32831,3575884292,3575884333,41
2,1058,32832,3575884292,3575884334,42
2,1058,32833,3575884292,3575884334,42
2,1058,32834,3575884292,3575884335,43
2,1058,32835,3575884292,3575884335,43
2,1058,32836,3575884292,3575884336,44
2,1058,32837,3575884292,3575884336,44
2,1058,32838,3575884292,3575884336,44
2,1058,32839,3575884292,3575884336,44
2,1058,32840,3575884292,3575884339,47
2,1058,32841,3575884292,3575884340,48
2,1058,32842,3575884292,3575884340,48
2,1058,32843,3575884292,3575884340,48
2,1058,32844,3575884292,3575884340,48
2,1058,32845,3575884292,3575884342,50
2,1059,32846,3575884356,3575884356,0
2,1059,32847,3575884356,3575884356,0
2,1059,32848,3575884356,3575884356,0
2,1059,32849,3575884356,3575884356,0
2,1059,32850,3575884356,3575884356,0
2,1059,32851,3575884356,3575884356,0
2,1059,32852,3575884356,3575884356,0
2,1059,32853,3575884356,3575884356,0
2,1059,32854,3575884356,3575884356,0
2,1059,32855,3575884356,3575884356,0
2,1059,32856,3575884356,3575884356,0
2,1059,32857,3575884356,3575884356,0
2,1059,32858,3575884356,3575884356,0
2,1059,32859,3575884356,3575884356,0
2,1059,32860,3575884356,3575884356,0
2,1059,32861,3575884356,3575884356,0
2,1059,32862,3575884356,3575884356,0
2,1059,32863,3575884356,3575884356,0
2,1059,32864,3575884356,3575884356,0
2,1059,32865,3575884356,3575884356,0
2,1059,32866,3575884356,3575884357,1
2,1059,32867,3575884356,3575884357,1
2,1059,32868,3575884356,3575884358,2
2,1059,32869,3575884356,3575884359,3
2,1059,32870,3575884356,3575884359,3
2,1059,32871,3575884356,3575884360,4
2,1059,32872,3575884356,3575884361,5
2,1059,32873,3575884356,3575884361,5
2,1059,32874,3575884356,3575884362,6
2,1059,32875,3575884356,3575884363,7
2,1059,32876,3575884356,3575884363,7
2,1059,32877,3575884356,3575884365,9
2,1059,32878,3575884356,3575884366,10
2,1059,32879,3575884356,3575884366,10
2,1059,32880,3575884356,3575884367,11
2,1059,32881,3575884356,3575884368,12
2,1059,32882,3575884356,3575884368,12
2,1059,32883,3575884356,3575884369,13
2,1059,32884,3575884356,3575884369,13
2,1059,32885,3575884356,3575884369,13
2,1059,32886,3575884356,3575884370,14
2,1059,32887,3575884356,3575884370,14
2,1059,32888,3575884356,3575884371,15
2,1059,32889,3575884356,3575884373,17
2,1059,32890,3575884356,3575884374,18
2,1059,32891,3575884356,3575884375,19
2,1059,32892,3575884356,3575884375,19
2,1059,32893,3575884356,3575884375,19
2,1059,32894,3575884356,3575884376,20
2,1059,32895,3575884356,3575884378,22
2,1059,32896,3575884356,3575884378,22
2,1059,32897,3575884356,3575884379,23
2,1059,32898,3575884356,3575884379,23
2,1059,32899,3575884356,3575884381,25
2,1059,32900,3575884356,3575884381,25
2,1059,32901,3575884356,3575884381,25
2,1059,32902,3575884356,3575884382,26
2,1059,32903,3575884356,3575884383,27
2,1059,32904,3575884356,3575884383,27
2,1059,32905,3575884356,3575884384,28
2,1059,32906,3575884356,3575884385,29
2,1059,32907,3575884356,3575884385,29
2,1059,32908,3575884356,3575884385,29
2,1059,32909,3575884356,3575884385,29
2,1059,32910,3575884356,3575884386,30
2,1059,32911,3575884356,3575884386,30
2,1059,32912,3575884356,3575884387,31
2,1059,32913,3575884356,3575884387,31
2,1059,32914,3575884356,3575884388,32
2,1059,32915,3575884356,3575884389,33
2,1059,32916,3575884356,3575884390,34
2,1059,32917,3575884356,3575884390,34
2,1059,32918,3575884356,3575884391,35
2,1059,32919,3575884356,3575884392,36
2,1059,32920,3575884356,3575884392,36
2,1059,32921,3575884356,3575884394,38
2,1059,32922,3575884356,3575884397,41
2,1059,32923,3575884356,3575884399,43
2,1059,32924,3575884356,3575884399,43
2,1059,32925,3575884356,3575884399,43
2,1059,32926,3575884356,3575884402,46
2,1059,32927,3575884356,3575884402,46
2,1059,32928,3575884356,3575884403,47
2,1059,32929,3575884356,3575884404,48
2,1059,32930,3575884356,3575884404,48
2,1059,32931,3575884356,3575884404,48
2,1059,32932,3575884356,3575884406,50
2,1060,32933,3575884424,3575884424,0
2,1060,32934,3575884424,3575884424,0
2,1060,32935,3575884424,3575884424,0
2,1060,32936,3575884424,3575884424,0
2,1060,32937,3575884424,3575884424,0
2,1060,32938,3575884424,3575884424,0
2,1060,32939,3575884424,3575884424,0
2,1060,32940,3575884424,3575884424,0
2,1060,32941,3575884424,3575884424,0
2,1060,32942,3575884424,3575884424,0
2,1060,32943,3575884424,3575884424,0
2,1060,32944,3575884424,3575884424,0
2,1060,32945,3575884424,3575884425,1
2,1060,32946,3575884424,3575884426,2
2,1060,32947,3575884424,3575884427,3
2,1060,32948,3575884424,3575884428,4
2,1060,32949,3575884424,3575884429,5
2,1060,32950,3575884424,3575884429,5
2,1060,32951,3575884424,3575884430,6
2,1060,32952,3575884424,3575884430,6
2,1060,32953,3575884424,3575884435,11
2,1060,32954,3575884424,3575884437,13
2,1060,32955,3575884424,3575884437,13
2,1060,32956,3575884424,3575884437,13
2,1060,32957,3575884424,3575884437,13
2,1060,32958,3575884424,3575884438,14
2,1060,32959,3575884424,3575884438,14
2,1060,32960,3575884424,3575884439,15
2,1060,32961,3575884424,3575884440,16
2,1060,32962,3575884424,3575884440,16
2,1060,32963,3575884424,3575884440,16
2,1060,32964,3575884424,3575884440,16
2,1060,32965,3575884424,3575884442,18
2,1060,32966,3575884424,3575884443,19
2,1060,32967,3575884424,3575884443,19
2,1060,32968,3575884424,3575884447,23
2,1060,32969,3575884424,3575884447,23
2,1060,32970,3575884424,3575884447,23
2,1060,32971,3575884424,3575884449,25
2,1060,32972,3575884424,3575884453,29
2,1060,32973,3575884424,3575884454,30
2,1060,32974,3575884424,3575884455,31
2,1060,32975,3575884424,3575884455,31
2,1060,32976,3575884424,3575884455,31
2,1060,32977,3575884424,3575884456,32
2,1060,32978,3575884424,3575884456,32
2,1060,32979,3575884424,3575884456,32
2,1060,32980,3575884424,3575884456,32
2,1060,32981,3575884424,3575884456,32
2,1060,32982,3575884424,3575884461,37
2,1060,32983,3575884424,3575884461,37
2,1060,32984,3575884424,3575884462,38
2,1060,32985,3575884424,3575884464,40
2,1060,32986,3575884424,3575884467,43
2,1060,32987,3575884424,3575884469,45
2,1061,32988,3575884486,3575884486,0
2,1061,32989,3575884486,3575884486,0
2,1061,32990,3575884486,3575884486,0
2,1061,32991,3575884486,3575884486,0
2,1061,32992,3575884486,3575884486,0
2,1061,32993,3575884486,3575884486,0
2,1061,32994,3575884486,3575884486,0
2,1061,32995,3575884486,3575884486,0
2,1061,32996,3575884486,3575884486,0
2,1061,32997,3575884486,3575884486,0
2,1061,32998,3575884486,3575884486,0
2,1061,32999,3575884486,3575884486,0
2,1061,33000,3575884486,3575884486,0
2,1061,33001,3575884486,3575884488,2
2,1061,33002,3575884486,3575884489,3
2,1061,33003,3575884486,3575884489,3
2,1061,33004,3575884486,3575884489,3
2,1061,33005,3575884486,3575884489,3
2,1061,33006,3575884486,3575884490,4
2,1061,33007,3575884486,3575884491,5
2,1061,33008,3575884486,3575884491,5
2,1061,33009,3575884486,3575884491,5
2,1061,33010,3575884486,3575884491,5
2,1061,33011,3575884486,3575884493,7
2,1061,33012,3575884486,3575884493,7
2,1061,33013,3575884486,3575884493,7
2,1061,33014,3575884486,3575884493,7
2,1061,33015,3575884486,3575884494,8
2,1061,33016,3575884486,3575884497,11
2,1061,33017,3575884486,3575884497,11
2,1061,33018,3575884486,3575884497,11
2,1061,33019,3575884486,3575884499,13
2,1061,33020,3575884486,3575884499,13
2,1061,33021,3575884486,3575884499,13
2,1061,33022,3575884486,3575884503,17
2,1061,33023,3575884486,3575884504,18
2,1061,33024,3575884486,3575884504,18
2,1061,33025,3575884486,3575884505,19
2,1061,33026,3575884486,3575884506,20
2,1061,33027,3575884486,3575884506,20
2,1061,33028,3575884486,3575884507,21
2,1061,33029,3575884486,3575884507,21
2,1061,33030,3575884486,3575884507,21
2,1061,33031,3575884486,3575884507,21
2,1061,33032,3575884486,3575884508,22
2,1061,33033,3575884486,3575884508,22
2,1061,33034,3575884486,3575884509,23
2,1061,33035,3575884486,3575884510,24
2,1061,33036,3575884486,3575884511,25
2,1061,33037,3575884486,3575884511,25
2,1061,33038,3575884486,3575884511,25
2,1061,33039,3575884486,3575884512,26
2,1061,33040,3575884486,3575884512,26
2,1061,33041,3575884486,3575884513,27
2,1061,33042,3575884486,3575884514,28
2,1061,33043,3575884486,3575884514,28
2,1061,33044,3575884486,3575884514,28
2,1061,33045,3575884486,3575884515,29
2,1061,33046,3575884486,3575884515,29
2,1061,33047,3575884486,3575884517,31
2,1061,33048,3575884486,3575884517,31
2,1061,33049,3575884486,3575884518,32
2,1061,33050,3575884486,3575884519,33
2,1061,33051,3575884486,3575884519,33
2,1061,33052,3575884486,3575884519,33
2,1061,33053,3575884486,3575884520,34
2,1061,33054,3575884486,3575884520,34
2,1061,33055,3575884486,3575884520,34
2,1061,33056,3575884486,3575884521,35
2,1061,33057,3575884486,3575884522,36
2,1061,33058,3575884486,3575884525,39
2,1061,33059,3575884486,3575884526,40
2,1061,33060,3575884486,3575884526,40
2,1061,33061,3575884486,3575884526,40
2,1061,33062,3575884486,3575884526,40
2,1061,33063,3575884486,3575884528,42
2,1061,33064,3575884486,3575884529,43
2,1061,33065,3575884486,3575884530,44
2,1061,33066,3575884486,3575884530,44
2,1061,33067,3575884486,3575884531,45
2,1061,33068,3575884486,3575884531,45
2,1061,33069,3575884486,3575884532,46
2,1061,33070,3575884486,3575884532,46
2,1061,33071,3575884486,3575884532,46
2,1061,33072,3575884486,3575884533,47
2,1061,33073,3575884486,3575884534,48
2,1061,33074,3575884486,3575884534,48
2,1061,33075,3575884486,3575884535,49
2,1061,33076,3575884486,3575884535,49
2,1061,33077,3575884486,3575884535,49
2,1061,33078,3575884486,3575884536,50
2,1062,33079,3575884552,3575884552,0
2,1062,33080,3575884552,3575884552,0
2,1062,33081,3575884552,3575884552,0
2,1062,33082,3575884552,3575884552,0
2,1062,33083,3575884552,3575884552,0
2,1062,33084,3575884552,3575884552,0
2,1062,33085,3575884552,3575884552,0
2,1062,33086,3575884552,3575884552,0
2,1062,33087,3575884552,3575884552,0
2,1062,33088,3575884552,3575884552,0
2,1062,33089,3575884552,3575884552,0
2,1062,33090,3575884552,3575884552,0
2,1062,33091,3575884552,3575884552,0
2,1062,33092,3575884552,3575884552,0
2,1062,33093,3575884552,3575884552,0
2,1062,33094,3575884552,3575884552,0
2,1062,33095,3575884552,3575884552,0
2,1062,33096,3575884552,3575884552,0
2,1062,33097,3575884552,3575884552,0
2,1062,33098,3575884552,3575884552,0
2,1062,33099,3575884552,3575884552,0
2,1062,33100,3575884552,3575884552,0
2,1062,33101,3575884552,3575884552,0
2,1062,33102,3575884552,3575884553,1
2,1062,33103,3575884552,3575884553,1
2,1062,33104,3575884552,3575884554,2
2,1062,33105,3575884552,3575884555,3
2,1062,33106,3575884552,3575884557,5
2,1062,33107,3575884552,3575884557,5
2,1062,33108,3575884552,3575884558,6
2,1062,33109,3575884552,3575884559,7
2,1062,33110,3575884552,3575884559,7
2,1062,33111,3575884552,3575884559,7
2,1062,33112,3575884552,3575884559,7
2,1062,33113,3575884552,3575884561,9
2,1062,33114,3575884552,3575884562,10
2,1062,33115,3575884552,3575884563,11
2,1062,33116,3575884552,3575884565,13
2,1062,33117,3575884552,3575884566,14
2,1062,33118,3575884552,3575884566,14
2,1062,33119,3575884552,3575884566,14
2,1062,33120,3575884552,3575884567,15
2,1062,33121,3575884552,3575884567,15
2,1062,33122,3575884552,3575884567,15
2,1062,33123,3575884552,3575884568,16
2,1062,33124,3575884552,3575884568,16
2,1062,33125,3575884552,3575884569,17
2,1062,33126,3575884552,3575884570,18
2,1062,33127,3575884552,3575884572,20
2,1062,33128,3575884552,3575884572,20
2,1062,33129,3575884552,3575884573,21
2,1062,33130,3575884552,3575884574,22
2,1062,33131,3575884552,3575884574,22
2,1062,33132,3575884552,3575884576,24
2,1062,33133,3575884552,3575884576,24
2,1062,33134,3575884552,3575884577,25
2,1062,33135,3575884552,3575884577,25
2,1062,33136,3575884552,3575884578,26
2,1062,33137,3575884552,3575884578,26
2,1062,33138,3575884552,3575884579,27
2,1062,33139,3575884552,3575884580,28
2,1062,33140,3575884552,3575884580,28
2,1062,33141,3575884552,3575884581,29
2,1062,33142,3575884552,3575884583,31
2,1062,33143,3575884552,3575884583,31
2,1062,33144,3575884552,3575884583,31
2,1062,33145,3575884552,3575884584,32
2,1062,33146,3575884552,3575884584,32
2,1062,33147,3575884552,3575884584,32
2,1062,33148,3575884552,3575884585,33
2,1062,33149,3575884552,3575884585,33
2,1062,33150,3575884552,3575884585,33
2,1062,33151,3575884552,3575884586,34
2,1062,33152,3575884552,3575884587,35
2,1062,33153,3575884552,3575884588,36
2,1062,33154,3575884552,3575884588,36
2,1062,33155,3575884552,3575884590,38
2,1062,33156,3575884552,3575884590,38
2,1062,33157,3575884552,3575884591,39
2,1062,33158,3575884552,3575884593,41
2,1062,33159,3575884552,3575884595,43
2,1062,33160,3575884552,3575884595,43
2,1062,33161,3575884552,3575884597,45
2,1062,33162,3575884552,3575884598,46
2,1062,33163,3575884552,3575884598,46
2,1062,33164,3575884552,3575884601,49
2,1062,33165,3575884552,3575884601,49
2,1062,33166,3575884552,3575884602,50
2,1063,33167,3575884613,3575884613,0
2,1063,33168,3575884613,3575884613,0
2,1063,33169,3575884613,3575884613,0
2,1063,33170,3575884613,3575884613,0
2,1063,33171,3575884613,3575884613,0
2,1063,33172,3575884613,3575884613,0
2,1063,33173,3575884613,3575884613,0
2,1063,33174,3575884613,3575884613,0
2,1063,33175,3575884613,3575884613,0
2,1063,33176,3575884613,3575884613,0
2,1063,33177,3575884613,3575884613,0
2,1063,33178,3575884613,3575884613,0
2,1063,33179,3575884613,3575884613,0
2,1063,33180,3575884613,3575884619,6
2,1063,33181,3575884613,3575884620,7
2,1063,33182,3575884613,3575884621,8
2,1063,33183,3575884613,3575884621,8
2,1063,33184,3575884613,3575884622,9
2,1063,33185,3575884613,3575884623,10
2,1063,33186,3575884613,3575884623,10
2,1063,33187,3575884613,3575884625,12
2,1063,33188,3575884613,3575884626,13
2,1063,33189,3575884613,3575884627,14
2,1063,33190,3575884613,3575884628,15
2,1063,33191,3575884613,3575884628,15
2,1063,33192,3575884613,3575884630,17
2,1063,33193,3575884613,3575884630,17
2,1063,33194,3575884613,3575884635,22
2,1063,33195,3575884613,3575884636,23
2,1063,33196,3575884613,3575884636,23
2,1063,33197,3575884613,3575884636,23
2,1063,33198,3575884613,3575884637,24
2,1063,33199,3575884613,3575884637,24
2,1063,33200,3575884613,3575884637,24
2,1063,33201,3575884613,3575884638,25
2,1063,33202,3575884613,3575884638,25
2,1063,33203,3575884613,3575884638,25
2,1063,33204,3575884613,3575884639,26
2,1063,33205,3575884613,3575884640,27
2,1063,33206,3575884613,3575884641,28
2,1063,33207,3575884613,3575884641,28
2,1063,33208,3575884613,3575884643,30
2,1063,33209,3575884613,3575884646,33
2,1063,33210,3575884613,3575884646,33
2,1063,33211,3575884613,3575884646,33
2,1063,33212,3575884613,3575884648,35
2,1063,33213,3575884613,3575884652,39
2,1063,33214,3575884613,3575884653,40
2,1063,33215,3575884613,3575884654,41
2,1063,33216,3575884613,3575884654,41
2,1063,33217,3575884613,3575884654,41
2,1063,33218,3575884613,3575884654,41
2,1063,33219,3575884613,3575884654,41
2,1063,33220,3575884613,3575884655,42
2,1063,33221,3575884613,3575884655,42
2,1063,33222,3575884613,3575884656,43
2,1063,33223,3575884613,3575884660,47
2,1063,33224,3575884613,3575884660,47
2,1063,33225,3575884613,3575884662,49
2,1064,33226,3575884676,3575884676,0
2,1064,33227,3575884676,3575884676,0
2,1064,33228,3575884676,3575884676,0
2,1064,33229,3575884676,3575884676,0
2,1064,33230,3575884676,3575884676,0
2,1064,33231,3575884676,3575884678,2
2,1064,33232,3575884676,3575884679,3
2,1064,33233,3575884676,3575884679,3
2,1064,33234,3575884676,3575884682,6
2,1064,33235,3575884676,3575884684,8
2,1064,33236,3575884676,3575884685,9
2,1064,33237,3575884676,3575884685,9
2,1064,33238,3575884676,3575884685,9
2,1064,33239,3575884676,3575884685,9
2,1064,33240,3575884676,3575884685,9
2,1064,33241,3575884676,3575884685,9
2,1064,33242,3575884676,3575884688,12
2,1064,33243,3575884676,3575884689,13
2,1064,33244,3575884676,3575884689,13
2,1064,33245,3575884676,3575884689,13
2,1064,33246,3575884676,3575884689,13
2,1064,33247,3575884676,3575884690,14
2,1064,33248,3575884676,3575884691,15
2,1064,33249,3575884676,3575884691,15
2,1064,33250,3575884676,3575884692,16
2,1064,33251,3575884676,3575884692,16
2,1064,33252,3575884676,3575884692,16
2,1064,33253,3575884676,3575884693,17
2,1064,33254,3575884676,3575884693,17
2,1064,33255,3575884676,3575884694,18
2,1064,33256,3575884676,3575884694,18
2,1064,33257,3575884676,3575884697,21
2,1064,33258,3575884676,3575884698,22
2,1064,33259,3575884676,3575884699,23
2,1064,33260,3575884676,3575884699,23
2,1064,33261,3575884676,3575884700,24
2,1064,33262,3575884676,3575884701,25
2,1064,33263,3575884676,3575884704,28
2,1064,33264,3575884676,3575884705,29
2,1064,33265,3575884676,3575884705,29
2,1064,33266,3575884676,3575884705,29
2,1064,33267,3575884676,3575884706,30
2,1064,33268,3575884676,3575884707,31
2,1064,33269,3575884676,3575884707,31
2,1064,33270,3575884676,3575884708,32
2,1064,33271,3575884676,3575884708,32
2,1064,33272,3575884676,3575884709,33
2,1064,33273,3575884676,3575884709,33
2,1064,33274,3575884676,3575884709,33
2,1064,33275,3575884676,3575884709,33
2,1064,33276,3575884676,3575884710,34
2,1064,33277,3575884676,3575884710,34
2,1064,33278,3575884676,3575884710,34
2,1064,33279,3575884676,3575884711,35
2,1064,33280,3575884676,3575884711,35
2,1064,33281,3575884676,3575884712,36
2,1064,33282,3575884676,3575884712,36
2,1064,33283,3575884676,3575884713,37
2,1064,33284,3575884676,3575884713,37
2,1064,33285,3575884676,3575884714,38
2,1064,33286,3575884676,3575884714,38
2,1064,33287,3575884676,3575884714,38
2,1064,33288,3575884676,3575884716,40
2,1064,33289,3575884676,3575884717,41
2,1064,33290,3575884676,3575884717,41
2,1064,33291,3575884676,3575884718,42
2,1064,33292,3575884676,3575884719,43
2,1064,33293,3575884676,3575884719,43
2,1064,33294,3575884676,3575884720,44
2,1064,33295,3575884676,3575884720,44
2,1064,33296,3575884676,3575884720,44
2,1064,33297,3575884676,3575884720,44
2,1064,33298,3575884676,3575884721,45
2,1064,33299,3575884676,3575884722,46
2,1064,33300,3575884676,3575884725,49
2,1064,33301,3575884676,3575884725,49
2,1064,33302,3575884676,3575884726,50
2,1065,33303,3575884741,3575884741,0
2,1065,33304,3575884741,3575884741,0
2,1065,33305,3575884741,3575884741,0
2,1065,33306,3575884741,3575884741,0
2,1065,33307,3575884741,3575884741,0
2,1065,33308,3575884741,3575884741,0
2,1065,33309,3575884741,3575884741,0
2,1065,33310,3575884741,3575884741,0
2,1065,33311,3575884741,3575884741,0
2,1065,33312,3575884741,3575884741,0
2,1065,33313,3575884741,3575884741,0
2,1065,33314,3575884741,3575884741,0
2,1065,33315,3575884741,3575884741,0
2,1065,33316,3575884741,3575884741,0
2,1065,33317,3575884741,3575884741,0
2,1065,33318,3575884741,3575884741,0
2,1065,33319,3575884741,3575884741,0
2,1065,33320,3575884741,3575884741,0
2,1065,33321,3575884741,3575884741,0
2,1065,33322,3575884741,3575884741,0
2,1065,33323,3575884741,3575884741,0
2,1065,33324,3575884741,3575884741,0
2,1065,33325,3575884741,3575884741,0
2,1065,33326,3575884741,3575884741,0
2,1065,33327,3575884741,3575884741,0
2,1065,33328,3575884741,3575884741,0
2,1065,33329,3575884741,3575884741,0
2,1065,33330,3575884741,3575884742,1
2,1065,33331,3575884741,3575884743,2
2,1065,33332,3575884741,3575884744,3
2,1065,33333,3575884741,3575884744,3
2,1065,33334,3575884741,3575884745,4
2,1065,33335,3575884741,3575884745,4
2,1065,33336,3575884741,3575884745,4
2,1065,33337,3575884741,3575884745,4
2,1065,33338,3575884741,3575884746,5
2,1065,33339,3575884741,3575884747,6
2,1065,33340,3575884741,3575884748,7
2,1065,33341,3575884741,3575884749,8
2,1065,33342,3575884741,3575884749,8
2,1065,33343,3575884741,3575884749,8
2,1065,33344,3575884741,3575884750,9
2,1065,33345,3575884741,3575884751,10
2,1065,33346,3575884741,3575884751,10
2,1065,33347,3575884741,3575884751,10
2,1065,33348,3575884741,3575884753,12
2,1065,33349,3575884741,3575884753,12
2,1065,33350,3575884741,3575884754,13
2,1065,33351,3575884741,3575884756,15
2,1065,33352,3575884741,3575884756,15
2,1065,33353,3575884741,3575884759,18
2,1065,33354,3575884741,3575884759,18
2,1065,33355,3575884741,3575884759,18
2,1065,33356,3575884741,3575884759,18
2,1065,33357,3575884741,3575884760,19
2,1065,33358,3575884741,3575884760,19
2,1065,33359,3575884741,3575884762,21
2,1065,33360,3575884741,3575884762,21
2,1065,33361,3575884741,3575884764,23
2,1065,33362,3575884741,3575884765,24
2,1065,33363,3575884741,3575884765,24
2,1065,33364,3575884741,3575884766,25
2,1065,33365,3575884741,3575884766,25
2,1065,33366,3575884741,3575884767,26
2,1065,33367,3575884741,3575884767,26
2,1065,33368,3575884741,3575884768,27
2,1065,33369,3575884741,3575884769,28
2,1065,33370,3575884741,3575884769,28
2,1065,33371,3575884741,3575884770,29
2,1065,33372,3575884741,3575884771,30
2,1065,33373,3575884741,3575884772,31
2,1065,33374,3575884741,3575884772,31
2,1065,33375,3575884741,3575884773,32
2,1065,33376,3575884741,3575884774,33
2,1065,33377,3575884741,3575884774,33
2,1065,33378,3575884741,3575884776,35
2,1065,33379,3575884741,3575884776,35
2,1065,33380,3575884741,3575884777,36
2,1065,33381,3575884741,3575884778,37
2,1065,33382,3575884741,3575884778,37
2,1065,33383,3575884741,3575884779,38
2,1065,33384,3575884741,3575884780,39
2,1065,33385,3575884741,3575884780,39
2,1065,33386,3575884741,3575884780,39
2,1065,33387,3575884741,3575884780,39
2,1065,33388,3575884741,3575884782,41
2,1065,33389,3575884741,3575884783,42
2,1065,33390,3575884741,3575884784,43
2,1065,33391,3575884741,3575884784,43
2,1065,33392,3575884741,3575884784,43
2,1065,33393,3575884741,3575884784,43
2,1065,33394,3575884741,3575884784,43
2,1065,33395,3575884741,3575884785,44
2,1065,33396,3575884741,3575884785,44
2,1065,33397,3575884741,3575884786,45
2,1065,33398,3575884741,3575884788,47
2,1065,33399,3575884741,3575884788,47
2,1065,33400,3575884741,3575884790,49
2,1065,33401,3575884741,3575884790,49
2,1065,33402,3575884741,3575884792,51
2,1066,33403,3575884806,3575884806,0
2,1066,33404,3575884806,3575884806,0
2,1066,33405,3575884806,3575884806,0
2,1066,33406,3575884806,3575884806,0
2,1066,33407,3575884806,3575884806,0
2,1066,33408,3575884806,3575884806,0
2,1066,33409,3575884806,3575884806,0
2,1066,33410,3575884806,3575884806,0
2,1066,33411,3575884806,3575884806,0
2,1066,33412,3575884806,3575884806,0
2,1066,33413,3575884806,3575884806,0
2,1066,33414,3575884806,3575884806,0
2,1066,33415,3575884806,3575884806,0
2,1066,33416,3575884806,3575884806,0
2,1066,33417,3575884806,3575884808,2
2,1066,33418,3575884806,3575884809,3
2,1066,33419,3575884806,3575884810,4
2,1066,33420,3575884806,3575884811,5
2,1066,33421,3575884806,3575884812,6
2,1066,33422,3575884806,3575884813,7
2,1066,33423,3575884806,3575884813,7
2,1066,33424,3575884806,3575884819,13
2,1066,33425,3575884806,3575884821,15
2,1066,33426,3575884806,3575884821,15
2,1066,33427,3575884806,3575884821,15
2,1066,33428,3575884806,3575884822,16
2,1066,33429,3575884806,3575884823,17
2,1066,33430,3575884806,3575884824,18
2,1066,33431,3575884806,3575884825,19
2,1066,33432,3575884806,3575884826,20
2,1066,33433,3575884806,3575884827,21
2,1066,33434,3575884806,3575884829,23
2,1066,33435,3575884806,3575884829,23
2,1066,33436,3575884806,3575884829,23
2,1066,33437,3575884806,3575884830,24
2,1066,33438,3575884806,3575884835,29
2,1066,33439,3575884806,3575884835,29
2,1066,33440,3575884806,3575884836,30
2,1066,33441,3575884806,3575884837,31
2,1066,33442,3575884806,3575884837,31
2,1066,33443,3575884806,3575884837,31
2,1066,33444,3575884806,3575884838,32
2,1066,33445,3575884806,3575884839,33
2,1066,33446,3575884806,3575884839,33
2,1066,33447,3575884806,3575884839,33
2,1066,33448,3575884806,3575884840,34
2,1066,33449,3575884806,3575884841,35
2,1066,33450,3575884806,3575884841,35
2,1066,33451,3575884806,3575884843,37
2,1066,33452,3575884806,3575884846,40
2,1066,33453,3575884806,3575884847,41
2,1066,33454,3575884806,3575884847,41
2,1066,33455,3575884806,3575884849,43
2,1066,33456,3575884806,3575884852,46
2,1066,33457,3575884806,3575884853,47
2,1066,33458,3575884806,3575884854,48
2,1066,33459,3575884806,3575884854,48
2,1066,33460,3575884806,3575884854,48
2,1066,33461,3575884806,3575884855,49
2,1066,33462,3575884806,3575884855,49
2,1066,33463,3575884806,3575884855,49
2,1066,33464,3575884806,3575884855,49
2,1066,33465,3575884806,3575884856,50
2,1067,33466,3575884875,3575884875,0
2,1067,33467,3575884875,3575884875,0
2,1067,33468,3575884875,3575884875,0
2,1067,33469,3575884875,3575884875,0
2,1067,33470,3575884875,3575884875,0
2,1067,33471,3575884875,3575884876,1
2,1067,33472,3575884875,3575884876,1
2,1067,33473,3575884875,3575884876,1
2,1067,33474,3575884875,3575884876,1
2,1067,33475,3575884875,3575884876,1
2,1067,33476,3575884875,3575884876,1
2,1067,33477,3575884875,3575884878,3
2,1067,33478,3575884875,3575884878,3
2,1067,33479,3575884875,3575884879,4
2,1067,33480,3575884875,3575884883,8
2,1067,33481,3575884875,3575884883,8
2,1067,33482,3575884875,3575884884,9
2,1067,33483,3575884875,3575884885,10
2,1067,33484,3575884875,3575884885,10
2,1067,33485,3575884875,3575884885,10
2,1067,33486,3575884875,3575884885,10
2,1067,33487,3575884875,3575884885,10
2,1067,33488,3575884875,3575884888,13
2,1067,33489,3575884875,3575884889,14
2,1067,33490,3575884875,3575884889,14
2,1067,33491,3575884875,3575884889,14
2,1067,33492,3575884875,3575884890,15
2,1067,33493,3575884875,3575884890,15
2,1067,33494,3575884875,3575884890,15
2,1067,33495,3575884875,3575884891,16
2,1067,33496,3575884875,3575884891,16
2,1067,33497,3575884875,3575884891,16
2,1067,33498,3575884875,3575884892,17
2,1067,33499,3575884875,3575884892,17
2,1067,33500,3575884875,3575884892,17
2,1067,33501,3575884875,3575884892,17
2,1067,33502,3575884875,3575884893,18
2,1067,33503,3575884875,3575884894,19
2,1067,33504,3575884875,3575884897,22
2,1067,33505,3575884875,3575884897,22
2,1067,33506,3575884875,3575884898,23
2,1067,33507,3575884875,3575884898,23
2,1067,33508,3575884875,3575884900,25
2,1067,33509,3575884875,3575884900,25
2,1067,33510,3575884875,3575884901,26
2,1067,33511,3575884875,3575884904,29
2,1067,33512,3575884875,3575884904,29
2,1067,33513,3575884875,3575884905,30
2,1067,33514,3575884875,3575884906,31
2,1067,33515,3575884875,3575884907,32
2,1067,33516,3575884875,3575884907,32
2,1067,33517,3575884875,3575884907,32
2,1067,33518,3575884875,3575884908,33
2,1067,33519,3575884875,3575884909,34
2,1067,33520,3575884875,3575884909,34
2,1067,33521,3575884875,3575884909,34
2,1067,33522,3575884875,3575884909,34
2,1067,33523,3575884875,3575884909,34
2,1067,33524,3575884875,3575884910,35
2,1067,33525,3575884875,3575884911,36
2,1067,33526,3575884875,3575884911,36
2,1067,33527,3575884875,3575884912,37
2,1067,33528,3575884875,3575884913,38
2,1067,33529,3575884875,3575884913,38
2,1067,33530,3575884875,3575884914,39
2,1067,33531,3575884875,3575884914,39
2,1067,33532,3575884875,3575884915,40
2,1067,33533,3575884875,3575884915,40
2,1067,33534,3575884875,3575884916,41
2,1067,33535,3575884875,3575884917,42
2,1067,33536,3575884875,3575884918,43
2,1067,33537,3575884875,3575884919,44
2,1067,33538,3575884875,3575884920,45
2,1067,33539,3575884875,3575884920,45
2,1067,33540,3575884875,3575884920,45
2,1067,33541,3575884875,3575884922,47
2,1067,33542,3575884875,3575884923,48
2,1067,33543,3575884875,3575884925,50
2,1068,33544,3575884939,3575884939,0
2,1068,33545,3575884939,3575884939,0
2,1068,33546,3575884939,3575884939,0
2,1068,33547,3575884939,3575884939,0
2,1068,33548,3575884939,3575884939,0
2,1068,33549,3575884939,3575884939,0
2,1068,33550,3575884939,3575884939,0
2,1068,33551,3575884939,3575884939,0
2,1068,33552,3575884939,3575884939,0
2,1068,33553,3575884939,3575884939,0
2,1068,33554,3575884939,3575884939,0
2,1068,33555,3575884939,3575884939,0
2,1068,33556,3575884939,3575884939,0
2,1068,33557,3575884939,3575884939,0
2,1068,33558,3575884939,3575884939,0
2,1068,33559,3575884939,3575884939,0
2,1068,33560,3575884939,3575884939,0
2,1068,33561,3575884939,3575884939,0
2,1068,33562,3575884939,3575884939,0
2,1068,33563,3575884939,3575884939,0
2,1068,33564,3575884939,3575884939,0
2,1068,33565,3575884939,3575884939,0
2,1068,33566,3575884939,3575884939,0
2,1068,33567,3575884939,3575884939,0
2,1068,33568,3575884939,3575884939,0
2,1068,33569,3575884939,3575884939,0
2,1068,33570,3575884939,3575884940,1
2,1068,33571,3575884939,3575884941,2
2,1068,33572,3575884939,3575884942,3
2,1068,33573,3575884939,3575884942,3
2,1068,33574,3575884939,3575884944,5
2,1068,33575,3575884939,3575884944,5
2,1068,33576,3575884939,3575884945,6
2,1068,33577,3575884939,3575884945,6
2,1068,33578,3575884939,3575884946,7
2,1068,33579,3575884939,3575884947,8
2,1068,33580,3575884939,3575884948,9
2,1068,33581,3575884939,3575884949,10
2,1068,33582,3575884939,3575884950,11
2,1068,33583,3575884939,3575884950,11
2,1068,33584,3575884939,3575884950,11
2,1068,33585,3575884939,3575884951,12
2,1068,33586,3575884939,3575884951,12
2,1068,33587,3575884939,3575884952,13
2,1068,33588,3575884939,3575884953,14
2,1068,33589,3575884939,3575884954,15
2,1068,33590,3575884939,3575884955,16
2,1068,33591,3575884939,3575884956,17
2,1068,33592,3575884939,3575884956,17
2,1068,33593,3575884939,3575884957,18
2,1068,33594,3575884939,3575884958,19
2,1068,33595,3575884939,3575884959,20
2,1068,33596,3575884939,3575884960,21
2,1068,33597,3575884939,3575884960,21
2,1068,33598,3575884939,3575884960,21
2,1068,33599,3575884939,3575884963,24
2,1068,33600,3575884939,3575884963,24
2,1068,33601,3575884939,3575884963,24
2,1068,33602,3575884939,3575884965,26
2,1068,33603,3575884939,3575884965,26
2,1068,33604,3575884939,3575884966,27
2,1068,33605,3575884939,3575884967,28
2,1068,33606,3575884939,3575884967,28
2,1068,33607,3575884939,3575884968,29
2,1068,33608,3575884939,3575884968,29
2,1068,33609,3575884939,3575884969,30
2,1068,33610,3575884939,3575884970,31
2,1068,33611,3575884939,3575884970,31
2,1068,33612,3575884939,3575884972,33
2,1068,33613,3575884939,3575884972,33
2,1068,33614,3575884939,3575884972,33
2,1068,33615,3575884939,3575884973,34
2,1068,33616,3575884939,3575884974,35
2,1068,33617,3575884939,3575884974,35
2,1068,33618,3575884939,3575884974,35
2,1068,33619,3575884939,3575884976,37
2,1068,33620,3575884939,3575884976,37
2,1068,33621,3575884939,3575884977,38
2,1068,33622,3575884939,3575884978,39
2,1068,33623,3575884939,3575884978,39
2,1068,33624,3575884939,3575884979,40
2,1068,33625,3575884939,3575884981,42
2,1068,33626,3575884939,3575884981,42
2,1068,33627,3575884939,3575884981,42
2,1068,33628,3575884939,3575884981,42
2,1068,33629,3575884939,3575884982,43
2,1068,33630,3575884939,3575884983,44
2,1068,33631,3575884939,3575884984,45
2,1068,33632,3575884939,3575884984,45
2,1068,33633,3575884939,3575884985,46
2,1068,33634,3575884939,3575884985,46
2,1068,33635,3575884939,3575884985,46
2,1068,33636,3575884939,3575884985,46
2,1068,33637,3575884939,3575884985,46
2,1068,33638,3575884939,3575884986,47
2,1068,33639,3575884939,3575884988,49
2,1068,33640,3575884939,3575884988,49
2,1068,33641,3575884939,3575884988,49
2,1069,33642,3575885003,3575885003,0
2,1069,33643,3575885003,3575885003,0
2,1069,33644,3575885003,3575885003,0
2,1069,33645,3575885003,3575885003,0
2,1069,33646,3575885003,3575885003,0
2,1069,33647,3575885003,3575885003,0
2,1069,33648,3575885003,3575885003,0
2,1069,33649,3575885003,3575885003,0
2,1069,33650,3575885003,3575885003,0
2,1069,33651,3575885003,3575885003,0
2,1069,33652,3575885003,3575885003,0
2,1069,33653,3575885003,3575885003,0
2,1069,33654,3575885003,3575885003,0
2,1069,33655,3575885003,3575885003,0
2,1069,33656,3575885003,3575885003,0
2,1069,33657,3575885003,3575885004,1
2,1069,33658,3575885003,3575885005,2
2,1069,33659,3575885003,3575885008,5
2,1069,33660,3575885003,3575885009,6
2,1069,33661,3575885003,3575885010,7
2,1069,33662,3575885003,3575885010,7
2,1069,33663,3575885003,3575885011,8
2,1069,33664,3575885003,3575885012,9
2,1069,33665,3575885003,3575885013,10
2,1069,33666,3575885003,3575885013,10
2,1069,33667,3575885003,3575885013,10
2,1069,33668,3575885003,3575885019,16
2,1069,33669,3575885003,3575885020,17
2,1069,33670,3575885003,3575885021,18
2,1069,33671,3575885003,3575885023,20
2,1069,33672,3575885003,3575885023,20
2,1069,33673,3575885003,3575885023,20
2,1069,33674,3575885003,3575885025,22
2,1069,33675,3575885003,3575885025,22
2,1069,33676,3575885003,3575885026,23
2,1069,33677,3575885003,3575885026,23
2,1069,33678,3575885003,3575885029,26
2,1069,33679,3575885003,3575885030,27
2,1069,33680,3575885003,3575885035,32
2,1069,33681,3575885003,3575885035,32
2,1069,33682,3575885003,3575885035,32
2,1069,33683,3575885003,3575885037,34
2,1069,33684,3575885003,3575885037,34
2,1069,33685,3575885003,3575885038,35
2,1069,33686,3575885003,3575885038,35
2,1069,33687,3575885003,3575885039,36
2,1069,33688,3575885003,3575885039,36
2,1069,33689,3575885003,3575885039,36
2,1069,33690,3575885003,3575885039,36
2,1069,33691,3575885003,3575885041,38
2,1069,33692,3575885003,3575885043,40
2,1069,33693,3575885003,3575885043,40
2,1069,33694,3575885003,3575885046,43
2,1069,33695,3575885003,3575885047,44
2,1069,33696,3575885003,3575885047,44
2,1069,33697,3575885003,3575885049,46
2,1069,33698,3575885003,3575885052,49
2,1070,33699,3575885072,3575885072,0
2,1070,33700,3575885072,3575885072,0
2,1070,33701,3575885072,3575885072,0
2,1070,33702,3575885072,3575885072,0
2,1070,33703,3575885072,3575885072,0
2,1070,33704,3575885072,3575885072,0
2,1070,33705,3575885072,3575885072,0
2,1070,33706,3575885072,3575885072,0
2,1070,33707,3575885072,3575885072,0
2,1070,33708,3575885072,3575885072,0
2,1070,33709,3575885072,3575885072,0
2,1070,33710,3575885072,3575885072,0
2,1070,33711,3575885072,3575885072,0
2,1070,33712,3575885072,3575885072,0
2,1070,33713,3575885072,3575885072,0
2,1070,33714,3575885072,3575885072,0
2,1070,33715,3575885072,3575885072,0
2,1070,33716,3575885072,3575885075,3
2,1070,33717,3575885072,3575885076,4
2,1070,33718,3575885072,3575885078,6
2,1070,33719,3575885072,3575885078,6
2,1070,33720,3575885072,3575885079,7
2,1070,33721,3575885072,3575885082,10
2,1070,33722,3575885072,3575885083,11
2,1070,33723,3575885072,3575885083,11
2,1070,33724,3575885072,3575885085,13
2,1070,33725,3575885072,3575885085,13
2,1070,33726,3575885072,3575885085,13
2,1070,33727,3575885072,3575885085,13
2,1070,33728,3575885072,3575885085,13
2,1070,33729,3575885072,3575885088,16
2,1070,33730,3575885072,3575885089,17
2,1070,33731,3575885072,3575885090,18
2,1070,33732,3575885072,3575885090,18
2,1070,33733,3575885072,3575885090,18
2,1070,33734,3575885072,3575885090,18
2,1070,33735,3575885072,3575885090,18
2,1070,33736,3575885072,3575885090,18
2,1070,33737,3575885072,3575885091,19
2,1070,33738,3575885072,3575885092,20
2,1070,33739,3575885072,3575885092,20
2,1070,33740,3575885072,3575885092,20
2,1070,33741,3575885072,3575885092,20
2,1070,33742,3575885072,3575885092,20
2,1070,33743,3575885072,3575885093,21
2,1070,33744,3575885072,3575885094,22
2,1070,33745,3575885072,3575885097,25
2,1070,33746,3575885072,3575885098,26
2,1070,33747,3575885072,3575885098,26
2,1070,33748,3575885072,3575885099,27
2,1070,33749,3575885072,3575885100,28
2,1070,33750,3575885072,3575885100,28
2,1070,33751,3575885072,3575885101,29
2,1070,33752,3575885072,3575885104,32
2,1070,33753,3575885072,3575885105,33
2,1070,33754,3575885072,3575885106,34
2,1070,33755,3575885072,3575885106,34
2,1070,33756,3575885072,3575885107,35
2,1070,33757,3575885072,3575885107,35
2,1070,33758,3575885072,3575885107,35
2,1070,33759,3575885072,3575885107,35
2,1070,33760,3575885072,3575885108,36
2,1070,33761,3575885072,3575885109,37
2,1070,33762,3575885072,3575885109,37
2,1070,33763,3575885072,3575885110,38
2,1070,33764,3575885072,3575885110,38
2,1070,33765,3575885072,3575885110,38
2,1070,33766,3575885072,3575885110,38
2,1070,33767,3575885072,3575885111,39
2,1070,33768,3575885072,3575885112,40
2,1070,33769,3575885072,3575885113,41
2,1070,33770,3575885072,3575885114,42
2,1070,33771,3575885072,3575885114,42
2,1070,33772,3575885072,3575885115,43
2,1070,33773,3575885072,3575885115,43
2,1070,33774,3575885072,3575885116,44
2,1070,33775,3575885072,3575885118,46
2,1070,33776,3575885072,3575885119,47
2,1070,33777,3575885072,3575885120,48
2,1070,33778,3575885072,3575885120,48
2,1070,33779,3575885072,3575885121,49
2,1070,33780,3575885072,3575885121,49
2,1070,33781,3575885072,3575885121,49
2,1071,33782,3575885136,3575885136,0
2,1071,33783,3575885136,3575885136,0
2,1071,33784,3575885136,3575885136,0
2,1071,33785,3575885136,3575885136,0
2,1071,33786,3575885136,3575885136,0
2,1071,33787,3575885136,3575885136,0
2,1071,33788,3575885136,3575885136,0
2,1071,33789,3575885136,3575885136,0
2,1071,33790,3575885136,3575885136,0
2,1071,33791,3575885136,3575885136,0
2,1071,33792,3575885136,3575885136,0
2,1071,33793,3575885136,3575885136,0
2,1071,33794,3575885136,3575885136,0
2,1071,33795,3575885136,3575885136,0
2,1071,33796,3575885136,3575885136,0
2,1071,33797,3575885136,3575885136,0
2,1071,33798,3575885136,3575885136,0
2,1071,33799,3575885136,3575885136,0
2,1071,33800,3575885136,3575885136,0
2,1071,33801,3575885136,3575885136,0
2,1071,33802,3575885136,3575885136,0
2,1071,33803,3575885136,3575885136,0
2,1071,33804,3575885136,3575885136,0
2,1071,33805,3575885136,3575885136,0
2,1071,33806,3575885136,3575885139,3
2,1071,33807,3575885136,3575885139,3
2,1071,33808,3575885136,3575885140,4
2,1071,33809,3575885136,3575885140,4
2,1071,33810,3575885136,3575885140,4
2,1071,33811,3575885136,3575885141,5
2,1071,33812,3575885136,3575885142,6
2,1071,33813,3575885136,3575885142,6
2,1071,33814,3575885136,3575885144,8
2,1071,33815,3575885136,3575885144,8
2,1071,33816,3575885136,3575885144,8
2,1071,33817,3575885136,3575885145,9
2,1071,33818,3575885136,3575885146,10
2,1071,33819,3575885136,3575885147,11
2,1071,33820,3575885136,3575885148,12
2,1071,33821,3575885136,3575885149,13
2,1071,33822,3575885136,3575885149,13
2,1071,33823,3575885136,3575885149,13
2,1071,33824,3575885136,3575885150,14
2,1071,33825,3575885136,3575885151,15
2,1071,33826,3575885136,3575885152,16
2,1071,33827,3575885136,3575885153,17
2,1071,33828,3575885136,3575885154,18
2,1071,33829,3575885136,3575885154,18
2,1071,33830,3575885136,3575885154,18
2,1071,33831,3575885136,3575885156,20
2,1071,33832,3575885136,3575885156,20
2,1071,33833,3575885136,3575885157,21
2,1071,33834,3575885136,3575885158,22
2,1071,33835,3575885136,3575885159,23
2,1071,33836,3575885136,3575885160,24
2,1071,33837,3575885136,3575885160,24
2,1071,33838,3575885136,3575885160,24
2,1071,33839,3575885136,3575885162,26
2,1071,33840,3575885136,3575885162,26
2,1071,33841,3575885136,3575885163,27
2,1071,33842,3575885136,3575885165,29
2,1071,33843,3575885136,3575885165,29
2,1071,33844,3575885136,3575885166,30
2,1071,33845,3575885136,3575885167,31
2,1071,33846,3575885136,3575885168,32
2,1071,33847,3575885136,3575885168,32
2,1071,33848,3575885136,3575885169,33
2,1071,33849,3575885136,3575885169,33
2,1071,33850,3575885136,3575885169,33
2,1071,33851,3575885136,3575885169,33
2,1071,33852,3575885136,3575885170,34
2,1071,33853,3575885136,3575885172,36
2,1071,33854,3575885136,3575885172,36
2,1071,33855,3575885136,3575885173,37
2,1071,33856,3575885136,3575885174,38
2,1071,33857,3575885136,3575885175,39
2,1071,33858,3575885136,3575885175,39
2,1071,33859,3575885136,3575885176,40
2,1071,33860,3575885136,3575885176,40
2,1071,33861,3575885136,3575885178,42
2,1071,33862,3575885136,3575885178,42
2,1071,33863,3575885136,3575885179,43
2,1071,33864,3575885136,3575885180,44
2,1071,33865,3575885136,3575885181,45
2,1071,33866,3575885136,3575885181,45
2,1071,33867,3575885136,3575885181,45
2,1071,33868,3575885136,3575885181,45
2,1071,33869,3575885136,3575885183,47
2,1071,33870,3575885136,3575885184,48
2,1071,33871,3575885136,3575885184,48
2,1071,33872,3575885136,3575885184,48
2,1071,33873,3575885136,3575885185,49
2,1071,33874,3575885136,3575885185,49
2,1071,33875,3575885136,3575885185,49
2,1071,33876,3575885136,3575885185,49
2,1072,33877,3575885201,3575885201,0
2,1072,33878,3575885201,3575885201,0
2,1072,33879,3575885201,3575885201,0
2,1072,33880,3575885201,3575885201,0
2,1072,33881,3575885201,3575885201,0
2,1072,33882,3575885201,3575885201,0
2,1072,33883,3575885201,3575885201,0
2,1072,33884,3575885201,3575885201,0
2,1072,33885,3575885201,3575885201,0
2,1072,33886,3575885201,3575885201,0
2,1072,33887,3575885201,3575885201,0
2,1072,33888,3575885201,3575885201,0
2,1072,33889,3575885201,3575885201,0
2,1072,33890,3575885201,3575885201,0
2,1072,33891,3575885201,3575885201,0
2,1072,33892,3575885201,3575885201,0
2,1072,33893,3575885201,3575885203,2
2,1072,33894,3575885201,3575885203,2
2,1072,33895,3575885201,3575885203,2
2,1072,33896,3575885201,3575885203,2
2,1072,33897,3575885201,3575885204,3
2,1072,33898,3575885201,3575885205,4
2,1072,33899,3575885201,3575885208,7
2,1072,33900,3575885201,3575885209,8
2,1072,33901,3575885201,3575885210,9
2,1072,33902,3575885201,3575885211,10
2,1072,33903,3575885201,3575885212,11
2,1072,33904,3575885201,3575885212,11
2,1072,33905,3575885201,3575885213,12
2,1072,33906,3575885201,3575885214,13
2,1072,33907,3575885201,3575885219,18
2,1072,33908,3575885201,3575885220,19
2,1072,33909,3575885201,3575885221,20
2,1072,33910,3575885201,3575885223,22
2,1072,33911,3575885201,3575885223,22
2,1072,33912,3575885201,3575885224,23
2,1072,33913,3575885201,3575885225,24
2,1072,33914,3575885201,3575885226,25
2,1072,33915,3575885201,3575885227,26
2,1072,33916,3575885201,3575885228,27
2,1072,33917,3575885201,3575885229,28
2,1072,33918,3575885201,3575885229,28
2,1072,33919,3575885201,3575885231,30
2,1072,33920,3575885201,3575885235,34
2,1072,33921,3575885201,3575885235,34
2,1072,33922,3575885201,3575885236,35
2,1072,33923,3575885201,3575885237,36
2,1072,33924,3575885201,3575885237,36
2,1072,33925,3575885201,3575885238,37
2,1072,33926,3575885201,3575885239,38
2,1072,33927,3575885201,3575885239,38
2,1072,33928,3575885201,3575885240,39
2,1072,33929,3575885201,3575885240,39
2,1072,33930,3575885201,3575885242,41
2,1072,33931,3575885201,3575885242,41
2,1072,33932,3575885201,3575885243,42
2,1072,33933,3575885201,3575885246,45
2,1072,33934,3575885201,3575885247,46
2,1072,33935,3575885201,3575885248,47
2,1072,33936,3575885201,3575885249,48
2,1073,33937,3575885265,3575885265,0
2,1073,33938,3575885265,3575885265,0
2,1073,33939,3575885265,3575885265,0
2,1073,33940,3575885265,3575885265,0
2,1073,33941,3575885265,3575885265,0
2,1073,33942,3575885265,3575885265,0
2,1073,33943,3575885265,3575885265,0
2,1073,33944,3575885265,3575885265,0
2,1073,33945,3575885265,3575885265,0
2,1073,33946,3575885265,3575885265,0
2,1073,33947,3575885265,3575885265,0
2,1073,33948,3575885265,3575885265,0
2,1073,33949,3575885265,3575885265,0
2,1073,33950,3575885265,3575885265,0
2,1073,33951,3575885265,3575885266,1
2,1073,33952,3575885265,3575885267,2
2,1073,33953,3575885265,3575885268,3
2,1073,33954,3575885265,3575885275,10
2,1073,33955,3575885265,3575885276,11
2,1073,33956,3575885265,3575885278,13
2,1073,33957,3575885265,3575885278,13
2,1073,33958,3575885265,3575885280,15
2,1073,33959,3575885265,3575885282,17
2,1073,33960,3575885265,3575885283,18
2,1073,33961,3575885265,3575885284,19
2,1073,33962,3575885265,3575885285,20
2,1073,33963,3575885265,3575885285,20
2,1073,33964,3575885265,3575885285,20
2,1073,33965,3575885265,3575885285,20
2,1073,33966,3575885265,3575885285,20
2,1073,33967,3575885265,3575885285,20
2,1073,33968,3575885265,3575885288,23
2,1073,33969,3575885265,3575885288,23
2,1073,33970,3575885265,3575885289,24
2,1073,33971,3575885265,3575885290,25
2,1073,33972,3575885265,3575885290,25
2,1073,33973,3575885265,3575885290,25
2,1073,33974,3575885265,3575885290,25
2,1073,33975,3575885265,3575885290,25
2,1073,33976,3575885265,3575885291,26
2,1073,33977,3575885265,3575885292,27
2,1073,33978,3575885265,3575885293,28
2,1073,33979,3575885265,3575885293,28
2,1073,33980,3575885265,3575885294,29
2,1073,33981,3575885265,3575885294,29
2,1073,33982,3575885265,3575885298,33
2,1073,33983,3575885265,3575885298,33
2,1073,33984,3575885265,3575885299,34
2,1073,33985,3575885265,3575885300,35
2,1073,33986,3575885265,3575885300,35
2,1073,33987,3575885265,3575885301,36
2,1073,33988,3575885265,3575885303,38
2,1073,33989,3575885265,3575885304,39
2,1073,33990,3575885265,3575885305,40
2,1073,33991,3575885265,3575885305,40
2,1073,33992,3575885265,3575885305,40
2,1073,33993,3575885265,3575885307,42
2,1073,33994,3575885265,3575885307,42
2,1073,33995,3575885265,3575885307,42
2,1073,33996,3575885265,3575885307,42
2,1073,33997,3575885265,3575885309,44
2,1073,33998,3575885265,3575885309,44
2,1073,33999,3575885265,3575885309,44
2,1073,34000,3575885265,3575885309,44
2,1073,34001,3575885265,3575885309,44
2,1073,34002,3575885265,3575885311,46
2,1073,34003,3575885265,3575885311,46
2,1073,34004,3575885265,3575885313,48
2,1073,34005,3575885265,3575885313,48
2,1073,34006,3575885265,3575885314,49
2,1073,34007,3575885265,3575885314,49
2,1073,34008,3575885265,3575885315,50
2,1074,34009,3575885330,3575885330,0
2,1074,34010,3575885330,3575885330,0
2,1074,34011,3575885330,3575885330,0
2,1074,34012,3575885330,3575885330,0
2,1074,34013,3575885330,3575885330,0
2,1074,34014,3575885330,3575885330,0
2,1074,34015,3575885330,3575885330,0
2,1074,34016,3575885330,3575885330,0
2,1074,34017,3575885330,3575885330,0
2,1074,34018,3575885330,3575885330,0
2,1074,34019,3575885330,3575885330,0
2,1074,34020,3575885330,3575885330,0
2,1074,34021,3575885330,3575885330,0
2,1074,34022,3575885330,3575885330,0
2,1074,34023,3575885330,3575885330,0
2,1074,34024,3575885330,3575885330,0
2,1074,34025,3575885330,3575885330,0
2,1074,34026,3575885330,3575885330,0
2,1074,34027,3575885330,3575885330,0
2,1074,34028,3575885330,3575885330,0
2,1074,34029,3575885330,3575885331,1
2,1074,34030,3575885330,3575885331,1
2,1074,34031,3575885330,3575885331,1
2,1074,34032,3575885330,3575885332,2
2,1074,34033,3575885330,3575885332,2
2,1074,34034,3575885330,3575885333,3
2,1074,34035,3575885330,3575885334,4
2,1074,34036,3575885330,3575885334,4
2,1074,34037,3575885330,3575885334,4
2,1074,34038,3575885330,3575885334,4
2,1074,34039,3575885330,3575885335,5
2,1074,34040,3575885330,3575885335,5
2,1074,34041,3575885330,3575885335,5
2,1074,34042,3575885330,3575885335,5
2,1074,34043,3575885330,3575885337,7
2,1074,34044,3575885330,3575885339,9
2,1074,34045,3575885330,3575885339,9
2,1074,34046,3575885330,3575885339,9
2,1074,34047,3575885330,3575885340,10
2,1074,34048,3575885330,3575885340,10
2,1074,34049,3575885330,3575885341,11
2,1074,34050,3575885330,3575885342,12
2,1074,34051,3575885330,3575885342,12
2,1074,34052,3575885330,3575885344,14
2,1074,34053,3575885330,3575885345,15
2,1074,34054,3575885330,3575885345,15
2,1074,34055,3575885330,3575885345,15
2,1074,34056,3575885330,3575885345,15
2,1074,34057,3575885330,3575885346,16
2,1074,34058,3575885330,3575885347,17
2,1074,34059,3575885330,3575885347,17
2,1074,34060,3575885330,3575885348,18
2,1074,34061,3575885330,3575885349,19
2,1074,34062,3575885330,3575885349,19
2,1074,34063,3575885330,3575885349,19
2,1074,34064,3575885330,3575885350,20
2,1074,34065,3575885330,3575885351,21
2,1074,34066,3575885330,3575885352,22
2,1074,34067,3575885330,3575885352,22
2,1074,34068,3575885330,3575885354,24
2,1074,34069,3575885330,3575885354,24
2,1074,34070,3575885330,3575885354,24
2,1074,34071,3575885330,3575885356,26
2,1074,34072,3575885330,3575885357,27
2,1074,34073,3575885330,3575885358,28
2,1074,34074,3575885330,3575885359,29
2,1074,34075,3575885330,3575885359,29
2,1074,34076,3575885330,3575885360,30
2,1074,34077,3575885330,3575885360,30
2,1074,34078,3575885330,3575885361,31
2,1074,34079,3575885330,3575885361,31
2,1074,34080,3575885330,3575885362,32
2,1074,34081,3575885330,3575885363,33
2,1074,34082,3575885330,3575885365,35
2,1074,34083,3575885330,3575885365,35
2,1074,34084,3575885330,3575885366,36
2,1074,34085,3575885330,3575885367,37
2,1074,34086,3575885330,3575885368,38
2,1074,34087,3575885330,3575885368,38
2,1074,34088,3575885330,3575885369,39
2,1074,34089,3575885330,3575885369,39
2,1074,34090,3575885330,3575885369,39
2,1074,34091,3575885330,3575885370,40
2,1074,34092,3575885330,3575885371,41
2,1074,34093,3575885330,3575885373,43
2,1074,34094,3575885330,3575885375,45
2,1074,34095,3575885330,3575885375,45
2,1074,34096,3575885330,3575885375,45
2,1074,34097,3575885330,3575885376,46
2,1074,34098,3575885330,3575885376,46
2,1074,34099,3575885330,3575885378,48
2,1074,34100,3575885330,3575885378,48
2,1074,34101,3575885330,3575885379,49
2,1074,34102,3575885330,3575885379,49
2,1075,34103,3575885393,3575885393,0
2,1075,34104,3575885393,3575885393,0
2,1075,34105,3575885393,3575885393,0
2,1075,34106,3575885393,3575885393,0
2,1075,34107,3575885393,3575885393,0
2,1075,34108,3575885393,3575885393,0
2,1075,34109,3575885393,3575885393,0
2,1075,34110,3575885393,3575885393,0
2,1075,34111,3575885393,3575885393,0
2,1075,34112,3575885393,3575885393,0
2,1075,34113,3575885393,3575885393,0
2,1075,34114,3575885393,3575885393,0
2,1075,34115,3575885393,3575885393,0
2,1075,34116,3575885393,3575885393,0
2,1075,34117,3575885393,3575885393,0
2,1075,34118,3575885393,3575885393,0
2,1075,34119,3575885393,3575885393,0
2,1075,34120,3575885393,3575885393,0
2,1075,34121,3575885393,3575885393,0
2,1075,34122,3575885393,3575885393,0
2,1075,34123,3575885393,3575885393,0
2,1075,34124,3575885393,3575885394,1
2,1075,34125,3575885393,3575885394,1
2,1075,34126,3575885393,3575885395,2
2,1075,34127,3575885393,3575885398,5
2,1075,34128,3575885393,3575885399,6
2,1075,34129,3575885393,3575885399,6
2,1075,34130,3575885393,3575885401,8
2,1075,34131,3575885393,3575885402,9
2,1075,34132,3575885393,3575885403,10
2,1075,34133,3575885393,3575885403,10
2,1075,34134,3575885393,3575885404,11
2,1075,34135,3575885393,3575885404,11
2,1075,34136,3575885393,3575885404,11
2,1075,34137,3575885393,3575885404,11
2,1075,34138,3575885393,3575885405,12
2,1075,34139,3575885393,3575885407,14
2,1075,34140,3575885393,3575885409,16
2,1075,34141,3575885393,3575885410,17
2,1075,34142,3575885393,3575885411,18
2,1075,34143,3575885393,3575885412,19
2,1075,34144,3575885393,3575885413,20
2,1075,34145,3575885393,3575885414,21
2,1075,34146,3575885393,3575885419,26
2,1075,34147,3575885393,3575885421,28
2,1075,34148,3575885393,3575885422,29
2,1075,34149,3575885393,3575885423,30
2,1075,34150,3575885393,3575885423,30
2,1075,34151,3575885393,3575885425,32
2,1075,34152,3575885393,3575885426,33
2,1075,34153,3575885393,3575885427,34
2,1075,34154,3575885393,3575885429,36
2,1075,34155,3575885393,3575885429,36
2,1075,34156,3575885393,3575885430,37
2,1075,34157,3575885393,3575885432,39
2,1075,34158,3575885393,3575885436,43
2,1075,34159,3575885393,3575885436,43
2,1075,34160,3575885393,3575885436,43
2,1075,34161,3575885393,3575885437,44
2,1075,34162,3575885393,3575885437,44
2,1075,34163,3575885393,3575885437,44
2,1075,34164,3575885393,3575885439,46
2,1075,34165,3575885393,3575885439,46
2,1075,34166,3575885393,3575885439,46
2,1075,34167,3575885393,3575885440,47
2,1075,34168,3575885393,3575885441,48
2,1075,34169,3575885393,3575885443,50
2,1076,34170,3575885457,3575885457,0
2,1076,34171,3575885457,3575885457,0
2,1076,34172,3575885457,3575885457,0
2,1076,34173,3575885457,3575885458,1
2,1076,34174,3575885457,3575885458,1
2,1076,34175,3575885457,3575885458,1
2,1076,34176,3575885457,3575885458,1
2,1076,34177,3575885457,3575885458,1
2,1076,34178,3575885457,3575885458,1
2,1076,34179,3575885457,3575885458,1
2,1076,34180,3575885457,3575885458,1
2,1076,34181,3575885457,3575885458,1
2,1076,34182,3575885457,3575885458,1
2,1076,34183,3575885457,3575885460,3
2,1076,34184,3575885457,3575885460,3
2,1076,34185,3575885457,3575885461,4
2,1076,34186,3575885457,3575885462,5
2,1076,34187,3575885457,3575885463,6
2,1076,34188,3575885457,3575885467,10
2,1076,34189,3575885457,3575885468,11
2,1076,34190,3575885457,3575885477,20
2,1076,34191,3575885457,3575885478,21
2,1076,34192,3575885457,3575885479,22
2,1076,34193,3575885457,3575885480,23
2,1076,34194,3575885457,3575885483,26
2,1076,34195,3575885457,3575885483,26
2,1076,34196,3575885457,3575885483,26
2,1076,34197,3575885457,3575885484,27
2,1076,34198,3575885457,3575885485,28
2,1076,34199,3575885457,3575885485,28
2,1076,34200,3575885457,3575885485,28
2,1076,34201,3575885457,3575885485,28
2,1076,34202,3575885457,3575885486,29
2,1076,34203,3575885457,3575885488,31
2,1076,34204,3575885457,3575885489,32
2,1076,34205,3575885457,3575885489,32
2,1076,34206,3575885457,3575885489,32
2,1076,34207,3575885457,3575885489,32
2,1076,34208,3575885457,3575885490,33
2,1076,34209,3575885457,3575885491,34
2,1076,34210,3575885457,3575885491,34
2,1076,34211,3575885457,3575885491,34
2,1076,34212,3575885457,3575885492,35
2,1076,34213,3575885457,3575885492,35
2,1076,34214,3575885457,3575885492,35
2,1076,34215,3575885457,3575885493,36
2,1076,34216,3575885457,3575885493,36
2,1076,34217,3575885457,3575885493,36
2,1076,34218,3575885457,3575885493,36
2,1076,34219,3575885457,3575885497,40
2,1076,34220,3575885457,3575885497,40
2,1076,34221,3575885457,3575885498,41
2,1076,34222,3575885457,3575885499,42
2,1076,34223,3575885457,3575885500,43
2,1076,34224,3575885457,3575885500,43
2,1076,34225,3575885457,3575885502,45
2,1076,34226,3575885457,3575885503,46
2,1076,34227,3575885457,3575885505,48
2,1076,34228,3575885457,3575885505,48
2,1076,34229,3575885457,3575885506,49
2,1076,34230,3575885457,3575885506,49
2,1076,34231,3575885457,3575885506,49
2,1076,34232,3575885457,3575885507,50
2,1077,34233,3575885519,3575885519,0
2,1077,34234,3575885519,3575885519,0
2,1077,34235,3575885519,3575885519,0
2,1077,34236,3575885519,3575885519,0
2,1077,34237,3575885519,3575885519,0
2,1077,34238,3575885519,3575885519,0
2,1077,34239,3575885519,3575885519,0
2,1077,34240,3575885519,3575885519,0
2,1077,34241,3575885519,3575885519,0
2,1077,34242,3575885519,3575885519,0
2,1077,34243,3575885519,3575885519,0
2,1077,34244,3575885519,3575885519,0
2,1077,34245,3575885519,3575885519,0
2,1077,34246,3575885519,3575885519,0
2,1077,34247,3575885519,3575885519,0
2,1077,34248,3575885519,3575885519,0
2,1077,34249,3575885519,3575885519,0
2,1077,34250,3575885519,3575885519,0
2,1077,34251,3575885519,3575885519,0
2,1077,34252,3575885519,3575885519,0
2,1077,34253,3575885519,3575885519,0
2,1077,34254,3575885519,3575885519,0
2,1077,34255,3575885519,3575885519,0
2,1077,34256,3575885519,3575885519,0
2,1077,34257,3575885519,3575885520,1
2,1077,34258,3575885519,3575885521,2
2,1077,34259,3575885519,3575885521,2
2,1077,34260,3575885519,3575885522,3
2,1077,34261,3575885519,3575885524,5
2,1077,34262,3575885519,3575885525,6
2,1077,34263,3575885519,3575885526,7
2,1077,34264,3575885519,3575885526,7
2,1077,34265,3575885519,3575885528,9
2,1077,34266,3575885519,3575885529,10
2,1077,34267,3575885519,3575885529,10
2,1077,34268,3575885519,3575885529,10
2,1077,34269,3575885519,3575885529,10
2,1077,34270,3575885519,3575885530,11
2,1077,34271,3575885519,3575885531,12
2,1077,34272,3575885519,3575885531,12
2,1077,34273,3575885519,3575885532,13
2,1077,34274,3575885519,3575885532,13
2,1077,34275,3575885519,3575885533,14
2,1077,34276,3575885519,3575885533,14
2,1077,34277,3575885519,3575885533,14
2,1077,34278,3575885519,3575885534,15
2,1077,34279,3575885519,3575885534,15
2,1077,34280,3575885519,3575885534,15
2,1077,34281,3575885519,3575885534,15
2,1077,34282,3575885519,3575885535,16
2,1077,34283,3575885519,3575885538,19
2,1077,34284,3575885519,3575885538,19
2,1077,34285,3575885519,3575885539,20
2,1077,34286,3575885519,3575885539,20
2,1077,34287,3575885519,3575885540,21
2,1077,34288,3575885519,3575885541,22
2,1077,34289,3575885519,3575885541,22
2,1077,34290,3575885519,3575885543,24
2,1077,34291,3575885519,3575885544,25
2,1077,34292,3575885519,3575885544,25
2,1077,34293,3575885519,3575885544,25
2,1077,34294,3575885519,3575885544,25
2,1077,34295,3575885519,3575885545,26
2,1077,34296,3575885519,3575885547,28
2,1077,34297,3575885519,3575885547,28
2,1077,34298,3575885519,3575885547,28
2,1077,34299,3575885519,3575885548,29
2,1077,34300,3575885519,3575885548,29
2,1077,34301,3575885519,3575885548,29
2,1077,34302,3575885519,3575885551,32
2,1077,34303,3575885519,3575885551,32
2,1077,34304,3575885519,3575885552,33
2,1077,34305,3575885519,3575885552,33
2,1077,34306,3575885519,3575885552,33
2,1077,34307,3575885519,3575885552,33
2,1077,34308,3575885519,3575885553,34
2,1077,34309,3575885519,3575885555,36
2,1077,34310,3575885519,3575885556,37
2,1077,34311,3575885519,3575885557,38
2,1077,34312,3575885519,3575885558,39
2,1077,34313,3575885519,3575885558,39
2,1077,34314,3575885519,3575885560,41
2,1077,34315,3575885519,3575885560,41
2,1077,34316,3575885519,3575885560,41
2,1077,34317,3575885519,3575885560,41
2,1077,34318,3575885519,3575885561,42
2,1077,34319,3575885519,3575885561,42
2,1077,34320,3575885519,3575885564,45
2,1077,34321,3575885519,3575885564,45
2,1077,34322,3575885519,3575885565,46
2,1077,34323,3575885519,3575885566,47
2,1077,34324,3575885519,3575885566,47
2,1077,34325,3575885519,3575885567,48
2,1077,34326,3575885519,3575885568,49
2,1077,34327,3575885519,3575885568,49
2,1077,34328,3575885519,3575885568,49
2,1077,34329,3575885519,3575885568,49
2,1077,34330,3575885519,3575885569,50
2,1078,34331,3575885582,3575885582,0
2,1078,34332,3575885582,3575885582,0
2,1078,34333,3575885582,3575885582,0
2,1078,34334,3575885582,3575885582,0
2,1078,34335,3575885582,3575885582,0
2,1078,34336,3575885582,3575885582,0
2,1078,34337,3575885582,3575885582,0
2,1078,34338,3575885582,3575885582,0
2,1078,34339,3575885582,3575885582,0
2,1078,34340,3575885582,3575885582,0
2,1078,34341,3575885582,3575885582,0
2,1078,34342,3575885582,3575885582,0
2,1078,34343,3575885582,3575885582,0
2,1078,34344,3575885582,3575885582,0
2,1078,34345,3575885582,3575885582,0
2,1078,34346,3575885582,3575885582,0
2,1078,34347,3575885582,3575885583,1
2,1078,34348,3575885582,3575885583,1
2,1078,34349,3575885582,3575885583,1
2,1078,34350,3575885582,3575885584,2
2,1078,34351,3575885582,3575885584,2
2,1078,34352,3575885582,3575885585,3
2,1078,34353,3575885582,3575885587,5
2,1078,34354,3575885582,3575885587,5
2,1078,34355,3575885582,3575885588,6
2,1078,34356,3575885582,3575885588,6
2,1078,34357,3575885582,3575885589,7
2,1078,34358,3575885582,3575885590,8
2,1078,34359,3575885582,3575885590,8
2,1078,34360,3575885582,3575885590,8
2,1078,34361,3575885582,3575885591,9
2,1078,34362,3575885582,3575885592,10
2,1078,34363,3575885582,3575885593,11
2,1078,34364,3575885582,3575885594,12
2,1078,34365,3575885582,3575885598,16
2,1078,34366,3575885582,3575885598,16
2,1078,34367,3575885582,3575885599,17
2,1078,34368,3575885582,3575885600,18
2,1078,34369,3575885582,3575885602,20
2,1078,34370,3575885582,3575885602,20
2,1078,34371,3575885582,3575885602,20
2,1078,34372,3575885582,3575885603,21
2,1078,34373,3575885582,3575885603,21
2,1078,34374,3575885582,3575885603,21
2,1078,34375,3575885582,3575885604,22
2,1078,34376,3575885582,3575885604,22
2,1078,34377,3575885582,3575885607,25
2,1078,34378,3575885582,3575885608,26
2,1078,34379,3575885582,3575885610,28
2,1078,34380,3575885582,3575885611,29
2,1078,34381,3575885582,3575885611,29
2,1078,34382,3575885582,3575885611,29
2,1078,34383,3575885582,3575885612,30
2,1078,34384,3575885582,3575885613,31
2,1078,34385,3575885582,3575885618,36
2,1078,34386,3575885582,3575885620,38
2,1078,34387,3575885582,3575885620,38
2,1078,34388,3575885582,3575885622,40
2,1078,34389,3575885582,3575885622,40
2,1078,34390,3575885582,3575885622,40
2,1078,34391,3575885582,3575885624,42
2,1078,34392,3575885582,3575885626,44
2,1078,34393,3575885582,3575885626,44
2,1078,34394,3575885582,3575885626,44
2,1078,34395,3575885582,3575885627,45
2,1078,34396,3575885582,3575885628,46
2,1078,34397,3575885582,3575885628,46
2,1078,34398,3575885582,3575885630,48
2,1079,34399,3575885646,3575885646,0
2,1079,34400,3575885646,3575885646,0
2,1079,34401,3575885646,3575885646,0
2,1079,34402,3575885646,3575885646,0
2,1079,34403,3575885646,3575885646,0
2,1079,34404,3575885646,3575885646,0
2,1079,34405,3575885646,3575885646,0
2,1079,34406,3575885646,3575885646,0
2,1079,34407,3575885646,3575885646,0
2,1079,34408,3575885646,3575885647,1
2,1079,34409,3575885646,3575885647,1
2,1079,34410,3575885646,3575885647,1
2,1079,34411,3575885646,3575885647,1
2,1079,34412,3575885646,3575885647,1
2,1079,34413,3575885646,3575885647,1
2,1079,34414,3575885646,3575885647,1
2,1079,34415,3575885646,3575885648,2
2,1079,34416,3575885646,3575885652,6
2,1079,34417,3575885646,3575885653,7
2,1079,34418,3575885646,3575885653,7
2,1079,34419,3575885646,3575885654,8
2,1079,34420,3575885646,3575885654,8
2,1079,34421,3575885646,3575885654,8
2,1079,34422,3575885646,3575885654,8
2,1079,34423,3575885646,3575885655,9
2,1079,34424,3575885646,3575885655,9
2,1079,34425,3575885646,3575885658,12
2,1079,34426,3575885646,3575885659,13
2,1079,34427,3575885646,3575885660,14
2,1079,34428,3575885646,3575885660,14
2,1079,34429,3575885646,3575885662,16
2,1079,34430,3575885646,3575885663,17
2,1079,34431,3575885646,3575885666,20
2,1079,34432,3575885646,3575885667,21
2,1079,34433,3575885646,3575885668,22
2,1079,34434,3575885646,3575885676,30
2,1079,34435,3575885646,3575885678,32
2,1079,34436,3575885646,3575885678,32
2,1079,34437,3575885646,3575885679,33
2,1079,34438,3575885646,3575885682,36
2,1079,34439,3575885646,3575885683,37
2,1079,34440,3575885646,3575885684,38
2,1079,34441,3575885646,3575885685,39
2,1079,34442,3575885646,3575885685,39
2,1079,34443,3575885646,3575885685,39
2,1079,34444,3575885646,3575885685,39
2,1079,34445,3575885646,3575885685,39
2,1079,34446,3575885646,3575885686,40
2,1079,34447,3575885646,3575885689,43
2,1079,34448,3575885646,3575885689,43
2,1079,34449,3575885646,3575885689,43
2,1079,34450,3575885646,3575885690,44
2,1079,34451,3575885646,3575885691,45
2,1079,34452,3575885646,3575885691,45
2,1079,34453,3575885646,3575885692,46
2,1079,34454,3575885646,3575885692,46
2,1079,34455,3575885646,3575885692,46
2,1079,34456,3575885646,3575885693,47
2,1079,34457,3575885646,3575885694,48
2,1079,34458,3575885646,3575885694,48
2,1079,34459,3575885646,3575885694,48
2,1080,34460,3575885709,3575885709,0
2,1080,34461,3575885709,3575885709,0
2,1080,34462,3575885709,3575885709,0
2,1080,34463,3575885709,3575885709,0
2,1080,34464,3575885709,3575885709,0
2,1080,34465,3575885709,3575885709,0
2,1080,34466,3575885709,3575885709,0
2,1080,34467,3575885709,3575885709,0
2,1080,34468,3575885709,3575885709,0
2,1080,34469,3575885709,3575885709,0
2,1080,34470,3575885709,3575885709,0
2,1080,34471,3575885709,3575885709,0
2,1080,34472,3575885709,3575885709,0
2,1080,34473,3575885709,3575885709,0
2,1080,34474,3575885709,3575885709,0
2,1080,34475,3575885709,3575885709,0
2,1080,34476,3575885709,3575885709,0
2,1080,34477,3575885709,3575885709,0
2,1080,34478,3575885709,3575885709,0
2,1080,34479,3575885709,3575885709,0
2,1080,34480,3575885709,3575885709,0
2,1080,34481,3575885709,3575885710,1
2,1080,34482,3575885709,3575885710,1
2,1080,34483,3575885709,3575885710,1
2,1080,34484,3575885709,3575885710,1
2,1080,34485,3575885709,3575885711,2
2,1080,34486,3575885709,3575885712,3
2,1080,34487,3575885709,3575885713,4
2,1080,34488,3575885709,3575885713,4
2,1080,34489,3575885709,3575885714,5
2,1080,34490,3575885709,3575885715,6
2,1080,34491,3575885709,3575885715,6
2,1080,34492,3575885709,3575885716,7
2,1080,34493,3575885709,3575885716,7
2,1080,34494,3575885709,3575885717,8
2,1080,34495,3575885709,3575885717,8
2,1080,34496,3575885709,3575885718,9
2,1080,34497,3575885709,3575885718,9
2,1080,34498,3575885709,3575885719,10
2,1080,34499,3575885709,3575885720,11
2,1080,34500,3575885709,3575885721,12
2,1080,34501,3575885709,3575885722,13
2,1080,34502,3575885709,3575885722,13
2,1080,34503,3575885709,3575885724,15
2,1080,34504,3575885709,3575885726,17
2,1080,34505,3575885709,3575885727,18
2,1080,34506,3575885709,3575885727,18
2,1080,34507,3575885709,3575885728,19
2,1080,34508,3575885709,3575885728,19
2,1080,34509,3575885709,3575885729,20
2,1080,34510,3575885709,3575885729,20
2,1080,34511,3575885709,3575885730,21
2,1080,34512,3575885709,3575885731,22
2,1080,34513,3575885709,3575885731,22
2,1080,34514,3575885709,3575885731,22
2,1080,34515,3575885709,3575885731,22
2,1080,34516,3575885709,3575885732,23
2,1080,34517,3575885709,3575885733,24
2,1080,34518,3575885709,3575885733,24
2,1080,34519,3575885709,3575885733,24
2,1080,34520,3575885709,3575885734,25
2,1080,34521,3575885709,3575885734,25
2,1080,34522,3575885709,3575885735,26
2,1080,34523,3575885709,3575885739,30
2,1080,34524,3575885709,3575885739,30
2,1080,34525,3575885709,3575885739,30
2,1080,34526,3575885709,3575885740,31
2,1080,34527,3575885709,3575885740,31
2,1080,34528,3575885709,3575885742,33
2,1080,34529,3575885709,3575885744,35
2,1080,34530,3575885709,3575885744,35
2,1080,34531,3575885709,3575885745,36
2,1080,34532,3575885709,3575885745,36
2,1080,34533,3575885709,3575885745,36
2,1080,34534,3575885709,3575885746,37
2,1080,34535,3575885709,3575885748,39
2,1080,34536,3575885709,3575885748,39
2,1080,34537,3575885709,3575885748,39
2,1080,34538,3575885709,3575885749,40
2,1080,34539,3575885709,3575885750,41
2,1080,34540,3575885709,3575885752,43
2,1080,34541,3575885709,3575885752,43
2,1080,34542,3575885709,3575885753,44
2,1080,34543,3575885709,3575885753,44
2,1080,34544,3575885709,3575885754,45
2,1080,34545,3575885709,3575885755,46
2,1080,34546,3575885709,3575885757,48
2,1080,34547,3575885709,3575885757,48
2,1080,34548,3575885709,3575885758,49
2,1080,34549,3575885709,3575885758,49
2,1080,34550,3575885709,3575885759,50
2,1081,34551,3575885780,3575885780,0
2,1081,34552,3575885780,3575885780,0
2,1081,34553,3575885780,3575885780,0
2,1081,34554,3575885780,3575885780,0
2,1081,34555,3575885780,3575885780,0
2,1081,34556,3575885780,3575885780,0
2,1081,34557,3575885780,3575885780,0
2,1081,34558,3575885780,3575885780,0
2,1081,34559,3575885780,3575885780,0
2,1081,34560,3575885780,3575885780,0
2,1081,34561,3575885780,3575885780,0
2,1081,34562,3575885780,3575885780,0
2,1081,34563,3575885780,3575885780,0
2,1081,34564,3575885780,3575885780,0
2,1081,34565,3575885780,3575885780,0
2,1081,34566,3575885780,3575885780,0
2,1081,34567,3575885780,3575885780,0
2,1081,34568,3575885780,3575885780,0
2,1081,34569,3575885780,3575885780,0
2,1081,34570,3575885780,3575885780,0
2,1081,34571,3575885780,3575885780,0
2,1081,34572,3575885780,3575885780,0
2,1081,34573,3575885780,3575885780,0
2,1081,34574,3575885780,3575885780,0
2,1081,34575,3575885780,3575885780,0
2,1081,34576,3575885780,3575885780,0
2,1081,34577,3575885780,3575885780,0
2,1081,34578,3575885780,3575885780,0
2,1081,34579,3575885780,3575885780,0
2,1081,34580,3575885780,3575885780,0
2,1081,34581,3575885780,3575885781,1
2,1081,34582,3575885780,3575885782,2
2,1081,34583,3575885780,3575885783,3
2,1081,34584,3575885780,3575885783,3
2,1081,34585,3575885780,3575885784,4
2,1081,34586,3575885780,3575885784,4
2,1081,34587,3575885780,3575885786,6
2,1081,34588,3575885780,3575885788,8
2,1081,34589,3575885780,3575885788,8
2,1081,34590,3575885780,3575885789,9
2,1081,34591,3575885780,3575885790,10
2,1081,34592,3575885780,3575885791,11
2,1081,34593,3575885780,3575885791,11
2,1081,34594,3575885780,3575885793,13
2,1081,34595,3575885780,3575885793,13
2,1081,34596,3575885780,3575885795,15
2,1081,34597,3575885780,3575885798,18
2,1081,34598,3575885780,3575885799,19
2,1081,34599,3575885780,3575885799,19
2,1081,34600,3575885780,3575885799,19
2,1081,34601,3575885780,3575885800,20
2,1081,34602,3575885780,3575885802,22
2,1081,34603,3575885780,3575885802,22
2,1081,34604,3575885780,3575885803,23
2,1081,34605,3575885780,3575885803,23
2,1081,34606,3575885780,3575885803,23
2,1081,34607,3575885780,3575885803,23
2,1081,34608,3575885780,3575885804,24
2,1081,34609,3575885780,3575885804,24
2,1081,34610,3575885780,3575885808,28
2,1081,34611,3575885780,3575885809,29
2,1081,34612,3575885780,3575885811,31
2,1081,34613,3575885780,3575885811,31
2,1081,34614,3575885780,3575885812,32
2,1081,34615,3575885780,3575885812,32
2,1081,34616,3575885780,3575885812,32
2,1081,34617,3575885780,3575885813,33
2,1081,34618,3575885780,3575885820,40
2,1081,34619,3575885780,3575885821,41
2,1081,34620,3575885780,3575885822,42
2,1081,34621,3575885780,3575885823,43
2,1081,34622,3575885780,3575885823,43
2,1081,34623,3575885780,3575885824,44
2,1081,34624,3575885780,3575885826,46
2,1081,34625,3575885780,3575885826,46
2,1081,34626,3575885780,3575885826,46
2,1081,34627,3575885780,3575885828,48
2,1081,34628,3575885780,3575885829,49
2,1081,34629,3575885780,3575885829,49
2,1081,34630,3575885780,3575885829,49
2,1082,34631,3575885843,3575885843,0
2,1082,34632,3575885843,3575885843,0
2,1082,34633,3575885843,3575885843,0
2,1082,34634,3575885843,3575885843,0
2,1082,34635,3575885843,3575885843,0
2,1082,34636,3575885843,3575885843,0
2,1082,34637,3575885843,3575885843,0
2,1082,34638,3575885843,3575885843,0
2,1082,34639,3575885843,3575885843,0
2,1082,34640,3575885843,3575885843,0
2,1082,34641,3575885843,3575885843,0
2,1082,34642,3575885843,3575885843,0
2,1082,34643,3575885843,3575885843,0
2,1082,34644,3575885843,3575885843,0
2,1082,34645,3575885843,3575885845,2
2,1082,34646,3575885843,3575885846,3
2,1082,34647,3575885843,3575885847,4
2,1082,34648,3575885843,3575885852,9
2,1082,34649,3575885843,3575885853,10
2,1082,34650,3575885843,3575885854,11
2,1082,34651,3575885843,3575885854,11
2,1082,34652,3575885843,3575885854,11
2,1082,34653,3575885843,3575885854,11
2,1082,34654,3575885843,3575885855,12
2,1082,34655,3575885843,3575885855,12
2,1082,34656,3575885843,3575885855,12
2,1082,34657,3575885843,3575885856,13
2,1082,34658,3575885843,3575885859,16
2,1082,34659,3575885843,3575885860,17
2,1082,34660,3575885843,3575885860,17
2,1082,34661,3575885843,3575885860,17
2,1082,34662,3575885843,3575885862,19
2,1082,34663,3575885843,3575885864,21
2,1082,34664,3575885843,3575885867,24
2,1082,34665,3575885843,3575885868,25
2,1082,34666,3575885843,3575885875,32
2,1082,34667,3575885843,3575885877,34
2,1082,34668,3575885843,3575885878,35
2,1082,34669,3575885843,3575885879,36
2,1082,34670,3575885843,3575885880,37
2,1082,34671,3575885843,3575885882,39
2,1082,34672,3575885843,3575885883,40
2,1082,34673,3575885843,3575885884,41
2,1082,34674,3575885843,3575885884,41
2,1082,34675,3575885843,3575885885,42
2,1082,34676,3575885843,3575885885,42
2,1082,34677,3575885843,3575885885,42
2,1082,34678,3575885843,3575885885,42
2,1082,34679,3575885843,3575885887,44
2,1082,34680,3575885843,3575885888,45
2,1082,34681,3575885843,3575885888,45
2,1082,34682,3575885843,3575885889,46
2,1082,34683,3575885843,3575885890,47
2,1082,34684,3575885843,3575885890,47
2,1082,34685,3575885843,3575885890,47
2,1082,34686,3575885843,3575885890,47
2,1082,34687,3575885843,3575885891,48
2,1082,34688,3575885843,3575885891,48
2,1082,34689,3575885843,3575885891,48
2,1082,34690,3575885843,3575885893,50
2,1083,34691,3575885906,3575885906,0
2,1083,34692,3575885906,3575885906,0
2,1083,34693,3575885906,3575885906,0
2,1083,34694,3575885906,3575885906,0
2,1083,34695,3575885906,3575885906,0
2,1083,34696,3575885906,3575885906,0
2,1083,34697,3575885906,3575885906,0
2,1083,34698,3575885906,3575885906,0
2,1083,34699,3575885906,3575885906,0
2,1083,34700,3575885906,3575885906,0
2,1083,34701,3575885906,3575885906,0
2,1083,34702,3575885906,3575885906,0
2,1083,34703,3575885906,3575885906,0
2,1083,34704,3575885906,3575885906,0
2,1083,34705,3575885906,3575885906,0
2,1083,34706,3575885906,3575885906,0
2,1083,34707,3575885906,3575885907,1
2,1083,34708,3575885906,3575885907,1
2,1083,34709,3575885906,3575885907,1
2,1083,34710,3575885906,3575885907,1
2,1083,34711,3575885906,3575885908,2
2,1083,34712,3575885906,3575885909,3
2,1083,34713,3575885906,3575885910,4
2,1083,34714,3575885906,3575885910,4
2,1083,34715,3575885906,3575885910,4
2,1083,34716,3575885906,3575885911,5
2,1083,34717,3575885906,3575885912,6
2,1083,34718,3575885906,3575885913,7
2,1083,34719,3575885906,3575885914,8
2,1083,34720,3575885906,3575885914,8
2,1083,34721,3575885906,3575885915,9
2,1083,34722,3575885906,3575885915,9
2,1083,34723,3575885906,3575885916,10
2,1083,34724,3575885906,3575885916,10
2,1083,34725,3575885906,3575885916,10
2,1083,34726,3575885906,3575885917,11
2,1083,34727,3575885906,3575885919,13
2,1083,34728,3575885906,3575885919,13
2,1083,34729,3575885906,3575885919,13
2,1083,34730,3575885906,3575885920,14
2,1083,34731,3575885906,3575885921,15
2,1083,34732,3575885906,3575885921,15
2,1083,34733,3575885906,3575885923,17
2,1083,34734,3575885906,3575885924,18
2,1083,34735,3575885906,3575885925,19
2,1083,34736,3575885906,3575885926,20
2,1083,34737,3575885906,3575885926,20
2,1083,34738,3575885906,3575885927,21
2,1083,34739,3575885906,3575885928,22
2,1083,34740,3575885906,3575885928,22
2,1083,34741,3575885906,3575885929,23
2,1083,34742,3575885906,3575885931,25
2,1083,34743,3575885906,3575885931,25
2,1083,34744,3575885906,3575885931,25
2,1083,34745,3575885906,3575885931,25
2,1083,34746,3575885906,3575885932,26
2,1083,34747,3575885906,3575885933,27
2,1083,34748,3575885906,3575885934,28
2,1083,34749,3575885906,3575885934,28
2,1083,34750,3575885906,3575885934,28
2,1083,34751,3575885906,3575885934,28
2,1083,34752,3575885906,3575885935,29
2,1083,34753,3575885906,3575885935,29
2,1083,34754,3575885906,3575885938,32
2,1083,34755,3575885906,3575885939,33
2,1083,34756,3575885906,3575885939,33
2,1083,34757,3575885906,3575885939,33
2,1083,34758,3575885906,3575885940,34
2,1083,34759,3575885906,3575885941,35
2,1083,34760,3575885906,3575885941,35
2,1083,34761,3575885906,3575885942,36
2,1083,34762,3575885906,3575885944,38
2,1083,34763,3575885906,3575885944,38
2,1083,34764,3575885906,3575885945,39
2,1083,34765,3575885906,3575885945,39
2,1083,34766,3575885906,3575885945,39
2,1083,34767,3575885906,3575885946,40
2,1083,34768,3575885906,3575885947,41
2,1083,34769,3575885906,3575885948,42
2,1083,34770,3575885906,3575885948,42
2,1083,34771,3575885906,3575885949,43
2,1083,34772,3575885906,3575885950,44
2,1083,34773,3575885906,3575885950,44
2,1083,34774,3575885906,3575885952,46
2,1083,34775,3575885906,3575885953,47
2,1083,34776,3575885906,3575885953,47
2,1083,34777,3575885906,3575885953,47
2,1083,34778,3575885906,3575885955,49
2,1084,34779,3575885970,3575885970,0
2,1084,34780,3575885970,3575885970,0
2,1084,34781,3575885970,3575885970,0
2,1084,34782,3575885970,3575885970,0
2,1084,34783,3575885970,3575885970,0
2,1084,34784,3575885970,3575885970,0
2,1084,34785,3575885970,3575885970,0
2,1084,34786,3575885970,3575885970,0
2,1084,34787,3575885970,3575885970,0
2,1084,34788,3575885970,3575885970,0
2,1084,34789,3575885970,3575885970,0
2,1084,34790,3575885970,3575885970,0
2,1084,34791,3575885970,3575885970,0
2,1084,34792,3575885970,3575885970,0
2,1084,34793,3575885970,3575885970,0
2,1084,34794,3575885970,3575885970,0
2,1084,34795,3575885970,3575885970,0
2,1084,34796,3575885970,3575885970,0
2,1084,34797,3575885970,3575885970,0
2,1084,34798,3575885970,3575885970,0
2,1084,34799,3575885970,3575885971,1
2,1084,34800,3575885970,3575885971,1
2,1084,34801,3575885970,3575885972,2
2,1084,34802,3575885970,3575885972,2
2,1084,34803,3575885970,3575885974,4
2,1084,34804,3575885970,3575885975,5
2,1084,34805,3575885970,3575885976,6
2,1084,34806,3575885970,3575885976,6
2,1084,34807,3575885970,3575885976,6
2,1084,34808,3575885970,3575885977,7
2,1084,34809,3575885970,3575885979,9
2,1084,34810,3575885970,3575885980,10
2,1084,34811,3575885970,3575885980,10
2,1084,34812,3575885970,3575885980,10
2,1084,34813,3575885970,3575885981,11
2,1084,34814,3575885970,3575885982,12
2,1084,34815,3575885970,3575885983,13
2,1084,34816,3575885970,3575885984,14
2,1084,34817,3575885970,3575885984,14
2,1084,34818,3575885970,3575885984,14
2,1084,34819,3575885970,3575885984,14
2,1084,34820,3575885970,3575885985,15
2,1084,34821,3575885970,3575885986,16
2,1084,34822,3575885970,3575885986,16
2,1084,34823,3575885970,3575885988,18
2,1084,34824,3575885970,3575885989,19
2,1084,34825,3575885970,3575885989,19
2,1084,34826,3575885970,3575885990,20
2,1084,34827,3575885970,3575885991,21
2,1084,34828,3575885970,3575885991,21
2,1084,34829,3575885970,3575885992,22
2,1084,34830,3575885970,3575885993,23
2,1084,34831,3575885970,3575885994,24
2,1084,34832,3575885970,3575885994,24
2,1084,34833,3575885970,3575885995,25
2,1084,34834,3575885970,3575885999,29
2,1084,34835,3575885970,3575885999,29
2,1084,34836,3575885970,3575885999,29
2,1084,34837,3575885970,3575886000,30
2,1084,34838,3575885970,3575886001,31
2,1084,34839,3575885970,3575886003,33
2,1084,34840,3575885970,3575886003,33
2,1084,34841,3575885970,3575886003,33
2,1084,34842,3575885970,3575886004,34
2,1084,34843,3575885970,3575886004,34
2,1084,34844,3575885970,3575886004,34
2,1084,34845,3575885970,3575886004,34
2,1084,34846,3575885970,3575886006,36
2,1084,34847,3575885970,3575886008,38
2,1084,34848,3575885970,3575886009,39
2,1084,34849,3575885970,3575886011,41
2,1084,34850,3575885970,3575886011,41
2,1084,34851,3575885970,3575886012,42
2,1084,34852,3575885970,3575886012,42
2,1084,34853,3575885970,3575886012,42
2,1084,34854,3575885970,3575886013,43
2,1084,34855,3575885970,3575886019,49
2,1085,34856,3575886037,3575886037,0
2,1085,34857,3575886037,3575886037,0
2,1085,34858,3575886037,3575886037,0
2,1085,34859,3575886037,3575886037,0
2,1085,34860,3575886037,3575886037,0
2,1085,34861,3575886037,3575886037,0
2,1085,34862,3575886037,3575886037,0
2,1085,34863,3575886037,3575886037,0
2,1085,34864,3575886037,3575886037,0
2,1085,34865,3575886037,3575886037,0
2,1085,34866,3575886037,3575886037,0
2,1085,34867,3575886037,3575886037,0
2,1085,34868,3575886037,3575886037,0
2,1085,34869,3575886037,3575886037,0
2,1085,34870,3575886037,3575886037,0
2,1085,34871,3575886037,3575886037,0
2,1085,34872,3575886037,3575886037,0
2,1085,34873,3575886037,3575886037,0
2,1085,34874,3575886037,3575886038,1
2,1085,34875,3575886037,3575886039,2
2,1085,34876,3575886037,3575886039,2
2,1085,34877,3575886037,3575886040,3
2,1085,34878,3575886037,3575886042,5
2,1085,34879,3575886037,3575886042,5
2,1085,34880,3575886037,3575886043,6
2,1085,34881,3575886037,3575886045,8
2,1085,34882,3575886037,3575886046,9
2,1085,34883,3575886037,3575886047,10
2,1085,34884,3575886037,3575886049,12
2,1085,34885,3575886037,3575886051,14
2,1085,34886,3575886037,3575886054,17
2,1085,34887,3575886037,3575886054,17
2,1085,34888,3575886037,3575886054,17
2,1085,34889,3575886037,3575886055,18
2,1085,34890,3575886037,3575886055,18
2,1085,34891,3575886037,3575886055,18
2,1085,34892,3575886037,3575886056,19
2,1085,34893,3575886037,3575886056,19
2,1085,34894,3575886037,3575886059,22
2,1085,34895,3575886037,3575886060,23
2,1085,34896,3575886037,3575886060,23
2,1085,34897,3575886037,3575886061,24
2,1085,34898,3575886037,3575886065,28
2,1085,34899,3575886037,3575886066,29
2,1085,34900,3575886037,3575886067,30
2,1085,34901,3575886037,3575886068,31
2,1085,34902,3575886037,3575886076,39
2,1085,34903,3575886037,3575886076,39
2,1085,34904,3575886037,3575886080,43
2,1085,34905,3575886037,3575886082,45
2,1085,34906,3575886037,3575886084,47
2,1085,34907,3575886037,3575886084,47
2,1085,34908,3575886037,3575886085,48
2,1085,34909,3575886037,3575886085,48
2,1085,34910,3575886037,3575886085,48
2,1085,34911,3575886037,3575886086,49
2,1085,34912,3575886037,3575886086,49
2,1085,34913,3575886037,3575886087,50
2,1086,34914,3575886103,3575886103,0
2,1086,34915,3575886103,3575886103,0
2,1086,34916,3575886103,3575886103,0
2,1086,34917,3575886103,3575886103,0
2,1086,34918,3575886103,3575886103,0
2,1086,34919,3575886103,3575886103,0
2,1086,34920,3575886103,3575886103,0
2,1086,34921,3575886103,3575886103,0
2,1086,34922,3575886103,3575886103,0
2,1086,34923,3575886103,3575886103,0
2,1086,34924,3575886103,3575886103,0
2,1086,34925,3575886103,3575886103,0
2,1086,34926,3575886103,3575886103,0
2,1086,34927,3575886103,3575886103,0
2,1086,34928,3575886103,3575886103,0
2,1086,34929,3575886103,3575886103,0
2,1086,34930,3575886103,3575886103,0
2,1086,34931,3575886103,3575886103,0
2,1086,34932,3575886103,3575886103,0
2,1086,34933,3575886103,3575886103,0
2,1086,34934,3575886103,3575886103,0
2,1086,34935,3575886103,3575886103,0
2,1086,34936,3575886103,3575886103,0
2,1086,34937,3575886103,3575886104,1
2,1086,34938,3575886103,3575886104,1
2,1086,34939,3575886103,3575886105,2
2,1086,34940,3575886103,3575886106,3
2,1086,34941,3575886103,3575886107,4
2,1086,34942,3575886103,3575886107,4
2,1086,34943,3575886103,3575886107,4
2,1086,34944,3575886103,3575886109,6
2,1086,34945,3575886103,3575886109,6
2,1086,34946,3575886103,3575886109,6
2,1086,34947,3575886103,3575886110,7
2,1086,34948,3575886103,3575886110,7
2,1086,34949,3575886103,3575886110,7
2,1086,34950,3575886103,3575886110,7
2,1086,34951,3575886103,3575886110,7
2,1086,34952,3575886103,3575886112,9
2,1086,34953,3575886103,3575886113,10
2,1086,34954,3575886103,3575886115,12
2,1086,34955,3575886103,3575886115,12
2,1086,34956,3575886103,3575886115,12
2,1086,34957,3575886103,3575886116,13
2,1086,34958,3575886103,3575886116,13
2,1086,34959,3575886103,3575886117,14
2,1086,34960,3575886103,3575886118,15
2,1086,34961,3575886103,3575886118,15
2,1086,34962,3575886103,3575886119,16
2,1086,34963,3575886103,3575886120,17
2,1086,34964,3575886103,3575886120,17
2,1086,34965,3575886103,3575886121,18
2,1086,34966,3575886103,3575886122,19
2,1086,34967,3575886103,3575886122,19
2,1086,34968,3575886103,3575886123,20
2,1086,34969,3575886103,3575886123,20
2,1086,34970,3575886103,3575886125,22
2,1086,34971,3575886103,3575886126,23
2,1086,34972,3575886103,3575886126,23
2,1086,34973,3575886103,3575886127,24
2,1086,34974,3575886103,3575886129,26
2,1086,34975,3575886103,3575886129,26
2,1086,34976,3575886103,3575886129,26
2,1086,34977,3575886103,3575886131,28
2,1086,34978,3575886103,3575886131,28
2,1086,34979,3575886103,3575886132,29
2,1086,34980,3575886103,3575886132,29
2,1086,34981,3575886103,3575886132,29
2,1086,34982,3575886103,3575886132,29
2,1086,34983,3575886103,3575886134,31
2,1086,34984,3575886103,3575886134,31
2,1086,34985,3575886103,3575886134,31
2,1086,34986,3575886103,3575886134,31
2,1086,34987,3575886103,3575886136,33
2,1086,34988,3575886103,3575886136,33
2,1086,34989,3575886103,3575886138,35
2,1086,34990,3575886103,3575886139,36
2,1086,34991,3575886103,3575886139,36
2,1086,34992,3575886103,3575886139,36
2,1086,34993,3575886103,3575886139,36
2,1086,34994,3575886103,3575886140,37
2,1086,34995,3575886103,3575886141,38
2,1086,34996,3575886103,3575886142,39
2,1086,34997,3575886103,3575886145,42
2,1086,34998,3575886103,3575886145,42
2,1086,34999,3575886103,3575886146,43
2,1086,35000,3575886103,3575886147,44
2,1086,35001,3575886103,3575886148,45
2,1086,35002,3575886103,3575886148,45
2,1086,35003,3575886103,3575886149,46
2,1086,35004,3575886103,3575886149,46
2,1086,35005,3575886103,3575886150,47
2,1086,35006,3575886103,3575886150,47
2,1086,35007,3575886103,3575886152,49
2,1087,35008,3575886165,3575886165,0
2,1087,35009,3575886165,3575886165,0
2,1087,35010,3575886165,3575886165,0
2,1087,35011,3575886165,3575886165,0
2,1087,35012,3575886165,3575886165,0
2,1087,35013,3575886165,3575886165,0
2,1087,35014,3575886165,3575886165,0
2,1087,35015,3575886165,3575886165,0
2,1087,35016,3575886165,3575886165,0
2,1087,35017,3575886165,3575886165,0
2,1087,35018,3575886165,3575886165,0
2,1087,35019,3575886165,3575886165,0
2,1087,35020,3575886165,3575886165,0
2,1087,35021,3575886165,3575886165,0
2,1087,35022,3575886165,3575886165,0
2,1087,35023,3575886165,3575886165,0
2,1087,35024,3575886165,3575886167,2
2,1087,35025,3575886165,3575886167,2
2,1087,35026,3575886165,3575886168,3
2,1087,35027,3575886165,3575886168,3
2,1087,35028,3575886165,3575886169,4
2,1087,35029,3575886165,3575886169,4
2,1087,35030,3575886165,3575886170,5
2,1087,35031,3575886165,3575886171,6
2,1087,35032,3575886165,3575886171,6
2,1087,35033,3575886165,3575886172,7
2,1087,35034,3575886165,3575886172,7
2,1087,35035,3575886165,3575886175,10
2,1087,35036,3575886165,3575886175,10
2,1087,35037,3575886165,3575886176,11
2,1087,35038,3575886165,3575886176,11
2,1087,35039,3575886165,3575886176,11
2,1087,35040,3575886165,3575886177,12
2,1087,35041,3575886165,3575886178,13
2,1087,35042,3575886165,3575886178,13
2,1087,35043,3575886165,3575886180,15
2,1087,35044,3575886165,3575886180,15
2,1087,35045,3575886165,3575886181,16
2,1087,35046,3575886165,3575886181,16
2,1087,35047,3575886165,3575886181,16
2,1087,35048,3575886165,3575886183,18
2,1087,35049,3575886165,3575886183,18
2,1087,35050,3575886165,3575886184,19
2,1087,35051,3575886165,3575886185,20
2,1087,35052,3575886165,3575886185,20
2,1087,35053,3575886165,3575886185,20
2,1087,35054,3575886165,3575886185,20
2,1087,35055,3575886165,3575886186,21
2,1087,35056,3575886165,3575886187,22
2,1087,35057,3575886165,3575886188,23
2,1087,35058,3575886165,3575886189,24
2,1087,35059,3575886165,3575886189,24
2,1087,35060,3575886165,3575886190,25
2,1087,35061,3575886165,3575886191,26
2,1087,35062,3575886165,3575886192,27
2,1087,35063,3575886165,3575886194,29
2,1087,35064,3575886165,3575886195,30
2,1087,35065,3575886165,3575886195,30
2,1087,35066,3575886165,3575886198,33
2,1087,35067,3575886165,3575886198,33
2,1087,35068,3575886165,3575886199,34
2,1087,35069,3575886165,3575886199,34
2,1087,35070,3575886165,3575886200,35
2,1087,35071,3575886165,3575886203,38
2,1087,35072,3575886165,3575886204,39
2,1087,35073,3575886165,3575886204,39
2,1087,35074,3575886165,3575886204,39
2,1087,35075,3575886165,3575886204,39
2,1087,35076,3575886165,3575886204,39
2,1087,35077,3575886165,3575886207,42
2,1087,35078,3575886165,3575886208,43
2,1087,35079,3575886165,3575886209,44
2,1087,35080,3575886165,3575886211,46
2,1087,35081,3575886165,3575886211,46
2,1087,35082,3575886165,3575886211,46
2,1087,35083,3575886165,3575886212,47
2,1088,35084,3575886230,3575886230,0
2,1088,35085,3575886230,3575886230,0
2,1088,35086,3575886230,3575886230,0
2,1088,35087,3575886230,3575886230,0
2,1088,35088,3575886230,3575886231,1
2,1088,35089,3575886230,3575886231,1
2,1088,35090,3575886230,3575886231,1
2,1088,35091,3575886230,3575886231,1
2,1088,35092,3575886230,3575886231,1
2,1088,35093,3575886230,3575886231,1
2,1088,35094,3575886230,3575886231,1
2,1088,35095,3575886230,3575886231,1
2,1088,35096,3575886230,3575886231,1
2,1088,35097,3575886230,3575886231,1
2,1088,35098,3575886230,3575886236,6
2,1088,35099,3575886230,3575886236,6
2,1088,35100,3575886230,3575886236,6
2,1088,35101,3575886230,3575886237,7
2,1088,35102,3575886230,3575886237,7
2,1088,35103,3575886230,3575886237,7
2,1088,35104,3575886230,3575886237,7
2,1088,35105,3575886230,3575886238,8
2,1088,35106,3575886230,3575886239,9
2,1088,35107,3575886230,3575886239,9
2,1088,35108,3575886230,3575886240,10
2,1088,35109,3575886230,3575886241,11
2,1088,35110,3575886230,3575886242,12
2,1088,35111,3575886230,3575886242,12
2,1088,35112,3575886230,3575886245,15
2,1088,35113,3575886230,3575886247,17
2,1088,35114,3575886230,3575886247,17
2,1088,35115,3575886230,3575886249,19
2,1088,35116,3575886230,3575886252,22
2,1088,35117,3575886230,3575886254,24
2,1088,35118,3575886230,3575886254,24
2,1088,35119,3575886230,3575886254,24
2,1088,35120,3575886230,3575886255,25
2,1088,35121,3575886230,3575886255,25
2,1088,35122,3575886230,3575886255,25
2,1088,35123,3575886230,3575886256,26
2,1088,35124,3575886230,3575886256,26
2,1088,35125,3575886230,3575886257,27
2,1088,35126,3575886230,3575886257,27
2,1088,35127,3575886230,3575886259,29
2,1088,35128,3575886230,3575886259,29
2,1088,35129,3575886230,3575886260,30
2,1088,35130,3575886230,3575886261,31
2,1088,35131,3575886230,3575886263,33
2,1088,35132,3575886230,3575886265,35
2,1088,35133,3575886230,3575886266,36
2,1088,35134,3575886230,3575886267,37
2,1088,35135,3575886230,3575886268,38
2,1088,35136,3575886230,3575886275,45
2,1088,35137,3575886230,3575886276,46
2,1088,35138,3575886230,3575886279,49
2,1088,35139,3575886230,3575886280,50
2,1089,35140,3575886293,3575886293,0
2,1089,35141,3575886293,3575886293,0
2,1089,35142,3575886293,3575886293,0
2,1089,35143,3575886293,3575886293,0
2,1089,35144,3575886293,3575886293,0
2,1089,35145,3575886293,3575886293,0
2,1089,35146,3575886293,3575886293,0
2,1089,35147,3575886293,3575886293,0
2,1089,35148,3575886293,3575886293,0
2,1089,35149,3575886293,3575886293,0
2,1089,35150,3575886293,3575886293,0
2,1089,35151,3575886293,3575886293,0
2,1089,35152,3575886293,3575886293,0
2,1089,35153,3575886293,3575886293,0
2,1089,35154,3575886293,3575886293,0
2,1089,35155,3575886293,3575886293,0
2,1089,35156,3575886293,3575886293,0
2,1089,35157,3575886293,3575886293,0
2,1089,35158,3575886293,3575886293,0
2,1089,35159,3575886293,3575886294,1
2,1089,35160,3575886293,3575886296,3
2,1089,35161,3575886293,3575886297,4
2,1089,35162,3575886293,3575886298,5
2,1089,35163,3575886293,3575886298,5
2,1089,35164,3575886293,3575886300,7
2,1089,35165,3575886293,3575886300,7
2,1089,35166,3575886293,3575886300,7
2,1089,35167,3575886293,3575886301,8
2,1089,35168,3575886293,3575886301,8
2,1089,35169,3575886293,3575886304,11
2,1089,35170,3575886293,3575886305,12
2,1089,35171,3575886293,3575886306,13
2,1089,35172,3575886293,3575886306,13
2,1089,35173,3575886293,3575886307,14
2,1089,35174,3575886293,3575886307,14
2,1089,35175,3575886293,3575886307,14
2,1089,35176,3575886293,3575886308,15
2,1089,35177,3575886293,3575886308,15
2,1089,35178,3575886293,3575886309,16
2,1089,35179,3575886293,3575886309,16
2,1089,35180,3575886293,3575886309,16
2,1089,35181,3575886293,3575886310,17
2,1089,35182,3575886293,3575886310,17
2,1089,35183,3575886293,3575886310,17
2,1089,35184,3575886293,3575886310,17
2,1089,35185,3575886293,3575886312,19
2,1089,35186,3575886293,3575886312,19
2,1089,35187,3575886293,3575886313,20
2,1089,35188,3575886293,3575886314,21
2,1089,35189,3575886293,3575886315,22
2,1089,35190,3575886293,3575886316,23
2,1089,35191,3575886293,3575886316,23
2,1089,35192,3575886293,3575886316,23
2,1089,35193,3575886293,3575886318,25
2,1089,35194,3575886293,3575886319,26
2,1089,35195,3575886293,3575886319,26
2,1089,35196,3575886293,3575886320,27
2,1089,35197,3575886293,3575886320,27
2,1089,35198,3575886293,3575886321,28
2,1089,35199,3575886293,3575886321,28
2,1089,35200,3575886293,3575886322,29
2,1089,35201,3575886293,3575886324,31
2,1089,35202,3575886293,3575886325,32
2,1089,35203,3575886293,3575886326,33
2,1089,35204,3575886293,3575886326,33
2,1089,35205,3575886293,3575886327,34
2,1089,35206,3575886293,3575886329,36
2,1089,35207,3575886293,3575886329,36
2,1089,35208,3575886293,3575886329,36
2,1089,35209,3575886293,3575886330,37
2,1089,35210,3575886293,3575886331,38
2,1089,35211,3575886293,3575886331,38
2,1089,35212,3575886293,3575886331,38
2,1089,35213,3575886293,3575886332,39
2,1089,35214,3575886293,3575886333,40
2,1089,35215,3575886293,3575886334,41
2,1089,35216,3575886293,3575886334,41
2,1089,35217,3575886293,3575886334,41
2,1089,35218,3575886293,3575886334,41
2,1089,35219,3575886293,3575886335,42
2,1089,35220,3575886293,3575886335,42
2,1089,35221,3575886293,3575886338,45
2,1089,35222,3575886293,3575886339,46
2,1089,35223,3575886293,3575886339,46
2,1089,35224,3575886293,3575886340,47
2,1089,35225,3575886293,3575886340,47
2,1089,35226,3575886293,3575886340,47
2,1089,35227,3575886293,3575886341,48
2,1090,35228,3575886357,3575886357,0
2,1090,35229,3575886357,3575886357,0
2,1090,35230,3575886357,3575886357,0
2,1090,35231,3575886357,3575886357,0
2,1090,35232,3575886357,3575886357,0
2,1090,35233,3575886357,3575886357,0
2,1090,35234,3575886357,3575886357,0
2,1090,35235,3575886357,3575886357,0
2,1090,35236,3575886357,3575886357,0
2,1090,35237,3575886357,3575886357,0
2,1090,35238,3575886357,3575886357,0
2,1090,35239,3575886357,3575886357,0
2,1090,35240,3575886357,3575886357,0
2,1090,35241,3575886357,3575886357,0
2,1090,35242,3575886357,3575886357,0
2,1090,35243,3575886357,3575886357,0
2,1090,35244,3575886357,3575886357,0
2,1090,35245,3575886357,3575886357,0
2,1090,35246,3575886357,3575886357,0
2,1090,35247,3575886357,3575886358,1
2,1090,35248,3575886357,3575886358,1
2,1090,35249,3575886357,3575886359,2
2,1090,35250,3575886357,3575886360,3
2,1090,35251,3575886357,3575886360,3
2,1090,35252,3575886357,3575886361,4
2,1090,35253,3575886357,3575886361,4
2,1090,35254,3575886357,3575886361,4
2,1090,35255,3575886357,3575886362,5
2,1090,35256,3575886357,3575886363,6
2,1090,35257,3575886357,3575886366,9
2,1090,35258,3575886357,3575886367,10
2,1090,35259,3575886357,3575886367,10
2,1090,35260,3575886357,3575886367,10
2,1090,35261,3575886357,3575886368,11
2,1090,35262,3575886357,3575886369,12
2,1090,35263,3575886357,3575886369,12
2,1090,35264,3575886357,3575886370,13
2,1090,35265,3575886357,3575886370,13
2,1090,35266,3575886357,3575886371,14
2,1090,35267,3575886357,3575886371,14
2,1090,35268,3575886357,3575886373,16
2,1090,35269,3575886357,3575886373,16
2,1090,35270,3575886357,3575886375,18
2,1090,35271,3575886357,3575886375,18
2,1090,35272,3575886357,3575886375,18
2,1090,35273,3575886357,3575886375,18
2,1090,35274,3575886357,3575886375,18
2,1090,35275,3575886357,3575886376,19
2,1090,35276,3575886357,3575886377,20
2,1090,35277,3575886357,3575886378,21
2,1090,35278,3575886357,3575886379,22
2,1090,35279,3575886357,3575886379,22
2,1090,35280,3575886357,3575886380,23
2,1090,35281,3575886357,3575886381,24
2,1090,35282,3575886357,3575886382,25
2,1090,35283,3575886357,3575886382,25
2,1090,35284,3575886357,3575886383,26
2,1090,35285,3575886357,3575886384,27
2,1090,35286,3575886357,3575886384,27
2,1090,35287,3575886357,3575886385,28
2,1090,35288,3575886357,3575886385,28
2,1090,35289,3575886357,3575886385,28
2,1090,35290,3575886357,3575886386,29
2,1090,35291,3575886357,3575886386,29
2,1090,35292,3575886357,3575886386,29
2,1090,35293,3575886357,3575886388,31
2,1090,35294,3575886357,3575886388,31
2,1090,35295,3575886357,3575886389,32
2,1090,35296,3575886357,3575886389,32
2,1090,35297,3575886357,3575886390,33
2,1090,35298,3575886357,3575886391,34
2,1090,35299,3575886357,3575886391,34
2,1090,35300,3575886357,3575886392,35
2,1090,35301,3575886357,3575886394,37
2,1090,35302,3575886357,3575886394,37
2,1090,35303,3575886357,3575886396,39
2,1090,35304,3575886357,3575886398,41
2,1090,35305,3575886357,3575886399,42
2,1090,35306,3575886357,3575886400,43
2,1090,35307,3575886357,3575886400,43
2,1090,35308,3575886357,3575886403,46
2,1090,35309,3575886357,3575886403,46
2,1090,35310,3575886357,3575886403,46
2,1090,35311,3575886357,3575886404,47
2,1090,35312,3575886357,3575886404,47
2,1090,35313,3575886357,3575886405,48
2,1091,35314,3575886420,3575886420,0
2,1091,35315,3575886420,3575886420,0
2,1091,35316,3575886420,3575886420,0
2,1091,35317,3575886420,3575886420,0
2,1091,35318,3575886420,3575886420,0
2,1091,35319,3575886420,3575886420,0
2,1091,35320,3575886420,3575886420,0
2,1091,35321,3575886420,3575886420,0
2,1091,35322,3575886420,3575886421,1
2,1091,35323,3575886420,3575886422,2
2,1091,35324,3575886420,3575886423,3
2,1091,35325,3575886420,3575886423,3
2,1091,35326,3575886420,3575886424,4
2,1091,35327,3575886420,3575886425,5
2,1091,35328,3575886420,3575886426,6
2,1091,35329,3575886420,3575886426,6
2,1091,35330,3575886420,3575886428,8
2,1091,35331,3575886420,3575886428,8
2,1091,35332,3575886420,3575886429,9
2,1091,35333,3575886420,3575886430,10
2,1091,35334,3575886420,3575886432,12
2,1091,35335,3575886420,3575886435,15
2,1091,35336,3575886420,3575886435,15
2,1091,35337,3575886420,3575886437,17
2,1091,35338,3575886420,3575886437,17
2,1091,35339,3575886420,3575886437,17
2,1091,35340,3575886420,3575886437,17
2,1091,35341,3575886420,3575886438,18
2,1091,35342,3575886420,3575886438,18
2,1091,35343,3575886420,3575886439,19
2,1091,35344,3575886420,3575886439,19
2,1091,35345,3575886420,3575886440,20
2,1091,35346,3575886420,3575886440,20
2,1091,35347,3575886420,3575886442,22
2,1091,35348,3575886420,3575886443,23
2,1091,35349,3575886420,3575886445,25
2,1091,35350,3575886420,3575886447,27
2,1091,35351,3575886420,3575886447,27
2,1091,35352,3575886420,3575886449,29
2,1091,35353,3575886420,3575886452,32
2,1091,35354,3575886420,3575886454,34
2,1091,35355,3575886420,3575886454,34
2,1091,35356,3575886420,3575886454,34
2,1091,35357,3575886420,3575886455,35
2,1091,35358,3575886420,3575886455,35
2,1091,35359,3575886420,3575886456,36
2,1091,35360,3575886420,3575886457,37
2,1091,35361,3575886420,3575886458,38
2,1091,35362,3575886420,3575886459,39
2,1091,35363,3575886420,3575886460,40
2,1091,35364,3575886420,3575886460,40
2,1091,35365,3575886420,3575886462,42
2,1091,35366,3575886420,3575886463,43
2,1091,35367,3575886420,3575886465,45
2,1091,35368,3575886420,3575886467,47
2,1091,35369,3575886420,3575886467,47
2,1092,35370,3575886483,3575886483,0
2,1092,35371,3575886483,3575886483,0
2,1092,35372,3575886483,3575886483,0
2,1092,35373,3575886483,3575886483,0
2,1092,35374,3575886483,3575886483,0
2,1092,35375,3575886483,3575886483,0
2,1092,35376,3575886483,3575886483,0
2,1092,35377,3575886483,3575886483,0
2,1092,35378,3575886483,3575886484,1
2,1092,35379,3575886483,3575886484,1
2,1092,35380,3575886483,3575886484,1
2,1092,35381,3575886483,3575886485,2
2,1092,35382,3575886483,3575886485,2
2,1092,35383,3575886483,3575886486,3
2,1092,35384,3575886483,3575886488,5
2,1092,35385,3575886483,3575886489,6
2,1092,35386,3575886483,3575886489,6
2,1092,35387,3575886483,3575886489,6
2,1092,35388,3575886483,3575886490,7
2,1092,35389,3575886483,3575886490,7
2,1092,35390,3575886483,3575886490,7
2,1092,35391,3575886483,3575886491,8
2,1092,35392,3575886483,3575886491,8
2,1092,35393,3575886483,3575886492,9
2,1092,35394,3575886483,3575886493,10
2,1092,35395,3575886483,3575886493,10
2,1092,35396,3575886483,3575886494,11
2,1092,35397,3575886483,3575886495,12
2,1092,35398,3575886483,3575886497,14
2,1092,35399,3575886483,3575886498,15
2,1092,35400,3575886483,3575886498,15
2,1092,35401,3575886483,3575886500,17
2,1092,35402,3575886483,3575886500,17
2,1092,35403,3575886483,3575886501,18
2,1092,35404,3575886483,3575886504,21
2,1092,35405,3575886483,3575886505,22
2,1092,35406,3575886483,3575886505,22
2,1092,35407,3575886483,3575886507,24
2,1092,35408,3575886483,3575886507,24
2,1092,35409,3575886483,3575886507,24
2,1092,35410,3575886483,3575886507,24
2,1092,35411,3575886483,3575886508,25
2,1092,35412,3575886483,3575886508,25
2,1092,35413,3575886483,3575886508,25
2,1092,35414,3575886483,3575886508,25
2,1092,35415,3575886483,3575886509,26
2,1092,35416,3575886483,3575886509,26
2,1092,35417,3575886483,3575886509,26
2,1092,35418,3575886483,3575886509,26
2,1092,35419,3575886483,3575886510,27
2,1092,35420,3575886483,3575886510,27
2,1092,35421,3575886483,3575886511,28
2,1092,35422,3575886483,3575886512,29
2,1092,35423,3575886483,3575886512,29
2,1092,35424,3575886483,3575886514,31
2,1092,35425,3575886483,3575886514,31
2,1092,35426,3575886483,3575886515,32
2,1092,35427,3575886483,3575886515,32
2,1092,35428,3575886483,3575886515,32
2,1092,35429,3575886483,3575886516,33
2,1092,35430,3575886483,3575886517,34
2,1092,35431,3575886483,3575886518,35
2,1092,35432,3575886483,3575886518,35
2,1092,35433,3575886483,3575886519,36
2,1092,35434,3575886483,3575886520,37
2,1092,35435,3575886483,3575886520,37
2,1092,35436,3575886483,3575886520,37
2,1092,35437,3575886483,3575886523,40
2,1092,35438,3575886483,3575886524,41
2,1092,35439,3575886483,3575886525,42
2,1092,35440,3575886483,3575886526,43
2,1092,35441,3575886483,3575886526,43
2,1092,35442,3575886483,3575886529,46
2,1092,35443,3575886483,3575886529,46
2,1092,35444,3575886483,3575886530,47
2,1092,35445,3575886483,3575886531,48
2,1092,35446,3575886483,3575886531,48
2,1092,35447,3575886483,3575886531,48
2,1092,35448,3575886483,3575886532,49
2,1092,35449,3575886483,3575886533,50
2,1093,35450,3575886546,3575886546,0
2,1093,35451,3575886546,3575886546,0
2,1093,35452,3575886546,3575886546,0
2,1093,35453,3575886546,3575886546,0
2,1093,35454,3575886546,3575886546,0
2,1093,35455,3575886546,3575886546,0
2,1093,35456,3575886546,3575886546,0
2,1093,35457,3575886546,3575886546,0
2,1093,35458,3575886546,3575886546,0
2,1093,35459,3575886546,3575886546,0
2,1093,35460,3575886546,3575886546,0
2,1093,35461,3575886546,3575886546,0
2,1093,35462,3575886546,3575886546,0
2,1093,35463,3575886546,3575886546,0
2,1093,35464,3575886546,3575886546,0
2,1093,35465,3575886546,3575886546,0
2,1093,35466,3575886546,3575886546,0
2,1093,35467,3575886546,3575886546,0
2,1093,35468,3575886546,3575886546,0
2,1093,35469,3575886546,3575886546,0
2,1093,35470,3575886546,3575886547,1
2,1093,35471,3575886546,3575886548,2
2,1093,35472,3575886546,3575886549,3
2,1093,35473,3575886546,3575886549,3
2,1093,35474,3575886546,3575886550,4
2,1093,35475,3575886546,3575886551,5
2,1093,35476,3575886546,3575886552,6
2,1093,35477,3575886546,3575886553,7
2,1093,35478,3575886546,3575886553,7
2,1093,35479,3575886546,3575886556,10
2,1093,35480,3575886546,3575886556,10
2,1093,35481,3575886546,3575886557,11
2,1093,35482,3575886546,3575886558,12
2,1093,35483,3575886546,3575886559,13
2,1093,35484,3575886546,3575886560,14
2,1093,35485,3575886546,3575886560,14
2,1093,35486,3575886546,3575886561,15
2,1093,35487,3575886546,3575886561,15
2,1093,35488,3575886546,3575886561,15
2,1093,35489,3575886546,3575886561,15
2,1093,35490,3575886546,3575886563,17
2,1093,35491,3575886546,3575886565,19
2,1093,35492,3575886546,3575886565,19
2,1093,35493,3575886546,3575886566,20
2,1093,35494,3575886546,3575886566,20
2,1093,35495,3575886546,3575886567,21
2,1093,35496,3575886546,3575886567,21
2,1093,35497,3575886546,3575886568,22
2,1093,35498,3575886546,3575886568,22
2,1093,35499,3575886546,3575886569,23
2,1093,35500,3575886546,3575886569,23
2,1093,35501,3575886546,3575886570,24
2,1093,35502,3575886546,3575886571,25
2,1093,35503,3575886546,3575886571,25
2,1093,35504,3575886546,3575886572,26
2,1093,35505,3575886546,3575886574,28
2,1093,35506,3575886546,3575886574,28
2,1093,35507,3575886546,3575886574,28
2,1093,35508,3575886546,3575886575,29
2,1093,35509,3575886546,3575886575,29
2,1093,35510,3575886546,3575886576,30
2,1093,35511,3575886546,3575886576,30
2,1093,35512,3575886546,3575886577,31
2,1093,35513,3575886546,3575886578,32
2,1093,35514,3575886546,3575886579,33
2,1093,35515,3575886546,3575886579,33
2,1093,35516,3575886546,3575886581,35
2,1093,35517,3575886546,3575886581,35
2,1093,35518,3575886546,3575886581,35
2,1093,35519,3575886546,3575886582,36
2,1093,35520,3575886546,3575886582,36
2,1093,35521,3575886546,3575886583,37
2,1093,35522,3575886546,3575886584,38
2,1093,35523,3575886546,3575886584,38
2,1093,35524,3575886546,3575886584,38
2,1093,35525,3575886546,3575886585,39
2,1093,35526,3575886546,3575886585,39
2,1093,35527,3575886546,3575886585,39
2,1093,35528,3575886546,3575886587,41
2,1093,35529,3575886546,3575886588,42
2,1093,35530,3575886546,3575886588,42
2,1093,35531,3575886546,3575886588,42
2,1093,35532,3575886546,3575886590,44
2,1093,35533,3575886546,3575886590,44
2,1093,35534,3575886546,3575886591,45
2,1093,35535,3575886546,3575886591,45
2,1093,35536,3575886546,3575886593,47
2,1093,35537,3575886546,3575886594,48
2,1093,35538,3575886546,3575886594,48
2,1093,35539,3575886546,3575886595,49
2,1094,35540,3575886608,3575886608,0
2,1094,35541,3575886608,3575886608,0
2,1094,35542,3575886608,3575886608,0
2,1094,35543,3575886608,3575886608,0
2,1094,35544,3575886608,3575886608,0
2,1094,35545,3575886608,3575886608,0
2,1094,35546,3575886608,3575886608,0
2,1094,35547,3575886608,3575886608,0
2,1094,35548,3575886608,3575886608,0
2,1094,35549,3575886608,3575886608,0
2,1094,35550,3575886608,3575886608,0
2,1094,35551,3575886608,3575886608,0
2,1094,35552,3575886608,3575886609,1
2,1094,35553,3575886608,3575886610,2
2,1094,35554,3575886608,3575886611,3
2,1094,35555,3575886608,3575886611,3
2,1094,35556,3575886608,3575886612,4
2,1094,35557,3575886608,3575886613,5
2,1094,35558,3575886608,3575886618,10
2,1094,35559,3575886608,3575886621,13
2,1094,35560,3575886608,3575886621,13
2,1094,35561,3575886608,3575886623,15
2,1094,35562,3575886608,3575886623,15
2,1094,35563,3575886608,3575886623,15
2,1094,35564,3575886608,3575886624,16
2,1094,35565,3575886608,3575886625,17
2,1094,35566,3575886608,3575886627,19
2,1094,35567,3575886608,3575886628,20
2,1094,35568,3575886608,3575886628,20
2,1094,35569,3575886608,3575886628,20
2,1094,35570,3575886608,3575886629,21
2,1094,35571,3575886608,3575886632,24
2,1094,35572,3575886608,3575886634,26
2,1094,35573,3575886608,3575886635,27
2,1094,35574,3575886608,3575886636,28
2,1094,35575,3575886608,3575886636,28
2,1094,35576,3575886608,3575886636,28
2,1094,35577,3575886608,3575886637,29
2,1094,35578,3575886608,3575886637,29
2,1094,35579,3575886608,3575886637,29
2,1094,35580,3575886608,3575886638,30
2,1094,35581,3575886608,3575886639,31
2,1094,35582,3575886608,3575886639,31
2,1094,35583,3575886608,3575886640,32
2,1094,35584,3575886608,3575886641,33
2,1094,35585,3575886608,3575886642,34
2,1094,35586,3575886608,3575886643,35
2,1094,35587,3575886608,3575886644,36
2,1094,35588,3575886608,3575886646,38
2,1094,35589,3575886608,3575886646,38
2,1094,35590,3575886608,3575886648,40
2,1094,35591,3575886608,3575886651,43
2,1094,35592,3575886608,3575886653,45
2,1094,35593,3575886608,3575886654,46
2,1094,35594,3575886608,3575886654,46
2,1094,35595,3575886608,3575886654,46
2,1094,35596,3575886608,3575886655,47
2,1094,35597,3575886608,3575886656,48
2,1094,35598,3575886608,3575886657,49
2,1094,35599,3575886608,3575886658,50
2,1095,35600,3575886672,3575886672,0
2,1095,35601,3575886672,3575886672,0
2,1095,35602,3575886672,3575886672,0
2,1095,35603,3575886672,3575886672,0
2,1095,35604,3575886672,3575886672,0
2,1095,35605,3575886672,3575886672,0
2,1095,35606,3575886672,3575886672,0
2,1095,35607,3575886672,3575886672,0
2,1095,35608,3575886672,3575886676,4
2,1095,35609,3575886672,3575886677,5
2,1095,35610,3575886672,3575886677,5
2,1095,35611,3575886672,3575886679,7
2,1095,35612,3575886672,3575886679,7
2,1095,35613,3575886672,3575886682,10
2,1095,35614,3575886672,3575886683,11
2,1095,35615,3575886672,3575886683,11
2,1095,35616,3575886672,3575886683,11
2,1095,35617,3575886672,3575886684,12
2,1095,35618,3575886672,3575886684,12
2,1095,35619,3575886672,3575886685,13
2,1095,35620,3575886672,3575886686,14
2,1095,35621,3575886672,3575886688,16
2,1095,35622,3575886672,3575886689,17
2,1095,35623,3575886672,3575886689,17
2,1095,35624,3575886672,3575886689,17
2,1095,35625,3575886672,3575886690,18
2,1095,35626,3575886672,3575886690,18
2,1095,35627,3575886672,3575886690,18
2,1095,35628,3575886672,3575886691,19
2,1095,35629,3575886672,3575886691,19
2,1095,35630,3575886672,3575886692,20
2,1095,35631,3575886672,3575886693,21
2,1095,35632,3575886672,3575886693,21
2,1095,35633,3575886672,3575886693,21
2,1095,35634,3575886672,3575886694,22
2,1095,35635,3575886672,3575886695,23
2,1095,35636,3575886672,3575886697,25
2,1095,35637,3575886672,3575886697,25
2,1095,35638,3575886672,3575886698,26
2,1095,35639,3575886672,3575886698,26
2,1095,35640,3575886672,3575886699,27
2,1095,35641,3575886672,3575886700,28
2,1095,35642,3575886672,3575886700,28
2,1095,35643,3575886672,3575886700,28
2,1095,35644,3575886672,3575886704,32
2,1095,35645,3575886672,3575886704,32
2,1095,35646,3575886672,3575886705,33
2,1095,35647,3575886672,3575886706,34
2,1095,35648,3575886672,3575886706,34
2,1095,35649,3575886672,3575886708,36
2,1095,35650,3575886672,3575886708,36
2,1095,35651,3575886672,3575886708,36
2,1095,35652,3575886672,3575886709,37
2,1095,35653,3575886672,3575886709,37
2,1095,35654,3575886672,3575886709,37
2,1095,35655,3575886672,3575886709,37
2,1095,35656,3575886672,3575886709,37
2,1095,35657,3575886672,3575886709,37
2,1095,35658,3575886672,3575886710,38
2,1095,35659,3575886672,3575886710,38
2,1095,35660,3575886672,3575886710,38
2,1095,35661,3575886672,3575886710,38
2,1095,35662,3575886672,3575886711,39
2,1095,35663,3575886672,3575886712,40
2,1095,35664,3575886672,3575886713,41
2,1095,35665,3575886672,3575886714,42
2,1095,35666,3575886672,3575886715,43
2,1095,35667,3575886672,3575886716,44
2,1095,35668,3575886672,3575886716,44
2,1095,35669,3575886672,3575886717,45
2,1095,35670,3575886672,3575886718,46
2,1095,35671,3575886672,3575886718,46
2,1095,35672,3575886672,3575886719,47
2,1095,35673,3575886672,3575886720,48
2,1095,35674,3575886672,3575886720,48
2,1095,35675,3575886672,3575886721,49
2,1095,35676,3575886672,3575886721,49
2,1095,35677,3575886672,3575886722,50
2,1096,35678,3575886735,3575886735,0
2,1096,35679,3575886735,3575886735,0
2,1096,35680,3575886735,3575886735,0
2,1096,35681,3575886735,3575886735,0
2,1096,35682,3575886735,3575886735,0
2,1096,35683,3575886735,3575886735,0
2,1096,35684,3575886735,3575886735,0
2,1096,35685,3575886735,3575886735,0
2,1096,35686,3575886735,3575886735,0
2,1096,35687,3575886735,3575886735,0
2,1096,35688,3575886735,3575886735,0
2,1096,35689,3575886735,3575886735,0
2,1096,35690,3575886735,3575886735,0
2,1096,35691,3575886735,3575886735,0
2,1096,35692,3575886735,3575886735,0
2,1096,35693,3575886735,3575886735,0
2,1096,35694,3575886735,3575886735,0
2,1096,35695,3575886735,3575886735,0
2,1096,35696,3575886735,3575886735,0
2,1096,35697,3575886735,3575886735,0
2,1096,35698,3575886735,3575886738,3
2,1096,35699,3575886735,3575886738,3
2,1096,35700,3575886735,3575886740,5
2,1096,35701,3575886735,3575886740,5
2,1096,35702,3575886735,3575886740,5
2,1096,35703,3575886735,3575886740,5
2,1096,35704,3575886735,3575886742,7
2,1096,35705,3575886735,3575886743,8
2,1096,35706,3575886735,3575886743,8
2,1096,35707,3575886735,3575886744,9
2,1096,35708,3575886735,3575886744,9
2,1096,35709,3575886735,3575886745,10
2,1096,35710,3575886735,3575886746,11
2,1096,35711,3575886735,3575886746,11
2,1096,35712,3575886735,3575886747,12
2,1096,35713,3575886735,3575886749,14
2,1096,35714,3575886735,3575886749,14
2,1096,35715,3575886735,3575886750,15
2,1096,35716,3575886735,3575886750,15
2,1096,35717,3575886735,3575886751,16
2,1096,35718,3575886735,3575886752,17
2,1096,35719,3575886735,3575886753,18
2,1096,35720,3575886735,3575886754,19
2,1096,35721,3575886735,3575886754,19
2,1096,35722,3575886735,3575886756,21
2,1096,35723,3575886735,3575886756,21
2,1096,35724,3575886735,3575886757,22
2,1096,35725,3575886735,3575886758,23
2,1096,35726,3575886735,3575886758,23
2,1096,35727,3575886735,3575886758,23
2,1096,35728,3575886735,3575886759,24
2,1096,35729,3575886735,3575886760,25
2,1096,35730,3575886735,3575886760,25
2,1096,35731,3575886735,3575886760,25
2,1096,35732,3575886735,3575886760,25
2,1096,35733,3575886735,3575886763,28
2,1096,35734,3575886735,3575886764,29
2,1096,35735,3575886735,3575886765,30
2,1096,35736,3575886735,3575886766,31
2,1096,35737,3575886735,3575886766,31
2,1096,35738,3575886735,3575886767,32
2,1096,35739,3575886735,3575886767,32
2,1096,35740,3575886735,3575886768,33
2,1096,35741,3575886735,3575886768,33
2,1096,35742,3575886735,3575886768,33
2,1096,35743,3575886735,3575886770,35
2,1096,35744,3575886735,3575886770,35
2,1096,35745,3575886735,3575886771,36
2,1096,35746,3575886735,3575886772,37
2,1096,35747,3575886735,3575886774,39
2,1096,35748,3575886735,3575886775,40
2,1096,35749,3575886735,3575886775,40
2,1096,35750,3575886735,3575886775,40
2,1096,35751,3575886735,3575886776,41
2,1096,35752,3575886735,3575886776,41
2,1096,35753,3575886735,3575886778,43
2,1096,35754,3575886735,3575886778,43
2,1096,35755,3575886735,3575886778,43
2,1096,35756,3575886735,3575886779,44
2,1096,35757,3575886735,3575886780,45
2,1096,35758,3575886735,3575886781,46
2,1096,35759,3575886735,3575886781,46
2,1096,35760,3575886735,3575886782,47
2,1096,35761,3575886735,3575886782,47
2,1096,35762,3575886735,3575886783,48
2,1096,35763,3575886735,3575886784,49
2,1096,35764,3575886735,3575886784,49
2,1096,35765,3575886735,3575886785,50
2,1097,35766,3575886800,3575886800,0
2,1097,35767,3575886800,3575886800,0
2,1097,35768,3575886800,3575886800,0
2,1097,35769,3575886800,3575886800,0
2,1097,35770,3575886800,3575886800,0
2,1097,35771,3575886800,3575886800,0
2,1097,35772,3575886800,3575886800,0
2,1097,35773,3575886800,3575886800,0
2,1097,35774,3575886800,3575886800,0
2,1097,35775,3575886800,3575886800,0
2,1097,35776,3575886800,3575886800,0
2,1097,35777,3575886800,3575886800,0
2,1097,35778,3575886800,3575886800,0
2,1097,35779,3575886800,3575886800,0
2,1097,35780,3575886800,3575886800,0
2,1097,35781,3575886800,3575886800,0
2,1097,35782,3575886800,3575886802,2
2,1097,35783,3575886800,3575886802,2
2,1097,35784,3575886800,3575886802,2
2,1097,35785,3575886800,3575886803,3
2,1097,35786,3575886800,3575886803,3
2,1097,35787,3575886800,3575886803,3
2,1097,35788,3575886800,3575886804,4
2,1097,35789,3575886800,3575886804,4
2,1097,35790,3575886800,3575886807,7
2,1097,35791,3575886800,3575886808,8
2,1097,35792,3575886800,3575886810,10
2,1097,35793,3575886800,3575886810,10
2,1097,35794,3575886800,3575886811,11
2,1097,35795,3575886800,3575886812,12
2,1097,35796,3575886800,3575886812,12
2,1097,35797,3575886800,3575886813,13
2,1097,35798,3575886800,3575886819,19
2,1097,35799,3575886800,3575886821,21
2,1097,35800,3575886800,3575886822,22
2,1097,35801,3575886800,3575886822,22
2,1097,35802,3575886800,3575886824,24
2,1097,35803,3575886800,3575886824,24
2,1097,35804,3575886800,3575886825,25
2,1097,35805,3575886800,3575886826,26
2,1097,35806,3575886800,3575886827,27
2,1097,35807,3575886800,3575886828,28
2,1097,35808,3575886800,3575886829,29
2,1097,35809,3575886800,3575886831,31
2,1097,35810,3575886800,3575886834,34
2,1097,35811,3575886800,3575886835,35
2,1097,35812,3575886800,3575886835,35
2,1097,35813,3575886800,3575886836,36
2,1097,35814,3575886800,3575886836,36
2,1097,35815,3575886800,3575886837,37
2,1097,35816,3575886800,3575886838,38
2,1097,35817,3575886800,3575886838,38
2,1097,35818,3575886800,3575886839,39
2,1097,35819,3575886800,3575886840,40
2,1097,35820,3575886800,3575886840,40
2,1097,35821,3575886800,3575886842,42
2,1097,35822,3575886800,3575886842,42
2,1097,35823,3575886800,3575886843,43
2,1097,35824,3575886800,3575886845,45
2,1097,35825,3575886800,3575886846,46
2,1097,35826,3575886800,3575886847,47
2,1097,35827,3575886800,3575886849,49
2,1098,35828,3575886863,3575886863,0
2,1098,35829,3575886863,3575886863,0
2,1098,35830,3575886863,3575886863,0
2,1098,35831,3575886863,3575886863,0
2,1098,35832,3575886863,3575886863,0
2,1098,35833,3575886863,3575886863,0
2,1098,35834,3575886863,3575886863,0
2,1098,35835,3575886863,3575886863,0
2,1098,35836,3575886863,3575886863,0
2,1098,35837,3575886863,3575886863,0
2,1098,35838,3575886863,3575886863,0
2,1098,35839,3575886863,3575886864,1
2,1098,35840,3575886863,3575886866,3
2,1098,35841,3575886863,3575886866,3
2,1098,35842,3575886863,3575886868,5
2,1098,35843,3575886863,3575886876,13
2,1098,35844,3575886863,3575886876,13
2,1098,35845,3575886863,3575886878,15
2,1098,35846,3575886863,3575886880,17
2,1098,35847,3575886863,3575886882,19
2,1098,35848,3575886863,3575886883,20
2,1098,35849,3575886863,3575886883,20
2,1098,35850,3575886863,3575886884,21
2,1098,35851,3575886863,3575886884,21
2,1098,35852,3575886863,3575886885,22
2,1098,35853,3575886863,3575886885,22
2,1098,35854,3575886863,3575886886,23
2,1098,35855,3575886863,3575886888,25
2,1098,35856,3575886863,3575886889,26
2,1098,35857,3575886863,3575886889,26
2,1098,35858,3575886863,3575886889,26
2,1098,35859,3575886863,3575886890,27
2,1098,35860,3575886863,3575886890,27
2,1098,35861,3575886863,3575886890,27
2,1098,35862,3575886863,3575886891,28
2,1098,35863,3575886863,3575886891,28
2,1098,35864,3575886863,3575886892,29
2,1098,35865,3575886863,3575886892,29
2,1098,35866,3575886863,3575886893,30
2,1098,35867,3575886863,3575886893,30
2,1098,35868,3575886863,3575886894,31
2,1098,35869,3575886863,3575886895,32
2,1098,35870,3575886863,3575886897,34
2,1098,35871,3575886863,3575886897,34
2,1098,35872,3575886863,3575886898,35
2,1098,35873,3575886863,3575886899,36
2,1098,35874,3575886863,3575886899,36
2,1098,35875,3575886863,3575886900,37
2,1098,35876,3575886863,3575886901,38
2,1098,35877,3575886863,3575886902,39
2,1098,35878,3575886863,3575886904,41
2,1098,35879,3575886863,3575886904,41
2,1098,35880,3575886863,3575886905,42
2,1098,35881,3575886863,3575886905,42
2,1098,35882,3575886863,3575886906,43
2,1098,35883,3575886863,3575886906,43
2,1098,35884,3575886863,3575886906,43
2,1098,35885,3575886863,3575886907,44
2,1098,35886,3575886863,3575886908,45
2,1098,35887,3575886863,3575886908,45
2,1098,35888,3575886863,3575886909,46
2,1098,35889,3575886863,3575886909,46
2,1098,35890,3575886863,3575886909,46
2,1098,35891,3575886863,3575886909,46
2,1098,35892,3575886863,3575886910,47
2,1098,35893,3575886863,3575886910,47
2,1098,35894,3575886863,3575886910,47
2,1098,35895,3575886863,3575886910,47
2,1098,35896,3575886863,3575886910,47
2,1098,35897,3575886863,3575886911,48
2,1098,35898,3575886863,3575886912,49
2,1099,35899,3575886929,3575886929,0
2,1099,35900,3575886929,3575886929,0
2,1099,35901,3575886929,3575886929,0
2,1099,35902,3575886929,3575886929,0
2,1099,35903,3575886929,3575886929,0
2,1099,35904,3575886929,3575886929,0
2,1099,35905,3575886929,3575886929,0
2,1099,35906,3575886929,3575886929,0
2,1099,35907,3575886929,3575886929,0
2,1099,35908,3575886929,3575886929,0
2,1099,35909,3575886929,3575886929,0
2,1099,35910,3575886929,3575886929,0
2,1099,35911,3575886929,3575886929,0
2,1099,35912,3575886929,3575886929,0
2,1099,35913,3575886929,3575886929,0
2,1099,35914,3575886929,3575886929,0
2,1099,35915,3575886929,3575886929,0
2,1099,35916,3575886929,3575886929,0
2,1099,35917,3575886929,3575886929,0
2,1099,35918,3575886929,3575886929,0
2,1099,35919,3575886929,3575886929,0
2,1099,35920,3575886929,3575886929,0
2,1099,35921,3575886929,3575886929,0
2,1099,35922,3575886929,3575886930,1
2,1099,35923,3575886929,3575886930,1
2,1099,35924,3575886929,3575886931,2
2,1099,35925,3575886929,3575886932,3
2,1099,35926,3575886929,3575886932,3
2,1099,35927,3575886929,3575886932,3
2,1099,35928,3575886929,3575886934,5
2,1099,35929,3575886929,3575886934,5
2,1099,35930,3575886929,3575886935,6
2,1099,35931,3575886929,3575886935,6
2,1099,35932,3575886929,3575886935,6
2,1099,35933,3575886929,3575886936,7
2,1099,35934,3575886929,3575886936,7
2,1099,35935,3575886929,3575886937,8
2,1099,35936,3575886929,3575886938,9
2,1099,35937,3575886929,3575886939,10
2,1099,35938,3575886929,3575886940,11
2,1099,35939,3575886929,3575886940,11
2,1099,35940,3575886929,3575886940,11
2,1099,35941,3575886929,3575886942,13
2,1099,35942,3575886929,3575886943,14
2,1099,35943,3575886929,3575886945,16
2,1099,35944,3575886929,3575886945,16
2,1099,35945,3575886929,3575886945,16
2,1099,35946,3575886929,3575886946,17
2,1099,35947,3575886929,3575886946,17
2,1099,35948,3575886929,3575886946,17
2,1099,35949,3575886929,3575886947,18
2,1099,35950,3575886929,3575886949,20
2,1099,35951,3575886929,3575886949,20
2,1099,35952,3575886929,3575886949,20
2,1099,35953,3575886929,3575886951,22
2,1099,35954,3575886929,3575886952,23
2,1099,35955,3575886929,3575886954,25
2,1099,35956,3575886929,3575886954,25
2,1099,35957,3575886929,3575886954,25
2,1099,35958,3575886929,3575886956,27
2,1099,35959,3575886929,3575886956,27
2,1099,35960,3575886929,3575886956,27
2,1099,35961,3575886929,3575886958,29
2,1099,35962,3575886929,3575886959,30
2,1099,35963,3575886929,3575886959,30
2,1099,35964,3575886929,3575886959,30
2,1099,35965,3575886929,3575886960,31
2,1099,35966,3575886929,3575886960,31
2,1099,35967,3575886929,3575886961,32
2,1099,35968,3575886929,3575886961,32
2,1099,35969,3575886929,3575886962,33
2,1099,35970,3575886929,3575886964,35
2,1099,35971,3575886929,3575886965,36
2,1099,35972,3575886929,3575886965,36
2,1099,35973,3575886929,3575886967,38
2,1099,35974,3575886929,3575886968,39
2,1099,35975,3575886929,3575886969,40
2,1099,35976,3575886929,3575886969,40
2,1099,35977,3575886929,3575886969,40
2,1099,35978,3575886929,3575886969,40
2,1099,35979,3575886929,3575886969,40
2,1099,35980,3575886929,3575886970,41
2,1099,35981,3575886929,3575886972,43
2,1099,35982,3575886929,3575886972,43
2,1099,35983,3575886929,3575886972,43
2,1099,35984,3575886929,3575886974,45
2,1099,35985,3575886929,3575886975,46
2,1099,35986,3575886929,3575886975,46
2,1099,35987,3575886929,3575886975,46
2,1099,35988,3575886929,3575886975,46
2,1099,35989,3575886929,3575886976,47
2,1099,35990,3575886929,3575886978,49
2,1099,35991,3575886929,3575886978,49
2,1099,35992,3575886929,3575886978,49
2,1099,35993,3575886929,3575886978,49
2,1099,35994,3575886929,3575886979,50
2,1100,35995,3575886991,3575886991,0
2,1100,35996,3575886991,3575886991,0
2,1100,35997,3575886991,3575886991,0
2,1100,35998,3575886991,3575886991,0
2,1100,35999,3575886991,3575886991,0
2,1100,36000,3575886991,3575886991,0
2,1100,36001,3575886991,3575886991,0
2,1100,36002,3575886991,3575886991,0
2,1100,36003,3575886991,3575886991,0
2,1100,36004,3575886991,3575886991,0
2,1100,36005,3575886991,3575886991,0
2,1100,36006,3575886991,3575886991,0
2,1100,36007,3575886991,3575886991,0
2,1100,36008,3575886991,3575886991,0
2,1100,36009,3575886991,3575886991,0
2,1100,36010,3575886991,3575886991,0
2,1100,36011,3575886991,3575886991,0
2,1100,36012,3575886991,3575886991,0
2,1100,36013,3575886991,3575886992,1
2,1100,36014,3575886991,3575886993,2
2,1100,36015,3575886991,3575886994,3
2,1100,36016,3575886991,3575886994,3
2,1100,36017,3575886991,3575886995,4
2,1100,36018,3575886991,3575886997,6
2,1100,36019,3575886991,3575886999,8
2,1100,36020,3575886991,3575886999,8
2,1100,36021,3575886991,3575886999,8
2,1100,36022,3575886991,3575887001,10
2,1100,36023,3575886991,3575887002,11
2,1100,36024,3575886991,3575887003,12
2,1100,36025,3575886991,3575887004,13
2,1100,36026,3575886991,3575887004,13
2,1100,36027,3575886991,3575887004,13
2,1100,36028,3575886991,3575887004,13
2,1100,36029,3575886991,3575887004,13
2,1100,36030,3575886991,3575887004,13
2,1100,36031,3575886991,3575887008,17
2,1100,36032,3575886991,3575887011,20
2,1100,36033,3575886991,3575887011,20
2,1100,36034,3575886991,3575887012,21
2,1100,36035,3575886991,3575887012,21
2,1100,36036,3575886991,3575887013,22
2,1100,36037,3575886991,3575887020,29
2,1100,36038,3575886991,3575887021,30
2,1100,36039,3575886991,3575887022,31
2,1100,36040,3575886991,3575887023,32
2,1100,36041,3575886991,3575887025,34
2,1100,36042,3575886991,3575887025,34
2,1100,36043,3575886991,3575887026,35
2,1100,36044,3575886991,3575887027,36
2,1100,36045,3575886991,3575887028,37
2,1100,36046,3575886991,3575887031,40
2,1100,36047,3575886991,3575887035,44
2,1100,36048,3575886991,3575887036,45
2,1100,36049,3575886991,3575887036,45
2,1100,36050,3575886991,3575887036,45
2,1100,36051,3575886991,3575887036,45
2,1100,36052,3575886991,3575887037,46
2,1100,36053,3575886991,3575887037,46
2,1100,36054,3575886991,3575887038,47
2,1100,36055,3575886991,3575887039,48
2,1100,36056,3575886991,3575887039,48
2,1100,36057,3575886991,3575887041,50
2,1101,36058,3575887056,3575887056,0
2,1101,36059,3575887056,3575887056,0
2,1101,36060,3575887056,3575887056,0
2,1101,36061,3575887056,3575887056,0
2,1101,36062,3575887056,3575887056,0
2,1101,36063,3575887056,3575887056,0
2,1101,36064,3575887056,3575887056,0
2,1101,36065,3575887056,3575887056,0
2,1101,36066,3575887056,3575887056,0
2,1101,36067,3575887056,3575887056,0
2,1101,36068,3575887056,3575887056,0
2,1101,36069,3575887056,3575887056,0
2,1101,36070,3575887056,3575887056,0
2,1101,36071,3575887056,3575887056,0
2,1101,36072,3575887056,3575887056,0
2,1101,36073,3575887056,3575887057,1
2,1101,36074,3575887056,3575887059,3
2,1101,36075,3575887056,3575887059,3
2,1101,36076,3575887056,3575887060,4
2,1101,36077,3575887056,3575887063,7
2,1101,36078,3575887056,3575887064,8
2,1101,36079,3575887056,3575887066,10
2,1101,36080,3575887056,3575887066,10
2,1101,36081,3575887056,3575887069,13
2,1101,36082,3575887056,3575887076,20
2,1101,36083,3575887056,3575887076,20
2,1101,36084,3575887056,3575887077,21
2,1101,36085,3575887056,3575887080,24
2,1101,36086,3575887056,3575887083,27
2,1101,36087,3575887056,3575887083,27
2,1101,36088,3575887056,3575887084,28
2,1101,36089,3575887056,3575887084,28
2,1101,36090,3575887056,3575887085,29
2,1101,36091,3575887056,3575887086,30
2,1101,36092,3575887056,3575887087,31
2,1101,36093,3575887056,3575887087,31
2,1101,36094,3575887056,3575887088,32
2,1101,36095,3575887056,3575887089,33
2,1101,36096,3575887056,3575887089,33
2,1101,36097,3575887056,3575887089,33
2,1101,36098,3575887056,3575887090,34
2,1101,36099,3575887056,3575887090,34
2,1101,36100,3575887056,3575887091,35
2,1101,36101,3575887056,3575887091,35
2,1101,36102,3575887056,3575887092,36
2,1101,36103,3575887056,3575887093,37
2,1101,36104,3575887056,3575887093,37
2,1101,36105,3575887056,3575887093,37
2,1101,36106,3575887056,3575887094,38
2,1101,36107,3575887056,3575887096,40
2,1101,36108,3575887056,3575887097,41
2,1101,36109,3575887056,3575887097,41
2,1101,36110,3575887056,3575887098,42
2,1101,36111,3575887056,3575887099,43
2,1101,36112,3575887056,3575887099,43
2,1101,36113,3575887056,3575887100,44
2,1101,36114,3575887056,3575887101,45
2,1101,36115,3575887056,3575887102,46
2,1101,36116,3575887056,3575887104,48
2,1101,36117,3575887056,3575887104,48
2,1101,36118,3575887056,3575887105,49
2,1101,36119,3575887056,3575887105,49
2,1101,36120,3575887056,3575887105,49
2,1102,36121,3575887120,3575887120,0
2,1102,36122,3575887120,3575887120,0
2,1102,36123,3575887120,3575887120,0
2,1102,36124,3575887120,3575887120,0
2,1102,36125,3575887120,3575887120,0
2,1102,36126,3575887120,3575887120,0
2,1102,36127,3575887120,3575887120,0
2,1102,36128,3575887120,3575887120,0
2,1102,36129,3575887120,3575887120,0
2,1102,36130,3575887120,3575887120,0
2,1102,36131,3575887120,3575887120,0
2,1102,36132,3575887120,3575887120,0
2,1102,36133,3575887120,3575887120,0
2,1102,36134,3575887120,3575887120,0
2,1102,36135,3575887120,3575887120,0
2,1102,36136,3575887120,3575887120,0
2,1102,36137,3575887120,3575887120,0
2,1102,36138,3575887120,3575887120,0
2,1102,36139,3575887120,3575887120,0
2,1102,36140,3575887120,3575887120,0
2,1102,36141,3575887120,3575887120,0
2,1102,36142,3575887120,3575887120,0
2,1102,36143,3575887120,3575887120,0
2,1102,36144,3575887120,3575887120,0
2,1102,36145,3575887120,3575887120,0
2,1102,36146,3575887120,3575887120,0
2,1102,36147,3575887120,3575887120,0
2,1102,36148,3575887120,3575887120,0
2,1102,36149,3575887120,3575887120,0
2,1102,36150,3575887120,3575887122,2
2,1102,36151,3575887120,3575887123,3
2,1102,36152,3575887120,3575887124,4
2,1102,36153,3575887120,3575887126,6
2,1102,36154,3575887120,3575887126,6
2,1102,36155,3575887120,3575887126,6
2,1102,36156,3575887120,3575887127,7
2,1102,36157,3575887120,3575887128,8
2,1102,36158,3575887120,3575887129,9
2,1102,36159,3575887120,3575887129,9
2,1102,36160,3575887120,3575887129,9
2,1102,36161,3575887120,3575887130,10
2,1102,36162,3575887120,3575887130,10
2,1102,36163,3575887120,3575887131,11
2,1102,36164,3575887120,3575887131,11
2,1102,36165,3575887120,3575887131,11
2,1102,36166,3575887120,3575887132,12
2,1102,36167,3575887120,3575887133,13
2,1102,36168,3575887120,3575887134,14
2,1102,36169,3575887120,3575887134,14
2,1102,36170,3575887120,3575887135,15
2,1102,36171,3575887120,3575887135,15
2,1102,36172,3575887120,3575887135,15
2,1102,36173,3575887120,3575887135,15
2,1102,36174,3575887120,3575887136,16
2,1102,36175,3575887120,3575887138,18
2,1102,36176,3575887120,3575887138,18
2,1102,36177,3575887120,3575887139,19
2,1102,36178,3575887120,3575887139,19
2,1102,36179,3575887120,3575887140,20
2,1102,36180,3575887120,3575887140,20
2,1102,36181,3575887120,3575887142,22
2,1102,36182,3575887120,3575887143,23
2,1102,36183,3575887120,3575887144,24
2,1102,36184,3575887120,3575887145,25
2,1102,36185,3575887120,3575887146,26
2,1102,36186,3575887120,3575887146,26
2,1102,36187,3575887120,3575887146,26
2,1102,36188,3575887120,3575887147,27
2,1102,36189,3575887120,3575887149,29
2,1102,36190,3575887120,3575887149,29
2,1102,36191,3575887120,3575887149,29
2,1102,36192,3575887120,3575887151,31
2,1102,36193,3575887120,3575887153,33
2,1102,36194,3575887120,3575887153,33
2,1102,36195,3575887120,3575887154,34
2,1102,36196,3575887120,3575887156,36
2,1102,36197,3575887120,3575887157,37
2,1102,36198,3575887120,3575887157,37
2,1102,36199,3575887120,3575887157,37
2,1102,36200,3575887120,3575887159,39
2,1102,36201,3575887120,3575887160,40
2,1102,36202,3575887120,3575887160,40
2,1102,36203,3575887120,3575887160,40
2,1102,36204,3575887120,3575887161,41
2,1102,36205,3575887120,3575887162,42
2,1102,36206,3575887120,3575887163,43
2,1102,36207,3575887120,3575887164,44
2,1102,36208,3575887120,3575887165,45
2,1102,36209,3575887120,3575887165,45
2,1102,36210,3575887120,3575887166,46
2,1102,36211,3575887120,3575887166,46
2,1102,36212,3575887120,3575887167,47
2,1102,36213,3575887120,3575887168,48
2,1102,36214,3575887120,3575887169,49
2,1102,36215,3575887120,3575887169,49
2,1102,36216,3575887120,3575887170,50
2,1103,36217,3575887184,3575887184,0
2,1103,36218,3575887184,3575887184,0
2,1103,36219,3575887184,3575887184,0
2,1103,36220,3575887184,3575887184,0
2,1103,36221,3575887184,3575887184,0
2,1103,36222,3575887184,3575887184,0
2,1103,36223,3575887184,3575887184,0
2,1103,36224,3575887184,3575887184,0
2,1103,36225,3575887184,3575887184,0
2,1103,36226,3575887184,3575887184,0
2,1103,36227,3575887184,3575887184,0
2,1103,36228,3575887184,3575887184,0
2,1103,36229,3575887184,3575887184,0
2,1103,36230,3575887184,3575887184,0
2,1103,36231,3575887184,3575887184,0
2,1103,36232,3575887184,3575887184,0
2,1103,36233,3575887184,3575887184,0
2,1103,36234,3575887184,3575887184,0
2,1103,36235,3575887184,3575887184,0
2,1103,36236,3575887184,3575887184,0
2,1103,36237,3575887184,3575887184,0
2,1103,36238,3575887184,3575887185,1
2,1103,36239,3575887184,3575887185,1
2,1103,36240,3575887184,3575887185,1
2,1103,36241,3575887184,3575887186,2
2,1103,36242,3575887184,3575887186,2
2,1103,36243,3575887184,3575887186,2
2,1103,36244,3575887184,3575887187,3
2,1103,36245,3575887184,3575887188,4
2,1103,36246,3575887184,3575887189,5
2,1103,36247,3575887184,3575887189,5
2,1103,36248,3575887184,3575887190,6
2,1103,36249,3575887184,3575887192,8
2,1103,36250,3575887184,3575887193,9
2,1103,36251,3575887184,3575887193,9
2,1103,36252,3575887184,3575887194,10
2,1103,36253,3575887184,3575887195,11
2,1103,36254,3575887184,3575887198,14
2,1103,36255,3575887184,3575887199,15
2,1103,36256,3575887184,3575887199,15
2,1103,36257,3575887184,3575887199,15
2,1103,36258,3575887184,3575887201,17
2,1103,36259,3575887184,3575887201,17
2,1103,36260,3575887184,3575887203,19
2,1103,36261,3575887184,3575887203,19
2,1103,36262,3575887184,3575887203,19
2,1103,36263,3575887184,3575887203,19
2,1103,36264,3575887184,3575887204,20
2,1103,36265,3575887184,3575887205,21
2,1103,36266,3575887184,3575887208,24
2,1103,36267,3575887184,3575887208,24
2,1103,36268,3575887184,3575887212,28
2,1103,36269,3575887184,3575887212,28
2,1103,36270,3575887184,3575887212,28
2,1103,36271,3575887184,3575887212,28
2,1103,36272,3575887184,3575887214,30
2,1103,36273,3575887184,3575887220,36
2,1103,36274,3575887184,3575887221,37
2,1103,36275,3575887184,3575887222,38
2,1103,36276,3575887184,3575887222,38
2,1103,36277,3575887184,3575887223,39
2,1103,36278,3575887184,3575887226,42
2,1103,36279,3575887184,3575887226,42
2,1103,36280,3575887184,3575887226,42
2,1103,36281,3575887184,3575887227,43
2,1103,36282,3575887184,3575887228,44
2,1103,36283,3575887184,3575887231,47
2,1104,36284,3575887248,3575887248,0
2,1104,36285,3575887248,3575887248,0
2,1104,36286,3575887248,3575887248,0
2,1104,36287,3575887248,3575887248,0
2,1104,36288,3575887248,3575887248,0
2,1104,36289,3575887248,3575887248,0
2,1104,36290,3575887248,3575887248,0
2,1104,36291,3575887248,3575887248,0
2,1104,36292,3575887248,3575887248,0
2,1104,36293,3575887248,3575887248,0
2,1104,36294,3575887248,3575887248,0
2,1104,36295,3575887248,3575887248,0
2,1104,36296,3575887248,3575887248,0
2,1104,36297,3575887248,3575887248,0
2,1104,36298,3575887248,3575887249,1
2,1104,36299,3575887248,3575887251,3
2,1104,36300,3575887248,3575887254,6
2,1104,36301,3575887248,3575887254,6
2,1104,36302,3575887248,3575887255,7
2,1104,36303,3575887248,3575887256,8
2,1104,36304,3575887248,3575887256,8
2,1104,36305,3575887248,3575887256,8
2,1104,36306,3575887248,3575887256,8
2,1104,36307,3575887248,3575887257,9
2,1104,36308,3575887248,3575887259,11
2,1104,36309,3575887248,3575887259,11
2,1104,36310,3575887248,3575887260,12
2,1104,36311,3575887248,3575887262,14
2,1104,36312,3575887248,3575887262,14
2,1104,36313,3575887248,3575887264,16
2,1104,36314,3575887248,3575887266,18
2,1104,36315,3575887248,3575887266,18
2,1104,36316,3575887248,3575887266,18
2,1104,36317,3575887248,3575887269,21
2,1104,36318,3575887248,3575887275,27
2,1104,36319,3575887248,3575887277,29
2,1104,36320,3575887248,3575887277,29
2,1104,36321,3575887248,3575887280,32
2,1104,36322,3575887248,3575887282,34
2,1104,36323,3575887248,3575887282,34
2,1104,36324,3575887248,3575887283,35
2,1104,36325,3575887248,3575887283,35
2,1104,36326,3575887248,3575887284,36
2,1104,36327,3575887248,3575887285,37
2,1104,36328,3575887248,3575887286,38
2,1104,36329,3575887248,3575887286,38
2,1104,36330,3575887248,3575887287,39
2,1104,36331,3575887248,3575887288,40
2,1104,36332,3575887248,3575887289,41
2,1104,36333,3575887248,3575887290,42
2,1104,36334,3575887248,3575887290,42
2,1104,36335,3575887248,3575887290,42
2,1104,36336,3575887248,3575887290,42
2,1104,36337,3575887248,3575887291,43
2,1104,36338,3575887248,3575887291,43
2,1104,36339,3575887248,3575887291,43
2,1104,36340,3575887248,3575887292,44
2,1104,36341,3575887248,3575887292,44
2,1104,36342,3575887248,3575887293,45
2,1104,36343,3575887248,3575887293,45
2,1104,36344,3575887248,3575887294,46
2,1104,36345,3575887248,3575887295,47
2,1104,36346,3575887248,3575887297,49
2,1105,36347,3575887310,3575887310,0
2,1105,36348,3575887310,3575887310,0
2,1105,36349,3575887310,3575887310,0
2,1105,36350,3575887310,3575887310,0
2,1105,36351,3575887310,3575887310,0
2,1105,36352,3575887310,3575887310,0
2,1105,36353,3575887310,3575887310,0
2,1105,36354,3575887310,3575887310,0
2,1105,36355,3575887310,3575887310,0
2,1105,36356,3575887310,3575887310,0
2,1105,36357,3575887310,3575887310,0
2,1105,36358,3575887310,3575887310,0
2,1105,36359,3575887310,3575887310,0
2,1105,36360,3575887310,3575887310,0
2,1105,36361,3575887310,3575887310,0
2,1105,36362,3575887310,3575887310,0
2,1105,36363,3575887310,3575887310,0
2,1105,36364,3575887310,3575887310,0
2,1105,36365,3575887310,3575887310,0
2,1105,36366,3575887310,3575887310,0
2,1105,36367,3575887310,3575887310,0
2,1105,36368,3575887310,3575887310,0
2,1105,36369,3575887310,3575887310,0
2,1105,36370,3575887310,3575887311,1
2,1105,36371,3575887310,3575887312,2
2,1105,36372,3575887310,3575887312,2
2,1105,36373,3575887310,3575887314,4
2,1105,36374,3575887310,3575887314,4
2,1105,36375,3575887310,3575887315,5
2,1105,36376,3575887310,3575887315,5
2,1105,36377,3575887310,3575887316,6
2,1105,36378,3575887310,3575887318,8
2,1105,36379,3575887310,3575887319,9
2,1105,36380,3575887310,3575887319,9
2,1105,36381,3575887310,3575887320,10
2,1105,36382,3575887310,3575887320,10
2,1105,36383,3575887310,3575887320,10
2,1105,36384,3575887310,3575887320,10
2,1105,36385,3575887310,3575887321,11
2,1105,36386,3575887310,3575887322,12
2,1105,36387,3575887310,3575887323,13
2,1105,36388,3575887310,3575887324,14
2,1105,36389,3575887310,3575887326,16
2,1105,36390,3575887310,3575887327,17
2,1105,36391,3575887310,3575887327,17
2,1105,36392,3575887310,3575887328,18
2,1105,36393,3575887310,3575887329,19
2,1105,36394,3575887310,3575887329,19
2,1105,36395,3575887310,3575887330,20
2,1105,36396,3575887310,3575887331,21
2,1105,36397,3575887310,3575887331,21
2,1105,36398,3575887310,3575887332,22
2,1105,36399,3575887310,3575887332,22
2,1105,36400,3575887310,3575887333,23
2,1105,36401,3575887310,3575887333,23
2,1105,36402,3575887310,3575887334,24
2,1105,36403,3575887310,3575887334,24
2,1105,36404,3575887310,3575887335,25
2,1105,36405,3575887310,3575887335,25
2,1105,36406,3575887310,3575887335,25
2,1105,36407,3575887310,3575887335,25
2,1105,36408,3575887310,3575887336,26
2,1105,36409,3575887310,3575887338,28
2,1105,36410,3575887310,3575887338,28
2,1105,36411,3575887310,3575887339,29
2,1105,36412,3575887310,3575887340,30
2,1105,36413,3575887310,3575887340,30
2,1105,36414,3575887310,3575887340,30
2,1105,36415,3575887310,3575887340,30
2,1105,36416,3575887310,3575887344,34
2,1105,36417,3575887310,3575887344,34
2,1105,36418,3575887310,3575887346,36
2,1105,36419,3575887310,3575887346,36
2,1105,36420,3575887310,3575887347,37
2,1105,36421,3575887310,3575887348,38
2,1105,36422,3575887310,3575887349,39
2,1105,36423,3575887310,3575887349,39
2,1105,36424,3575887310,3575887349,39
2,1105,36425,3575887310,3575887350,40
2,1105,36426,3575887310,3575887352,42
2,1105,36427,3575887310,3575887354,44
2,1105,36428,3575887310,3575887354,44
2,1105,36429,3575887310,3575887354,44
2,1105,36430,3575887310,3575887357,47
2,1105,36431,3575887310,3575887357,47
2,1105,36432,3575887310,3575887358,48
2,1105,36433,3575887310,3575887358,48
2,1105,36434,3575887310,3575887359,49
2,1105,36435,3575887310,3575887359,49
2,1106,36436,3575887374,3575887374,0
2,1106,36437,3575887374,3575887374,0
2,1106,36438,3575887374,3575887374,0
2,1106,36439,3575887374,3575887374,0
2,1106,36440,3575887374,3575887374,0
2,1106,36441,3575887374,3575887374,0
2,1106,36442,3575887374,3575887374,0
2,1106,36443,3575887374,3575887374,0
2,1106,36444,3575887374,3575887374,0
2,1106,36445,3575887374,3575887374,0
2,1106,36446,3575887374,3575887374,0
2,1106,36447,3575887374,3575887374,0
2,1106,36448,3575887374,3575887374,0
2,1106,36449,3575887374,3575887374,0
2,1106,36450,3575887374,3575887374,0
2,1106,36451,3575887374,3575887374,0
2,1106,36452,3575887374,3575887374,0
2,1106,36453,3575887374,3575887374,0
2,1106,36454,3575887374,3575887374,0
2,1106,36455,3575887374,3575887374,0
2,1106,36456,3575887374,3575887374,0
2,1106,36457,3575887374,3575887375,1
2,1106,36458,3575887374,3575887375,1
2,1106,36459,3575887374,3575887375,1
2,1106,36460,3575887374,3575887376,2
2,1106,36461,3575887374,3575887376,2
2,1106,36462,3575887374,3575887378,4
2,1106,36463,3575887374,3575887378,4
2,1106,36464,3575887374,3575887379,5
2,1106,36465,3575887374,3575887379,5
2,1106,36466,3575887374,3575887379,5
2,1106,36467,3575887374,3575887381,7
2,1106,36468,3575887374,3575887381,7
2,1106,36469,3575887374,3575887383,9
2,1106,36470,3575887374,3575887383,9
2,1106,36471,3575887374,3575887384,10
2,1106,36472,3575887374,3575887384,10
2,1106,36473,3575887374,3575887384,10
2,1106,36474,3575887374,3575887385,11
2,1106,36475,3575887374,3575887386,12
2,1106,36476,3575887374,3575887386,12
2,1106,36477,3575887374,3575887386,12
2,1106,36478,3575887374,3575887386,12
2,1106,36479,3575887374,3575887387,13
2,1106,36480,3575887374,3575887388,14
2,1106,36481,3575887374,3575887388,14
2,1106,36482,3575887374,3575887389,15
2,1106,36483,3575887374,3575887390,16
2,1106,36484,3575887374,3575887390,16
2,1106,36485,3575887374,3575887391,17
2,1106,36486,3575887374,3575887392,18
2,1106,36487,3575887374,3575887393,19
2,1106,36488,3575887374,3575887394,20
2,1106,36489,3575887374,3575887394,20
2,1106,36490,3575887374,3575887395,21
2,1106,36491,3575887374,3575887398,24
2,1106,36492,3575887374,3575887398,24
2,1106,36493,3575887374,3575887399,25
2,1106,36494,3575887374,3575887399,25
2,1106,36495,3575887374,3575887401,27
2,1106,36496,3575887374,3575887402,28
2,1106,36497,3575887374,3575887403,29
2,1106,36498,3575887374,3575887403,29
2,1106,36499,3575887374,3575887403,29
2,1106,36500,3575887374,3575887404,30
2,1106,36501,3575887374,3575887404,30
2,1106,36502,3575887374,3575887405,31
2,1106,36503,3575887374,3575887408,34
2,1106,36504,3575887374,3575887408,34
2,1106,36505,3575887374,3575887409,35
2,1106,36506,3575887374,3575887411,37
2,1106,36507,3575887374,3575887411,37
2,1106,36508,3575887374,3575887412,38
2,1106,36509,3575887374,3575887412,38
2,1106,36510,3575887374,3575887413,39
2,1106,36511,3575887374,3575887414,40
2,1106,36512,3575887374,3575887420,46
2,1106,36513,3575887374,3575887422,48
2,1106,36514,3575887374,3575887422,48
2,1106,36515,3575887374,3575887424,50
2,1107,36516,3575887437,3575887437,0
2,1107,36517,3575887437,3575887437,0
2,1107,36518,3575887437,3575887437,0
2,1107,36519,3575887437,3575887437,0
2,1107,36520,3575887437,3575887437,0
2,1107,36521,3575887437,3575887437,0
2,1107,36522,3575887437,3575887437,0
2,1107,36523,3575887437,3575887437,0
2,1107,36524,3575887437,3575887437,0
2,1107,36525,3575887437,3575887437,0
2,1107,36526,3575887437,3575887437,0
2,1107,36527,3575887437,3575887437,0
2,1107,36528,3575887437,3575887437,0
2,1107,36529,3575887437,3575887437,0
2,1107,36530,3575887437,3575887437,0
2,1107,36531,3575887437,3575887437,0
2,1107,36532,3575887437,3575887438,1
2,1107,36533,3575887437,3575887440,3
2,1107,36534,3575887437,3575887440,3
2,1107,36535,3575887437,3575887440,3
2,1107,36536,3575887437,3575887441,4
2,1107,36537,3575887437,3575887443,6
2,1107,36538,3575887437,3575887443,6
2,1107,36539,3575887437,3575887443,6
2,1107,36540,3575887437,3575887445,8
2,1107,36541,3575887437,3575887447,10
2,1107,36542,3575887437,3575887449,12
2,1107,36543,3575887437,3575887451,14
2,1107,36544,3575887437,3575887455,18
2,1107,36545,3575887437,3575887455,18
2,1107,36546,3575887437,3575887455,18
2,1107,36547,3575887437,3575887456,19
2,1107,36548,3575887437,3575887456,19
2,1107,36549,3575887437,3575887457,20
2,1107,36550,3575887437,3575887457,20
2,1107,36551,3575887437,3575887459,22
2,1107,36552,3575887437,3575887459,22
2,1107,36553,3575887437,3575887459,22
2,1107,36554,3575887437,3575887462,25
2,1107,36555,3575887437,3575887463,26
2,1107,36556,3575887437,3575887464,27
2,1107,36557,3575887437,3575887467,30
2,1107,36558,3575887437,3575887467,30
2,1107,36559,3575887437,3575887469,32
2,1107,36560,3575887437,3575887476,39
2,1107,36561,3575887437,3575887477,40
2,1107,36562,3575887437,3575887478,41
2,1107,36563,3575887437,3575887479,42
2,1107,36564,3575887437,3575887480,43
2,1107,36565,3575887437,3575887482,45
2,1107,36566,3575887437,3575887482,45
2,1107,36567,3575887437,3575887483,46
2,1107,36568,3575887437,3575887484,47
2,1107,36569,3575887437,3575887484,47
2,1107,36570,3575887437,3575887485,48
2,1107,36571,3575887437,3575887486,49
2,1107,36572,3575887437,3575887486,49
2,1107,36573,3575887437,3575887487,50
2,1108,36574,3575887503,3575887503,0
2,1108,36575,3575887503,3575887503,0
2,1108,36576,3575887503,3575887503,0
2,1108,36577,3575887503,3575887503,0
2,1108,36578,3575887503,3575887503,0
2,1108,36579,3575887503,3575887503,0
2,1108,36580,3575887503,3575887503,0
2,1108,36581,3575887503,3575887503,0
2,1108,36582,3575887503,3575887503,0
2,1108,36583,3575887503,3575887503,0
2,1108,36584,3575887503,3575887503,0
2,1108,36585,3575887503,3575887503,0
2,1108,36586,3575887503,3575887503,0
2,1108,36587,3575887503,3575887503,0
2,1108,36588,3575887503,3575887503,0
2,1108,36589,3575887503,3575887503,0
2,1108,36590,3575887503,3575887503,0
2,1108,36591,3575887503,3575887503,0
2,1108,36592,3575887503,3575887503,0
2,1108,36593,3575887503,3575887503,0
2,1108,36594,3575887503,3575887503,0
2,1108,36595,3575887503,3575887503,0
2,1108,36596,3575887503,3575887503,0
2,1108,36597,3575887503,3575887503,0
2,1108,36598,3575887503,3575887504,1
2,1108,36599,3575887503,3575887504,1
2,1108,36600,3575887503,3575887505,2
2,1108,36601,3575887503,3575887505,2
2,1108,36602,3575887503,3575887505,2
2,1108,36603,3575887503,3575887506,3
2,1108,36604,3575887503,3575887507,4
2,1108,36605,3575887503,3575887507,4
2,1108,36606,3575887503,3575887507,4
2,1108,36607,3575887503,3575887508,5
2,1108,36608,3575887503,3575887508,5
2,1108,36609,3575887503,3575887508,5
2,1108,36610,3575887503,3575887508,5
2,1108,36611,3575887503,3575887508,5
2,1108,36612,3575887503,3575887509,6
2,1108,36613,3575887503,3575887509,6
2,1108,36614,3575887503,3575887509,6
2,1108,36615,3575887503,3575887509,6
2,1108,36616,3575887503,3575887509,6
2,1108,36617,3575887503,3575887511,8
2,1108,36618,3575887503,3575887511,8
2,1108,36619,3575887503,3575887513,10
2,1108,36620,3575887503,3575887513,10
2,1108,36621,3575887503,3575887514,11
2,1108,36622,3575887503,3575887514,11
2,1108,36623,3575887503,3575887517,14
2,1108,36624,3575887503,3575887517,14
2,1108,36625,3575887503,3575887518,15
2,1108,36626,3575887503,3575887519,16
2,1108,36627,3575887503,3575887519,16
2,1108,36628,3575887503,3575887520,17
2,1108,36629,3575887503,3575887520,17
2,1108,36630,3575887503,3575887521,18
2,1108,36631,3575887503,3575887522,19
2,1108,36632,3575887503,3575887523,20
2,1108,36633,3575887503,3575887525,22
2,1108,36634,3575887503,3575887526,23
2,1108,36635,3575887503,3575887526,23
2,1108,36636,3575887503,3575887527,24
2,1108,36637,3575887503,3575887528,25
2,1108,36638,3575887503,3575887528,25
2,1108,36639,3575887503,3575887530,27
2,1108,36640,3575887503,3575887530,27
2,1108,36641,3575887503,3575887531,28
2,1108,36642,3575887503,3575887531,28
2,1108,36643,3575887503,3575887531,28
2,1108,36644,3575887503,3575887532,29
2,1108,36645,3575887503,3575887533,30
2,1108,36646,3575887503,3575887533,30
2,1108,36647,3575887503,3575887533,30
2,1108,36648,3575887503,3575887534,31
2,1108,36649,3575887503,3575887535,32
2,1108,36650,3575887503,3575887535,32
2,1108,36651,3575887503,3575887535,32
2,1108,36652,3575887503,3575887537,34
2,1108,36653,3575887503,3575887538,35
2,1108,36654,3575887503,3575887538,35
2,1108,36655,3575887503,3575887539,36
2,1108,36656,3575887503,3575887539,36
2,1108,36657,3575887503,3575887539,36
2,1108,36658,3575887503,3575887543,40
2,1108,36659,3575887503,3575887544,41
2,1108,36660,3575887503,3575887545,42
2,1108,36661,3575887503,3575887545,42
2,1108,36662,3575887503,3575887546,43
2,1108,36663,3575887503,3575887546,43
2,1108,36664,3575887503,3575887546,43
2,1108,36665,3575887503,3575887547,44
2,1108,36666,3575887503,3575887548,45
2,1108,36667,3575887503,3575887550,47
2,1108,36668,3575887503,3575887551,48
2,1108,36669,3575887503,3575887551,48
2,1108,36670,3575887503,3575887552,49
2,1108,36671,3575887503,3575887553,50
2,1108,36672,3575887503,3575887553,50
2,1109,36673,3575887566,3575887566,0
2,1109,36674,3575887566,3575887566,0
2,1109,36675,3575887566,3575887566,0
2,1109,36676,3575887566,3575887566,0
2,1109,36677,3575887566,3575887566,0
2,1109,36678,3575887566,3575887566,0
2,1109,36679,3575887566,3575887566,0
2,1109,36680,3575887566,3575887566,0
2,1109,36681,3575887566,3575887566,0
2,1109,36682,3575887566,3575887566,0
2,1109,36683,3575887566,3575887566,0
2,1109,36684,3575887566,3575887566,0
2,1109,36685,3575887566,3575887566,0
2,1109,36686,3575887566,3575887566,0
2,1109,36687,3575887566,3575887566,0
2,1109,36688,3575887566,3575887566,0
2,1109,36689,3575887566,3575887568,2
2,1109,36690,3575887566,3575887568,2
2,1109,36691,3575887566,3575887568,2
2,1109,36692,3575887566,3575887569,3
2,1109,36693,3575887566,3575887569,3
2,1109,36694,3575887566,3575887569,3
2,1109,36695,3575887566,3575887571,5
2,1109,36696,3575887566,3575887572,6
2,1109,36697,3575887566,3575887572,6
2,1109,36698,3575887566,3575887574,8
2,1109,36699,3575887566,3575887575,9
2,1109,36700,3575887566,3575887575,9
2,1109,36701,3575887566,3575887575,9
2,1109,36702,3575887566,3575887576,10
2,1109,36703,3575887566,3575887577,11
2,1109,36704,3575887566,3575887577,11
2,1109,36705,3575887566,3575887578,12
2,1109,36706,3575887566,3575887578,12
2,1109,36707,3575887566,3575887580,14
2,1109,36708,3575887566,3575887580,14
2,1109,36709,3575887566,3575887581,15
2,1109,36710,3575887566,3575887582,16
2,1109,36711,3575887566,3575887582,16
2,1109,36712,3575887566,3575887583,17
2,1109,36713,3575887566,3575887583,17
2,1109,36714,3575887566,3575887583,17
2,1109,36715,3575887566,3575887584,18
2,1109,36716,3575887566,3575887585,19
2,1109,36717,3575887566,3575887585,19
2,1109,36718,3575887566,3575887585,19
2,1109,36719,3575887566,3575887587,21
2,1109,36720,3575887566,3575887588,22
2,1109,36721,3575887566,3575887588,22
2,1109,36722,3575887566,3575887589,23
2,1109,36723,3575887566,3575887590,24
2,1109,36724,3575887566,3575887591,25
2,1109,36725,3575887566,3575887591,25
2,1109,36726,3575887566,3575887592,26
2,1109,36727,3575887566,3575887593,27
2,1109,36728,3575887566,3575887593,27
2,1109,36729,3575887566,3575887594,28
2,1109,36730,3575887566,3575887595,29
2,1109,36731,3575887566,3575887596,30
2,1109,36732,3575887566,3575887597,31
2,1109,36733,3575887566,3575887598,32
2,1109,36734,3575887566,3575887599,33
2,1109,36735,3575887566,3575887600,34
2,1109,36736,3575887566,3575887601,35
2,1109,36737,3575887566,3575887602,36
2,1109,36738,3575887566,3575887602,36
2,1109,36739,3575887566,3575887602,36
2,1109,36740,3575887566,3575887603,37
2,1109,36741,3575887566,3575887603,37
2,1109,36742,3575887566,3575887604,38
2,1109,36743,3575887566,3575887604,38
2,1109,36744,3575887566,3575887607,41
2,1109,36745,3575887566,3575887607,41
2,1109,36746,3575887566,3575887609,43
2,1109,36747,3575887566,3575887610,44
2,1109,36748,3575887566,3575887610,44
2,1109,36749,3575887566,3575887611,45
2,1109,36750,3575887566,3575887612,46
2,1109,36751,3575887566,3575887612,46
2,1109,36752,3575887566,3575887613,47
2,1110,36753,3575887631,3575887631,0
2,1110,36754,3575887631,3575887631,0
2,1110,36755,3575887631,3575887631,0
2,1110,36756,3575887631,3575887631,0
2,1110,36757,3575887631,3575887631,0
2,1110,36758,3575887631,3575887631,0
2,1110,36759,3575887631,3575887631,0
2,1110,36760,3575887631,3575887631,0
2,1110,36761,3575887631,3575887631,0
2,1110,36762,3575887631,3575887631,0
2,1110,36763,3575887631,3575887631,0
2,1110,36764,3575887631,3575887631,0
2,1110,36765,3575887631,3575887631,0
2,1110,36766,3575887631,3575887631,0
2,1110,36767,3575887631,3575887634,3
2,1110,36768,3575887631,3575887635,4
2,1110,36769,3575887631,3575887635,4
2,1110,36770,3575887631,3575887636,5
2,1110,36771,3575887631,3575887636,5
2,1110,36772,3575887631,3575887637,6
2,1110,36773,3575887631,3575887639,8
2,1110,36774,3575887631,3575887639,8
2,1110,36775,3575887631,3575887639,8
2,1110,36776,3575887631,3575887640,9
2,1110,36777,3575887631,3575887642,11
2,1110,36778,3575887631,3575887642,11
2,1110,36779,3575887631,3575887642,11
2,1110,36780,3575887631,3575887644,13
2,1110,36781,3575887631,3575887645,14
2,1110,36782,3575887631,3575887648,17
2,1110,36783,3575887631,3575887651,20
2,1110,36784,3575887631,3575887653,22
2,1110,36785,3575887631,3575887654,23
2,1110,36786,3575887631,3575887654,23
2,1110,36787,3575887631,3575887655,24
2,1110,36788,3575887631,3575887655,24
2,1110,36789,3575887631,3575887655,24
2,1110,36790,3575887631,3575887656,25
2,1110,36791,3575887631,3575887656,25
2,1110,36792,3575887631,3575887658,27
2,1110,36793,3575887631,3575887658,27
2,1110,36794,3575887631,3575887658,27
2,1110,36795,3575887631,3575887661,30
2,1110,36796,3575887631,3575887662,31
2,1110,36797,3575887631,3575887663,32
2,1110,36798,3575887631,3575887666,35
2,1110,36799,3575887631,3575887666,35
2,1110,36800,3575887631,3575887668,37
2,1110,36801,3575887631,3575887676,45
2,1110,36802,3575887631,3575887677,46
2,1110,36803,3575887631,3575887678,47
2,1110,36804,3575887631,3575887679,48
2,1111,36805,3575887696,3575887696,0
2,1111,36806,3575887696,3575887696,0
2,1111,36807,3575887696,3575887696,0
2,1111,36808,3575887696,3575887696,0
2,1111,36809,3575887696,3575887696,0
2,1111,36810,3575887696,3575887696,0
2,1111,36811,3575887696,3575887696,0
2,1111,36812,3575887696,3575887696,0
2,1111,36813,3575887696,3575887696,0
2,1111,36814,3575887696,3575887696,0
2,1111,36815,3575887696,3575887696,0
2,1111,36816,3575887696,3575887696,0
2,1111,36817,3575887696,3575887696,0
2,1111,36818,3575887696,3575887696,0
2,1111,36819,3575887696,3575887696,0
2,1111,36820,3575887696,3575887696,0
2,1111,36821,3575887696,3575887696,0
2,1111,36822,3575887696,3575887696,0
2,1111,36823,3575887696,3575887696,0
2,1111,36824,3575887696,3575887696,0
2,1111,36825,3575887696,3575887696,0
2,1111,36826,3575887696,3575887696,0
2,1111,36827,3575887696,3575887696,0
2,1111,36828,3575887696,3575887696,0
2,1111,36829,3575887696,3575887697,1
2,1111,36830,3575887696,3575887698,2
2,1111,36831,3575887696,3575887698,2
2,1111,36832,3575887696,3575887699,3
2,1111,36833,3575887696,3575887699,3
2,1111,36834,3575887696,3575887700,4
2,1111,36835,3575887696,3575887700,4
2,1111,36836,3575887696,3575887703,7
2,1111,36837,3575887696,3575887704,8
2,1111,36838,3575887696,3575887704,8
2,1111,36839,3575887696,3575887705,9
2,1111,36840,3575887696,3575887705,9
2,1111,36841,3575887696,3575887705,9
2,1111,36842,3575887696,3575887706,10
2,1111,36843,3575887696,3575887707,11
2,1111,36844,3575887696,3575887707,11
2,1111,36845,3575887696,3575887707,11
2,1111,36846,3575887696,3575887708,12
2,1111,36847,3575887696,3575887708,12
2,1111,36848,3575887696,3575887708,12
2,1111,36849,3575887696,3575887708,12
2,1111,36850,3575887696,3575887709,13
2,1111,36851,3575887696,3575887709,13
2,1111,36852,3575887696,3575887710,14
2,1111,36853,3575887696,3575887710,14
2,1111,36854,3575887696,3575887710,14
2,1111,36855,3575887696,3575887711,15
2,1111,36856,3575887696,3575887712,16
2,1111,36857,3575887696,3575887714,18
2,1111,36858,3575887696,3575887714,18
2,1111,36859,3575887696,3575887715,19
2,1111,36860,3575887696,3575887717,21
2,1111,36861,3575887696,3575887718,22
2,1111,36862,3575887696,3575887718,22
2,1111,36863,3575887696,3575887719,23
2,1111,36864,3575887696,3575887719,23
2,1111,36865,3575887696,3575887720,24
2,1111,36866,3575887696,3575887720,24
2,1111,36867,3575887696,3575887720,24
2,1111,36868,3575887696,3575887720,24
2,1111,36869,3575887696,3575887722,26
2,1111,36870,3575887696,3575887723,27
2,1111,36871,3575887696,3575887726,30
2,1111,36872,3575887696,3575887726,30
2,1111,36873,3575887696,3575887726,30
2,1111,36874,3575887696,3575887727,31
2,1111,36875,3575887696,3575887728,32
2,1111,36876,3575887696,3575887728,32
2,1111,36877,3575887696,3575887730,34
2,1111,36878,3575887696,3575887730,34
2,1111,36879,3575887696,3575887731,35
2,1111,36880,3575887696,3575887731,35
2,1111,36881,3575887696,3575887731,35
2,1111,36882,3575887696,3575887732,36
2,1111,36883,3575887696,3575887732,36
2,1111,36884,3575887696,3575887733,37
2,1111,36885,3575887696,3575887733,37
2,1111,36886,3575887696,3575887734,38
2,1111,36887,3575887696,3575887734,38
2,1111,36888,3575887696,3575887735,39
2,1111,36889,3575887696,3575887735,39
2,1111,36890,3575887696,3575887736,40
2,1111,36891,3575887696,3575887739,43
2,1111,36892,3575887696,3575887739,43
2,1111,36893,3575887696,3575887739,43
2,1111,36894,3575887696,3575887740,44
2,1111,36895,3575887696,3575887740,44
2,1111,36896,3575887696,3575887744,48
2,1111,36897,3575887696,3575887744,48
2,1111,36898,3575887696,3575887744,48
2,1111,36899,3575887696,3575887745,49
2,1111,36900,3575887696,3575887745,49
2,1111,36901,3575887696,3575887746,50
2,1112,36902,3575887760,3575887760,0
2,1112,36903,3575887760,3575887760,0
2,1112,36904,3575887760,3575887760,0
2,1112,36905,3575887760,3575887760,0
2,1112,36906,3575887760,3575887760,0
2,1112,36907,3575887760,3575887761,1
2,1112,36908,3575887760,3575887761,1
2,1112,36909,3575887760,3575887761,1
2,1112,36910,3575887760,3575887761,1
2,1112,36911,3575887760,3575887761,1
2,1112,36912,3575887760,3575887761,1
2,1112,36913,3575887760,3575887761,1
2,1112,36914,3575887760,3575887761,1
2,1112,36915,3575887760,3575887761,1
2,1112,36916,3575887760,3575887761,1
2,1112,36917,3575887760,3575887761,1
2,1112,36918,3575887760,3575887761,1
2,1112,36919,3575887760,3575887761,1
2,1112,36920,3575887760,3575887761,1
2,1112,36921,3575887760,3575887761,1
2,1112,36922,3575887760,3575887762,2
2,1112,36923,3575887760,3575887764,4
2,1112,36924,3575887760,3575887765,5
2,1112,36925,3575887760,3575887765,5
2,1112,36926,3575887760,3575887765,5
2,1112,36927,3575887760,3575887765,5
2,1112,36928,3575887760,3575887767,7
2,1112,36929,3575887760,3575887769,9
2,1112,36930,3575887760,3575887769,9
2,1112,36931,3575887760,3575887769,9
2,1112,36932,3575887760,3575887769,9
2,1112,36933,3575887760,3575887770,10
2,1112,36934,3575887760,3575887771,11
2,1112,36935,3575887760,3575887771,11
2,1112,36936,3575887760,3575887772,12
2,1112,36937,3575887760,3575887773,13
2,1112,36938,3575887760,3575887774,14
2,1112,36939,3575887760,3575887775,15
2,1112,36940,3575887760,3575887775,15
2,1112,36941,3575887760,3575887776,16
2,1112,36942,3575887760,3575887777,17
2,1112,36943,3575887760,3575887777,17
2,1112,36944,3575887760,3575887778,18
2,1112,36945,3575887760,3575887778,18
2,1112,36946,3575887760,3575887779,19
2,1112,36947,3575887760,3575887780,20
2,1112,36948,3575887760,3575887780,20
2,1112,36949,3575887760,3575887781,21
2,1112,36950,3575887760,3575887781,21
2,1112,36951,3575887760,3575887782,22
2,1112,36952,3575887760,3575887783,23
2,1112,36953,3575887760,3575887783,23
2,1112,36954,3575887760,3575887783,23
2,1112,36955,3575887760,3575887785,25
2,1112,36956,3575887760,3575887785,25
2,1112,36957,3575887760,3575887785,25
2,1112,36958,3575887760,3575887785,25
2,1112,36959,3575887760,3575887788,28
2,1112,36960,3575887760,3575887789,29
2,1112,36961,3575887760,3575887790,30
2,1112,36962,3575887760,3575887791,31
2,1112,36963,3575887760,3575887791,31
2,1112,36964,3575887760,3575887791,31
2,1112,36965,3575887760,3575887792,32
2,1112,36966,3575887760,3575887793,33
2,1112,36967,3575887760,3575887794,34
2,1112,36968,3575887760,3575887795,35
2,1112,36969,3575887760,3575887796,36
2,1112,36970,3575887760,3575887798,38
2,1112,36971,3575887760,3575887798,38
2,1112,36972,3575887760,3575887799,39
2,1112,36973,3575887760,3575887801,41
2,1112,36974,3575887760,3575887801,41
2,1112,36975,3575887760,3575887802,42
2,1112,36976,3575887760,3575887802,42
2,1112,36977,3575887760,3575887803,43
2,1112,36978,3575887760,3575887803,43
2,1112,36979,3575887760,3575887804,44
2,1112,36980,3575887760,3575887804,44
2,1112,36981,3575887760,3575887804,44
2,1112,36982,3575887760,3575887807,47
2,1112,36983,3575887760,3575887807,47
2,1112,36984,3575887760,3575887809,49
2,1112,36985,3575887760,3575887809,49
2,1112,36986,3575887760,3575887811,51
2,1113,36987,3575887825,3575887825,0
2,1113,36988,3575887825,3575887825,0
2,1113,36989,3575887825,3575887825,0
2,1113,36990,3575887825,3575887825,0
2,1113,36991,3575887825,3575887825,0
2,1113,36992,3575887825,3575887825,0
2,1113,36993,3575887825,3575887825,0
2,1113,36994,3575887825,3575887825,0
2,1113,36995,3575887825,3575887825,0
2,1113,36996,3575887825,3575887825,0
2,1113,36997,3575887825,3575887826,1
2,1113,36998,3575887825,3575887827,2
2,1113,36999,3575887825,3575887828,3
2,1113,37000,3575887825,3575887829,4
2,1113,37001,3575887825,3575887830,5
2,1113,37002,3575887825,3575887830,5
2,1113,37003,3575887825,3575887835,10
2,1113,37004,3575887825,3575887835,10
2,1113,37005,3575887825,3575887835,10
2,1113,37006,3575887825,3575887835,10
2,1113,37007,3575887825,3575887836,11
2,1113,37008,3575887825,3575887837,12
2,1113,37009,3575887825,3575887837,12
2,1113,37010,3575887825,3575887839,14
2,1113,37011,3575887825,3575887840,15
2,1113,37012,3575887825,3575887841,16
2,1113,37013,3575887825,3575887842,17
2,1113,37014,3575887825,3575887842,17
2,1113,37015,3575887825,3575887843,18
2,1113,37016,3575887825,3575887845,20
2,1113,37017,3575887825,3575887845,20
2,1113,37018,3575887825,3575887849,24
2,1113,37019,3575887825,3575887851,26
2,1113,37020,3575887825,3575887853,28
2,1113,37021,3575887825,3575887854,29
2,1113,37022,3575887825,3575887854,29
2,1113,37023,3575887825,3575887854,29
2,1113,37024,3575887825,3575887854,29
2,1113,37025,3575887825,3575887855,30
2,1113,37026,3575887825,3575887855,30
2,1113,37027,3575887825,3575887856,31
2,1113,37028,3575887825,3575887857,32
2,1113,37029,3575887825,3575887858,33
2,1113,37030,3575887825,3575887858,33
2,1113,37031,3575887825,3575887861,36
2,1113,37032,3575887825,3575887862,37
2,1113,37033,3575887825,3575887863,38
2,1113,37034,3575887825,3575887866,41
2,1113,37035,3575887825,3575887867,42
2,1113,37036,3575887825,3575887868,43
2,1114,37037,3575887888,3575887888,0
2,1114,37038,3575887888,3575887888,0
2,1114,37039,3575887888,3575887888,0
2,1114,37040,3575887888,3575887888,0
2,1114,37041,3575887888,3575887888,0
2,1114,37042,3575887888,3575887888,0
2,1114,37043,3575887888,3575887888,0
2,1114,37044,3575887888,3575887888,0
2,1114,37045,3575887888,3575887888,0
2,1114,37046,3575887888,3575887888,0
2,1114,37047,3575887888,3575887888,0
2,1114,37048,3575887888,3575887888,0
2,1114,37049,3575887888,3575887889,1
2,1114,37050,3575887888,3575887890,2
2,1114,37051,3575887888,3575887890,2
2,1114,37052,3575887888,3575887890,2
2,1114,37053,3575887888,3575887891,3
2,1114,37054,3575887888,3575887891,3
2,1114,37055,3575887888,3575887891,3
2,1114,37056,3575887888,3575887892,4
2,1114,37057,3575887888,3575887893,5
2,1114,37058,3575887888,3575887894,6
2,1114,37059,3575887888,3575887895,7
2,1114,37060,3575887888,3575887895,7
2,1114,37061,3575887888,3575887896,8
2,1114,37062,3575887888,3575887896,8
2,1114,37063,3575887888,3575887897,9
2,1114,37064,3575887888,3575887897,9
2,1114,37065,3575887888,3575887898,10
2,1114,37066,3575887888,3575887898,10
2,1114,37067,3575887888,3575887901,13
2,1114,37068,3575887888,3575887901,13
2,1114,37069,3575887888,3575887903,15
2,1114,37070,3575887888,3575887904,16
2,1114,37071,3575887888,3575887904,16
2,1114,37072,3575887888,3575887905,17
2,1114,37073,3575887888,3575887905,17
2,1114,37074,3575887888,3575887905,17
2,1114,37075,3575887888,3575887906,18
2,1114,37076,3575887888,3575887907,19
2,1114,37077,3575887888,3575887907,19
2,1114,37078,3575887888,3575887907,19
2,1114,37079,3575887888,3575887907,19
2,1114,37080,3575887888,3575887908,20
2,1114,37081,3575887888,3575887908,20
2,1114,37082,3575887888,3575887909,21
2,1114,37083,3575887888,3575887909,21
2,1114,37084,3575887888,3575887909,21
2,1114,37085,3575887888,3575887910,22
2,1114,37086,3575887888,3575887910,22
2,1114,37087,3575887888,3575887910,22
2,1114,37088,3575887888,3575887911,23
2,1114,37089,3575887888,3575887912,24
2,1114,37090,3575887888,3575887913,25
2,1114,37091,3575887888,3575887913,25
2,1114,37092,3575887888,3575887914,26
2,1114,37093,3575887888,3575887914,26
2,1114,37094,3575887888,3575887914,26
2,1114,37095,3575887888,3575887916,28
2,1114,37096,3575887888,3575887918,30
2,1114,37097,3575887888,3575887919,31
2,1114,37098,3575887888,3575887919,31
2,1114,37099,3575887888,3575887920,32
2,1114,37100,3575887888,3575887920,32
2,1114,37101,3575887888,3575887921,33
2,1114,37102,3575887888,3575887921,33
2,1114,37103,3575887888,3575887922,34
2,1114,37104,3575887888,3575887923,35
2,1114,37105,3575887888,3575887925,37
2,1114,37106,3575887888,3575887926,38
2,1114,37107,3575887888,3575887926,38
2,1114,37108,3575887888,3575887928,40
2,1114,37109,3575887888,3575887928,40
2,1114,37110,3575887888,3575887929,41
2,1114,37111,3575887888,3575887930,42
2,1114,37112,3575887888,3575887931,43
2,1114,37113,3575887888,3575887931,43
2,1114,37114,3575887888,3575887932,44
2,1114,37115,3575887888,3575887932,44
2,1114,37116,3575887888,3575887932,44
2,1114,37117,3575887888,3575887933,45
2,1114,37118,3575887888,3575887934,46
2,1114,37119,3575887888,3575887934,46
2,1114,37120,3575887888,3575887935,47
2,1114,37121,3575887888,3575887935,47
2,1114,37122,3575887888,3575887937,49
2,1115,37123,3575887952,3575887952,0
2,1115,37124,3575887952,3575887952,0
2,1115,37125,3575887952,3575887952,0
2,1115,37126,3575887952,3575887952,0
2,1115,37127,3575887952,3575887952,0
2,1115,37128,3575887952,3575887952,0
2,1115,37129,3575887952,3575887952,0
2,1115,37130,3575887952,3575887952,0
2,1115,37131,3575887952,3575887952,0
2,1115,37132,3575887952,3575887952,0
2,1115,37133,3575887952,3575887952,0
2,1115,37134,3575887952,3575887952,0
2,1115,37135,3575887952,3575887952,0
2,1115,37136,3575887952,3575887952,0
2,1115,37137,3575887952,3575887952,0
2,1115,37138,3575887952,3575887952,0
2,1115,37139,3575887952,3575887952,0
2,1115,37140,3575887952,3575887952,0
2,1115,37141,3575887952,3575887952,0
2,1115,37142,3575887952,3575887953,1
2,1115,37143,3575887952,3575887953,1
2,1115,37144,3575887952,3575887954,2
2,1115,37145,3575887952,3575887955,3
2,1115,37146,3575887952,3575887956,4
2,1115,37147,3575887952,3575887957,5
2,1115,37148,3575887952,3575887957,5
2,1115,37149,3575887952,3575887958,6
2,1115,37150,3575887952,3575887959,7
2,1115,37151,3575887952,3575887959,7
2,1115,37152,3575887952,3575887960,8
2,1115,37153,3575887952,3575887961,9
2,1115,37154,3575887952,3575887962,10
2,1115,37155,3575887952,3575887962,10
2,1115,37156,3575887952,3575887963,11
2,1115,37157,3575887952,3575887964,12
2,1115,37158,3575887952,3575887965,13
2,1115,37159,3575887952,3575887966,14
2,1115,37160,3575887952,3575887966,14
2,1115,37161,3575887952,3575887966,14
2,1115,37162,3575887952,3575887967,15
2,1115,37163,3575887952,3575887969,17
2,1115,37164,3575887952,3575887969,17
2,1115,37165,3575887952,3575887969,17
2,1115,37166,3575887952,3575887969,17
2,1115,37167,3575887952,3575887971,19
2,1115,37168,3575887952,3575887972,20
2,1115,37169,3575887952,3575887972,20
2,1115,37170,3575887952,3575887973,21
2,1115,37171,3575887952,3575887974,22
2,1115,37172,3575887952,3575887974,22
2,1115,37173,3575887952,3575887976,24
2,1115,37174,3575887952,3575887977,25
2,1115,37175,3575887952,3575887977,25
2,1115,37176,3575887952,3575887978,26
2,1115,37177,3575887952,3575887978,26
2,1115,37178,3575887952,3575887978,26
2,1115,37179,3575887952,3575887981,29
2,1115,37180,3575887952,3575887981,29
2,1115,37181,3575887952,3575887981,29
2,1115,37182,3575887952,3575887982,30
2,1115,37183,3575887952,3575887982,30
2,1115,37184,3575887952,3575887983,31
2,1115,37185,3575887952,3575887984,32
2,1115,37186,3575887952,3575887985,33
2,1115,37187,3575887952,3575887985,33
2,1115,37188,3575887952,3575887986,34
2,1115,37189,3575887952,3575887986,34
2,1115,37190,3575887952,3575887988,36
2,1115,37191,3575887952,3575887988,36
2,1115,37192,3575887952,3575887990,38
2,1115,37193,3575887952,3575887990,38
2,1115,37194,3575887952,3575887991,39
2,1115,37195,3575887952,3575887992,40
2,1115,37196,3575887952,3575887992,40
2,1115,37197,3575887952,3575887993,41
2,1115,37198,3575887952,3575887993,41
2,1115,37199,3575887952,3575887994,42
2,1115,37200,3575887952,3575887995,43
2,1115,37201,3575887952,3575887996,44
2,1115,37202,3575887952,3575887998,46
2,1115,37203,3575887952,3575887998,46
2,1115,37204,3575887952,3575887999,47
2,1115,37205,3575887952,3575888001,49
2,1115,37206,3575887952,3575888001,49
2,1116,37207,3575888015,3575888015,0
2,1116,37208,3575888015,3575888015,0
2,1116,37209,3575888015,3575888015,0
2,1116,37210,3575888015,3575888015,0
2,1116,37211,3575888015,3575888015,0
2,1116,37212,3575888015,3575888015,0
2,1116,37213,3575888015,3575888015,0
2,1116,37214,3575888015,3575888015,0
2,1116,37215,3575888015,3575888015,0
2,1116,37216,3575888015,3575888015,0
2,1116,37217,3575888015,3575888015,0
2,1116,37218,3575888015,3575888015,0
2,1116,37219,3575888015,3575888015,0
2,1116,37220,3575888015,3575888015,0
2,1116,37221,3575888015,3575888015,0
2,1116,37222,3575888015,3575888021,6
2,1116,37223,3575888015,3575888022,7
2,1116,37224,3575888015,3575888023,8
2,1116,37225,3575888015,3575888024,9
2,1116,37226,3575888015,3575888025,10
2,1116,37227,3575888015,3575888026,11
2,1116,37228,3575888015,3575888026,11
2,1116,37229,3575888015,3575888027,12
2,1116,37230,3575888015,3575888027,12
2,1116,37231,3575888015,3575888028,13
2,1116,37232,3575888015,3575888028,13
2,1116,37233,3575888015,3575888030,15
2,1116,37234,3575888015,3575888030,15
2,1116,37235,3575888015,3575888035,20
2,1116,37236,3575888015,3575888035,20
2,1116,37237,3575888015,3575888035,20
2,1116,37238,3575888015,3575888036,21
2,1116,37239,3575888015,3575888037,22
2,1116,37240,3575888015,3575888037,22
2,1116,37241,3575888015,3575888037,22
2,1116,37242,3575888015,3575888039,24
2,1116,37243,3575888015,3575888040,25
2,1116,37244,3575888015,3575888041,26
2,1116,37245,3575888015,3575888042,27
2,1116,37246,3575888015,3575888042,27
2,1116,37247,3575888015,3575888043,28
2,1116,37248,3575888015,3575888045,30
2,1116,37249,3575888015,3575888045,30
2,1116,37250,3575888015,3575888047,32
2,1116,37251,3575888015,3575888047,32
2,1116,37252,3575888015,3575888049,34
2,1116,37253,3575888015,3575888051,36
2,1116,37254,3575888015,3575888053,38
2,1116,37255,3575888015,3575888054,39
2,1116,37256,3575888015,3575888054,39
2,1116,37257,3575888015,3575888055,40
2,1116,37258,3575888015,3575888055,40
2,1116,37259,3575888015,3575888055,40
2,1116,37260,3575888015,3575888056,41
2,1116,37261,3575888015,3575888056,41
2,1116,37262,3575888015,3575888057,42
2,1116,37263,3575888015,3575888058,43
2,1116,37264,3575888015,3575888058,43
2,1116,37265,3575888015,3575888060,45
2,1116,37266,3575888015,3575888062,47
2,1116,37267,3575888015,3575888063,48
2,1117,37268,3575888081,3575888081,0
2,1117,37269,3575888081,3575888081,0
2,1117,37270,3575888081,3575888081,0
2,1117,37271,3575888081,3575888081,0
2,1117,37272,3575888081,3575888081,0
2,1117,37273,3575888081,3575888081,0
2,1117,37274,3575888081,3575888081,0
2,1117,37275,3575888081,3575888081,0
2,1117,37276,3575888081,3575888082,1
2,1117,37277,3575888081,3575888083,2
2,1117,37278,3575888081,3575888084,3
2,1117,37279,3575888081,3575888085,4
2,1117,37280,3575888081,3575888085,4
2,1117,37281,3575888081,3575888085,4
2,1117,37282,3575888081,3575888086,5
2,1117,37283,3575888081,3575888087,6
2,1117,37284,3575888081,3575888087,6
2,1117,37285,3575888081,3575888089,8
2,1117,37286,3575888081,3575888090,9
2,1117,37287,3575888081,3575888090,9
2,1117,37288,3575888081,3575888090,9
2,1117,37289,3575888081,3575888091,10
2,1117,37290,3575888081,3575888091,10
2,1117,37291,3575888081,3575888091,10
2,1117,37292,3575888081,3575888091,10
2,1117,37293,3575888081,3575888092,11
2,1117,37294,3575888081,3575888092,11
2,1117,37295,3575888081,3575888093,12
2,1117,37296,3575888081,3575888095,14
2,1117,37297,3575888081,3575888095,14
2,1117,37298,3575888081,3575888095,14
2,1117,37299,3575888081,3575888096,15
2,1117,37300,3575888081,3575888096,15
2,1117,37301,3575888081,3575888097,16
2,1117,37302,3575888081,3575888098,17
2,1117,37303,3575888081,3575888098,17
2,1117,37304,3575888081,3575888099,18
2,1117,37305,3575888081,3575888100,19
2,1117,37306,3575888081,3575888100,19
2,1117,37307,3575888081,3575888101,20
2,1117,37308,3575888081,3575888103,22
2,1117,37309,3575888081,3575888104,23
2,1117,37310,3575888081,3575888105,24
2,1117,37311,3575888081,3575888106,25
2,1117,37312,3575888081,3575888106,25
2,1117,37313,3575888081,3575888106,25
2,1117,37314,3575888081,3575888107,26
2,1117,37315,3575888081,3575888107,26
2,1117,37316,3575888081,3575888107,26
2,1117,37317,3575888081,3575888107,26
2,1117,37318,3575888081,3575888108,27
2,1117,37319,3575888081,3575888108,27
2,1117,37320,3575888081,3575888109,28
2,1117,37321,3575888081,3575888109,28
2,1117,37322,3575888081,3575888109,28
2,1117,37323,3575888081,3575888109,28
2,1117,37324,3575888081,3575888110,29
2,1117,37325,3575888081,3575888111,30
2,1117,37326,3575888081,3575888112,31
2,1117,37327,3575888081,3575888112,31
2,1117,37328,3575888081,3575888112,31
2,1117,37329,3575888081,3575888113,32
2,1117,37330,3575888081,3575888113,32
2,1117,37331,3575888081,3575888114,33
2,1117,37332,3575888081,3575888114,33
2,1117,37333,3575888081,3575888115,34
2,1117,37334,3575888081,3575888117,36
2,1117,37335,3575888081,3575888119,38
2,1117,37336,3575888081,3575888119,38
2,1117,37337,3575888081,3575888120,39
2,1117,37338,3575888081,3575888120,39
2,1117,37339,3575888081,3575888120,39
2,1117,37340,3575888081,3575888120,39
2,1117,37341,3575888081,3575888121,40
2,1117,37342,3575888081,3575888121,40
2,1117,37343,3575888081,3575888122,41
2,1117,37344,3575888081,3575888123,42
2,1117,37345,3575888081,3575888126,45
2,1117,37346,3575888081,3575888126,45
2,1117,37347,3575888081,3575888126,45
2,1117,37348,3575888081,3575888127,46
2,1117,37349,3575888081,3575888128,47
2,1117,37350,3575888081,3575888129,48
2,1117,37351,3575888081,3575888129,48
2,1117,37352,3575888081,3575888130,49
2,1117,37353,3575888081,3575888130,49
2,1117,37354,3575888081,3575888131,50
2,1118,37355,3575888143,3575888143,0
2,1118,37356,3575888143,3575888143,0
2,1118,37357,3575888143,3575888143,0
2,1118,37358,3575888143,3575888143,0
2,1118,37359,3575888143,3575888143,0
2,1118,37360,3575888143,3575888143,0
2,1118,37361,3575888143,3575888143,0
2,1118,37362,3575888143,3575888143,0
2,1118,37363,3575888143,3575888143,0
2,1118,37364,3575888143,3575888143,0
2,1118,37365,3575888143,3575888143,0
2,1118,37366,3575888143,3575888143,0
2,1118,37367,3575888143,3575888143,0
2,1118,37368,3575888143,3575888143,0
2,1118,37369,3575888143,3575888143,0
2,1118,37370,3575888143,3575888143,0
2,1118,37371,3575888143,3575888143,0
2,1118,37372,3575888143,3575888144,1
2,1118,37373,3575888143,3575888144,1
2,1118,37374,3575888143,3575888145,2
2,1118,37375,3575888143,3575888145,2
2,1118,37376,3575888143,3575888146,3
2,1118,37377,3575888143,3575888147,4
2,1118,37378,3575888143,3575888147,4
2,1118,37379,3575888143,3575888149,6
2,1118,37380,3575888143,3575888149,6
2,1118,37381,3575888143,3575888149,6
2,1118,37382,3575888143,3575888151,8
2,1118,37383,3575888143,3575888152,9
2,1118,37384,3575888143,3575888152,9
2,1118,37385,3575888143,3575888152,9
2,1118,37386,3575888143,3575888154,11
2,1118,37387,3575888143,3575888156,13
2,1118,37388,3575888143,3575888156,13
2,1118,37389,3575888143,3575888156,13
2,1118,37390,3575888143,3575888158,15
2,1118,37391,3575888143,3575888158,15
2,1118,37392,3575888143,3575888159,16
2,1118,37393,3575888143,3575888159,16
2,1118,37394,3575888143,3575888160,17
2,1118,37395,3575888143,3575888160,17
2,1118,37396,3575888143,3575888161,18
2,1118,37397,3575888143,3575888161,18
2,1118,37398,3575888143,3575888162,19
2,1118,37399,3575888143,3575888164,21
2,1118,37400,3575888143,3575888165,22
2,1118,37401,3575888143,3575888165,22
2,1118,37402,3575888143,3575888165,22
2,1118,37403,3575888143,3575888167,24
2,1118,37404,3575888143,3575888167,24
2,1118,37405,3575888143,3575888168,25
2,1118,37406,3575888143,3575888168,25
2,1118,37407,3575888143,3575888169,26
2,1118,37408,3575888143,3575888170,27
2,1118,37409,3575888143,3575888170,27
2,1118,37410,3575888143,3575888170,27
2,1118,37411,3575888143,3575888171,28
2,1118,37412,3575888143,3575888172,29
2,1118,37413,3575888143,3575888172,29
2,1118,37414,3575888143,3575888173,30
2,1118,37415,3575888143,3575888173,30
2,1118,37416,3575888143,3575888174,31
2,1118,37417,3575888143,3575888175,32
2,1118,37418,3575888143,3575888176,33
2,1118,37419,3575888143,3575888177,34
2,1118,37420,3575888143,3575888178,35
2,1118,37421,3575888143,3575888179,36
2,1118,37422,3575888143,3575888179,36
2,1118,37423,3575888143,3575888181,38
2,1118,37424,3575888143,3575888181,38
2,1118,37425,3575888143,3575888181,38
2,1118,37426,3575888143,3575888182,39
2,1118,37427,3575888143,3575888183,40
2,1118,37428,3575888143,3575888184,41
2,1118,37429,3575888143,3575888184,41
2,1118,37430,3575888143,3575888185,42
2,1118,37431,3575888143,3575888185,42
2,1118,37432,3575888143,3575888185,42
2,1118,37433,3575888143,3575888185,42
2,1118,37434,3575888143,3575888185,42
2,1118,37435,3575888143,3575888187,44
2,1118,37436,3575888143,3575888188,45
2,1118,37437,3575888143,3575888188,45
2,1118,37438,3575888143,3575888191,48
2,1118,37439,3575888143,3575888192,49
2,1118,37440,3575888143,3575888192,49
2,1118,37441,3575888143,3575888192,49
2,1118,37442,3575888143,3575888192,49
2,1119,37443,3575888207,3575888207,0
2,1119,37444,3575888207,3575888207,0
2,1119,37445,3575888207,3575888207,0
2,1119,37446,3575888207,3575888207,0
2,1119,37447,3575888207,3575888207,0
2,1119,37448,3575888207,3575888207,0
2,1119,37449,3575888207,3575888207,0
2,1119,37450,3575888207,3575888207,0
2,1119,37451,3575888207,3575888207,0
2,1119,37452,3575888207,3575888207,0
2,1119,37453,3575888207,3575888207,0
2,1119,37454,3575888207,3575888207,0
2,1119,37455,3575888207,3575888207,0
2,1119,37456,3575888207,3575888207,0
2,1119,37457,3575888207,3575888207,0
2,1119,37458,3575888207,3575888207,0
2,1119,37459,3575888207,3575888207,0
2,1119,37460,3575888207,3575888207,0
2,1119,37461,3575888207,3575888207,0
2,1119,37462,3575888207,3575888209,2
2,1119,37463,3575888207,3575888211,4
2,1119,37464,3575888207,3575888211,4
2,1119,37465,3575888207,3575888212,5
2,1119,37466,3575888207,3575888212,5
2,1119,37467,3575888207,3575888212,5
2,1119,37468,3575888207,3575888214,7
2,1119,37469,3575888207,3575888221,14
2,1119,37470,3575888207,3575888222,15
2,1119,37471,3575888207,3575888223,16
2,1119,37472,3575888207,3575888223,16
2,1119,37473,3575888207,3575888226,19
2,1119,37474,3575888207,3575888226,19
2,1119,37475,3575888207,3575888226,19
2,1119,37476,3575888207,3575888227,20
2,1119,37477,3575888207,3575888228,21
2,1119,37478,3575888207,3575888228,21
2,1119,37479,3575888207,3575888229,22
2,1119,37480,3575888207,3575888230,23
2,1119,37481,3575888207,3575888235,28
2,1119,37482,3575888207,3575888235,28
2,1119,37483,3575888207,3575888235,28
2,1119,37484,3575888207,3575888235,28
2,1119,37485,3575888207,3575888237,30
2,1119,37486,3575888207,3575888237,30
2,1119,37487,3575888207,3575888238,31
2,1119,37488,3575888207,3575888239,32
2,1119,37489,3575888207,3575888239,32
2,1119,37490,3575888207,3575888240,33
2,1119,37491,3575888207,3575888241,34
2,1119,37492,3575888207,3575888242,35
2,1119,37493,3575888207,3575888242,35
2,1119,37494,3575888207,3575888245,38
2,1119,37495,3575888207,3575888245,38
2,1119,37496,3575888207,3575888247,40
2,1119,37497,3575888207,3575888248,41
2,1119,37498,3575888207,3575888249,42
2,1119,37499,3575888207,3575888251,44
2,1119,37500,3575888207,3575888253,46
2,1119,37501,3575888207,3575888255,48
2,1119,37502,3575888207,3575888255,48
2,1119,37503,3575888207,3575888255,48
2,1119,37504,3575888207,3575888256,49
2,1119,37505,3575888207,3575888257,50
2,1120,37506,3575888270,3575888270,0
2,1120,37507,3575888270,3575888270,0
2,1120,37508,3575888270,3575888270,0
2,1120,37509,3575888270,3575888270,0
2,1120,37510,3575888270,3575888270,0
2,1120,37511,3575888270,3575888270,0
2,1120,37512,3575888270,3575888270,0
2,1120,37513,3575888270,3575888270,0
2,1120,37514,3575888270,3575888270,0
2,1120,37515,3575888270,3575888270,0
2,1120,37516,3575888270,3575888276,6
2,1120,37517,3575888270,3575888277,7
2,1120,37518,3575888270,3575888278,8
2,1120,37519,3575888270,3575888280,10
2,1120,37520,3575888270,3575888281,11
2,1120,37521,3575888270,3575888282,12
2,1120,37522,3575888270,3575888284,14
2,1120,37523,3575888270,3575888284,14
2,1120,37524,3575888270,3575888285,15
2,1120,37525,3575888270,3575888285,15
2,1120,37526,3575888270,3575888286,16
2,1120,37527,3575888270,3575888286,16
2,1120,37528,3575888270,3575888287,17
2,1120,37529,3575888270,3575888287,17
2,1120,37530,3575888270,3575888289,19
2,1120,37531,3575888270,3575888290,20
2,1120,37532,3575888270,3575888290,20
2,1120,37533,3575888270,3575888291,21
2,1120,37534,3575888270,3575888291,21
2,1120,37535,3575888270,3575888291,21
2,1120,37536,3575888270,3575888292,22
2,1120,37537,3575888270,3575888292,22
2,1120,37538,3575888270,3575888293,23
2,1120,37539,3575888270,3575888294,24
2,1120,37540,3575888270,3575888295,25
2,1120,37541,3575888270,3575888296,26
2,1120,37542,3575888270,3575888296,26
2,1120,37543,3575888270,3575888296,26
2,1120,37544,3575888270,3575888297,27
2,1120,37545,3575888270,3575888298,28
2,1120,37546,3575888270,3575888298,28
2,1120,37547,3575888270,3575888298,28
2,1120,37548,3575888270,3575888299,29
2,1120,37549,3575888270,3575888300,30
2,1120,37550,3575888270,3575888300,30
2,1120,37551,3575888270,3575888301,31
2,1120,37552,3575888270,3575888304,34
2,1120,37553,3575888270,3575888304,34
2,1120,37554,3575888270,3575888306,36
2,1120,37555,3575888270,3575888306,36
2,1120,37556,3575888270,3575888307,37
2,1120,37557,3575888270,3575888307,37
2,1120,37558,3575888270,3575888307,37
2,1120,37559,3575888270,3575888307,37
2,1120,37560,3575888270,3575888307,37
2,1120,37561,3575888270,3575888307,37
2,1120,37562,3575888270,3575888308,38
2,1120,37563,3575888270,3575888308,38
2,1120,37564,3575888270,3575888308,38
2,1120,37565,3575888270,3575888309,39
2,1120,37566,3575888270,3575888309,39
2,1120,37567,3575888270,3575888309,39
2,1120,37568,3575888270,3575888309,39
2,1120,37569,3575888270,3575888310,40
2,1120,37570,3575888270,3575888310,40
2,1120,37571,3575888270,3575888311,41
2,1120,37572,3575888270,3575888312,42
2,1120,37573,3575888270,3575888313,43
2,1120,37574,3575888270,3575888313,43
2,1120,37575,3575888270,3575888313,43
2,1120,37576,3575888270,3575888314,44
2,1120,37577,3575888270,3575888316,46
2,1120,37578,3575888270,3575888316,46
2,1120,37579,3575888270,3575888317,47
2,1120,37580,3575888270,3575888319,49
2,1120,37581,3575888270,3575888319,49
2,1120,37582,3575888270,3575888320,50
2,1121,37583,3575888333,3575888333,0
2,1121,37584,3575888333,3575888333,0
2,1121,37585,3575888333,3575888333,0
2,1121,37586,3575888333,3575888333,0
2,1121,37587,3575888333,3575888333,0
2,1121,37588,3575888333,3575888333,0
2,1121,37589,3575888333,3575888333,0
2,1121,37590,3575888333,3575888333,0
2,1121,37591,3575888333,3575888333,0
2,1121,37592,3575888333,3575888333,0
2,1121,37593,3575888333,3575888333,0
2,1121,37594,3575888333,3575888333,0
2,1121,37595,3575888333,3575888333,0
2,1121,37596,3575888333,3575888333,0
2,1121,37597,3575888333,3575888333,0
2,1121,37598,3575888333,3575888333,0
2,1121,37599,3575888333,3575888333,0
2,1121,37600,3575888333,3575888333,0
2,1121,37601,3575888333,3575888333,0
2,1121,37602,3575888333,3575888333,0
2,1121,37603,3575888333,3575888333,0
2,1121,37604,3575888333,3575888333,0
2,1121,37605,3575888333,3575888334,1
2,1121,37606,3575888333,3575888334,1
2,1121,37607,3575888333,3575888334,1
2,1121,37608,3575888333,3575888334,1
2,1121,37609,3575888333,3575888335,2
2,1121,37610,3575888333,3575888335,2
2,1121,37611,3575888333,3575888336,3
2,1121,37612,3575888333,3575888337,4
2,1121,37613,3575888333,3575888338,5
2,1121,37614,3575888333,3575888339,6
2,1121,37615,3575888333,3575888340,7
2,1121,37616,3575888333,3575888340,7
2,1121,37617,3575888333,3575888340,7
2,1121,37618,3575888333,3575888342,9
2,1121,37619,3575888333,3575888344,11
2,1121,37620,3575888333,3575888344,11
2,1121,37621,3575888333,3575888344,11
2,1121,37622,3575888333,3575888345,12
2,1121,37623,3575888333,3575888345,12
2,1121,37624,3575888333,3575888346,13
2,1121,37625,3575888333,3575888347,14
2,1121,37626,3575888333,3575888347,14
2,1121,37627,3575888333,3575888348,15
2,1121,37628,3575888333,3575888349,16
2,1121,37629,3575888333,3575888349,16
2,1121,37630,3575888333,3575888351,18
2,1121,37631,3575888333,3575888351,18
2,1121,37632,3575888333,3575888352,19
2,1121,37633,3575888333,3575888353,20
2,1121,37634,3575888333,3575888353,20
2,1121,37635,3575888333,3575888354,21
2,1121,37636,3575888333,3575888355,22
2,1121,37637,3575888333,3575888356,23
2,1121,37638,3575888333,3575888358,25
2,1121,37639,3575888333,3575888358,25
2,1121,37640,3575888333,3575888358,25
2,1121,37641,3575888333,3575888360,27
2,1121,37642,3575888333,3575888360,27
2,1121,37643,3575888333,3575888361,28
2,1121,37644,3575888333,3575888361,28
2,1121,37645,3575888333,3575888361,28
2,1121,37646,3575888333,3575888361,28
2,1121,37647,3575888333,3575888364,31
2,1121,37648,3575888333,3575888365,32
2,1121,37649,3575888333,3575888366,33
2,1121,37650,3575888333,3575888366,33
2,1121,37651,3575888333,3575888366,33
2,1121,37652,3575888333,3575888369,36
2,1121,37653,3575888333,3575888369,36
2,1121,37654,3575888333,3575888369,36
2,1121,37655,3575888333,3575888370,37
2,1121,37656,3575888333,3575888370,37
2,1121,37657,3575888333,3575888370,37
2,1121,37658,3575888333,3575888371,38
2,1121,37659,3575888333,3575888371,38
2,1121,37660,3575888333,3575888373,40
2,1121,37661,3575888333,3575888374,41
2,1121,37662,3575888333,3575888376,43
2,1121,37663,3575888333,3575888376,43
2,1121,37664,3575888333,3575888376,43
2,1121,37665,3575888333,3575888377,44
2,1121,37666,3575888333,3575888378,45
2,1121,37667,3575888333,3575888379,46
2,1121,37668,3575888333,3575888379,46
2,1121,37669,3575888333,3575888381,48
2,1121,37670,3575888333,3575888381,48
2,1121,37671,3575888333,3575888381,48
2,1121,37672,3575888333,3575888381,48
2,1121,37673,3575888333,3575888383,50
2,1122,37674,3575888396,3575888396,0
2,1122,37675,3575888396,3575888396,0
2,1122,37676,3575888396,3575888396,0
2,1122,37677,3575888396,3575888397,1
2,1122,37678,3575888396,3575888397,1
2,1122,37679,3575888396,3575888397,1
2,1122,37680,3575888396,3575888397,1
2,1122,37681,3575888396,3575888397,1
2,1122,37682,3575888396,3575888397,1
2,1122,37683,3575888396,3575888397,1
2,1122,37684,3575888396,3575888397,1
2,1122,37685,3575888396,3575888397,1
2,1122,37686,3575888396,3575888397,1
2,1122,37687,3575888396,3575888397,1
2,1122,37688,3575888396,3575888397,1
2,1122,37689,3575888396,3575888397,1
2,1122,37690,3575888396,3575888397,1
2,1122,37691,3575888396,3575888397,1
2,1122,37692,3575888396,3575888397,1
2,1122,37693,3575888396,3575888397,1
2,1122,37694,3575888396,3575888399,3
2,1122,37695,3575888396,3575888399,3
2,1122,37696,3575888396,3575888399,3
2,1122,37697,3575888396,3575888400,4
2,1122,37698,3575888396,3575888401,5
2,1122,37699,3575888396,3575888403,7
2,1122,37700,3575888396,3575888403,7
2,1122,37701,3575888396,3575888404,8
2,1122,37702,3575888396,3575888404,8
2,1122,37703,3575888396,3575888404,8
2,1122,37704,3575888396,3575888405,9
2,1122,37705,3575888396,3575888407,11
2,1122,37706,3575888396,3575888408,12
2,1122,37707,3575888396,3575888408,12
2,1122,37708,3575888396,3575888411,15
2,1122,37709,3575888396,3575888411,15
2,1122,37710,3575888396,3575888412,16
2,1122,37711,3575888396,3575888413,17
2,1122,37712,3575888396,3575888413,17
2,1122,37713,3575888396,3575888415,19
2,1122,37714,3575888396,3575888421,25
2,1122,37715,3575888396,3575888422,26
2,1122,37716,3575888396,3575888423,27
2,1122,37717,3575888396,3575888423,27
2,1122,37718,3575888396,3575888426,30
2,1122,37719,3575888396,3575888426,30
2,1122,37720,3575888396,3575888426,30
2,1122,37721,3575888396,3575888426,30
2,1122,37722,3575888396,3575888428,32
2,1122,37723,3575888396,3575888428,32
2,1122,37724,3575888396,3575888428,32
2,1122,37725,3575888396,3575888429,33
2,1122,37726,3575888396,3575888430,34
2,1122,37727,3575888396,3575888430,34
2,1122,37728,3575888396,3575888435,39
2,1122,37729,3575888396,3575888435,39
2,1122,37730,3575888396,3575888435,39
2,1122,37731,3575888396,3575888436,40
2,1122,37732,3575888396,3575888437,41
2,1122,37733,3575888396,3575888437,41
2,1122,37734,3575888396,3575888438,42
2,1122,37735,3575888396,3575888439,43
2,1122,37736,3575888396,3575888439,43
2,1122,37737,3575888396,3575888440,44
2,1122,37738,3575888396,3575888440,44
2,1122,37739,3575888396,3575888441,45
2,1122,37740,3575888396,3575888442,46
2,1122,37741,3575888396,3575888444,48
2,1122,37742,3575888396,3575888445,49
2,1122,37743,3575888396,3575888446,50
2,1123,37744,3575888458,3575888458,0
2,1123,37745,3575888458,3575888458,0
2,1123,37746,3575888458,3575888458,0
2,1123,37747,3575888458,3575888458,0
2,1123,37748,3575888458,3575888458,0
2,1123,37749,3575888458,3575888458,0
2,1123,37750,3575888458,3575888458,0
2,1123,37751,3575888458,3575888458,0
2,1123,37752,3575888458,3575888458,0
2,1123,37753,3575888458,3575888458,0
2,1123,37754,3575888458,3575888458,0
2,1123,37755,3575888458,3575888458,0
2,1123,37756,3575888458,3575888458,0
2,1123,37757,3575888458,3575888459,1
2,1123,37758,3575888458,3575888460,2
2,1123,37759,3575888458,3575888460,2
2,1123,37760,3575888458,3575888463,5
2,1123,37761,3575888458,3575888464,6
2,1123,37762,3575888458,3575888465,7
2,1123,37763,3575888458,3575888467,9
2,1123,37764,3575888458,3575888468,10
2,1123,37765,3575888458,3575888469,11
2,1123,37766,3575888458,3575888476,18
2,1123,37767,3575888458,3575888478,20
2,1123,37768,3575888458,3575888478,20
2,1123,37769,3575888458,3575888479,21
2,1123,37770,3575888458,3575888481,23
2,1123,37771,3575888458,3575888482,24
2,1123,37772,3575888458,3575888483,25
2,1123,37773,3575888458,3575888484,26
2,1123,37774,3575888458,3575888485,27
2,1123,37775,3575888458,3575888486,28
2,1123,37776,3575888458,3575888486,28
2,1123,37777,3575888458,3575888486,28
2,1123,37778,3575888458,3575888487,29
2,1123,37779,3575888458,3575888487,29
2,1123,37780,3575888458,3575888488,30
2,1123,37781,3575888458,3575888490,32
2,1123,37782,3575888458,3575888491,33
2,1123,37783,3575888458,3575888491,33
2,1123,37784,3575888458,3575888491,33
2,1123,37785,3575888458,3575888492,34
2,1123,37786,3575888458,3575888492,34
2,1123,37787,3575888458,3575888493,35
2,1123,37788,3575888458,3575888493,35
2,1123,37789,3575888458,3575888494,36
2,1123,37790,3575888458,3575888494,36
2,1123,37791,3575888458,3575888495,37
2,1123,37792,3575888458,3575888496,38
2,1123,37793,3575888458,3575888496,38
2,1123,37794,3575888458,3575888497,39
2,1123,37795,3575888458,3575888497,39
2,1123,37796,3575888458,3575888498,40
2,1123,37797,3575888458,3575888499,41
2,1123,37798,3575888458,3575888499,41
2,1123,37799,3575888458,3575888500,42
2,1123,37800,3575888458,3575888500,42
2,1123,37801,3575888458,3575888501,43
2,1123,37802,3575888458,3575888504,46
2,1123,37803,3575888458,3575888504,46
2,1123,37804,3575888458,3575888504,46
2,1123,37805,3575888458,3575888506,48
2,1123,37806,3575888458,3575888506,48
2,1123,37807,3575888458,3575888506,48
2,1123,37808,3575888458,3575888506,48
2,1123,37809,3575888458,3575888507,49
2,1123,37810,3575888458,3575888507,49
2,1123,37811,3575888458,3575888507,49
2,1123,37812,3575888458,3575888508,50
2,1124,37813,3575888524,3575888524,0
2,1124,37814,3575888524,3575888524,0
2,1124,37815,3575888524,3575888524,0
2,1124,37816,3575888524,3575888524,0
2,1124,37817,3575888524,3575888524,0
2,1124,37818,3575888524,3575888524,0
2,1124,37819,3575888524,3575888524,0
2,1124,37820,3575888524,3575888524,0
2,1124,37821,3575888524,3575888524,0
2,1124,37822,3575888524,3575888524,0
2,1124,37823,3575888524,3575888524,0
2,1124,37824,3575888524,3575888524,0
2,1124,37825,3575888524,3575888524,0
2,1124,37826,3575888524,3575888524,0
2,1124,37827,3575888524,3575888524,0
2,1124,37828,3575888524,3575888524,0
2,1124,37829,3575888524,3575888524,0
2,1124,37830,3575888524,3575888524,0
2,1124,37831,3575888524,3575888524,0
2,1124,37832,3575888524,3575888524,0
2,1124,37833,3575888524,3575888524,0
2,1124,37834,3575888524,3575888524,0
2,1124,37835,3575888524,3575888524,0
2,1124,37836,3575888524,3575888524,0
2,1124,37837,3575888524,3575888524,0
2,1124,37838,3575888524,3575888524,0
2,1124,37839,3575888524,3575888524,0
2,1124,37840,3575888524,3575888524,0
2,1124,37841,3575888524,3575888524,0
2,1124,37842,3575888524,3575888525,1
2,1124,37843,3575888524,3575888526,2
2,1124,37844,3575888524,3575888526,2
2,1124,37845,3575888524,3575888526,2
2,1124,37846,3575888524,3575888527,3
2,1124,37847,3575888524,3575888527,3
2,1124,37848,3575888524,3575888528,4
2,1124,37849,3575888524,3575888529,5
2,1124,37850,3575888524,3575888530,6
2,1124,37851,3575888524,3575888530,6
2,1124,37852,3575888524,3575888530,6
2,1124,37853,3575888524,3575888530,6
2,1124,37854,3575888524,3575888531,7
2,1124,37855,3575888524,3575888531,7
2,1124,37856,3575888524,3575888532,8
2,1124,37857,3575888524,3575888533,9
2,1124,37858,3575888524,3575888533,9
2,1124,37859,3575888524,3575888533,9
2,1124,37860,3575888524,3575888533,9
2,1124,37861,3575888524,3575888534,10
2,1124,37862,3575888524,3575888535,11
2,1124,37863,3575888524,3575888535,11
2,1124,37864,3575888524,3575888536,12
2,1124,37865,3575888524,3575888537,13
2,1124,37866,3575888524,3575888538,14
2,1124,37867,3575888524,3575888539,15
2,1124,37868,3575888524,3575888539,15
2,1124,37869,3575888524,3575888539,15
2,1124,37870,3575888524,3575888539,15
2,1124,37871,3575888524,3575888541,17
2,1124,37872,3575888524,3575888543,19
2,1124,37873,3575888524,3575888544,20
2,1124,37874,3575888524,3575888544,20
2,1124,37875,3575888524,3575888544,20
2,1124,37876,3575888524,3575888545,21
2,1124,37877,3575888524,3575888545,21
2,1124,37878,3575888524,3575888546,22
2,1124,37879,3575888524,3575888546,22
2,1124,37880,3575888524,3575888547,23
2,1124,37881,3575888524,3575888548,24
2,1124,37882,3575888524,3575888549,25
2,1124,37883,3575888524,3575888551,27
2,1124,37884,3575888524,3575888551,27
2,1124,37885,3575888524,3575888553,29
2,1124,37886,3575888524,3575888554,30
2,1124,37887,3575888524,3575888556,32
2,1124,37888,3575888524,3575888557,33
2,1124,37889,3575888524,3575888558,34
2,1124,37890,3575888524,3575888559,35
2,1124,37891,3575888524,3575888560,36
2,1124,37892,3575888524,3575888560,36
2,1124,37893,3575888524,3575888561,37
2,1124,37894,3575888524,3575888561,37
2,1124,37895,3575888524,3575888561,37
2,1124,37896,3575888524,3575888564,40
2,1124,37897,3575888524,3575888564,40
2,1124,37898,3575888524,3575888565,41
2,1124,37899,3575888524,3575888566,42
2,1124,37900,3575888524,3575888566,42
2,1124,37901,3575888524,3575888567,43
2,1124,37902,3575888524,3575888568,44
2,1124,37903,3575888524,3575888568,44
2,1124,37904,3575888524,3575888569,45
2,1124,37905,3575888524,3575888569,45
2,1124,37906,3575888524,3575888569,45
2,1124,37907,3575888524,3575888570,46
2,1124,37908,3575888524,3575888571,47
2,1124,37909,3575888524,3575888572,48
2,1124,37910,3575888524,3575888572,48
2,1124,37911,3575888524,3575888573,49
2,1124,37912,3575888524,3575888573,49
2,1125,37913,3575888588,3575888588,0
2,1125,37914,3575888588,3575888588,0
2,1125,37915,3575888588,3575888588,0
2,1125,37916,3575888588,3575888588,0
2,1125,37917,3575888588,3575888588,0
2,1125,37918,3575888588,3575888588,0
2,1125,37919,3575888588,3575888588,0
2,1125,37920,3575888588,3575888588,0
2,1125,37921,3575888588,3575888588,0
2,1125,37922,3575888588,3575888588,0
2,1125,37923,3575888588,3575888588,0
2,1125,37924,3575888588,3575888588,0
2,1125,37925,3575888588,3575888588,0
2,1125,37926,3575888588,3575888588,0
2,1125,37927,3575888588,3575888588,0
2,1125,37928,3575888588,3575888588,0
2,1125,37929,3575888588,3575888588,0
2,1125,37930,3575888588,3575888588,0
2,1125,37931,3575888588,3575888588,0
2,1125,37932,3575888588,3575888588,0
2,1125,37933,3575888588,3575888588,0
2,1125,37934,3575888588,3575888591,3
2,1125,37935,3575888588,3575888591,3
2,1125,37936,3575888588,3575888591,3
2,1125,37937,3575888588,3575888592,4
2,1125,37938,3575888588,3575888593,5
2,1125,37939,3575888588,3575888593,5
2,1125,37940,3575888588,3575888594,6
2,1125,37941,3575888588,3575888595,7
2,1125,37942,3575888588,3575888598,10
2,1125,37943,3575888588,3575888598,10
2,1125,37944,3575888588,3575888598,10
2,1125,37945,3575888588,3575888599,11
2,1125,37946,3575888588,3575888600,12
2,1125,37947,3575888588,3575888601,13
2,1125,37948,3575888588,3575888602,14
2,1125,37949,3575888588,3575888603,15
2,1125,37950,3575888588,3575888603,15
2,1125,37951,3575888588,3575888604,16
2,1125,37952,3575888588,3575888604,16
2,1125,37953,3575888588,3575888607,19
2,1125,37954,3575888588,3575888607,19
2,1125,37955,3575888588,3575888610,22
2,1125,37956,3575888588,3575888611,23
2,1125,37957,3575888588,3575888611,23
2,1125,37958,3575888588,3575888611,23
2,1125,37959,3575888588,3575888612,24
2,1125,37960,3575888588,3575888614,26
2,1125,37961,3575888588,3575888618,30
2,1125,37962,3575888588,3575888621,33
2,1125,37963,3575888588,3575888622,34
2,1125,37964,3575888588,3575888625,37
2,1125,37965,3575888588,3575888625,37
2,1125,37966,3575888588,3575888626,38
2,1125,37967,3575888588,3575888626,38
2,1125,37968,3575888588,3575888627,39
2,1125,37969,3575888588,3575888627,39
2,1125,37970,3575888588,3575888628,40
2,1125,37971,3575888588,3575888629,41
2,1125,37972,3575888588,3575888629,41
2,1125,37973,3575888588,3575888634,46
2,1125,37974,3575888588,3575888634,46
2,1125,37975,3575888588,3575888634,46
2,1125,37976,3575888588,3575888635,47
2,1125,37977,3575888588,3575888636,48
2,1125,37978,3575888588,3575888637,49
2,1125,37979,3575888588,3575888637,49
2,1125,37980,3575888588,3575888637,49
2,1125,37981,3575888588,3575888638,50
2,1126,37982,3575888653,3575888653,0
2,1126,37983,3575888653,3575888653,0
2,1126,37984,3575888653,3575888653,0
2,1126,37985,3575888653,3575888653,0
2,1126,37986,3575888653,3575888653,0
2,1126,37987,3575888653,3575888653,0
2,1126,37988,3575888653,3575888653,0
2,1126,37989,3575888653,3575888653,0
2,1126,37990,3575888653,3575888653,0
2,1126,37991,3575888653,3575888653,0
2,1126,37992,3575888653,3575888653,0
2,1126,37993,3575888653,3575888653,0
2,1126,37994,3575888653,3575888653,0
2,1126,37995,3575888653,3575888654,1
2,1126,37996,3575888653,3575888654,1
2,1126,37997,3575888653,3575888654,1
2,1126,37998,3575888653,3575888654,1
2,1126,37999,3575888653,3575888655,2
2,1126,38000,3575888653,3575888655,2
2,1126,38001,3575888653,3575888655,2
2,1126,38002,3575888653,3575888656,3
2,1126,38003,3575888653,3575888658,5
2,1126,38004,3575888653,3575888659,6
2,1126,38005,3575888653,3575888659,6
2,1126,38006,3575888653,3575888660,7
2,1126,38007,3575888653,3575888663,10
2,1126,38008,3575888653,3575888663,10
2,1126,38009,3575888653,3575888666,13
2,1126,38010,3575888653,3575888667,14
2,1126,38011,3575888653,3575888667,14
2,1126,38012,3575888653,3575888675,22
2,1126,38013,3575888653,3575888678,25
2,1126,38014,3575888653,3575888678,25
2,1126,38015,3575888653,3575888680,27
2,1126,38016,3575888653,3575888681,28
2,1126,38017,3575888653,3575888682,29
2,1126,38018,3575888653,3575888683,30
2,1126,38019,3575888653,3575888684,31
2,1126,38020,3575888653,3575888687,34
2,1126,38021,3575888653,3575888687,34
2,1126,38022,3575888653,3575888687,34
2,1126,38023,3575888653,3575888688,35
2,1126,38024,3575888653,3575888688,35
2,1126,38025,3575888653,3575888689,36
2,1126,38026,3575888653,3575888690,37
2,1126,38027,3575888653,3575888691,38
2,1126,38028,3575888653,3575888691,38
2,1126,38029,3575888653,3575888691,38
2,1126,38030,3575888653,3575888691,38
2,1126,38031,3575888653,3575888692,39
2,1126,38032,3575888653,3575888692,39
2,1126,38033,3575888653,3575888693,40
2,1126,38034,3575888653,3575888693,40
2,1126,38035,3575888653,3575888694,41
2,1126,38036,3575888653,3575888695,42
2,1126,38037,3575888653,3575888696,43
2,1126,38038,3575888653,3575888696,43
2,1126,38039,3575888653,3575888696,43
2,1126,38040,3575888653,3575888697,44
2,1126,38041,3575888653,3575888698,45
2,1126,38042,3575888653,3575888698,45
2,1126,38043,3575888653,3575888699,46
2,1126,38044,3575888653,3575888699,46
2,1126,38045,3575888653,3575888700,47
2,1126,38046,3575888653,3575888700,47
2,1126,38047,3575888653,3575888701,48
2,1126,38048,3575888653,3575888701,48
2,1126,38049,3575888653,3575888703,50
2,1127,38050,3575888716,3575888716,0
2,1127,38051,3575888716,3575888716,0
2,1127,38052,3575888716,3575888716,0
2,1127,38053,3575888716,3575888716,0
2,1127,38054,3575888716,3575888716,0
2,1127,38055,3575888716,3575888716,0
2,1127,38056,3575888716,3575888716,0
2,1127,38057,3575888716,3575888716,0
2,1127,38058,3575888716,3575888716,0
2,1127,38059,3575888716,3575888716,0
2,1127,38060,3575888716,3575888716,0
2,1127,38061,3575888716,3575888716,0
2,1127,38062,3575888716,3575888716,0
2,1127,38063,3575888716,3575888716,0
2,1127,38064,3575888716,3575888716,0
2,1127,38065,3575888716,3575888716,0
2,1127,38066,3575888716,3575888716,0
2,1127,38067,3575888716,3575888716,0
2,1127,38068,3575888716,3575888716,0
2,1127,38069,3575888716,3575888716,0
2,1127,38070,3575888716,3575888716,0
2,1127,38071,3575888716,3575888716,0
2,1127,38072,3575888716,3575888716,0
2,1127,38073,3575888716,3575888716,0
2,1127,38074,3575888716,3575888718,2
2,1127,38075,3575888716,3575888718,2
2,1127,38076,3575888716,3575888718,2
2,1127,38077,3575888716,3575888718,2
2,1127,38078,3575888716,3575888719,3
2,1127,38079,3575888716,3575888719,3
2,1127,38080,3575888716,3575888719,3
2,1127,38081,3575888716,3575888720,4
2,1127,38082,3575888716,3575888721,5
2,1127,38083,3575888716,3575888722,6
2,1127,38084,3575888716,3575888725,9
2,1127,38085,3575888716,3575888725,9
2,1127,38086,3575888716,3575888726,10
2,1127,38087,3575888716,3575888726,10
2,1127,38088,3575888716,3575888727,11
2,1127,38089,3575888716,3575888728,12
2,1127,38090,3575888716,3575888729,13
2,1127,38091,3575888716,3575888729,13
2,1127,38092,3575888716,3575888730,14
2,1127,38093,3575888716,3575888731,15
2,1127,38094,3575888716,3575888731,15
2,1127,38095,3575888716,3575888732,16
2,1127,38096,3575888716,3575888733,17
2,1127,38097,3575888716,3575888733,17
2,1127,38098,3575888716,3575888734,18
2,1127,38099,3575888716,3575888734,18
2,1127,38100,3575888716,3575888734,18
2,1127,38101,3575888716,3575888735,19
2,1127,38102,3575888716,3575888736,20
2,1127,38103,3575888716,3575888738,22
2,1127,38104,3575888716,3575888739,23
2,1127,38105,3575888716,3575888739,23
2,1127,38106,3575888716,3575888739,23
2,1127,38107,3575888716,3575888739,23
2,1127,38108,3575888716,3575888740,24
2,1127,38109,3575888716,3575888742,26
2,1127,38110,3575888716,3575888744,28
2,1127,38111,3575888716,3575888744,28
2,1127,38112,3575888716,3575888745,29
2,1127,38113,3575888716,3575888745,29
2,1127,38114,3575888716,3575888746,30
2,1127,38115,3575888716,3575888746,30
2,1127,38116,3575888716,3575888746,30
2,1127,38117,3575888716,3575888747,31
2,1127,38118,3575888716,3575888748,32
2,1127,38119,3575888716,3575888748,32
2,1127,38120,3575888716,3575888751,35
2,1127,38121,3575888716,3575888751,35
2,1127,38122,3575888716,3575888752,36
2,1127,38123,3575888716,3575888753,37
2,1127,38124,3575888716,3575888753,37
2,1127,38125,3575888716,3575888754,38
2,1127,38126,3575888716,3575888756,40
2,1127,38127,3575888716,3575888756,40
2,1127,38128,3575888716,3575888757,41
2,1127,38129,3575888716,3575888758,42
2,1127,38130,3575888716,3575888759,43
2,1127,38131,3575888716,3575888759,43
2,1127,38132,3575888716,3575888759,43
2,1127,38133,3575888716,3575888760,44
2,1127,38134,3575888716,3575888761,45
2,1127,38135,3575888716,3575888761,45
2,1127,38136,3575888716,3575888762,46
2,1127,38137,3575888716,3575888764,48
2,1127,38138,3575888716,3575888765,49
2,1127,38139,3575888716,3575888765,49
2,1127,38140,3575888716,3575888766,50
2,1128,38141,3575888782,3575888782,0
2,1128,38142,3575888782,3575888782,0
2,1128,38143,3575888782,3575888782,0
2,1128,38144,3575888782,3575888782,0
2,1128,38145,3575888782,3575888782,0
2,1128,38146,3575888782,3575888782,0
2,1128,38147,3575888782,3575888782,0
2,1128,38148,3575888782,3575888782,0
2,1128,38149,3575888782,3575888782,0
2,1128,38150,3575888782,3575888782,0
2,1128,38151,3575888782,3575888782,0
2,1128,38152,3575888782,3575888782,0
2,1128,38153,3575888782,3575888782,0
2,1128,38154,3575888782,3575888782,0
2,1128,38155,3575888782,3575888782,0
2,1128,38156,3575888782,3575888782,0
2,1128,38157,3575888782,3575888782,0
2,1128,38158,3575888782,3575888782,0
2,1128,38159,3575888782,3575888782,0
2,1128,38160,3575888782,3575888782,0
2,1128,38161,3575888782,3575888782,0
2,1128,38162,3575888782,3575888782,0
2,1128,38163,3575888782,3575888782,0
2,1128,38164,3575888782,3575888782,0
2,1128,38165,3575888782,3575888782,0
2,1128,38166,3575888782,3575888782,0
2,1128,38167,3575888782,3575888784,2
2,1128,38168,3575888782,3575888784,2
2,1128,38169,3575888782,3575888784,2
2,1128,38170,3575888782,3575888785,3
2,1128,38171,3575888782,3575888785,3
2,1128,38172,3575888782,3575888785,3
2,1128,38173,3575888782,3575888787,5
2,1128,38174,3575888782,3575888787,5
2,1128,38175,3575888782,3575888788,6
2,1128,38176,3575888782,3575888788,6
2,1128,38177,3575888782,3575888790,8
2,1128,38178,3575888782,3575888791,9
2,1128,38179,3575888782,3575888791,9
2,1128,38180,3575888782,3575888792,10
2,1128,38181,3575888782,3575888793,11
2,1128,38182,3575888782,3575888793,11
2,1128,38183,3575888782,3575888794,12
2,1128,38184,3575888782,3575888794,12
2,1128,38185,3575888782,3575888795,13
2,1128,38186,3575888782,3575888798,16
2,1128,38187,3575888782,3575888798,16
2,1128,38188,3575888782,3575888798,16
2,1128,38189,3575888782,3575888800,18
2,1128,38190,3575888782,3575888800,18
2,1128,38191,3575888782,3575888801,19
2,1128,38192,3575888782,3575888803,21
2,1128,38193,3575888782,3575888803,21
2,1128,38194,3575888782,3575888804,22
2,1128,38195,3575888782,3575888804,22
2,1128,38196,3575888782,3575888805,23
2,1128,38197,3575888782,3575888806,24
2,1128,38198,3575888782,3575888808,26
2,1128,38199,3575888782,3575888808,26
2,1128,38200,3575888782,3575888811,29
2,1128,38201,3575888782,3575888811,29
2,1128,38202,3575888782,3575888812,30
2,1128,38203,3575888782,3575888812,30
2,1128,38204,3575888782,3575888814,32
2,1128,38205,3575888782,3575888819,37
2,1128,38206,3575888782,3575888820,38
2,1128,38207,3575888782,3575888822,40
2,1128,38208,3575888782,3575888825,43
2,1128,38209,3575888782,3575888825,43
2,1128,38210,3575888782,3575888825,43
2,1128,38211,3575888782,3575888827,45
2,1128,38212,3575888782,3575888828,46
2,1128,38213,3575888782,3575888828,46
2,1128,38214,3575888782,3575888828,46
2,1128,38215,3575888782,3575888828,46
2,1128,38216,3575888782,3575888829,47
2,1128,38217,3575888782,3575888829,47
2,1129,38218,3575888844,3575888844,0
2,1129,38219,3575888844,3575888844,0
2,1129,38220,3575888844,3575888844,0
2,1129,38221,3575888844,3575888844,0
2,1129,38222,3575888844,3575888844,0
2,1129,38223,3575888844,3575888844,0
2,1129,38224,3575888844,3575888844,0
2,1129,38225,3575888844,3575888844,0
2,1129,38226,3575888844,3575888844,0
2,1129,38227,3575888844,3575888844,0
2,1129,38228,3575888844,3575888844,0
2,1129,38229,3575888844,3575888844,0
2,1129,38230,3575888844,3575888844,0
2,1129,38231,3575888844,3575888844,0
2,1129,38232,3575888844,3575888845,1
2,1129,38233,3575888844,3575888845,1
2,1129,38234,3575888844,3575888848,4
2,1129,38235,3575888844,3575888849,5
2,1129,38236,3575888844,3575888849,5
2,1129,38237,3575888844,3575888851,7
2,1129,38238,3575888844,3575888853,9
2,1129,38239,3575888844,3575888854,10
2,1129,38240,3575888844,3575888854,10
2,1129,38241,3575888844,3575888854,10
2,1129,38242,3575888844,3575888854,10
2,1129,38243,3575888844,3575888855,11
2,1129,38244,3575888844,3575888855,11
2,1129,38245,3575888844,3575888856,12
2,1129,38246,3575888844,3575888856,12
2,1129,38247,3575888844,3575888857,13
2,1129,38248,3575888844,3575888858,14
2,1129,38249,3575888844,3575888859,15
2,1129,38250,3575888844,3575888859,15
2,1129,38251,3575888844,3575888860,16
2,1129,38252,3575888844,3575888863,19
2,1129,38253,3575888844,3575888864,20
2,1129,38254,3575888844,3575888866,22
2,1129,38255,3575888844,3575888866,22
2,1129,38256,3575888844,3575888867,23
2,1129,38257,3575888844,3575888868,24
2,1129,38258,3575888844,3575888875,31
2,1129,38259,3575888844,3575888877,33
2,1129,38260,3575888844,3575888878,34
2,1129,38261,3575888844,3575888880,36
2,1129,38262,3575888844,3575888881,37
2,1129,38263,3575888844,3575888882,38
2,1129,38264,3575888844,3575888884,40
2,1129,38265,3575888844,3575888884,40
2,1129,38266,3575888844,3575888885,41
2,1129,38267,3575888844,3575888886,42
2,1129,38268,3575888844,3575888886,42
2,1129,38269,3575888844,3575888886,42
2,1129,38270,3575888844,3575888887,43
2,1129,38271,3575888844,3575888887,43
2,1129,38272,3575888844,3575888888,44
2,1129,38273,3575888844,3575888889,45
2,1129,38274,3575888844,3575888890,46
2,1129,38275,3575888844,3575888890,46
2,1129,38276,3575888844,3575888891,47
2,1129,38277,3575888844,3575888891,47
2,1129,38278,3575888844,3575888892,48
2,1129,38279,3575888844,3575888892,48
2,1129,38280,3575888844,3575888893,49
2,1129,38281,3575888844,3575888893,49
2,1129,38282,3575888844,3575888894,50
2,1130,38283,3575888908,3575888908,0
2,1130,38284,3575888908,3575888908,0
2,1130,38285,3575888908,3575888908,0
2,1130,38286,3575888908,3575888908,0
2,1130,38287,3575888908,3575888908,0
2,1130,38288,3575888908,3575888908,0
2,1130,38289,3575888908,3575888908,0
2,1130,38290,3575888908,3575888908,0
2,1130,38291,3575888908,3575888908,0
2,1130,38292,3575888908,3575888908,0
2,1130,38293,3575888908,3575888908,0
2,1130,38294,3575888908,3575888908,0
2,1130,38295,3575888908,3575888908,0
2,1130,38296,3575888908,3575888908,0
2,1130,38297,3575888908,3575888908,0
2,1130,38298,3575888908,3575888908,0
2,1130,38299,3575888908,3575888908,0
2,1130,38300,3575888908,3575888908,0
2,1130,38301,3575888908,3575888908,0
2,1130,38302,3575888908,3575888908,0
2,1130,38303,3575888908,3575888908,0
2,1130,38304,3575888908,3575888908,0
2,1130,38305,3575888908,3575888908,0
2,1130,38306,3575888908,3575888908,0
2,1130,38307,3575888908,3575888909,1
2,1130,38308,3575888908,3575888909,1
2,1130,38309,3575888908,3575888909,1
2,1130,38310,3575888908,3575888909,1
2,1130,38311,3575888908,3575888909,1
2,1130,38312,3575888908,3575888910,2
2,1130,38313,3575888908,3575888911,3
2,1130,38314,3575888908,3575888914,6
2,1130,38315,3575888908,3575888914,6
2,1130,38316,3575888908,3575888914,6
2,1130,38317,3575888908,3575888915,7
2,1130,38318,3575888908,3575888916,8
2,1130,38319,3575888908,3575888916,8
2,1130,38320,3575888908,3575888918,10
2,1130,38321,3575888908,3575888918,10
2,1130,38322,3575888908,3575888918,10
2,1130,38323,3575888908,3575888919,11
2,1130,38324,3575888908,3575888919,11
2,1130,38325,3575888908,3575888919,11
2,1130,38326,3575888908,3575888919,11
2,1130,38327,3575888908,3575888920,12
2,1130,38328,3575888908,3575888921,13
2,1130,38329,3575888908,3575888925,17
2,1130,38330,3575888908,3575888925,17
2,1130,38331,3575888908,3575888926,18
2,1130,38332,3575888908,3575888926,18
2,1130,38333,3575888908,3575888927,19
2,1130,38334,3575888908,3575888928,20
2,1130,38335,3575888908,3575888928,20
2,1130,38336,3575888908,3575888928,20
2,1130,38337,3575888908,3575888930,22
2,1130,38338,3575888908,3575888931,23
2,1130,38339,3575888908,3575888931,23
2,1130,38340,3575888908,3575888931,23
2,1130,38341,3575888908,3575888931,23
2,1130,38342,3575888908,3575888932,24
2,1130,38343,3575888908,3575888933,25
2,1130,38344,3575888908,3575888934,26
2,1130,38345,3575888908,3575888934,26
2,1130,38346,3575888908,3575888934,26
2,1130,38347,3575888908,3575888935,27
2,1130,38348,3575888908,3575888935,27
2,1130,38349,3575888908,3575888936,28
2,1130,38350,3575888908,3575888938,30
2,1130,38351,3575888908,3575888939,31
2,1130,38352,3575888908,3575888939,31
2,1130,38353,3575888908,3575888939,31
2,1130,38354,3575888908,3575888940,32
2,1130,38355,3575888908,3575888940,32
2,1130,38356,3575888908,3575888942,34
2,1130,38357,3575888908,3575888944,36
2,1130,38358,3575888908,3575888945,37
2,1130,38359,3575888908,3575888945,37
2,1130,38360,3575888908,3575888945,37
2,1130,38361,3575888908,3575888946,38
2,1130,38362,3575888908,3575888946,38
2,1130,38363,3575888908,3575888946,38
2,1130,38364,3575888908,3575888947,39
2,1130,38365,3575888908,3575888949,41
2,1130,38366,3575888908,3575888949,41
2,1130,38367,3575888908,3575888949,41
2,1130,38368,3575888908,3575888951,43
2,1130,38369,3575888908,3575888952,44
2,1130,38370,3575888908,3575888953,45
2,1130,38371,3575888908,3575888954,46
2,1130,38372,3575888908,3575888954,46
2,1130,38373,3575888908,3575888956,48
2,1130,38374,3575888908,3575888956,48
2,1130,38375,3575888908,3575888957,49
2,1131,38376,3575888972,3575888972,0
2,1131,38377,3575888972,3575888972,0
2,1131,38378,3575888972,3575888972,0
2,1131,38379,3575888972,3575888972,0
2,1131,38380,3575888972,3575888972,0
2,1131,38381,3575888972,3575888972,0
2,1131,38382,3575888972,3575888972,0
2,1131,38383,3575888972,3575888972,0
2,1131,38384,3575888972,3575888972,0
2,1131,38385,3575888972,3575888972,0
2,1131,38386,3575888972,3575888972,0
2,1131,38387,3575888972,3575888972,0
2,1131,38388,3575888972,3575888972,0
2,1131,38389,3575888972,3575888972,0
2,1131,38390,3575888972,3575888972,0
2,1131,38391,3575888972,3575888972,0
2,1131,38392,3575888972,3575888972,0
2,1131,38393,3575888972,3575888972,0
2,1131,38394,3575888972,3575888972,0
2,1131,38395,3575888972,3575888972,0
2,1131,38396,3575888972,3575888972,0
2,1131,38397,3575888972,3575888972,0
2,1131,38398,3575888972,3575888972,0
2,1131,38399,3575888972,3575888972,0
2,1131,38400,3575888972,3575888975,3
2,1131,38401,3575888972,3575888975,3
2,1131,38402,3575888972,3575888976,4
2,1131,38403,3575888972,3575888978,6
2,1131,38404,3575888972,3575888978,6
2,1131,38405,3575888972,3575888978,6
2,1131,38406,3575888972,3575888979,7
2,1131,38407,3575888972,3575888980,8
2,1131,38408,3575888972,3575888980,8
2,1131,38409,3575888972,3575888981,9
2,1131,38410,3575888972,3575888981,9
2,1131,38411,3575888972,3575888982,10
2,1131,38412,3575888972,3575888982,10
2,1131,38413,3575888972,3575888983,11
2,1131,38414,3575888972,3575888984,12
2,1131,38415,3575888972,3575888985,13
2,1131,38416,3575888972,3575888985,13
2,1131,38417,3575888972,3575888985,13
2,1131,38418,3575888972,3575888985,13
2,1131,38419,3575888972,3575888987,15
2,1131,38420,3575888972,3575888988,16
2,1131,38421,3575888972,3575888988,16
2,1131,38422,3575888972,3575888988,16
2,1131,38423,3575888972,3575888988,16
2,1131,38424,3575888972,3575888990,18
2,1131,38425,3575888972,3575888991,19
2,1131,38426,3575888972,3575888991,19
2,1131,38427,3575888972,3575888992,20
2,1131,38428,3575888972,3575888993,21
2,1131,38429,3575888972,3575888993,21
2,1131,38430,3575888972,3575888993,21
2,1131,38431,3575888972,3575888994,22
2,1131,38432,3575888972,3575888996,24
2,1131,38433,3575888972,3575888997,25
2,1131,38434,3575888972,3575888998,26
2,1131,38435,3575888972,3575888998,26
2,1131,38436,3575888972,3575888999,27
2,1131,38437,3575888972,3575889000,28
2,1131,38438,3575888972,3575889003,31
2,1131,38439,3575888972,3575889003,31
2,1131,38440,3575888972,3575889004,32
2,1131,38441,3575888972,3575889004,32
2,1131,38442,3575888972,3575889004,32
2,1131,38443,3575888972,3575889006,34
2,1131,38444,3575888972,3575889007,35
2,1131,38445,3575888972,3575889008,36
2,1131,38446,3575888972,3575889009,37
2,1131,38447,3575888972,3575889010,38
2,1131,38448,3575888972,3575889011,39
2,1131,38449,3575888972,3575889012,40
2,1131,38450,3575888972,3575889013,41
2,1131,38451,3575888972,3575889014,42
2,1131,38452,3575888972,3575889019,47
2,1131,38453,3575888972,3575889021,49
2,1132,38454,3575889034,3575889034,0
2,1132,38455,3575889034,3575889034,0
2,1132,38456,3575889034,3575889034,0
2,1132,38457,3575889034,3575889034,0
2,1132,38458,3575889034,3575889034,0
2,1132,38459,3575889034,3575889034,0
2,1132,38460,3575889034,3575889034,0
2,1132,38461,3575889034,3575889034,0
2,1132,38462,3575889034,3575889034,0
2,1132,38463,3575889034,3575889034,0
2,1132,38464,3575889034,3575889034,0
2,1132,38465,3575889034,3575889034,0
2,1132,38466,3575889034,3575889034,0
2,1132,38467,3575889034,3575889035,1
2,1132,38468,3575889034,3575889035,1
2,1132,38469,3575889034,3575889036,2
2,1132,38470,3575889034,3575889037,3
2,1132,38471,3575889034,3575889037,3
2,1132,38472,3575889034,3575889037,3
2,1132,38473,3575889034,3575889038,4
2,1132,38474,3575889034,3575889039,5
2,1132,38475,3575889034,3575889039,5
2,1132,38476,3575889034,3575889040,6
2,1132,38477,3575889034,3575889042,8
2,1132,38478,3575889034,3575889042,8
2,1132,38479,3575889034,3575889042,8
2,1132,38480,3575889034,3575889045,11
2,1132,38481,3575889034,3575889046,12
2,1132,38482,3575889034,3575889048,14
2,1132,38483,3575889034,3575889049,15
2,1132,38484,3575889034,3575889049,15
2,1132,38485,3575889034,3575889051,17
2,1132,38486,3575889034,3575889053,19
2,1132,38487,3575889034,3575889054,20
2,1132,38488,3575889034,3575889055,21
2,1132,38489,3575889034,3575889055,21
2,1132,38490,3575889034,3575889055,21
2,1132,38491,3575889034,3575889055,21
2,1132,38492,3575889034,3575889056,22
2,1132,38493,3575889034,3575889056,22
2,1132,38494,3575889034,3575889056,22
2,1132,38495,3575889034,3575889057,23
2,1132,38496,3575889034,3575889058,24
2,1132,38497,3575889034,3575889060,26
2,1132,38498,3575889034,3575889060,26
2,1132,38499,3575889034,3575889062,28
2,1132,38500,3575889034,3575889064,30
2,1132,38501,3575889034,3575889066,32
2,1132,38502,3575889034,3575889066,32
2,1132,38503,3575889034,3575889067,33
2,1132,38504,3575889034,3575889068,34
2,1132,38505,3575889034,3575889076,42
2,1132,38506,3575889034,3575889078,44
2,1132,38507,3575889034,3575889079,45
2,1132,38508,3575889034,3575889081,47
2,1132,38509,3575889034,3575889082,48
2,1132,38510,3575889034,3575889084,50
2,1133,38511,3575889098,3575889098,0
2,1133,38512,3575889098,3575889098,0
2,1133,38513,3575889098,3575889098,0
2,1133,38514,3575889098,3575889098,0
2,1133,38515,3575889098,3575889098,0
2,1133,38516,3575889098,3575889098,0
2,1133,38517,3575889098,3575889098,0
2,1133,38518,3575889098,3575889098,0
2,1133,38519,3575889098,3575889098,0
2,1133,38520,3575889098,3575889098,0
2,1133,38521,3575889098,3575889098,0
2,1133,38522,3575889098,3575889098,0
2,1133,38523,3575889098,3575889098,0
2,1133,38524,3575889098,3575889098,0
2,1133,38525,3575889098,3575889098,0
2,1133,38526,3575889098,3575889098,0
2,1133,38527,3575889098,3575889098,0
2,1133,38528,3575889098,3575889098,0
2,1133,38529,3575889098,3575889098,0
2,1133,38530,3575889098,3575889098,0
2,1133,38531,3575889098,3575889098,0
2,1133,38532,3575889098,3575889098,0
2,1133,38533,3575889098,3575889098,0
2,1133,38534,3575889098,3575889098,0
2,1133,38535,3575889098,3575889099,1
2,1133,38536,3575889098,3575889099,1
2,1133,38537,3575889098,3575889099,1
2,1133,38538,3575889098,3575889100,2
2,1133,38539,3575889098,3575889100,2
2,1133,38540,3575889098,3575889101,3
2,1133,38541,3575889098,3575889102,4
2,1133,38542,3575889098,3575889104,6
2,1133,38543,3575889098,3575889104,6
2,1133,38544,3575889098,3575889104,6
2,1133,38545,3575889098,3575889106,8
2,1133,38546,3575889098,3575889106,8
2,1133,38547,3575889098,3575889107,9
2,1133,38548,3575889098,3575889107,9
2,1133,38549,3575889098,3575889107,9
2,1133,38550,3575889098,3575889108,10
2,1133,38551,3575889098,3575889108,10
2,1133,38552,3575889098,3575889108,10
2,1133,38553,3575889098,3575889108,10
2,1133,38554,3575889098,3575889109,11
2,1133,38555,3575889098,3575889109,11
2,1133,38556,3575889098,3575889109,11
2,1133,38557,3575889098,3575889109,11
2,1133,38558,3575889098,3575889109,11
2,1133,38559,3575889098,3575889111,13
2,1133,38560,3575889098,3575889111,13
2,1133,38561,3575889098,3575889112,14
2,1133,38562,3575889098,3575889114,16
2,1133,38563,3575889098,3575889114,16
2,1133,38564,3575889098,3575889114,16
2,1133,38565,3575889098,3575889115,17
2,1133,38566,3575889098,3575889115,17
2,1133,38567,3575889098,3575889116,18
2,1133,38568,3575889098,3575889117,19
2,1133,38569,3575889098,3575889118,20
2,1133,38570,3575889098,3575889118,20
2,1133,38571,3575889098,3575889118,20
2,1133,38572,3575889098,3575889119,21
2,1133,38573,3575889098,3575889120,22
2,1133,38574,3575889098,3575889120,22
2,1133,38575,3575889098,3575889120,22
2,1133,38576,3575889098,3575889120,22
2,1133,38577,3575889098,3575889122,24
2,1133,38578,3575889098,3575889123,25
2,1133,38579,3575889098,3575889125,27
2,1133,38580,3575889098,3575889126,28
2,1133,38581,3575889098,3575889127,29
2,1133,38582,3575889098,3575889127,29
2,1133,38583,3575889098,3575889128,30
2,1133,38584,3575889098,3575889128,30
2,1133,38585,3575889098,3575889128,30
2,1133,38586,3575889098,3575889128,30
2,1133,38587,3575889098,3575889130,32
2,1133,38588,3575889098,3575889131,33
2,1133,38589,3575889098,3575889131,33
2,1133,38590,3575889098,3575889131,33
2,1133,38591,3575889098,3575889132,34
2,1133,38592,3575889098,3575889133,35
2,1133,38593,3575889098,3575889133,35
2,1133,38594,3575889098,3575889134,36
2,1133,38595,3575889098,3575889134,36
2,1133,38596,3575889098,3575889135,37
2,1133,38597,3575889098,3575889135,37
2,1133,38598,3575889098,3575889135,37
2,1133,38599,3575889098,3575889136,38
2,1133,38600,3575889098,3575889139,41
2,1133,38601,3575889098,3575889139,41
2,1133,38602,3575889098,3575889139,41
2,1133,38603,3575889098,3575889140,42
2,1133,38604,3575889098,3575889140,42
2,1133,38605,3575889098,3575889142,44
2,1133,38606,3575889098,3575889144,46
2,1133,38607,3575889098,3575889144,46
2,1133,38608,3575889098,3575889145,47
2,1133,38609,3575889098,3575889145,47
2,1133,38610,3575889098,3575889146,48
2,1133,38611,3575889098,3575889146,48
2,1133,38612,3575889098,3575889147,49
2,1133,38613,3575889098,3575889147,49
2,1134,38614,3575889162,3575889162,0
2,1134,38615,3575889162,3575889162,0
2,1134,38616,3575889162,3575889162,0
2,1134,38617,3575889162,3575889162,0
2,1134,38618,3575889162,3575889162,0
2,1134,38619,3575889162,3575889162,0
2,1134,38620,3575889162,3575889162,0
2,1134,38621,3575889162,3575889162,0
2,1134,38622,3575889162,3575889162,0
2,1134,38623,3575889162,3575889162,0
2,1134,38624,3575889162,3575889162,0
2,1134,38625,3575889162,3575889162,0
2,1134,38626,3575889162,3575889162,0
2,1134,38627,3575889162,3575889162,0
2,1134,38628,3575889162,3575889162,0
2,1134,38629,3575889162,3575889162,0
2,1134,38630,3575889162,3575889162,0
2,1134,38631,3575889162,3575889162,0
2,1134,38632,3575889162,3575889162,0
2,1134,38633,3575889162,3575889162,0
2,1134,38634,3575889162,3575889162,0
2,1134,38635,3575889162,3575889164,2
2,1134,38636,3575889162,3575889165,3
2,1134,38637,3575889162,3575889166,4
2,1134,38638,3575889162,3575889167,5
2,1134,38639,3575889162,3575889168,6
2,1134,38640,3575889162,3575889169,7
2,1134,38641,3575889162,3575889169,7
2,1134,38642,3575889162,3575889170,8
2,1134,38643,3575889162,3575889170,8
2,1134,38644,3575889162,3575889170,8
2,1134,38645,3575889162,3575889170,8
2,1134,38646,3575889162,3575889171,9
2,1134,38647,3575889162,3575889172,10
2,1134,38648,3575889162,3575889172,10
2,1134,38649,3575889162,3575889176,14
2,1134,38650,3575889162,3575889176,14
2,1134,38651,3575889162,3575889177,15
2,1134,38652,3575889162,3575889177,15
2,1134,38653,3575889162,3575889179,17
2,1134,38654,3575889162,3575889179,17
2,1134,38655,3575889162,3575889180,18
2,1134,38656,3575889162,3575889180,18
2,1134,38657,3575889162,3575889181,19
2,1134,38658,3575889162,3575889181,19
2,1134,38659,3575889162,3575889182,20
2,1134,38660,3575889162,3575889182,20
2,1134,38661,3575889162,3575889183,21
2,1134,38662,3575889162,3575889184,22
2,1134,38663,3575889162,3575889185,23
2,1134,38664,3575889162,3575889185,23
2,1134,38665,3575889162,3575889185,23
2,1134,38666,3575889162,3575889186,24
2,1134,38667,3575889162,3575889188,26
2,1134,38668,3575889162,3575889188,26
2,1134,38669,3575889162,3575889188,26
2,1134,38670,3575889162,3575889188,26
2,1134,38671,3575889162,3575889188,26
2,1134,38672,3575889162,3575889188,26
2,1134,38673,3575889162,3575889190,28
2,1134,38674,3575889162,3575889191,29
2,1134,38675,3575889162,3575889192,30
2,1134,38676,3575889162,3575889192,30
2,1134,38677,3575889162,3575889193,31
2,1134,38678,3575889162,3575889193,31
2,1134,38679,3575889162,3575889194,32
2,1134,38680,3575889162,3575889195,33
2,1134,38681,3575889162,3575889195,33
2,1134,38682,3575889162,3575889195,33
2,1134,38683,3575889162,3575889198,36
2,1134,38684,3575889162,3575889198,36
2,1134,38685,3575889162,3575889199,37
2,1134,38686,3575889162,3575889200,38
2,1134,38687,3575889162,3575889201,39
2,1134,38688,3575889162,3575889201,39
2,1134,38689,3575889162,3575889203,41
2,1134,38690,3575889162,3575889203,41
2,1134,38691,3575889162,3575889203,41
2,1134,38692,3575889162,3575889204,42
2,1134,38693,3575889162,3575889204,42
2,1134,38694,3575889162,3575889205,43
2,1134,38695,3575889162,3575889206,44
2,1134,38696,3575889162,3575889207,45
2,1134,38697,3575889162,3575889208,46
2,1134,38698,3575889162,3575889209,47
2,1134,38699,3575889162,3575889211,49
2,1135,38700,3575889226,3575889226,0
2,1135,38701,3575889226,3575889227,1
2,1135,38702,3575889226,3575889227,1
2,1135,38703,3575889226,3575889227,1
2,1135,38704,3575889226,3575889227,1
2,1135,38705,3575889226,3575889227,1
2,1135,38706,3575889226,3575889227,1
2,1135,38707,3575889226,3575889227,1
2,1135,38708,3575889226,3575889227,1
2,1135,38709,3575889226,3575889227,1
2,1135,38710,3575889226,3575889227,1
2,1135,38711,3575889226,3575889228,2
2,1135,38712,3575889226,3575889228,2
2,1135,38713,3575889226,3575889228,2
2,1135,38714,3575889226,3575889229,3
2,1135,38715,3575889226,3575889229,3
2,1135,38716,3575889226,3575889229,3
2,1135,38717,3575889226,3575889230,4
2,1135,38718,3575889226,3575889234,8
2,1135,38719,3575889226,3575889235,9
2,1135,38720,3575889226,3575889236,10
2,1135,38721,3575889226,3575889236,10
2,1135,38722,3575889226,3575889237,11
2,1135,38723,3575889226,3575889237,11
2,1135,38724,3575889226,3575889238,12
2,1135,38725,3575889226,3575889239,13
2,1135,38726,3575889226,3575889239,13
2,1135,38727,3575889226,3575889239,13
2,1135,38728,3575889226,3575889239,13
2,1135,38729,3575889226,3575889242,16
2,1135,38730,3575889226,3575889243,17
2,1135,38731,3575889226,3575889243,17
2,1135,38732,3575889226,3575889245,19
2,1135,38733,3575889226,3575889246,20
2,1135,38734,3575889226,3575889248,22
2,1135,38735,3575889226,3575889249,23
2,1135,38736,3575889226,3575889249,23
2,1135,38737,3575889226,3575889251,25
2,1135,38738,3575889226,3575889253,27
2,1135,38739,3575889226,3575889253,27
2,1135,38740,3575889226,3575889254,28
2,1135,38741,3575889226,3575889255,29
2,1135,38742,3575889226,3575889255,29
2,1135,38743,3575889226,3575889255,29
2,1135,38744,3575889226,3575889256,30
2,1135,38745,3575889226,3575889256,30
2,1135,38746,3575889226,3575889258,32
2,1135,38747,3575889226,3575889260,34
2,1135,38748,3575889226,3575889260,34
2,1135,38749,3575889226,3575889260,34
2,1135,38750,3575889226,3575889260,34
2,1135,38751,3575889226,3575889263,37
2,1135,38752,3575889226,3575889266,40
2,1135,38753,3575889226,3575889266,40
2,1135,38754,3575889226,3575889267,41
2,1135,38755,3575889226,3575889268,42
2,1136,38756,3575889289,3575889289,0
2,1136,38757,3575889289,3575889289,0
2,1136,38758,3575889289,3575889289,0
2,1136,38759,3575889289,3575889289,0
2,1136,38760,3575889289,3575889289,0
2,1136,38761,3575889289,3575889289,0
2,1136,38762,3575889289,3575889289,0
2,1136,38763,3575889289,3575889289,0
2,1136,38764,3575889289,3575889289,0
2,1136,38765,3575889289,3575889289,0
2,1136,38766,3575889289,3575889289,0
2,1136,38767,3575889289,3575889289,0
2,1136,38768,3575889289,3575889289,0
2,1136,38769,3575889289,3575889289,0
2,1136,38770,3575889289,3575889289,0
2,1136,38771,3575889289,3575889289,0
2,1136,38772,3575889289,3575889290,1
2,1136,38773,3575889289,3575889291,2
2,1136,38774,3575889289,3575889291,2
2,1136,38775,3575889289,3575889292,3
2,1136,38776,3575889289,3575889292,3
2,1136,38777,3575889289,3575889292,3
2,1136,38778,3575889289,3575889293,4
2,1136,38779,3575889289,3575889293,4
2,1136,38780,3575889289,3575889293,4
2,1136,38781,3575889289,3575889295,6
2,1136,38782,3575889289,3575889295,6
2,1136,38783,3575889289,3575889296,7
2,1136,38784,3575889289,3575889296,7
2,1136,38785,3575889289,3575889297,8
2,1136,38786,3575889289,3575889298,9
2,1136,38787,3575889289,3575889298,9
2,1136,38788,3575889289,3575889298,9
2,1136,38789,3575889289,3575889299,10
2,1136,38790,3575889289,3575889299,10
2,1136,38791,3575889289,3575889300,11
2,1136,38792,3575889289,3575889300,11
2,1136,38793,3575889289,3575889301,12
2,1136,38794,3575889289,3575889302,13
2,1136,38795,3575889289,3575889303,14
2,1136,38796,3575889289,3575889304,15
2,1136,38797,3575889289,3575889304,15
2,1136,38798,3575889289,3575889306,17
2,1136,38799,3575889289,3575889306,17
2,1136,38800,3575889289,3575889307,18
2,1136,38801,3575889289,3575889307,18
2,1136,38802,3575889289,3575889307,18
2,1136,38803,3575889289,3575889307,18
2,1136,38804,3575889289,3575889308,19
2,1136,38805,3575889289,3575889308,19
2,1136,38806,3575889289,3575889309,20
2,1136,38807,3575889289,3575889309,20
2,1136,38808,3575889289,3575889309,20
2,1136,38809,3575889289,3575889309,20
2,1136,38810,3575889289,3575889310,21
2,1136,38811,3575889289,3575889310,21
2,1136,38812,3575889289,3575889311,22
2,1136,38813,3575889289,3575889311,22
2,1136,38814,3575889289,3575889311,22
2,1136,38815,3575889289,3575889314,25
2,1136,38816,3575889289,3575889314,25
2,1136,38817,3575889289,3575889314,25
2,1136,38818,3575889289,3575889315,26
2,1136,38819,3575889289,3575889315,26
2,1136,38820,3575889289,3575889316,27
2,1136,38821,3575889289,3575889317,28
2,1136,38822,3575889289,3575889318,29
2,1136,38823,3575889289,3575889318,29
2,1136,38824,3575889289,3575889319,30
2,1136,38825,3575889289,3575889319,30
2,1136,38826,3575889289,3575889320,31
2,1136,38827,3575889289,3575889320,31
2,1136,38828,3575889289,3575889320,31
2,1136,38829,3575889289,3575889320,31
2,1136,38830,3575889289,3575889322,33
2,1136,38831,3575889289,3575889323,34
2,1136,38832,3575889289,3575889325,36
2,1136,38833,3575889289,3575889325,36
2,1136,38834,3575889289,3575889326,37
2,1136,38835,3575889289,3575889326,37
2,1136,38836,3575889289,3575889328,39
2,1136,38837,3575889289,3575889328,39
2,1136,38838,3575889289,3575889328,39
2,1136,38839,3575889289,3575889328,39
2,1136,38840,3575889289,3575889330,41
2,1136,38841,3575889289,3575889330,41
2,1136,38842,3575889289,3575889331,42
2,1136,38843,3575889289,3575889331,42
2,1136,38844,3575889289,3575889332,43
2,1136,38845,3575889289,3575889332,43
2,1136,38846,3575889289,3575889333,44
2,1136,38847,3575889289,3575889333,44
2,1136,38848,3575889289,3575889334,45
2,1136,38849,3575889289,3575889335,46
2,1136,38850,3575889289,3575889335,46
2,1136,38851,3575889289,3575889335,46
2,1136,38852,3575889289,3575889336,47
2,1136,38853,3575889289,3575889336,47
2,1136,38854,3575889289,3575889337,48
2,1136,38855,3575889289,3575889339,50
2,1137,38856,3575889352,3575889352,0
2,1137,38857,3575889352,3575889352,0
2,1137,38858,3575889352,3575889352,0
2,1137,38859,3575889352,3575889352,0
2,1137,38860,3575889352,3575889352,0
2,1137,38861,3575889352,3575889352,0
2,1137,38862,3575889352,3575889352,0
2,1137,38863,3575889352,3575889352,0
2,1137,38864,3575889352,3575889352,0
2,1137,38865,3575889352,3575889352,0
2,1137,38866,3575889352,3575889352,0
2,1137,38867,3575889352,3575889352,0
2,1137,38868,3575889352,3575889352,0
2,1137,38869,3575889352,3575889352,0
2,1137,38870,3575889352,3575889352,0
2,1137,38871,3575889352,3575889352,0
2,1137,38872,3575889352,3575889352,0
2,1137,38873,3575889352,3575889352,0
2,1137,38874,3575889352,3575889352,0
2,1137,38875,3575889352,3575889353,1
2,1137,38876,3575889352,3575889353,1
2,1137,38877,3575889352,3575889353,1
2,1137,38878,3575889352,3575889354,2
2,1137,38879,3575889352,3575889354,2
2,1137,38880,3575889352,3575889355,3
2,1137,38881,3575889352,3575889357,5
2,1137,38882,3575889352,3575889357,5
2,1137,38883,3575889352,3575889359,7
2,1137,38884,3575889352,3575889359,7
2,1137,38885,3575889352,3575889359,7
2,1137,38886,3575889352,3575889360,8
2,1137,38887,3575889352,3575889360,8
2,1137,38888,3575889352,3575889360,8
2,1137,38889,3575889352,3575889361,9
2,1137,38890,3575889352,3575889362,10
2,1137,38891,3575889352,3575889362,10
2,1137,38892,3575889352,3575889364,12
2,1137,38893,3575889352,3575889365,13
2,1137,38894,3575889352,3575889366,14
2,1137,38895,3575889352,3575889366,14
2,1137,38896,3575889352,3575889367,15
2,1137,38897,3575889352,3575889367,15
2,1137,38898,3575889352,3575889368,16
2,1137,38899,3575889352,3575889368,16
2,1137,38900,3575889352,3575889368,16
2,1137,38901,3575889352,3575889370,18
2,1137,38902,3575889352,3575889370,18
2,1137,38903,3575889352,3575889370,18
2,1137,38904,3575889352,3575889370,18
2,1137,38905,3575889352,3575889371,19
2,1137,38906,3575889352,3575889372,20
2,1137,38907,3575889352,3575889373,21
2,1137,38908,3575889352,3575889375,23
2,1137,38909,3575889352,3575889375,23
2,1137,38910,3575889352,3575889375,23
2,1137,38911,3575889352,3575889377,25
2,1137,38912,3575889352,3575889377,25
2,1137,38913,3575889352,3575889378,26
2,1137,38914,3575889352,3575889379,27
2,1137,38915,3575889352,3575889379,27
2,1137,38916,3575889352,3575889379,27
2,1137,38917,3575889352,3575889380,28
2,1137,38918,3575889352,3575889381,29
2,1137,38919,3575889352,3575889381,29
2,1137,38920,3575889352,3575889382,30
2,1137,38921,3575889352,3575889383,31
2,1137,38922,3575889352,3575889383,31
2,1137,38923,3575889352,3575889384,32
2,1137,38924,3575889352,3575889384,32
2,1137,38925,3575889352,3575889385,33
2,1137,38926,3575889352,3575889386,34
2,1137,38927,3575889352,3575889386,34
2,1137,38928,3575889352,3575889388,36
2,1137,38929,3575889352,3575889388,36
2,1137,38930,3575889352,3575889388,36
2,1137,38931,3575889352,3575889388,36
2,1137,38932,3575889352,3575889388,36
2,1137,38933,3575889352,3575889389,37
2,1137,38934,3575889352,3575889391,39
2,1137,38935,3575889352,3575889392,40
2,1137,38936,3575889352,3575889392,40
2,1137,38937,3575889352,3575889393,41
2,1137,38938,3575889352,3575889394,42
2,1137,38939,3575889352,3575889395,43
2,1137,38940,3575889352,3575889396,44
2,1137,38941,3575889352,3575889398,46
2,1137,38942,3575889352,3575889399,47
2,1137,38943,3575889352,3575889399,47
2,1137,38944,3575889352,3575889400,48
2,1137,38945,3575889352,3575889402,50
2,1138,38946,3575889415,3575889415,0
2,1138,38947,3575889415,3575889415,0
2,1138,38948,3575889415,3575889415,0
2,1138,38949,3575889415,3575889415,0
2,1138,38950,3575889415,3575889415,0
2,1138,38951,3575889415,3575889415,0
2,1138,38952,3575889415,3575889415,0
2,1138,38953,3575889415,3575889415,0
2,1138,38954,3575889415,3575889415,0
2,1138,38955,3575889415,3575889415,0
2,1138,38956,3575889415,3575889415,0
2,1138,38957,3575889415,3575889415,0
2,1138,38958,3575889415,3575889415,0
2,1138,38959,3575889415,3575889421,6
2,1138,38960,3575889415,3575889423,8
2,1138,38961,3575889415,3575889423,8
2,1138,38962,3575889415,3575889424,9
2,1138,38963,3575889415,3575889426,11
2,1138,38964,3575889415,3575889426,11
2,1138,38965,3575889415,3575889426,11
2,1138,38966,3575889415,3575889427,12
2,1138,38967,3575889415,3575889428,13
2,1138,38968,3575889415,3575889428,13
2,1138,38969,3575889415,3575889428,13
2,1138,38970,3575889415,3575889429,14
2,1138,38971,3575889415,3575889429,14
2,1138,38972,3575889415,3575889430,15
2,1138,38973,3575889415,3575889434,19
2,1138,38974,3575889415,3575889435,20
2,1138,38975,3575889415,3575889436,21
2,1138,38976,3575889415,3575889437,22
2,1138,38977,3575889415,3575889437,22
2,1138,38978,3575889415,3575889437,22
2,1138,38979,3575889415,3575889439,24
2,1138,38980,3575889415,3575889439,24
2,1138,38981,3575889415,3575889440,25
2,1138,38982,3575889415,3575889440,25
2,1138,38983,3575889415,3575889440,25
2,1138,38984,3575889415,3575889441,26
2,1138,38985,3575889415,3575889443,28
2,1138,38986,3575889415,3575889444,29
2,1138,38987,3575889415,3575889445,30
2,1138,38988,3575889415,3575889446,31
2,1138,38989,3575889415,3575889448,33
2,1138,38990,3575889415,3575889448,33
2,1138,38991,3575889415,3575889454,39
2,1138,38992,3575889415,3575889455,40
2,1138,38993,3575889415,3575889455,40
2,1138,38994,3575889415,3575889455,40
2,1138,38995,3575889415,3575889455,40
2,1138,38996,3575889415,3575889456,41
2,1138,38997,3575889415,3575889456,41
2,1138,38998,3575889415,3575889456,41
2,1138,38999,3575889415,3575889456,41
2,1138,39000,3575889415,3575889458,43
2,1138,39001,3575889415,3575889459,44
2,1138,39002,3575889415,3575889460,45
2,1138,39003,3575889415,3575889460,45
2,1138,39004,3575889415,3575889460,45
2,1138,39005,3575889415,3575889463,48
2,1139,39006,3575889478,3575889478,0
2,1139,39007,3575889478,3575889478,0
2,1139,39008,3575889478,3575889478,0
2,1139,39009,3575889478,3575889478,0
2,1139,39010,3575889478,3575889478,0
2,1139,39011,3575889478,3575889478,0
2,1139,39012,3575889478,3575889478,0
2,1139,39013,3575889478,3575889480,2
2,1139,39014,3575889478,3575889481,3
2,1139,39015,3575889478,3575889483,5
2,1139,39016,3575889478,3575889485,7
2,1139,39017,3575889478,3575889486,8
2,1139,39018,3575889478,3575889487,9
2,1139,39019,3575889478,3575889487,9
2,1139,39020,3575889478,3575889488,10
2,1139,39021,3575889478,3575889488,10
2,1139,39022,3575889478,3575889488,10
2,1139,39023,3575889478,3575889489,11
2,1139,39024,3575889478,3575889490,12
2,1139,39025,3575889478,3575889490,12
2,1139,39026,3575889478,3575889491,13
2,1139,39027,3575889478,3575889491,13
2,1139,39028,3575889478,3575889491,13
2,1139,39029,3575889478,3575889491,13
2,1139,39030,3575889478,3575889492,14
2,1139,39031,3575889478,3575889492,14
2,1139,39032,3575889478,3575889494,16
2,1139,39033,3575889478,3575889494,16
2,1139,39034,3575889478,3575889495,17
2,1139,39035,3575889478,3575889495,17
2,1139,39036,3575889478,3575889496,18
2,1139,39037,3575889478,3575889497,19
2,1139,39038,3575889478,3575889497,19
2,1139,39039,3575889478,3575889498,20
2,1139,39040,3575889478,3575889499,21
2,1139,39041,3575889478,3575889499,21
2,1139,39042,3575889478,3575889500,22
2,1139,39043,3575889478,3575889500,22
2,1139,39044,3575889478,3575889500,22
2,1139,39045,3575889478,3575889502,24
2,1139,39046,3575889478,3575889504,26
2,1139,39047,3575889478,3575889504,26
2,1139,39048,3575889478,3575889506,28
2,1139,39049,3575889478,3575889506,28
2,1139,39050,3575889478,3575889506,28
2,1139,39051,3575889478,3575889507,29
2,1139,39052,3575889478,3575889507,29
2,1139,39053,3575889478,3575889507,29
2,1139,39054,3575889478,3575889507,29
2,1139,39055,3575889478,3575889507,29
2,1139,39056,3575889478,3575889508,30
2,1139,39057,3575889478,3575889509,31
2,1139,39058,3575889478,3575889509,31
2,1139,39059,3575889478,3575889509,31
2,1139,39060,3575889478,3575889509,31
2,1139,39061,3575889478,3575889510,32
2,1139,39062,3575889478,3575889510,32
2,1139,39063,3575889478,3575889511,33
2,1139,39064,3575889478,3575889511,33
2,1139,39065,3575889478,3575889513,35
2,1139,39066,3575889478,3575889513,35
2,1139,39067,3575889478,3575889514,36
2,1139,39068,3575889478,3575889515,37
2,1139,39069,3575889478,3575889515,37
2,1139,39070,3575889478,3575889516,38
2,1139,39071,3575889478,3575889517,39
2,1139,39072,3575889478,3575889517,39
2,1139,39073,3575889478,3575889518,40
2,1139,39074,3575889478,3575889518,40
2,1139,39075,3575889478,3575889519,41
2,1139,39076,3575889478,3575889519,41
2,1139,39077,3575889478,3575889521,43
2,1139,39078,3575889478,3575889521,43
2,1139,39079,3575889478,3575889522,44
2,1139,39080,3575889478,3575889522,44
2,1139,39081,3575889478,3575889524,46
2,1139,39082,3575889478,3575889525,47
2,1139,39083,3575889478,3575889525,47
2,1139,39084,3575889478,3575889526,48
2,1139,39085,3575889478,3575889527,49
2,1139,39086,3575889478,3575889528,50
2,1140,39087,3575889640,3575889640,0
2,1140,39088,3575889640,3575889640,0
2,1140,39089,3575889640,3575889640,0
2,1140,39090,3575889640,3575889640,0
2,1140,39091,3575889640,3575889640,0
2,1140,39092,3575889640,3575889640,0
2,1140,39093,3575889640,3575889640,0
2,1140,39094,3575889640,3575889640,0
2,1140,39095,3575889640,3575889640,0
2,1140,39096,3575889640,3575889640,0
2,1140,39097,3575889640,3575889640,0
2,1140,39098,3575889640,3575889640,0
2,1140,39099,3575889640,3575889640,0
2,1140,39100,3575889640,3575889640,0
2,1140,39101,3575889640,3575889640,0
2,1140,39102,3575889640,3575889640,0
2,1140,39103,3575889640,3575889640,0
2,1140,39104,3575889640,3575889640,0
2,1140,39105,3575889640,3575889640,0
2,1140,39106,3575889640,3575889640,0
2,1140,39107,3575889640,3575889640,0
2,1140,39108,3575889640,3575889640,0
2,1140,39109,3575889640,3575889640,0
2,1140,39110,3575889640,3575889640,0
2,1140,39111,3575889640,3575889640,0
2,1140,39112,3575889640,3575889640,0
2,1140,39113,3575889640,3575889640,0
2,1140,39114,3575889640,3575889640,0
2,1140,39115,3575889640,3575889640,0
2,1140,39116,3575889640,3575889640,0
2,1140,39117,3575889640,3575889640,0
2,1140,39118,3575889640,3575889640,0
2,1140,39119,3575889640,3575889640,0
2,1140,39120,3575889640,3575889640,0
2,1140,39121,3575889640,3575889640,0
2,1140,39122,3575889640,3575889640,0
2,1140,39123,3575889640,3575889640,0
2,1140,39124,3575889640,3575889640,0
2,1140,39125,3575889640,3575889641,1
2,1140,39126,3575889640,3575889641,1
2,1140,39127,3575889640,3575889641,1
2,1140,39128,3575889640,3575889641,1
2,1140,39129,3575889640,3575889641,1
2,1140,39130,3575889640,3575889641,1
2,1140,39131,3575889640,3575889641,1
2,1140,39132,3575889640,3575889641,1
2,1140,39133,3575889640,3575889641,1
2,1140,39134,3575889640,3575889641,1
2,1140,39135,3575889640,3575889641,1
2,1140,39136,3575889640,3575889641,1
2,1140,39137,3575889640,3575889641,1
2,1140,39138,3575889640,3575889641,1
2,1140,39139,3575889640,3575889641,1
2,1140,39140,3575889640,3575889641,1
2,1140,39141,3575889640,3575889641,1
2,1140,39142,3575889640,3575889641,1
2,1140,39143,3575889640,3575889641,1
2,1140,39144,3575889640,3575889641,1
2,1140,39145,3575889640,3575889641,1
2,1140,39146,3575889640,3575889641,1
2,1140,39147,3575889640,3575889641,1
2,1140,39148,3575889640,3575889641,1
2,1140,39149,3575889640,3575889641,1
2,1140,39150,3575889640,3575889641,1
2,1140,39151,3575889640,3575889641,1
2,1140,39152,3575889640,3575889641,1
2,1140,39153,3575889640,3575889641,1
2,1140,39154,3575889640,3575889641,1
2,1140,39155,3575889640,3575889641,1
2,1140,39156,3575889640,3575889641,1
2,1140,39157,3575889640,3575889641,1
2,1140,39158,3575889640,3575889641,1
2,1140,39159,3575889640,3575889641,1
2,1140,39160,3575889640,3575889641,1
2,1140,39161,3575889640,3575889641,1
2,1140,39162,3575889640,3575889641,1
2,1140,39163,3575889640,3575889641,1
2,1140,39164,3575889640,3575889641,1
2,1140,39165,3575889640,3575889641,1
2,1140,39166,3575889640,3575889641,1
2,1140,39167,3575889640,3575889641,1
2,1140,39168,3575889640,3575889641,1
2,1140,39169,3575889640,3575889641,1
2,1140,39170,3575889640,3575889641,1
2,1140,39171,3575889640,3575889641,1
2,1140,39172,3575889640,3575889641,1
2,1140,39173,3575889640,3575889641,1
2,1140,39174,3575889640,3575889641,1
2,1140,39175,3575889640,3575889641,1
2,1140,39176,3575889640,3575889641,1
2,1140,39177,3575889640,3575889641,1
2,1140,39178,3575889640,3575889641,1
2,1140,39179,3575889640,3575889641,1
2,1140,39180,3575889640,3575889641,1
2,1140,39181,3575889640,3575889641,1
2,1140,39182,3575889640,3575889641,1
2,1140,39183,3575889640,3575889641,1
2,1140,39184,3575889640,3575889641,1
2,1140,39185,3575889640,3575889641,1
2,1140,39186,3575889640,3575889641,1
2,1140,39187,3575889640,3575889641,1
2,1140,39188,3575889640,3575889641,1
2,1140,39189,3575889640,3575889641,1
2,1140,39190,3575889640,3575889641,1
2,1140,39191,3575889640,3575889641,1
2,1140,39192,3575889640,3575889641,1
2,1140,39193,3575889640,3575889641,1
2,1140,39194,3575889640,3575889641,1
2,1140,39195,3575889640,3575889641,1
2,1140,39196,3575889640,3575889641,1
2,1140,39197,3575889640,3575889641,1
2,1140,39198,3575889640,3575889641,1
2,1140,39199,3575889640,3575889641,1
2,1140,39200,3575889640,3575889641,1
2,1140,39201,3575889640,3575889641,1
2,1140,39202,3575889640,3575889641,1
2,1140,39203,3575889640,3575889641,1
2,1140,39204,3575889640,3575889641,1
2,1140,39205,3575889640,3575889641,1
2,1140,39206,3575889640,3575889641,1
2,1140,39207,3575889640,3575889641,1
2,1140,39208,3575889640,3575889641,1
2,1140,39209,3575889640,3575889641,1
2,1140,39210,3575889640,3575889641,1
2,1140,39211,3575889640,3575889641,1
2,1140,39212,3575889640,3575889641,1
2,1140,39213,3575889640,3575889641,1
2,1140,39214,3575889640,3575889641,1
2,1140,39215,3575889640,3575889641,1
2,1140,39216,3575889640,3575889641,1
2,1140,39217,3575889640,3575889641,1
2,1140,39218,3575889640,3575889641,1
2,1140,39219,3575889640,3575889641,1
2,1140,39220,3575889640,3575889641,1
2,1140,39221,3575889640,3575889641,1
2,1140,39222,3575889640,3575889641,1
2,1140,39223,3575889640,3575889641,1
2,1140,39224,3575889640,3575889641,1
2,1140,39225,3575889640,3575889641,1
2,1140,39226,3575889640,3575889641,1
2,1140,39227,3575889640,3575889641,1
2,1140,39228,3575889640,3575889641,1
2,1140,39229,3575889640,3575889641,1
2,1140,39230,3575889640,3575889641,1
2,1140,39231,3575889640,3575889642,2
2,1140,39232,3575889640,3575889643,3
2,1140,39233,3575889640,3575889643,3
2,1140,39234,3575889640,3575889644,4
2,1140,39235,3575889640,3575889646,6
2,1140,39236,3575889640,3575889647,7
2,1140,39237,3575889640,3575889648,8
2,1140,39238,3575889640,3575889648,8
2,1140,39239,3575889640,3575889653,13
2,1140,39240,3575889640,3575889654,14
2,1140,39241,3575889640,3575889654,14
2,1140,39242,3575889640,3575889654,14
2,1140,39243,3575889640,3575889655,15
2,1140,39244,3575889640,3575889655,15
2,1140,39245,3575889640,3575889655,15
2,1140,39246,3575889640,3575889655,15
2,1140,39247,3575889640,3575889655,15
2,1140,39248,3575889640,3575889657,17
2,1140,39249,3575889640,3575889659,19
2,1140,39250,3575889640,3575889659,19
2,1140,39251,3575889640,3575889659,19
2,1140,39252,3575889640,3575889660,20
2,1140,39253,3575889640,3575889661,21
2,1140,39254,3575889640,3575889666,26
2,1140,39255,3575889640,3575889666,26
2,1140,39256,3575889640,3575889667,27
2,1140,39257,3575889640,3575889675,35
2,1140,39258,3575889640,3575889676,36
2,1140,39259,3575889640,3575889680,40
2,1140,39260,3575889640,3575889682,42
2,1140,39261,3575889640,3575889683,43
2,1140,39262,3575889640,3575889684,44
2,1140,39263,3575889640,3575889686,46
2,1140,39264,3575889640,3575889686,46
2,1140,39265,3575889640,3575889686,46
2,1140,39266,3575889640,3575889687,47
2,1140,39267,3575889640,3575889688,48
2,1140,39268,3575889640,3575889688,48
2,1140,39269,3575889640,3575889690,50
2,1141,39270,3575889702,3575889702,0
2,1141,39271,3575889702,3575889702,0
2,1141,39272,3575889702,3575889702,0
2,1141,39273,3575889702,3575889702,0
2,1141,39274,3575889702,3575889702,0
2,1141,39275,3575889702,3575889702,0
2,1141,39276,3575889702,3575889702,0
2,1141,39277,3575889702,3575889702,0
2,1141,39278,3575889702,3575889702,0
2,1141,39279,3575889702,3575889702,0
2,1141,39280,3575889702,3575889702,0
2,1141,39281,3575889702,3575889702,0
2,1141,39282,3575889702,3575889702,0
2,1141,39283,3575889702,3575889702,0
2,1141,39284,3575889702,3575889702,0
2,1141,39285,3575889702,3575889702,0
2,1141,39286,3575889702,3575889702,0
2,1141,39287,3575889702,3575889702,0
2,1141,39288,3575889702,3575889702,0
2,1141,39289,3575889702,3575889702,0
2,1141,39290,3575889702,3575889704,2
2,1141,39291,3575889702,3575889704,2
2,1141,39292,3575889702,3575889706,4
2,1141,39293,3575889702,3575889706,4
2,1141,39294,3575889702,3575889706,4
2,1141,39295,3575889702,3575889706,4
2,1141,39296,3575889702,3575889707,5
2,1141,39297,3575889702,3575889707,5
2,1141,39298,3575889702,3575889707,5
2,1141,39299,3575889702,3575889707,5
2,1141,39300,3575889702,3575889708,6
2,1141,39301,3575889702,3575889709,7
2,1141,39302,3575889702,3575889709,7
2,1141,39303,3575889702,3575889709,7
2,1141,39304,3575889702,3575889709,7
2,1141,39305,3575889702,3575889710,8
2,1141,39306,3575889702,3575889710,8
2,1141,39307,3575889702,3575889711,9
2,1141,39308,3575889702,3575889711,9
2,1141,39309,3575889702,3575889712,10
2,1141,39310,3575889702,3575889713,11
2,1141,39311,3575889702,3575889713,11
2,1141,39312,3575889702,3575889714,12
2,1141,39313,3575889702,3575889715,13
2,1141,39314,3575889702,3575889715,13
2,1141,39315,3575889702,3575889717,15
2,1141,39316,3575889702,3575889717,15
2,1141,39317,3575889702,3575889718,16
2,1141,39318,3575889702,3575889719,17
2,1141,39319,3575889702,3575889719,17
2,1141,39320,3575889702,3575889719,17
2,1141,39321,3575889702,3575889721,19
2,1141,39322,3575889702,3575889721,19
2,1141,39323,3575889702,3575889721,19
2,1141,39324,3575889702,3575889722,20
2,1141,39325,3575889702,3575889722,20
2,1141,39326,3575889702,3575889722,20
2,1141,39327,3575889702,3575889724,22
2,1141,39328,3575889702,3575889726,24
2,1141,39329,3575889702,3575889726,24
2,1141,39330,3575889702,3575889726,24
2,1141,39331,3575889702,3575889728,26
2,1141,39332,3575889702,3575889729,27
2,1141,39333,3575889702,3575889729,27
2,1141,39334,3575889702,3575889730,28
2,1141,39335,3575889702,3575889730,28
2,1141,39336,3575889702,3575889730,28
2,1141,39337,3575889702,3575889731,29
2,1141,39338,3575889702,3575889731,29
2,1141,39339,3575889702,3575889731,29
2,1141,39340,3575889702,3575889733,31
2,1141,39341,3575889702,3575889733,31
2,1141,39342,3575889702,3575889733,31
2,1141,39343,3575889702,3575889733,31
2,1141,39344,3575889702,3575889734,32
2,1141,39345,3575889702,3575889735,33
2,1141,39346,3575889702,3575889735,33
2,1141,39347,3575889702,3575889735,33
2,1141,39348,3575889702,3575889736,34
2,1141,39349,3575889702,3575889736,34
2,1141,39350,3575889702,3575889738,36
2,1141,39351,3575889702,3575889738,36
2,1141,39352,3575889702,3575889739,37
2,1141,39353,3575889702,3575889739,37
2,1141,39354,3575889702,3575889739,37
2,1141,39355,3575889702,3575889740,38
2,1141,39356,3575889702,3575889742,40
2,1141,39357,3575889702,3575889743,41
2,1141,39358,3575889702,3575889744,42
2,1141,39359,3575889702,3575889744,42
2,1141,39360,3575889702,3575889744,42
2,1141,39361,3575889702,3575889745,43
2,1141,39362,3575889702,3575889747,45
2,1141,39363,3575889702,3575889747,45
2,1141,39364,3575889702,3575889748,46
2,1141,39365,3575889702,3575889749,47
2,1141,39366,3575889702,3575889749,47
2,1141,39367,3575889702,3575889751,49
2,1141,39368,3575889702,3575889751,49
2,1141,39369,3575889702,3575889752,50
2,1142,39370,3575889769,3575889769,0
2,1142,39371,3575889769,3575889769,0
2,1142,39372,3575889769,3575889769,0
2,1142,39373,3575889769,3575889769,0
2,1142,39374,3575889769,3575889769,0
2,1142,39375,3575889769,3575889769,0
2,1142,39376,3575889769,3575889769,0
2,1142,39377,3575889769,3575889769,0
2,1142,39378,3575889769,3575889769,0
2,1142,39379,3575889769,3575889769,0
2,1142,39380,3575889769,3575889769,0
2,1142,39381,3575889769,3575889769,0
2,1142,39382,3575889769,3575889769,0
2,1142,39383,3575889769,3575889769,0
2,1142,39384,3575889769,3575889769,0
2,1142,39385,3575889769,3575889769,0
2,1142,39386,3575889769,3575889769,0
2,1142,39387,3575889769,3575889769,0
2,1142,39388,3575889769,3575889769,0
2,1142,39389,3575889769,3575889769,0
2,1142,39390,3575889769,3575889769,0
2,1142,39391,3575889769,3575889769,0
2,1142,39392,3575889769,3575889769,0
2,1142,39393,3575889769,3575889769,0
2,1142,39394,3575889769,3575889771,2
2,1142,39395,3575889769,3575889771,2
2,1142,39396,3575889769,3575889774,5
2,1142,39397,3575889769,3575889774,5
2,1142,39398,3575889769,3575889775,6
2,1142,39399,3575889769,3575889776,7
2,1142,39400,3575889769,3575889777,8
2,1142,39401,3575889769,3575889778,9
2,1142,39402,3575889769,3575889778,9
2,1142,39403,3575889769,3575889778,9
2,1142,39404,3575889769,3575889780,11
2,1142,39405,3575889769,3575889781,12
2,1142,39406,3575889769,3575889781,12
2,1142,39407,3575889769,3575889782,13
2,1142,39408,3575889769,3575889782,13
2,1142,39409,3575889769,3575889783,14
2,1142,39410,3575889769,3575889783,14
2,1142,39411,3575889769,3575889783,14
2,1142,39412,3575889769,3575889784,15
2,1142,39413,3575889769,3575889784,15
2,1142,39414,3575889769,3575889785,16
2,1142,39415,3575889769,3575889785,16
2,1142,39416,3575889769,3575889786,17
2,1142,39417,3575889769,3575889787,18
2,1142,39418,3575889769,3575889787,18
2,1142,39419,3575889769,3575889788,19
2,1142,39420,3575889769,3575889788,19
2,1142,39421,3575889769,3575889788,19
2,1142,39422,3575889769,3575889790,21
2,1142,39423,3575889769,3575889790,21
2,1142,39424,3575889769,3575889791,22
2,1142,39425,3575889769,3575889791,22
2,1142,39426,3575889769,3575889793,24
2,1142,39427,3575889769,3575889793,24
2,1142,39428,3575889769,3575889793,24
2,1142,39429,3575889769,3575889795,26
2,1142,39430,3575889769,3575889795,26
2,1142,39431,3575889769,3575889797,28
2,1142,39432,3575889769,3575889799,30
2,1142,39433,3575889769,3575889799,30
2,1142,39434,3575889769,3575889800,31
2,1142,39435,3575889769,3575889801,32
2,1142,39436,3575889769,3575889802,33
2,1142,39437,3575889769,3575889803,34
2,1142,39438,3575889769,3575889803,34
2,1142,39439,3575889769,3575889803,34
2,1142,39440,3575889769,3575889804,35
2,1142,39441,3575889769,3575889805,36
2,1142,39442,3575889769,3575889805,36
2,1142,39443,3575889769,3575889807,38
2,1142,39444,3575889769,3575889807,38
2,1142,39445,3575889769,3575889811,42
2,1142,39446,3575889769,3575889813,44
2,1142,39447,3575889769,3575889813,44
2,1142,39448,3575889769,3575889814,45
2,1143,39449,3575889831,3575889831,0
2,1143,39450,3575889831,3575889831,0
2,1143,39451,3575889831,3575889831,0
2,1143,39452,3575889831,3575889831,0
2,1143,39453,3575889831,3575889831,0
2,1143,39454,3575889831,3575889831,0
2,1143,39455,3575889831,3575889831,0
2,1143,39456,3575889831,3575889831,0
2,1143,39457,3575889831,3575889831,0
2,1143,39458,3575889831,3575889831,0
2,1143,39459,3575889831,3575889831,0
2,1143,39460,3575889831,3575889831,0
2,1143,39461,3575889831,3575889831,0
2,1143,39462,3575889831,3575889831,0
2,1143,39463,3575889831,3575889831,0
2,1143,39464,3575889831,3575889833,2
2,1143,39465,3575889831,3575889834,3
2,1143,39466,3575889831,3575889835,4
2,1143,39467,3575889831,3575889835,4
2,1143,39468,3575889831,3575889837,6
2,1143,39469,3575889831,3575889837,6
2,1143,39470,3575889831,3575889839,8
2,1143,39471,3575889831,3575889839,8
2,1143,39472,3575889831,3575889840,9
2,1143,39473,3575889831,3575889842,11
2,1143,39474,3575889831,3575889843,12
2,1143,39475,3575889831,3575889844,13
2,1143,39476,3575889831,3575889845,14
2,1143,39477,3575889831,3575889846,15
2,1143,39478,3575889831,3575889847,16
2,1143,39479,3575889831,3575889848,17
2,1143,39480,3575889831,3575889850,19
2,1143,39481,3575889831,3575889853,22
2,1143,39482,3575889831,3575889854,23
2,1143,39483,3575889831,3575889855,24
2,1143,39484,3575889831,3575889855,24
2,1143,39485,3575889831,3575889855,24
2,1143,39486,3575889831,3575889855,24
2,1143,39487,3575889831,3575889855,24
2,1143,39488,3575889831,3575889856,25
2,1143,39489,3575889831,3575889856,25
2,1143,39490,3575889831,3575889856,25
2,1143,39491,3575889831,3575889858,27
2,1143,39492,3575889831,3575889859,28
2,1143,39493,3575889831,3575889859,28
2,1143,39494,3575889831,3575889859,28
2,1143,39495,3575889831,3575889861,30
2,1143,39496,3575889831,3575889866,35
2,1143,39497,3575889831,3575889867,36
2,1143,39498,3575889831,3575889876,45
2,1143,39499,3575889831,3575889876,45
2,1143,39500,3575889831,3575889880,49
2,1144,39501,3575889898,3575889898,0
2,1144,39502,3575889898,3575889898,0
2,1144,39503,3575889898,3575889898,0
2,1144,39504,3575889898,3575889898,0
2,1144,39505,3575889898,3575889898,0
2,1144,39506,3575889898,3575889898,0
2,1144,39507,3575889898,3575889898,0
2,1144,39508,3575889898,3575889898,0
2,1144,39509,3575889898,3575889898,0
2,1144,39510,3575889898,3575889898,0
2,1144,39511,3575889898,3575889898,0
2,1144,39512,3575889898,3575889898,0
2,1144,39513,3575889898,3575889898,0
2,1144,39514,3575889898,3575889898,0
2,1144,39515,3575889898,3575889898,0
2,1144,39516,3575889898,3575889898,0
2,1144,39517,3575889898,3575889898,0
2,1144,39518,3575889898,3575889898,0
2,1144,39519,3575889898,3575889898,0
2,1144,39520,3575889898,3575889898,0
2,1144,39521,3575889898,3575889898,0
2,1144,39522,3575889898,3575889898,0
2,1144,39523,3575889898,3575889899,1
2,1144,39524,3575889898,3575889899,1
2,1144,39525,3575889898,3575889899,1
2,1144,39526,3575889898,3575889900,2
2,1144,39527,3575889898,3575889901,3
2,1144,39528,3575889898,3575889902,4
2,1144,39529,3575889898,3575889903,5
2,1144,39530,3575889898,3575889904,6
2,1144,39531,3575889898,3575889904,6
2,1144,39532,3575889898,3575889906,8
2,1144,39533,3575889898,3575889906,8
2,1144,39534,3575889898,3575889906,8
2,1144,39535,3575889898,3575889907,9
2,1144,39536,3575889898,3575889907,9
2,1144,39537,3575889898,3575889907,9
2,1144,39538,3575889898,3575889907,9
2,1144,39539,3575889898,3575889907,9
2,1144,39540,3575889898,3575889908,10
2,1144,39541,3575889898,3575889908,10
2,1144,39542,3575889898,3575889909,11
2,1144,39543,3575889898,3575889909,11
2,1144,39544,3575889898,3575889909,11
2,1144,39545,3575889898,3575889910,12
2,1144,39546,3575889898,3575889911,13
2,1144,39547,3575889898,3575889911,13
2,1144,39548,3575889898,3575889912,14
2,1144,39549,3575889898,3575889912,14
2,1144,39550,3575889898,3575889914,16
2,1144,39551,3575889898,3575889914,16
2,1144,39552,3575889898,3575889914,16
2,1144,39553,3575889898,3575889915,17
2,1144,39554,3575889898,3575889915,17
2,1144,39555,3575889898,3575889916,18
2,1144,39556,3575889898,3575889917,19
2,1144,39557,3575889898,3575889918,20
2,1144,39558,3575889898,3575889918,20
2,1144,39559,3575889898,3575889919,21
2,1144,39560,3575889898,3575889919,21
2,1144,39561,3575889898,3575889919,21
2,1144,39562,3575889898,3575889920,22
2,1144,39563,3575889898,3575889921,23
2,1144,39564,3575889898,3575889921,23
2,1144,39565,3575889898,3575889922,24
2,1144,39566,3575889898,3575889922,24
2,1144,39567,3575889898,3575889923,25
2,1144,39568,3575889898,3575889925,27
2,1144,39569,3575889898,3575889926,28
2,1144,39570,3575889898,3575889926,28
2,1144,39571,3575889898,3575889926,28
2,1144,39572,3575889898,3575889927,29
2,1144,39573,3575889898,3575889928,30
2,1144,39574,3575889898,3575889928,30
2,1144,39575,3575889898,3575889928,30
2,1144,39576,3575889898,3575889929,31
2,1144,39577,3575889898,3575889930,32
2,1144,39578,3575889898,3575889930,32
2,1144,39579,3575889898,3575889931,33
2,1144,39580,3575889898,3575889931,33
2,1144,39581,3575889898,3575889932,34
2,1144,39582,3575889898,3575889933,35
2,1144,39583,3575889898,3575889933,35
2,1144,39584,3575889898,3575889934,36
2,1144,39585,3575889898,3575889934,36
2,1144,39586,3575889898,3575889935,37
2,1144,39587,3575889898,3575889935,37
2,1144,39588,3575889898,3575889935,37
2,1144,39589,3575889898,3575889935,37
2,1144,39590,3575889898,3575889936,38
2,1144,39591,3575889898,3575889937,39
2,1144,39592,3575889898,3575889938,40
2,1144,39593,3575889898,3575889938,40
2,1144,39594,3575889898,3575889939,41
2,1144,39595,3575889898,3575889939,41
2,1144,39596,3575889898,3575889939,41
2,1144,39597,3575889898,3575889940,42
2,1144,39598,3575889898,3575889942,44
2,1144,39599,3575889898,3575889943,45
2,1144,39600,3575889898,3575889944,46
2,1144,39601,3575889898,3575889944,46
2,1144,39602,3575889898,3575889945,47
2,1144,39603,3575889898,3575889945,47
2,1144,39604,3575889898,3575889946,48
2,1144,39605,3575889898,3575889947,49
2,1144,39606,3575889898,3575889947,49
2,1145,39607,3575889961,3575889961,0
2,1145,39608,3575889961,3575889961,0
2,1145,39609,3575889961,3575889961,0
2,1145,39610,3575889961,3575889961,0
2,1145,39611,3575889961,3575889961,0
2,1145,39612,3575889961,3575889961,0
2,1145,39613,3575889961,3575889961,0
2,1145,39614,3575889961,3575889961,0
2,1145,39615,3575889961,3575889961,0
2,1145,39616,3575889961,3575889961,0
2,1145,39617,3575889961,3575889961,0
2,1145,39618,3575889961,3575889961,0
2,1145,39619,3575889961,3575889961,0
2,1145,39620,3575889961,3575889961,0
2,1145,39621,3575889961,3575889961,0
2,1145,39622,3575889961,3575889961,0
2,1145,39623,3575889961,3575889961,0
2,1145,39624,3575889961,3575889961,0
2,1145,39625,3575889961,3575889961,0
2,1145,39626,3575889961,3575889964,3
2,1145,39627,3575889961,3575889965,4
2,1145,39628,3575889961,3575889965,4
2,1145,39629,3575889961,3575889967,6
2,1145,39630,3575889961,3575889968,7
2,1145,39631,3575889961,3575889968,7
2,1145,39632,3575889961,3575889968,7
2,1145,39633,3575889961,3575889969,8
2,1145,39634,3575889961,3575889969,8
2,1145,39635,3575889961,3575889969,8
2,1145,39636,3575889961,3575889971,10
2,1145,39637,3575889961,3575889971,10
2,1145,39638,3575889961,3575889975,14
2,1145,39639,3575889961,3575889975,14
2,1145,39640,3575889961,3575889976,15
2,1145,39641,3575889961,3575889978,17
2,1145,39642,3575889961,3575889978,17
2,1145,39643,3575889961,3575889978,17
2,1145,39644,3575889961,3575889978,17
2,1145,39645,3575889961,3575889978,17
2,1145,39646,3575889961,3575889980,19
2,1145,39647,3575889961,3575889981,20
2,1145,39648,3575889961,3575889982,21
2,1145,39649,3575889961,3575889983,22
2,1145,39650,3575889961,3575889984,23
2,1145,39651,3575889961,3575889985,24
2,1145,39652,3575889961,3575889985,24
2,1145,39653,3575889961,3575889985,24
2,1145,39654,3575889961,3575889986,25
2,1145,39655,3575889961,3575889987,26
2,1145,39656,3575889961,3575889987,26
2,1145,39657,3575889961,3575889987,26
2,1145,39658,3575889961,3575889988,27
2,1145,39659,3575889961,3575889988,27
2,1145,39660,3575889961,3575889988,27
2,1145,39661,3575889961,3575889990,29
2,1145,39662,3575889961,3575889991,30
2,1145,39663,3575889961,3575889991,30
2,1145,39664,3575889961,3575889992,31
2,1145,39665,3575889961,3575889993,32
2,1145,39666,3575889961,3575889993,32
2,1145,39667,3575889961,3575889993,32
2,1145,39668,3575889961,3575889995,34
2,1145,39669,3575889961,3575889995,34
2,1145,39670,3575889961,3575889996,35
2,1145,39671,3575889961,3575889996,35
2,1145,39672,3575889961,3575889998,37
2,1145,39673,3575889961,3575889999,38
2,1145,39674,3575889961,3575889999,38
2,1145,39675,3575889961,3575890000,39
2,1145,39676,3575889961,3575890000,39
2,1145,39677,3575889961,3575890002,41
2,1145,39678,3575889961,3575890003,42
2,1145,39679,3575889961,3575890004,43
2,1145,39680,3575889961,3575890005,44
2,1145,39681,3575889961,3575890006,45
2,1145,39682,3575889961,3575890006,45
2,1145,39683,3575889961,3575890007,46
2,1145,39684,3575889961,3575890011,50
2,1146,39685,3575890025,3575890025,0
2,1146,39686,3575890025,3575890025,0
2,1146,39687,3575890025,3575890025,0
2,1146,39688,3575890025,3575890025,0
2,1146,39689,3575890025,3575890025,0
2,1146,39690,3575890025,3575890025,0
2,1146,39691,3575890025,3575890025,0
2,1146,39692,3575890025,3575890025,0
2,1146,39693,3575890025,3575890025,0
2,1146,39694,3575890025,3575890025,0
2,1146,39695,3575890025,3575890025,0
2,1146,39696,3575890025,3575890025,0
2,1146,39697,3575890025,3575890026,1
2,1146,39698,3575890025,3575890026,1
2,1146,39699,3575890025,3575890028,3
2,1146,39700,3575890025,3575890028,3
2,1146,39701,3575890025,3575890028,3
2,1146,39702,3575890025,3575890028,3
2,1146,39703,3575890025,3575890028,3
2,1146,39704,3575890025,3575890029,4
2,1146,39705,3575890025,3575890035,10
2,1146,39706,3575890025,3575890035,10
2,1146,39707,3575890025,3575890036,11
2,1146,39708,3575890025,3575890036,11
2,1146,39709,3575890025,3575890037,12
2,1146,39710,3575890025,3575890039,14
2,1146,39711,3575890025,3575890039,14
2,1146,39712,3575890025,3575890039,14
2,1146,39713,3575890025,3575890042,17
2,1146,39714,3575890025,3575890043,18
2,1146,39715,3575890025,3575890044,19
2,1146,39716,3575890025,3575890045,20
2,1146,39717,3575890025,3575890046,21
2,1146,39718,3575890025,3575890047,22
2,1146,39719,3575890025,3575890048,23
2,1146,39720,3575890025,3575890053,28
2,1146,39721,3575890025,3575890054,29
2,1146,39722,3575890025,3575890055,30
2,1146,39723,3575890025,3575890055,30
2,1146,39724,3575890025,3575890055,30
2,1146,39725,3575890025,3575890056,31
2,1146,39726,3575890025,3575890056,31
2,1146,39727,3575890025,3575890056,31
2,1146,39728,3575890025,3575890056,31
2,1146,39729,3575890025,3575890059,34
2,1146,39730,3575890025,3575890059,34
2,1146,39731,3575890025,3575890059,34
2,1146,39732,3575890025,3575890063,38
2,1146,39733,3575890025,3575890066,41
2,1146,39734,3575890025,3575890066,41
2,1146,39735,3575890025,3575890068,43
2,1147,39736,3575890089,3575890089,0
2,1147,39737,3575890089,3575890089,0
2,1147,39738,3575890089,3575890089,0
2,1147,39739,3575890089,3575890089,0
2,1147,39740,3575890089,3575890089,0
2,1147,39741,3575890089,3575890089,0
2,1147,39742,3575890089,3575890089,0
2,1147,39743,3575890089,3575890089,0
2,1147,39744,3575890089,3575890089,0
2,1147,39745,3575890089,3575890089,0
2,1147,39746,3575890089,3575890089,0
2,1147,39747,3575890089,3575890090,1
2,1147,39748,3575890089,3575890090,1
2,1147,39749,3575890089,3575890090,1
2,1147,39750,3575890089,3575890091,2
2,1147,39751,3575890089,3575890091,2
2,1147,39752,3575890089,3575890092,3
2,1147,39753,3575890089,3575890092,3
2,1147,39754,3575890089,3575890093,4
2,1147,39755,3575890089,3575890095,6
2,1147,39756,3575890089,3575890095,6
2,1147,39757,3575890089,3575890095,6
2,1147,39758,3575890089,3575890095,6
2,1147,39759,3575890089,3575890097,8
2,1147,39760,3575890089,3575890097,8
2,1147,39761,3575890089,3575890098,9
2,1147,39762,3575890089,3575890098,9
2,1147,39763,3575890089,3575890099,10
2,1147,39764,3575890089,3575890099,10
2,1147,39765,3575890089,3575890100,11
2,1147,39766,3575890089,3575890100,11
2,1147,39767,3575890089,3575890101,12
2,1147,39768,3575890089,3575890102,13
2,1147,39769,3575890089,3575890103,14
2,1147,39770,3575890089,3575890104,15
2,1147,39771,3575890089,3575890104,15
2,1147,39772,3575890089,3575890106,17
2,1147,39773,3575890089,3575890106,17
2,1147,39774,3575890089,3575890106,17
2,1147,39775,3575890089,3575890107,18
2,1147,39776,3575890089,3575890107,18
2,1147,39777,3575890089,3575890107,18
2,1147,39778,3575890089,3575890108,19
2,1147,39779,3575890089,3575890108,19
2,1147,39780,3575890089,3575890109,20
2,1147,39781,3575890089,3575890109,20
2,1147,39782,3575890089,3575890110,21
2,1147,39783,3575890089,3575890111,22
2,1147,39784,3575890089,3575890111,22
2,1147,39785,3575890089,3575890111,22
2,1147,39786,3575890089,3575890112,23
2,1147,39787,3575890089,3575890113,24
2,1147,39788,3575890089,3575890113,24
2,1147,39789,3575890089,3575890114,25
2,1147,39790,3575890089,3575890116,27
2,1147,39791,3575890089,3575890117,28
2,1147,39792,3575890089,3575890117,28
2,1147,39793,3575890089,3575890118,29
2,1147,39794,3575890089,3575890118,29
2,1147,39795,3575890089,3575890119,30
2,1147,39796,3575890089,3575890119,30
2,1147,39797,3575890089,3575890119,30
2,1147,39798,3575890089,3575890120,31
2,1147,39799,3575890089,3575890121,32
2,1147,39800,3575890089,3575890121,32
2,1147,39801,3575890089,3575890122,33
2,1147,39802,3575890089,3575890122,33
2,1147,39803,3575890089,3575890123,34
2,1147,39804,3575890089,3575890126,37
2,1147,39805,3575890089,3575890126,37
2,1147,39806,3575890089,3575890127,38
2,1147,39807,3575890089,3575890128,39
2,1147,39808,3575890089,3575890128,39
2,1147,39809,3575890089,3575890128,39
2,1147,39810,3575890089,3575890129,40
2,1147,39811,3575890089,3575890129,40
2,1147,39812,3575890089,3575890130,41
2,1147,39813,3575890089,3575890131,42
2,1147,39814,3575890089,3575890131,42
2,1147,39815,3575890089,3575890131,42
2,1147,39816,3575890089,3575890132,43
2,1147,39817,3575890089,3575890133,44
2,1147,39818,3575890089,3575890134,45
2,1147,39819,3575890089,3575890134,45
2,1147,39820,3575890089,3575890134,45
2,1147,39821,3575890089,3575890135,46
2,1147,39822,3575890089,3575890135,46
2,1147,39823,3575890089,3575890137,48
2,1147,39824,3575890089,3575890137,48
2,1147,39825,3575890089,3575890138,49
2,1147,39826,3575890089,3575890138,49
2,1147,39827,3575890089,3575890139,50
2,1148,39828,3575890151,3575890151,0
2,1148,39829,3575890151,3575890151,0
2,1148,39830,3575890151,3575890151,0
2,1148,39831,3575890151,3575890151,0
2,1148,39832,3575890151,3575890151,0
2,1148,39833,3575890151,3575890151,0
2,1148,39834,3575890151,3575890151,0
2,1148,39835,3575890151,3575890151,0
2,1148,39836,3575890151,3575890151,0
2,1148,39837,3575890151,3575890151,0
2,1148,39838,3575890151,3575890151,0
2,1148,39839,3575890151,3575890151,0
2,1148,39840,3575890151,3575890151,0
2,1148,39841,3575890151,3575890151,0
2,1148,39842,3575890151,3575890151,0
2,1148,39843,3575890151,3575890151,0
2,1148,39844,3575890151,3575890152,1
2,1148,39845,3575890151,3575890152,1
2,1148,39846,3575890151,3575890153,2
2,1148,39847,3575890151,3575890154,3
2,1148,39848,3575890151,3575890154,3
2,1148,39849,3575890151,3575890155,4
2,1148,39850,3575890151,3575890155,4
2,1148,39851,3575890151,3575890157,6
2,1148,39852,3575890151,3575890157,6
2,1148,39853,3575890151,3575890159,8
2,1148,39854,3575890151,3575890160,9
2,1148,39855,3575890151,3575890160,9
2,1148,39856,3575890151,3575890160,9
2,1148,39857,3575890151,3575890160,9
2,1148,39858,3575890151,3575890161,10
2,1148,39859,3575890151,3575890162,11
2,1148,39860,3575890151,3575890164,13
2,1148,39861,3575890151,3575890164,13
2,1148,39862,3575890151,3575890165,14
2,1148,39863,3575890151,3575890165,14
2,1148,39864,3575890151,3575890167,16
2,1148,39865,3575890151,3575890167,16
2,1148,39866,3575890151,3575890167,16
2,1148,39867,3575890151,3575890168,17
2,1148,39868,3575890151,3575890168,17
2,1148,39869,3575890151,3575890168,17
2,1148,39870,3575890151,3575890170,19
2,1148,39871,3575890151,3575890170,19
2,1148,39872,3575890151,3575890170,19
2,1148,39873,3575890151,3575890170,19
2,1148,39874,3575890151,3575890171,20
2,1148,39875,3575890151,3575890171,20
2,1148,39876,3575890151,3575890176,25
2,1148,39877,3575890151,3575890176,25
2,1148,39878,3575890151,3575890177,26
2,1148,39879,3575890151,3575890178,27
2,1148,39880,3575890151,3575890178,27
2,1148,39881,3575890151,3575890178,27
2,1148,39882,3575890151,3575890179,28
2,1148,39883,3575890151,3575890180,29
2,1148,39884,3575890151,3575890180,29
2,1148,39885,3575890151,3575890181,30
2,1148,39886,3575890151,3575890181,30
2,1148,39887,3575890151,3575890182,31
2,1148,39888,3575890151,3575890183,32
2,1148,39889,3575890151,3575890183,32
2,1148,39890,3575890151,3575890185,34
2,1148,39891,3575890151,3575890185,34
2,1148,39892,3575890151,3575890186,35
2,1148,39893,3575890151,3575890186,35
2,1148,39894,3575890151,3575890186,35
2,1148,39895,3575890151,3575890187,36
2,1148,39896,3575890151,3575890188,37
2,1148,39897,3575890151,3575890188,37
2,1148,39898,3575890151,3575890188,37
2,1148,39899,3575890151,3575890189,38
2,1148,39900,3575890151,3575890190,39
2,1148,39901,3575890151,3575890191,40
2,1148,39902,3575890151,3575890191,40
2,1148,39903,3575890151,3575890192,41
2,1148,39904,3575890151,3575890193,42
2,1148,39905,3575890151,3575890193,42
2,1148,39906,3575890151,3575890194,43
2,1148,39907,3575890151,3575890195,44
2,1148,39908,3575890151,3575890196,45
2,1148,39909,3575890151,3575890196,45
2,1148,39910,3575890151,3575890197,46
2,1148,39911,3575890151,3575890198,47
2,1148,39912,3575890151,3575890199,48
2,1148,39913,3575890151,3575890200,49
2,1148,39914,3575890151,3575890200,49
2,1148,39915,3575890151,3575890200,49
2,1149,39916,3575890215,3575890215,0
2,1149,39917,3575890215,3575890215,0
2,1149,39918,3575890215,3575890215,0
2,1149,39919,3575890215,3575890215,0
2,1149,39920,3575890215,3575890215,0
2,1149,39921,3575890215,3575890215,0
2,1149,39922,3575890215,3575890215,0
2,1149,39923,3575890215,3575890215,0
2,1149,39924,3575890215,3575890215,0
2,1149,39925,3575890215,3575890215,0
2,1149,39926,3575890215,3575890215,0
2,1149,39927,3575890215,3575890215,0
2,1149,39928,3575890215,3575890215,0
2,1149,39929,3575890215,3575890219,4
2,1149,39930,3575890215,3575890221,6
2,1149,39931,3575890215,3575890222,7
2,1149,39932,3575890215,3575890223,8
2,1149,39933,3575890215,3575890223,8
2,1149,39934,3575890215,3575890224,9
2,1149,39935,3575890215,3575890225,10
2,1149,39936,3575890215,3575890226,11
2,1149,39937,3575890215,3575890227,12
2,1149,39938,3575890215,3575890227,12
2,1149,39939,3575890215,3575890228,13
2,1149,39940,3575890215,3575890228,13
2,1149,39941,3575890215,3575890228,13
2,1149,39942,3575890215,3575890228,13
2,1149,39943,3575890215,3575890229,14
2,1149,39944,3575890215,3575890229,14
2,1149,39945,3575890215,3575890233,18
2,1149,39946,3575890215,3575890235,20
2,1149,39947,3575890215,3575890236,21
2,1149,39948,3575890215,3575890237,22
2,1149,39949,3575890215,3575890238,23
2,1149,39950,3575890215,3575890238,23
2,1149,39951,3575890215,3575890239,24
2,1149,39952,3575890215,3575890239,24
2,1149,39953,3575890215,3575890240,25
2,1149,39954,3575890215,3575890240,25
2,1149,39955,3575890215,3575890243,28
2,1149,39956,3575890215,3575890243,28
2,1149,39957,3575890215,3575890245,30
2,1149,39958,3575890215,3575890245,30
2,1149,39959,3575890215,3575890246,31
2,1149,39960,3575890215,3575890248,33
2,1149,39961,3575890215,3575890251,36
2,1149,39962,3575890215,3575890253,38
2,1149,39963,3575890215,3575890254,39
2,1149,39964,3575890215,3575890254,39
2,1149,39965,3575890215,3575890255,40
2,1149,39966,3575890215,3575890256,41
2,1149,39967,3575890215,3575890256,41
2,1149,39968,3575890215,3575890256,41
2,1149,39969,3575890215,3575890256,41
2,1149,39970,3575890215,3575890256,41
2,1149,39971,3575890215,3575890256,41
2,1149,39972,3575890215,3575890257,42
2,1149,39973,3575890215,3575890259,44
2,1149,39974,3575890215,3575890259,44
2,1149,39975,3575890215,3575890259,44
2,1149,39976,3575890215,3575890261,46
2,1149,39977,3575890215,3575890262,47
2,1149,39978,3575890215,3575890265,50
2,1150,39979,3575890277,3575890277,0
2,1150,39980,3575890277,3575890277,0
2,1150,39981,3575890277,3575890277,0
2,1150,39982,3575890277,3575890277,0
2,1150,39983,3575890277,3575890280,3
2,1150,39984,3575890277,3575890281,4
2,1150,39985,3575890277,3575890283,6
2,1150,39986,3575890277,3575890284,7
2,1150,39987,3575890277,3575890284,7
2,1150,39988,3575890277,3575890285,8
2,1150,39989,3575890277,3575890286,9
2,1150,39990,3575890277,3575890288,11
2,1150,39991,3575890277,3575890288,11
2,1150,39992,3575890277,3575890288,11
2,1150,39993,3575890277,3575890289,12
2,1150,39994,3575890277,3575890289,12
2,1150,39995,3575890277,3575890290,13
2,1150,39996,3575890277,3575890291,14
2,1150,39997,3575890277,3575890291,14
2,1150,39998,3575890277,3575890291,14
2,1150,39999,3575890277,3575890292,15
2,1150,40000,3575890277,3575890292,15
2,1150,40001,3575890277,3575890292,15
2,1150,40002,3575890277,3575890294,17
2,1150,40003,3575890277,3575890294,17
2,1150,40004,3575890277,3575890294,17
2,1150,40005,3575890277,3575890295,18
2,1150,40006,3575890277,3575890295,18
2,1150,40007,3575890277,3575890296,19
2,1150,40008,3575890277,3575890297,20
2,1150,40009,3575890277,3575890298,21
2,1150,40010,3575890277,3575890298,21
2,1150,40011,3575890277,3575890299,22
2,1150,40012,3575890277,3575890299,22
2,1150,40013,3575890277,3575890300,23
2,1150,40014,3575890277,3575890300,23
2,1150,40015,3575890277,3575890301,24
2,1150,40016,3575890277,3575890302,25
2,1150,40017,3575890277,3575890303,26
2,1150,40018,3575890277,3575890304,27
2,1150,40019,3575890277,3575890305,28
2,1150,40020,3575890277,3575890306,29
2,1150,40021,3575890277,3575890306,29
2,1150,40022,3575890277,3575890306,29
2,1150,40023,3575890277,3575890307,30
2,1150,40024,3575890277,3575890307,30
2,1150,40025,3575890277,3575890307,30
2,1150,40026,3575890277,3575890307,30
2,1150,40027,3575890277,3575890307,30
2,1150,40028,3575890277,3575890308,31
2,1150,40029,3575890277,3575890308,31
2,1150,40030,3575890277,3575890309,32
2,1150,40031,3575890277,3575890309,32
2,1150,40032,3575890277,3575890310,33
2,1150,40033,3575890277,3575890311,34
2,1150,40034,3575890277,3575890311,34
2,1150,40035,3575890277,3575890311,34
2,1150,40036,3575890277,3575890313,36
2,1150,40037,3575890277,3575890313,36
2,1150,40038,3575890277,3575890314,37
2,1150,40039,3575890277,3575890315,38
2,1150,40040,3575890277,3575890317,40
2,1150,40041,3575890277,3575890317,40
2,1150,40042,3575890277,3575890318,41
2,1150,40043,3575890277,3575890318,41
2,1150,40044,3575890277,3575890319,42
2,1150,40045,3575890277,3575890319,42
2,1150,40046,3575890277,3575890319,42
2,1150,40047,3575890277,3575890320,43
2,1150,40048,3575890277,3575890320,43
2,1150,40049,3575890277,3575890321,44
2,1150,40050,3575890277,3575890322,45
2,1150,40051,3575890277,3575890325,48
2,1150,40052,3575890277,3575890326,49
2,1150,40053,3575890277,3575890327,50
2,1151,40054,3575890342,3575890342,0
2,1151,40055,3575890342,3575890342,0
2,1151,40056,3575890342,3575890342,0
2,1151,40057,3575890342,3575890342,0
2,1151,40058,3575890342,3575890342,0
2,1151,40059,3575890342,3575890342,0
2,1151,40060,3575890342,3575890342,0
2,1151,40061,3575890342,3575890342,0
2,1151,40062,3575890342,3575890342,0
2,1151,40063,3575890342,3575890342,0
2,1151,40064,3575890342,3575890342,0
2,1151,40065,3575890342,3575890342,0
2,1151,40066,3575890342,3575890342,0
2,1151,40067,3575890342,3575890342,0
2,1151,40068,3575890342,3575890342,0
2,1151,40069,3575890342,3575890342,0
2,1151,40070,3575890342,3575890342,0
2,1151,40071,3575890342,3575890342,0
2,1151,40072,3575890342,3575890342,0
2,1151,40073,3575890342,3575890342,0
2,1151,40074,3575890342,3575890342,0
2,1151,40075,3575890342,3575890342,0
2,1151,40076,3575890342,3575890342,0
2,1151,40077,3575890342,3575890342,0
2,1151,40078,3575890342,3575890342,0
2,1151,40079,3575890342,3575890342,0
2,1151,40080,3575890342,3575890344,2
2,1151,40081,3575890342,3575890344,2
2,1151,40082,3575890342,3575890344,2
2,1151,40083,3575890342,3575890345,3
2,1151,40084,3575890342,3575890345,3
2,1151,40085,3575890342,3575890346,4
2,1151,40086,3575890342,3575890347,5
2,1151,40087,3575890342,3575890347,5
2,1151,40088,3575890342,3575890349,7
2,1151,40089,3575890342,3575890349,7
2,1151,40090,3575890342,3575890350,8
2,1151,40091,3575890342,3575890350,8
2,1151,40092,3575890342,3575890351,9
2,1151,40093,3575890342,3575890352,10
2,1151,40094,3575890342,3575890352,10
2,1151,40095,3575890342,3575890354,12
2,1151,40096,3575890342,3575890354,12
2,1151,40097,3575890342,3575890355,13
2,1151,40098,3575890342,3575890355,13
2,1151,40099,3575890342,3575890356,14
2,1151,40100,3575890342,3575890357,15
2,1151,40101,3575890342,3575890359,17
2,1151,40102,3575890342,3575890360,18
2,1151,40103,3575890342,3575890360,18
2,1151,40104,3575890342,3575890360,18
2,1151,40105,3575890342,3575890361,19
2,1151,40106,3575890342,3575890361,19
2,1151,40107,3575890342,3575890362,20
2,1151,40108,3575890342,3575890364,22
2,1151,40109,3575890342,3575890365,23
2,1151,40110,3575890342,3575890365,23
2,1151,40111,3575890342,3575890366,24
2,1151,40112,3575890342,3575890367,25
2,1151,40113,3575890342,3575890367,25
2,1151,40114,3575890342,3575890368,26
2,1151,40115,3575890342,3575890368,26
2,1151,40116,3575890342,3575890368,26
2,1151,40117,3575890342,3575890369,27
2,1151,40118,3575890342,3575890369,27
2,1151,40119,3575890342,3575890369,27
2,1151,40120,3575890342,3575890371,29
2,1151,40121,3575890342,3575890371,29
2,1151,40122,3575890342,3575890376,34
2,1151,40123,3575890342,3575890376,34
2,1151,40124,3575890342,3575890376,34
2,1151,40125,3575890342,3575890378,36
2,1151,40126,3575890342,3575890378,36
2,1151,40127,3575890342,3575890380,38
2,1151,40128,3575890342,3575890380,38
2,1151,40129,3575890342,3575890381,39
2,1151,40130,3575890342,3575890382,40
2,1151,40131,3575890342,3575890382,40
2,1151,40132,3575890342,3575890384,42
2,1151,40133,3575890342,3575890384,42
2,1151,40134,3575890342,3575890385,43
2,1151,40135,3575890342,3575890386,44
2,1151,40136,3575890342,3575890386,44
2,1151,40137,3575890342,3575890386,44
2,1151,40138,3575890342,3575890386,44
2,1151,40139,3575890342,3575890388,46
2,1151,40140,3575890342,3575890388,46
2,1151,40141,3575890342,3575890389,47
2,1151,40142,3575890342,3575890389,47
2,1151,40143,3575890342,3575890391,49
2,1151,40144,3575890342,3575890391,49
2,1151,40145,3575890342,3575890391,49
2,1152,40146,3575890405,3575890405,0
2,1152,40147,3575890405,3575890405,0
2,1152,40148,3575890405,3575890405,0
2,1152,40149,3575890405,3575890405,0
2,1152,40150,3575890405,3575890405,0
2,1152,40151,3575890405,3575890405,0
2,1152,40152,3575890405,3575890405,0
2,1152,40153,3575890405,3575890405,0
2,1152,40154,3575890405,3575890405,0
2,1152,40155,3575890405,3575890405,0
2,1152,40156,3575890405,3575890405,0
2,1152,40157,3575890405,3575890405,0
2,1152,40158,3575890405,3575890405,0
2,1152,40159,3575890405,3575890405,0
2,1152,40160,3575890405,3575890405,0
2,1152,40161,3575890405,3575890405,0
2,1152,40162,3575890405,3575890405,0
2,1152,40163,3575890405,3575890405,0
2,1152,40164,3575890405,3575890406,1
2,1152,40165,3575890405,3575890407,2
2,1152,40166,3575890405,3575890408,3
2,1152,40167,3575890405,3575890411,6
2,1152,40168,3575890405,3575890411,6
2,1152,40169,3575890405,3575890411,6
2,1152,40170,3575890405,3575890413,8
2,1152,40171,3575890405,3575890413,8
2,1152,40172,3575890405,3575890414,9
2,1152,40173,3575890405,3575890419,14
2,1152,40174,3575890405,3575890420,15
2,1152,40175,3575890405,3575890422,17
2,1152,40176,3575890405,3575890423,18
2,1152,40177,3575890405,3575890423,18
2,1152,40178,3575890405,3575890424,19
2,1152,40179,3575890405,3575890426,21
2,1152,40180,3575890405,3575890427,22
2,1152,40181,3575890405,3575890427,22
2,1152,40182,3575890405,3575890428,23
2,1152,40183,3575890405,3575890428,23
2,1152,40184,3575890405,3575890428,23
2,1152,40185,3575890405,3575890428,23
2,1152,40186,3575890405,3575890428,23
2,1152,40187,3575890405,3575890429,24
2,1152,40188,3575890405,3575890429,24
2,1152,40189,3575890405,3575890430,25
2,1152,40190,3575890405,3575890435,30
2,1152,40191,3575890405,3575890435,30
2,1152,40192,3575890405,3575890436,31
2,1152,40193,3575890405,3575890437,32
2,1152,40194,3575890405,3575890438,33
2,1152,40195,3575890405,3575890439,34
2,1152,40196,3575890405,3575890439,34
2,1152,40197,3575890405,3575890440,35
2,1152,40198,3575890405,3575890440,35
2,1152,40199,3575890405,3575890443,38
2,1152,40200,3575890405,3575890443,38
2,1152,40201,3575890405,3575890445,40
2,1152,40202,3575890405,3575890446,41
2,1152,40203,3575890405,3575890448,43
2,1152,40204,3575890405,3575890448,43
2,1152,40205,3575890405,3575890450,45
2,1153,40206,3575890473,3575890473,0
2,1153,40207,3575890473,3575890473,0
2,1153,40208,3575890473,3575890473,0
2,1153,40209,3575890473,3575890473,0
2,1153,40210,3575890473,3575890473,0
2,1153,40211,3575890473,3575890473,0
2,1153,40212,3575890473,3575890473,0
2,1153,40213,3575890473,3575890473,0
2,1153,40214,3575890473,3575890473,0
2,1153,40215,3575890473,3575890473,0
2,1153,40216,3575890473,3575890473,0
2,1153,40217,3575890473,3575890473,0
2,1153,40218,3575890473,3575890473,0
2,1153,40219,3575890473,3575890473,0
2,1153,40220,3575890473,3575890476,3
2,1153,40221,3575890473,3575890477,4
2,1153,40222,3575890473,3575890480,7
2,1153,40223,3575890473,3575890481,8
2,1153,40224,3575890473,3575890483,10
2,1153,40225,3575890473,3575890484,11
2,1153,40226,3575890473,3575890486,13
2,1153,40227,3575890473,3575890486,13
2,1153,40228,3575890473,3575890487,14
2,1153,40229,3575890473,3575890488,15
2,1153,40230,3575890473,3575890488,15
2,1153,40231,3575890473,3575890489,16
2,1153,40232,3575890473,3575890490,17
2,1153,40233,3575890473,3575890491,18
2,1153,40234,3575890473,3575890491,18
2,1153,40235,3575890473,3575890491,18
2,1153,40236,3575890473,3575890492,19
2,1153,40237,3575890473,3575890492,19
2,1153,40238,3575890473,3575890492,19
2,1153,40239,3575890473,3575890492,19
2,1153,40240,3575890473,3575890493,20
2,1153,40241,3575890473,3575890494,21
2,1153,40242,3575890473,3575890494,21
2,1153,40243,3575890473,3575890495,22
2,1153,40244,3575890473,3575890495,22
2,1153,40245,3575890473,3575890495,22
2,1153,40246,3575890473,3575890496,23
2,1153,40247,3575890473,3575890497,24
2,1153,40248,3575890473,3575890498,25
2,1153,40249,3575890473,3575890499,26
2,1153,40250,3575890473,3575890499,26
2,1153,40251,3575890473,3575890500,27
2,1153,40252,3575890473,3575890501,28
2,1153,40253,3575890473,3575890503,30
2,1153,40254,3575890473,3575890504,31
2,1153,40255,3575890473,3575890505,32
2,1153,40256,3575890473,3575890506,33
2,1153,40257,3575890473,3575890506,33
2,1153,40258,3575890473,3575890506,33
2,1153,40259,3575890473,3575890507,34
2,1153,40260,3575890473,3575890507,34
2,1153,40261,3575890473,3575890507,34
2,1153,40262,3575890473,3575890508,35
2,1153,40263,3575890473,3575890508,35
2,1153,40264,3575890473,3575890508,35
2,1153,40265,3575890473,3575890508,35
2,1153,40266,3575890473,3575890508,35
2,1153,40267,3575890473,3575890509,36
2,1153,40268,3575890473,3575890510,37
2,1153,40269,3575890473,3575890510,37
2,1153,40270,3575890473,3575890510,37
2,1153,40271,3575890473,3575890511,38
2,1153,40272,3575890473,3575890512,39
2,1153,40273,3575890473,3575890513,40
2,1153,40274,3575890473,3575890514,41
2,1153,40275,3575890473,3575890514,41
2,1153,40276,3575890473,3575890514,41
2,1153,40277,3575890473,3575890516,43
2,1153,40278,3575890473,3575890517,44
2,1153,40279,3575890473,3575890518,45
2,1153,40280,3575890473,3575890518,45
2,1153,40281,3575890473,3575890518,45
2,1153,40282,3575890473,3575890519,46
2,1153,40283,3575890473,3575890519,46
2,1153,40284,3575890473,3575890519,46
2,1153,40285,3575890473,3575890520,47
2,1153,40286,3575890473,3575890521,48
2,1153,40287,3575890473,3575890521,48
2,1153,40288,3575890473,3575890522,49
2,1153,40289,3575890473,3575890522,49
2,1154,40290,3575890535,3575890535,0
2,1154,40291,3575890535,3575890535,0
2,1154,40292,3575890535,3575890535,0
2,1154,40293,3575890535,3575890535,0
2,1154,40294,3575890535,3575890535,0
2,1154,40295,3575890535,3575890535,0
2,1154,40296,3575890535,3575890535,0
2,1154,40297,3575890535,3575890535,0
2,1154,40298,3575890535,3575890535,0
2,1154,40299,3575890535,3575890535,0
2,1154,40300,3575890535,3575890535,0
2,1154,40301,3575890535,3575890535,0
2,1154,40302,3575890535,3575890535,0
2,1154,40303,3575890535,3575890535,0
2,1154,40304,3575890535,3575890535,0
2,1154,40305,3575890535,3575890535,0
2,1154,40306,3575890535,3575890535,0
2,1154,40307,3575890535,3575890535,0
2,1154,40308,3575890535,3575890535,0
2,1154,40309,3575890535,3575890535,0
2,1154,40310,3575890535,3575890535,0
2,1154,40311,3575890535,3575890536,1
2,1154,40312,3575890535,3575890536,1
2,1154,40313,3575890535,3575890536,1
2,1154,40314,3575890535,3575890537,2
2,1154,40315,3575890535,3575890539,4
2,1154,40316,3575890535,3575890539,4
2,1154,40317,3575890535,3575890539,4
2,1154,40318,3575890535,3575890540,5
2,1154,40319,3575890535,3575890543,8
2,1154,40320,3575890535,3575890544,9
2,1154,40321,3575890535,3575890544,9
2,1154,40322,3575890535,3575890544,9
2,1154,40323,3575890535,3575890544,9
2,1154,40324,3575890535,3575890545,10
2,1154,40325,3575890535,3575890545,10
2,1154,40326,3575890535,3575890547,12
2,1154,40327,3575890535,3575890548,13
2,1154,40328,3575890535,3575890548,13
2,1154,40329,3575890535,3575890549,14
2,1154,40330,3575890535,3575890549,14
2,1154,40331,3575890535,3575890550,15
2,1154,40332,3575890535,3575890550,15
2,1154,40333,3575890535,3575890551,16
2,1154,40334,3575890535,3575890551,16
2,1154,40335,3575890535,3575890553,18
2,1154,40336,3575890535,3575890553,18
2,1154,40337,3575890535,3575890554,19
2,1154,40338,3575890535,3575890554,19
2,1154,40339,3575890535,3575890557,22
2,1154,40340,3575890535,3575890558,23
2,1154,40341,3575890535,3575890558,23
2,1154,40342,3575890535,3575890559,24
2,1154,40343,3575890535,3575890559,24
2,1154,40344,3575890535,3575890560,25
2,1154,40345,3575890535,3575890560,25
2,1154,40346,3575890535,3575890560,25
2,1154,40347,3575890535,3575890561,26
2,1154,40348,3575890535,3575890563,28
2,1154,40349,3575890535,3575890564,29
2,1154,40350,3575890535,3575890564,29
2,1154,40351,3575890535,3575890566,31
2,1154,40352,3575890535,3575890566,31
2,1154,40353,3575890535,3575890567,32
2,1154,40354,3575890535,3575890568,33
2,1154,40355,3575890535,3575890568,33
2,1154,40356,3575890535,3575890568,33
2,1154,40357,3575890535,3575890569,34
2,1154,40358,3575890535,3575890570,35
2,1154,40359,3575890535,3575890571,36
2,1154,40360,3575890535,3575890574,39
2,1154,40361,3575890535,3575890575,40
2,1154,40362,3575890535,3575890576,41
2,1154,40363,3575890535,3575890576,41
2,1154,40364,3575890535,3575890577,42
2,1154,40365,3575890535,3575890577,42
2,1154,40366,3575890535,3575890578,43
2,1154,40367,3575890535,3575890579,44
2,1154,40368,3575890535,3575890581,46
2,1154,40369,3575890535,3575890581,46
2,1154,40370,3575890535,3575890581,46
2,1154,40371,3575890535,3575890581,46
2,1154,40372,3575890535,3575890583,48
2,1154,40373,3575890535,3575890583,48
2,1154,40374,3575890535,3575890584,49
2,1154,40375,3575890535,3575890584,49
2,1154,40376,3575890535,3575890585,50
2,1155,40377,3575890597,3575890597,0
2,1155,40378,3575890597,3575890597,0
2,1155,40379,3575890597,3575890597,0
2,1155,40380,3575890597,3575890597,0
2,1155,40381,3575890597,3575890597,0
2,1155,40382,3575890597,3575890597,0
2,1155,40383,3575890597,3575890597,0
2,1155,40384,3575890597,3575890597,0
2,1155,40385,3575890597,3575890597,0
2,1155,40386,3575890597,3575890597,0
2,1155,40387,3575890597,3575890597,0
2,1155,40388,3575890597,3575890597,0
2,1155,40389,3575890597,3575890597,0
2,1155,40390,3575890597,3575890597,0
2,1155,40391,3575890597,3575890597,0
2,1155,40392,3575890597,3575890597,0
2,1155,40393,3575890597,3575890597,0
2,1155,40394,3575890597,3575890597,0
2,1155,40395,3575890597,3575890597,0
2,1155,40396,3575890597,3575890597,0
2,1155,40397,3575890597,3575890598,1
2,1155,40398,3575890597,3575890599,2
2,1155,40399,3575890597,3575890599,2
2,1155,40400,3575890597,3575890600,3
2,1155,40401,3575890597,3575890603,6
2,1155,40402,3575890597,3575890603,6
2,1155,40403,3575890597,3575890603,6
2,1155,40404,3575890597,3575890603,6
2,1155,40405,3575890597,3575890604,7
2,1155,40406,3575890597,3575890604,7
2,1155,40407,3575890597,3575890606,9
2,1155,40408,3575890597,3575890607,10
2,1155,40409,3575890597,3575890610,13
2,1155,40410,3575890597,3575890611,14
2,1155,40411,3575890597,3575890611,14
2,1155,40412,3575890597,3575890612,15
2,1155,40413,3575890597,3575890612,15
2,1155,40414,3575890597,3575890613,16
2,1155,40415,3575890597,3575890618,21
2,1155,40416,3575890597,3575890620,23
2,1155,40417,3575890597,3575890621,24
2,1155,40418,3575890597,3575890622,25
2,1155,40419,3575890597,3575890623,26
2,1155,40420,3575890597,3575890623,26
2,1155,40421,3575890597,3575890625,28
2,1155,40422,3575890597,3575890626,29
2,1155,40423,3575890597,3575890626,29
2,1155,40424,3575890597,3575890626,29
2,1155,40425,3575890597,3575890626,29
2,1155,40426,3575890597,3575890627,30
2,1155,40427,3575890597,3575890627,30
2,1155,40428,3575890597,3575890627,30
2,1155,40429,3575890597,3575890628,31
2,1155,40430,3575890597,3575890628,31
2,1155,40431,3575890597,3575890629,32
2,1155,40432,3575890597,3575890634,37
2,1155,40433,3575890597,3575890634,37
2,1155,40434,3575890597,3575890635,38
2,1155,40435,3575890597,3575890636,39
2,1155,40436,3575890597,3575890637,40
2,1155,40437,3575890597,3575890638,41
2,1155,40438,3575890597,3575890638,41
2,1155,40439,3575890597,3575890639,42
2,1155,40440,3575890597,3575890639,42
2,1155,40441,3575890597,3575890641,44
2,1155,40442,3575890597,3575890642,45
2,1155,40443,3575890597,3575890644,47
2,1155,40444,3575890597,3575890646,49
2,1156,40445,3575890661,3575890661,0
2,1156,40446,3575890661,3575890661,0
2,1156,40447,3575890661,3575890661,0
2,1156,40448,3575890661,3575890661,0
2,1156,40449,3575890661,3575890661,0
2,1156,40450,3575890661,3575890661,0
2,1156,40451,3575890661,3575890661,0
2,1156,40452,3575890661,3575890661,0
2,1156,40453,3575890661,3575890661,0
2,1156,40454,3575890661,3575890661,0
2,1156,40455,3575890661,3575890661,0
2,1156,40456,3575890661,3575890661,0
2,1156,40457,3575890661,3575890661,0
2,1156,40458,3575890661,3575890661,0
2,1156,40459,3575890661,3575890661,0
2,1156,40460,3575890661,3575890661,0
2,1156,40461,3575890661,3575890665,4
2,1156,40462,3575890661,3575890665,4
2,1156,40463,3575890661,3575890666,5
2,1156,40464,3575890661,3575890676,15
2,1156,40465,3575890661,3575890678,17
2,1156,40466,3575890661,3575890680,19
2,1156,40467,3575890661,3575890681,20
2,1156,40468,3575890661,3575890683,22
2,1156,40469,3575890661,3575890683,22
2,1156,40470,3575890661,3575890684,23
2,1156,40471,3575890661,3575890686,25
2,1156,40472,3575890661,3575890686,25
2,1156,40473,3575890661,3575890688,27
2,1156,40474,3575890661,3575890688,27
2,1156,40475,3575890661,3575890688,27
2,1156,40476,3575890661,3575890689,28
2,1156,40477,3575890661,3575890690,29
2,1156,40478,3575890661,3575890691,30
2,1156,40479,3575890661,3575890691,30
2,1156,40480,3575890661,3575890692,31
2,1156,40481,3575890661,3575890692,31
2,1156,40482,3575890661,3575890692,31
2,1156,40483,3575890661,3575890693,32
2,1156,40484,3575890661,3575890693,32
2,1156,40485,3575890661,3575890693,32
2,1156,40486,3575890661,3575890694,33
2,1156,40487,3575890661,3575890694,33
2,1156,40488,3575890661,3575890694,33
2,1156,40489,3575890661,3575890695,34
2,1156,40490,3575890661,3575890695,34
2,1156,40491,3575890661,3575890697,36
2,1156,40492,3575890661,3575890697,36
2,1156,40493,3575890661,3575890698,37
2,1156,40494,3575890661,3575890699,38
2,1156,40495,3575890661,3575890699,38
2,1156,40496,3575890661,3575890699,38
2,1156,40497,3575890661,3575890700,39
2,1156,40498,3575890661,3575890702,41
2,1156,40499,3575890661,3575890703,42
2,1156,40500,3575890661,3575890704,43
2,1156,40501,3575890661,3575890706,45
2,1156,40502,3575890661,3575890706,45
2,1156,40503,3575890661,3575890706,45
2,1156,40504,3575890661,3575890707,46
2,1156,40505,3575890661,3575890707,46
2,1156,40506,3575890661,3575890707,46
2,1156,40507,3575890661,3575890707,46
2,1156,40508,3575890661,3575890707,46
2,1156,40509,3575890661,3575890708,47
2,1156,40510,3575890661,3575890708,47
2,1156,40511,3575890661,3575890708,47
2,1156,40512,3575890661,3575890708,47
2,1156,40513,3575890661,3575890709,48
2,1156,40514,3575890661,3575890709,48
2,1156,40515,3575890661,3575890710,49
2,1156,40516,3575890661,3575890711,50
2,1157,40517,3575890724,3575890724,0
2,1157,40518,3575890724,3575890724,0
2,1157,40519,3575890724,3575890724,0
2,1157,40520,3575890724,3575890724,0
2,1157,40521,3575890724,3575890724,0
2,1157,40522,3575890724,3575890724,0
2,1157,40523,3575890724,3575890724,0
2,1157,40524,3575890724,3575890724,0
2,1157,40525,3575890724,3575890724,0
2,1157,40526,3575890724,3575890724,0
2,1157,40527,3575890724,3575890724,0
2,1157,40528,3575890724,3575890724,0
2,1157,40529,3575890724,3575890724,0
2,1157,40530,3575890724,3575890724,0
2,1157,40531,3575890724,3575890724,0
2,1157,40532,3575890724,3575890724,0
2,1157,40533,3575890724,3575890724,0
2,1157,40534,3575890724,3575890724,0
2,1157,40535,3575890724,3575890724,0
2,1157,40536,3575890724,3575890725,1
2,1157,40537,3575890724,3575890726,2
2,1157,40538,3575890724,3575890726,2
2,1157,40539,3575890724,3575890727,3
2,1157,40540,3575890724,3575890727,3
2,1157,40541,3575890724,3575890728,4
2,1157,40542,3575890724,3575890729,5
2,1157,40543,3575890724,3575890729,5
2,1157,40544,3575890724,3575890729,5
2,1157,40545,3575890724,3575890731,7
2,1157,40546,3575890724,3575890731,7
2,1157,40547,3575890724,3575890732,8
2,1157,40548,3575890724,3575890732,8
2,1157,40549,3575890724,3575890733,9
2,1157,40550,3575890724,3575890734,10
2,1157,40551,3575890724,3575890734,10
2,1157,40552,3575890724,3575890734,10
2,1157,40553,3575890724,3575890735,11
2,1157,40554,3575890724,3575890735,11
2,1157,40555,3575890724,3575890735,11
2,1157,40556,3575890724,3575890737,13
2,1157,40557,3575890724,3575890737,13
2,1157,40558,3575890724,3575890739,15
2,1157,40559,3575890724,3575890739,15
2,1157,40560,3575890724,3575890740,16
2,1157,40561,3575890724,3575890743,19
2,1157,40562,3575890724,3575890744,20
2,1157,40563,3575890724,3575890744,20
2,1157,40564,3575890724,3575890744,20
2,1157,40565,3575890724,3575890744,20
2,1157,40566,3575890724,3575890745,21
2,1157,40567,3575890724,3575890745,21
2,1157,40568,3575890724,3575890747,23
2,1157,40569,3575890724,3575890747,23
2,1157,40570,3575890724,3575890748,24
2,1157,40571,3575890724,3575890749,25
2,1157,40572,3575890724,3575890750,26
2,1157,40573,3575890724,3575890750,26
2,1157,40574,3575890724,3575890751,27
2,1157,40575,3575890724,3575890751,27
2,1157,40576,3575890724,3575890752,28
2,1157,40577,3575890724,3575890752,28
2,1157,40578,3575890724,3575890753,29
2,1157,40579,3575890724,3575890753,29
2,1157,40580,3575890724,3575890754,30
2,1157,40581,3575890724,3575890755,31
2,1157,40582,3575890724,3575890756,32
2,1157,40583,3575890724,3575890758,34
2,1157,40584,3575890724,3575890759,35
2,1157,40585,3575890724,3575890759,35
2,1157,40586,3575890724,3575890759,35
2,1157,40587,3575890724,3575890760,36
2,1157,40588,3575890724,3575890760,36
2,1157,40589,3575890724,3575890760,36
2,1157,40590,3575890724,3575890763,39
2,1157,40591,3575890724,3575890763,39
2,1157,40592,3575890724,3575890765,41
2,1157,40593,3575890724,3575890766,42
2,1157,40594,3575890724,3575890766,42
2,1157,40595,3575890724,3575890767,43
2,1157,40596,3575890724,3575890767,43
2,1157,40597,3575890724,3575890768,44
2,1157,40598,3575890724,3575890768,44
2,1157,40599,3575890724,3575890769,45
2,1157,40600,3575890724,3575890770,46
2,1157,40601,3575890724,3575890770,46
2,1157,40602,3575890724,3575890771,47
2,1157,40603,3575890724,3575890774,50
2,1158,40604,3575890786,3575890786,0
2,1158,40605,3575890786,3575890786,0
2,1158,40606,3575890786,3575890786,0
2,1158,40607,3575890786,3575890786,0
2,1158,40608,3575890786,3575890786,0
2,1158,40609,3575890786,3575890786,0
2,1158,40610,3575890786,3575890786,0
2,1158,40611,3575890786,3575890786,0
2,1158,40612,3575890786,3575890786,0
2,1158,40613,3575890786,3575890786,0
2,1158,40614,3575890786,3575890786,0
2,1158,40615,3575890786,3575890786,0
2,1158,40616,3575890786,3575890786,0
2,1158,40617,3575890786,3575890786,0
2,1158,40618,3575890786,3575890786,0
2,1158,40619,3575890786,3575890786,0
2,1158,40620,3575890786,3575890786,0
2,1158,40621,3575890786,3575890786,0
2,1158,40622,3575890786,3575890786,0
2,1158,40623,3575890786,3575890786,0
2,1158,40624,3575890786,3575890787,1
2,1158,40625,3575890786,3575890788,2
2,1158,40626,3575890786,3575890788,2
2,1158,40627,3575890786,3575890788,2
2,1158,40628,3575890786,3575890789,3
2,1158,40629,3575890786,3575890790,4
2,1158,40630,3575890786,3575890790,4
2,1158,40631,3575890786,3575890790,4
2,1158,40632,3575890786,3575890791,5
2,1158,40633,3575890786,3575890792,6
2,1158,40634,3575890786,3575890793,7
2,1158,40635,3575890786,3575890794,8
2,1158,40636,3575890786,3575890794,8
2,1158,40637,3575890786,3575890794,8
2,1158,40638,3575890786,3575890795,9
2,1158,40639,3575890786,3575890796,10
2,1158,40640,3575890786,3575890796,10
2,1158,40641,3575890786,3575890797,11
2,1158,40642,3575890786,3575890798,12
2,1158,40643,3575890786,3575890799,13
2,1158,40644,3575890786,3575890799,13
2,1158,40645,3575890786,3575890800,14
2,1158,40646,3575890786,3575890803,17
2,1158,40647,3575890786,3575890803,17
2,1158,40648,3575890786,3575890803,17
2,1158,40649,3575890786,3575890804,18
2,1158,40650,3575890786,3575890805,19
2,1158,40651,3575890786,3575890807,21
2,1158,40652,3575890786,3575890810,24
2,1158,40653,3575890786,3575890812,26
2,1158,40654,3575890786,3575890812,26
2,1158,40655,3575890786,3575890813,27
2,1158,40656,3575890786,3575890813,27
2,1158,40657,3575890786,3575890813,27
2,1158,40658,3575890786,3575890819,33
2,1158,40659,3575890786,3575890821,35
2,1158,40660,3575890786,3575890821,35
2,1158,40661,3575890786,3575890823,37
2,1158,40662,3575890786,3575890823,37
2,1158,40663,3575890786,3575890823,37
2,1158,40664,3575890786,3575890825,39
2,1158,40665,3575890786,3575890826,40
2,1158,40666,3575890786,3575890826,40
2,1158,40667,3575890786,3575890827,41
2,1158,40668,3575890786,3575890827,41
2,1158,40669,3575890786,3575890827,41
2,1158,40670,3575890786,3575890828,42
2,1158,40671,3575890786,3575890828,42
2,1158,40672,3575890786,3575890829,43
2,1158,40673,3575890786,3575890829,43
2,1158,40674,3575890786,3575890830,44
2,1158,40675,3575890786,3575890834,48
2,1158,40676,3575890786,3575890835,49
2,1158,40677,3575890786,3575890835,49
2,1159,40678,3575890850,3575890850,0
2,1159,40679,3575890850,3575890850,0
2,1159,40680,3575890850,3575890850,0
2,1159,40681,3575890850,3575890850,0
2,1159,40682,3575890850,3575890850,0
2,1159,40683,3575890850,3575890850,0
2,1159,40684,3575890850,3575890850,0
2,1159,40685,3575890850,3575890850,0
2,1159,40686,3575890850,3575890850,0
2,1159,40687,3575890850,3575890850,0
2,1159,40688,3575890850,3575890850,0
2,1159,40689,3575890850,3575890850,0
2,1159,40690,3575890850,3575890850,0
2,1159,40691,3575890850,3575890853,3
2,1159,40692,3575890850,3575890854,4
2,1159,40693,3575890850,3575890855,5
2,1159,40694,3575890850,3575890855,5
2,1159,40695,3575890850,3575890855,5
2,1159,40696,3575890850,3575890856,6
2,1159,40697,3575890850,3575890856,6
2,1159,40698,3575890850,3575890857,7
2,1159,40699,3575890850,3575890858,8
2,1159,40700,3575890850,3575890859,9
2,1159,40701,3575890850,3575890860,10
2,1159,40702,3575890850,3575890861,11
2,1159,40703,3575890850,3575890865,15
2,1159,40704,3575890850,3575890865,15
2,1159,40705,3575890850,3575890866,16
2,1159,40706,3575890850,3575890867,17
2,1159,40707,3575890850,3575890875,25
2,1159,40708,3575890850,3575890877,27
2,1159,40709,3575890850,3575890880,30
2,1159,40710,3575890850,3575890881,31
2,1159,40711,3575890850,3575890884,34
2,1159,40712,3575890850,3575890884,34
2,1159,40713,3575890850,3575890884,34
2,1159,40714,3575890850,3575890885,35
2,1159,40715,3575890850,3575890886,36
2,1159,40716,3575890850,3575890887,37
2,1159,40717,3575890850,3575890888,38
2,1159,40718,3575890850,3575890888,38
2,1159,40719,3575890850,3575890888,38
2,1159,40720,3575890850,3575890888,38
2,1159,40721,3575890850,3575890888,38
2,1159,40722,3575890850,3575890890,40
2,1159,40723,3575890850,3575890891,41
2,1159,40724,3575890850,3575890891,41
2,1159,40725,3575890850,3575890892,42
2,1159,40726,3575890850,3575890892,42
2,1159,40727,3575890850,3575890892,42
2,1159,40728,3575890850,3575890892,42
2,1159,40729,3575890850,3575890893,43
2,1159,40730,3575890850,3575890893,43
2,1159,40731,3575890850,3575890894,44
2,1159,40732,3575890850,3575890894,44
2,1159,40733,3575890850,3575890895,45
2,1159,40734,3575890850,3575890895,45
2,1159,40735,3575890850,3575890896,46
2,1159,40736,3575890850,3575890896,46
2,1159,40737,3575890850,3575890897,47
2,1159,40738,3575890850,3575890898,48
2,1159,40739,3575890850,3575890899,49
2,1159,40740,3575890850,3575890899,49
2,1159,40741,3575890850,3575890900,50
2,1159,40742,3575890850,3575890900,50
2,1160,40743,3575890914,3575890914,0
2,1160,40744,3575890914,3575890914,0
2,1160,40745,3575890914,3575890914,0
2,1160,40746,3575890914,3575890914,0
2,1160,40747,3575890914,3575890914,0
2,1160,40748,3575890914,3575890914,0
2,1160,40749,3575890914,3575890914,0
2,1160,40750,3575890914,3575890914,0
2,1160,40751,3575890914,3575890914,0
2,1160,40752,3575890914,3575890914,0
2,1160,40753,3575890914,3575890914,0
2,1160,40754,3575890914,3575890914,0
2,1160,40755,3575890914,3575890914,0
2,1160,40756,3575890914,3575890914,0
2,1160,40757,3575890914,3575890914,0
2,1160,40758,3575890914,3575890914,0
2,1160,40759,3575890914,3575890914,0
2,1160,40760,3575890914,3575890914,0
2,1160,40761,3575890914,3575890914,0
2,1160,40762,3575890914,3575890914,0
2,1160,40763,3575890914,3575890914,0
2,1160,40764,3575890914,3575890915,1
2,1160,40765,3575890914,3575890915,1
2,1160,40766,3575890914,3575890915,1
2,1160,40767,3575890914,3575890915,1
2,1160,40768,3575890914,3575890915,1
2,1160,40769,3575890914,3575890917,3
2,1160,40770,3575890914,3575890918,4
2,1160,40771,3575890914,3575890918,4
2,1160,40772,3575890914,3575890918,4
2,1160,40773,3575890914,3575890919,5
2,1160,40774,3575890914,3575890919,5
2,1160,40775,3575890914,3575890919,5
2,1160,40776,3575890914,3575890920,6
2,1160,40777,3575890914,3575890921,7
2,1160,40778,3575890914,3575890922,8
2,1160,40779,3575890914,3575890922,8
2,1160,40780,3575890914,3575890922,8
2,1160,40781,3575890914,3575890922,8
2,1160,40782,3575890914,3575890925,11
2,1160,40783,3575890914,3575890926,12
2,1160,40784,3575890914,3575890926,12
2,1160,40785,3575890914,3575890926,12
2,1160,40786,3575890914,3575890927,13
2,1160,40787,3575890914,3575890928,14
2,1160,40788,3575890914,3575890929,15
2,1160,40789,3575890914,3575890929,15
2,1160,40790,3575890914,3575890930,16
2,1160,40791,3575890914,3575890931,17
2,1160,40792,3575890914,3575890931,17
2,1160,40793,3575890914,3575890932,18
2,1160,40794,3575890914,3575890933,19
2,1160,40795,3575890914,3575890933,19
2,1160,40796,3575890914,3575890934,20
2,1160,40797,3575890914,3575890934,20
2,1160,40798,3575890914,3575890935,21
2,1160,40799,3575890914,3575890936,22
2,1160,40800,3575890914,3575890936,22
2,1160,40801,3575890914,3575890937,23
2,1160,40802,3575890914,3575890939,25
2,1160,40803,3575890914,3575890939,25
2,1160,40804,3575890914,3575890940,26
2,1160,40805,3575890914,3575890940,26
2,1160,40806,3575890914,3575890943,29
2,1160,40807,3575890914,3575890944,30
2,1160,40808,3575890914,3575890944,30
2,1160,40809,3575890914,3575890945,31
2,1160,40810,3575890914,3575890945,31
2,1160,40811,3575890914,3575890945,31
2,1160,40812,3575890914,3575890947,33
2,1160,40813,3575890914,3575890947,33
2,1160,40814,3575890914,3575890948,34
2,1160,40815,3575890914,3575890949,35
2,1160,40816,3575890914,3575890949,35
2,1160,40817,3575890914,3575890950,36
2,1160,40818,3575890914,3575890951,37
2,1160,40819,3575890914,3575890951,37
2,1160,40820,3575890914,3575890952,38
2,1160,40821,3575890914,3575890953,39
2,1160,40822,3575890914,3575890954,40
2,1160,40823,3575890914,3575890954,40
2,1160,40824,3575890914,3575890954,40
2,1160,40825,3575890914,3575890956,42
2,1160,40826,3575890914,3575890957,43
2,1160,40827,3575890914,3575890958,44
2,1160,40828,3575890914,3575890959,45
2,1160,40829,3575890914,3575890959,45
2,1160,40830,3575890914,3575890960,46
2,1160,40831,3575890914,3575890960,46
2,1160,40832,3575890914,3575890960,46
2,1160,40833,3575890914,3575890961,47
2,1160,40834,3575890914,3575890963,49
2,1160,40835,3575890914,3575890964,50
2,1161,40836,3575890977,3575890977,0
2,1161,40837,3575890977,3575890977,0
2,1161,40838,3575890977,3575890977,0
2,1161,40839,3575890977,3575890977,0
2,1161,40840,3575890977,3575890977,0
2,1161,40841,3575890977,3575890977,0
2,1161,40842,3575890977,3575890977,0
2,1161,40843,3575890977,3575890977,0
2,1161,40844,3575890977,3575890977,0
2,1161,40845,3575890977,3575890977,0
2,1161,40846,3575890977,3575890977,0
2,1161,40847,3575890977,3575890977,0
2,1161,40848,3575890977,3575890977,0
2,1161,40849,3575890977,3575890977,0
2,1161,40850,3575890977,3575890977,0
2,1161,40851,3575890977,3575890977,0
2,1161,40852,3575890977,3575890977,0
2,1161,40853,3575890977,3575890977,0
2,1161,40854,3575890977,3575890977,0
2,1161,40855,3575890977,3575890977,0
2,1161,40856,3575890977,3575890978,1
2,1161,40857,3575890977,3575890978,1
2,1161,40858,3575890977,3575890978,1
2,1161,40859,3575890977,3575890979,2
2,1161,40860,3575890977,3575890980,3
2,1161,40861,3575890977,3575890981,4
2,1161,40862,3575890977,3575890981,4
2,1161,40863,3575890977,3575890981,4
2,1161,40864,3575890977,3575890982,5
2,1161,40865,3575890977,3575890983,6
2,1161,40866,3575890977,3575890983,6
2,1161,40867,3575890977,3575890984,7
2,1161,40868,3575890977,3575890984,7
2,1161,40869,3575890977,3575890985,8
2,1161,40870,3575890977,3575890985,8
2,1161,40871,3575890977,3575890986,9
2,1161,40872,3575890977,3575890987,10
2,1161,40873,3575890977,3575890987,10
2,1161,40874,3575890977,3575890987,10
2,1161,40875,3575890977,3575890988,11
2,1161,40876,3575890977,3575890990,13
2,1161,40877,3575890977,3575890991,14
2,1161,40878,3575890977,3575890991,14
2,1161,40879,3575890977,3575890992,15
2,1161,40880,3575890977,3575890993,16
2,1161,40881,3575890977,3575890994,17
2,1161,40882,3575890977,3575890994,17
2,1161,40883,3575890977,3575890994,17
2,1161,40884,3575890977,3575890995,18
2,1161,40885,3575890977,3575890996,19
2,1161,40886,3575890977,3575890997,20
2,1161,40887,3575890977,3575890998,21
2,1161,40888,3575890977,3575890999,22
2,1161,40889,3575890977,3575890999,22
2,1161,40890,3575890977,3575890999,22
2,1161,40891,3575890977,3575891000,23
2,1161,40892,3575890977,3575891003,26
2,1161,40893,3575890977,3575891003,26
2,1161,40894,3575890977,3575891003,26
2,1161,40895,3575890977,3575891004,27
2,1161,40896,3575890977,3575891005,28
2,1161,40897,3575890977,3575891006,29
2,1161,40898,3575890977,3575891008,31
2,1161,40899,3575890977,3575891010,33
2,1161,40900,3575890977,3575891011,34
2,1161,40901,3575890977,3575891012,35
2,1161,40902,3575890977,3575891013,36
2,1161,40903,3575890977,3575891013,36
2,1161,40904,3575890977,3575891013,36
2,1161,40905,3575890977,3575891019,42
2,1161,40906,3575890977,3575891020,43
2,1161,40907,3575890977,3575891022,45
2,1161,40908,3575890977,3575891022,45
2,1161,40909,3575890977,3575891023,46
2,1161,40910,3575890977,3575891023,46
2,1161,40911,3575890977,3575891026,49
2,1161,40912,3575890977,3575891026,49
2,1161,40913,3575890977,3575891026,49
2,1161,40914,3575890977,3575891026,49
2,1161,40915,3575890977,3575891027,50
2,1162,40916,3575891041,3575891041,0
2,1162,40917,3575891041,3575891041,0
2,1162,40918,3575891041,3575891041,0
2,1162,40919,3575891041,3575891041,0
2,1162,40920,3575891041,3575891041,0
2,1162,40921,3575891041,3575891041,0
2,1162,40922,3575891041,3575891041,0
2,1162,40923,3575891041,3575891041,0
2,1162,40924,3575891041,3575891041,0
2,1162,40925,3575891041,3575891041,0
2,1162,40926,3575891041,3575891041,0
2,1162,40927,3575891041,3575891041,0
2,1162,40928,3575891041,3575891041,0
2,1162,40929,3575891041,3575891041,0
2,1162,40930,3575891041,3575891041,0
2,1162,40931,3575891041,3575891041,0
2,1162,40932,3575891041,3575891041,0
2,1162,40933,3575891041,3575891043,2
2,1162,40934,3575891041,3575891043,2
2,1162,40935,3575891041,3575891045,4
2,1162,40936,3575891041,3575891047,6
2,1162,40937,3575891041,3575891049,8
2,1162,40938,3575891041,3575891051,10
2,1162,40939,3575891041,3575891053,12
2,1162,40940,3575891041,3575891054,13
2,1162,40941,3575891041,3575891054,13
2,1162,40942,3575891041,3575891054,13
2,1162,40943,3575891041,3575891054,13
2,1162,40944,3575891041,3575891055,14
2,1162,40945,3575891041,3575891055,14
2,1162,40946,3575891041,3575891056,15
2,1162,40947,3575891041,3575891056,15
2,1162,40948,3575891041,3575891057,16
2,1162,40949,3575891041,3575891057,16
2,1162,40950,3575891041,3575891058,17
2,1162,40951,3575891041,3575891059,18
2,1162,40952,3575891041,3575891060,19
2,1162,40953,3575891041,3575891062,21
2,1162,40954,3575891041,3575891065,24
2,1162,40955,3575891041,3575891066,25
2,1162,40956,3575891041,3575891067,26
2,1162,40957,3575891041,3575891075,34
2,1162,40958,3575891041,3575891078,37
2,1162,40959,3575891041,3575891081,40
2,1162,40960,3575891041,3575891081,40
2,1162,40961,3575891041,3575891083,42
2,1162,40962,3575891041,3575891083,42
2,1162,40963,3575891041,3575891084,43
2,1162,40964,3575891041,3575891086,45
2,1162,40965,3575891041,3575891086,45
2,1162,40966,3575891041,3575891087,46
2,1162,40967,3575891041,3575891087,46
2,1162,40968,3575891041,3575891088,47
2,1162,40969,3575891041,3575891088,47
2,1162,40970,3575891041,3575891089,48
2,1162,40971,3575891041,3575891089,48
2,1162,40972,3575891041,3575891090,49
2,1162,40973,3575891041,3575891091,50
2,1163,40974,3575891103,3575891103,0
2,1163,40975,3575891103,3575891103,0
2,1163,40976,3575891103,3575891103,0
2,1163,40977,3575891103,3575891103,0
2,1163,40978,3575891103,3575891103,0
2,1163,40979,3575891103,3575891103,0
2,1163,40980,3575891103,3575891103,0
2,1163,40981,3575891103,3575891103,0
2,1163,40982,3575891103,3575891103,0
2,1163,40983,3575891103,3575891103,0
2,1163,40984,3575891103,3575891103,0
2,1163,40985,3575891103,3575891103,0
2,1163,40986,3575891103,3575891103,0
2,1163,40987,3575891103,3575891103,0
2,1163,40988,3575891103,3575891103,0
2,1163,40989,3575891103,3575891103,0
2,1163,40990,3575891103,3575891103,0
2,1163,40991,3575891103,3575891103,0
2,1163,40992,3575891103,3575891103,0
2,1163,40993,3575891103,3575891103,0
2,1163,40994,3575891103,3575891104,1
2,1163,40995,3575891103,3575891106,3
2,1163,40996,3575891103,3575891106,3
2,1163,40997,3575891103,3575891107,4
2,1163,40998,3575891103,3575891107,4
2,1163,40999,3575891103,3575891107,4
2,1163,41000,3575891103,3575891108,5
2,1163,41001,3575891103,3575891108,5
2,1163,41002,3575891103,3575891108,5
2,1163,41003,3575891103,3575891108,5
2,1163,41004,3575891103,3575891109,6
2,1163,41005,3575891103,3575891109,6
2,1163,41006,3575891103,3575891109,6
2,1163,41007,3575891103,3575891110,7
2,1163,41008,3575891103,3575891111,8
2,1163,41009,3575891103,3575891112,9
2,1163,41010,3575891103,3575891112,9
2,1163,41011,3575891103,3575891114,11
2,1163,41012,3575891103,3575891115,12
2,1163,41013,3575891103,3575891115,12
2,1163,41014,3575891103,3575891116,13
2,1163,41015,3575891103,3575891116,13
2,1163,41016,3575891103,3575891117,14
2,1163,41017,3575891103,3575891118,15
2,1163,41018,3575891103,3575891118,15
2,1163,41019,3575891103,3575891118,15
2,1163,41020,3575891103,3575891119,16
2,1163,41021,3575891103,3575891119,16
2,1163,41022,3575891103,3575891120,17
2,1163,41023,3575891103,3575891120,17
2,1163,41024,3575891103,3575891121,18
2,1163,41025,3575891103,3575891121,18
2,1163,41026,3575891103,3575891122,19
2,1163,41027,3575891103,3575891123,20
2,1163,41028,3575891103,3575891126,23
2,1163,41029,3575891103,3575891126,23
2,1163,41030,3575891103,3575891126,23
2,1163,41031,3575891103,3575891128,25
2,1163,41032,3575891103,3575891128,25
2,1163,41033,3575891103,3575891129,26
2,1163,41034,3575891103,3575891129,26
2,1163,41035,3575891103,3575891129,26
2,1163,41036,3575891103,3575891129,26
2,1163,41037,3575891103,3575891131,28
2,1163,41038,3575891103,3575891131,28
2,1163,41039,3575891103,3575891132,29
2,1163,41040,3575891103,3575891132,29
2,1163,41041,3575891103,3575891133,30
2,1163,41042,3575891103,3575891133,30
2,1163,41043,3575891103,3575891134,31
2,1163,41044,3575891103,3575891134,31
2,1163,41045,3575891103,3575891135,32
2,1163,41046,3575891103,3575891135,32
2,1163,41047,3575891103,3575891136,33
2,1163,41048,3575891103,3575891137,34
2,1163,41049,3575891103,3575891139,36
2,1163,41050,3575891103,3575891140,37
2,1163,41051,3575891103,3575891140,37
2,1163,41052,3575891103,3575891140,37
2,1163,41053,3575891103,3575891142,39
2,1163,41054,3575891103,3575891144,41
2,1163,41055,3575891103,3575891144,41
2,1163,41056,3575891103,3575891145,42
2,1163,41057,3575891103,3575891145,42
2,1163,41058,3575891103,3575891146,43
2,1163,41059,3575891103,3575891146,43
2,1163,41060,3575891103,3575891147,44
2,1163,41061,3575891103,3575891148,45
2,1163,41062,3575891103,3575891150,47
2,1163,41063,3575891103,3575891150,47
2,1163,41064,3575891103,3575891150,47
2,1163,41065,3575891103,3575891151,48
2,1163,41066,3575891103,3575891152,49
2,1163,41067,3575891103,3575891152,49
2,1163,41068,3575891103,3575891152,49
2,1163,41069,3575891103,3575891153,50
2,1164,41070,3575891169,3575891169,0
2,1164,41071,3575891169,3575891169,0
2,1164,41072,3575891169,3575891169,0
2,1164,41073,3575891169,3575891169,0
2,1164,41074,3575891169,3575891169,0
2,1164,41075,3575891169,3575891169,0
2,1164,41076,3575891169,3575891169,0
2,1164,41077,3575891169,3575891169,0
2,1164,41078,3575891169,3575891169,0
2,1164,41079,3575891169,3575891169,0
2,1164,41080,3575891169,3575891169,0
2,1164,41081,3575891169,3575891169,0
2,1164,41082,3575891169,3575891169,0
2,1164,41083,3575891169,3575891169,0
2,1164,41084,3575891169,3575891169,0
2,1164,41085,3575891169,3575891169,0
2,1164,41086,3575891169,3575891169,0
2,1164,41087,3575891169,3575891169,0
2,1164,41088,3575891169,3575891169,0
2,1164,41089,3575891169,3575891169,0
2,1164,41090,3575891169,3575891169,0
2,1164,41091,3575891169,3575891169,0
2,1164,41092,3575891169,3575891169,0
2,1164,41093,3575891169,3575891170,1
2,1164,41094,3575891169,3575891170,1
2,1164,41095,3575891169,3575891170,1
2,1164,41096,3575891169,3575891170,1
2,1164,41097,3575891169,3575891173,4
2,1164,41098,3575891169,3575891174,5
2,1164,41099,3575891169,3575891175,6
2,1164,41100,3575891169,3575891176,7
2,1164,41101,3575891169,3575891177,8
2,1164,41102,3575891169,3575891178,9
2,1164,41103,3575891169,3575891178,9
2,1164,41104,3575891169,3575891179,10
2,1164,41105,3575891169,3575891180,11
2,1164,41106,3575891169,3575891180,11
2,1164,41107,3575891169,3575891181,12
2,1164,41108,3575891169,3575891181,12
2,1164,41109,3575891169,3575891181,12
2,1164,41110,3575891169,3575891182,13
2,1164,41111,3575891169,3575891183,14
2,1164,41112,3575891169,3575891184,15
2,1164,41113,3575891169,3575891184,15
2,1164,41114,3575891169,3575891184,15
2,1164,41115,3575891169,3575891185,16
2,1164,41116,3575891169,3575891185,16
2,1164,41117,3575891169,3575891185,16
2,1164,41118,3575891169,3575891186,17
2,1164,41119,3575891169,3575891187,18
2,1164,41120,3575891169,3575891187,18
2,1164,41121,3575891169,3575891187,18
2,1164,41122,3575891169,3575891188,19
2,1164,41123,3575891169,3575891188,19
2,1164,41124,3575891169,3575891190,21
2,1164,41125,3575891169,3575891190,21
2,1164,41126,3575891169,3575891191,22
2,1164,41127,3575891169,3575891192,23
2,1164,41128,3575891169,3575891193,24
2,1164,41129,3575891169,3575891194,25
2,1164,41130,3575891169,3575891194,25
2,1164,41131,3575891169,3575891195,26
2,1164,41132,3575891169,3575891196,27
2,1164,41133,3575891169,3575891196,27
2,1164,41134,3575891169,3575891197,28
2,1164,41135,3575891169,3575891198,29
2,1164,41136,3575891169,3575891198,29
2,1164,41137,3575891169,3575891199,30
2,1164,41138,3575891169,3575891199,30
2,1164,41139,3575891169,3575891200,31
2,1164,41140,3575891169,3575891200,31
2,1164,41141,3575891169,3575891203,34
2,1164,41142,3575891169,3575891203,34
2,1164,41143,3575891169,3575891203,34
2,1164,41144,3575891169,3575891204,35
2,1164,41145,3575891169,3575891205,36
2,1164,41146,3575891169,3575891205,36
2,1164,41147,3575891169,3575891206,37
2,1164,41148,3575891169,3575891209,40
2,1164,41149,3575891169,3575891210,41
2,1164,41150,3575891169,3575891211,42
2,1164,41151,3575891169,3575891211,42
2,1164,41152,3575891169,3575891213,44
2,1164,41153,3575891169,3575891213,44
2,1164,41154,3575891169,3575891214,45
2,1164,41155,3575891169,3575891219,50
2,1165,41156,3575891233,3575891234,1
2,1165,41157,3575891233,3575891234,1
2,1165,41158,3575891233,3575891234,1
2,1165,41159,3575891233,3575891234,1
2,1165,41160,3575891233,3575891234,1
2,1165,41161,3575891233,3575891234,1
2,1165,41162,3575891233,3575891234,1
2,1165,41163,3575891233,3575891234,1
2,1165,41164,3575891233,3575891234,1
2,1165,41165,3575891233,3575891234,1
2,1165,41166,3575891233,3575891234,1
2,1165,41167,3575891233,3575891234,1
2,1165,41168,3575891233,3575891234,1
2,1165,41169,3575891233,3575891234,1
2,1165,41170,3575891233,3575891234,1
2,1165,41171,3575891233,3575891234,1
2,1165,41172,3575891233,3575891234,1
2,1165,41173,3575891233,3575891235,2
2,1165,41174,3575891233,3575891236,3
2,1165,41175,3575891233,3575891237,4
2,1165,41176,3575891233,3575891238,5
2,1165,41177,3575891233,3575891238,5
2,1165,41178,3575891233,3575891238,5
2,1165,41179,3575891233,3575891239,6
2,1165,41180,3575891233,3575891239,6
2,1165,41181,3575891233,3575891240,7
2,1165,41182,3575891233,3575891240,7
2,1165,41183,3575891233,3575891242,9
2,1165,41184,3575891233,3575891243,10
2,1165,41185,3575891233,3575891244,11
2,1165,41186,3575891233,3575891245,12
2,1165,41187,3575891233,3575891245,12
2,1165,41188,3575891233,3575891248,15
2,1165,41189,3575891233,3575891249,16
2,1165,41190,3575891233,3575891251,18
2,1165,41191,3575891233,3575891253,20
2,1165,41192,3575891233,3575891253,20
2,1165,41193,3575891233,3575891254,21
2,1165,41194,3575891233,3575891255,22
2,1165,41195,3575891233,3575891256,23
2,1165,41196,3575891233,3575891256,23
2,1165,41197,3575891233,3575891256,23
2,1165,41198,3575891233,3575891256,23
2,1165,41199,3575891233,3575891256,23
2,1165,41200,3575891233,3575891257,24
2,1165,41201,3575891233,3575891258,25
2,1165,41202,3575891233,3575891259,26
2,1165,41203,3575891233,3575891259,26
2,1165,41204,3575891233,3575891261,28
2,1165,41205,3575891233,3575891262,29
2,1165,41206,3575891233,3575891265,32
2,1165,41207,3575891233,3575891266,33
2,1165,41208,3575891233,3575891267,34
2,1165,41209,3575891233,3575891267,34
2,1165,41210,3575891233,3575891275,42
2,1165,41211,3575891233,3575891277,44
2,1165,41212,3575891233,3575891281,48
2,1165,41213,3575891233,3575891283,50
2,1166,41214,3575891295,3575891296,1
2,1166,41215,3575891295,3575891296,1
2,1166,41216,3575891295,3575891296,1
2,1166,41217,3575891295,3575891296,1
2,1166,41218,3575891295,3575891296,1
2,1166,41219,3575891295,3575891296,1
2,1166,41220,3575891295,3575891296,1
2,1166,41221,3575891295,3575891296,1
2,1166,41222,3575891295,3575891296,1
2,1166,41223,3575891295,3575891296,1
2,1166,41224,3575891295,3575891296,1
2,1166,41225,3575891295,3575891296,1
2,1166,41226,3575891295,3575891296,1
2,1166,41227,3575891295,3575891296,1
2,1166,41228,3575891295,3575891296,1
2,1166,41229,3575891295,3575891296,1
2,1166,41230,3575891295,3575891296,1
2,1166,41231,3575891295,3575891296,1
2,1166,41232,3575891295,3575891296,1
2,1166,41233,3575891295,3575891296,1
2,1166,41234,3575891295,3575891296,1
2,1166,41235,3575891295,3575891296,1
2,1166,41236,3575891295,3575891297,2
2,1166,41237,3575891295,3575891299,4
2,1166,41238,3575891295,3575891300,5
2,1166,41239,3575891295,3575891300,5
2,1166,41240,3575891295,3575891302,7
2,1166,41241,3575891295,3575891302,7
2,1166,41242,3575891295,3575891303,8
2,1166,41243,3575891295,3575891304,9
2,1166,41244,3575891295,3575891306,11
2,1166,41245,3575891295,3575891306,11
2,1166,41246,3575891295,3575891307,12
2,1166,41247,3575891295,3575891308,13
2,1166,41248,3575891295,3575891308,13
2,1166,41249,3575891295,3575891308,13
2,1166,41250,3575891295,3575891308,13
2,1166,41251,3575891295,3575891308,13
2,1166,41252,3575891295,3575891309,14
2,1166,41253,3575891295,3575891309,14
2,1166,41254,3575891295,3575891309,14
2,1166,41255,3575891295,3575891310,15
2,1166,41256,3575891295,3575891311,16
2,1166,41257,3575891295,3575891312,17
2,1166,41258,3575891295,3575891313,18
2,1166,41259,3575891295,3575891313,18
2,1166,41260,3575891295,3575891315,20
2,1166,41261,3575891295,3575891315,20
2,1166,41262,3575891295,3575891315,20
2,1166,41263,3575891295,3575891316,21
2,1166,41264,3575891295,3575891317,22
2,1166,41265,3575891295,3575891318,23
2,1166,41266,3575891295,3575891318,23
2,1166,41267,3575891295,3575891318,23
2,1166,41268,3575891295,3575891319,24
2,1166,41269,3575891295,3575891319,24
2,1166,41270,3575891295,3575891320,25
2,1166,41271,3575891295,3575891320,25
2,1166,41272,3575891295,3575891320,25
2,1166,41273,3575891295,3575891321,26
2,1166,41274,3575891295,3575891322,27
2,1166,41275,3575891295,3575891323,28
2,1166,41276,3575891295,3575891323,28
2,1166,41277,3575891295,3575891325,30
2,1166,41278,3575891295,3575891326,31
2,1166,41279,3575891295,3575891326,31
2,1166,41280,3575891295,3575891327,32
2,1166,41281,3575891295,3575891328,33
2,1166,41282,3575891295,3575891328,33
2,1166,41283,3575891295,3575891329,34
2,1166,41284,3575891295,3575891329,34
2,1166,41285,3575891295,3575891329,34
2,1166,41286,3575891295,3575891331,36
2,1166,41287,3575891295,3575891331,36
2,1166,41288,3575891295,3575891331,36
2,1166,41289,3575891295,3575891332,37
2,1166,41290,3575891295,3575891333,38
2,1166,41291,3575891295,3575891333,38
2,1166,41292,3575891295,3575891333,38
2,1166,41293,3575891295,3575891334,39
2,1166,41294,3575891295,3575891335,40
2,1166,41295,3575891295,3575891335,40
2,1166,41296,3575891295,3575891335,40
2,1166,41297,3575891295,3575891335,40
2,1166,41298,3575891295,3575891336,41
2,1166,41299,3575891295,3575891336,41
2,1166,41300,3575891295,3575891337,42
2,1166,41301,3575891295,3575891339,44
2,1166,41302,3575891295,3575891339,44
2,1166,41303,3575891295,3575891340,45
2,1166,41304,3575891295,3575891340,45
2,1166,41305,3575891295,3575891342,47
2,1166,41306,3575891295,3575891344,49
2,1166,41307,3575891295,3575891344,49
2,1166,41308,3575891295,3575891345,50
2,1167,41309,3575891357,3575891357,0
2,1167,41310,3575891357,3575891357,0
2,1167,41311,3575891357,3575891357,0
2,1167,41312,3575891357,3575891357,0
2,1167,41313,3575891357,3575891357,0
2,1167,41314,3575891357,3575891357,0
2,1167,41315,3575891357,3575891357,0
2,1167,41316,3575891357,3575891357,0
2,1167,41317,3575891357,3575891357,0
2,1167,41318,3575891357,3575891357,0
2,1167,41319,3575891357,3575891357,0
2,1167,41320,3575891357,3575891357,0
2,1167,41321,3575891357,3575891357,0
2,1167,41322,3575891357,3575891357,0
2,1167,41323,3575891357,3575891357,0
2,1167,41324,3575891357,3575891357,0
2,1167,41325,3575891357,3575891357,0
2,1167,41326,3575891357,3575891357,0
2,1167,41327,3575891357,3575891358,1
2,1167,41328,3575891357,3575891360,3
2,1167,41329,3575891357,3575891361,4
2,1167,41330,3575891357,3575891361,4
2,1167,41331,3575891357,3575891361,4
2,1167,41332,3575891357,3575891361,4
2,1167,41333,3575891357,3575891361,4
2,1167,41334,3575891357,3575891362,5
2,1167,41335,3575891357,3575891363,6
2,1167,41336,3575891357,3575891364,7
2,1167,41337,3575891357,3575891365,8
2,1167,41338,3575891357,3575891366,9
2,1167,41339,3575891357,3575891367,10
2,1167,41340,3575891357,3575891368,11
2,1167,41341,3575891357,3575891368,11
2,1167,41342,3575891357,3575891369,12
2,1167,41343,3575891357,3575891369,12
2,1167,41344,3575891357,3575891370,13
2,1167,41345,3575891357,3575891370,13
2,1167,41346,3575891357,3575891370,13
2,1167,41347,3575891357,3575891370,13
2,1167,41348,3575891357,3575891370,13
2,1167,41349,3575891357,3575891371,14
2,1167,41350,3575891357,3575891373,16
2,1167,41351,3575891357,3575891376,19
2,1167,41352,3575891357,3575891376,19
2,1167,41353,3575891357,3575891376,19
2,1167,41354,3575891357,3575891376,19
2,1167,41355,3575891357,3575891377,20
2,1167,41356,3575891357,3575891378,21
2,1167,41357,3575891357,3575891378,21
2,1167,41358,3575891357,3575891379,22
2,1167,41359,3575891357,3575891380,23
2,1167,41360,3575891357,3575891380,23
2,1167,41361,3575891357,3575891380,23
2,1167,41362,3575891357,3575891381,24
2,1167,41363,3575891357,3575891381,24
2,1167,41364,3575891357,3575891382,25
2,1167,41365,3575891357,3575891383,26
2,1167,41366,3575891357,3575891383,26
2,1167,41367,3575891357,3575891384,27
2,1167,41368,3575891357,3575891385,28
2,1167,41369,3575891357,3575891385,28
2,1167,41370,3575891357,3575891385,28
2,1167,41371,3575891357,3575891386,29
2,1167,41372,3575891357,3575891386,29
2,1167,41373,3575891357,3575891388,31
2,1167,41374,3575891357,3575891388,31
2,1167,41375,3575891357,3575891389,32
2,1167,41376,3575891357,3575891389,32
2,1167,41377,3575891357,3575891391,34
2,1167,41378,3575891357,3575891391,34
2,1167,41379,3575891357,3575891391,34
2,1167,41380,3575891357,3575891391,34
2,1167,41381,3575891357,3575891392,35
2,1167,41382,3575891357,3575891393,36
2,1167,41383,3575891357,3575891394,37
2,1167,41384,3575891357,3575891394,37
2,1167,41385,3575891357,3575891395,38
2,1167,41386,3575891357,3575891395,38
2,1167,41387,3575891357,3575891396,39
2,1167,41388,3575891357,3575891396,39
2,1167,41389,3575891357,3575891397,40
2,1167,41390,3575891357,3575891398,41
2,1167,41391,3575891357,3575891398,41
2,1167,41392,3575891357,3575891399,42
2,1167,41393,3575891357,3575891399,42
2,1167,41394,3575891357,3575891400,43
2,1167,41395,3575891357,3575891403,46
2,1167,41396,3575891357,3575891403,46
2,1167,41397,3575891357,3575891403,46
2,1167,41398,3575891357,3575891404,47
2,1167,41399,3575891357,3575891404,47
2,1167,41400,3575891357,3575891405,48
2,1167,41401,3575891357,3575891406,49
2,1167,41402,3575891357,3575891406,49
2,1168,41403,3575891421,3575891421,0
2,1168,41404,3575891421,3575891421,0
2,1168,41405,3575891421,3575891421,0
2,1168,41406,3575891421,3575891421,0
2,1168,41407,3575891421,3575891421,0
2,1168,41408,3575891421,3575891421,0
2,1168,41409,3575891421,3575891421,0
2,1168,41410,3575891421,3575891421,0
2,1168,41411,3575891421,3575891421,0
2,1168,41412,3575891421,3575891422,1
2,1168,41413,3575891421,3575891424,3
2,1168,41414,3575891421,3575891424,3
2,1168,41415,3575891421,3575891427,6
2,1168,41416,3575891421,3575891427,6
2,1168,41417,3575891421,3575891427,6
2,1168,41418,3575891421,3575891428,7
2,1168,41419,3575891421,3575891428,7
2,1168,41420,3575891421,3575891428,7
2,1168,41421,3575891421,3575891428,7
2,1168,41422,3575891421,3575891428,7
2,1168,41423,3575891421,3575891428,7
2,1168,41424,3575891421,3575891429,8
2,1168,41425,3575891421,3575891431,10
2,1168,41426,3575891421,3575891433,12
2,1168,41427,3575891421,3575891435,14
2,1168,41428,3575891421,3575891435,14
2,1168,41429,3575891421,3575891436,15
2,1168,41430,3575891421,3575891437,16
2,1168,41431,3575891421,3575891437,16
2,1168,41432,3575891421,3575891438,17
2,1168,41433,3575891421,3575891439,18
2,1168,41434,3575891421,3575891439,18
2,1168,41435,3575891421,3575891440,19
2,1168,41436,3575891421,3575891440,19
2,1168,41437,3575891421,3575891440,19
2,1168,41438,3575891421,3575891443,22
2,1168,41439,3575891421,3575891443,22
2,1168,41440,3575891421,3575891444,23
2,1168,41441,3575891421,3575891446,25
2,1168,41442,3575891421,3575891446,25
2,1168,41443,3575891421,3575891448,27
2,1168,41444,3575891421,3575891449,28
2,1168,41445,3575891421,3575891451,30
2,1168,41446,3575891421,3575891454,33
2,1168,41447,3575891421,3575891454,33
2,1168,41448,3575891421,3575891455,34
2,1168,41449,3575891421,3575891455,34
2,1168,41450,3575891421,3575891455,34
2,1168,41451,3575891421,3575891456,35
2,1168,41452,3575891421,3575891456,35
2,1168,41453,3575891421,3575891456,35
2,1168,41454,3575891421,3575891457,36
2,1168,41455,3575891421,3575891458,37
2,1168,41456,3575891421,3575891459,38
2,1168,41457,3575891421,3575891461,40
2,1168,41458,3575891421,3575891462,41
2,1168,41459,3575891421,3575891466,45
2,1168,41460,3575891421,3575891466,45
2,1168,41461,3575891421,3575891467,46
2,1168,41462,3575891421,3575891467,46
2,1169,41463,3575891484,3575891484,0
2,1169,41464,3575891484,3575891484,0
2,1169,41465,3575891484,3575891484,0
2,1169,41466,3575891484,3575891484,0
2,1169,41467,3575891484,3575891484,0
2,1169,41468,3575891484,3575891484,0
2,1169,41469,3575891484,3575891486,2
2,1169,41470,3575891484,3575891486,2
2,1169,41471,3575891484,3575891486,2
2,1169,41472,3575891484,3575891487,3
2,1169,41473,3575891484,3575891487,3
2,1169,41474,3575891484,3575891487,3
2,1169,41475,3575891484,3575891488,4
2,1169,41476,3575891484,3575891489,5
2,1169,41477,3575891484,3575891491,7
2,1169,41478,3575891484,3575891491,7
2,1169,41479,3575891484,3575891491,7
2,1169,41480,3575891484,3575891491,7
2,1169,41481,3575891484,3575891492,8
2,1169,41482,3575891484,3575891492,8
2,1169,41483,3575891484,3575891493,9
2,1169,41484,3575891484,3575891494,10
2,1169,41485,3575891484,3575891494,10
2,1169,41486,3575891484,3575891495,11
2,1169,41487,3575891484,3575891495,11
2,1169,41488,3575891484,3575891496,12
2,1169,41489,3575891484,3575891496,12
2,1169,41490,3575891484,3575891496,12
2,1169,41491,3575891484,3575891497,13
2,1169,41492,3575891484,3575891498,14
2,1169,41493,3575891484,3575891499,15
2,1169,41494,3575891484,3575891499,15
2,1169,41495,3575891484,3575891501,17
2,1169,41496,3575891484,3575891501,17
2,1169,41497,3575891484,3575891503,19
2,1169,41498,3575891484,3575891504,20
2,1169,41499,3575891484,3575891505,21
2,1169,41500,3575891484,3575891505,21
2,1169,41501,3575891484,3575891506,22
2,1169,41502,3575891484,3575891506,22
2,1169,41503,3575891484,3575891507,23
2,1169,41504,3575891484,3575891507,23
2,1169,41505,3575891484,3575891507,23
2,1169,41506,3575891484,3575891508,24
2,1169,41507,3575891484,3575891508,24
2,1169,41508,3575891484,3575891508,24
2,1169,41509,3575891484,3575891508,24
2,1169,41510,3575891484,3575891509,25
2,1169,41511,3575891484,3575891510,26
2,1169,41512,3575891484,3575891510,26
2,1169,41513,3575891484,3575891511,27
2,1169,41514,3575891484,3575891513,29
2,1169,41515,3575891484,3575891513,29
2,1169,41516,3575891484,3575891514,30
2,1169,41517,3575891484,3575891514,30
2,1169,41518,3575891484,3575891515,31
2,1169,41519,3575891484,3575891515,31
2,1169,41520,3575891484,3575891515,31
2,1169,41521,3575891484,3575891517,33
2,1169,41522,3575891484,3575891517,33
2,1169,41523,3575891484,3575891518,34
2,1169,41524,3575891484,3575891518,34
2,1169,41525,3575891484,3575891519,35
2,1169,41526,3575891484,3575891519,35
2,1169,41527,3575891484,3575891519,35
2,1169,41528,3575891484,3575891520,36
2,1169,41529,3575891484,3575891521,37
2,1169,41530,3575891484,3575891521,37
2,1169,41531,3575891484,3575891525,41
2,1169,41532,3575891484,3575891525,41
2,1169,41533,3575891484,3575891526,42
2,1169,41534,3575891484,3575891526,42
2,1169,41535,3575891484,3575891527,43
2,1169,41536,3575891484,3575891528,44
2,1169,41537,3575891484,3575891528,44
2,1169,41538,3575891484,3575891528,44
2,1169,41539,3575891484,3575891528,44
2,1169,41540,3575891484,3575891530,46
2,1169,41541,3575891484,3575891530,46
2,1169,41542,3575891484,3575891531,47
2,1169,41543,3575891484,3575891531,47
2,1169,41544,3575891484,3575891532,48
2,1169,41545,3575891484,3575891533,49
2,1169,41546,3575891484,3575891533,49
2,1169,41547,3575891484,3575891534,50
2,1170,41548,3575891547,3575891547,0
2,1170,41549,3575891547,3575891547,0
2,1170,41550,3575891547,3575891547,0
2,1170,41551,3575891547,3575891547,0
2,1170,41552,3575891547,3575891547,0
2,1170,41553,3575891547,3575891547,0
2,1170,41554,3575891547,3575891547,0
2,1170,41555,3575891547,3575891547,0
2,1170,41556,3575891547,3575891547,0
2,1170,41557,3575891547,3575891547,0
2,1170,41558,3575891547,3575891547,0
2,1170,41559,3575891547,3575891547,0
2,1170,41560,3575891547,3575891547,0
2,1170,41561,3575891547,3575891547,0
2,1170,41562,3575891547,3575891547,0
2,1170,41563,3575891547,3575891547,0
2,1170,41564,3575891547,3575891547,0
2,1170,41565,3575891547,3575891547,0
2,1170,41566,3575891547,3575891547,0
2,1170,41567,3575891547,3575891547,0
2,1170,41568,3575891547,3575891549,2
2,1170,41569,3575891547,3575891549,2
2,1170,41570,3575891547,3575891549,2
2,1170,41571,3575891547,3575891550,3
2,1170,41572,3575891547,3575891551,4
2,1170,41573,3575891547,3575891551,4
2,1170,41574,3575891547,3575891552,5
2,1170,41575,3575891547,3575891552,5
2,1170,41576,3575891547,3575891553,6
2,1170,41577,3575891547,3575891553,6
2,1170,41578,3575891547,3575891553,6
2,1170,41579,3575891547,3575891556,9
2,1170,41580,3575891547,3575891556,9
2,1170,41581,3575891547,3575891558,11
2,1170,41582,3575891547,3575891559,12
2,1170,41583,3575891547,3575891559,12
2,1170,41584,3575891547,3575891560,13
2,1170,41585,3575891547,3575891560,13
2,1170,41586,3575891547,3575891560,13
2,1170,41587,3575891547,3575891561,14
2,1170,41588,3575891547,3575891561,14
2,1170,41589,3575891547,3575891561,14
2,1170,41590,3575891547,3575891562,15
2,1170,41591,3575891547,3575891563,16
2,1170,41592,3575891547,3575891565,18
2,1170,41593,3575891547,3575891566,19
2,1170,41594,3575891547,3575891566,19
2,1170,41595,3575891547,3575891566,19
2,1170,41596,3575891547,3575891567,20
2,1170,41597,3575891547,3575891568,21
2,1170,41598,3575891547,3575891568,21
2,1170,41599,3575891547,3575891568,21
2,1170,41600,3575891547,3575891568,21
2,1170,41601,3575891547,3575891569,22
2,1170,41602,3575891547,3575891570,23
2,1170,41603,3575891547,3575891570,23
2,1170,41604,3575891547,3575891571,24
2,1170,41605,3575891547,3575891572,25
2,1170,41606,3575891547,3575891574,27
2,1170,41607,3575891547,3575891575,28
2,1170,41608,3575891547,3575891576,29
2,1170,41609,3575891547,3575891576,29
2,1170,41610,3575891547,3575891576,29
2,1170,41611,3575891547,3575891577,30
2,1170,41612,3575891547,3575891577,30
2,1170,41613,3575891547,3575891578,31
2,1170,41614,3575891547,3575891578,31
2,1170,41615,3575891547,3575891580,33
2,1170,41616,3575891547,3575891580,33
2,1170,41617,3575891547,3575891580,33
2,1170,41618,3575891547,3575891581,34
2,1170,41619,3575891547,3575891583,36
2,1170,41620,3575891547,3575891583,36
2,1170,41621,3575891547,3575891584,37
2,1170,41622,3575891547,3575891584,37
2,1170,41623,3575891547,3575891584,37
2,1170,41624,3575891547,3575891585,38
2,1170,41625,3575891547,3575891585,38
2,1170,41626,3575891547,3575891587,40
2,1170,41627,3575891547,3575891588,41
2,1170,41628,3575891547,3575891588,41
2,1170,41629,3575891547,3575891589,42
2,1170,41630,3575891547,3575891590,43
2,1170,41631,3575891547,3575891590,43
2,1170,41632,3575891547,3575891591,44
2,1170,41633,3575891547,3575891591,44
2,1170,41634,3575891547,3575891592,45
2,1170,41635,3575891547,3575891593,46
2,1170,41636,3575891547,3575891593,46
2,1170,41637,3575891547,3575891594,47
2,1170,41638,3575891547,3575891594,47
2,1170,41639,3575891547,3575891594,47
2,1170,41640,3575891547,3575891595,48
2,1170,41641,3575891547,3575891596,49
2,1171,41642,3575891612,3575891612,0
2,1171,41643,3575891612,3575891612,0
2,1171,41644,3575891612,3575891612,0
2,1171,41645,3575891612,3575891612,0
2,1171,41646,3575891612,3575891612,0
2,1171,41647,3575891612,3575891612,0
2,1171,41648,3575891612,3575891612,0
2,1171,41649,3575891612,3575891612,0
2,1171,41650,3575891612,3575891612,0
2,1171,41651,3575891612,3575891612,0
2,1171,41652,3575891612,3575891612,0
2,1171,41653,3575891612,3575891612,0
2,1171,41654,3575891612,3575891612,0
2,1171,41655,3575891612,3575891612,0
2,1171,41656,3575891612,3575891612,0
2,1171,41657,3575891612,3575891612,0
2,1171,41658,3575891612,3575891612,0
2,1171,41659,3575891612,3575891612,0
2,1171,41660,3575891612,3575891613,1
2,1171,41661,3575891612,3575891619,7
2,1171,41662,3575891612,3575891620,8
2,1171,41663,3575891612,3575891620,8
2,1171,41664,3575891612,3575891621,9
2,1171,41665,3575891612,3575891622,10
2,1171,41666,3575891612,3575891622,10
2,1171,41667,3575891612,3575891623,11
2,1171,41668,3575891612,3575891625,13
2,1171,41669,3575891612,3575891626,14
2,1171,41670,3575891612,3575891626,14
2,1171,41671,3575891612,3575891626,14
2,1171,41672,3575891612,3575891627,15
2,1171,41673,3575891612,3575891627,15
2,1171,41674,3575891612,3575891627,15
2,1171,41675,3575891612,3575891628,16
2,1171,41676,3575891612,3575891628,16
2,1171,41677,3575891612,3575891629,17
2,1171,41678,3575891612,3575891630,18
2,1171,41679,3575891612,3575891632,20
2,1171,41680,3575891612,3575891633,21
2,1171,41681,3575891612,3575891634,22
2,1171,41682,3575891612,3575891636,24
2,1171,41683,3575891612,3575891636,24
2,1171,41684,3575891612,3575891636,24
2,1171,41685,3575891612,3575891637,25
2,1171,41686,3575891612,3575891638,26
2,1171,41687,3575891612,3575891638,26
2,1171,41688,3575891612,3575891639,27
2,1171,41689,3575891612,3575891639,27
2,1171,41690,3575891612,3575891641,29
2,1171,41691,3575891612,3575891642,30
2,1171,41692,3575891612,3575891643,31
2,1171,41693,3575891612,3575891645,33
2,1171,41694,3575891612,3575891645,33
2,1171,41695,3575891612,3575891647,35
2,1171,41696,3575891612,3575891648,36
2,1171,41697,3575891612,3575891650,38
2,1171,41698,3575891612,3575891653,41
2,1171,41699,3575891612,3575891653,41
2,1171,41700,3575891612,3575891654,42
2,1171,41701,3575891612,3575891654,42
2,1171,41702,3575891612,3575891654,42
2,1171,41703,3575891612,3575891654,42
2,1171,41704,3575891612,3575891655,43
2,1171,41705,3575891612,3575891656,44
2,1171,41706,3575891612,3575891656,44
2,1171,41707,3575891612,3575891657,45
2,1171,41708,3575891612,3575891658,46
2,1171,41709,3575891612,3575891660,48
2,1171,41710,3575891612,3575891661,49
2,1172,41711,3575891674,3575891674,0
2,1172,41712,3575891674,3575891674,0
2,1172,41713,3575891674,3575891674,0
2,1172,41714,3575891674,3575891674,0
2,1172,41715,3575891674,3575891676,2
2,1172,41716,3575891674,3575891678,4
2,1172,41717,3575891674,3575891681,7
2,1172,41718,3575891674,3575891684,10
2,1172,41719,3575891674,3575891685,11
2,1172,41720,3575891674,3575891686,12
2,1172,41721,3575891674,3575891686,12
2,1172,41722,3575891674,3575891686,12
2,1172,41723,3575891674,3575891686,12
2,1172,41724,3575891674,3575891687,13
2,1172,41725,3575891674,3575891687,13
2,1172,41726,3575891674,3575891687,13
2,1172,41727,3575891674,3575891688,14
2,1172,41728,3575891674,3575891690,16
2,1172,41729,3575891674,3575891691,17
2,1172,41730,3575891674,3575891691,17
2,1172,41731,3575891674,3575891691,17
2,1172,41732,3575891674,3575891691,17
2,1172,41733,3575891674,3575891692,18
2,1172,41734,3575891674,3575891692,18
2,1172,41735,3575891674,3575891692,18
2,1172,41736,3575891674,3575891693,19
2,1172,41737,3575891674,3575891694,20
2,1172,41738,3575891674,3575891695,21
2,1172,41739,3575891674,3575891695,21
2,1172,41740,3575891674,3575891696,22
2,1172,41741,3575891674,3575891696,22
2,1172,41742,3575891674,3575891696,22
2,1172,41743,3575891674,3575891697,23
2,1172,41744,3575891674,3575891699,25
2,1172,41745,3575891674,3575891699,25
2,1172,41746,3575891674,3575891701,27
2,1172,41747,3575891674,3575891701,27
2,1172,41748,3575891674,3575891703,29
2,1172,41749,3575891674,3575891704,30
2,1172,41750,3575891674,3575891705,31
2,1172,41751,3575891674,3575891706,32
2,1172,41752,3575891674,3575891706,32
2,1172,41753,3575891674,3575891706,32
2,1172,41754,3575891674,3575891707,33
2,1172,41755,3575891674,3575891707,33
2,1172,41756,3575891674,3575891707,33
2,1172,41757,3575891674,3575891707,33
2,1172,41758,3575891674,3575891708,34
2,1172,41759,3575891674,3575891708,34
2,1172,41760,3575891674,3575891708,34
2,1172,41761,3575891674,3575891708,34
2,1172,41762,3575891674,3575891709,35
2,1172,41763,3575891674,3575891710,36
2,1172,41764,3575891674,3575891711,37
2,1172,41765,3575891674,3575891712,38
2,1172,41766,3575891674,3575891713,39
2,1172,41767,3575891674,3575891713,39
2,1172,41768,3575891674,3575891714,40
2,1172,41769,3575891674,3575891714,40
2,1172,41770,3575891674,3575891714,40
2,1172,41771,3575891674,3575891716,42
2,1172,41772,3575891674,3575891716,42
2,1172,41773,3575891674,3575891717,43
2,1172,41774,3575891674,3575891717,43
2,1172,41775,3575891674,3575891717,43
2,1172,41776,3575891674,3575891718,44
2,1172,41777,3575891674,3575891718,44
2,1172,41778,3575891674,3575891719,45
2,1172,41779,3575891674,3575891720,46
2,1172,41780,3575891674,3575891720,46
2,1172,41781,3575891674,3575891720,46
2,1172,41782,3575891674,3575891721,47
2,1172,41783,3575891674,3575891722,48
2,1173,41784,3575891751,3575891751,0
2,1173,41785,3575891751,3575891751,0
2,1173,41786,3575891751,3575891751,0
2,1173,41787,3575891751,3575891751,0
2,1173,41788,3575891751,3575891751,0
2,1173,41789,3575891751,3575891751,0
2,1173,41790,3575891751,3575891751,0
2,1173,41791,3575891751,3575891751,0
2,1173,41792,3575891751,3575891751,0
2,1173,41793,3575891751,3575891751,0
2,1173,41794,3575891751,3575891751,0
2,1173,41795,3575891751,3575891751,0
2,1173,41796,3575891751,3575891751,0
2,1173,41797,3575891751,3575891751,0
2,1173,41798,3575891751,3575891751,0
2,1173,41799,3575891751,3575891751,0
2,1173,41800,3575891751,3575891751,0
2,1173,41801,3575891751,3575891751,0
2,1173,41802,3575891751,3575891751,0
2,1173,41803,3575891751,3575891751,0
2,1173,41804,3575891751,3575891751,0
2,1173,41805,3575891751,3575891751,0
2,1173,41806,3575891751,3575891751,0
2,1173,41807,3575891751,3575891751,0
2,1173,41808,3575891751,3575891751,0
2,1173,41809,3575891751,3575891751,0
2,1173,41810,3575891751,3575891751,0
2,1173,41811,3575891751,3575891751,0
2,1173,41812,3575891751,3575891751,0
2,1173,41813,3575891751,3575891751,0
2,1173,41814,3575891751,3575891751,0
2,1173,41815,3575891751,3575891751,0
2,1173,41816,3575891751,3575891751,0
2,1173,41817,3575891751,3575891751,0
2,1173,41818,3575891751,3575891751,0
2,1173,41819,3575891751,3575891751,0
2,1173,41820,3575891751,3575891751,0
2,1173,41821,3575891751,3575891751,0
2,1173,41822,3575891751,3575891751,0
2,1173,41823,3575891751,3575891751,0
2,1173,41824,3575891751,3575891752,1
2,1173,41825,3575891751,3575891752,1
2,1173,41826,3575891751,3575891752,1
2,1173,41827,3575891751,3575891753,2
2,1173,41828,3575891751,3575891753,2
2,1173,41829,3575891751,3575891756,5
2,1173,41830,3575891751,3575891757,6
2,1173,41831,3575891751,3575891758,7
2,1173,41832,3575891751,3575891759,8
2,1173,41833,3575891751,3575891759,8
2,1173,41834,3575891751,3575891759,8
2,1173,41835,3575891751,3575891760,9
2,1173,41836,3575891751,3575891760,9
2,1173,41837,3575891751,3575891761,10
2,1173,41838,3575891751,3575891761,10
2,1173,41839,3575891751,3575891761,10
2,1173,41840,3575891751,3575891762,11
2,1173,41841,3575891751,3575891763,12
2,1173,41842,3575891751,3575891766,15
2,1173,41843,3575891751,3575891766,15
2,1173,41844,3575891751,3575891767,16
2,1173,41845,3575891751,3575891767,16
2,1173,41846,3575891751,3575891768,17
2,1173,41847,3575891751,3575891768,17
2,1173,41848,3575891751,3575891768,17
2,1173,41849,3575891751,3575891769,18
2,1173,41850,3575891751,3575891769,18
2,1173,41851,3575891751,3575891769,18
2,1173,41852,3575891751,3575891770,19
2,1173,41853,3575891751,3575891770,19
2,1173,41854,3575891751,3575891771,20
2,1173,41855,3575891751,3575891773,22
2,1173,41856,3575891751,3575891775,24
2,1173,41857,3575891751,3575891775,24
2,1173,41858,3575891751,3575891775,24
2,1173,41859,3575891751,3575891776,25
2,1173,41860,3575891751,3575891776,25
2,1173,41861,3575891751,3575891776,25
2,1173,41862,3575891751,3575891777,26
2,1173,41863,3575891751,3575891777,26
2,1173,41864,3575891751,3575891778,27
2,1173,41865,3575891751,3575891778,27
2,1173,41866,3575891751,3575891778,27
2,1173,41867,3575891751,3575891780,29
2,1173,41868,3575891751,3575891781,30
2,1173,41869,3575891751,3575891783,32
2,1173,41870,3575891751,3575891783,32
2,1173,41871,3575891751,3575891784,33
2,1173,41872,3575891751,3575891784,33
2,1173,41873,3575891751,3575891785,34
2,1173,41874,3575891751,3575891785,34
2,1173,41875,3575891751,3575891786,35
2,1173,41876,3575891751,3575891786,35
2,1173,41877,3575891751,3575891787,36
2,1173,41878,3575891751,3575891787,36
2,1173,41879,3575891751,3575891788,37
2,1173,41880,3575891751,3575891790,39
2,1173,41881,3575891751,3575891790,39
2,1173,41882,3575891751,3575891791,40
2,1173,41883,3575891751,3575891791,40
2,1173,41884,3575891751,3575891792,41
2,1173,41885,3575891751,3575891793,42
2,1173,41886,3575891751,3575891793,42
2,1173,41887,3575891751,3575891793,42
2,1173,41888,3575891751,3575891794,43
2,1173,41889,3575891751,3575891794,43
2,1173,41890,3575891751,3575891796,45
2,1173,41891,3575891751,3575891796,45
2,1173,41892,3575891751,3575891797,46
2,1173,41893,3575891751,3575891798,47
2,1173,41894,3575891751,3575891798,47
2,1173,41895,3575891751,3575891798,47
2,1173,41896,3575891751,3575891800,49
2,1173,41897,3575891751,3575891801,50
2,1174,41898,3575891815,3575891815,0
2,1174,41899,3575891815,3575891815,0
2,1174,41900,3575891815,3575891815,0
2,1174,41901,3575891815,3575891815,0
2,1174,41902,3575891815,3575891815,0
2,1174,41903,3575891815,3575891815,0
2,1174,41904,3575891815,3575891815,0
2,1174,41905,3575891815,3575891815,0
2,1174,41906,3575891815,3575891815,0
2,1174,41907,3575891815,3575891815,0
2,1174,41908,3575891815,3575891815,0
2,1174,41909,3575891815,3575891815,0
2,1174,41910,3575891815,3575891815,0
2,1174,41911,3575891815,3575891820,5
2,1174,41912,3575891815,3575891821,6
2,1174,41913,3575891815,3575891821,6
2,1174,41914,3575891815,3575891823,8
2,1174,41915,3575891815,3575891823,8
2,1174,41916,3575891815,3575891824,9
2,1174,41917,3575891815,3575891826,11
2,1174,41918,3575891815,3575891826,11
2,1174,41919,3575891815,3575891827,12
2,1174,41920,3575891815,3575891827,12
2,1174,41921,3575891815,3575891827,12
2,1174,41922,3575891815,3575891828,13
2,1174,41923,3575891815,3575891828,13
2,1174,41924,3575891815,3575891830,15
2,1174,41925,3575891815,3575891832,17
2,1174,41926,3575891815,3575891834,19
2,1174,41927,3575891815,3575891835,20
2,1174,41928,3575891815,3575891836,21
2,1174,41929,3575891815,3575891836,21
2,1174,41930,3575891815,3575891836,21
2,1174,41931,3575891815,3575891837,22
2,1174,41932,3575891815,3575891837,22
2,1174,41933,3575891815,3575891838,23
2,1174,41934,3575891815,3575891840,25
2,1174,41935,3575891815,3575891840,25
2,1174,41936,3575891815,3575891840,25
2,1174,41937,3575891815,3575891842,27
2,1174,41938,3575891815,3575891842,27
2,1174,41939,3575891815,3575891843,28
2,1174,41940,3575891815,3575891845,30
2,1174,41941,3575891815,3575891847,32
2,1174,41942,3575891815,3575891848,33
2,1174,41943,3575891815,3575891850,35
2,1174,41944,3575891815,3575891853,38
2,1174,41945,3575891815,3575891854,39
2,1174,41946,3575891815,3575891854,39
2,1174,41947,3575891815,3575891855,40
2,1174,41948,3575891815,3575891855,40
2,1174,41949,3575891815,3575891855,40
2,1174,41950,3575891815,3575891855,40
2,1174,41951,3575891815,3575891855,40
2,1174,41952,3575891815,3575891856,41
2,1174,41953,3575891815,3575891856,41
2,1174,41954,3575891815,3575891858,43
2,1174,41955,3575891815,3575891860,45
2,1174,41956,3575891815,3575891861,46
2,1174,41957,3575891815,3575891865,50
2,1175,41958,3575891878,3575891878,0
2,1175,41959,3575891878,3575891878,0
2,1175,41960,3575891878,3575891878,0
2,1175,41961,3575891878,3575891878,0
2,1175,41962,3575891878,3575891881,3
2,1175,41963,3575891878,3575891884,6
2,1175,41964,3575891878,3575891885,7
2,1175,41965,3575891878,3575891886,8
2,1175,41966,3575891878,3575891886,8
2,1175,41967,3575891878,3575891886,8
2,1175,41968,3575891878,3575891887,9
2,1175,41969,3575891878,3575891887,9
2,1175,41970,3575891878,3575891887,9
2,1175,41971,3575891878,3575891889,11
2,1175,41972,3575891878,3575891890,12
2,1175,41973,3575891878,3575891890,12
2,1175,41974,3575891878,3575891891,13
2,1175,41975,3575891878,3575891891,13
2,1175,41976,3575891878,3575891892,14
2,1175,41977,3575891878,3575891892,14
2,1175,41978,3575891878,3575891892,14
2,1175,41979,3575891878,3575891892,14
2,1175,41980,3575891878,3575891893,15
2,1175,41981,3575891878,3575891895,17
2,1175,41982,3575891878,3575891895,17
2,1175,41983,3575891878,3575891895,17
2,1175,41984,3575891878,3575891895,17
2,1175,41985,3575891878,3575891895,17
2,1175,41986,3575891878,3575891896,18
2,1175,41987,3575891878,3575891897,19
2,1175,41988,3575891878,3575891897,19
2,1175,41989,3575891878,3575891899,21
2,1175,41990,3575891878,3575891900,22
2,1175,41991,3575891878,3575891901,23
2,1175,41992,3575891878,3575891902,24
2,1175,41993,3575891878,3575891902,24
2,1175,41994,3575891878,3575891903,25
2,1175,41995,3575891878,3575891904,26
2,1175,41996,3575891878,3575891905,27
2,1175,41997,3575891878,3575891905,27
2,1175,41998,3575891878,3575891906,28
2,1175,41999,3575891878,3575891906,28
2,1175,42000,3575891878,3575891907,29
2,1175,42001,3575891878,3575891907,29
2,1175,42002,3575891878,3575891907,29
2,1175,42003,3575891878,3575891908,30
2,1175,42004,3575891878,3575891908,30
2,1175,42005,3575891878,3575891908,30
2,1175,42006,3575891878,3575891908,30
2,1175,42007,3575891878,3575891908,30
2,1175,42008,3575891878,3575891909,31
2,1175,42009,3575891878,3575891910,32
2,1175,42010,3575891878,3575891911,33
2,1175,42011,3575891878,3575891912,34
2,1175,42012,3575891878,3575891913,35
2,1175,42013,3575891878,3575891914,36
2,1175,42014,3575891878,3575891914,36
2,1175,42015,3575891878,3575891914,36
2,1175,42016,3575891878,3575891915,37
2,1175,42017,3575891878,3575891916,38
2,1175,42018,3575891878,3575891916,38
2,1175,42019,3575891878,3575891917,39
2,1175,42020,3575891878,3575891917,39
2,1175,42021,3575891878,3575891917,39
2,1175,42022,3575891878,3575891918,40
2,1175,42023,3575891878,3575891919,41
2,1175,42024,3575891878,3575891920,42
2,1175,42025,3575891878,3575891920,42
2,1175,42026,3575891878,3575891921,43
2,1175,42027,3575891878,3575891922,44
2,1175,42028,3575891878,3575891925,47
2,1175,42029,3575891878,3575891925,47
2,1175,42030,3575891878,3575891925,47
2,1175,42031,3575891878,3575891926,48
2,1175,42032,3575891878,3575891927,49
2,1175,42033,3575891878,3575891928,50
2,1176,42034,3575891944,3575891944,0
2,1176,42035,3575891944,3575891944,0
2,1176,42036,3575891944,3575891944,0
2,1176,42037,3575891944,3575891944,0
2,1176,42038,3575891944,3575891944,0
2,1176,42039,3575891944,3575891944,0
2,1176,42040,3575891944,3575891944,0
2,1176,42041,3575891944,3575891944,0
2,1176,42042,3575891944,3575891944,0
2,1176,42043,3575891944,3575891944,0
2,1176,42044,3575891944,3575891944,0
2,1176,42045,3575891944,3575891944,0
2,1176,42046,3575891944,3575891944,0
2,1176,42047,3575891944,3575891944,0
2,1176,42048,3575891944,3575891944,0
2,1176,42049,3575891944,3575891944,0
2,1176,42050,3575891944,3575891944,0
2,1176,42051,3575891944,3575891944,0
2,1176,42052,3575891944,3575891944,0
2,1176,42053,3575891944,3575891944,0
2,1176,42054,3575891944,3575891944,0
2,1176,42055,3575891944,3575891944,0
2,1176,42056,3575891944,3575891944,0
2,1176,42057,3575891944,3575891944,0
2,1176,42058,3575891944,3575891945,1
2,1176,42059,3575891944,3575891946,2
2,1176,42060,3575891944,3575891947,3
2,1176,42061,3575891944,3575891948,4
2,1176,42062,3575891944,3575891949,5
2,1176,42063,3575891944,3575891949,5
2,1176,42064,3575891944,3575891949,5
2,1176,42065,3575891944,3575891951,7
2,1176,42066,3575891944,3575891952,8
2,1176,42067,3575891944,3575891952,8
2,1176,42068,3575891944,3575891952,8
2,1176,42069,3575891944,3575891953,9
2,1176,42070,3575891944,3575891954,10
2,1176,42071,3575891944,3575891954,10
2,1176,42072,3575891944,3575891956,12
2,1176,42073,3575891944,3575891956,12
2,1176,42074,3575891944,3575891959,15
2,1176,42075,3575891944,3575891959,15
2,1176,42076,3575891944,3575891960,16
2,1176,42077,3575891944,3575891960,16
2,1176,42078,3575891944,3575891961,17
2,1176,42079,3575891944,3575891961,17
2,1176,42080,3575891944,3575891961,17
2,1176,42081,3575891944,3575891961,17
2,1176,42082,3575891944,3575891961,17
2,1176,42083,3575891944,3575891962,18
2,1176,42084,3575891944,3575891963,19
2,1176,42085,3575891944,3575891965,21
2,1176,42086,3575891944,3575891966,22
2,1176,42087,3575891944,3575891966,22
2,1176,42088,3575891944,3575891967,23
2,1176,42089,3575891944,3575891968,24
2,1176,42090,3575891944,3575891968,24
2,1176,42091,3575891944,3575891968,24
2,1176,42092,3575891944,3575891968,24
2,1176,42093,3575891944,3575891969,25
2,1176,42094,3575891944,3575891969,25
2,1176,42095,3575891944,3575891970,26
2,1176,42096,3575891944,3575891970,26
2,1176,42097,3575891944,3575891970,26
2,1176,42098,3575891944,3575891971,27
2,1176,42099,3575891944,3575891972,28
2,1176,42100,3575891944,3575891974,30
2,1176,42101,3575891944,3575891975,31
2,1176,42102,3575891944,3575891975,31
2,1176,42103,3575891944,3575891975,31
2,1176,42104,3575891944,3575891976,32
2,1176,42105,3575891944,3575891977,33
2,1176,42106,3575891944,3575891977,33
2,1176,42107,3575891944,3575891978,34
2,1176,42108,3575891944,3575891978,34
2,1176,42109,3575891944,3575891978,34
2,1176,42110,3575891944,3575891980,36
2,1176,42111,3575891944,3575891980,36
2,1176,42112,3575891944,3575891981,37
2,1176,42113,3575891944,3575891983,39
2,1176,42114,3575891944,3575891984,40
2,1176,42115,3575891944,3575891985,41
2,1176,42116,3575891944,3575891985,41
2,1176,42117,3575891944,3575891985,41
2,1176,42118,3575891944,3575891985,41
2,1176,42119,3575891944,3575891986,42
2,1176,42120,3575891944,3575891986,42
2,1176,42121,3575891944,3575891987,43
2,1176,42122,3575891944,3575891988,44
2,1176,42123,3575891944,3575891988,44
2,1176,42124,3575891944,3575891988,44
2,1176,42125,3575891944,3575891990,46
2,1176,42126,3575891944,3575891990,46
2,1176,42127,3575891944,3575891991,47
2,1176,42128,3575891944,3575891992,48
2,1176,42129,3575891944,3575891993,49
2,1176,42130,3575891944,3575891993,49
2,1176,42131,3575891944,3575891993,49
2,1176,42132,3575891944,3575891994,50
2,1177,42133,3575892008,3575892008,0
2,1177,42134,3575892008,3575892008,0
2,1177,42135,3575892008,3575892008,0
2,1177,42136,3575892008,3575892008,0
2,1177,42137,3575892008,3575892008,0
2,1177,42138,3575892008,3575892008,0
2,1177,42139,3575892008,3575892008,0
2,1177,42140,3575892008,3575892008,0
2,1177,42141,3575892008,3575892008,0
2,1177,42142,3575892008,3575892008,0
2,1177,42143,3575892008,3575892008,0
2,1177,42144,3575892008,3575892008,0
2,1177,42145,3575892008,3575892008,0
2,1177,42146,3575892008,3575892008,0
2,1177,42147,3575892008,3575892008,0
2,1177,42148,3575892008,3575892008,0
2,1177,42149,3575892008,3575892008,0
2,1177,42150,3575892008,3575892008,0
2,1177,42151,3575892008,3575892010,2
2,1177,42152,3575892008,3575892011,3
2,1177,42153,3575892008,3575892012,4
2,1177,42154,3575892008,3575892014,6
2,1177,42155,3575892008,3575892015,7
2,1177,42156,3575892008,3575892021,13
2,1177,42157,3575892008,3575892021,13
2,1177,42158,3575892008,3575892021,13
2,1177,42159,3575892008,3575892022,14
2,1177,42160,3575892008,3575892022,14
2,1177,42161,3575892008,3575892023,15
2,1177,42162,3575892008,3575892023,15
2,1177,42163,3575892008,3575892025,17
2,1177,42164,3575892008,3575892026,18
2,1177,42165,3575892008,3575892026,18
2,1177,42166,3575892008,3575892027,19
2,1177,42167,3575892008,3575892027,19
2,1177,42168,3575892008,3575892027,19
2,1177,42169,3575892008,3575892028,20
2,1177,42170,3575892008,3575892028,20
2,1177,42171,3575892008,3575892028,20
2,1177,42172,3575892008,3575892029,21
2,1177,42173,3575892008,3575892032,24
2,1177,42174,3575892008,3575892034,26
2,1177,42175,3575892008,3575892035,27
2,1177,42176,3575892008,3575892036,28
2,1177,42177,3575892008,3575892036,28
2,1177,42178,3575892008,3575892036,28
2,1177,42179,3575892008,3575892037,29
2,1177,42180,3575892008,3575892037,29
2,1177,42181,3575892008,3575892038,30
2,1177,42182,3575892008,3575892039,31
2,1177,42183,3575892008,3575892039,31
2,1177,42184,3575892008,3575892041,33
2,1177,42185,3575892008,3575892042,34
2,1177,42186,3575892008,3575892043,35
2,1177,42187,3575892008,3575892045,37
2,1177,42188,3575892008,3575892047,39
2,1177,42189,3575892008,3575892048,40
2,1177,42190,3575892008,3575892051,43
2,1177,42191,3575892008,3575892053,45
2,1177,42192,3575892008,3575892054,46
2,1177,42193,3575892008,3575892054,46
2,1177,42194,3575892008,3575892054,46
2,1177,42195,3575892008,3575892054,46
2,1177,42196,3575892008,3575892055,47
2,1177,42197,3575892008,3575892055,47
2,1177,42198,3575892008,3575892056,48
2,1177,42199,3575892008,3575892056,48
2,1177,42200,3575892008,3575892057,49
2,1177,42201,3575892008,3575892057,49
2,1178,42202,3575892080,3575892080,0
2,1178,42203,3575892080,3575892080,0
2,1178,42204,3575892080,3575892080,0
2,1178,42205,3575892080,3575892080,0
2,1178,42206,3575892080,3575892080,0
2,1178,42207,3575892080,3575892080,0
2,1178,42208,3575892080,3575892080,0
2,1178,42209,3575892080,3575892080,0
2,1178,42210,3575892080,3575892080,0
2,1178,42211,3575892080,3575892080,0
2,1178,42212,3575892080,3575892080,0
2,1178,42213,3575892080,3575892082,2
2,1178,42214,3575892080,3575892083,3
2,1178,42215,3575892080,3575892085,5
2,1178,42216,3575892080,3575892086,6
2,1178,42217,3575892080,3575892086,6
2,1178,42218,3575892080,3575892086,6
2,1178,42219,3575892080,3575892086,6
2,1178,42220,3575892080,3575892087,7
2,1178,42221,3575892080,3575892087,7
2,1178,42222,3575892080,3575892088,8
2,1178,42223,3575892080,3575892089,9
2,1178,42224,3575892080,3575892090,10
2,1178,42225,3575892080,3575892091,11
2,1178,42226,3575892080,3575892091,11
2,1178,42227,3575892080,3575892091,11
2,1178,42228,3575892080,3575892092,12
2,1178,42229,3575892080,3575892092,12
2,1178,42230,3575892080,3575892092,12
2,1178,42231,3575892080,3575892093,13
2,1178,42232,3575892080,3575892093,13
2,1178,42233,3575892080,3575892095,15
2,1178,42234,3575892080,3575892095,15
2,1178,42235,3575892080,3575892095,15
2,1178,42236,3575892080,3575892095,15
2,1178,42237,3575892080,3575892096,16
2,1178,42238,3575892080,3575892096,16
2,1178,42239,3575892080,3575892097,17
2,1178,42240,3575892080,3575892097,17
2,1178,42241,3575892080,3575892098,18
2,1178,42242,3575892080,3575892098,18
2,1178,42243,3575892080,3575892099,19
2,1178,42244,3575892080,3575892100,20
2,1178,42245,3575892080,3575892102,22
2,1178,42246,3575892080,3575892102,22
2,1178,42247,3575892080,3575892103,23
2,1178,42248,3575892080,3575892105,25
2,1178,42249,3575892080,3575892106,26
2,1178,42250,3575892080,3575892106,26
2,1178,42251,3575892080,3575892107,27
2,1178,42252,3575892080,3575892107,27
2,1178,42253,3575892080,3575892107,27
2,1178,42254,3575892080,3575892108,28
2,1178,42255,3575892080,3575892108,28
2,1178,42256,3575892080,3575892108,28
2,1178,42257,3575892080,3575892108,28
2,1178,42258,3575892080,3575892108,28
2,1178,42259,3575892080,3575892108,28
2,1178,42260,3575892080,3575892108,28
2,1178,42261,3575892080,3575892109,29
2,1178,42262,3575892080,3575892110,30
2,1178,42263,3575892080,3575892111,31
2,1178,42264,3575892080,3575892114,34
2,1178,42265,3575892080,3575892114,34
2,1178,42266,3575892080,3575892114,34
2,1178,42267,3575892080,3575892114,34
2,1178,42268,3575892080,3575892114,34
2,1178,42269,3575892080,3575892116,36
2,1178,42270,3575892080,3575892117,37
2,1178,42271,3575892080,3575892117,37
2,1178,42272,3575892080,3575892117,37
2,1178,42273,3575892080,3575892119,39
2,1178,42274,3575892080,3575892119,39
2,1178,42275,3575892080,3575892120,40
2,1178,42276,3575892080,3575892120,40
2,1178,42277,3575892080,3575892120,40
2,1178,42278,3575892080,3575892121,41
2,1178,42279,3575892080,3575892122,42
2,1178,42280,3575892080,3575892123,43
2,1178,42281,3575892080,3575892125,45
2,1178,42282,3575892080,3575892125,45
2,1178,42283,3575892080,3575892126,46
2,1178,42284,3575892080,3575892126,46
2,1178,42285,3575892080,3575892127,47
2,1178,42286,3575892080,3575892128,48
2,1178,42287,3575892080,3575892128,48
2,1178,42288,3575892080,3575892128,48
2,1179,42289,3575892145,3575892145,0
2,1179,42290,3575892145,3575892145,0
2,1179,42291,3575892145,3575892145,0
2,1179,42292,3575892145,3575892145,0
2,1179,42293,3575892145,3575892145,0
2,1179,42294,3575892145,3575892145,0
2,1179,42295,3575892145,3575892145,0
2,1179,42296,3575892145,3575892145,0
2,1179,42297,3575892145,3575892145,0
2,1179,42298,3575892145,3575892145,0
2,1179,42299,3575892145,3575892145,0
2,1179,42300,3575892145,3575892145,0
2,1179,42301,3575892145,3575892145,0
2,1179,42302,3575892145,3575892145,0
2,1179,42303,3575892145,3575892145,0
2,1179,42304,3575892145,3575892145,0
2,1179,42305,3575892145,3575892145,0
2,1179,42306,3575892145,3575892145,0
2,1179,42307,3575892145,3575892145,0
2,1179,42308,3575892145,3575892145,0
2,1179,42309,3575892145,3575892145,0
2,1179,42310,3575892145,3575892145,0
2,1179,42311,3575892145,3575892145,0
2,1179,42312,3575892145,3575892146,1
2,1179,42313,3575892145,3575892147,2
2,1179,42314,3575892145,3575892147,2
2,1179,42315,3575892145,3575892148,3
2,1179,42316,3575892145,3575892148,3
2,1179,42317,3575892145,3575892149,4
2,1179,42318,3575892145,3575892151,6
2,1179,42319,3575892145,3575892152,7
2,1179,42320,3575892145,3575892152,7
2,1179,42321,3575892145,3575892154,9
2,1179,42322,3575892145,3575892154,9
2,1179,42323,3575892145,3575892154,9
2,1179,42324,3575892145,3575892156,11
2,1179,42325,3575892145,3575892159,14
2,1179,42326,3575892145,3575892160,15
2,1179,42327,3575892145,3575892160,15
2,1179,42328,3575892145,3575892161,16
2,1179,42329,3575892145,3575892161,16
2,1179,42330,3575892145,3575892161,16
2,1179,42331,3575892145,3575892161,16
2,1179,42332,3575892145,3575892163,18
2,1179,42333,3575892145,3575892164,19
2,1179,42334,3575892145,3575892165,20
2,1179,42335,3575892145,3575892166,21
2,1179,42336,3575892145,3575892166,21
2,1179,42337,3575892145,3575892166,21
2,1179,42338,3575892145,3575892168,23
2,1179,42339,3575892145,3575892168,23
2,1179,42340,3575892145,3575892168,23
2,1179,42341,3575892145,3575892169,24
2,1179,42342,3575892145,3575892169,24
2,1179,42343,3575892145,3575892170,25
2,1179,42344,3575892145,3575892170,25
2,1179,42345,3575892145,3575892171,26
2,1179,42346,3575892145,3575892171,26
2,1179,42347,3575892145,3575892172,27
2,1179,42348,3575892145,3575892174,29
2,1179,42349,3575892145,3575892175,30
2,1179,42350,3575892145,3575892175,30
2,1179,42351,3575892145,3575892176,31
2,1179,42352,3575892145,3575892176,31
2,1179,42353,3575892145,3575892177,32
2,1179,42354,3575892145,3575892177,32
2,1179,42355,3575892145,3575892178,33
2,1179,42356,3575892145,3575892178,33
2,1179,42357,3575892145,3575892179,34
2,1179,42358,3575892145,3575892181,36
2,1179,42359,3575892145,3575892181,36
2,1179,42360,3575892145,3575892181,36
2,1179,42361,3575892145,3575892183,38
2,1179,42362,3575892145,3575892184,39
2,1179,42363,3575892145,3575892185,40
2,1179,42364,3575892145,3575892185,40
2,1179,42365,3575892145,3575892185,40
2,1179,42366,3575892145,3575892186,41
2,1179,42367,3575892145,3575892186,41
2,1179,42368,3575892145,3575892186,41
2,1179,42369,3575892145,3575892186,41
2,1179,42370,3575892145,3575892187,42
2,1179,42371,3575892145,3575892187,42
2,1179,42372,3575892145,3575892188,43
2,1179,42373,3575892145,3575892188,43
2,1179,42374,3575892145,3575892190,45
2,1179,42375,3575892145,3575892191,46
2,1179,42376,3575892145,3575892191,46
2,1179,42377,3575892145,3575892192,47
2,1179,42378,3575892145,3575892193,48
2,1179,42379,3575892145,3575892193,48
2,1179,42380,3575892145,3575892194,49
2,1179,42381,3575892145,3575892195,50
2,1180,42382,3575892209,3575892209,0
2,1180,42383,3575892209,3575892209,0
2,1180,42384,3575892209,3575892209,0
2,1180,42385,3575892209,3575892209,0
2,1180,42386,3575892209,3575892209,0
2,1180,42387,3575892209,3575892209,0
2,1180,42388,3575892209,3575892209,0
2,1180,42389,3575892209,3575892209,0
2,1180,42390,3575892209,3575892209,0
2,1180,42391,3575892209,3575892209,0
2,1180,42392,3575892209,3575892209,0
2,1180,42393,3575892209,3575892209,0
2,1180,42394,3575892209,3575892209,0
2,1180,42395,3575892209,3575892209,0
2,1180,42396,3575892209,3575892209,0
2,1180,42397,3575892209,3575892209,0
2,1180,42398,3575892209,3575892209,0
2,1180,42399,3575892209,3575892209,0
2,1180,42400,3575892209,3575892210,1
2,1180,42401,3575892209,3575892211,2
2,1180,42402,3575892209,3575892212,3
2,1180,42403,3575892209,3575892212,3
2,1180,42404,3575892209,3575892214,5
2,1180,42405,3575892209,3575892215,6
2,1180,42406,3575892209,3575892220,11
2,1180,42407,3575892209,3575892220,11
2,1180,42408,3575892209,3575892220,11
2,1180,42409,3575892209,3575892222,13
2,1180,42410,3575892209,3575892222,13
2,1180,42411,3575892209,3575892223,14
2,1180,42412,3575892209,3575892223,14
2,1180,42413,3575892209,3575892226,17
2,1180,42414,3575892209,3575892227,18
2,1180,42415,3575892209,3575892227,18
2,1180,42416,3575892209,3575892228,19
2,1180,42417,3575892209,3575892228,19
2,1180,42418,3575892209,3575892228,19
2,1180,42419,3575892209,3575892228,19
2,1180,42420,3575892209,3575892228,19
2,1180,42421,3575892209,3575892229,20
2,1180,42422,3575892209,3575892229,20
2,1180,42423,3575892209,3575892229,20
2,1180,42424,3575892209,3575892232,23
2,1180,42425,3575892209,3575892233,24
2,1180,42426,3575892209,3575892235,26
2,1180,42427,3575892209,3575892235,26
2,1180,42428,3575892209,3575892236,27
2,1180,42429,3575892209,3575892237,28
2,1180,42430,3575892209,3575892238,29
2,1180,42431,3575892209,3575892238,29
2,1180,42432,3575892209,3575892239,30
2,1180,42433,3575892209,3575892239,30
2,1180,42434,3575892209,3575892240,31
2,1180,42435,3575892209,3575892241,32
2,1180,42436,3575892209,3575892242,33
2,1180,42437,3575892209,3575892242,33
2,1180,42438,3575892209,3575892243,34
2,1180,42439,3575892209,3575892245,36
2,1180,42440,3575892209,3575892248,39
2,1180,42441,3575892209,3575892248,39
2,1180,42442,3575892209,3575892253,44
2,1180,42443,3575892209,3575892254,45
2,1180,42444,3575892209,3575892255,46
2,1180,42445,3575892209,3575892255,46
2,1180,42446,3575892209,3575892255,46
2,1180,42447,3575892209,3575892255,46
2,1180,42448,3575892209,3575892255,46
2,1180,42449,3575892209,3575892256,47
2,1180,42450,3575892209,3575892257,48
2,1180,42451,3575892209,3575892257,48
2,1181,42452,3575892273,3575892273,0
2,1181,42453,3575892273,3575892273,0
2,1181,42454,3575892273,3575892273,0
2,1181,42455,3575892273,3575892273,0
2,1181,42456,3575892273,3575892273,0
2,1181,42457,3575892273,3575892273,0
2,1181,42458,3575892273,3575892273,0
2,1181,42459,3575892273,3575892276,3
2,1181,42460,3575892273,3575892279,6
2,1181,42461,3575892273,3575892281,8
2,1181,42462,3575892273,3575892281,8
2,1181,42463,3575892273,3575892283,10
2,1181,42464,3575892273,3575892285,12
2,1181,42465,3575892273,3575892286,13
2,1181,42466,3575892273,3575892286,13
2,1181,42467,3575892273,3575892286,13
2,1181,42468,3575892273,3575892287,14
2,1181,42469,3575892273,3575892287,14
2,1181,42470,3575892273,3575892287,14
2,1181,42471,3575892273,3575892287,14
2,1181,42472,3575892273,3575892288,15
2,1181,42473,3575892273,3575892289,16
2,1181,42474,3575892273,3575892290,17
2,1181,42475,3575892273,3575892291,18
2,1181,42476,3575892273,3575892291,18
2,1181,42477,3575892273,3575892291,18
2,1181,42478,3575892273,3575892292,19
2,1181,42479,3575892273,3575892292,19
2,1181,42480,3575892273,3575892292,19
2,1181,42481,3575892273,3575892293,20
2,1181,42482,3575892273,3575892293,20
2,1181,42483,3575892273,3575892294,21
2,1181,42484,3575892273,3575892295,22
2,1181,42485,3575892273,3575892295,22
2,1181,42486,3575892273,3575892296,23
2,1181,42487,3575892273,3575892296,23
2,1181,42488,3575892273,3575892297,24
2,1181,42489,3575892273,3575892297,24
2,1181,42490,3575892273,3575892298,25
2,1181,42491,3575892273,3575892298,25
2,1181,42492,3575892273,3575892298,25
2,1181,42493,3575892273,3575892298,25
2,1181,42494,3575892273,3575892298,25
2,1181,42495,3575892273,3575892300,27
2,1181,42496,3575892273,3575892302,29
2,1181,42497,3575892273,3575892303,30
2,1181,42498,3575892273,3575892304,31
2,1181,42499,3575892273,3575892305,32
2,1181,42500,3575892273,3575892306,33
2,1181,42501,3575892273,3575892306,33
2,1181,42502,3575892273,3575892307,34
2,1181,42503,3575892273,3575892307,34
2,1181,42504,3575892273,3575892307,34
2,1181,42505,3575892273,3575892308,35
2,1181,42506,3575892273,3575892308,35
2,1181,42507,3575892273,3575892308,35
2,1181,42508,3575892273,3575892308,35
2,1181,42509,3575892273,3575892308,35
2,1181,42510,3575892273,3575892308,35
2,1181,42511,3575892273,3575892309,36
2,1181,42512,3575892273,3575892310,37
2,1181,42513,3575892273,3575892311,38
2,1181,42514,3575892273,3575892311,38
2,1181,42515,3575892273,3575892311,38
2,1181,42516,3575892273,3575892313,40
2,1181,42517,3575892273,3575892314,41
2,1181,42518,3575892273,3575892314,41
2,1181,42519,3575892273,3575892314,41
2,1181,42520,3575892273,3575892315,42
2,1181,42521,3575892273,3575892315,42
2,1181,42522,3575892273,3575892316,43
2,1181,42523,3575892273,3575892317,44
2,1181,42524,3575892273,3575892317,44
2,1181,42525,3575892273,3575892318,45
2,1181,42526,3575892273,3575892320,47
2,1181,42527,3575892273,3575892320,47
2,1181,42528,3575892273,3575892320,47
2,1181,42529,3575892273,3575892320,47
2,1181,42530,3575892273,3575892321,48
2,1181,42531,3575892273,3575892321,48
2,1181,42532,3575892273,3575892321,48
2,1181,42533,3575892273,3575892322,49
2,1181,42534,3575892273,3575892323,50
2,1182,42535,3575892337,3575892337,0
2,1182,42536,3575892337,3575892337,0
2,1182,42537,3575892337,3575892337,0
2,1182,42538,3575892337,3575892337,0
2,1182,42539,3575892337,3575892337,0
2,1182,42540,3575892337,3575892337,0
2,1182,42541,3575892337,3575892337,0
2,1182,42542,3575892337,3575892337,0
2,1182,42543,3575892337,3575892337,0
2,1182,42544,3575892337,3575892337,0
2,1182,42545,3575892337,3575892337,0
2,1182,42546,3575892337,3575892337,0
2,1182,42547,3575892337,3575892337,0
2,1182,42548,3575892337,3575892337,0
2,1182,42549,3575892337,3575892337,0
2,1182,42550,3575892337,3575892337,0
2,1182,42551,3575892337,3575892337,0
2,1182,42552,3575892337,3575892337,0
2,1182,42553,3575892337,3575892337,0
2,1182,42554,3575892337,3575892337,0
2,1182,42555,3575892337,3575892337,0
2,1182,42556,3575892337,3575892337,0
2,1182,42557,3575892337,3575892337,0
2,1182,42558,3575892337,3575892339,2
2,1182,42559,3575892337,3575892339,2
2,1182,42560,3575892337,3575892340,3
2,1182,42561,3575892337,3575892340,3
2,1182,42562,3575892337,3575892343,6
2,1182,42563,3575892337,3575892344,7
2,1182,42564,3575892337,3575892344,7
2,1182,42565,3575892337,3575892345,8
2,1182,42566,3575892337,3575892345,8
2,1182,42567,3575892337,3575892346,9
2,1182,42568,3575892337,3575892346,9
2,1182,42569,3575892337,3575892347,10
2,1182,42570,3575892337,3575892347,10
2,1182,42571,3575892337,3575892348,11
2,1182,42572,3575892337,3575892348,11
2,1182,42573,3575892337,3575892349,12
2,1182,42574,3575892337,3575892349,12
2,1182,42575,3575892337,3575892350,13
2,1182,42576,3575892337,3575892351,14
2,1182,42577,3575892337,3575892352,15
2,1182,42578,3575892337,3575892352,15
2,1182,42579,3575892337,3575892352,15
2,1182,42580,3575892337,3575892353,16
2,1182,42581,3575892337,3575892354,17
2,1182,42582,3575892337,3575892354,17
2,1182,42583,3575892337,3575892357,20
2,1182,42584,3575892337,3575892357,20
2,1182,42585,3575892337,3575892359,22
2,1182,42586,3575892337,3575892360,23
2,1182,42587,3575892337,3575892360,23
2,1182,42588,3575892337,3575892360,23
2,1182,42589,3575892337,3575892361,24
2,1182,42590,3575892337,3575892361,24
2,1182,42591,3575892337,3575892361,24
2,1182,42592,3575892337,3575892361,24
2,1182,42593,3575892337,3575892362,25
2,1182,42594,3575892337,3575892362,25
2,1182,42595,3575892337,3575892365,28
2,1182,42596,3575892337,3575892366,29
2,1182,42597,3575892337,3575892366,29
2,1182,42598,3575892337,3575892366,29
2,1182,42599,3575892337,3575892368,31
2,1182,42600,3575892337,3575892368,31
2,1182,42601,3575892337,3575892368,31
2,1182,42602,3575892337,3575892368,31
2,1182,42603,3575892337,3575892369,32
2,1182,42604,3575892337,3575892370,33
2,1182,42605,3575892337,3575892371,34
2,1182,42606,3575892337,3575892371,34
2,1182,42607,3575892337,3575892371,34
2,1182,42608,3575892337,3575892373,36
2,1182,42609,3575892337,3575892375,38
2,1182,42610,3575892337,3575892375,38
2,1182,42611,3575892337,3575892376,39
2,1182,42612,3575892337,3575892376,39
2,1182,42613,3575892337,3575892377,40
2,1182,42614,3575892337,3575892377,40
2,1182,42615,3575892337,3575892377,40
2,1182,42616,3575892337,3575892378,41
2,1182,42617,3575892337,3575892379,42
2,1182,42618,3575892337,3575892380,43
2,1182,42619,3575892337,3575892380,43
2,1182,42620,3575892337,3575892381,44
2,1182,42621,3575892337,3575892382,45
2,1182,42622,3575892337,3575892382,45
2,1182,42623,3575892337,3575892384,47
2,1182,42624,3575892337,3575892385,48
2,1182,42625,3575892337,3575892385,48
2,1182,42626,3575892337,3575892386,49
2,1182,42627,3575892337,3575892386,49
2,1182,42628,3575892337,3575892386,49
2,1182,42629,3575892337,3575892386,49
2,1182,42630,3575892337,3575892387,50
2,1183,42631,3575892405,3575892405,0
2,1183,42632,3575892405,3575892405,0
2,1183,42633,3575892405,3575892405,0
2,1183,42634,3575892405,3575892405,0
2,1183,42635,3575892405,3575892405,0
2,1183,42636,3575892405,3575892405,0
2,1183,42637,3575892405,3575892405,0
2,1183,42638,3575892405,3575892405,0
2,1183,42639,3575892405,3575892405,0
2,1183,42640,3575892405,3575892405,0
2,1183,42641,3575892405,3575892405,0
2,1183,42642,3575892405,3575892405,0
2,1183,42643,3575892405,3575892405,0
2,1183,42644,3575892405,3575892405,0
2,1183,42645,3575892405,3575892405,0
2,1183,42646,3575892405,3575892405,0
2,1183,42647,3575892405,3575892405,0
2,1183,42648,3575892405,3575892405,0
2,1183,42649,3575892405,3575892405,0
2,1183,42650,3575892405,3575892405,0
2,1183,42651,3575892405,3575892405,0
2,1183,42652,3575892405,3575892405,0
2,1183,42653,3575892405,3575892405,0
2,1183,42654,3575892405,3575892405,0
2,1183,42655,3575892405,3575892405,0
2,1183,42656,3575892405,3575892405,0
2,1183,42657,3575892405,3575892405,0
2,1183,42658,3575892405,3575892405,0
2,1183,42659,3575892405,3575892406,1
2,1183,42660,3575892405,3575892408,3
2,1183,42661,3575892405,3575892410,5
2,1183,42662,3575892405,3575892411,6
2,1183,42663,3575892405,3575892411,6
2,1183,42664,3575892405,3575892413,8
2,1183,42665,3575892405,3575892414,9
2,1183,42666,3575892405,3575892416,11
2,1183,42667,3575892405,3575892421,16
2,1183,42668,3575892405,3575892421,16
2,1183,42669,3575892405,3575892422,17
2,1183,42670,3575892405,3575892422,17
2,1183,42671,3575892405,3575892423,18
2,1183,42672,3575892405,3575892423,18
2,1183,42673,3575892405,3575892424,19
2,1183,42674,3575892405,3575892426,21
2,1183,42675,3575892405,3575892427,22
2,1183,42676,3575892405,3575892427,22
2,1183,42677,3575892405,3575892428,23
2,1183,42678,3575892405,3575892428,23
2,1183,42679,3575892405,3575892428,23
2,1183,42680,3575892405,3575892428,23
2,1183,42681,3575892405,3575892428,23
2,1183,42682,3575892405,3575892428,23
2,1183,42683,3575892405,3575892428,23
2,1183,42684,3575892405,3575892429,24
2,1183,42685,3575892405,3575892433,28
2,1183,42686,3575892405,3575892434,29
2,1183,42687,3575892405,3575892435,30
2,1183,42688,3575892405,3575892435,30
2,1183,42689,3575892405,3575892436,31
2,1183,42690,3575892405,3575892437,32
2,1183,42691,3575892405,3575892437,32
2,1183,42692,3575892405,3575892438,33
2,1183,42693,3575892405,3575892439,34
2,1183,42694,3575892405,3575892440,35
2,1183,42695,3575892405,3575892440,35
2,1183,42696,3575892405,3575892441,36
2,1183,42697,3575892405,3575892441,36
2,1183,42698,3575892405,3575892443,38
2,1183,42699,3575892405,3575892443,38
2,1183,42700,3575892405,3575892445,40
2,1183,42701,3575892405,3575892446,41
2,1183,42702,3575892405,3575892448,43
2,1183,42703,3575892405,3575892448,43
2,1183,42704,3575892405,3575892451,46
2,1183,42705,3575892405,3575892453,48
2,1183,42706,3575892405,3575892455,50
2,1183,42707,3575892405,3575892455,50
2,1184,42708,3575892469,3575892469,0
2,1184,42709,3575892469,3575892469,0
2,1184,42710,3575892469,3575892469,0
2,1184,42711,3575892469,3575892469,0
2,1184,42712,3575892469,3575892469,0
2,1184,42713,3575892469,3575892469,0
2,1184,42714,3575892469,3575892469,0
2,1184,42715,3575892469,3575892469,0
2,1184,42716,3575892469,3575892469,0
2,1184,42717,3575892469,3575892469,0
2,1184,42718,3575892469,3575892469,0
2,1184,42719,3575892469,3575892469,0
2,1184,42720,3575892469,3575892469,0
2,1184,42721,3575892469,3575892469,0
2,1184,42722,3575892469,3575892469,0
2,1184,42723,3575892469,3575892469,0
2,1184,42724,3575892469,3575892476,7
2,1184,42725,3575892469,3575892479,10
2,1184,42726,3575892469,3575892481,12
2,1184,42727,3575892469,3575892484,15
2,1184,42728,3575892469,3575892485,16
2,1184,42729,3575892469,3575892485,16
2,1184,42730,3575892469,3575892486,17
2,1184,42731,3575892469,3575892486,17
2,1184,42732,3575892469,3575892486,17
2,1184,42733,3575892469,3575892487,18
2,1184,42734,3575892469,3575892488,19
2,1184,42735,3575892469,3575892488,19
2,1184,42736,3575892469,3575892489,20
2,1184,42737,3575892469,3575892491,22
2,1184,42738,3575892469,3575892491,22
2,1184,42739,3575892469,3575892491,22
2,1184,42740,3575892469,3575892492,23
2,1184,42741,3575892469,3575892492,23
2,1184,42742,3575892469,3575892492,23
2,1184,42743,3575892469,3575892492,23
2,1184,42744,3575892469,3575892493,24
2,1184,42745,3575892469,3575892493,24
2,1184,42746,3575892469,3575892494,25
2,1184,42747,3575892469,3575892494,25
2,1184,42748,3575892469,3575892496,27
2,1184,42749,3575892469,3575892496,27
2,1184,42750,3575892469,3575892496,27
2,1184,42751,3575892469,3575892497,28
2,1184,42752,3575892469,3575892497,28
2,1184,42753,3575892469,3575892498,29
2,1184,42754,3575892469,3575892498,29
2,1184,42755,3575892469,3575892499,30
2,1184,42756,3575892469,3575892499,30
2,1184,42757,3575892469,3575892500,31
2,1184,42758,3575892469,3575892501,32
2,1184,42759,3575892469,3575892503,34
2,1184,42760,3575892469,3575892503,34
2,1184,42761,3575892469,3575892504,35
2,1184,42762,3575892469,3575892504,35
2,1184,42763,3575892469,3575892506,37
2,1184,42764,3575892469,3575892506,37
2,1184,42765,3575892469,3575892507,38
2,1184,42766,3575892469,3575892508,39
2,1184,42767,3575892469,3575892508,39
2,1184,42768,3575892469,3575892508,39
2,1184,42769,3575892469,3575892508,39
2,1184,42770,3575892469,3575892508,39
2,1184,42771,3575892469,3575892509,40
2,1184,42772,3575892469,3575892509,40
2,1184,42773,3575892469,3575892510,41
2,1184,42774,3575892469,3575892510,41
2,1184,42775,3575892469,3575892511,42
2,1184,42776,3575892469,3575892511,42
2,1184,42777,3575892469,3575892511,42
2,1184,42778,3575892469,3575892514,45
2,1184,42779,3575892469,3575892514,45
2,1184,42780,3575892469,3575892516,47
2,1184,42781,3575892469,3575892516,47
2,1184,42782,3575892469,3575892516,47
2,1184,42783,3575892469,3575892516,47
2,1184,42784,3575892469,3575892517,48
2,1184,42785,3575892469,3575892518,49
2,1185,42786,3575892531,3575892531,0
2,1185,42787,3575892531,3575892531,0
2,1185,42788,3575892531,3575892531,0
2,1185,42789,3575892531,3575892531,0
2,1185,42790,3575892531,3575892531,0
2,1185,42791,3575892531,3575892531,0
2,1185,42792,3575892531,3575892531,0
2,1185,42793,3575892531,3575892531,0
2,1185,42794,3575892531,3575892531,0
2,1185,42795,3575892531,3575892531,0
2,1185,42796,3575892531,3575892531,0
2,1185,42797,3575892531,3575892531,0
2,1185,42798,3575892531,3575892531,0
2,1185,42799,3575892531,3575892531,0
2,1185,42800,3575892531,3575892531,0
2,1185,42801,3575892531,3575892531,0
2,1185,42802,3575892531,3575892531,0
2,1185,42803,3575892531,3575892531,0
2,1185,42804,3575892531,3575892532,1
2,1185,42805,3575892531,3575892532,1
2,1185,42806,3575892531,3575892533,2
2,1185,42807,3575892531,3575892533,2
2,1185,42808,3575892531,3575892533,2
2,1185,42809,3575892531,3575892534,3
2,1185,42810,3575892531,3575892535,4
2,1185,42811,3575892531,3575892535,4
2,1185,42812,3575892531,3575892536,5
2,1185,42813,3575892531,3575892537,6
2,1185,42814,3575892531,3575892539,8
2,1185,42815,3575892531,3575892539,8
2,1185,42816,3575892531,3575892540,9
2,1185,42817,3575892531,3575892540,9
2,1185,42818,3575892531,3575892542,11
2,1185,42819,3575892531,3575892543,12
2,1185,42820,3575892531,3575892544,13
2,1185,42821,3575892531,3575892544,13
2,1185,42822,3575892531,3575892545,14
2,1185,42823,3575892531,3575892545,14
2,1185,42824,3575892531,3575892546,15
2,1185,42825,3575892531,3575892546,15
2,1185,42826,3575892531,3575892547,16
2,1185,42827,3575892531,3575892548,17
2,1185,42828,3575892531,3575892548,17
2,1185,42829,3575892531,3575892548,17
2,1185,42830,3575892531,3575892548,17
2,1185,42831,3575892531,3575892550,19
2,1185,42832,3575892531,3575892551,20
2,1185,42833,3575892531,3575892551,20
2,1185,42834,3575892531,3575892551,20
2,1185,42835,3575892531,3575892552,21
2,1185,42836,3575892531,3575892552,21
2,1185,42837,3575892531,3575892553,22
2,1185,42838,3575892531,3575892553,22
2,1185,42839,3575892531,3575892556,25
2,1185,42840,3575892531,3575892559,28
2,1185,42841,3575892531,3575892559,28
2,1185,42842,3575892531,3575892559,28
2,1185,42843,3575892531,3575892560,29
2,1185,42844,3575892531,3575892560,29
2,1185,42845,3575892531,3575892560,29
2,1185,42846,3575892531,3575892560,29
2,1185,42847,3575892531,3575892560,29
2,1185,42848,3575892531,3575892561,30
2,1185,42849,3575892531,3575892561,30
2,1185,42850,3575892531,3575892564,33
2,1185,42851,3575892531,3575892565,34
2,1185,42852,3575892531,3575892565,34
2,1185,42853,3575892531,3575892566,35
2,1185,42854,3575892531,3575892567,36
2,1185,42855,3575892531,3575892567,36
2,1185,42856,3575892531,3575892567,36
2,1185,42857,3575892531,3575892567,36
2,1185,42858,3575892531,3575892567,36
2,1185,42859,3575892531,3575892569,38
2,1185,42860,3575892531,3575892570,39
2,1185,42861,3575892531,3575892571,40
2,1185,42862,3575892531,3575892572,41
2,1185,42863,3575892531,3575892572,41
2,1185,42864,3575892531,3575892574,43
2,1185,42865,3575892531,3575892574,43
2,1185,42866,3575892531,3575892575,44
2,1185,42867,3575892531,3575892576,45
2,1185,42868,3575892531,3575892576,45
2,1185,42869,3575892531,3575892576,45
2,1185,42870,3575892531,3575892576,45
2,1185,42871,3575892531,3575892577,46
2,1185,42872,3575892531,3575892580,49
2,1185,42873,3575892531,3575892580,49
2,1185,42874,3575892531,3575892580,49
2,1185,42875,3575892531,3575892581,50
2,1186,42876,3575892595,3575892595,0
2,1186,42877,3575892595,3575892595,0
2,1186,42878,3575892595,3575892595,0
2,1186,42879,3575892595,3575892595,0
2,1186,42880,3575892595,3575892595,0
2,1186,42881,3575892595,3575892595,0
2,1186,42882,3575892595,3575892595,0
2,1186,42883,3575892595,3575892595,0
2,1186,42884,3575892595,3575892595,0
2,1186,42885,3575892595,3575892595,0
2,1186,42886,3575892595,3575892595,0
2,1186,42887,3575892595,3575892595,0
2,1186,42888,3575892595,3575892595,0
2,1186,42889,3575892595,3575892595,0
2,1186,42890,3575892595,3575892595,0
2,1186,42891,3575892595,3575892595,0
2,1186,42892,3575892595,3575892595,0
2,1186,42893,3575892595,3575892595,0
2,1186,42894,3575892595,3575892595,0
2,1186,42895,3575892595,3575892595,0
2,1186,42896,3575892595,3575892595,0
2,1186,42897,3575892595,3575892595,0
2,1186,42898,3575892595,3575892595,0
2,1186,42899,3575892595,3575892595,0
2,1186,42900,3575892595,3575892595,0
2,1186,42901,3575892595,3575892596,1
2,1186,42902,3575892595,3575892597,2
2,1186,42903,3575892595,3575892598,3
2,1186,42904,3575892595,3575892598,3
2,1186,42905,3575892595,3575892599,4
2,1186,42906,3575892595,3575892600,5
2,1186,42907,3575892595,3575892600,5
2,1186,42908,3575892595,3575892602,7
2,1186,42909,3575892595,3575892603,8
2,1186,42910,3575892595,3575892603,8
2,1186,42911,3575892595,3575892603,8
2,1186,42912,3575892595,3575892603,8
2,1186,42913,3575892595,3575892604,9
2,1186,42914,3575892595,3575892605,10
2,1186,42915,3575892595,3575892607,12
2,1186,42916,3575892595,3575892610,15
2,1186,42917,3575892595,3575892611,16
2,1186,42918,3575892595,3575892611,16
2,1186,42919,3575892595,3575892612,17
2,1186,42920,3575892595,3575892613,18
2,1186,42921,3575892595,3575892615,20
2,1186,42922,3575892595,3575892619,24
2,1186,42923,3575892595,3575892620,25
2,1186,42924,3575892595,3575892621,26
2,1186,42925,3575892595,3575892621,26
2,1186,42926,3575892595,3575892622,27
2,1186,42927,3575892595,3575892622,27
2,1186,42928,3575892595,3575892623,28
2,1186,42929,3575892595,3575892625,30
2,1186,42930,3575892595,3575892626,31
2,1186,42931,3575892595,3575892627,32
2,1186,42932,3575892595,3575892627,32
2,1186,42933,3575892595,3575892627,32
2,1186,42934,3575892595,3575892628,33
2,1186,42935,3575892595,3575892628,33
2,1186,42936,3575892595,3575892628,33
2,1186,42937,3575892595,3575892628,33
2,1186,42938,3575892595,3575892628,33
2,1186,42939,3575892595,3575892628,33
2,1186,42940,3575892595,3575892631,36
2,1186,42941,3575892595,3575892633,38
2,1186,42942,3575892595,3575892633,38
2,1186,42943,3575892595,3575892634,39
2,1186,42944,3575892595,3575892635,40
2,1186,42945,3575892595,3575892635,40
2,1186,42946,3575892595,3575892637,42
2,1186,42947,3575892595,3575892637,42
2,1186,42948,3575892595,3575892637,42
2,1186,42949,3575892595,3575892638,43
2,1186,42950,3575892595,3575892638,43
2,1186,42951,3575892595,3575892639,44
2,1186,42952,3575892595,3575892640,45
2,1186,42953,3575892595,3575892641,46
2,1186,42954,3575892595,3575892643,48
2,1186,42955,3575892595,3575892643,48
2,1186,42956,3575892595,3575892644,49
2,1187,42957,3575892658,3575892658,0
2,1187,42958,3575892658,3575892658,0
2,1187,42959,3575892658,3575892658,0
2,1187,42960,3575892658,3575892658,0
2,1187,42961,3575892658,3575892658,0
2,1187,42962,3575892658,3575892658,0
2,1187,42963,3575892658,3575892658,0
2,1187,42964,3575892658,3575892658,0
2,1187,42965,3575892658,3575892658,0
2,1187,42966,3575892658,3575892658,0
2,1187,42967,3575892658,3575892658,0
2,1187,42968,3575892658,3575892658,0
2,1187,42969,3575892658,3575892658,0
2,1187,42970,3575892658,3575892658,0
2,1187,42971,3575892658,3575892658,0
2,1187,42972,3575892658,3575892660,2
2,1187,42973,3575892658,3575892660,2
2,1187,42974,3575892658,3575892661,3
2,1187,42975,3575892658,3575892662,4
2,1187,42976,3575892658,3575892665,7
2,1187,42977,3575892658,3575892665,7
2,1187,42978,3575892658,3575892667,9
2,1187,42979,3575892658,3575892668,10
2,1187,42980,3575892658,3575892677,19
2,1187,42981,3575892658,3575892678,20
2,1187,42982,3575892658,3575892681,23
2,1187,42983,3575892658,3575892681,23
2,1187,42984,3575892658,3575892684,26
2,1187,42985,3575892658,3575892685,27
2,1187,42986,3575892658,3575892686,28
2,1187,42987,3575892658,3575892686,28
2,1187,42988,3575892658,3575892687,29
2,1187,42989,3575892658,3575892687,29
2,1187,42990,3575892658,3575892687,29
2,1187,42991,3575892658,3575892688,30
2,1187,42992,3575892658,3575892688,30
2,1187,42993,3575892658,3575892688,30
2,1187,42994,3575892658,3575892689,31
2,1187,42995,3575892658,3575892691,33
2,1187,42996,3575892658,3575892691,33
2,1187,42997,3575892658,3575892691,33
2,1187,42998,3575892658,3575892691,33
2,1187,42999,3575892658,3575892692,34
2,1187,43000,3575892658,3575892692,34
2,1187,43001,3575892658,3575892692,34
2,1187,43002,3575892658,3575892693,35
2,1187,43003,3575892658,3575892693,35
2,1187,43004,3575892658,3575892694,36
2,1187,43005,3575892658,3575892694,36
2,1187,43006,3575892658,3575892696,38
2,1187,43007,3575892658,3575892696,38
2,1187,43008,3575892658,3575892697,39
2,1187,43009,3575892658,3575892697,39
2,1187,43010,3575892658,3575892698,40
2,1187,43011,3575892658,3575892698,40
2,1187,43012,3575892658,3575892698,40
2,1187,43013,3575892658,3575892698,40
2,1187,43014,3575892658,3575892699,41
2,1187,43015,3575892658,3575892699,41
2,1187,43016,3575892658,3575892700,42
2,1187,43017,3575892658,3575892701,43
2,1187,43018,3575892658,3575892703,45
2,1187,43019,3575892658,3575892704,46
2,1187,43020,3575892658,3575892704,46
2,1187,43021,3575892658,3575892705,47
2,1187,43022,3575892658,3575892706,48
2,1187,43023,3575892658,3575892706,48
2,1187,43024,3575892658,3575892707,49
2,1187,43025,3575892658,3575892708,50
2,1187,43026,3575892658,3575892708,50
2,1188,43027,3575892726,3575892726,0
2,1188,43028,3575892726,3575892726,0
2,1188,43029,3575892726,3575892726,0
2,1188,43030,3575892726,3575892726,0
2,1188,43031,3575892726,3575892726,0
2,1188,43032,3575892726,3575892726,0
2,1188,43033,3575892726,3575892726,0
2,1188,43034,3575892726,3575892726,0
2,1188,43035,3575892726,3575892726,0
2,1188,43036,3575892726,3575892726,0
2,1188,43037,3575892726,3575892726,0
2,1188,43038,3575892726,3575892726,0
2,1188,43039,3575892726,3575892726,0
2,1188,43040,3575892726,3575892726,0
2,1188,43041,3575892726,3575892726,0
2,1188,43042,3575892726,3575892726,0
2,1188,43043,3575892726,3575892726,0
2,1188,43044,3575892726,3575892726,0
2,1188,43045,3575892726,3575892726,0
2,1188,43046,3575892726,3575892726,0
2,1188,43047,3575892726,3575892726,0
2,1188,43048,3575892726,3575892726,0
2,1188,43049,3575892726,3575892726,0
2,1188,43050,3575892726,3575892726,0
2,1188,43051,3575892726,3575892726,0
2,1188,43052,3575892726,3575892726,0
2,1188,43053,3575892726,3575892726,0
2,1188,43054,3575892726,3575892726,0
2,1188,43055,3575892726,3575892727,1
2,1188,43056,3575892726,3575892728,2
2,1188,43057,3575892726,3575892729,3
2,1188,43058,3575892726,3575892729,3
2,1188,43059,3575892726,3575892729,3
2,1188,43060,3575892726,3575892730,4
2,1188,43061,3575892726,3575892731,5
2,1188,43062,3575892726,3575892731,5
2,1188,43063,3575892726,3575892732,6
2,1188,43064,3575892726,3575892732,6
2,1188,43065,3575892726,3575892732,6
2,1188,43066,3575892726,3575892733,7
2,1188,43067,3575892726,3575892733,7
2,1188,43068,3575892726,3575892735,9
2,1188,43069,3575892726,3575892735,9
2,1188,43070,3575892726,3575892735,9
2,1188,43071,3575892726,3575892735,9
2,1188,43072,3575892726,3575892738,12
2,1188,43073,3575892726,3575892739,13
2,1188,43074,3575892726,3575892740,14
2,1188,43075,3575892726,3575892740,14
2,1188,43076,3575892726,3575892740,14
2,1188,43077,3575892726,3575892742,16
2,1188,43078,3575892726,3575892743,17
2,1188,43079,3575892726,3575892744,18
2,1188,43080,3575892726,3575892744,18
2,1188,43081,3575892726,3575892745,19
2,1188,43082,3575892726,3575892746,20
2,1188,43083,3575892726,3575892747,21
2,1188,43084,3575892726,3575892747,21
2,1188,43085,3575892726,3575892747,21
2,1188,43086,3575892726,3575892748,22
2,1188,43087,3575892726,3575892748,22
2,1188,43088,3575892726,3575892748,22
2,1188,43089,3575892726,3575892748,22
2,1188,43090,3575892726,3575892750,24
2,1188,43091,3575892726,3575892751,25
2,1188,43092,3575892726,3575892751,25
2,1188,43093,3575892726,3575892751,25
2,1188,43094,3575892726,3575892752,26
2,1188,43095,3575892726,3575892753,27
2,1188,43096,3575892726,3575892753,27
2,1188,43097,3575892726,3575892753,27
2,1188,43098,3575892726,3575892753,27
2,1188,43099,3575892726,3575892756,30
2,1188,43100,3575892726,3575892759,33
2,1188,43101,3575892726,3575892759,33
2,1188,43102,3575892726,3575892759,33
2,1188,43103,3575892726,3575892760,34
2,1188,43104,3575892726,3575892760,34
2,1188,43105,3575892726,3575892760,34
2,1188,43106,3575892726,3575892760,34
2,1188,43107,3575892726,3575892760,34
2,1188,43108,3575892726,3575892762,36
2,1188,43109,3575892726,3575892764,38
2,1188,43110,3575892726,3575892765,39
2,1188,43111,3575892726,3575892765,39
2,1188,43112,3575892726,3575892765,39
2,1188,43113,3575892726,3575892767,41
2,1188,43114,3575892726,3575892767,41
2,1188,43115,3575892726,3575892767,41
2,1188,43116,3575892726,3575892769,43
2,1188,43117,3575892726,3575892769,43
2,1188,43118,3575892726,3575892770,44
2,1188,43119,3575892726,3575892770,44
2,1188,43120,3575892726,3575892771,45
2,1188,43121,3575892726,3575892772,46
2,1188,43122,3575892726,3575892772,46
2,1188,43123,3575892726,3575892773,47
2,1188,43124,3575892726,3575892774,48
2,1188,43125,3575892726,3575892775,49
2,1188,43126,3575892726,3575892775,49
2,1189,43127,3575892790,3575892791,1
2,1189,43128,3575892790,3575892791,1
2,1189,43129,3575892790,3575892791,1
2,1189,43130,3575892790,3575892791,1
2,1189,43131,3575892790,3575892791,1
2,1189,43132,3575892790,3575892791,1
2,1189,43133,3575892790,3575892791,1
2,1189,43134,3575892790,3575892791,1
2,1189,43135,3575892790,3575892791,1
2,1189,43136,3575892790,3575892791,1
2,1189,43137,3575892790,3575892791,1
2,1189,43138,3575892790,3575892791,1
2,1189,43139,3575892790,3575892791,1
2,1189,43140,3575892790,3575892791,1
2,1189,43141,3575892790,3575892791,1
2,1189,43142,3575892790,3575892791,1
2,1189,43143,3575892790,3575892791,1
2,1189,43144,3575892790,3575892791,1
2,1189,43145,3575892790,3575892791,1
2,1189,43146,3575892790,3575892791,1
2,1189,43147,3575892790,3575892791,1
2,1189,43148,3575892790,3575892791,1
2,1189,43149,3575892790,3575892792,2
2,1189,43150,3575892790,3575892793,3
2,1189,43151,3575892790,3575892793,3
2,1189,43152,3575892790,3575892793,3
2,1189,43153,3575892790,3575892794,4
2,1189,43154,3575892790,3575892794,4
2,1189,43155,3575892790,3575892794,4
2,1189,43156,3575892790,3575892795,5
2,1189,43157,3575892790,3575892796,6
2,1189,43158,3575892790,3575892797,7
2,1189,43159,3575892790,3575892798,8
2,1189,43160,3575892790,3575892798,8
2,1189,43161,3575892790,3575892798,8
2,1189,43162,3575892790,3575892799,9
2,1189,43163,3575892790,3575892799,9
2,1189,43164,3575892790,3575892800,10
2,1189,43165,3575892790,3575892802,12
2,1189,43166,3575892790,3575892802,12
2,1189,43167,3575892790,3575892804,14
2,1189,43168,3575892790,3575892804,14
2,1189,43169,3575892790,3575892804,14
2,1189,43170,3575892790,3575892805,15
2,1189,43171,3575892790,3575892810,20
2,1189,43172,3575892790,3575892811,21
2,1189,43173,3575892790,3575892811,21
2,1189,43174,3575892790,3575892811,21
2,1189,43175,3575892790,3575892813,23
2,1189,43176,3575892790,3575892815,25
2,1189,43177,3575892790,3575892819,29
2,1189,43178,3575892790,3575892821,31
2,1189,43179,3575892790,3575892821,31
2,1189,43180,3575892790,3575892822,32
2,1189,43181,3575892790,3575892822,32
2,1189,43182,3575892790,3575892823,33
2,1189,43183,3575892790,3575892825,35
2,1189,43184,3575892790,3575892825,35
2,1189,43185,3575892790,3575892827,37
2,1189,43186,3575892790,3575892827,37
2,1189,43187,3575892790,3575892828,38
2,1189,43188,3575892790,3575892828,38
2,1189,43189,3575892790,3575892828,38
2,1189,43190,3575892790,3575892828,38
2,1189,43191,3575892790,3575892829,39
2,1189,43192,3575892790,3575892829,39
2,1189,43193,3575892790,3575892831,41
2,1189,43194,3575892790,3575892833,43
2,1189,43195,3575892790,3575892834,44
2,1189,43196,3575892790,3575892835,45
2,1189,43197,3575892790,3575892835,45
2,1189,43198,3575892790,3575892835,45
2,1189,43199,3575892790,3575892836,46
2,1189,43200,3575892790,3575892837,47
2,1189,43201,3575892790,3575892838,48
2,1189,43202,3575892790,3575892838,48
2,1189,43203,3575892790,3575892839,49
2,1189,43204,3575892790,3575892840,50
2,1190,43205,3575892860,3575892860,0
2,1190,43206,3575892860,3575892860,0
2,1190,43207,3575892860,3575892860,0
2,1190,43208,3575892860,3575892860,0
2,1190,43209,3575892860,3575892860,0
2,1190,43210,3575892860,3575892860,0
2,1190,43211,3575892860,3575892860,0
2,1190,43212,3575892860,3575892860,0
2,1190,43213,3575892860,3575892860,0
2,1190,43214,3575892860,3575892860,0
2,1190,43215,3575892860,3575892860,0
2,1190,43216,3575892860,3575892860,0
2,1190,43217,3575892860,3575892860,0
2,1190,43218,3575892860,3575892860,0
2,1190,43219,3575892860,3575892860,0
2,1190,43220,3575892860,3575892860,0
2,1190,43221,3575892860,3575892860,0
2,1190,43222,3575892860,3575892860,0
2,1190,43223,3575892860,3575892860,0
2,1190,43224,3575892860,3575892860,0
2,1190,43225,3575892860,3575892860,0
2,1190,43226,3575892860,3575892862,2
2,1190,43227,3575892860,3575892865,5
2,1190,43228,3575892860,3575892866,6
2,1190,43229,3575892860,3575892867,7
2,1190,43230,3575892860,3575892869,9
2,1190,43231,3575892860,3575892877,17
2,1190,43232,3575892860,3575892878,18
2,1190,43233,3575892860,3575892881,21
2,1190,43234,3575892860,3575892881,21
2,1190,43235,3575892860,3575892884,24
2,1190,43236,3575892860,3575892885,25
2,1190,43237,3575892860,3575892886,26
2,1190,43238,3575892860,3575892886,26
2,1190,43239,3575892860,3575892886,26
2,1190,43240,3575892860,3575892887,27
2,1190,43241,3575892860,3575892887,27
2,1190,43242,3575892860,3575892888,28
2,1190,43243,3575892860,3575892888,28
2,1190,43244,3575892860,3575892888,28
2,1190,43245,3575892860,3575892889,29
2,1190,43246,3575892860,3575892891,31
2,1190,43247,3575892860,3575892891,31
2,1190,43248,3575892860,3575892891,31
2,1190,43249,3575892860,3575892891,31
2,1190,43250,3575892860,3575892892,32
2,1190,43251,3575892860,3575892892,32
2,1190,43252,3575892860,3575892892,32
2,1190,43253,3575892860,3575892893,33
2,1190,43254,3575892860,3575892894,34
2,1190,43255,3575892860,3575892894,34
2,1190,43256,3575892860,3575892896,36
2,1190,43257,3575892860,3575892897,37
2,1190,43258,3575892860,3575892897,37
2,1190,43259,3575892860,3575892897,37
2,1190,43260,3575892860,3575892898,38
2,1190,43261,3575892860,3575892898,38
2,1190,43262,3575892860,3575892898,38
2,1190,43263,3575892860,3575892899,39
2,1190,43264,3575892860,3575892900,40
2,1190,43265,3575892860,3575892900,40
2,1190,43266,3575892860,3575892901,41
2,1190,43267,3575892860,3575892904,44
2,1190,43268,3575892860,3575892904,44
2,1190,43269,3575892860,3575892904,44
2,1190,43270,3575892860,3575892904,44
2,1190,43271,3575892860,3575892905,45
2,1190,43272,3575892860,3575892906,46
2,1190,43273,3575892860,3575892907,47
2,1190,43274,3575892860,3575892908,48
2,1190,43275,3575892860,3575892908,48
2,1190,43276,3575892860,3575892908,48
2,1190,43277,3575892860,3575892908,48
2,1190,43278,3575892860,3575892908,48
2,1190,43279,3575892860,3575892908,48
2,1190,43280,3575892860,3575892909,49
2,1190,43281,3575892860,3575892910,50
2,1191,43282,3575892926,3575892926,0
2,1191,43283,3575892926,3575892926,0
2,1191,43284,3575892926,3575892926,0
2,1191,43285,3575892926,3575892926,0
2,1191,43286,3575892926,3575892926,0
2,1191,43287,3575892926,3575892926,0
2,1191,43288,3575892926,3575892926,0
2,1191,43289,3575892926,3575892926,0
2,1191,43290,3575892926,3575892926,0
2,1191,43291,3575892926,3575892926,0
2,1191,43292,3575892926,3575892926,0
2,1191,43293,3575892926,3575892926,0
2,1191,43294,3575892926,3575892926,0
2,1191,43295,3575892926,3575892926,0
2,1191,43296,3575892926,3575892926,0
2,1191,43297,3575892926,3575892926,0
2,1191,43298,3575892926,3575892926,0
2,1191,43299,3575892926,3575892926,0
2,1191,43300,3575892926,3575892926,0
2,1191,43301,3575892926,3575892928,2
2,1191,43302,3575892926,3575892928,2
2,1191,43303,3575892926,3575892929,3
2,1191,43304,3575892926,3575892929,3
2,1191,43305,3575892926,3575892930,4
2,1191,43306,3575892926,3575892930,4
2,1191,43307,3575892926,3575892932,6
2,1191,43308,3575892926,3575892932,6
2,1191,43309,3575892926,3575892932,6
2,1191,43310,3575892926,3575892933,7
2,1191,43311,3575892926,3575892933,7
2,1191,43312,3575892926,3575892935,9
2,1191,43313,3575892926,3575892935,9
2,1191,43314,3575892926,3575892935,9
2,1191,43315,3575892926,3575892935,9
2,1191,43316,3575892926,3575892935,9
2,1191,43317,3575892926,3575892939,13
2,1191,43318,3575892926,3575892939,13
2,1191,43319,3575892926,3575892940,14
2,1191,43320,3575892926,3575892941,15
2,1191,43321,3575892926,3575892944,18
2,1191,43322,3575892926,3575892944,18
2,1191,43323,3575892926,3575892945,19
2,1191,43324,3575892926,3575892946,20
2,1191,43325,3575892926,3575892947,21
2,1191,43326,3575892926,3575892948,22
2,1191,43327,3575892926,3575892948,22
2,1191,43328,3575892926,3575892948,22
2,1191,43329,3575892926,3575892949,23
2,1191,43330,3575892926,3575892951,25
2,1191,43331,3575892926,3575892951,25
2,1191,43332,3575892926,3575892952,26
2,1191,43333,3575892926,3575892952,26
2,1191,43334,3575892926,3575892953,27
2,1191,43335,3575892926,3575892953,27
2,1191,43336,3575892926,3575892953,27
2,1191,43337,3575892926,3575892960,34
2,1191,43338,3575892926,3575892960,34
2,1191,43339,3575892926,3575892960,34
2,1191,43340,3575892926,3575892960,34
2,1191,43341,3575892926,3575892960,34
2,1191,43342,3575892926,3575892961,35
2,1191,43343,3575892926,3575892961,35
2,1191,43344,3575892926,3575892965,39
2,1191,43345,3575892926,3575892965,39
2,1191,43346,3575892926,3575892965,39
2,1191,43347,3575892926,3575892966,40
2,1191,43348,3575892926,3575892967,41
2,1191,43349,3575892926,3575892968,42
2,1191,43350,3575892926,3575892968,42
2,1191,43351,3575892926,3575892968,42
2,1191,43352,3575892926,3575892969,43
2,1191,43353,3575892926,3575892970,44
2,1191,43354,3575892926,3575892971,45
2,1191,43355,3575892926,3575892972,46
2,1191,43356,3575892926,3575892972,46
2,1191,43357,3575892926,3575892975,49
2,1191,43358,3575892926,3575892975,49
2,1191,43359,3575892926,3575892975,49
2,1191,43360,3575892926,3575892976,50
2,1192,43361,3575892997,3575892997,0
2,1192,43362,3575892997,3575892997,0
2,1192,43363,3575892997,3575892997,0
2,1192,43364,3575892997,3575892997,0
2,1192,43365,3575892997,3575892997,0
2,1192,43366,3575892997,3575892997,0
2,1192,43367,3575892997,3575892997,0
2,1192,43368,3575892997,3575892997,0
2,1192,43369,3575892997,3575892997,0
2,1192,43370,3575892997,3575892997,0
2,1192,43371,3575892997,3575892997,0
2,1192,43372,3575892997,3575892997,0
2,1192,43373,3575892997,3575892997,0
2,1192,43374,3575892997,3575892997,0
2,1192,43375,3575892997,3575892997,0
2,1192,43376,3575892997,3575892997,0
2,1192,43377,3575892997,3575892997,0
2,1192,43378,3575892997,3575892997,0
2,1192,43379,3575892997,3575892997,0
2,1192,43380,3575892997,3575892997,0
2,1192,43381,3575892997,3575892997,0
2,1192,43382,3575892997,3575892997,0
2,1192,43383,3575892997,3575892997,0
2,1192,43384,3575892997,3575892997,0
2,1192,43385,3575892997,3575892997,0
2,1192,43386,3575892997,3575892997,0
2,1192,43387,3575892997,3575892997,0
2,1192,43388,3575892997,3575892998,1
2,1192,43389,3575892997,3575892998,1
2,1192,43390,3575892997,3575892998,1
2,1192,43391,3575892997,3575892999,2
2,1192,43392,3575892997,3575892999,2
2,1192,43393,3575892997,3575892999,2
2,1192,43394,3575892997,3575893000,3
2,1192,43395,3575892997,3575893002,5
2,1192,43396,3575892997,3575893003,6
2,1192,43397,3575892997,3575893003,6
2,1192,43398,3575892997,3575893004,7
2,1192,43399,3575892997,3575893005,8
2,1192,43400,3575892997,3575893005,8
2,1192,43401,3575892997,3575893006,9
2,1192,43402,3575892997,3575893007,10
2,1192,43403,3575892997,3575893011,14
2,1192,43404,3575892997,3575893012,15
2,1192,43405,3575892997,3575893012,15
2,1192,43406,3575892997,3575893013,16
2,1192,43407,3575892997,3575893015,18
2,1192,43408,3575892997,3575893019,22
2,1192,43409,3575892997,3575893021,24
2,1192,43410,3575892997,3575893021,24
2,1192,43411,3575892997,3575893022,25
2,1192,43412,3575892997,3575893022,25
2,1192,43413,3575892997,3575893023,26
2,1192,43414,3575892997,3575893025,28
2,1192,43415,3575892997,3575893025,28
2,1192,43416,3575892997,3575893025,28
2,1192,43417,3575892997,3575893027,30
2,1192,43418,3575892997,3575893027,30
2,1192,43419,3575892997,3575893027,30
2,1192,43420,3575892997,3575893028,31
2,1192,43421,3575892997,3575893028,31
2,1192,43422,3575892997,3575893028,31
2,1192,43423,3575892997,3575893029,32
2,1192,43424,3575892997,3575893030,33
2,1192,43425,3575892997,3575893033,36
2,1192,43426,3575892997,3575893034,37
2,1192,43427,3575892997,3575893035,38
2,1192,43428,3575892997,3575893035,38
2,1192,43429,3575892997,3575893036,39
2,1192,43430,3575892997,3575893036,39
2,1192,43431,3575892997,3575893038,41
2,1192,43432,3575892997,3575893039,42
2,1192,43433,3575892997,3575893040,43
2,1192,43434,3575892997,3575893040,43
2,1192,43435,3575892997,3575893040,43
2,1192,43436,3575892997,3575893042,45
2,1192,43437,3575892997,3575893043,46
2,1192,43438,3575892997,3575893043,46
2,1192,43439,3575892997,3575893046,49
2,1192,43440,3575892997,3575893047,50
2,1193,43441,3575893065,3575893065,0
2,1193,43442,3575893065,3575893065,0
2,1193,43443,3575893065,3575893065,0
2,1193,43444,3575893065,3575893065,0
2,1193,43445,3575893065,3575893065,0
2,1193,43446,3575893065,3575893065,0
2,1193,43447,3575893065,3575893065,0
2,1193,43448,3575893065,3575893065,0
2,1193,43449,3575893065,3575893065,0
2,1193,43450,3575893065,3575893065,0
2,1193,43451,3575893065,3575893065,0
2,1193,43452,3575893065,3575893065,0
2,1193,43453,3575893065,3575893065,0
2,1193,43454,3575893065,3575893065,0
2,1193,43455,3575893065,3575893065,0
2,1193,43456,3575893065,3575893065,0
2,1193,43457,3575893065,3575893065,0
2,1193,43458,3575893065,3575893067,2
2,1193,43459,3575893065,3575893067,2
2,1193,43460,3575893065,3575893069,4
2,1193,43461,3575893065,3575893077,12
2,1193,43462,3575893065,3575893078,13
2,1193,43463,3575893065,3575893081,16
2,1193,43464,3575893065,3575893081,16
2,1193,43465,3575893065,3575893084,19
2,1193,43466,3575893065,3575893085,20
2,1193,43467,3575893065,3575893086,21
2,1193,43468,3575893065,3575893086,21
2,1193,43469,3575893065,3575893087,22
2,1193,43470,3575893065,3575893087,22
2,1193,43471,3575893065,3575893087,22
2,1193,43472,3575893065,3575893088,23
2,1193,43473,3575893065,3575893088,23
2,1193,43474,3575893065,3575893088,23
2,1193,43475,3575893065,3575893089,24
2,1193,43476,3575893065,3575893091,26
2,1193,43477,3575893065,3575893091,26
2,1193,43478,3575893065,3575893092,27
2,1193,43479,3575893065,3575893092,27
2,1193,43480,3575893065,3575893092,27
2,1193,43481,3575893065,3575893092,27
2,1193,43482,3575893065,3575893093,28
2,1193,43483,3575893065,3575893093,28
2,1193,43484,3575893065,3575893094,29
2,1193,43485,3575893065,3575893096,31
2,1193,43486,3575893065,3575893097,32
2,1193,43487,3575893065,3575893098,33
2,1193,43488,3575893065,3575893098,33
2,1193,43489,3575893065,3575893098,33
2,1193,43490,3575893065,3575893098,33
2,1193,43491,3575893065,3575893098,33
2,1193,43492,3575893065,3575893098,33
2,1193,43493,3575893065,3575893100,35
2,1193,43494,3575893065,3575893101,36
2,1193,43495,3575893065,3575893103,38
2,1193,43496,3575893065,3575893104,39
2,1193,43497,3575893065,3575893104,39
2,1193,43498,3575893065,3575893105,40
2,1193,43499,3575893065,3575893106,41
2,1193,43500,3575893065,3575893107,42
2,1193,43501,3575893065,3575893108,43
2,1193,43502,3575893065,3575893108,43
2,1193,43503,3575893065,3575893108,43
2,1193,43504,3575893065,3575893108,43
2,1193,43505,3575893065,3575893108,43
2,1193,43506,3575893065,3575893109,44
2,1193,43507,3575893065,3575893109,44
2,1193,43508,3575893065,3575893110,45
2,1193,43509,3575893065,3575893110,45
2,1193,43510,3575893065,3575893111,46
2,1193,43511,3575893065,3575893113,48
2,1193,43512,3575893065,3575893114,49
2,1193,43513,3575893065,3575893115,50
2,1194,43514,3575893129,3575893129,0
2,1194,43515,3575893129,3575893129,0
2,1194,43516,3575893129,3575893129,0
2,1194,43517,3575893129,3575893129,0
2,1194,43518,3575893129,3575893129,0
2,1194,43519,3575893129,3575893129,0
2,1194,43520,3575893129,3575893129,0
2,1194,43521,3575893129,3575893129,0
2,1194,43522,3575893129,3575893129,0
2,1194,43523,3575893129,3575893129,0
2,1194,43524,3575893129,3575893129,0
2,1194,43525,3575893129,3575893129,0
2,1194,43526,3575893129,3575893129,0
2,1194,43527,3575893129,3575893129,0
2,1194,43528,3575893129,3575893129,0
2,1194,43529,3575893129,3575893129,0
2,1194,43530,3575893129,3575893129,0
2,1194,43531,3575893129,3575893129,0
2,1194,43532,3575893129,3575893130,1
2,1194,43533,3575893129,3575893130,1
2,1194,43534,3575893129,3575893132,3
2,1194,43535,3575893129,3575893132,3
2,1194,43536,3575893129,3575893133,4
2,1194,43537,3575893129,3575893133,4
2,1194,43538,3575893129,3575893133,4
2,1194,43539,3575893129,3575893134,5
2,1194,43540,3575893129,3575893135,6
2,1194,43541,3575893129,3575893136,7
2,1194,43542,3575893129,3575893136,7
2,1194,43543,3575893129,3575893138,9
2,1194,43544,3575893129,3575893139,10
2,1194,43545,3575893129,3575893140,11
2,1194,43546,3575893129,3575893140,11
2,1194,43547,3575893129,3575893142,13
2,1194,43548,3575893129,3575893142,13
2,1194,43549,3575893129,3575893144,15
2,1194,43550,3575893129,3575893145,16
2,1194,43551,3575893129,3575893146,17
2,1194,43552,3575893129,3575893146,17
2,1194,43553,3575893129,3575893147,18
2,1194,43554,3575893129,3575893147,18
2,1194,43555,3575893129,3575893148,19
2,1194,43556,3575893129,3575893148,19
2,1194,43557,3575893129,3575893148,19
2,1194,43558,3575893129,3575893149,20
2,1194,43559,3575893129,3575893149,20
2,1194,43560,3575893129,3575893150,21
2,1194,43561,3575893129,3575893150,21
2,1194,43562,3575893129,3575893151,22
2,1194,43563,3575893129,3575893152,23
2,1194,43564,3575893129,3575893153,24
2,1194,43565,3575893129,3575893153,24
2,1194,43566,3575893129,3575893154,25
2,1194,43567,3575893129,3575893154,25
2,1194,43568,3575893129,3575893154,25
2,1194,43569,3575893129,3575893156,27
2,1194,43570,3575893129,3575893159,30
2,1194,43571,3575893129,3575893159,30
2,1194,43572,3575893129,3575893160,31
2,1194,43573,3575893129,3575893160,31
2,1194,43574,3575893129,3575893161,32
2,1194,43575,3575893129,3575893161,32
2,1194,43576,3575893129,3575893161,32
2,1194,43577,3575893129,3575893161,32
2,1194,43578,3575893129,3575893164,35
2,1194,43579,3575893129,3575893165,36
2,1194,43580,3575893129,3575893166,37
2,1194,43581,3575893129,3575893166,37
2,1194,43582,3575893129,3575893167,38
2,1194,43583,3575893129,3575893168,39
2,1194,43584,3575893129,3575893168,39
2,1194,43585,3575893129,3575893169,40
2,1194,43586,3575893129,3575893169,40
2,1194,43587,3575893129,3575893169,40
2,1194,43588,3575893129,3575893170,41
2,1194,43589,3575893129,3575893171,42
2,1194,43590,3575893129,3575893172,43
2,1194,43591,3575893129,3575893172,43
2,1194,43592,3575893129,3575893173,44
2,1194,43593,3575893129,3575893175,46
2,1194,43594,3575893129,3575893175,46
2,1194,43595,3575893129,3575893176,47
2,1194,43596,3575893129,3575893176,47
2,1194,43597,3575893129,3575893176,47
2,1194,43598,3575893129,3575893176,47
2,1194,43599,3575893129,3575893177,48
2,1194,43600,3575893129,3575893177,48
2,1195,43601,3575893192,3575893192,0
2,1195,43602,3575893192,3575893192,0
2,1195,43603,3575893192,3575893192,0
2,1195,43604,3575893192,3575893192,0
2,1195,43605,3575893192,3575893192,0
2,1195,43606,3575893192,3575893192,0
2,1195,43607,3575893192,3575893192,0
2,1195,43608,3575893192,3575893192,0
2,1195,43609,3575893192,3575893192,0
2,1195,43610,3575893192,3575893192,0
2,1195,43611,3575893192,3575893192,0
2,1195,43612,3575893192,3575893192,0
2,1195,43613,3575893192,3575893192,0
2,1195,43614,3575893192,3575893192,0
2,1195,43615,3575893192,3575893192,0
2,1195,43616,3575893192,3575893192,0
2,1195,43617,3575893192,3575893192,0
2,1195,43618,3575893192,3575893192,0
2,1195,43619,3575893192,3575893192,0
2,1195,43620,3575893192,3575893192,0
2,1195,43621,3575893192,3575893192,0
2,1195,43622,3575893192,3575893193,1
2,1195,43623,3575893192,3575893194,2
2,1195,43624,3575893192,3575893194,2
2,1195,43625,3575893192,3575893194,2
2,1195,43626,3575893192,3575893195,3
2,1195,43627,3575893192,3575893195,3
2,1195,43628,3575893192,3575893196,4
2,1195,43629,3575893192,3575893196,4
2,1195,43630,3575893192,3575893197,5
2,1195,43631,3575893192,3575893198,6
2,1195,43632,3575893192,3575893198,6
2,1195,43633,3575893192,3575893199,7
2,1195,43634,3575893192,3575893199,7
2,1195,43635,3575893192,3575893199,7
2,1195,43636,3575893192,3575893199,7
2,1195,43637,3575893192,3575893200,8
2,1195,43638,3575893192,3575893203,11
2,1195,43639,3575893192,3575893204,12
2,1195,43640,3575893192,3575893204,12
2,1195,43641,3575893192,3575893204,12
2,1195,43642,3575893192,3575893204,12
2,1195,43643,3575893192,3575893206,14
2,1195,43644,3575893192,3575893210,18
2,1195,43645,3575893192,3575893211,19
2,1195,43646,3575893192,3575893212,20
2,1195,43647,3575893192,3575893213,21
2,1195,43648,3575893192,3575893215,23
2,1195,43649,3575893192,3575893220,28
2,1195,43650,3575893192,3575893221,29
2,1195,43651,3575893192,3575893222,30
2,1195,43652,3575893192,3575893222,30
2,1195,43653,3575893192,3575893223,31
2,1195,43654,3575893192,3575893223,31
2,1195,43655,3575893192,3575893225,33
2,1195,43656,3575893192,3575893226,34
2,1195,43657,3575893192,3575893226,34
2,1195,43658,3575893192,3575893228,36
2,1195,43659,3575893192,3575893228,36
2,1195,43660,3575893192,3575893228,36
2,1195,43661,3575893192,3575893228,36
2,1195,43662,3575893192,3575893228,36
2,1195,43663,3575893192,3575893228,36
2,1195,43664,3575893192,3575893230,38
2,1195,43665,3575893192,3575893231,39
2,1195,43666,3575893192,3575893235,43
2,1195,43667,3575893192,3575893235,43
2,1195,43668,3575893192,3575893235,43
2,1195,43669,3575893192,3575893237,45
2,1195,43670,3575893192,3575893237,45
2,1195,43671,3575893192,3575893238,46
2,1195,43672,3575893192,3575893239,47
2,1195,43673,3575893192,3575893240,48
2,1195,43674,3575893192,3575893240,48
2,1195,43675,3575893192,3575893240,48
2,1195,43676,3575893192,3575893240,48
2,1195,43677,3575893192,3575893242,50
2,1196,43678,3575893258,3575893258,0
2,1196,43679,3575893258,3575893258,0
2,1196,43680,3575893258,3575893258,0
2,1196,43681,3575893258,3575893258,0
2,1196,43682,3575893258,3575893258,0
2,1196,43683,3575893258,3575893258,0
2,1196,43684,3575893258,3575893258,0
2,1196,43685,3575893258,3575893258,0
2,1196,43686,3575893258,3575893258,0
2,1196,43687,3575893258,3575893258,0
2,1196,43688,3575893258,3575893258,0
2,1196,43689,3575893258,3575893258,0
2,1196,43690,3575893258,3575893258,0
2,1196,43691,3575893258,3575893258,0
2,1196,43692,3575893258,3575893258,0
2,1196,43693,3575893258,3575893258,0
2,1196,43694,3575893258,3575893258,0
2,1196,43695,3575893258,3575893259,1
2,1196,43696,3575893258,3575893260,2
2,1196,43697,3575893258,3575893261,3
2,1196,43698,3575893258,3575893265,7
2,1196,43699,3575893258,3575893267,9
2,1196,43700,3575893258,3575893268,10
2,1196,43701,3575893258,3575893269,11
2,1196,43702,3575893258,3575893278,20
2,1196,43703,3575893258,3575893278,20
2,1196,43704,3575893258,3575893281,23
2,1196,43705,3575893258,3575893284,26
2,1196,43706,3575893258,3575893285,27
2,1196,43707,3575893258,3575893286,28
2,1196,43708,3575893258,3575893287,29
2,1196,43709,3575893258,3575893287,29
2,1196,43710,3575893258,3575893288,30
2,1196,43711,3575893258,3575893288,30
2,1196,43712,3575893258,3575893288,30
2,1196,43713,3575893258,3575893288,30
2,1196,43714,3575893258,3575893289,31
2,1196,43715,3575893258,3575893291,33
2,1196,43716,3575893258,3575893291,33
2,1196,43717,3575893258,3575893291,33
2,1196,43718,3575893258,3575893292,34
2,1196,43719,3575893258,3575893292,34
2,1196,43720,3575893258,3575893293,35
2,1196,43721,3575893258,3575893293,35
2,1196,43722,3575893258,3575893293,35
2,1196,43723,3575893258,3575893294,36
2,1196,43724,3575893258,3575893295,37
2,1196,43725,3575893258,3575893296,38
2,1196,43726,3575893258,3575893297,39
2,1196,43727,3575893258,3575893298,40
2,1196,43728,3575893258,3575893298,40
2,1196,43729,3575893258,3575893298,40
2,1196,43730,3575893258,3575893298,40
2,1196,43731,3575893258,3575893299,41
2,1196,43732,3575893258,3575893299,41
2,1196,43733,3575893258,3575893300,42
2,1196,43734,3575893258,3575893301,43
2,1196,43735,3575893258,3575893301,43
2,1196,43736,3575893258,3575893303,45
2,1196,43737,3575893258,3575893304,46
2,1196,43738,3575893258,3575893305,47
2,1196,43739,3575893258,3575893306,48
2,1196,43740,3575893258,3575893308,50
2,1197,43741,3575893321,3575893321,0
2,1197,43742,3575893321,3575893321,0
2,1197,43743,3575893321,3575893321,0
2,1197,43744,3575893321,3575893321,0
2,1197,43745,3575893321,3575893321,0
2,1197,43746,3575893321,3575893321,0
2,1197,43747,3575893321,3575893321,0
2,1197,43748,3575893321,3575893321,0
2,1197,43749,3575893321,3575893321,0
2,1197,43750,3575893321,3575893321,0
2,1197,43751,3575893321,3575893321,0
2,1197,43752,3575893321,3575893321,0
2,1197,43753,3575893321,3575893321,0
2,1197,43754,3575893321,3575893321,0
2,1197,43755,3575893321,3575893321,0
2,1197,43756,3575893321,3575893321,0
2,1197,43757,3575893321,3575893321,0
2,1197,43758,3575893321,3575893321,0
2,1197,43759,3575893321,3575893321,0
2,1197,43760,3575893321,3575893321,0
2,1197,43761,3575893321,3575893321,0
2,1197,43762,3575893321,3575893321,0
2,1197,43763,3575893321,3575893321,0
2,1197,43764,3575893321,3575893322,1
2,1197,43765,3575893321,3575893323,2
2,1197,43766,3575893321,3575893324,3
2,1197,43767,3575893321,3575893326,5
2,1197,43768,3575893321,3575893326,5
2,1197,43769,3575893321,3575893327,6
2,1197,43770,3575893321,3575893328,7
2,1197,43771,3575893321,3575893328,7
2,1197,43772,3575893321,3575893329,8
2,1197,43773,3575893321,3575893330,9
2,1197,43774,3575893321,3575893330,9
2,1197,43775,3575893321,3575893331,10
2,1197,43776,3575893321,3575893332,11
2,1197,43777,3575893321,3575893333,12
2,1197,43778,3575893321,3575893333,12
2,1197,43779,3575893321,3575893333,12
2,1197,43780,3575893321,3575893334,13
2,1197,43781,3575893321,3575893334,13
2,1197,43782,3575893321,3575893334,13
2,1197,43783,3575893321,3575893335,14
2,1197,43784,3575893321,3575893336,15
2,1197,43785,3575893321,3575893336,15
2,1197,43786,3575893321,3575893337,16
2,1197,43787,3575893321,3575893338,17
2,1197,43788,3575893321,3575893339,18
2,1197,43789,3575893321,3575893340,19
2,1197,43790,3575893321,3575893340,19
2,1197,43791,3575893321,3575893342,21
2,1197,43792,3575893321,3575893343,22
2,1197,43793,3575893321,3575893344,23
2,1197,43794,3575893321,3575893346,25
2,1197,43795,3575893321,3575893347,26
2,1197,43796,3575893321,3575893347,26
2,1197,43797,3575893321,3575893347,26
2,1197,43798,3575893321,3575893347,26
2,1197,43799,3575893321,3575893348,27
2,1197,43800,3575893321,3575893349,28
2,1197,43801,3575893321,3575893349,28
2,1197,43802,3575893321,3575893351,30
2,1197,43803,3575893321,3575893352,31
2,1197,43804,3575893321,3575893352,31
2,1197,43805,3575893321,3575893353,32
2,1197,43806,3575893321,3575893353,32
2,1197,43807,3575893321,3575893354,33
2,1197,43808,3575893321,3575893354,33
2,1197,43809,3575893321,3575893354,33
2,1197,43810,3575893321,3575893356,35
2,1197,43811,3575893321,3575893359,38
2,1197,43812,3575893321,3575893360,39
2,1197,43813,3575893321,3575893360,39
2,1197,43814,3575893321,3575893360,39
2,1197,43815,3575893321,3575893360,39
2,1197,43816,3575893321,3575893361,40
2,1197,43817,3575893321,3575893361,40
2,1197,43818,3575893321,3575893363,42
2,1197,43819,3575893321,3575893365,44
2,1197,43820,3575893321,3575893365,44
2,1197,43821,3575893321,3575893366,45
2,1197,43822,3575893321,3575893366,45
2,1197,43823,3575893321,3575893367,46
2,1197,43824,3575893321,3575893368,47
2,1197,43825,3575893321,3575893368,47
2,1197,43826,3575893321,3575893368,47
2,1197,43827,3575893321,3575893370,49
2,1198,43828,3575893388,3575893388,0
2,1198,43829,3575893388,3575893388,0
2,1198,43830,3575893388,3575893388,0
2,1198,43831,3575893388,3575893388,0
2,1198,43832,3575893388,3575893388,0
2,1198,43833,3575893388,3575893388,0
2,1198,43834,3575893388,3575893388,0
2,1198,43835,3575893388,3575893388,0
2,1198,43836,3575893388,3575893388,0
2,1198,43837,3575893388,3575893388,0
2,1198,43838,3575893388,3575893388,0
2,1198,43839,3575893388,3575893388,0
2,1198,43840,3575893388,3575893388,0
2,1198,43841,3575893388,3575893388,0
2,1198,43842,3575893388,3575893388,0
2,1198,43843,3575893388,3575893388,0
2,1198,43844,3575893388,3575893388,0
2,1198,43845,3575893388,3575893388,0
2,1198,43846,3575893388,3575893388,0
2,1198,43847,3575893388,3575893388,0
2,1198,43848,3575893388,3575893388,0
2,1198,43849,3575893388,3575893388,0
2,1198,43850,3575893388,3575893388,0
2,1198,43851,3575893388,3575893388,0
2,1198,43852,3575893388,3575893388,0
2,1198,43853,3575893388,3575893389,1
2,1198,43854,3575893388,3575893389,1
2,1198,43855,3575893388,3575893390,2
2,1198,43856,3575893388,3575893391,3
2,1198,43857,3575893388,3575893392,4
2,1198,43858,3575893388,3575893393,5
2,1198,43859,3575893388,3575893394,6
2,1198,43860,3575893388,3575893395,7
2,1198,43861,3575893388,3575893396,8
2,1198,43862,3575893388,3575893396,8
2,1198,43863,3575893388,3575893396,8
2,1198,43864,3575893388,3575893397,9
2,1198,43865,3575893388,3575893398,10
2,1198,43866,3575893388,3575893398,10
2,1198,43867,3575893388,3575893399,11
2,1198,43868,3575893388,3575893399,11
2,1198,43869,3575893388,3575893399,11
2,1198,43870,3575893388,3575893400,12
2,1198,43871,3575893388,3575893400,12
2,1198,43872,3575893388,3575893403,15
2,1198,43873,3575893388,3575893403,15
2,1198,43874,3575893388,3575893404,16
2,1198,43875,3575893388,3575893405,17
2,1198,43876,3575893388,3575893405,17
2,1198,43877,3575893388,3575893405,17
2,1198,43878,3575893388,3575893406,18
2,1198,43879,3575893388,3575893408,20
2,1198,43880,3575893388,3575893410,22
2,1198,43881,3575893388,3575893412,24
2,1198,43882,3575893388,3575893413,25
2,1198,43883,3575893388,3575893417,29
2,1198,43884,3575893388,3575893420,32
2,1198,43885,3575893388,3575893422,34
2,1198,43886,3575893388,3575893423,35
2,1198,43887,3575893388,3575893423,35
2,1198,43888,3575893388,3575893424,36
2,1198,43889,3575893388,3575893425,37
2,1198,43890,3575893388,3575893426,38
2,1198,43891,3575893388,3575893427,39
2,1198,43892,3575893388,3575893428,40
2,1198,43893,3575893388,3575893428,40
2,1198,43894,3575893388,3575893428,40
2,1198,43895,3575893388,3575893428,40
2,1198,43896,3575893388,3575893428,40
2,1198,43897,3575893388,3575893429,41
2,1198,43898,3575893388,3575893429,41
2,1198,43899,3575893388,3575893430,42
2,1198,43900,3575893388,3575893431,43
2,1198,43901,3575893388,3575893436,48
2,1198,43902,3575893388,3575893436,48
2,1198,43903,3575893388,3575893437,49
2,1198,43904,3575893388,3575893438,50
2,1199,43905,3575893451,3575893452,1
2,1199,43906,3575893451,3575893452,1
2,1199,43907,3575893451,3575893452,1
2,1199,43908,3575893451,3575893452,1
2,1199,43909,3575893451,3575893452,1
2,1199,43910,3575893451,3575893452,1
2,1199,43911,3575893451,3575893452,1
2,1199,43912,3575893451,3575893452,1
2,1199,43913,3575893451,3575893452,1
2,1199,43914,3575893451,3575893452,1
2,1199,43915,3575893451,3575893452,1
2,1199,43916,3575893451,3575893452,1
2,1199,43917,3575893451,3575893452,1
2,1199,43918,3575893451,3575893454,3
2,1199,43919,3575893451,3575893454,3
2,1199,43920,3575893451,3575893455,4
2,1199,43921,3575893451,3575893455,4
2,1199,43922,3575893451,3575893456,5
2,1199,43923,3575893451,3575893456,5
2,1199,43924,3575893451,3575893456,5
2,1199,43925,3575893451,3575893457,6
2,1199,43926,3575893451,3575893457,6
2,1199,43927,3575893451,3575893458,7
2,1199,43928,3575893451,3575893458,7
2,1199,43929,3575893451,3575893459,8
2,1199,43930,3575893451,3575893460,9
2,1199,43931,3575893451,3575893461,10
2,1199,43932,3575893451,3575893462,11
2,1199,43933,3575893451,3575893468,17
2,1199,43934,3575893451,3575893470,19
2,1199,43935,3575893451,3575893478,27
2,1199,43936,3575893451,3575893478,27
2,1199,43937,3575893451,3575893481,30
2,1199,43938,3575893451,3575893486,35
2,1199,43939,3575893451,3575893486,35
2,1199,43940,3575893451,3575893487,36
2,1199,43941,3575893451,3575893487,36
2,1199,43942,3575893451,3575893488,37
2,1199,43943,3575893451,3575893488,37
2,1199,43944,3575893451,3575893488,37
2,1199,43945,3575893451,3575893488,37
2,1199,43946,3575893451,3575893489,38
2,1199,43947,3575893451,3575893491,40
2,1199,43948,3575893451,3575893491,40
2,1199,43949,3575893451,3575893492,41
2,1199,43950,3575893451,3575893492,41
2,1199,43951,3575893451,3575893492,41
2,1199,43952,3575893451,3575893492,41
2,1199,43953,3575893451,3575893493,42
2,1199,43954,3575893451,3575893493,42
2,1199,43955,3575893451,3575893493,42
2,1199,43956,3575893451,3575893494,43
2,1199,43957,3575893451,3575893495,44
2,1199,43958,3575893451,3575893497,46
2,1199,43959,3575893451,3575893497,46
2,1199,43960,3575893451,3575893498,47
2,1199,43961,3575893451,3575893498,47
2,1199,43962,3575893451,3575893500,49
2,1199,43963,3575893451,3575893500,49
2,1199,43964,3575893451,3575893500,49
2,1199,43965,3575893451,3575893500,49
2,1199,43966,3575893451,3575893500,49
2,1199,43967,3575893451,3575893500,49
2,1199,43968,3575893451,3575893500,49
2,1199,43969,3575893451,3575893501,50
2,1200,43970,3575893518,3575893518,0
2,1200,43971,3575893518,3575893518,0
2,1200,43972,3575893518,3575893518,0
2,1200,43973,3575893518,3575893518,0
2,1200,43974,3575893518,3575893518,0
2,1200,43975,3575893518,3575893518,0
2,1200,43976,3575893518,3575893518,0
2,1200,43977,3575893518,3575893518,0
2,1200,43978,3575893518,3575893518,0
2,1200,43979,3575893518,3575893518,0
2,1200,43980,3575893518,3575893518,0
2,1200,43981,3575893518,3575893518,0
2,1200,43982,3575893518,3575893518,0
2,1200,43983,3575893518,3575893518,0
2,1200,43984,3575893518,3575893518,0
2,1200,43985,3575893518,3575893518,0
2,1200,43986,3575893518,3575893518,0
2,1200,43987,3575893518,3575893518,0
2,1200,43988,3575893518,3575893518,0
2,1200,43989,3575893518,3575893518,0
2,1200,43990,3575893518,3575893518,0
2,1200,43991,3575893518,3575893518,0
2,1200,43992,3575893518,3575893518,0
2,1200,43993,3575893518,3575893518,0
2,1200,43994,3575893518,3575893518,0
2,1200,43995,3575893518,3575893519,1
2,1200,43996,3575893518,3575893519,1
2,1200,43997,3575893518,3575893520,2
2,1200,43998,3575893518,3575893520,2
2,1200,43999,3575893518,3575893521,3
2,1200,44000,3575893518,3575893521,3
2,1200,44001,3575893518,3575893522,4
2,1200,44002,3575893518,3575893525,7
2,1200,44003,3575893518,3575893526,8
2,1200,44004,3575893518,3575893526,8
2,1200,44005,3575893518,3575893527,9
2,1200,44006,3575893518,3575893527,9
2,1200,44007,3575893518,3575893528,10
2,1200,44008,3575893518,3575893529,11
2,1200,44009,3575893518,3575893530,12
2,1200,44010,3575893518,3575893531,13
2,1200,44011,3575893518,3575893531,13
2,1200,44012,3575893518,3575893531,13
2,1200,44013,3575893518,3575893532,14
2,1200,44014,3575893518,3575893532,14
2,1200,44015,3575893518,3575893532,14
2,1200,44016,3575893518,3575893533,15
2,1200,44017,3575893518,3575893533,15
2,1200,44018,3575893518,3575893534,16
2,1200,44019,3575893518,3575893535,17
2,1200,44020,3575893518,3575893535,17
2,1200,44021,3575893518,3575893536,18
2,1200,44022,3575893518,3575893538,20
2,1200,44023,3575893518,3575893539,21
2,1200,44024,3575893518,3575893540,22
2,1200,44025,3575893518,3575893541,23
2,1200,44026,3575893518,3575893542,24
2,1200,44027,3575893518,3575893543,25
2,1200,44028,3575893518,3575893545,27
2,1200,44029,3575893518,3575893546,28
2,1200,44030,3575893518,3575893547,29
2,1200,44031,3575893518,3575893547,29
2,1200,44032,3575893518,3575893547,29
2,1200,44033,3575893518,3575893547,29
2,1200,44034,3575893518,3575893548,30
2,1200,44035,3575893518,3575893548,30
2,1200,44036,3575893518,3575893550,32
2,1200,44037,3575893518,3575893550,32
2,1200,44038,3575893518,3575893551,33
2,1200,44039,3575893518,3575893551,33
2,1200,44040,3575893518,3575893552,34
2,1200,44041,3575893518,3575893553,35
2,1200,44042,3575893518,3575893553,35
2,1200,44043,3575893518,3575893554,36
2,1200,44044,3575893518,3575893556,38
2,1200,44045,3575893518,3575893558,40
2,1200,44046,3575893518,3575893558,40
2,1200,44047,3575893518,3575893559,41
2,1200,44048,3575893518,3575893559,41
2,1200,44049,3575893518,3575893560,42
2,1200,44050,3575893518,3575893561,43
2,1200,44051,3575893518,3575893565,47
2,1200,44052,3575893518,3575893566,48
2,1200,44053,3575893518,3575893566,48
2,1200,44054,3575893518,3575893566,48
2,1200,44055,3575893518,3575893567,49
2,1200,44056,3575893518,3575893567,49
2,1200,44057,3575893518,3575893568,50
2,1200,44058,3575893518,3575893568,50
2,1201,44059,3575893581,3575893581,0
2,1201,44060,3575893581,3575893581,0
2,1201,44061,3575893581,3575893581,0
2,1201,44062,3575893581,3575893581,0
2,1201,44063,3575893581,3575893581,0
2,1201,44064,3575893581,3575893581,0
2,1201,44065,3575893581,3575893581,0
2,1201,44066,3575893581,3575893581,0
2,1201,44067,3575893581,3575893581,0
2,1201,44068,3575893581,3575893581,0
2,1201,44069,3575893581,3575893581,0
2,1201,44070,3575893581,3575893581,0
2,1201,44071,3575893581,3575893581,0
2,1201,44072,3575893581,3575893581,0
2,1201,44073,3575893581,3575893581,0
2,1201,44074,3575893581,3575893581,0
2,1201,44075,3575893581,3575893582,1
2,1201,44076,3575893581,3575893583,2
2,1201,44077,3575893581,3575893583,2
2,1201,44078,3575893581,3575893584,3
2,1201,44079,3575893581,3575893585,4
2,1201,44080,3575893581,3575893585,4
2,1201,44081,3575893581,3575893585,4
2,1201,44082,3575893581,3575893585,4
2,1201,44083,3575893581,3575893586,5
2,1201,44084,3575893581,3575893587,6
2,1201,44085,3575893581,3575893587,6
2,1201,44086,3575893581,3575893588,7
2,1201,44087,3575893581,3575893588,7
2,1201,44088,3575893581,3575893588,7
2,1201,44089,3575893581,3575893590,9
2,1201,44090,3575893581,3575893594,13
2,1201,44091,3575893581,3575893594,13
2,1201,44092,3575893581,3575893594,13
2,1201,44093,3575893581,3575893594,13
2,1201,44094,3575893581,3575893594,13
2,1201,44095,3575893581,3575893595,14
2,1201,44096,3575893581,3575893598,17
2,1201,44097,3575893581,3575893598,17
2,1201,44098,3575893581,3575893598,17
2,1201,44099,3575893581,3575893600,19
2,1201,44100,3575893581,3575893600,19
2,1201,44101,3575893581,3575893602,21
2,1201,44102,3575893581,3575893603,22
2,1201,44103,3575893581,3575893603,22
2,1201,44104,3575893581,3575893603,22
2,1201,44105,3575893581,3575893604,23
2,1201,44106,3575893581,3575893605,24
2,1201,44107,3575893581,3575893606,25
2,1201,44108,3575893581,3575893609,28
2,1201,44109,3575893581,3575893611,30
2,1201,44110,3575893581,3575893612,31
2,1201,44111,3575893581,3575893612,31
2,1201,44112,3575893581,3575893616,35
2,1201,44113,3575893581,3575893619,38
2,1201,44114,3575893581,3575893621,40
2,1201,44115,3575893581,3575893622,41
2,1201,44116,3575893581,3575893623,42
2,1201,44117,3575893581,3575893623,42
2,1201,44118,3575893581,3575893625,44
2,1201,44119,3575893581,3575893625,44
2,1201,44120,3575893581,3575893625,44
2,1201,44121,3575893581,3575893626,45
2,1201,44122,3575893581,3575893627,46
2,1201,44123,3575893581,3575893627,46
2,1201,44124,3575893581,3575893627,46
2,1201,44125,3575893581,3575893627,46
2,1201,44126,3575893581,3575893628,47
2,1201,44127,3575893581,3575893628,47
2,1201,44128,3575893581,3575893630,49
2,1201,44129,3575893581,3575893631,50
2,1202,44130,3575893646,3575893646,0
2,1202,44131,3575893646,3575893646,0
2,1202,44132,3575893646,3575893646,0
2,1202,44133,3575893646,3575893646,0
2,1202,44134,3575893646,3575893646,0
2,1202,44135,3575893646,3575893646,0
2,1202,44136,3575893646,3575893646,0
2,1202,44137,3575893646,3575893646,0
2,1202,44138,3575893646,3575893646,0
2,1202,44139,3575893646,3575893646,0
2,1202,44140,3575893646,3575893646,0
2,1202,44141,3575893646,3575893646,0
2,1202,44142,3575893646,3575893646,0
2,1202,44143,3575893646,3575893646,0
2,1202,44144,3575893646,3575893648,2
2,1202,44145,3575893646,3575893650,4
2,1202,44146,3575893646,3575893653,7
2,1202,44147,3575893646,3575893653,7
2,1202,44148,3575893646,3575893654,8
2,1202,44149,3575893646,3575893654,8
2,1202,44150,3575893646,3575893654,8
2,1202,44151,3575893646,3575893655,9
2,1202,44152,3575893646,3575893656,10
2,1202,44153,3575893646,3575893656,10
2,1202,44154,3575893646,3575893657,11
2,1202,44155,3575893646,3575893658,12
2,1202,44156,3575893646,3575893660,14
2,1202,44157,3575893646,3575893660,14
2,1202,44158,3575893646,3575893662,16
2,1202,44159,3575893646,3575893665,19
2,1202,44160,3575893646,3575893667,21
2,1202,44161,3575893646,3575893667,21
2,1202,44162,3575893646,3575893669,23
2,1202,44163,3575893646,3575893678,32
2,1202,44164,3575893646,3575893678,32
2,1202,44165,3575893646,3575893681,35
2,1202,44166,3575893646,3575893682,36
2,1202,44167,3575893646,3575893684,38
2,1202,44168,3575893646,3575893685,39
2,1202,44169,3575893646,3575893686,40
2,1202,44170,3575893646,3575893686,40
2,1202,44171,3575893646,3575893687,41
2,1202,44172,3575893646,3575893687,41
2,1202,44173,3575893646,3575893688,42
2,1202,44174,3575893646,3575893688,42
2,1202,44175,3575893646,3575893688,42
2,1202,44176,3575893646,3575893688,42
2,1202,44177,3575893646,3575893689,43
2,1202,44178,3575893646,3575893691,45
2,1202,44179,3575893646,3575893691,45
2,1202,44180,3575893646,3575893691,45
2,1202,44181,3575893646,3575893692,46
2,1202,44182,3575893646,3575893692,46
2,1202,44183,3575893646,3575893692,46
2,1202,44184,3575893646,3575893692,46
2,1202,44185,3575893646,3575893693,47
2,1202,44186,3575893646,3575893694,48
2,1202,44187,3575893646,3575893696,50
2,1203,44188,3575893711,3575893711,0
2,1203,44189,3575893711,3575893711,0
2,1203,44190,3575893711,3575893711,0
2,1203,44191,3575893711,3575893711,0
2,1203,44192,3575893711,3575893711,0
2,1203,44193,3575893711,3575893711,0
2,1203,44194,3575893711,3575893711,0
2,1203,44195,3575893711,3575893711,0
2,1203,44196,3575893711,3575893711,0
2,1203,44197,3575893711,3575893711,0
2,1203,44198,3575893711,3575893711,0
2,1203,44199,3575893711,3575893711,0
2,1203,44200,3575893711,3575893711,0
2,1203,44201,3575893711,3575893711,0
2,1203,44202,3575893711,3575893711,0
2,1203,44203,3575893711,3575893711,0
2,1203,44204,3575893711,3575893711,0
2,1203,44205,3575893711,3575893711,0
2,1203,44206,3575893711,3575893711,0
2,1203,44207,3575893711,3575893711,0
2,1203,44208,3575893711,3575893711,0
2,1203,44209,3575893711,3575893711,0
2,1203,44210,3575893711,3575893711,0
2,1203,44211,3575893711,3575893711,0
2,1203,44212,3575893711,3575893713,2
2,1203,44213,3575893711,3575893713,2
2,1203,44214,3575893711,3575893714,3
2,1203,44215,3575893711,3575893714,3
2,1203,44216,3575893711,3575893715,4
2,1203,44217,3575893711,3575893717,6
2,1203,44218,3575893711,3575893717,6
2,1203,44219,3575893711,3575893717,6
2,1203,44220,3575893711,3575893719,8
2,1203,44221,3575893711,3575893719,8
2,1203,44222,3575893711,3575893719,8
2,1203,44223,3575893711,3575893720,9
2,1203,44224,3575893711,3575893720,9
2,1203,44225,3575893711,3575893720,9
2,1203,44226,3575893711,3575893720,9
2,1203,44227,3575893711,3575893722,11
2,1203,44228,3575893711,3575893722,11
2,1203,44229,3575893711,3575893724,13
2,1203,44230,3575893711,3575893726,15
2,1203,44231,3575893711,3575893727,16
2,1203,44232,3575893711,3575893728,17
2,1203,44233,3575893711,3575893728,17
2,1203,44234,3575893711,3575893728,17
2,1203,44235,3575893711,3575893729,18
2,1203,44236,3575893711,3575893729,18
2,1203,44237,3575893711,3575893731,20
2,1203,44238,3575893711,3575893731,20
2,1203,44239,3575893711,3575893732,21
2,1203,44240,3575893711,3575893732,21
2,1203,44241,3575893711,3575893733,22
2,1203,44242,3575893711,3575893734,23
2,1203,44243,3575893711,3575893734,23
2,1203,44244,3575893711,3575893735,24
2,1203,44245,3575893711,3575893735,24
2,1203,44246,3575893711,3575893736,25
2,1203,44247,3575893711,3575893737,26
2,1203,44248,3575893711,3575893738,27
2,1203,44249,3575893711,3575893739,28
2,1203,44250,3575893711,3575893739,28
2,1203,44251,3575893711,3575893742,31
2,1203,44252,3575893711,3575893742,31
2,1203,44253,3575893711,3575893744,33
2,1203,44254,3575893711,3575893744,33
2,1203,44255,3575893711,3575893744,33
2,1203,44256,3575893711,3575893746,35
2,1203,44257,3575893711,3575893747,36
2,1203,44258,3575893711,3575893747,36
2,1203,44259,3575893711,3575893748,37
2,1203,44260,3575893711,3575893748,37
2,1203,44261,3575893711,3575893748,37
2,1203,44262,3575893711,3575893749,38
2,1203,44263,3575893711,3575893751,40
2,1203,44264,3575893711,3575893751,40
2,1203,44265,3575893711,3575893752,41
2,1203,44266,3575893711,3575893752,41
2,1203,44267,3575893711,3575893753,42
2,1203,44268,3575893711,3575893754,43
2,1203,44269,3575893711,3575893756,45
2,1203,44270,3575893711,3575893759,48
2,1203,44271,3575893711,3575893759,48
2,1203,44272,3575893711,3575893760,49
2,1203,44273,3575893711,3575893760,49
2,1203,44274,3575893711,3575893760,49
2,1203,44275,3575893711,3575893760,49
2,1203,44276,3575893711,3575893760,49
2,1203,44277,3575893711,3575893761,50
2,1204,44278,3575893775,3575893775,0
2,1204,44279,3575893775,3575893775,0
2,1204,44280,3575893775,3575893775,0
2,1204,44281,3575893775,3575893775,0
2,1204,44282,3575893775,3575893775,0
2,1204,44283,3575893775,3575893775,0
2,1204,44284,3575893775,3575893775,0
2,1204,44285,3575893775,3575893775,0
2,1204,44286,3575893775,3575893775,0
2,1204,44287,3575893775,3575893775,0
2,1204,44288,3575893775,3575893775,0
2,1204,44289,3575893775,3575893775,0
2,1204,44290,3575893775,3575893775,0
2,1204,44291,3575893775,3575893775,0
2,1204,44292,3575893775,3575893775,0
2,1204,44293,3575893775,3575893775,0
2,1204,44294,3575893775,3575893776,1
2,1204,44295,3575893775,3575893777,2
2,1204,44296,3575893775,3575893777,2
2,1204,44297,3575893775,3575893777,2
2,1204,44298,3575893775,3575893778,3
2,1204,44299,3575893775,3575893781,6
2,1204,44300,3575893775,3575893781,6
2,1204,44301,3575893775,3575893782,7
2,1204,44302,3575893775,3575893783,8
2,1204,44303,3575893775,3575893783,8
2,1204,44304,3575893775,3575893784,9
2,1204,44305,3575893775,3575893784,9
2,1204,44306,3575893775,3575893785,10
2,1204,44307,3575893775,3575893785,10
2,1204,44308,3575893775,3575893785,10
2,1204,44309,3575893775,3575893787,12
2,1204,44310,3575893775,3575893787,12
2,1204,44311,3575893775,3575893787,12
2,1204,44312,3575893775,3575893787,12
2,1204,44313,3575893775,3575893788,13
2,1204,44314,3575893775,3575893789,14
2,1204,44315,3575893775,3575893790,15
2,1204,44316,3575893775,3575893791,16
2,1204,44317,3575893775,3575893794,19
2,1204,44318,3575893775,3575893795,20
2,1204,44319,3575893775,3575893795,20
2,1204,44320,3575893775,3575893796,21
2,1204,44321,3575893775,3575893796,21
2,1204,44322,3575893775,3575893797,22
2,1204,44323,3575893775,3575893798,23
2,1204,44324,3575893775,3575893798,23
2,1204,44325,3575893775,3575893798,23
2,1204,44326,3575893775,3575893799,24
2,1204,44327,3575893775,3575893801,26
2,1204,44328,3575893775,3575893802,27
2,1204,44329,3575893775,3575893803,28
2,1204,44330,3575893775,3575893804,29
2,1204,44331,3575893775,3575893804,29
2,1204,44332,3575893775,3575893805,30
2,1204,44333,3575893775,3575893805,30
2,1204,44334,3575893775,3575893805,30
2,1204,44335,3575893775,3575893806,31
2,1204,44336,3575893775,3575893807,32
2,1204,44337,3575893775,3575893810,35
2,1204,44338,3575893775,3575893811,36
2,1204,44339,3575893775,3575893812,37
2,1204,44340,3575893775,3575893813,38
2,1204,44341,3575893775,3575893816,41
2,1204,44342,3575893775,3575893819,44
2,1204,44343,3575893775,3575893821,46
2,1204,44344,3575893775,3575893822,47
2,1204,44345,3575893775,3575893823,48
2,1204,44346,3575893775,3575893824,49
2,1204,44347,3575893775,3575893825,50
2,1205,44348,3575893842,3575893842,0
2,1205,44349,3575893842,3575893842,0
2,1205,44350,3575893842,3575893842,0
2,1205,44351,3575893842,3575893842,0
2,1205,44352,3575893842,3575893842,0
2,1205,44353,3575893842,3575893842,0
2,1205,44354,3575893842,3575893842,0
2,1205,44355,3575893842,3575893842,0
2,1205,44356,3575893842,3575893842,0
2,1205,44357,3575893842,3575893842,0
2,1205,44358,3575893842,3575893842,0
2,1205,44359,3575893842,3575893842,0
2,1205,44360,3575893842,3575893842,0
2,1205,44361,3575893842,3575893842,0
2,1205,44362,3575893842,3575893842,0
2,1205,44363,3575893842,3575893842,0
2,1205,44364,3575893842,3575893842,0
2,1205,44365,3575893842,3575893842,0
2,1205,44366,3575893842,3575893842,0
2,1205,44367,3575893842,3575893842,0
2,1205,44368,3575893842,3575893842,0
2,1205,44369,3575893842,3575893843,1
2,1205,44370,3575893842,3575893843,1
2,1205,44371,3575893842,3575893847,5
2,1205,44372,3575893842,3575893849,7
2,1205,44373,3575893842,3575893851,9
2,1205,44374,3575893842,3575893853,11
2,1205,44375,3575893842,3575893853,11
2,1205,44376,3575893842,3575893854,12
2,1205,44377,3575893842,3575893855,13
2,1205,44378,3575893842,3575893855,13
2,1205,44379,3575893842,3575893855,13
2,1205,44380,3575893842,3575893855,13
2,1205,44381,3575893842,3575893856,14
2,1205,44382,3575893842,3575893856,14
2,1205,44383,3575893842,3575893857,15
2,1205,44384,3575893842,3575893858,16
2,1205,44385,3575893842,3575893859,17
2,1205,44386,3575893842,3575893861,19
2,1205,44387,3575893842,3575893861,19
2,1205,44388,3575893842,3575893861,19
2,1205,44389,3575893842,3575893861,19
2,1205,44390,3575893842,3575893865,23
2,1205,44391,3575893842,3575893866,24
2,1205,44392,3575893842,3575893867,25
2,1205,44393,3575893842,3575893867,25
2,1205,44394,3575893842,3575893869,27
2,1205,44395,3575893842,3575893878,36
2,1205,44396,3575893842,3575893879,37
2,1205,44397,3575893842,3575893883,41
2,1205,44398,3575893842,3575893883,41
2,1205,44399,3575893842,3575893885,43
2,1205,44400,3575893842,3575893886,44
2,1205,44401,3575893842,3575893887,45
2,1205,44402,3575893842,3575893888,46
2,1205,44403,3575893842,3575893888,46
2,1205,44404,3575893842,3575893888,46
2,1205,44405,3575893842,3575893889,47
2,1205,44406,3575893842,3575893891,49
2,1205,44407,3575893842,3575893892,50
2,1206,44408,3575893904,3575893904,0
2,1206,44409,3575893904,3575893904,0
2,1206,44410,3575893904,3575893904,0
2,1206,44411,3575893904,3575893904,0
2,1206,44412,3575893904,3575893904,0
2,1206,44413,3575893904,3575893904,0
2,1206,44414,3575893904,3575893905,1
2,1206,44415,3575893904,3575893905,1
2,1206,44416,3575893904,3575893905,1
2,1206,44417,3575893904,3575893905,1
2,1206,44418,3575893904,3575893905,1
2,1206,44419,3575893904,3575893905,1
2,1206,44420,3575893904,3575893905,1
2,1206,44421,3575893904,3575893905,1
2,1206,44422,3575893904,3575893905,1
2,1206,44423,3575893904,3575893905,1
2,1206,44424,3575893904,3575893905,1
2,1206,44425,3575893904,3575893905,1
2,1206,44426,3575893904,3575893905,1
2,1206,44427,3575893904,3575893907,3
2,1206,44428,3575893904,3575893907,3
2,1206,44429,3575893904,3575893908,4
2,1206,44430,3575893904,3575893908,4
2,1206,44431,3575893904,3575893909,5
2,1206,44432,3575893904,3575893909,5
2,1206,44433,3575893904,3575893910,6
2,1206,44434,3575893904,3575893911,7
2,1206,44435,3575893904,3575893911,7
2,1206,44436,3575893904,3575893911,7
2,1206,44437,3575893904,3575893912,8
2,1206,44438,3575893904,3575893913,9
2,1206,44439,3575893904,3575893913,9
2,1206,44440,3575893904,3575893913,9
2,1206,44441,3575893904,3575893914,10
2,1206,44442,3575893904,3575893914,10
2,1206,44443,3575893904,3575893916,12
2,1206,44444,3575893904,3575893917,13
2,1206,44445,3575893904,3575893918,14
2,1206,44446,3575893904,3575893919,15
2,1206,44447,3575893904,3575893920,16
2,1206,44448,3575893904,3575893920,16
2,1206,44449,3575893904,3575893921,17
2,1206,44450,3575893904,3575893922,18
2,1206,44451,3575893904,3575893923,19
2,1206,44452,3575893904,3575893926,22
2,1206,44453,3575893904,3575893926,22
2,1206,44454,3575893904,3575893926,22
2,1206,44455,3575893904,3575893927,23
2,1206,44456,3575893904,3575893928,24
2,1206,44457,3575893904,3575893928,24
2,1206,44458,3575893904,3575893929,25
2,1206,44459,3575893904,3575893930,26
2,1206,44460,3575893904,3575893931,27
2,1206,44461,3575893904,3575893931,27
2,1206,44462,3575893904,3575893933,29
2,1206,44463,3575893904,3575893933,29
2,1206,44464,3575893904,3575893935,31
2,1206,44465,3575893904,3575893935,31
2,1206,44466,3575893904,3575893935,31
2,1206,44467,3575893904,3575893935,31
2,1206,44468,3575893904,3575893936,32
2,1206,44469,3575893904,3575893937,33
2,1206,44470,3575893904,3575893939,35
2,1206,44471,3575893904,3575893939,35
2,1206,44472,3575893904,3575893940,36
2,1206,44473,3575893904,3575893942,38
2,1206,44474,3575893904,3575893945,41
2,1206,44475,3575893904,3575893945,41
2,1206,44476,3575893904,3575893947,43
2,1206,44477,3575893904,3575893947,43
2,1206,44478,3575893904,3575893948,44
2,1206,44479,3575893904,3575893948,44
2,1206,44480,3575893904,3575893948,44
2,1206,44481,3575893904,3575893949,45
2,1206,44482,3575893904,3575893950,46
2,1206,44483,3575893904,3575893950,46
2,1206,44484,3575893904,3575893952,48
2,1206,44485,3575893904,3575893952,48
2,1206,44486,3575893904,3575893953,49
2,1206,44487,3575893904,3575893954,50
2,1207,44488,3575893970,3575893970,0
2,1207,44489,3575893970,3575893970,0
2,1207,44490,3575893970,3575893970,0
2,1207,44491,3575893970,3575893970,0
2,1207,44492,3575893970,3575893970,0
2,1207,44493,3575893970,3575893970,0
2,1207,44494,3575893970,3575893970,0
2,1207,44495,3575893970,3575893970,0
2,1207,44496,3575893970,3575893970,0
2,1207,44497,3575893970,3575893970,0
2,1207,44498,3575893970,3575893970,0
2,1207,44499,3575893970,3575893970,0
2,1207,44500,3575893970,3575893970,0
2,1207,44501,3575893970,3575893970,0
2,1207,44502,3575893970,3575893970,0
2,1207,44503,3575893970,3575893970,0
2,1207,44504,3575893970,3575893970,0
2,1207,44505,3575893970,3575893970,0
2,1207,44506,3575893970,3575893970,0
2,1207,44507,3575893970,3575893970,0
2,1207,44508,3575893970,3575893971,1
2,1207,44509,3575893970,3575893972,2
2,1207,44510,3575893970,3575893973,3
2,1207,44511,3575893970,3575893974,4
2,1207,44512,3575893970,3575893975,5
2,1207,44513,3575893970,3575893975,5
2,1207,44514,3575893970,3575893975,5
2,1207,44515,3575893970,3575893976,6
2,1207,44516,3575893970,3575893976,6
2,1207,44517,3575893970,3575893976,6
2,1207,44518,3575893970,3575893978,8
2,1207,44519,3575893970,3575893980,10
2,1207,44520,3575893970,3575893981,11
2,1207,44521,3575893970,3575893982,12
2,1207,44522,3575893970,3575893983,13
2,1207,44523,3575893970,3575893985,15
2,1207,44524,3575893970,3575893985,15
2,1207,44525,3575893970,3575893986,16
2,1207,44526,3575893970,3575893987,17
2,1207,44527,3575893970,3575893987,17
2,1207,44528,3575893970,3575893988,18
2,1207,44529,3575893970,3575893988,18
2,1207,44530,3575893970,3575893988,18
2,1207,44531,3575893970,3575893991,21
2,1207,44532,3575893970,3575893993,23
2,1207,44533,3575893970,3575893993,23
2,1207,44534,3575893970,3575893993,23
2,1207,44535,3575893970,3575893994,24
2,1207,44536,3575893970,3575893995,25
2,1207,44537,3575893970,3575893995,25
2,1207,44538,3575893970,3575893995,25
2,1207,44539,3575893970,3575893996,26
2,1207,44540,3575893970,3575893998,28
2,1207,44541,3575893970,3575893998,28
2,1207,44542,3575893970,3575893998,28
2,1207,44543,3575893970,3575893999,29
2,1207,44544,3575893970,3575894000,30
2,1207,44545,3575893970,3575894000,30
2,1207,44546,3575893970,3575894001,31
2,1207,44547,3575893970,3575894003,33
2,1207,44548,3575893970,3575894004,34
2,1207,44549,3575893970,3575894004,34
2,1207,44550,3575893970,3575894004,34
2,1207,44551,3575893970,3575894005,35
2,1207,44552,3575893970,3575894006,36
2,1207,44553,3575893970,3575894007,37
2,1207,44554,3575893970,3575894010,40
2,1207,44555,3575893970,3575894011,41
2,1207,44556,3575893970,3575894011,41
2,1207,44557,3575893970,3575894013,43
2,1207,44558,3575893970,3575894016,46
2,1207,44559,3575893970,3575894019,49
2,1208,44560,3575894033,3575894033,0
2,1208,44561,3575894033,3575894033,0
2,1208,44562,3575894033,3575894033,0
2,1208,44563,3575894033,3575894033,0
2,1208,44564,3575894033,3575894033,0
2,1208,44565,3575894033,3575894033,0
2,1208,44566,3575894033,3575894033,0
2,1208,44567,3575894033,3575894033,0
2,1208,44568,3575894033,3575894033,0
2,1208,44569,3575894033,3575894033,0
2,1208,44570,3575894033,3575894033,0
2,1208,44571,3575894033,3575894033,0
2,1208,44572,3575894033,3575894033,0
2,1208,44573,3575894033,3575894033,0
2,1208,44574,3575894033,3575894033,0
2,1208,44575,3575894033,3575894033,0
2,1208,44576,3575894033,3575894033,0
2,1208,44577,3575894033,3575894033,0
2,1208,44578,3575894033,3575894035,2
2,1208,44579,3575894033,3575894036,3
2,1208,44580,3575894033,3575894036,3
2,1208,44581,3575894033,3575894036,3
2,1208,44582,3575894033,3575894037,4
2,1208,44583,3575894033,3575894037,4
2,1208,44584,3575894033,3575894038,5
2,1208,44585,3575894033,3575894040,7
2,1208,44586,3575894033,3575894040,7
2,1208,44587,3575894033,3575894041,8
2,1208,44588,3575894033,3575894041,8
2,1208,44589,3575894033,3575894043,10
2,1208,44590,3575894033,3575894043,10
2,1208,44591,3575894033,3575894043,10
2,1208,44592,3575894033,3575894047,14
2,1208,44593,3575894033,3575894047,14
2,1208,44594,3575894033,3575894049,16
2,1208,44595,3575894033,3575894050,17
2,1208,44596,3575894033,3575894053,20
2,1208,44597,3575894033,3575894053,20
2,1208,44598,3575894033,3575894054,21
2,1208,44599,3575894033,3575894055,22
2,1208,44600,3575894033,3575894055,22
2,1208,44601,3575894033,3575894055,22
2,1208,44602,3575894033,3575894056,23
2,1208,44603,3575894033,3575894056,23
2,1208,44604,3575894033,3575894056,23
2,1208,44605,3575894033,3575894057,24
2,1208,44606,3575894033,3575894058,25
2,1208,44607,3575894033,3575894059,26
2,1208,44608,3575894033,3575894061,28
2,1208,44609,3575894033,3575894061,28
2,1208,44610,3575894033,3575894061,28
2,1208,44611,3575894033,3575894062,29
2,1208,44612,3575894033,3575894066,33
2,1208,44613,3575894033,3575894066,33
2,1208,44614,3575894033,3575894067,34
2,1208,44615,3575894033,3575894068,35
2,1208,44616,3575894033,3575894069,36
2,1208,44617,3575894033,3575894078,45
2,1209,44618,3575894097,3575894097,0
2,1209,44619,3575894097,3575894097,0
2,1209,44620,3575894097,3575894097,0
2,1209,44621,3575894097,3575894097,0
2,1209,44622,3575894097,3575894097,0
2,1209,44623,3575894097,3575894097,0
2,1209,44624,3575894097,3575894097,0
2,1209,44625,3575894097,3575894097,0
2,1209,44626,3575894097,3575894097,0
2,1209,44627,3575894097,3575894097,0
2,1209,44628,3575894097,3575894097,0
2,1209,44629,3575894097,3575894097,0
2,1209,44630,3575894097,3575894097,0
2,1209,44631,3575894097,3575894097,0
2,1209,44632,3575894097,3575894097,0
2,1209,44633,3575894097,3575894097,0
2,1209,44634,3575894097,3575894097,0
2,1209,44635,3575894097,3575894097,0
2,1209,44636,3575894097,3575894098,1
2,1209,44637,3575894097,3575894099,2
2,1209,44638,3575894097,3575894099,2
2,1209,44639,3575894097,3575894099,2
2,1209,44640,3575894097,3575894100,3
2,1209,44641,3575894097,3575894101,4
2,1209,44642,3575894097,3575894101,4
2,1209,44643,3575894097,3575894103,6
2,1209,44644,3575894097,3575894103,6
2,1209,44645,3575894097,3575894104,7
2,1209,44646,3575894097,3575894106,9
2,1209,44647,3575894097,3575894107,10
2,1209,44648,3575894097,3575894107,10
2,1209,44649,3575894097,3575894108,11
2,1209,44650,3575894097,3575894108,11
2,1209,44651,3575894097,3575894108,11
2,1209,44652,3575894097,3575894109,12
2,1209,44653,3575894097,3575894109,12
2,1209,44654,3575894097,3575894111,14
2,1209,44655,3575894097,3575894111,14
2,1209,44656,3575894097,3575894112,15
2,1209,44657,3575894097,3575894113,16
2,1209,44658,3575894097,3575894114,17
2,1209,44659,3575894097,3575894117,20
2,1209,44660,3575894097,3575894118,21
2,1209,44661,3575894097,3575894118,21
2,1209,44662,3575894097,3575894119,22
2,1209,44663,3575894097,3575894119,22
2,1209,44664,3575894097,3575894120,23
2,1209,44665,3575894097,3575894122,25
2,1209,44666,3575894097,3575894123,26
2,1209,44667,3575894097,3575894126,29
2,1209,44668,3575894097,3575894126,29
2,1209,44669,3575894097,3575894127,30
2,1209,44670,3575894097,3575894127,30
2,1209,44671,3575894097,3575894128,31
2,1209,44672,3575894097,3575894128,31
2,1209,44673,3575894097,3575894129,32
2,1209,44674,3575894097,3575894130,33
2,1209,44675,3575894097,3575894130,33
2,1209,44676,3575894097,3575894130,33
2,1209,44677,3575894097,3575894131,34
2,1209,44678,3575894097,3575894131,34
2,1209,44679,3575894097,3575894133,36
2,1209,44680,3575894097,3575894133,36
2,1209,44681,3575894097,3575894134,37
2,1209,44682,3575894097,3575894135,38
2,1209,44683,3575894097,3575894135,38
2,1209,44684,3575894097,3575894136,39
2,1209,44685,3575894097,3575894136,39
2,1209,44686,3575894097,3575894138,41
2,1209,44687,3575894097,3575894139,42
2,1209,44688,3575894097,3575894140,43
2,1209,44689,3575894097,3575894142,45
2,1209,44690,3575894097,3575894142,45
2,1209,44691,3575894097,3575894144,47
2,1209,44692,3575894097,3575894145,48
2,1209,44693,3575894097,3575894145,48
2,1210,44694,3575894160,3575894160,0
2,1210,44695,3575894160,3575894160,0
2,1210,44696,3575894160,3575894160,0
2,1210,44697,3575894160,3575894160,0
2,1210,44698,3575894160,3575894160,0
2,1210,44699,3575894160,3575894160,0
2,1210,44700,3575894160,3575894160,0
2,1210,44701,3575894160,3575894160,0
2,1210,44702,3575894160,3575894160,0
2,1210,44703,3575894160,3575894160,0
2,1210,44704,3575894160,3575894160,0
2,1210,44705,3575894160,3575894160,0
2,1210,44706,3575894160,3575894160,0
2,1210,44707,3575894160,3575894160,0
2,1210,44708,3575894160,3575894160,0
2,1210,44709,3575894160,3575894160,0
2,1210,44710,3575894160,3575894160,0
2,1210,44711,3575894160,3575894161,1
2,1210,44712,3575894160,3575894161,1
2,1210,44713,3575894160,3575894164,4
2,1210,44714,3575894160,3575894165,5
2,1210,44715,3575894160,3575894165,5
2,1210,44716,3575894160,3575894166,6
2,1210,44717,3575894160,3575894166,6
2,1210,44718,3575894160,3575894166,6
2,1210,44719,3575894160,3575894168,8
2,1210,44720,3575894160,3575894168,8
2,1210,44721,3575894160,3575894168,8
2,1210,44722,3575894160,3575894169,9
2,1210,44723,3575894160,3575894169,9
2,1210,44724,3575894160,3575894170,10
2,1210,44725,3575894160,3575894171,11
2,1210,44726,3575894160,3575894171,11
2,1210,44727,3575894160,3575894173,13
2,1210,44728,3575894160,3575894173,13
2,1210,44729,3575894160,3575894174,14
2,1210,44730,3575894160,3575894175,15
2,1210,44731,3575894160,3575894175,15
2,1210,44732,3575894160,3575894176,16
2,1210,44733,3575894160,3575894176,16
2,1210,44734,3575894160,3575894176,16
2,1210,44735,3575894160,3575894176,16
2,1210,44736,3575894160,3575894181,21
2,1210,44737,3575894160,3575894182,22
2,1210,44738,3575894160,3575894182,22
2,1210,44739,3575894160,3575894183,23
2,1210,44740,3575894160,3575894185,25
2,1210,44741,3575894160,3575894185,25
2,1210,44742,3575894160,3575894185,25
2,1210,44743,3575894160,3575894185,25
2,1210,44744,3575894160,3575894186,26
2,1210,44745,3575894160,3575894187,27
2,1210,44746,3575894160,3575894188,28
2,1210,44747,3575894160,3575894188,28
2,1210,44748,3575894160,3575894188,28
2,1210,44749,3575894160,3575894189,29
2,1210,44750,3575894160,3575894189,29
2,1210,44751,3575894160,3575894190,30
2,1210,44752,3575894160,3575894191,31
2,1210,44753,3575894160,3575894193,33
2,1210,44754,3575894160,3575894193,33
2,1210,44755,3575894160,3575894195,35
2,1210,44756,3575894160,3575894196,36
2,1210,44757,3575894160,3575894196,36
2,1210,44758,3575894160,3575894196,36
2,1210,44759,3575894160,3575894198,38
2,1210,44760,3575894160,3575894198,38
2,1210,44761,3575894160,3575894200,40
2,1210,44762,3575894160,3575894200,40
2,1210,44763,3575894160,3575894200,40
2,1210,44764,3575894160,3575894202,42
2,1210,44765,3575894160,3575894203,43
2,1210,44766,3575894160,3575894204,44
2,1210,44767,3575894160,3575894204,44
2,1210,44768,3575894160,3575894205,45
2,1210,44769,3575894160,3575894206,46
2,1210,44770,3575894160,3575894206,46
2,1210,44771,3575894160,3575894207,47
2,1210,44772,3575894160,3575894207,47
2,1211,44773,3575894224,3575894224,0
2,1211,44774,3575894224,3575894224,0
2,1211,44775,3575894224,3575894224,0
2,1211,44776,3575894224,3575894224,0
2,1211,44777,3575894224,3575894224,0
2,1211,44778,3575894224,3575894224,0
2,1211,44779,3575894224,3575894224,0
2,1211,44780,3575894224,3575894224,0
2,1211,44781,3575894224,3575894226,2
2,1211,44782,3575894224,3575894226,2
2,1211,44783,3575894224,3575894228,4
2,1211,44784,3575894224,3575894228,4
2,1211,44785,3575894224,3575894229,5
2,1211,44786,3575894224,3575894229,5
2,1211,44787,3575894224,3575894229,5
2,1211,44788,3575894224,3575894229,5
2,1211,44789,3575894224,3575894230,6
2,1211,44790,3575894224,3575894230,6
2,1211,44791,3575894224,3575894231,7
2,1211,44792,3575894224,3575894231,7
2,1211,44793,3575894224,3575894231,7
2,1211,44794,3575894224,3575894233,9
2,1211,44795,3575894224,3575894235,11
2,1211,44796,3575894224,3575894235,11
2,1211,44797,3575894224,3575894237,13
2,1211,44798,3575894224,3575894237,13
2,1211,44799,3575894224,3575894239,15
2,1211,44800,3575894224,3575894240,16
2,1211,44801,3575894224,3575894240,16
2,1211,44802,3575894224,3575894240,16
2,1211,44803,3575894224,3575894242,18
2,1211,44804,3575894224,3575894243,19
2,1211,44805,3575894224,3575894243,19
2,1211,44806,3575894224,3575894243,19
2,1211,44807,3575894224,3575894246,22
2,1211,44808,3575894224,3575894247,23
2,1211,44809,3575894224,3575894247,23
2,1211,44810,3575894224,3575894249,25
2,1211,44811,3575894224,3575894251,27
2,1211,44812,3575894224,3575894253,29
2,1211,44813,3575894224,3575894254,30
2,1211,44814,3575894224,3575894255,31
2,1211,44815,3575894224,3575894255,31
2,1211,44816,3575894224,3575894256,32
2,1211,44817,3575894224,3575894256,32
2,1211,44818,3575894224,3575894256,32
2,1211,44819,3575894224,3575894258,34
2,1211,44820,3575894224,3575894258,34
2,1211,44821,3575894224,3575894261,37
2,1211,44822,3575894224,3575894262,38
2,1211,44823,3575894224,3575894262,38
2,1211,44824,3575894224,3575894263,39
2,1211,44825,3575894224,3575894266,42
2,1211,44826,3575894224,3575894266,42
2,1211,44827,3575894224,3575894268,44
2,1211,44828,3575894224,3575894269,45
2,1212,44829,3575894290,3575894290,0
2,1212,44830,3575894290,3575894290,0
2,1212,44831,3575894290,3575894290,0
2,1212,44832,3575894290,3575894290,0
2,1212,44833,3575894290,3575894290,0
2,1212,44834,3575894290,3575894290,0
2,1212,44835,3575894290,3575894290,0
2,1212,44836,3575894290,3575894290,0
2,1212,44837,3575894290,3575894290,0
2,1212,44838,3575894290,3575894290,0
2,1212,44839,3575894290,3575894290,0
2,1212,44840,3575894290,3575894292,2
2,1212,44841,3575894290,3575894292,2
2,1212,44842,3575894290,3575894292,2
2,1212,44843,3575894290,3575894293,3
2,1212,44844,3575894290,3575894293,3
2,1212,44845,3575894290,3575894293,3
2,1212,44846,3575894290,3575894294,4
2,1212,44847,3575894290,3575894295,5
2,1212,44848,3575894290,3575894297,7
2,1212,44849,3575894290,3575894298,8
2,1212,44850,3575894290,3575894299,9
2,1212,44851,3575894290,3575894299,9
2,1212,44852,3575894290,3575894300,10
2,1212,44853,3575894290,3575894300,10
2,1212,44854,3575894290,3575894300,10
2,1212,44855,3575894290,3575894300,10
2,1212,44856,3575894290,3575894301,11
2,1212,44857,3575894290,3575894301,11
2,1212,44858,3575894290,3575894302,12
2,1212,44859,3575894290,3575894303,13
2,1212,44860,3575894290,3575894303,13
2,1212,44861,3575894290,3575894303,13
2,1212,44862,3575894290,3575894306,16
2,1212,44863,3575894290,3575894307,17
2,1212,44864,3575894290,3575894307,17
2,1212,44865,3575894290,3575894308,18
2,1212,44866,3575894290,3575894308,18
2,1212,44867,3575894290,3575894308,18
2,1212,44868,3575894290,3575894308,18
2,1212,44869,3575894290,3575894309,19
2,1212,44870,3575894290,3575894309,19
2,1212,44871,3575894290,3575894311,21
2,1212,44872,3575894290,3575894311,21
2,1212,44873,3575894290,3575894311,21
2,1212,44874,3575894290,3575894313,23
2,1212,44875,3575894290,3575894313,23
2,1212,44876,3575894290,3575894314,24
2,1212,44877,3575894290,3575894314,24
2,1212,44878,3575894290,3575894316,26
2,1212,44879,3575894290,3575894316,26
2,1212,44880,3575894290,3575894317,27
2,1212,44881,3575894290,3575894318,28
2,1212,44882,3575894290,3575894319,29
2,1212,44883,3575894290,3575894319,29
2,1212,44884,3575894290,3575894320,30
2,1212,44885,3575894290,3575894320,30
2,1212,44886,3575894290,3575894323,33
2,1212,44887,3575894290,3575894326,36
2,1212,44888,3575894290,3575894326,36
2,1212,44889,3575894290,3575894327,37
2,1212,44890,3575894290,3575894328,38
2,1212,44891,3575894290,3575894328,38
2,1212,44892,3575894290,3575894329,39
2,1212,44893,3575894290,3575894330,40
2,1212,44894,3575894290,3575894330,40
2,1212,44895,3575894290,3575894331,41
2,1212,44896,3575894290,3575894331,41
2,1212,44897,3575894290,3575894331,41
2,1212,44898,3575894290,3575894332,42
2,1212,44899,3575894290,3575894332,42
2,1212,44900,3575894290,3575894334,44
2,1212,44901,3575894290,3575894334,44
2,1212,44902,3575894290,3575894334,44
2,1212,44903,3575894290,3575894336,46
2,1212,44904,3575894290,3575894336,46
2,1212,44905,3575894290,3575894336,46
2,1212,44906,3575894290,3575894336,46
2,1212,44907,3575894290,3575894338,48
2,1212,44908,3575894290,3575894340,50
2,1213,44909,3575894353,3575894353,0
2,1213,44910,3575894353,3575894353,0
2,1213,44911,3575894353,3575894353,0
2,1213,44912,3575894353,3575894353,0
2,1213,44913,3575894353,3575894353,0
2,1213,44914,3575894353,3575894353,0
2,1213,44915,3575894353,3575894353,0
2,1213,44916,3575894353,3575894353,0
2,1213,44917,3575894353,3575894353,0
2,1213,44918,3575894353,3575894353,0
2,1213,44919,3575894353,3575894353,0
2,1213,44920,3575894353,3575894353,0
2,1213,44921,3575894353,3575894353,0
2,1213,44922,3575894353,3575894353,0
2,1213,44923,3575894353,3575894353,0
2,1213,44924,3575894353,3575894353,0
2,1213,44925,3575894353,3575894353,0
2,1213,44926,3575894353,3575894353,0
2,1213,44927,3575894353,3575894354,1
2,1213,44928,3575894353,3575894354,1
2,1213,44929,3575894353,3575894355,2
2,1213,44930,3575894353,3575894357,4
2,1213,44931,3575894353,3575894358,5
2,1213,44932,3575894353,3575894359,6
2,1213,44933,3575894353,3575894360,7
2,1213,44934,3575894353,3575894360,7
2,1213,44935,3575894353,3575894360,7
2,1213,44936,3575894353,3575894361,8
2,1213,44937,3575894353,3575894362,9
2,1213,44938,3575894353,3575894364,11
2,1213,44939,3575894353,3575894365,12
2,1213,44940,3575894353,3575894366,13
2,1213,44941,3575894353,3575894366,13
2,1213,44942,3575894353,3575894366,13
2,1213,44943,3575894353,3575894368,15
2,1213,44944,3575894353,3575894368,15
2,1213,44945,3575894353,3575894368,15
2,1213,44946,3575894353,3575894369,16
2,1213,44947,3575894353,3575894371,18
2,1213,44948,3575894353,3575894372,19
2,1213,44949,3575894353,3575894373,20
2,1213,44950,3575894353,3575894374,21
2,1213,44951,3575894353,3575894375,22
2,1213,44952,3575894353,3575894376,23
2,1213,44953,3575894353,3575894376,23
2,1213,44954,3575894353,3575894376,23
2,1213,44955,3575894353,3575894376,23
2,1213,44956,3575894353,3575894376,23
2,1213,44957,3575894353,3575894377,24
2,1213,44958,3575894353,3575894378,25
2,1213,44959,3575894353,3575894381,28
2,1213,44960,3575894353,3575894381,28
2,1213,44961,3575894353,3575894382,29
2,1213,44962,3575894353,3575894382,29
2,1213,44963,3575894353,3575894383,30
2,1213,44964,3575894353,3575894385,32
2,1213,44965,3575894353,3575894385,32
2,1213,44966,3575894353,3575894385,32
2,1213,44967,3575894353,3575894386,33
2,1213,44968,3575894353,3575894386,33
2,1213,44969,3575894353,3575894388,35
2,1213,44970,3575894353,3575894388,35
2,1213,44971,3575894353,3575894388,35
2,1213,44972,3575894353,3575894388,35
2,1213,44973,3575894353,3575894389,36
2,1213,44974,3575894353,3575894389,36
2,1213,44975,3575894353,3575894391,38
2,1213,44976,3575894353,3575894391,38
2,1213,44977,3575894353,3575894392,39
2,1213,44978,3575894353,3575894393,40
2,1213,44979,3575894353,3575894394,41
2,1213,44980,3575894353,3575894395,42
2,1213,44981,3575894353,3575894395,42
2,1213,44982,3575894353,3575894395,42
2,1213,44983,3575894353,3575894396,43
2,1213,44984,3575894353,3575894399,46
2,1213,44985,3575894353,3575894399,46
2,1213,44986,3575894353,3575894399,46
2,1213,44987,3575894353,3575894400,47
2,1213,44988,3575894353,3575894400,47
2,1213,44989,3575894353,3575894401,48
2,1213,44990,3575894353,3575894403,50
2,1214,44991,3575894418,3575894418,0
2,1214,44992,3575894418,3575894418,0
2,1214,44993,3575894418,3575894418,0
2,1214,44994,3575894418,3575894418,0
2,1214,44995,3575894418,3575894418,0
2,1214,44996,3575894418,3575894418,0
2,1214,44997,3575894418,3575894418,0
2,1214,44998,3575894418,3575894418,0
2,1214,44999,3575894418,3575894418,0
2,1214,45000,3575894418,3575894418,0
2,1214,45001,3575894418,3575894418,0
2,1214,45002,3575894418,3575894419,1
2,1214,45003,3575894418,3575894422,4
2,1214,45004,3575894418,3575894422,4
2,1214,45005,3575894418,3575894423,5
2,1214,45006,3575894418,3575894424,6
2,1214,45007,3575894418,3575894426,8
2,1214,45008,3575894418,3575894426,8
2,1214,45009,3575894418,3575894427,9
2,1214,45010,3575894418,3575894428,10
2,1214,45011,3575894418,3575894428,10
2,1214,45012,3575894418,3575894428,10
2,1214,45013,3575894418,3575894429,11
2,1214,45014,3575894418,3575894429,11
2,1214,45015,3575894418,3575894430,12
2,1214,45016,3575894418,3575894430,12
2,1214,45017,3575894418,3575894431,13
2,1214,45018,3575894418,3575894432,14
2,1214,45019,3575894418,3575894434,16
2,1214,45020,3575894418,3575894436,18
2,1214,45021,3575894418,3575894437,19
2,1214,45022,3575894418,3575894437,19
2,1214,45023,3575894418,3575894437,19
2,1214,45024,3575894418,3575894437,19
2,1214,45025,3575894418,3575894439,21
2,1214,45026,3575894418,3575894440,22
2,1214,45027,3575894418,3575894440,22
2,1214,45028,3575894418,3575894441,23
2,1214,45029,3575894418,3575894441,23
2,1214,45030,3575894418,3575894443,25
2,1214,45031,3575894418,3575894443,25
2,1214,45032,3575894418,3575894444,26
2,1214,45033,3575894418,3575894446,28
2,1214,45034,3575894418,3575894447,29
2,1214,45035,3575894418,3575894449,31
2,1214,45036,3575894418,3575894449,31
2,1214,45037,3575894418,3575894452,34
2,1214,45038,3575894418,3575894453,35
2,1214,45039,3575894418,3575894455,37
2,1214,45040,3575894418,3575894455,37
2,1214,45041,3575894418,3575894455,37
2,1214,45042,3575894418,3575894456,38
2,1214,45043,3575894418,3575894456,38
2,1214,45044,3575894418,3575894459,41
2,1214,45045,3575894418,3575894459,41
2,1214,45046,3575894418,3575894459,41
2,1214,45047,3575894418,3575894461,43
2,1214,45048,3575894418,3575894461,43
2,1214,45049,3575894418,3575894462,44
2,1214,45050,3575894418,3575894463,45
2,1214,45051,3575894418,3575894466,48
2,1214,45052,3575894418,3575894466,48
2,1214,45053,3575894418,3575894467,49
2,1214,45054,3575894418,3575894468,50
2,1215,45055,3575894481,3575894481,0
2,1215,45056,3575894481,3575894481,0
2,1215,45057,3575894481,3575894481,0
2,1215,45058,3575894481,3575894482,1
2,1215,45059,3575894481,3575894482,1
2,1215,45060,3575894481,3575894484,3
2,1215,45061,3575894481,3575894485,4
2,1215,45062,3575894481,3575894485,4
2,1215,45063,3575894481,3575894486,5
2,1215,45064,3575894481,3575894488,7
2,1215,45065,3575894481,3575894488,7
2,1215,45066,3575894481,3575894488,7
2,1215,45067,3575894481,3575894488,7
2,1215,45068,3575894481,3575894491,10
2,1215,45069,3575894481,3575894491,10
2,1215,45070,3575894481,3575894491,10
2,1215,45071,3575894481,3575894492,11
2,1215,45072,3575894481,3575894492,11
2,1215,45073,3575894481,3575894492,11
2,1215,45074,3575894481,3575894493,12
2,1215,45075,3575894481,3575894494,13
2,1215,45076,3575894481,3575894494,13
2,1215,45077,3575894481,3575894495,14
2,1215,45078,3575894481,3575894495,14
2,1215,45079,3575894481,3575894498,17
2,1215,45080,3575894481,3575894498,17
2,1215,45081,3575894481,3575894498,17
2,1215,45082,3575894481,3575894500,19
2,1215,45083,3575894481,3575894500,19
2,1215,45084,3575894481,3575894500,19
2,1215,45085,3575894481,3575894500,19
2,1215,45086,3575894481,3575894501,20
2,1215,45087,3575894481,3575894501,20
2,1215,45088,3575894481,3575894502,21
2,1215,45089,3575894481,3575894503,22
2,1215,45090,3575894481,3575894503,22
2,1215,45091,3575894481,3575894503,22
2,1215,45092,3575894481,3575894504,23
2,1215,45093,3575894481,3575894505,24
2,1215,45094,3575894481,3575894506,25
2,1215,45095,3575894481,3575894507,26
2,1215,45096,3575894481,3575894507,26
2,1215,45097,3575894481,3575894508,27
2,1215,45098,3575894481,3575894508,27
2,1215,45099,3575894481,3575894511,30
2,1215,45100,3575894481,3575894511,30
2,1215,45101,3575894481,3575894511,30
2,1215,45102,3575894481,3575894511,30
2,1215,45103,3575894481,3575894511,30
2,1215,45104,3575894481,3575894512,31
2,1215,45105,3575894481,3575894513,32
2,1215,45106,3575894481,3575894513,32
2,1215,45107,3575894481,3575894514,33
2,1215,45108,3575894481,3575894515,34
2,1215,45109,3575894481,3575894516,35
2,1215,45110,3575894481,3575894517,36
2,1215,45111,3575894481,3575894518,37
2,1215,45112,3575894481,3575894518,37
2,1215,45113,3575894481,3575894519,38
2,1215,45114,3575894481,3575894519,38
2,1215,45115,3575894481,3575894520,39
2,1215,45116,3575894481,3575894520,39
2,1215,45117,3575894481,3575894525,44
2,1215,45118,3575894481,3575894525,44
2,1215,45119,3575894481,3575894525,44
2,1215,45120,3575894481,3575894526,45
2,1215,45121,3575894481,3575894527,46
2,1215,45122,3575894481,3575894527,46
2,1215,45123,3575894481,3575894529,48
2,1215,45124,3575894481,3575894529,48
2,1215,45125,3575894481,3575894530,49
2,1215,45126,3575894481,3575894531,50
2,1216,45127,3575894550,3575894550,0
2,1216,45128,3575894550,3575894550,0
2,1216,45129,3575894550,3575894550,0
2,1216,45130,3575894550,3575894550,0
2,1216,45131,3575894550,3575894550,0
2,1216,45132,3575894550,3575894550,0
2,1216,45133,3575894550,3575894550,0
2,1216,45134,3575894550,3575894550,0
2,1216,45135,3575894550,3575894550,0
2,1216,45136,3575894550,3575894550,0
2,1216,45137,3575894550,3575894550,0
2,1216,45138,3575894550,3575894550,0
2,1216,45139,3575894550,3575894550,0
2,1216,45140,3575894550,3575894550,0
2,1216,45141,3575894550,3575894550,0
2,1216,45142,3575894550,3575894550,0
2,1216,45143,3575894550,3575894550,0
2,1216,45144,3575894550,3575894550,0
2,1216,45145,3575894550,3575894550,0
2,1216,45146,3575894550,3575894550,0
2,1216,45147,3575894550,3575894550,0
2,1216,45148,3575894550,3575894550,0
2,1216,45149,3575894550,3575894550,0
2,1216,45150,3575894550,3575894550,0
2,1216,45151,3575894550,3575894550,0
2,1216,45152,3575894550,3575894550,0
2,1216,45153,3575894550,3575894550,0
2,1216,45154,3575894550,3575894550,0
2,1216,45155,3575894550,3575894551,1
2,1216,45156,3575894550,3575894551,1
2,1216,45157,3575894550,3575894552,2
2,1216,45158,3575894550,3575894553,3
2,1216,45159,3575894550,3575894553,3
2,1216,45160,3575894550,3575894555,5
2,1216,45161,3575894550,3575894556,6
2,1216,45162,3575894550,3575894558,8
2,1216,45163,3575894550,3575894559,9
2,1216,45164,3575894550,3575894559,9
2,1216,45165,3575894550,3575894559,9
2,1216,45166,3575894550,3575894560,10
2,1216,45167,3575894550,3575894560,10
2,1216,45168,3575894550,3575894560,10
2,1216,45169,3575894550,3575894560,10
2,1216,45170,3575894550,3575894560,10
2,1216,45171,3575894550,3575894563,13
2,1216,45172,3575894550,3575894564,14
2,1216,45173,3575894550,3575894565,15
2,1216,45174,3575894550,3575894566,16
2,1216,45175,3575894550,3575894566,16
2,1216,45176,3575894550,3575894567,17
2,1216,45177,3575894550,3575894567,17
2,1216,45178,3575894550,3575894567,17
2,1216,45179,3575894550,3575894567,17
2,1216,45180,3575894550,3575894567,17
2,1216,45181,3575894550,3575894569,19
2,1216,45182,3575894550,3575894569,19
2,1216,45183,3575894550,3575894571,21
2,1216,45184,3575894550,3575894571,21
2,1216,45185,3575894550,3575894573,23
2,1216,45186,3575894550,3575894574,24
2,1216,45187,3575894550,3575894575,25
2,1216,45188,3575894550,3575894576,26
2,1216,45189,3575894550,3575894576,26
2,1216,45190,3575894550,3575894577,27
2,1216,45191,3575894550,3575894581,31
2,1216,45192,3575894550,3575894581,31
2,1216,45193,3575894550,3575894581,31
2,1216,45194,3575894550,3575894581,31
2,1216,45195,3575894550,3575894583,33
2,1216,45196,3575894550,3575894583,33
2,1216,45197,3575894550,3575894583,33
2,1216,45198,3575894550,3575894584,34
2,1216,45199,3575894550,3575894584,34
2,1216,45200,3575894550,3575894584,34
2,1216,45201,3575894550,3575894586,36
2,1216,45202,3575894550,3575894587,37
2,1216,45203,3575894550,3575894587,37
2,1216,45204,3575894550,3575894588,38
2,1216,45205,3575894550,3575894588,38
2,1216,45206,3575894550,3575894588,38
2,1216,45207,3575894550,3575894589,39
2,1216,45208,3575894550,3575894590,40
2,1216,45209,3575894550,3575894591,41
2,1216,45210,3575894550,3575894593,43
2,1216,45211,3575894550,3575894594,44
2,1216,45212,3575894550,3575894594,44
2,1216,45213,3575894550,3575894595,45
2,1216,45214,3575894550,3575894595,45
2,1216,45215,3575894550,3575894595,45
2,1216,45216,3575894550,3575894598,48
2,1216,45217,3575894550,3575894598,48
2,1216,45218,3575894550,3575894598,48
2,1216,45219,3575894550,3575894599,49
2,1216,45220,3575894550,3575894599,49
2,1217,45221,3575894613,3575894613,0
2,1217,45222,3575894613,3575894613,0
2,1217,45223,3575894613,3575894613,0
2,1217,45224,3575894613,3575894613,0
2,1217,45225,3575894613,3575894613,0
2,1217,45226,3575894613,3575894613,0
2,1217,45227,3575894613,3575894613,0
2,1217,45228,3575894613,3575894613,0
2,1217,45229,3575894613,3575894613,0
2,1217,45230,3575894613,3575894613,0
2,1217,45231,3575894613,3575894613,0
2,1217,45232,3575894613,3575894613,0
2,1217,45233,3575894613,3575894613,0
2,1217,45234,3575894613,3575894613,0
2,1217,45235,3575894613,3575894615,2
2,1217,45236,3575894613,3575894618,5
2,1217,45237,3575894613,3575894620,7
2,1217,45238,3575894613,3575894622,9
2,1217,45239,3575894613,3575894623,10
2,1217,45240,3575894613,3575894625,12
2,1217,45241,3575894613,3575894627,14
2,1217,45242,3575894613,3575894627,14
2,1217,45243,3575894613,3575894627,14
2,1217,45244,3575894613,3575894627,14
2,1217,45245,3575894613,3575894627,14
2,1217,45246,3575894613,3575894628,15
2,1217,45247,3575894613,3575894628,15
2,1217,45248,3575894613,3575894629,16
2,1217,45249,3575894613,3575894629,16
2,1217,45250,3575894613,3575894630,17
2,1217,45251,3575894613,3575894631,18
2,1217,45252,3575894613,3575894634,21
2,1217,45253,3575894613,3575894634,21
2,1217,45254,3575894613,3575894635,22
2,1217,45255,3575894613,3575894636,23
2,1217,45256,3575894613,3575894636,23
2,1217,45257,3575894613,3575894637,24
2,1217,45258,3575894613,3575894638,25
2,1217,45259,3575894613,3575894639,26
2,1217,45260,3575894613,3575894640,27
2,1217,45261,3575894613,3575894640,27
2,1217,45262,3575894613,3575894640,27
2,1217,45263,3575894613,3575894643,30
2,1217,45264,3575894613,3575894643,30
2,1217,45265,3575894613,3575894644,31
2,1217,45266,3575894613,3575894645,32
2,1217,45267,3575894613,3575894648,35
2,1217,45268,3575894613,3575894648,35
2,1217,45269,3575894613,3575894651,38
2,1217,45270,3575894613,3575894653,40
2,1217,45271,3575894613,3575894653,40
2,1217,45272,3575894613,3575894654,41
2,1217,45273,3575894613,3575894654,41
2,1217,45274,3575894613,3575894655,42
2,1217,45275,3575894613,3575894655,42
2,1217,45276,3575894613,3575894655,42
2,1217,45277,3575894613,3575894655,42
2,1217,45278,3575894613,3575894658,45
2,1217,45279,3575894613,3575894658,45
2,1217,45280,3575894613,3575894658,45
2,1217,45281,3575894613,3575894660,47
2,1217,45282,3575894613,3575894661,48
2,1217,45283,3575894613,3575894662,49
2,1218,45284,3575894678,3575894678,0
2,1218,45285,3575894678,3575894678,0
2,1218,45286,3575894678,3575894678,0
2,1218,45287,3575894678,3575894678,0
2,1218,45288,3575894678,3575894678,0
2,1218,45289,3575894678,3575894678,0
2,1218,45290,3575894678,3575894678,0
2,1218,45291,3575894678,3575894682,4
2,1218,45292,3575894678,3575894683,5
2,1218,45293,3575894678,3575894683,5
2,1218,45294,3575894678,3575894684,6
2,1218,45295,3575894678,3575894685,7
2,1218,45296,3575894678,3575894685,7
2,1218,45297,3575894678,3575894686,8
2,1218,45298,3575894678,3575894687,9
2,1218,45299,3575894678,3575894688,10
2,1218,45300,3575894678,3575894688,10
2,1218,45301,3575894678,3575894689,11
2,1218,45302,3575894678,3575894689,11
2,1218,45303,3575894678,3575894689,11
2,1218,45304,3575894678,3575894690,12
2,1218,45305,3575894678,3575894691,13
2,1218,45306,3575894678,3575894692,14
2,1218,45307,3575894678,3575894692,14
2,1218,45308,3575894678,3575894692,14
2,1218,45309,3575894678,3575894693,15
2,1218,45310,3575894678,3575894693,15
2,1218,45311,3575894678,3575894693,15
2,1218,45312,3575894678,3575894694,16
2,1218,45313,3575894678,3575894695,17
2,1218,45314,3575894678,3575894695,17
2,1218,45315,3575894678,3575894696,18
2,1218,45316,3575894678,3575894698,20
2,1218,45317,3575894678,3575894698,20
2,1218,45318,3575894678,3575894699,21
2,1218,45319,3575894678,3575894700,22
2,1218,45320,3575894678,3575894700,22
2,1218,45321,3575894678,3575894701,23
2,1218,45322,3575894678,3575894702,24
2,1218,45323,3575894678,3575894702,24
2,1218,45324,3575894678,3575894703,25
2,1218,45325,3575894678,3575894704,26
2,1218,45326,3575894678,3575894704,26
2,1218,45327,3575894678,3575894705,27
2,1218,45328,3575894678,3575894707,29
2,1218,45329,3575894678,3575894707,29
2,1218,45330,3575894678,3575894707,29
2,1218,45331,3575894678,3575894708,30
2,1218,45332,3575894678,3575894708,30
2,1218,45333,3575894678,3575894708,30
2,1218,45334,3575894678,3575894710,32
2,1218,45335,3575894678,3575894711,33
2,1218,45336,3575894678,3575894711,33
2,1218,45337,3575894678,3575894712,34
2,1218,45338,3575894678,3575894712,34
2,1218,45339,3575894678,3575894713,35
2,1218,45340,3575894678,3575894713,35
2,1218,45341,3575894678,3575894713,35
2,1218,45342,3575894678,3575894714,36
2,1218,45343,3575894678,3575894714,36
2,1218,45344,3575894678,3575894715,37
2,1218,45345,3575894678,3575894716,38
2,1218,45346,3575894678,3575894716,38
2,1218,45347,3575894678,3575894718,40
2,1218,45348,3575894678,3575894719,41
2,1218,45349,3575894678,3575894721,43
2,1218,45350,3575894678,3575894721,43
2,1218,45351,3575894678,3575894721,43
2,1218,45352,3575894678,3575894722,44
2,1218,45353,3575894678,3575894723,45
2,1218,45354,3575894678,3575894725,47
2,1218,45355,3575894678,3575894725,47
2,1218,45356,3575894678,3575894726,48
2,1218,45357,3575894678,3575894726,48
2,1218,45358,3575894678,3575894727,49
2,1218,45359,3575894678,3575894727,49
2,1219,45360,3575894745,3575894745,0
2,1219,45361,3575894745,3575894745,0
2,1219,45362,3575894745,3575894745,0
2,1219,45363,3575894745,3575894745,0
2,1219,45364,3575894745,3575894745,0
2,1219,45365,3575894745,3575894745,0
2,1219,45366,3575894745,3575894745,0
2,1219,45367,3575894745,3575894745,0
2,1219,45368,3575894745,3575894745,0
2,1219,45369,3575894745,3575894745,0
2,1219,45370,3575894745,3575894745,0
2,1219,45371,3575894745,3575894745,0
2,1219,45372,3575894745,3575894745,0
2,1219,45373,3575894745,3575894745,0
2,1219,45374,3575894745,3575894745,0
2,1219,45375,3575894745,3575894745,0
2,1219,45376,3575894745,3575894745,0
2,1219,45377,3575894745,3575894745,0
2,1219,45378,3575894745,3575894745,0
2,1219,45379,3575894745,3575894745,0
2,1219,45380,3575894745,3575894745,0
2,1219,45381,3575894745,3575894745,0
2,1219,45382,3575894745,3575894746,1
2,1219,45383,3575894745,3575894747,2
2,1219,45384,3575894745,3575894747,2
2,1219,45385,3575894745,3575894748,3
2,1219,45386,3575894745,3575894748,3
2,1219,45387,3575894745,3575894749,4
2,1219,45388,3575894745,3575894749,4
2,1219,45389,3575894745,3575894750,5
2,1219,45390,3575894745,3575894750,5
2,1219,45391,3575894745,3575894750,5
2,1219,45392,3575894745,3575894752,7
2,1219,45393,3575894745,3575894753,8
2,1219,45394,3575894745,3575894755,10
2,1219,45395,3575894745,3575894756,11
2,1219,45396,3575894745,3575894759,14
2,1219,45397,3575894745,3575894759,14
2,1219,45398,3575894745,3575894759,14
2,1219,45399,3575894745,3575894759,14
2,1219,45400,3575894745,3575894760,15
2,1219,45401,3575894745,3575894760,15
2,1219,45402,3575894745,3575894760,15
2,1219,45403,3575894745,3575894761,16
2,1219,45404,3575894745,3575894763,18
2,1219,45405,3575894745,3575894764,19
2,1219,45406,3575894745,3575894765,20
2,1219,45407,3575894745,3575894766,21
2,1219,45408,3575894745,3575894767,22
2,1219,45409,3575894745,3575894767,22
2,1219,45410,3575894745,3575894767,22
2,1219,45411,3575894745,3575894768,23
2,1219,45412,3575894745,3575894769,24
2,1219,45413,3575894745,3575894769,24
2,1219,45414,3575894745,3575894769,24
2,1219,45415,3575894745,3575894770,25
2,1219,45416,3575894745,3575894771,26
2,1219,45417,3575894745,3575894772,27
2,1219,45418,3575894745,3575894773,28
2,1219,45419,3575894745,3575894774,29
2,1219,45420,3575894745,3575894775,30
2,1219,45421,3575894745,3575894775,30
2,1219,45422,3575894745,3575894776,31
2,1219,45423,3575894745,3575894778,33
2,1219,45424,3575894745,3575894781,36
2,1219,45425,3575894745,3575894781,36
2,1219,45426,3575894745,3575894781,36
2,1219,45427,3575894745,3575894781,36
2,1219,45428,3575894745,3575894783,38
2,1219,45429,3575894745,3575894783,38
2,1219,45430,3575894745,3575894784,39
2,1219,45431,3575894745,3575894784,39
2,1219,45432,3575894745,3575894785,40
2,1219,45433,3575894745,3575894787,42
2,1219,45434,3575894745,3575894787,42
2,1219,45435,3575894745,3575894788,43
2,1219,45436,3575894745,3575894788,43
2,1219,45437,3575894745,3575894788,43
2,1219,45438,3575894745,3575894788,43
2,1219,45439,3575894745,3575894790,45
2,1219,45440,3575894745,3575894790,45
2,1219,45441,3575894745,3575894790,45
2,1219,45442,3575894745,3575894791,46
2,1219,45443,3575894745,3575894793,48
2,1219,45444,3575894745,3575894793,48
2,1219,45445,3575894745,3575894794,49
2,1219,45446,3575894745,3575894794,49
2,1219,45447,3575894745,3575894794,49
2,1220,45448,3575894809,3575894809,0
2,1220,45449,3575894809,3575894809,0
2,1220,45450,3575894809,3575894809,0
2,1220,45451,3575894809,3575894809,0
2,1220,45452,3575894809,3575894809,0
2,1220,45453,3575894809,3575894809,0
2,1220,45454,3575894809,3575894809,0
2,1220,45455,3575894809,3575894809,0
2,1220,45456,3575894809,3575894809,0
2,1220,45457,3575894809,3575894809,0
2,1220,45458,3575894809,3575894809,0
2,1220,45459,3575894809,3575894809,0
2,1220,45460,3575894809,3575894809,0
2,1220,45461,3575894809,3575894809,0
2,1220,45462,3575894809,3575894809,0
2,1220,45463,3575894809,3575894811,2
2,1220,45464,3575894809,3575894811,2
2,1220,45465,3575894809,3575894813,4
2,1220,45466,3575894809,3575894815,6
2,1220,45467,3575894809,3575894819,10
2,1220,45468,3575894809,3575894821,12
2,1220,45469,3575894809,3575894822,13
2,1220,45470,3575894809,3575894823,14
2,1220,45471,3575894809,3575894823,14
2,1220,45472,3575894809,3575894826,17
2,1220,45473,3575894809,3575894827,18
2,1220,45474,3575894809,3575894827,18
2,1220,45475,3575894809,3575894828,19
2,1220,45476,3575894809,3575894829,20
2,1220,45477,3575894809,3575894829,20
2,1220,45478,3575894809,3575894829,20
2,1220,45479,3575894809,3575894829,20
2,1220,45480,3575894809,3575894830,21
2,1220,45481,3575894809,3575894831,22
2,1220,45482,3575894809,3575894831,22
2,1220,45483,3575894809,3575894834,25
2,1220,45484,3575894809,3575894835,26
2,1220,45485,3575894809,3575894836,27
2,1220,45486,3575894809,3575894836,27
2,1220,45487,3575894809,3575894836,27
2,1220,45488,3575894809,3575894836,27
2,1220,45489,3575894809,3575894837,28
2,1220,45490,3575894809,3575894839,30
2,1220,45491,3575894809,3575894840,31
2,1220,45492,3575894809,3575894840,31
2,1220,45493,3575894809,3575894840,31
2,1220,45494,3575894809,3575894843,34
2,1220,45495,3575894809,3575894843,34
2,1220,45496,3575894809,3575894845,36
2,1220,45497,3575894809,3575894848,39
2,1220,45498,3575894809,3575894848,39
2,1220,45499,3575894809,3575894850,41
2,1220,45500,3575894809,3575894853,44
2,1220,45501,3575894809,3575894854,45
2,1220,45502,3575894809,3575894855,46
2,1220,45503,3575894809,3575894855,46
2,1220,45504,3575894809,3575894855,46
2,1220,45505,3575894809,3575894855,46
2,1220,45506,3575894809,3575894856,47
2,1220,45507,3575894809,3575894858,49
2,1220,45508,3575894809,3575894859,50
2,1221,45509,3575894874,3575894874,0
2,1221,45510,3575894874,3575894874,0
2,1221,45511,3575894874,3575894874,0
2,1221,45512,3575894874,3575894874,0
2,1221,45513,3575894874,3575894874,0
2,1221,45514,3575894874,3575894874,0
2,1221,45515,3575894874,3575894874,0
2,1221,45516,3575894874,3575894874,0
2,1221,45517,3575894874,3575894876,2
2,1221,45518,3575894874,3575894877,3
2,1221,45519,3575894874,3575894881,7
2,1221,45520,3575894874,3575894883,9
2,1221,45521,3575894874,3575894884,10
2,1221,45522,3575894874,3575894884,10
2,1221,45523,3575894874,3575894884,10
2,1221,45524,3575894874,3575894885,11
2,1221,45525,3575894874,3575894886,12
2,1221,45526,3575894874,3575894887,13
2,1221,45527,3575894874,3575894888,14
2,1221,45528,3575894874,3575894889,15
2,1221,45529,3575894874,3575894889,15
2,1221,45530,3575894874,3575894891,17
2,1221,45531,3575894874,3575894891,17
2,1221,45532,3575894874,3575894892,18
2,1221,45533,3575894874,3575894893,19
2,1221,45534,3575894874,3575894893,19
2,1221,45535,3575894874,3575894894,20
2,1221,45536,3575894874,3575894894,20
2,1221,45537,3575894874,3575894895,21
2,1221,45538,3575894874,3575894895,21
2,1221,45539,3575894874,3575894897,23
2,1221,45540,3575894874,3575894898,24
2,1221,45541,3575894874,3575894898,24
2,1221,45542,3575894874,3575894898,24
2,1221,45543,3575894874,3575894899,25
2,1221,45544,3575894874,3575894900,26
2,1221,45545,3575894874,3575894900,26
2,1221,45546,3575894874,3575894900,26
2,1221,45547,3575894874,3575894902,28
2,1221,45548,3575894874,3575894902,28
2,1221,45549,3575894874,3575894903,29
2,1221,45550,3575894874,3575894903,29
2,1221,45551,3575894874,3575894904,30
2,1221,45552,3575894874,3575894905,31
2,1221,45553,3575894874,3575894905,31
2,1221,45554,3575894874,3575894907,33
2,1221,45555,3575894874,3575894907,33
2,1221,45556,3575894874,3575894907,33
2,1221,45557,3575894874,3575894908,34
2,1221,45558,3575894874,3575894911,37
2,1221,45559,3575894874,3575894911,37
2,1221,45560,3575894874,3575894912,38
2,1221,45561,3575894874,3575894913,39
2,1221,45562,3575894874,3575894913,39
2,1221,45563,3575894874,3575894913,39
2,1221,45564,3575894874,3575894914,40
2,1221,45565,3575894874,3575894914,40
2,1221,45566,3575894874,3575894916,42
2,1221,45567,3575894874,3575894917,43
2,1221,45568,3575894874,3575894918,44
2,1221,45569,3575894874,3575894918,44
2,1221,45570,3575894874,3575894918,44
2,1221,45571,3575894874,3575894921,47
2,1221,45572,3575894874,3575894922,48
2,1221,45573,3575894874,3575894923,49
2,1221,45574,3575894874,3575894924,50
2,1222,45575,3575894937,3575894937,0
2,1222,45576,3575894937,3575894937,0
2,1222,45577,3575894937,3575894937,0
2,1222,45578,3575894937,3575894937,0
2,1222,45579,3575894937,3575894937,0
2,1222,45580,3575894937,3575894937,0
2,1222,45581,3575894937,3575894937,0
2,1222,45582,3575894937,3575894937,0
2,1222,45583,3575894937,3575894937,0
2,1222,45584,3575894937,3575894937,0
2,1222,45585,3575894937,3575894937,0
2,1222,45586,3575894937,3575894937,0
2,1222,45587,3575894937,3575894937,0
2,1222,45588,3575894937,3575894937,0
2,1222,45589,3575894937,3575894937,0
2,1222,45590,3575894937,3575894937,0
2,1222,45591,3575894937,3575894937,0
2,1222,45592,3575894937,3575894937,0
2,1222,45593,3575894937,3575894937,0
2,1222,45594,3575894937,3575894940,3
2,1222,45595,3575894937,3575894940,3
2,1222,45596,3575894937,3575894940,3
2,1222,45597,3575894937,3575894941,4
2,1222,45598,3575894937,3575894942,5
2,1222,45599,3575894937,3575894944,7
2,1222,45600,3575894937,3575894944,7
2,1222,45601,3575894937,3575894945,8
2,1222,45602,3575894937,3575894947,10
2,1222,45603,3575894937,3575894947,10
2,1222,45604,3575894937,3575894947,10
2,1222,45605,3575894937,3575894947,10
2,1222,45606,3575894937,3575894948,11
2,1222,45607,3575894937,3575894949,12
2,1222,45608,3575894937,3575894949,12
2,1222,45609,3575894937,3575894949,12
2,1222,45610,3575894937,3575894950,13
2,1222,45611,3575894937,3575894951,14
2,1222,45612,3575894937,3575894951,14
2,1222,45613,3575894937,3575894951,14
2,1222,45614,3575894937,3575894952,15
2,1222,45615,3575894937,3575894952,15
2,1222,45616,3575894937,3575894954,17
2,1222,45617,3575894937,3575894955,18
2,1222,45618,3575894937,3575894956,19
2,1222,45619,3575894937,3575894959,22
2,1222,45620,3575894937,3575894959,22
2,1222,45621,3575894937,3575894959,22
2,1222,45622,3575894937,3575894959,22
2,1222,45623,3575894937,3575894960,23
2,1222,45624,3575894937,3575894960,23
2,1222,45625,3575894937,3575894960,23
2,1222,45626,3575894937,3575894961,24
2,1222,45627,3575894937,3575894961,24
2,1222,45628,3575894937,3575894964,27
2,1222,45629,3575894937,3575894964,27
2,1222,45630,3575894937,3575894966,29
2,1222,45631,3575894937,3575894966,29
2,1222,45632,3575894937,3575894967,30
2,1222,45633,3575894937,3575894968,31
2,1222,45634,3575894937,3575894968,31
2,1222,45635,3575894937,3575894968,31
2,1222,45636,3575894937,3575894969,32
2,1222,45637,3575894937,3575894970,33
2,1222,45638,3575894937,3575894970,33
2,1222,45639,3575894937,3575894971,34
2,1222,45640,3575894937,3575894971,34
2,1222,45641,3575894937,3575894971,34
2,1222,45642,3575894937,3575894972,35
2,1222,45643,3575894937,3575894974,37
2,1222,45644,3575894937,3575894974,37
2,1222,45645,3575894937,3575894975,38
2,1222,45646,3575894937,3575894975,38
2,1222,45647,3575894937,3575894976,39
2,1222,45648,3575894937,3575894977,40
2,1222,45649,3575894937,3575894978,41
2,1222,45650,3575894937,3575894980,43
2,1222,45651,3575894937,3575894981,44
2,1222,45652,3575894937,3575894981,44
2,1222,45653,3575894937,3575894981,44
2,1222,45654,3575894937,3575894983,46
2,1222,45655,3575894937,3575894984,47
2,1222,45656,3575894937,3575894985,48
2,1222,45657,3575894937,3575894986,49
2,1223,45658,3575895001,3575895001,0
2,1223,45659,3575895001,3575895001,0
2,1223,45660,3575895001,3575895001,0
2,1223,45661,3575895001,3575895001,0
2,1223,45662,3575895001,3575895001,0
2,1223,45663,3575895001,3575895001,0
2,1223,45664,3575895001,3575895001,0
2,1223,45665,3575895001,3575895001,0
2,1223,45666,3575895001,3575895001,0
2,1223,45667,3575895001,3575895001,0
2,1223,45668,3575895001,3575895001,0
2,1223,45669,3575895001,3575895001,0
2,1223,45670,3575895001,3575895001,0
2,1223,45671,3575895001,3575895001,0
2,1223,45672,3575895001,3575895001,0
2,1223,45673,3575895001,3575895001,0
2,1223,45674,3575895001,3575895001,0
2,1223,45675,3575895001,3575895001,0
2,1223,45676,3575895001,3575895001,0
2,1223,45677,3575895001,3575895001,0
2,1223,45678,3575895001,3575895003,2
2,1223,45679,3575895001,3575895003,2
2,1223,45680,3575895001,3575895004,3
2,1223,45681,3575895001,3575895006,5
2,1223,45682,3575895001,3575895006,5
2,1223,45683,3575895001,3575895007,6
2,1223,45684,3575895001,3575895009,8
2,1223,45685,3575895001,3575895011,10
2,1223,45686,3575895001,3575895011,10
2,1223,45687,3575895001,3575895013,12
2,1223,45688,3575895001,3575895015,14
2,1223,45689,3575895001,3575895019,18
2,1223,45690,3575895001,3575895022,21
2,1223,45691,3575895001,3575895023,22
2,1223,45692,3575895001,3575895023,22
2,1223,45693,3575895001,3575895026,25
2,1223,45694,3575895001,3575895026,25
2,1223,45695,3575895001,3575895028,27
2,1223,45696,3575895001,3575895029,28
2,1223,45697,3575895001,3575895029,28
2,1223,45698,3575895001,3575895029,28
2,1223,45699,3575895001,3575895029,28
2,1223,45700,3575895001,3575895030,29
2,1223,45701,3575895001,3575895031,30
2,1223,45702,3575895001,3575895031,30
2,1223,45703,3575895001,3575895031,30
2,1223,45704,3575895001,3575895034,33
2,1223,45705,3575895001,3575895035,34
2,1223,45706,3575895001,3575895036,35
2,1223,45707,3575895001,3575895036,35
2,1223,45708,3575895001,3575895037,36
2,1223,45709,3575895001,3575895039,38
2,1223,45710,3575895001,3575895040,39
2,1223,45711,3575895001,3575895040,39
2,1223,45712,3575895001,3575895041,40
2,1223,45713,3575895001,3575895042,41
2,1223,45714,3575895001,3575895043,42
2,1223,45715,3575895001,3575895043,42
2,1223,45716,3575895001,3575895044,43
2,1223,45717,3575895001,3575895045,44
2,1223,45718,3575895001,3575895048,47
2,1223,45719,3575895001,3575895050,49
2,1223,45720,3575895001,3575895050,49
2,1224,45721,3575895066,3575895066,0
2,1224,45722,3575895066,3575895066,0
2,1224,45723,3575895066,3575895066,0
2,1224,45724,3575895066,3575895066,0
2,1224,45725,3575895066,3575895066,0
2,1224,45726,3575895066,3575895066,0
2,1224,45727,3575895066,3575895066,0
2,1224,45728,3575895066,3575895066,0
2,1224,45729,3575895066,3575895067,1
2,1224,45730,3575895066,3575895067,1
2,1224,45731,3575895066,3575895067,1
2,1224,45732,3575895066,3575895067,1
2,1224,45733,3575895066,3575895067,1
2,1224,45734,3575895066,3575895067,1
2,1224,45735,3575895066,3575895067,1
2,1224,45736,3575895066,3575895067,1
2,1224,45737,3575895066,3575895067,1
2,1224,45738,3575895066,3575895067,1
2,1224,45739,3575895066,3575895070,4
2,1224,45740,3575895066,3575895070,4
2,1224,45741,3575895066,3575895077,11
2,1224,45742,3575895066,3575895077,11
2,1224,45743,3575895066,3575895081,15
2,1224,45744,3575895066,3575895083,17
2,1224,45745,3575895066,3575895084,18
2,1224,45746,3575895066,3575895084,18
2,1224,45747,3575895066,3575895085,19
2,1224,45748,3575895066,3575895085,19
2,1224,45749,3575895066,3575895086,20
2,1224,45750,3575895066,3575895088,22
2,1224,45751,3575895066,3575895088,22
2,1224,45752,3575895066,3575895088,22
2,1224,45753,3575895066,3575895089,23
2,1224,45754,3575895066,3575895090,24
2,1224,45755,3575895066,3575895091,25
2,1224,45756,3575895066,3575895092,26
2,1224,45757,3575895066,3575895093,27
2,1224,45758,3575895066,3575895094,28
2,1224,45759,3575895066,3575895094,28
2,1224,45760,3575895066,3575895095,29
2,1224,45761,3575895066,3575895095,29
2,1224,45762,3575895066,3575895095,29
2,1224,45763,3575895066,3575895096,30
2,1224,45764,3575895066,3575895098,32
2,1224,45765,3575895066,3575895098,32
2,1224,45766,3575895066,3575895098,32
2,1224,45767,3575895066,3575895099,33
2,1224,45768,3575895066,3575895100,34
2,1224,45769,3575895066,3575895100,34
2,1224,45770,3575895066,3575895101,35
2,1224,45771,3575895066,3575895103,37
2,1224,45772,3575895066,3575895103,37
2,1224,45773,3575895066,3575895103,37
2,1224,45774,3575895066,3575895104,38
2,1224,45775,3575895066,3575895105,39
2,1224,45776,3575895066,3575895106,40
2,1224,45777,3575895066,3575895110,44
2,1224,45778,3575895066,3575895110,44
2,1224,45779,3575895066,3575895110,44
2,1224,45780,3575895066,3575895110,44
2,1224,45781,3575895066,3575895110,44
2,1224,45782,3575895066,3575895110,44
2,1224,45783,3575895066,3575895110,44
2,1224,45784,3575895066,3575895112,46
2,1224,45785,3575895066,3575895112,46
2,1224,45786,3575895066,3575895112,46
2,1224,45787,3575895066,3575895113,47
2,1224,45788,3575895066,3575895113,47
2,1224,45789,3575895066,3575895113,47
2,1224,45790,3575895066,3575895114,48
2,1224,45791,3575895066,3575895114,48
2,1224,45792,3575895066,3575895115,49
2,1224,45793,3575895066,3575895115,49
2,1225,45794,3575895132,3575895132,0
2,1225,45795,3575895132,3575895132,0
2,1225,45796,3575895132,3575895132,0
2,1225,45797,3575895132,3575895132,0
2,1225,45798,3575895132,3575895132,0
2,1225,45799,3575895132,3575895132,0
2,1225,45800,3575895132,3575895132,0
2,1225,45801,3575895132,3575895132,0
2,1225,45802,3575895132,3575895132,0
2,1225,45803,3575895132,3575895132,0
2,1225,45804,3575895132,3575895132,0
2,1225,45805,3575895132,3575895132,0
2,1225,45806,3575895132,3575895132,0
2,1225,45807,3575895132,3575895132,0
2,1225,45808,3575895132,3575895132,0
2,1225,45809,3575895132,3575895132,0
2,1225,45810,3575895132,3575895132,0
2,1225,45811,3575895132,3575895132,0
2,1225,45812,3575895132,3575895132,0
2,1225,45813,3575895132,3575895133,1
2,1225,45814,3575895132,3575895134,2
2,1225,45815,3575895132,3575895134,2
2,1225,45816,3575895132,3575895134,2
2,1225,45817,3575895132,3575895134,2
2,1225,45818,3575895132,3575895135,3
2,1225,45819,3575895132,3575895136,4
2,1225,45820,3575895132,3575895136,4
2,1225,45821,3575895132,3575895136,4
2,1225,45822,3575895132,3575895140,8
2,1225,45823,3575895132,3575895140,8
2,1225,45824,3575895132,3575895140,8
2,1225,45825,3575895132,3575895142,10
2,1225,45826,3575895132,3575895142,10
2,1225,45827,3575895132,3575895144,12
2,1225,45828,3575895132,3575895144,12
2,1225,45829,3575895132,3575895145,13
2,1225,45830,3575895132,3575895145,13
2,1225,45831,3575895132,3575895146,14
2,1225,45832,3575895132,3575895147,15
2,1225,45833,3575895132,3575895148,16
2,1225,45834,3575895132,3575895148,16
2,1225,45835,3575895132,3575895148,16
2,1225,45836,3575895132,3575895149,17
2,1225,45837,3575895132,3575895149,17
2,1225,45838,3575895132,3575895149,17
2,1225,45839,3575895132,3575895150,18
2,1225,45840,3575895132,3575895151,19
2,1225,45841,3575895132,3575895151,19
2,1225,45842,3575895132,3575895151,19
2,1225,45843,3575895132,3575895152,20
2,1225,45844,3575895132,3575895152,20
2,1225,45845,3575895132,3575895154,22
2,1225,45846,3575895132,3575895154,22
2,1225,45847,3575895132,3575895155,23
2,1225,45848,3575895132,3575895157,25
2,1225,45849,3575895132,3575895159,27
2,1225,45850,3575895132,3575895159,27
2,1225,45851,3575895132,3575895159,27
2,1225,45852,3575895132,3575895160,28
2,1225,45853,3575895132,3575895160,28
2,1225,45854,3575895132,3575895161,29
2,1225,45855,3575895132,3575895161,29
2,1225,45856,3575895132,3575895162,30
2,1225,45857,3575895132,3575895164,32
2,1225,45858,3575895132,3575895165,33
2,1225,45859,3575895132,3575895166,34
2,1225,45860,3575895132,3575895166,34
2,1225,45861,3575895132,3575895167,35
2,1225,45862,3575895132,3575895167,35
2,1225,45863,3575895132,3575895168,36
2,1225,45864,3575895132,3575895169,37
2,1225,45865,3575895132,3575895169,37
2,1225,45866,3575895132,3575895170,38
2,1225,45867,3575895132,3575895170,38
2,1225,45868,3575895132,3575895171,39
2,1225,45869,3575895132,3575895171,39
2,1225,45870,3575895132,3575895173,41
2,1225,45871,3575895132,3575895173,41
2,1225,45872,3575895132,3575895174,42
2,1225,45873,3575895132,3575895175,43
2,1225,45874,3575895132,3575895176,44
2,1225,45875,3575895132,3575895176,44
2,1225,45876,3575895132,3575895176,44
2,1225,45877,3575895132,3575895178,46
2,1225,45878,3575895132,3575895178,46
2,1225,45879,3575895132,3575895178,46
2,1225,45880,3575895132,3575895181,49
2,1225,45881,3575895132,3575895181,49
2,1225,45882,3575895132,3575895182,50
2,1226,45883,3575895195,3575895195,0
2,1226,45884,3575895195,3575895195,0
2,1226,45885,3575895195,3575895195,0
2,1226,45886,3575895195,3575895195,0
2,1226,45887,3575895195,3575895195,0
2,1226,45888,3575895195,3575895195,0
2,1226,45889,3575895195,3575895195,0
2,1226,45890,3575895195,3575895195,0
2,1226,45891,3575895195,3575895195,0
2,1226,45892,3575895195,3575895195,0
2,1226,45893,3575895195,3575895195,0
2,1226,45894,3575895195,3575895195,0
2,1226,45895,3575895195,3575895195,0
2,1226,45896,3575895195,3575895195,0
2,1226,45897,3575895195,3575895195,0
2,1226,45898,3575895195,3575895195,0
2,1226,45899,3575895195,3575895195,0
2,1226,45900,3575895195,3575895195,0
2,1226,45901,3575895195,3575895196,1
2,1226,45902,3575895195,3575895196,1
2,1226,45903,3575895195,3575895196,1
2,1226,45904,3575895195,3575895197,2
2,1226,45905,3575895195,3575895198,3
2,1226,45906,3575895195,3575895200,5
2,1226,45907,3575895195,3575895200,5
2,1226,45908,3575895195,3575895200,5
2,1226,45909,3575895195,3575895202,7
2,1226,45910,3575895195,3575895203,8
2,1226,45911,3575895195,3575895203,8
2,1226,45912,3575895195,3575895203,8
2,1226,45913,3575895195,3575895205,10
2,1226,45914,3575895195,3575895206,11
2,1226,45915,3575895195,3575895206,11
2,1226,45916,3575895195,3575895209,14
2,1226,45917,3575895195,3575895213,18
2,1226,45918,3575895195,3575895213,18
2,1226,45919,3575895195,3575895215,20
2,1226,45920,3575895195,3575895221,26
2,1226,45921,3575895195,3575895222,27
2,1226,45922,3575895195,3575895224,29
2,1226,45923,3575895195,3575895224,29
2,1226,45924,3575895195,3575895227,32
2,1226,45925,3575895195,3575895227,32
2,1226,45926,3575895195,3575895228,33
2,1226,45927,3575895195,3575895228,33
2,1226,45928,3575895195,3575895229,34
2,1226,45929,3575895195,3575895229,34
2,1226,45930,3575895195,3575895229,34
2,1226,45931,3575895195,3575895230,35
2,1226,45932,3575895195,3575895231,36
2,1226,45933,3575895195,3575895232,37
2,1226,45934,3575895195,3575895235,40
2,1226,45935,3575895195,3575895235,40
2,1226,45936,3575895195,3575895236,41
2,1226,45937,3575895195,3575895238,43
2,1226,45938,3575895195,3575895238,43
2,1226,45939,3575895195,3575895238,43
2,1226,45940,3575895195,3575895240,45
2,1226,45941,3575895195,3575895240,45
2,1226,45942,3575895195,3575895240,45
2,1226,45943,3575895195,3575895242,47
2,1226,45944,3575895195,3575895243,48
2,1226,45945,3575895195,3575895243,48
2,1226,45946,3575895195,3575895244,49
2,1226,45947,3575895195,3575895244,49
2,1226,45948,3575895195,3575895245,50
2,1227,45949,3575895258,3575895258,0
2,1227,45950,3575895258,3575895258,0
2,1227,45951,3575895258,3575895258,0
2,1227,45952,3575895258,3575895258,0
2,1227,45953,3575895258,3575895258,0
2,1227,45954,3575895258,3575895258,0
2,1227,45955,3575895258,3575895258,0
2,1227,45956,3575895258,3575895258,0
2,1227,45957,3575895258,3575895258,0
2,1227,45958,3575895258,3575895258,0
2,1227,45959,3575895258,3575895258,0
2,1227,45960,3575895258,3575895258,0
2,1227,45961,3575895258,3575895259,1
2,1227,45962,3575895258,3575895259,1
2,1227,45963,3575895258,3575895260,2
2,1227,45964,3575895258,3575895260,2
2,1227,45965,3575895258,3575895262,4
2,1227,45966,3575895258,3575895264,6
2,1227,45967,3575895258,3575895264,6
2,1227,45968,3575895258,3575895266,8
2,1227,45969,3575895258,3575895270,12
2,1227,45970,3575895258,3575895271,13
2,1227,45971,3575895258,3575895277,19
2,1227,45972,3575895258,3575895278,20
2,1227,45973,3575895258,3575895281,23
2,1227,45974,3575895258,3575895283,25
2,1227,45975,3575895258,3575895284,26
2,1227,45976,3575895258,3575895284,26
2,1227,45977,3575895258,3575895285,27
2,1227,45978,3575895258,3575895285,27
2,1227,45979,3575895258,3575895286,28
2,1227,45980,3575895258,3575895288,30
2,1227,45981,3575895258,3575895288,30
2,1227,45982,3575895258,3575895289,31
2,1227,45983,3575895258,3575895290,32
2,1227,45984,3575895258,3575895291,33
2,1227,45985,3575895258,3575895291,33
2,1227,45986,3575895258,3575895291,33
2,1227,45987,3575895258,3575895293,35
2,1227,45988,3575895258,3575895294,36
2,1227,45989,3575895258,3575895294,36
2,1227,45990,3575895258,3575895294,36
2,1227,45991,3575895258,3575895295,37
2,1227,45992,3575895258,3575895295,37
2,1227,45993,3575895258,3575895299,41
2,1227,45994,3575895258,3575895299,41
2,1227,45995,3575895258,3575895299,41
2,1227,45996,3575895258,3575895299,41
2,1227,45997,3575895258,3575895300,42
2,1227,45998,3575895258,3575895301,43
2,1227,45999,3575895258,3575895302,44
2,1227,46000,3575895258,3575895302,44
2,1227,46001,3575895258,3575895302,44
2,1227,46002,3575895258,3575895303,45
2,1227,46003,3575895258,3575895303,45
2,1227,46004,3575895258,3575895306,48
2,1227,46005,3575895258,3575895307,49
2,1227,46006,3575895258,3575895307,49
2,1227,46007,3575895258,3575895308,50
2,1228,46008,3575895327,3575895327,0
2,1228,46009,3575895327,3575895327,0
2,1228,46010,3575895327,3575895327,0
2,1228,46011,3575895327,3575895327,0
2,1228,46012,3575895327,3575895327,0
2,1228,46013,3575895327,3575895327,0
2,1228,46014,3575895327,3575895327,0
2,1228,46015,3575895327,3575895327,0
2,1228,46016,3575895327,3575895327,0
2,1228,46017,3575895327,3575895327,0
2,1228,46018,3575895327,3575895327,0
2,1228,46019,3575895327,3575895327,0
2,1228,46020,3575895327,3575895327,0
2,1228,46021,3575895327,3575895327,0
2,1228,46022,3575895327,3575895327,0
2,1228,46023,3575895327,3575895327,0
2,1228,46024,3575895327,3575895327,0
2,1228,46025,3575895327,3575895327,0
2,1228,46026,3575895327,3575895327,0
2,1228,46027,3575895327,3575895327,0
2,1228,46028,3575895327,3575895327,0
2,1228,46029,3575895327,3575895327,0
2,1228,46030,3575895327,3575895327,0
2,1228,46031,3575895327,3575895328,1
2,1228,46032,3575895327,3575895328,1
2,1228,46033,3575895327,3575895329,2
2,1228,46034,3575895327,3575895330,3
2,1228,46035,3575895327,3575895331,4
2,1228,46036,3575895327,3575895332,5
2,1228,46037,3575895327,3575895332,5
2,1228,46038,3575895327,3575895333,6
2,1228,46039,3575895327,3575895333,6
2,1228,46040,3575895327,3575895334,7
2,1228,46041,3575895327,3575895334,7
2,1228,46042,3575895327,3575895334,7
2,1228,46043,3575895327,3575895335,8
2,1228,46044,3575895327,3575895336,9
2,1228,46045,3575895327,3575895336,9
2,1228,46046,3575895327,3575895337,10
2,1228,46047,3575895327,3575895340,13
2,1228,46048,3575895327,3575895340,13
2,1228,46049,3575895327,3575895340,13
2,1228,46050,3575895327,3575895342,15
2,1228,46051,3575895327,3575895342,15
2,1228,46052,3575895327,3575895344,17
2,1228,46053,3575895327,3575895344,17
2,1228,46054,3575895327,3575895345,18
2,1228,46055,3575895327,3575895347,20
2,1228,46056,3575895327,3575895347,20
2,1228,46057,3575895327,3575895348,21
2,1228,46058,3575895327,3575895348,21
2,1228,46059,3575895327,3575895349,22
2,1228,46060,3575895327,3575895349,22
2,1228,46061,3575895327,3575895350,23
2,1228,46062,3575895327,3575895352,25
2,1228,46063,3575895327,3575895352,25
2,1228,46064,3575895327,3575895352,25
2,1228,46065,3575895327,3575895352,25
2,1228,46066,3575895327,3575895354,27
2,1228,46067,3575895327,3575895354,27
2,1228,46068,3575895327,3575895355,28
2,1228,46069,3575895327,3575895356,29
2,1228,46070,3575895327,3575895358,31
2,1228,46071,3575895327,3575895359,32
2,1228,46072,3575895327,3575895360,33
2,1228,46073,3575895327,3575895360,33
2,1228,46074,3575895327,3575895361,34
2,1228,46075,3575895327,3575895361,34
2,1228,46076,3575895327,3575895361,34
2,1228,46077,3575895327,3575895361,34
2,1228,46078,3575895327,3575895362,35
2,1228,46079,3575895327,3575895365,38
2,1228,46080,3575895327,3575895365,38
2,1228,46081,3575895327,3575895366,39
2,1228,46082,3575895327,3575895367,40
2,1228,46083,3575895327,3575895367,40
2,1228,46084,3575895327,3575895367,40
2,1228,46085,3575895327,3575895368,41
2,1228,46086,3575895327,3575895368,41
2,1228,46087,3575895327,3575895369,42
2,1228,46088,3575895327,3575895369,42
2,1228,46089,3575895327,3575895370,43
2,1228,46090,3575895327,3575895371,44
2,1228,46091,3575895327,3575895371,44
2,1228,46092,3575895327,3575895373,46
2,1228,46093,3575895327,3575895375,48
2,1228,46094,3575895327,3575895375,48
2,1228,46095,3575895327,3575895376,49
2,1228,46096,3575895327,3575895376,49
2,1228,46097,3575895327,3575895376,49
2,1229,46098,3575895390,3575895390,0
2,1229,46099,3575895390,3575895390,0
2,1229,46100,3575895390,3575895390,0
2,1229,46101,3575895390,3575895390,0
2,1229,46102,3575895390,3575895390,0
2,1229,46103,3575895390,3575895390,0
2,1229,46104,3575895390,3575895390,0
2,1229,46105,3575895390,3575895390,0
2,1229,46106,3575895390,3575895390,0
2,1229,46107,3575895390,3575895390,0
2,1229,46108,3575895390,3575895390,0
2,1229,46109,3575895390,3575895390,0
2,1229,46110,3575895390,3575895390,0
2,1229,46111,3575895390,3575895390,0
2,1229,46112,3575895390,3575895390,0
2,1229,46113,3575895390,3575895390,0
2,1229,46114,3575895390,3575895390,0
2,1229,46115,3575895390,3575895391,1
2,1229,46116,3575895390,3575895393,3
2,1229,46117,3575895390,3575895394,4
2,1229,46118,3575895390,3575895395,5
2,1229,46119,3575895390,3575895396,6
2,1229,46120,3575895390,3575895396,6
2,1229,46121,3575895390,3575895398,8
2,1229,46122,3575895390,3575895400,10
2,1229,46123,3575895390,3575895400,10
2,1229,46124,3575895390,3575895401,11
2,1229,46125,3575895390,3575895401,11
2,1229,46126,3575895390,3575895403,13
2,1229,46127,3575895390,3575895403,13
2,1229,46128,3575895390,3575895404,14
2,1229,46129,3575895390,3575895406,16
2,1229,46130,3575895390,3575895407,17
2,1229,46131,3575895390,3575895408,18
2,1229,46132,3575895390,3575895409,19
2,1229,46133,3575895390,3575895410,20
2,1229,46134,3575895390,3575895411,21
2,1229,46135,3575895390,3575895415,25
2,1229,46136,3575895390,3575895419,29
2,1229,46137,3575895390,3575895422,32
2,1229,46138,3575895390,3575895423,33
2,1229,46139,3575895390,3575895427,37
2,1229,46140,3575895390,3575895428,38
2,1229,46141,3575895390,3575895429,39
2,1229,46142,3575895390,3575895429,39
2,1229,46143,3575895390,3575895429,39
2,1229,46144,3575895390,3575895430,40
2,1229,46145,3575895390,3575895430,40
2,1229,46146,3575895390,3575895431,41
2,1229,46147,3575895390,3575895431,41
2,1229,46148,3575895390,3575895432,42
2,1229,46149,3575895390,3575895435,45
2,1229,46150,3575895390,3575895436,46
2,1229,46151,3575895390,3575895437,47
2,1229,46152,3575895390,3575895438,48
2,1229,46153,3575895390,3575895438,48
2,1229,46154,3575895390,3575895439,49
2,1229,46155,3575895390,3575895440,50
2,1230,46156,3575895457,3575895457,0
2,1230,46157,3575895457,3575895457,0
2,1230,46158,3575895457,3575895457,0
2,1230,46159,3575895457,3575895457,0
2,1230,46160,3575895457,3575895457,0
2,1230,46161,3575895457,3575895457,0
2,1230,46162,3575895457,3575895457,0
2,1230,46163,3575895457,3575895457,0
2,1230,46164,3575895457,3575895457,0
2,1230,46165,3575895457,3575895457,0
2,1230,46166,3575895457,3575895457,0
2,1230,46167,3575895457,3575895457,0
2,1230,46168,3575895457,3575895457,0
2,1230,46169,3575895457,3575895457,0
2,1230,46170,3575895457,3575895457,0
2,1230,46171,3575895457,3575895457,0
2,1230,46172,3575895457,3575895457,0
2,1230,46173,3575895457,3575895459,2
2,1230,46174,3575895457,3575895459,2
2,1230,46175,3575895457,3575895460,3
2,1230,46176,3575895457,3575895461,4
2,1230,46177,3575895457,3575895462,5
2,1230,46178,3575895457,3575895463,6
2,1230,46179,3575895457,3575895465,8
2,1230,46180,3575895457,3575895467,10
2,1230,46181,3575895457,3575895467,10
2,1230,46182,3575895457,3575895467,10
2,1230,46183,3575895457,3575895470,13
2,1230,46184,3575895457,3575895470,13
2,1230,46185,3575895457,3575895476,19
2,1230,46186,3575895457,3575895482,25
2,1230,46187,3575895457,3575895484,27
2,1230,46188,3575895457,3575895484,27
2,1230,46189,3575895457,3575895485,28
2,1230,46190,3575895457,3575895485,28
2,1230,46191,3575895457,3575895486,29
2,1230,46192,3575895457,3575895487,30
2,1230,46193,3575895457,3575895488,31
2,1230,46194,3575895457,3575895489,32
2,1230,46195,3575895457,3575895490,33
2,1230,46196,3575895457,3575895491,34
2,1230,46197,3575895457,3575895491,34
2,1230,46198,3575895457,3575895491,34
2,1230,46199,3575895457,3575895492,35
2,1230,46200,3575895457,3575895493,36
2,1230,46201,3575895457,3575895494,37
2,1230,46202,3575895457,3575895494,37
2,1230,46203,3575895457,3575895495,38
2,1230,46204,3575895457,3575895495,38
2,1230,46205,3575895457,3575895495,38
2,1230,46206,3575895457,3575895496,39
2,1230,46207,3575895457,3575895498,41
2,1230,46208,3575895457,3575895498,41
2,1230,46209,3575895457,3575895499,42
2,1230,46210,3575895457,3575895499,42
2,1230,46211,3575895457,3575895500,43
2,1230,46212,3575895457,3575895500,43
2,1230,46213,3575895457,3575895502,45
2,1230,46214,3575895457,3575895502,45
2,1230,46215,3575895457,3575895502,45
2,1230,46216,3575895457,3575895503,46
2,1230,46217,3575895457,3575895503,46
2,1230,46218,3575895457,3575895506,49
2,1231,46219,3575895520,3575895520,0
2,1231,46220,3575895520,3575895520,0
2,1231,46221,3575895520,3575895520,0
2,1231,46222,3575895520,3575895520,0
2,1231,46223,3575895520,3575895520,0
2,1231,46224,3575895520,3575895520,0
2,1231,46225,3575895520,3575895520,0
2,1231,46226,3575895520,3575895520,0
2,1231,46227,3575895520,3575895520,0
2,1231,46228,3575895520,3575895520,0
2,1231,46229,3575895520,3575895520,0
2,1231,46230,3575895520,3575895520,0
2,1231,46231,3575895520,3575895520,0
2,1231,46232,3575895520,3575895520,0
2,1231,46233,3575895520,3575895520,0
2,1231,46234,3575895520,3575895520,0
2,1231,46235,3575895520,3575895520,0
2,1231,46236,3575895520,3575895520,0
2,1231,46237,3575895520,3575895520,0
2,1231,46238,3575895520,3575895520,0
2,1231,46239,3575895520,3575895520,0
2,1231,46240,3575895520,3575895520,0
2,1231,46241,3575895520,3575895520,0
2,1231,46242,3575895520,3575895520,0
2,1231,46243,3575895520,3575895520,0
2,1231,46244,3575895520,3575895521,1
2,1231,46245,3575895520,3575895522,2
2,1231,46246,3575895520,3575895523,3
2,1231,46247,3575895520,3575895525,5
2,1231,46248,3575895520,3575895525,5
2,1231,46249,3575895520,3575895525,5
2,1231,46250,3575895520,3575895526,6
2,1231,46251,3575895520,3575895527,7
2,1231,46252,3575895520,3575895528,8
2,1231,46253,3575895520,3575895531,11
2,1231,46254,3575895520,3575895531,11
2,1231,46255,3575895520,3575895531,11
2,1231,46256,3575895520,3575895531,11
2,1231,46257,3575895520,3575895532,12
2,1231,46258,3575895520,3575895532,12
2,1231,46259,3575895520,3575895533,13
2,1231,46260,3575895520,3575895533,13
2,1231,46261,3575895520,3575895533,13
2,1231,46262,3575895520,3575895534,14
2,1231,46263,3575895520,3575895535,15
2,1231,46264,3575895520,3575895537,17
2,1231,46265,3575895520,3575895539,19
2,1231,46266,3575895520,3575895540,20
2,1231,46267,3575895520,3575895541,21
2,1231,46268,3575895520,3575895541,21
2,1231,46269,3575895520,3575895543,23
2,1231,46270,3575895520,3575895544,24
2,1231,46271,3575895520,3575895546,26
2,1231,46272,3575895520,3575895546,26
2,1231,46273,3575895520,3575895547,27
2,1231,46274,3575895520,3575895547,27
2,1231,46275,3575895520,3575895548,28
2,1231,46276,3575895520,3575895548,28
2,1231,46277,3575895520,3575895549,29
2,1231,46278,3575895520,3575895549,29
2,1231,46279,3575895520,3575895550,30
2,1231,46280,3575895520,3575895550,30
2,1231,46281,3575895520,3575895551,31
2,1231,46282,3575895520,3575895553,33
2,1231,46283,3575895520,3575895553,33
2,1231,46284,3575895520,3575895555,35
2,1231,46285,3575895520,3575895556,36
2,1231,46286,3575895520,3575895558,38
2,1231,46287,3575895520,3575895558,38
2,1231,46288,3575895520,3575895559,39
2,1231,46289,3575895520,3575895559,39
2,1231,46290,3575895520,3575895560,40
2,1231,46291,3575895520,3575895561,41
2,1231,46292,3575895520,3575895561,41
2,1231,46293,3575895520,3575895561,41
2,1231,46294,3575895520,3575895564,44
2,1231,46295,3575895520,3575895565,45
2,1231,46296,3575895520,3575895565,45
2,1231,46297,3575895520,3575895566,46
2,1231,46298,3575895520,3575895566,46
2,1231,46299,3575895520,3575895567,47
2,1231,46300,3575895520,3575895567,47
2,1231,46301,3575895520,3575895567,47
2,1231,46302,3575895520,3575895568,48
2,1231,46303,3575895520,3575895569,49
2,1231,46304,3575895520,3575895570,50
2,1232,46305,3575895584,3575895584,0
2,1232,46306,3575895584,3575895584,0
2,1232,46307,3575895584,3575895584,0
2,1232,46308,3575895584,3575895584,0
2,1232,46309,3575895584,3575895584,0
2,1232,46310,3575895584,3575895584,0
2,1232,46311,3575895584,3575895584,0
2,1232,46312,3575895584,3575895584,0
2,1232,46313,3575895584,3575895584,0
2,1232,46314,3575895584,3575895584,0
2,1232,46315,3575895584,3575895584,0
2,1232,46316,3575895584,3575895584,0
2,1232,46317,3575895584,3575895584,0
2,1232,46318,3575895584,3575895584,0
2,1232,46319,3575895584,3575895584,0
2,1232,46320,3575895584,3575895585,1
2,1232,46321,3575895584,3575895585,1
2,1232,46322,3575895584,3575895585,1
2,1232,46323,3575895584,3575895585,1
2,1232,46324,3575895584,3575895585,1
2,1232,46325,3575895584,3575895588,4
2,1232,46326,3575895584,3575895588,4
2,1232,46327,3575895584,3575895588,4
2,1232,46328,3575895584,3575895588,4
2,1232,46329,3575895584,3575895588,4
2,1232,46330,3575895584,3575895589,5
2,1232,46331,3575895584,3575895589,5
2,1232,46332,3575895584,3575895590,6
2,1232,46333,3575895584,3575895591,7
2,1232,46334,3575895584,3575895592,8
2,1232,46335,3575895584,3575895592,8
2,1232,46336,3575895584,3575895593,9
2,1232,46337,3575895584,3575895593,9
2,1232,46338,3575895584,3575895594,10
2,1232,46339,3575895584,3575895594,10
2,1232,46340,3575895584,3575895595,11
2,1232,46341,3575895584,3575895595,11
2,1232,46342,3575895584,3575895596,12
2,1232,46343,3575895584,3575895597,13
2,1232,46344,3575895584,3575895597,13
2,1232,46345,3575895584,3575895599,15
2,1232,46346,3575895584,3575895600,16
2,1232,46347,3575895584,3575895601,17
2,1232,46348,3575895584,3575895602,18
2,1232,46349,3575895584,3575895602,18
2,1232,46350,3575895584,3575895603,19
2,1232,46351,3575895584,3575895603,19
2,1232,46352,3575895584,3575895604,20
2,1232,46353,3575895584,3575895605,21
2,1232,46354,3575895584,3575895606,22
2,1232,46355,3575895584,3575895607,23
2,1232,46356,3575895584,3575895608,24
2,1232,46357,3575895584,3575895610,26
2,1232,46358,3575895584,3575895611,27
2,1232,46359,3575895584,3575895612,28
2,1232,46360,3575895584,3575895614,30
2,1232,46361,3575895584,3575895618,34
2,1232,46362,3575895584,3575895621,37
2,1232,46363,3575895584,3575895621,37
2,1232,46364,3575895584,3575895623,39
2,1232,46365,3575895584,3575895623,39
2,1232,46366,3575895584,3575895625,41
2,1232,46367,3575895584,3575895626,42
2,1232,46368,3575895584,3575895627,43
2,1232,46369,3575895584,3575895627,43
2,1232,46370,3575895584,3575895628,44
2,1232,46371,3575895584,3575895628,44
2,1232,46372,3575895584,3575895628,44
2,1232,46373,3575895584,3575895629,45
2,1232,46374,3575895584,3575895629,45
2,1232,46375,3575895584,3575895630,46
2,1232,46376,3575895584,3575895630,46
2,1232,46377,3575895584,3575895631,47
2,1232,46378,3575895584,3575895631,47
2,1233,46379,3575895650,3575895650,0
2,1233,46380,3575895650,3575895650,0
2,1233,46381,3575895650,3575895650,0
2,1233,46382,3575895650,3575895650,0
2,1233,46383,3575895650,3575895650,0
2,1233,46384,3575895650,3575895650,0
2,1233,46385,3575895650,3575895650,0
2,1233,46386,3575895650,3575895650,0
2,1233,46387,3575895650,3575895650,0
2,1233,46388,3575895650,3575895650,0
2,1233,46389,3575895650,3575895650,0
2,1233,46390,3575895650,3575895650,0
2,1233,46391,3575895650,3575895650,0
2,1233,46392,3575895650,3575895650,0
2,1233,46393,3575895650,3575895650,0
2,1233,46394,3575895650,3575895650,0
2,1233,46395,3575895650,3575895650,0
2,1233,46396,3575895650,3575895650,0
2,1233,46397,3575895650,3575895653,3
2,1233,46398,3575895650,3575895654,4
2,1233,46399,3575895650,3575895654,4
2,1233,46400,3575895650,3575895654,4
2,1233,46401,3575895650,3575895655,5
2,1233,46402,3575895650,3575895655,5
2,1233,46403,3575895650,3575895656,6
2,1233,46404,3575895650,3575895659,9
2,1233,46405,3575895650,3575895660,10
2,1233,46406,3575895650,3575895660,10
2,1233,46407,3575895650,3575895661,11
2,1233,46408,3575895650,3575895663,13
2,1233,46409,3575895650,3575895664,14
2,1233,46410,3575895650,3575895665,15
2,1233,46411,3575895650,3575895666,16
2,1233,46412,3575895650,3575895670,20
2,1233,46413,3575895650,3575895670,20
2,1233,46414,3575895650,3575895677,27
2,1233,46415,3575895650,3575895677,27
2,1233,46416,3575895650,3575895681,31
2,1233,46417,3575895650,3575895683,33
2,1233,46418,3575895650,3575895684,34
2,1233,46419,3575895650,3575895685,35
2,1233,46420,3575895650,3575895685,35
2,1233,46421,3575895650,3575895685,35
2,1233,46422,3575895650,3575895686,36
2,1233,46423,3575895650,3575895688,38
2,1233,46424,3575895650,3575895688,38
2,1233,46425,3575895650,3575895689,39
2,1233,46426,3575895650,3575895690,40
2,1233,46427,3575895650,3575895691,41
2,1233,46428,3575895650,3575895691,41
2,1233,46429,3575895650,3575895691,41
2,1233,46430,3575895650,3575895692,42
2,1233,46431,3575895650,3575895692,42
2,1233,46432,3575895650,3575895693,43
2,1233,46433,3575895650,3575895694,44
2,1233,46434,3575895650,3575895695,45
2,1233,46435,3575895650,3575895696,46
2,1233,46436,3575895650,3575895696,46
2,1233,46437,3575895650,3575895697,47
2,1233,46438,3575895650,3575895699,49
2,1233,46439,3575895650,3575895699,49
2,1233,46440,3575895650,3575895699,49
2,1233,46441,3575895650,3575895700,50
2,1234,46442,3575895713,3575895713,0
2,1234,46443,3575895713,3575895713,0
2,1234,46444,3575895713,3575895713,0
2,1234,46445,3575895713,3575895713,0
2,1234,46446,3575895713,3575895713,0
2,1234,46447,3575895713,3575895713,0
2,1234,46448,3575895713,3575895713,0
2,1234,46449,3575895713,3575895713,0
2,1234,46450,3575895713,3575895713,0
2,1234,46451,3575895713,3575895713,0
2,1234,46452,3575895713,3575895713,0
2,1234,46453,3575895713,3575895713,0
2,1234,46454,3575895713,3575895713,0
2,1234,46455,3575895713,3575895713,0
2,1234,46456,3575895713,3575895713,0
2,1234,46457,3575895713,3575895713,0
2,1234,46458,3575895713,3575895713,0
2,1234,46459,3575895713,3575895713,0
2,1234,46460,3575895713,3575895713,0
2,1234,46461,3575895713,3575895713,0
2,1234,46462,3575895713,3575895713,0
2,1234,46463,3575895713,3575895713,0
2,1234,46464,3575895713,3575895713,0
2,1234,46465,3575895713,3575895713,0
2,1234,46466,3575895713,3575895714,1
2,1234,46467,3575895713,3575895714,1
2,1234,46468,3575895713,3575895714,1
2,1234,46469,3575895713,3575895714,1
2,1234,46470,3575895713,3575895715,2
2,1234,46471,3575895713,3575895716,3
2,1234,46472,3575895713,3575895716,3
2,1234,46473,3575895713,3575895717,4
2,1234,46474,3575895713,3575895717,4
2,1234,46475,3575895713,3575895718,5
2,1234,46476,3575895713,3575895718,5
2,1234,46477,3575895713,3575895718,5
2,1234,46478,3575895713,3575895719,6
2,1234,46479,3575895713,3575895721,8
2,1234,46480,3575895713,3575895721,8
2,1234,46481,3575895713,3575895723,10
2,1234,46482,3575895713,3575895725,12
2,1234,46483,3575895713,3575895725,12
2,1234,46484,3575895713,3575895726,13
2,1234,46485,3575895713,3575895727,14
2,1234,46486,3575895713,3575895727,14
2,1234,46487,3575895713,3575895730,17
2,1234,46488,3575895713,3575895730,17
2,1234,46489,3575895713,3575895731,18
2,1234,46490,3575895713,3575895732,19
2,1234,46491,3575895713,3575895732,19
2,1234,46492,3575895713,3575895732,19
2,1234,46493,3575895713,3575895733,20
2,1234,46494,3575895713,3575895733,20
2,1234,46495,3575895713,3575895734,21
2,1234,46496,3575895713,3575895734,21
2,1234,46497,3575895713,3575895735,22
2,1234,46498,3575895713,3575895735,22
2,1234,46499,3575895713,3575895740,27
2,1234,46500,3575895713,3575895740,27
2,1234,46501,3575895713,3575895742,29
2,1234,46502,3575895713,3575895742,29
2,1234,46503,3575895713,3575895743,30
2,1234,46504,3575895713,3575895743,30
2,1234,46505,3575895713,3575895744,31
2,1234,46506,3575895713,3575895744,31
2,1234,46507,3575895713,3575895747,34
2,1234,46508,3575895713,3575895747,34
2,1234,46509,3575895713,3575895747,34
2,1234,46510,3575895713,3575895747,34
2,1234,46511,3575895713,3575895747,34
2,1234,46512,3575895713,3575895749,36
2,1234,46513,3575895713,3575895749,36
2,1234,46514,3575895713,3575895750,37
2,1234,46515,3575895713,3575895750,37
2,1234,46516,3575895713,3575895750,37
2,1234,46517,3575895713,3575895751,38
2,1234,46518,3575895713,3575895751,38
2,1234,46519,3575895713,3575895753,40
2,1234,46520,3575895713,3575895753,40
2,1234,46521,3575895713,3575895754,41
2,1234,46522,3575895713,3575895756,43
2,1234,46523,3575895713,3575895758,45
2,1234,46524,3575895713,3575895759,46
2,1234,46525,3575895713,3575895759,46
2,1234,46526,3575895713,3575895760,47
2,1234,46527,3575895713,3575895761,48
2,1234,46528,3575895713,3575895762,49
2,1235,46529,3575895780,3575895780,0
2,1235,46530,3575895780,3575895780,0
2,1235,46531,3575895780,3575895780,0
2,1235,46532,3575895780,3575895780,0
2,1235,46533,3575895780,3575895780,0
2,1235,46534,3575895780,3575895780,0
2,1235,46535,3575895780,3575895780,0
2,1235,46536,3575895780,3575895780,0
2,1235,46537,3575895780,3575895780,0
2,1235,46538,3575895780,3575895780,0
2,1235,46539,3575895780,3575895780,0
2,1235,46540,3575895780,3575895780,0
2,1235,46541,3575895780,3575895780,0
2,1235,46542,3575895780,3575895780,0
2,1235,46543,3575895780,3575895780,0
2,1235,46544,3575895780,3575895780,0
2,1235,46545,3575895780,3575895780,0
2,1235,46546,3575895780,3575895780,0
2,1235,46547,3575895780,3575895780,0
2,1235,46548,3575895780,3575895780,0
2,1235,46549,3575895780,3575895780,0
2,1235,46550,3575895780,3575895780,0
2,1235,46551,3575895780,3575895780,0
2,1235,46552,3575895780,3575895781,1
2,1235,46553,3575895780,3575895781,1
2,1235,46554,3575895780,3575895783,3
2,1235,46555,3575895780,3575895784,4
2,1235,46556,3575895780,3575895785,5
2,1235,46557,3575895780,3575895785,5
2,1235,46558,3575895780,3575895785,5
2,1235,46559,3575895780,3575895785,5
2,1235,46560,3575895780,3575895785,5
2,1235,46561,3575895780,3575895788,8
2,1235,46562,3575895780,3575895788,8
2,1235,46563,3575895780,3575895788,8
2,1235,46564,3575895780,3575895789,9
2,1235,46565,3575895780,3575895789,9
2,1235,46566,3575895780,3575895790,10
2,1235,46567,3575895780,3575895790,10
2,1235,46568,3575895780,3575895790,10
2,1235,46569,3575895780,3575895791,11
2,1235,46570,3575895780,3575895793,13
2,1235,46571,3575895780,3575895793,13
2,1235,46572,3575895780,3575895793,13
2,1235,46573,3575895780,3575895795,15
2,1235,46574,3575895780,3575895795,15
2,1235,46575,3575895780,3575895796,16
2,1235,46576,3575895780,3575895796,16
2,1235,46577,3575895780,3575895797,17
2,1235,46578,3575895780,3575895798,18
2,1235,46579,3575895780,3575895799,19
2,1235,46580,3575895780,3575895801,21
2,1235,46581,3575895780,3575895801,21
2,1235,46582,3575895780,3575895801,21
2,1235,46583,3575895780,3575895802,22
2,1235,46584,3575895780,3575895803,23
2,1235,46585,3575895780,3575895803,23
2,1235,46586,3575895780,3575895803,23
2,1235,46587,3575895780,3575895804,24
2,1235,46588,3575895780,3575895805,25
2,1235,46589,3575895780,3575895805,25
2,1235,46590,3575895780,3575895808,28
2,1235,46591,3575895780,3575895810,30
2,1235,46592,3575895780,3575895811,31
2,1235,46593,3575895780,3575895814,34
2,1235,46594,3575895780,3575895814,34
2,1235,46595,3575895780,3575895820,40
2,1235,46596,3575895780,3575895821,41
2,1235,46597,3575895780,3575895822,42
2,1235,46598,3575895780,3575895823,43
2,1235,46599,3575895780,3575895826,46
2,1235,46600,3575895780,3575895827,47
2,1235,46601,3575895780,3575895828,48
2,1235,46602,3575895780,3575895829,49
2,1235,46603,3575895780,3575895829,49
2,1235,46604,3575895780,3575895829,49
2,1235,46605,3575895780,3575895829,49
2,1236,46606,3575895843,3575895843,0
2,1236,46607,3575895843,3575895843,0
2,1236,46608,3575895843,3575895843,0
2,1236,46609,3575895843,3575895843,0
2,1236,46610,3575895843,3575895843,0
2,1236,46611,3575895843,3575895843,0
2,1236,46612,3575895843,3575895843,0
2,1236,46613,3575895843,3575895843,0
2,1236,46614,3575895843,3575895843,0
2,1236,46615,3575895843,3575895843,0
2,1236,46616,3575895843,3575895843,0
2,1236,46617,3575895843,3575895843,0
2,1236,46618,3575895843,3575895843,0
2,1236,46619,3575895843,3575895843,0
2,1236,46620,3575895843,3575895843,0
2,1236,46621,3575895843,3575895844,1
2,1236,46622,3575895843,3575895845,2
2,1236,46623,3575895843,3575895847,4
2,1236,46624,3575895843,3575895849,6
2,1236,46625,3575895843,3575895850,7
2,1236,46626,3575895843,3575895854,11
2,1236,46627,3575895843,3575895854,11
2,1236,46628,3575895843,3575895854,11
2,1236,46629,3575895843,3575895854,11
2,1236,46630,3575895843,3575895854,11
2,1236,46631,3575895843,3575895855,12
2,1236,46632,3575895843,3575895855,12
2,1236,46633,3575895843,3575895857,14
2,1236,46634,3575895843,3575895859,16
2,1236,46635,3575895843,3575895859,16
2,1236,46636,3575895843,3575895859,16
2,1236,46637,3575895843,3575895861,18
2,1236,46638,3575895843,3575895861,18
2,1236,46639,3575895843,3575895863,20
2,1236,46640,3575895843,3575895864,21
2,1236,46641,3575895843,3575895866,23
2,1236,46642,3575895843,3575895867,24
2,1236,46643,3575895843,3575895869,26
2,1236,46644,3575895843,3575895871,28
2,1236,46645,3575895843,3575895878,35
2,1236,46646,3575895843,3575895881,38
2,1236,46647,3575895843,3575895883,40
2,1236,46648,3575895843,3575895884,41
2,1236,46649,3575895843,3575895884,41
2,1236,46650,3575895843,3575895885,42
2,1236,46651,3575895843,3575895885,42
2,1236,46652,3575895843,3575895886,43
2,1236,46653,3575895843,3575895888,45
2,1236,46654,3575895843,3575895890,47
2,1236,46655,3575895843,3575895890,47
2,1236,46656,3575895843,3575895890,47
2,1236,46657,3575895843,3575895890,47
2,1236,46658,3575895843,3575895891,48
2,1236,46659,3575895843,3575895892,49
2,1236,46660,3575895843,3575895892,49
2,1236,46661,3575895843,3575895893,50
2,1237,46662,3575895909,3575895909,0
2,1237,46663,3575895909,3575895909,0
2,1237,46664,3575895909,3575895909,0
2,1237,46665,3575895909,3575895909,0
2,1237,46666,3575895909,3575895909,0
2,1237,46667,3575895909,3575895909,0
2,1237,46668,3575895909,3575895909,0
2,1237,46669,3575895909,3575895909,0
2,1237,46670,3575895909,3575895909,0
2,1237,46671,3575895909,3575895909,0
2,1237,46672,3575895909,3575895909,0
2,1237,46673,3575895909,3575895909,0
2,1237,46674,3575895909,3575895909,0
2,1237,46675,3575895909,3575895909,0
2,1237,46676,3575895909,3575895909,0
2,1237,46677,3575895909,3575895909,0
2,1237,46678,3575895909,3575895909,0
2,1237,46679,3575895909,3575895909,0
2,1237,46680,3575895909,3575895909,0
2,1237,46681,3575895909,3575895909,0
2,1237,46682,3575895909,3575895909,0
2,1237,46683,3575895909,3575895909,0
2,1237,46684,3575895909,3575895909,0
2,1237,46685,3575895909,3575895909,0
2,1237,46686,3575895909,3575895909,0
2,1237,46687,3575895909,3575895909,0
2,1237,46688,3575895909,3575895909,0
2,1237,46689,3575895909,3575895910,1
2,1237,46690,3575895909,3575895910,1
2,1237,46691,3575895909,3575895911,2
2,1237,46692,3575895909,3575895913,4
2,1237,46693,3575895909,3575895913,4
2,1237,46694,3575895909,3575895914,5
2,1237,46695,3575895909,3575895914,5
2,1237,46696,3575895909,3575895914,5
2,1237,46697,3575895909,3575895914,5
2,1237,46698,3575895909,3575895915,6
2,1237,46699,3575895909,3575895915,6
2,1237,46700,3575895909,3575895916,7
2,1237,46701,3575895909,3575895917,8
2,1237,46702,3575895909,3575895917,8
2,1237,46703,3575895909,3575895918,9
2,1237,46704,3575895909,3575895918,9
2,1237,46705,3575895909,3575895918,9
2,1237,46706,3575895909,3575895919,10
2,1237,46707,3575895909,3575895920,11
2,1237,46708,3575895909,3575895922,13
2,1237,46709,3575895909,3575895923,14
2,1237,46710,3575895909,3575895924,15
2,1237,46711,3575895909,3575895925,16
2,1237,46712,3575895909,3575895925,16
2,1237,46713,3575895909,3575895925,16
2,1237,46714,3575895909,3575895926,17
2,1237,46715,3575895909,3575895927,18
2,1237,46716,3575895909,3575895927,18
2,1237,46717,3575895909,3575895930,21
2,1237,46718,3575895909,3575895931,22
2,1237,46719,3575895909,3575895932,23
2,1237,46720,3575895909,3575895932,23
2,1237,46721,3575895909,3575895932,23
2,1237,46722,3575895909,3575895932,23
2,1237,46723,3575895909,3575895932,23
2,1237,46724,3575895909,3575895933,24
2,1237,46725,3575895909,3575895933,24
2,1237,46726,3575895909,3575895934,25
2,1237,46727,3575895909,3575895934,25
2,1237,46728,3575895909,3575895935,26
2,1237,46729,3575895909,3575895935,26
2,1237,46730,3575895909,3575895935,26
2,1237,46731,3575895909,3575895939,30
2,1237,46732,3575895909,3575895942,33
2,1237,46733,3575895909,3575895942,33
2,1237,46734,3575895909,3575895944,35
2,1237,46735,3575895909,3575895944,35
2,1237,46736,3575895909,3575895944,35
2,1237,46737,3575895909,3575895944,35
2,1237,46738,3575895909,3575895946,37
2,1237,46739,3575895909,3575895946,37
2,1237,46740,3575895909,3575895947,38
2,1237,46741,3575895909,3575895947,38
2,1237,46742,3575895909,3575895947,38
2,1237,46743,3575895909,3575895949,40
2,1237,46744,3575895909,3575895950,41
2,1237,46745,3575895909,3575895951,42
2,1237,46746,3575895909,3575895952,43
2,1237,46747,3575895909,3575895952,43
2,1237,46748,3575895909,3575895952,43
2,1237,46749,3575895909,3575895952,43
2,1237,46750,3575895909,3575895953,44
2,1237,46751,3575895909,3575895953,44
2,1237,46752,3575895909,3575895954,45
2,1237,46753,3575895909,3575895955,46
2,1237,46754,3575895909,3575895956,47
2,1237,46755,3575895909,3575895959,50
2,1238,46756,3575895974,3575895974,0
2,1238,46757,3575895974,3575895974,0
2,1238,46758,3575895974,3575895974,0
2,1238,46759,3575895974,3575895974,0
2,1238,46760,3575895974,3575895974,0
2,1238,46761,3575895974,3575895974,0
2,1238,46762,3575895974,3575895974,0
2,1238,46763,3575895974,3575895974,0
2,1238,46764,3575895974,3575895974,0
2,1238,46765,3575895974,3575895974,0
2,1238,46766,3575895974,3575895974,0
2,1238,46767,3575895974,3575895974,0
2,1238,46768,3575895974,3575895974,0
2,1238,46769,3575895974,3575895974,0
2,1238,46770,3575895974,3575895974,0
2,1238,46771,3575895974,3575895974,0
2,1238,46772,3575895974,3575895974,0
2,1238,46773,3575895974,3575895974,0
2,1238,46774,3575895974,3575895974,0
2,1238,46775,3575895974,3575895974,0
2,1238,46776,3575895974,3575895974,0
2,1238,46777,3575895974,3575895975,1
2,1238,46778,3575895974,3575895976,2
2,1238,46779,3575895974,3575895977,3
2,1238,46780,3575895974,3575895978,4
2,1238,46781,3575895974,3575895978,4
2,1238,46782,3575895974,3575895980,6
2,1238,46783,3575895974,3575895980,6
2,1238,46784,3575895974,3575895981,7
2,1238,46785,3575895974,3575895981,7
2,1238,46786,3575895974,3575895984,10
2,1238,46787,3575895974,3575895984,10
2,1238,46788,3575895974,3575895985,11
2,1238,46789,3575895974,3575895985,11
2,1238,46790,3575895974,3575895985,11
2,1238,46791,3575895974,3575895988,14
2,1238,46792,3575895974,3575895988,14
2,1238,46793,3575895974,3575895989,15
2,1238,46794,3575895974,3575895989,15
2,1238,46795,3575895974,3575895989,15
2,1238,46796,3575895974,3575895990,16
2,1238,46797,3575895974,3575895991,17
2,1238,46798,3575895974,3575895991,17
2,1238,46799,3575895974,3575895991,17
2,1238,46800,3575895974,3575895993,19
2,1238,46801,3575895974,3575895994,20
2,1238,46802,3575895974,3575895995,21
2,1238,46803,3575895974,3575895996,22
2,1238,46804,3575895974,3575895996,22
2,1238,46805,3575895974,3575895997,23
2,1238,46806,3575895974,3575895998,24
2,1238,46807,3575895974,3575895998,24
2,1238,46808,3575895974,3575896000,26
2,1238,46809,3575895974,3575896001,27
2,1238,46810,3575895974,3575896002,28
2,1238,46811,3575895974,3575896002,28
2,1238,46812,3575895974,3575896003,29
2,1238,46813,3575895974,3575896004,30
2,1238,46814,3575895974,3575896004,30
2,1238,46815,3575895974,3575896005,31
2,1238,46816,3575895974,3575896006,32
2,1238,46817,3575895974,3575896009,35
2,1238,46818,3575895974,3575896010,36
2,1238,46819,3575895974,3575896011,37
2,1238,46820,3575895974,3575896014,40
2,1238,46821,3575895974,3575896015,41
2,1238,46822,3575895974,3575896022,48
2,1238,46823,3575895974,3575896022,48
2,1238,46824,3575895974,3575896022,48
2,1239,46825,3575896040,3575896040,0
2,1239,46826,3575896040,3575896040,0
2,1239,46827,3575896040,3575896040,0
2,1239,46828,3575896040,3575896040,0
2,1239,46829,3575896040,3575896040,0
2,1239,46830,3575896040,3575896040,0
2,1239,46831,3575896040,3575896040,0
2,1239,46832,3575896040,3575896040,0
2,1239,46833,3575896040,3575896040,0
2,1239,46834,3575896040,3575896040,0
2,1239,46835,3575896040,3575896040,0
2,1239,46836,3575896040,3575896040,0
2,1239,46837,3575896040,3575896040,0
2,1239,46838,3575896040,3575896040,0
2,1239,46839,3575896040,3575896040,0
2,1239,46840,3575896040,3575896040,0
2,1239,46841,3575896040,3575896040,0
2,1239,46842,3575896040,3575896040,0
2,1239,46843,3575896040,3575896040,0
2,1239,46844,3575896040,3575896042,2
2,1239,46845,3575896040,3575896043,3
2,1239,46846,3575896040,3575896044,4
2,1239,46847,3575896040,3575896044,4
2,1239,46848,3575896040,3575896044,4
2,1239,46849,3575896040,3575896045,5
2,1239,46850,3575896040,3575896047,7
2,1239,46851,3575896040,3575896049,9
2,1239,46852,3575896040,3575896050,10
2,1239,46853,3575896040,3575896054,14
2,1239,46854,3575896040,3575896054,14
2,1239,46855,3575896040,3575896054,14
2,1239,46856,3575896040,3575896055,15
2,1239,46857,3575896040,3575896056,16
2,1239,46858,3575896040,3575896056,16
2,1239,46859,3575896040,3575896056,16
2,1239,46860,3575896040,3575896056,16
2,1239,46861,3575896040,3575896059,19
2,1239,46862,3575896040,3575896059,19
2,1239,46863,3575896040,3575896059,19
2,1239,46864,3575896040,3575896061,21
2,1239,46865,3575896040,3575896062,22
2,1239,46866,3575896040,3575896062,22
2,1239,46867,3575896040,3575896064,24
2,1239,46868,3575896040,3575896066,26
2,1239,46869,3575896040,3575896067,27
2,1239,46870,3575896040,3575896070,30
2,1239,46871,3575896040,3575896071,31
2,1239,46872,3575896040,3575896076,36
2,1239,46873,3575896040,3575896077,37
2,1239,46874,3575896040,3575896082,42
2,1239,46875,3575896040,3575896083,43
2,1239,46876,3575896040,3575896084,44
2,1239,46877,3575896040,3575896084,44
2,1239,46878,3575896040,3575896086,46
2,1239,46879,3575896040,3575896086,46
2,1239,46880,3575896040,3575896089,49
2,1240,46881,3575896106,3575896106,0
2,1240,46882,3575896106,3575896106,0
2,1240,46883,3575896106,3575896106,0
2,1240,46884,3575896106,3575896106,0
2,1240,46885,3575896106,3575896106,0
2,1240,46886,3575896106,3575896106,0
2,1240,46887,3575896106,3575896106,0
2,1240,46888,3575896106,3575896106,0
2,1240,46889,3575896106,3575896106,0
2,1240,46890,3575896106,3575896106,0
2,1240,46891,3575896106,3575896106,0
2,1240,46892,3575896106,3575896106,0
2,1240,46893,3575896106,3575896106,0
2,1240,46894,3575896106,3575896106,0
2,1240,46895,3575896106,3575896106,0
2,1240,46896,3575896106,3575896106,0
2,1240,46897,3575896106,3575896106,0
2,1240,46898,3575896106,3575896106,0
2,1240,46899,3575896106,3575896106,0
2,1240,46900,3575896106,3575896106,0
2,1240,46901,3575896106,3575896106,0
2,1240,46902,3575896106,3575896106,0
2,1240,46903,3575896106,3575896106,0
2,1240,46904,3575896106,3575896106,0
2,1240,46905,3575896106,3575896106,0
2,1240,46906,3575896106,3575896106,0
2,1240,46907,3575896106,3575896106,0
2,1240,46908,3575896106,3575896106,0
2,1240,46909,3575896106,3575896107,1
2,1240,46910,3575896106,3575896107,1
2,1240,46911,3575896106,3575896108,2
2,1240,46912,3575896106,3575896108,2
2,1240,46913,3575896106,3575896108,2
2,1240,46914,3575896106,3575896109,3
2,1240,46915,3575896106,3575896110,4
2,1240,46916,3575896106,3575896111,5
2,1240,46917,3575896106,3575896111,5
2,1240,46918,3575896106,3575896113,7
2,1240,46919,3575896106,3575896113,7
2,1240,46920,3575896106,3575896114,8
2,1240,46921,3575896106,3575896114,8
2,1240,46922,3575896106,3575896114,8
2,1240,46923,3575896106,3575896114,8
2,1240,46924,3575896106,3575896115,9
2,1240,46925,3575896106,3575896115,9
2,1240,46926,3575896106,3575896116,10
2,1240,46927,3575896106,3575896116,10
2,1240,46928,3575896106,3575896117,11
2,1240,46929,3575896106,3575896118,12
2,1240,46930,3575896106,3575896118,12
2,1240,46931,3575896106,3575896118,12
2,1240,46932,3575896106,3575896118,12
2,1240,46933,3575896106,3575896119,13
2,1240,46934,3575896106,3575896120,14
2,1240,46935,3575896106,3575896122,16
2,1240,46936,3575896106,3575896124,18
2,1240,46937,3575896106,3575896125,19
2,1240,46938,3575896106,3575896126,20
2,1240,46939,3575896106,3575896127,21
2,1240,46940,3575896106,3575896127,21
2,1240,46941,3575896106,3575896127,21
2,1240,46942,3575896106,3575896130,24
2,1240,46943,3575896106,3575896131,25
2,1240,46944,3575896106,3575896132,26
2,1240,46945,3575896106,3575896132,26
2,1240,46946,3575896106,3575896133,27
2,1240,46947,3575896106,3575896134,28
2,1240,46948,3575896106,3575896134,28
2,1240,46949,3575896106,3575896134,28
2,1240,46950,3575896106,3575896135,29
2,1240,46951,3575896106,3575896135,29
2,1240,46952,3575896106,3575896139,33
2,1240,46953,3575896106,3575896140,34
2,1240,46954,3575896106,3575896143,37
2,1240,46955,3575896106,3575896144,38
2,1240,46956,3575896106,3575896144,38
2,1240,46957,3575896106,3575896145,39
2,1240,46958,3575896106,3575896145,39
2,1240,46959,3575896106,3575896147,41
2,1240,46960,3575896106,3575896147,41
2,1240,46961,3575896106,3575896147,41
2,1240,46962,3575896106,3575896147,41
2,1240,46963,3575896106,3575896148,42
2,1240,46964,3575896106,3575896149,43
2,1240,46965,3575896106,3575896150,44
2,1240,46966,3575896106,3575896150,44
2,1240,46967,3575896106,3575896150,44
2,1240,46968,3575896106,3575896152,46
2,1240,46969,3575896106,3575896152,46
2,1240,46970,3575896106,3575896152,46
2,1240,46971,3575896106,3575896154,48
2,1240,46972,3575896106,3575896154,48
2,1240,46973,3575896106,3575896154,48
2,1241,46974,3575896173,3575896173,0
2,1241,46975,3575896173,3575896173,0
2,1241,46976,3575896173,3575896173,0
2,1241,46977,3575896173,3575896173,0
2,1241,46978,3575896173,3575896173,0
2,1241,46979,3575896173,3575896173,0
2,1241,46980,3575896173,3575896173,0
2,1241,46981,3575896173,3575896173,0
2,1241,46982,3575896173,3575896173,0
2,1241,46983,3575896173,3575896173,0
2,1241,46984,3575896173,3575896173,0
2,1241,46985,3575896173,3575896173,0
2,1241,46986,3575896173,3575896173,0
2,1241,46987,3575896173,3575896173,0
2,1241,46988,3575896173,3575896173,0
2,1241,46989,3575896173,3575896173,0
2,1241,46990,3575896173,3575896173,0
2,1241,46991,3575896173,3575896173,0
2,1241,46992,3575896173,3575896173,0
2,1241,46993,3575896173,3575896173,0
2,1241,46994,3575896173,3575896174,1
2,1241,46995,3575896173,3575896175,2
2,1241,46996,3575896173,3575896176,3
2,1241,46997,3575896173,3575896176,3
2,1241,46998,3575896173,3575896176,3
2,1241,46999,3575896173,3575896177,4
2,1241,47000,3575896173,3575896178,5
2,1241,47001,3575896173,3575896178,5
2,1241,47002,3575896173,3575896181,8
2,1241,47003,3575896173,3575896181,8
2,1241,47004,3575896173,3575896181,8
2,1241,47005,3575896173,3575896181,8
2,1241,47006,3575896173,3575896184,11
2,1241,47007,3575896173,3575896184,11
2,1241,47008,3575896173,3575896185,12
2,1241,47009,3575896173,3575896185,12
2,1241,47010,3575896173,3575896186,13
2,1241,47011,3575896173,3575896186,13
2,1241,47012,3575896173,3575896189,16
2,1241,47013,3575896173,3575896189,16
2,1241,47014,3575896173,3575896189,16
2,1241,47015,3575896173,3575896190,17
2,1241,47016,3575896173,3575896190,17
2,1241,47017,3575896173,3575896191,18
2,1241,47018,3575896173,3575896191,18
2,1241,47019,3575896173,3575896191,18
2,1241,47020,3575896173,3575896194,21
2,1241,47021,3575896173,3575896194,21
2,1241,47022,3575896173,3575896195,22
2,1241,47023,3575896173,3575896196,23
2,1241,47024,3575896173,3575896196,23
2,1241,47025,3575896173,3575896196,23
2,1241,47026,3575896173,3575896197,24
2,1241,47027,3575896173,3575896197,24
2,1241,47028,3575896173,3575896198,25
2,1241,47029,3575896173,3575896200,27
2,1241,47030,3575896173,3575896201,28
2,1241,47031,3575896173,3575896201,28
2,1241,47032,3575896173,3575896203,30
2,1241,47033,3575896173,3575896203,30
2,1241,47034,3575896173,3575896205,32
2,1241,47035,3575896173,3575896205,32
2,1241,47036,3575896173,3575896206,33
2,1241,47037,3575896173,3575896206,33
2,1241,47038,3575896173,3575896207,34
2,1241,47039,3575896173,3575896209,36
2,1241,47040,3575896173,3575896210,37
2,1241,47041,3575896173,3575896212,39
2,1241,47042,3575896173,3575896214,41
2,1241,47043,3575896173,3575896214,41
2,1241,47044,3575896173,3575896222,49
2,1241,47045,3575896173,3575896222,49
2,1241,47046,3575896173,3575896222,49
2,1242,47047,3575896239,3575896239,0
2,1242,47048,3575896239,3575896239,0
2,1242,47049,3575896239,3575896239,0
2,1242,47050,3575896239,3575896239,0
2,1242,47051,3575896239,3575896239,0
2,1242,47052,3575896239,3575896239,0
2,1242,47053,3575896239,3575896239,0
2,1242,47054,3575896239,3575896239,0
2,1242,47055,3575896239,3575896239,0
2,1242,47056,3575896239,3575896239,0
2,1242,47057,3575896239,3575896239,0
2,1242,47058,3575896239,3575896239,0
2,1242,47059,3575896239,3575896239,0
2,1242,47060,3575896239,3575896239,0
2,1242,47061,3575896239,3575896239,0
2,1242,47062,3575896239,3575896239,0
2,1242,47063,3575896239,3575896239,0
2,1242,47064,3575896239,3575896239,0
2,1242,47065,3575896239,3575896239,0
2,1242,47066,3575896239,3575896240,1
2,1242,47067,3575896239,3575896240,1
2,1242,47068,3575896239,3575896243,4
2,1242,47069,3575896239,3575896243,4
2,1242,47070,3575896239,3575896243,4
2,1242,47071,3575896239,3575896243,4
2,1242,47072,3575896239,3575896244,5
2,1242,47073,3575896239,3575896245,6
2,1242,47074,3575896239,3575896247,8
2,1242,47075,3575896239,3575896249,10
2,1242,47076,3575896239,3575896251,12
2,1242,47077,3575896239,3575896254,15
2,1242,47078,3575896239,3575896254,15
2,1242,47079,3575896239,3575896255,16
2,1242,47080,3575896239,3575896255,16
2,1242,47081,3575896239,3575896256,17
2,1242,47082,3575896239,3575896256,17
2,1242,47083,3575896239,3575896259,20
2,1242,47084,3575896239,3575896259,20
2,1242,47085,3575896239,3575896260,21
2,1242,47086,3575896239,3575896261,22
2,1242,47087,3575896239,3575896261,22
2,1242,47088,3575896239,3575896262,23
2,1242,47089,3575896239,3575896264,25
2,1242,47090,3575896239,3575896267,28
2,1242,47091,3575896239,3575896267,28
2,1242,47092,3575896239,3575896271,32
2,1242,47093,3575896239,3575896271,32
2,1242,47094,3575896239,3575896276,37
2,1242,47095,3575896239,3575896281,42
2,1242,47096,3575896239,3575896283,44
2,1242,47097,3575896239,3575896284,45
2,1242,47098,3575896239,3575896284,45
2,1242,47099,3575896239,3575896286,47
2,1242,47100,3575896239,3575896286,47
2,1242,47101,3575896239,3575896286,47
2,1242,47102,3575896239,3575896288,49
2,1242,47103,3575896239,3575896289,50
2,1243,47104,3575896302,3575896302,0
2,1243,47105,3575896302,3575896302,0
2,1243,47106,3575896302,3575896302,0
2,1243,47107,3575896302,3575896302,0
2,1243,47108,3575896302,3575896302,0
2,1243,47109,3575896302,3575896302,0
2,1243,47110,3575896302,3575896302,0
2,1243,47111,3575896302,3575896302,0
2,1243,47112,3575896302,3575896302,0
2,1243,47113,3575896302,3575896302,0
2,1243,47114,3575896302,3575896302,0
2,1243,47115,3575896302,3575896302,0
2,1243,47116,3575896302,3575896302,0
2,1243,47117,3575896302,3575896302,0
2,1243,47118,3575896302,3575896302,0
2,1243,47119,3575896302,3575896302,0
2,1243,47120,3575896302,3575896302,0
2,1243,47121,3575896302,3575896302,0
2,1243,47122,3575896302,3575896302,0
2,1243,47123,3575896302,3575896302,0
2,1243,47124,3575896302,3575896302,0
2,1243,47125,3575896302,3575896302,0
2,1243,47126,3575896302,3575896302,0
2,1243,47127,3575896302,3575896303,1
2,1243,47128,3575896302,3575896303,1
2,1243,47129,3575896302,3575896304,2
2,1243,47130,3575896302,3575896304,2
2,1243,47131,3575896302,3575896304,2
2,1243,47132,3575896302,3575896304,2
2,1243,47133,3575896302,3575896305,3
2,1243,47134,3575896302,3575896306,4
2,1243,47135,3575896302,3575896307,5
2,1243,47136,3575896302,3575896308,6
2,1243,47137,3575896302,3575896308,6
2,1243,47138,3575896302,3575896308,6
2,1243,47139,3575896302,3575896308,6
2,1243,47140,3575896302,3575896309,7
2,1243,47141,3575896302,3575896310,8
2,1243,47142,3575896302,3575896310,8
2,1243,47143,3575896302,3575896311,9
2,1243,47144,3575896302,3575896311,9
2,1243,47145,3575896302,3575896312,10
2,1243,47146,3575896302,3575896314,12
2,1243,47147,3575896302,3575896314,12
2,1243,47148,3575896302,3575896314,12
2,1243,47149,3575896302,3575896315,13
2,1243,47150,3575896302,3575896315,13
2,1243,47151,3575896302,3575896316,14
2,1243,47152,3575896302,3575896317,15
2,1243,47153,3575896302,3575896317,15
2,1243,47154,3575896302,3575896317,15
2,1243,47155,3575896302,3575896318,16
2,1243,47156,3575896302,3575896318,16
2,1243,47157,3575896302,3575896318,16
2,1243,47158,3575896302,3575896318,16
2,1243,47159,3575896302,3575896319,17
2,1243,47160,3575896302,3575896319,17
2,1243,47161,3575896302,3575896320,18
2,1243,47162,3575896302,3575896322,20
2,1243,47163,3575896302,3575896323,21
2,1243,47164,3575896302,3575896325,23
2,1243,47165,3575896302,3575896326,24
2,1243,47166,3575896302,3575896327,25
2,1243,47167,3575896302,3575896329,27
2,1243,47168,3575896302,3575896330,28
2,1243,47169,3575896302,3575896331,29
2,1243,47170,3575896302,3575896331,29
2,1243,47171,3575896302,3575896332,30
2,1243,47172,3575896302,3575896332,30
2,1243,47173,3575896302,3575896333,31
2,1243,47174,3575896302,3575896333,31
2,1243,47175,3575896302,3575896334,32
2,1243,47176,3575896302,3575896334,32
2,1243,47177,3575896302,3575896335,33
2,1243,47178,3575896302,3575896335,33
2,1243,47179,3575896302,3575896336,34
2,1243,47180,3575896302,3575896339,37
2,1243,47181,3575896302,3575896339,37
2,1243,47182,3575896302,3575896340,38
2,1243,47183,3575896302,3575896342,40
2,1243,47184,3575896302,3575896343,41
2,1243,47185,3575896302,3575896344,42
2,1243,47186,3575896302,3575896345,43
2,1243,47187,3575896302,3575896345,43
2,1243,47188,3575896302,3575896346,44
2,1243,47189,3575896302,3575896347,45
2,1243,47190,3575896302,3575896347,45
2,1243,47191,3575896302,3575896347,45
2,1243,47192,3575896302,3575896347,45
2,1243,47193,3575896302,3575896349,47
2,1243,47194,3575896302,3575896350,48
2,1243,47195,3575896302,3575896350,48
2,1243,47196,3575896302,3575896351,49
2,1243,47197,3575896302,3575896352,50
2,1243,47198,3575896302,3575896352,50
2,1244,47199,3575896366,3575896366,0
2,1244,47200,3575896366,3575896366,0
2,1244,47201,3575896366,3575896366,0
2,1244,47202,3575896366,3575896366,0
2,1244,47203,3575896366,3575896366,0
2,1244,47204,3575896366,3575896366,0
2,1244,47205,3575896366,3575896366,0
2,1244,47206,3575896366,3575896366,0
2,1244,47207,3575896366,3575896367,1
2,1244,47208,3575896366,3575896367,1
2,1244,47209,3575896366,3575896367,1
2,1244,47210,3575896366,3575896367,1
2,1244,47211,3575896366,3575896367,1
2,1244,47212,3575896366,3575896367,1
2,1244,47213,3575896366,3575896367,1
2,1244,47214,3575896366,3575896367,1
2,1244,47215,3575896366,3575896367,1
2,1244,47216,3575896366,3575896367,1
2,1244,47217,3575896366,3575896367,1
2,1244,47218,3575896366,3575896368,2
2,1244,47219,3575896366,3575896368,2
2,1244,47220,3575896366,3575896368,2
2,1244,47221,3575896366,3575896368,2
2,1244,47222,3575896366,3575896369,3
2,1244,47223,3575896366,3575896369,3
2,1244,47224,3575896366,3575896370,4
2,1244,47225,3575896366,3575896370,4
2,1244,47226,3575896366,3575896370,4
2,1244,47227,3575896366,3575896370,4
2,1244,47228,3575896366,3575896371,5
2,1244,47229,3575896366,3575896374,8
2,1244,47230,3575896366,3575896374,8
2,1244,47231,3575896366,3575896375,9
2,1244,47232,3575896366,3575896376,10
2,1244,47233,3575896366,3575896376,10
2,1244,47234,3575896366,3575896376,10
2,1244,47235,3575896366,3575896376,10
2,1244,47236,3575896366,3575896377,11
2,1244,47237,3575896366,3575896378,12
2,1244,47238,3575896366,3575896378,12
2,1244,47239,3575896366,3575896381,15
2,1244,47240,3575896366,3575896381,15
2,1244,47241,3575896366,3575896381,15
2,1244,47242,3575896366,3575896382,16
2,1244,47243,3575896366,3575896384,18
2,1244,47244,3575896366,3575896384,18
2,1244,47245,3575896366,3575896385,19
2,1244,47246,3575896366,3575896385,19
2,1244,47247,3575896366,3575896386,20
2,1244,47248,3575896366,3575896386,20
2,1244,47249,3575896366,3575896388,22
2,1244,47250,3575896366,3575896388,22
2,1244,47251,3575896366,3575896389,23
2,1244,47252,3575896366,3575896389,23
2,1244,47253,3575896366,3575896390,24
2,1244,47254,3575896366,3575896390,24
2,1244,47255,3575896366,3575896390,24
2,1244,47256,3575896366,3575896391,25
2,1244,47257,3575896366,3575896391,25
2,1244,47258,3575896366,3575896392,26
2,1244,47259,3575896366,3575896393,27
2,1244,47260,3575896366,3575896393,27
2,1244,47261,3575896366,3575896395,29
2,1244,47262,3575896366,3575896395,29
2,1244,47263,3575896366,3575896396,30
2,1244,47264,3575896366,3575896396,30
2,1244,47265,3575896366,3575896396,30
2,1244,47266,3575896366,3575896397,31
2,1244,47267,3575896366,3575896398,32
2,1244,47268,3575896366,3575896398,32
2,1244,47269,3575896366,3575896400,34
2,1244,47270,3575896366,3575896401,35
2,1244,47271,3575896366,3575896401,35
2,1244,47272,3575896366,3575896401,35
2,1244,47273,3575896366,3575896403,37
2,1244,47274,3575896366,3575896404,38
2,1244,47275,3575896366,3575896405,39
2,1244,47276,3575896366,3575896405,39
2,1244,47277,3575896366,3575896406,40
2,1244,47278,3575896366,3575896406,40
2,1244,47279,3575896366,3575896408,42
2,1244,47280,3575896366,3575896409,43
2,1244,47281,3575896366,3575896410,44
2,1244,47282,3575896366,3575896411,45
2,1244,47283,3575896366,3575896413,47
2,1244,47284,3575896366,3575896414,48
2,1244,47285,3575896366,3575896414,48
2,1245,47286,3575896431,3575896431,0
2,1245,47287,3575896431,3575896431,0
2,1245,47288,3575896431,3575896431,0
2,1245,47289,3575896431,3575896431,0
2,1245,47290,3575896431,3575896431,0
2,1245,47291,3575896431,3575896431,0
2,1245,47292,3575896431,3575896431,0
2,1245,47293,3575896431,3575896431,0
2,1245,47294,3575896431,3575896431,0
2,1245,47295,3575896431,3575896431,0
2,1245,47296,3575896431,3575896431,0
2,1245,47297,3575896431,3575896431,0
2,1245,47298,3575896431,3575896431,0
2,1245,47299,3575896431,3575896431,0
2,1245,47300,3575896431,3575896432,1
2,1245,47301,3575896431,3575896432,1
2,1245,47302,3575896431,3575896434,3
2,1245,47303,3575896431,3575896435,4
2,1245,47304,3575896431,3575896436,5
2,1245,47305,3575896431,3575896437,6
2,1245,47306,3575896431,3575896437,6
2,1245,47307,3575896431,3575896438,7
2,1245,47308,3575896431,3575896439,8
2,1245,47309,3575896431,3575896439,8
2,1245,47310,3575896431,3575896440,9
2,1245,47311,3575896431,3575896440,9
2,1245,47312,3575896431,3575896443,12
2,1245,47313,3575896431,3575896443,12
2,1245,47314,3575896431,3575896444,13
2,1245,47315,3575896431,3575896444,13
2,1245,47316,3575896431,3575896445,14
2,1245,47317,3575896431,3575896445,14
2,1245,47318,3575896431,3575896447,16
2,1245,47319,3575896431,3575896450,19
2,1245,47320,3575896431,3575896451,20
2,1245,47321,3575896431,3575896454,23
2,1245,47322,3575896431,3575896455,24
2,1245,47323,3575896431,3575896455,24
2,1245,47324,3575896431,3575896455,24
2,1245,47325,3575896431,3575896456,25
2,1245,47326,3575896431,3575896456,25
2,1245,47327,3575896431,3575896459,28
2,1245,47328,3575896431,3575896460,29
2,1245,47329,3575896431,3575896460,29
2,1245,47330,3575896431,3575896462,31
2,1245,47331,3575896431,3575896462,31
2,1245,47332,3575896431,3575896463,32
2,1245,47333,3575896431,3575896465,34
2,1245,47334,3575896431,3575896467,36
2,1245,47335,3575896431,3575896467,36
2,1245,47336,3575896431,3575896472,41
2,1245,47337,3575896431,3575896472,41
2,1245,47338,3575896431,3575896477,46
2,1245,47339,3575896431,3575896481,50
2,1246,47340,3575896494,3575896494,0
2,1246,47341,3575896494,3575896494,0
2,1246,47342,3575896494,3575896494,0
2,1246,47343,3575896494,3575896494,0
2,1246,47344,3575896494,3575896494,0
2,1246,47345,3575896494,3575896494,0
2,1246,47346,3575896494,3575896494,0
2,1246,47347,3575896494,3575896494,0
2,1246,47348,3575896494,3575896494,0
2,1246,47349,3575896494,3575896494,0
2,1246,47350,3575896494,3575896494,0
2,1246,47351,3575896494,3575896494,0
2,1246,47352,3575896494,3575896494,0
2,1246,47353,3575896494,3575896494,0
2,1246,47354,3575896494,3575896494,0
2,1246,47355,3575896494,3575896494,0
2,1246,47356,3575896494,3575896494,0
2,1246,47357,3575896494,3575896494,0
2,1246,47358,3575896494,3575896494,0
2,1246,47359,3575896494,3575896494,0
2,1246,47360,3575896494,3575896494,0
2,1246,47361,3575896494,3575896496,2
2,1246,47362,3575896494,3575896497,3
2,1246,47363,3575896494,3575896497,3
2,1246,47364,3575896494,3575896498,4
2,1246,47365,3575896494,3575896499,5
2,1246,47366,3575896494,3575896500,6
2,1246,47367,3575896494,3575896501,7
2,1246,47368,3575896494,3575896501,7
2,1246,47369,3575896494,3575896502,8
2,1246,47370,3575896494,3575896503,9
2,1246,47371,3575896494,3575896503,9
2,1246,47372,3575896494,3575896503,9
2,1246,47373,3575896494,3575896503,9
2,1246,47374,3575896494,3575896505,11
2,1246,47375,3575896494,3575896505,11
2,1246,47376,3575896494,3575896505,11
2,1246,47377,3575896494,3575896506,12
2,1246,47378,3575896494,3575896506,12
2,1246,47379,3575896494,3575896506,12
2,1246,47380,3575896494,3575896507,13
2,1246,47381,3575896494,3575896508,14
2,1246,47382,3575896494,3575896508,14
2,1246,47383,3575896494,3575896509,15
2,1246,47384,3575896494,3575896510,16
2,1246,47385,3575896494,3575896510,16
2,1246,47386,3575896494,3575896511,17
2,1246,47387,3575896494,3575896513,19
2,1246,47388,3575896494,3575896513,19
2,1246,47389,3575896494,3575896513,19
2,1246,47390,3575896494,3575896513,19
2,1246,47391,3575896494,3575896514,20
2,1246,47392,3575896494,3575896515,21
2,1246,47393,3575896494,3575896515,21
2,1246,47394,3575896494,3575896515,21
2,1246,47395,3575896494,3575896516,22
2,1246,47396,3575896494,3575896516,22
2,1246,47397,3575896494,3575896517,23
2,1246,47398,3575896494,3575896517,23
2,1246,47399,3575896494,3575896518,24
2,1246,47400,3575896494,3575896518,24
2,1246,47401,3575896494,3575896520,26
2,1246,47402,3575896494,3575896520,26
2,1246,47403,3575896494,3575896522,28
2,1246,47404,3575896494,3575896523,29
2,1246,47405,3575896494,3575896524,30
2,1246,47406,3575896494,3575896524,30
2,1246,47407,3575896494,3575896525,31
2,1246,47408,3575896494,3575896528,34
2,1246,47409,3575896494,3575896529,35
2,1246,47410,3575896494,3575896530,36
2,1246,47411,3575896494,3575896531,37
2,1246,47412,3575896494,3575896531,37
2,1246,47413,3575896494,3575896532,38
2,1246,47414,3575896494,3575896532,38
2,1246,47415,3575896494,3575896532,38
2,1246,47416,3575896494,3575896533,39
2,1246,47417,3575896494,3575896533,39
2,1246,47418,3575896494,3575896534,40
2,1246,47419,3575896494,3575896534,40
2,1246,47420,3575896494,3575896535,41
2,1246,47421,3575896494,3575896538,44
2,1246,47422,3575896494,3575896539,45
2,1246,47423,3575896494,3575896541,47
2,1246,47424,3575896494,3575896543,49
2,1246,47425,3575896494,3575896543,49
2,1246,47426,3575896494,3575896543,49
2,1246,47427,3575896494,3575896544,50
2,1247,47428,3575896562,3575896562,0
2,1247,47429,3575896562,3575896562,0
2,1247,47430,3575896562,3575896562,0
2,1247,47431,3575896562,3575896562,0
2,1247,47432,3575896562,3575896562,0
2,1247,47433,3575896562,3575896562,0
2,1247,47434,3575896562,3575896562,0
2,1247,47435,3575896562,3575896562,0
2,1247,47436,3575896562,3575896562,0
2,1247,47437,3575896562,3575896562,0
2,1247,47438,3575896562,3575896562,0
2,1247,47439,3575896562,3575896562,0
2,1247,47440,3575896562,3575896562,0
2,1247,47441,3575896562,3575896562,0
2,1247,47442,3575896562,3575896562,0
2,1247,47443,3575896562,3575896562,0
2,1247,47444,3575896562,3575896562,0
2,1247,47445,3575896562,3575896562,0
2,1247,47446,3575896562,3575896562,0
2,1247,47447,3575896562,3575896562,0
2,1247,47448,3575896562,3575896562,0
2,1247,47449,3575896562,3575896562,0
2,1247,47450,3575896562,3575896562,0
2,1247,47451,3575896562,3575896562,0
2,1247,47452,3575896562,3575896562,0
2,1247,47453,3575896562,3575896563,1
2,1247,47454,3575896562,3575896564,2
2,1247,47455,3575896562,3575896564,2
2,1247,47456,3575896562,3575896565,3
2,1247,47457,3575896562,3575896565,3
2,1247,47458,3575896562,3575896566,4
2,1247,47459,3575896562,3575896567,5
2,1247,47460,3575896562,3575896569,7
2,1247,47461,3575896562,3575896569,7
2,1247,47462,3575896562,3575896569,7
2,1247,47463,3575896562,3575896569,7
2,1247,47464,3575896562,3575896570,8
2,1247,47465,3575896562,3575896571,9
2,1247,47466,3575896562,3575896572,10
2,1247,47467,3575896562,3575896573,11
2,1247,47468,3575896562,3575896574,12
2,1247,47469,3575896562,3575896574,12
2,1247,47470,3575896562,3575896575,13
2,1247,47471,3575896562,3575896575,13
2,1247,47472,3575896562,3575896575,13
2,1247,47473,3575896562,3575896576,14
2,1247,47474,3575896562,3575896576,14
2,1247,47475,3575896562,3575896577,15
2,1247,47476,3575896562,3575896577,15
2,1247,47477,3575896562,3575896580,18
2,1247,47478,3575896562,3575896580,18
2,1247,47479,3575896562,3575896581,19
2,1247,47480,3575896562,3575896582,20
2,1247,47481,3575896562,3575896583,21
2,1247,47482,3575896562,3575896584,22
2,1247,47483,3575896562,3575896584,22
2,1247,47484,3575896562,3575896585,23
2,1247,47485,3575896562,3575896585,23
2,1247,47486,3575896562,3575896587,25
2,1247,47487,3575896562,3575896588,26
2,1247,47488,3575896562,3575896589,27
2,1247,47489,3575896562,3575896589,27
2,1247,47490,3575896562,3575896589,27
2,1247,47491,3575896562,3575896589,27
2,1247,47492,3575896562,3575896590,28
2,1247,47493,3575896562,3575896590,28
2,1247,47494,3575896562,3575896591,29
2,1247,47495,3575896562,3575896592,30
2,1247,47496,3575896562,3575896593,31
2,1247,47497,3575896562,3575896593,31
2,1247,47498,3575896562,3575896594,32
2,1247,47499,3575896562,3575896594,32
2,1247,47500,3575896562,3575896595,33
2,1247,47501,3575896562,3575896595,33
2,1247,47502,3575896562,3575896595,33
2,1247,47503,3575896562,3575896597,35
2,1247,47504,3575896562,3575896597,35
2,1247,47505,3575896562,3575896597,35
2,1247,47506,3575896562,3575896598,36
2,1247,47507,3575896562,3575896599,37
2,1247,47508,3575896562,3575896600,38
2,1247,47509,3575896562,3575896600,38
2,1247,47510,3575896562,3575896601,39
2,1247,47511,3575896562,3575896602,40
2,1247,47512,3575896562,3575896602,40
2,1247,47513,3575896562,3575896603,41
2,1247,47514,3575896562,3575896604,42
2,1247,47515,3575896562,3575896605,43
2,1247,47516,3575896562,3575896606,44
2,1247,47517,3575896562,3575896608,46
2,1247,47518,3575896562,3575896609,47
2,1247,47519,3575896562,3575896611,49
2,1247,47520,3575896562,3575896612,50
2,1248,47521,3575896626,3575896626,0
2,1248,47522,3575896626,3575896626,0
2,1248,47523,3575896626,3575896626,0
2,1248,47524,3575896626,3575896626,0
2,1248,47525,3575896626,3575896626,0
2,1248,47526,3575896626,3575896626,0
2,1248,47527,3575896626,3575896627,1
2,1248,47528,3575896626,3575896628,2
2,1248,47529,3575896626,3575896629,3
2,1248,47530,3575896626,3575896629,3
2,1248,47531,3575896626,3575896630,4
2,1248,47532,3575896626,3575896630,4
2,1248,47533,3575896626,3575896630,4
2,1248,47534,3575896626,3575896633,7
2,1248,47535,3575896626,3575896634,8
2,1248,47536,3575896626,3575896636,10
2,1248,47537,3575896626,3575896636,10
2,1248,47538,3575896626,3575896636,10
2,1248,47539,3575896626,3575896637,11
2,1248,47540,3575896626,3575896639,13
2,1248,47541,3575896626,3575896639,13
2,1248,47542,3575896626,3575896639,13
2,1248,47543,3575896626,3575896640,14
2,1248,47544,3575896626,3575896640,14
2,1248,47545,3575896626,3575896642,16
2,1248,47546,3575896626,3575896643,17
2,1248,47547,3575896626,3575896643,17
2,1248,47548,3575896626,3575896644,18
2,1248,47549,3575896626,3575896645,19
2,1248,47550,3575896626,3575896646,20
2,1248,47551,3575896626,3575896649,23
2,1248,47552,3575896626,3575896651,25
2,1248,47553,3575896626,3575896653,27
2,1248,47554,3575896626,3575896653,27
2,1248,47555,3575896626,3575896653,27
2,1248,47556,3575896626,3575896654,28
2,1248,47557,3575896626,3575896655,29
2,1248,47558,3575896626,3575896655,29
2,1248,47559,3575896626,3575896655,29
2,1248,47560,3575896626,3575896659,33
2,1248,47561,3575896626,3575896659,33
2,1248,47562,3575896626,3575896660,34
2,1248,47563,3575896626,3575896660,34
2,1248,47564,3575896626,3575896661,35
2,1248,47565,3575896626,3575896662,36
2,1248,47566,3575896626,3575896664,38
2,1248,47567,3575896626,3575896666,40
2,1248,47568,3575896626,3575896666,40
2,1248,47569,3575896626,3575896670,44
2,1248,47570,3575896626,3575896672,46
2,1249,47571,3575896690,3575896690,0
2,1249,47572,3575896690,3575896690,0
2,1249,47573,3575896690,3575896690,0
2,1249,47574,3575896690,3575896690,0
2,1249,47575,3575896690,3575896690,0
2,1249,47576,3575896690,3575896690,0
2,1249,47577,3575896690,3575896690,0
2,1249,47578,3575896690,3575896690,0
2,1249,47579,3575896690,3575896690,0
2,1249,47580,3575896690,3575896690,0
2,1249,47581,3575896690,3575896690,0
2,1249,47582,3575896690,3575896690,0
2,1249,47583,3575896690,3575896691,1
2,1249,47584,3575896690,3575896691,1
2,1249,47585,3575896690,3575896691,1
2,1249,47586,3575896690,3575896692,2
2,1249,47587,3575896690,3575896692,2
2,1249,47588,3575896690,3575896694,4
2,1249,47589,3575896690,3575896694,4
2,1249,47590,3575896690,3575896695,5
2,1249,47591,3575896690,3575896695,5
2,1249,47592,3575896690,3575896695,5
2,1249,47593,3575896690,3575896697,7
2,1249,47594,3575896690,3575896697,7
2,1249,47595,3575896690,3575896699,9
2,1249,47596,3575896690,3575896699,9
2,1249,47597,3575896690,3575896700,10
2,1249,47598,3575896690,3575896701,11
2,1249,47599,3575896690,3575896702,12
2,1249,47600,3575896690,3575896702,12
2,1249,47601,3575896690,3575896703,13
2,1249,47602,3575896690,3575896703,13
2,1249,47603,3575896690,3575896703,13
2,1249,47604,3575896690,3575896704,14
2,1249,47605,3575896690,3575896704,14
2,1249,47606,3575896690,3575896705,15
2,1249,47607,3575896690,3575896705,15
2,1249,47608,3575896690,3575896706,16
2,1249,47609,3575896690,3575896706,16
2,1249,47610,3575896690,3575896707,17
2,1249,47611,3575896690,3575896707,17
2,1249,47612,3575896690,3575896707,17
2,1249,47613,3575896690,3575896709,19
2,1249,47614,3575896690,3575896709,19
2,1249,47615,3575896690,3575896710,20
2,1249,47616,3575896690,3575896710,20
2,1249,47617,3575896690,3575896712,22
2,1249,47618,3575896690,3575896712,22
2,1249,47619,3575896690,3575896713,23
2,1249,47620,3575896690,3575896713,23
2,1249,47621,3575896690,3575896714,24
2,1249,47622,3575896690,3575896714,24
2,1249,47623,3575896690,3575896714,24
2,1249,47624,3575896690,3575896715,25
2,1249,47625,3575896690,3575896715,25
2,1249,47626,3575896690,3575896716,26
2,1249,47627,3575896690,3575896717,27
2,1249,47628,3575896690,3575896717,27
2,1249,47629,3575896690,3575896717,27
2,1249,47630,3575896690,3575896717,27
2,1249,47631,3575896690,3575896718,28
2,1249,47632,3575896690,3575896718,28
2,1249,47633,3575896690,3575896719,29
2,1249,47634,3575896690,3575896720,30
2,1249,47635,3575896690,3575896720,30
2,1249,47636,3575896690,3575896723,33
2,1249,47637,3575896690,3575896724,34
2,1249,47638,3575896690,3575896724,34
2,1249,47639,3575896690,3575896724,34
2,1249,47640,3575896690,3575896727,37
2,1249,47641,3575896690,3575896728,38
2,1249,47642,3575896690,3575896730,40
2,1249,47643,3575896690,3575896730,40
2,1249,47644,3575896690,3575896731,41
2,1249,47645,3575896690,3575896731,41
2,1249,47646,3575896690,3575896731,41
2,1249,47647,3575896690,3575896732,42
2,1249,47648,3575896690,3575896732,42
2,1249,47649,3575896690,3575896733,43
2,1249,47650,3575896690,3575896733,43
2,1249,47651,3575896690,3575896733,43
2,1249,47652,3575896690,3575896734,44
2,1249,47653,3575896690,3575896734,44
2,1249,47654,3575896690,3575896734,44
2,1249,47655,3575896690,3575896735,45
2,1249,47656,3575896690,3575896739,49
2,1249,47657,3575896690,3575896739,49
2,1250,47658,3575896755,3575896755,0
2,1250,47659,3575896755,3575896755,0
2,1250,47660,3575896755,3575896755,0
2,1250,47661,3575896755,3575896755,0
2,1250,47662,3575896755,3575896755,0
2,1250,47663,3575896755,3575896755,0
2,1250,47664,3575896755,3575896755,0
2,1250,47665,3575896755,3575896755,0
2,1250,47666,3575896755,3575896755,0
2,1250,47667,3575896755,3575896755,0
2,1250,47668,3575896755,3575896755,0
2,1250,47669,3575896755,3575896755,0
2,1250,47670,3575896755,3575896755,0
2,1250,47671,3575896755,3575896755,0
2,1250,47672,3575896755,3575896755,0
2,1250,47673,3575896755,3575896755,0
2,1250,47674,3575896755,3575896755,0
2,1250,47675,3575896755,3575896755,0
2,1250,47676,3575896755,3575896755,0
2,1250,47677,3575896755,3575896755,0
2,1250,47678,3575896755,3575896755,0
2,1250,47679,3575896755,3575896755,0
2,1250,47680,3575896755,3575896755,0
2,1250,47681,3575896755,3575896755,0
2,1250,47682,3575896755,3575896756,1
2,1250,47683,3575896755,3575896759,4
2,1250,47684,3575896755,3575896759,4
2,1250,47685,3575896755,3575896759,4
2,1250,47686,3575896755,3575896760,5
2,1250,47687,3575896755,3575896760,5
2,1250,47688,3575896755,3575896760,5
2,1250,47689,3575896755,3575896760,5
2,1250,47690,3575896755,3575896764,9
2,1250,47691,3575896755,3575896764,9
2,1250,47692,3575896755,3575896764,9
2,1250,47693,3575896755,3575896765,10
2,1250,47694,3575896755,3575896765,10
2,1250,47695,3575896755,3575896766,11
2,1250,47696,3575896755,3575896767,12
2,1250,47697,3575896755,3575896767,12
2,1250,47698,3575896755,3575896769,14
2,1250,47699,3575896755,3575896769,14
2,1250,47700,3575896755,3575896769,14
2,1250,47701,3575896755,3575896770,15
2,1250,47702,3575896755,3575896770,15
2,1250,47703,3575896755,3575896772,17
2,1250,47704,3575896755,3575896774,19
2,1250,47705,3575896755,3575896774,19
2,1250,47706,3575896755,3575896774,19
2,1250,47707,3575896755,3575896774,19
2,1250,47708,3575896755,3575896775,20
2,1250,47709,3575896755,3575896775,20
2,1250,47710,3575896755,3575896776,21
2,1250,47711,3575896755,3575896777,22
2,1250,47712,3575896755,3575896778,23
2,1250,47713,3575896755,3575896781,26
2,1250,47714,3575896755,3575896781,26
2,1250,47715,3575896755,3575896782,27
2,1250,47716,3575896755,3575896782,27
2,1250,47717,3575896755,3575896784,29
2,1250,47718,3575896755,3575896785,30
2,1250,47719,3575896755,3575896785,30
2,1250,47720,3575896755,3575896786,31
2,1250,47721,3575896755,3575896788,33
2,1250,47722,3575896755,3575896788,33
2,1250,47723,3575896755,3575896788,33
2,1250,47724,3575896755,3575896789,34
2,1250,47725,3575896755,3575896789,34
2,1250,47726,3575896755,3575896790,35
2,1250,47727,3575896755,3575896790,35
2,1250,47728,3575896755,3575896791,36
2,1250,47729,3575896755,3575896791,36
2,1250,47730,3575896755,3575896792,37
2,1250,47731,3575896755,3575896793,38
2,1250,47732,3575896755,3575896793,38
2,1250,47733,3575896755,3575896794,39
2,1250,47734,3575896755,3575896794,39
2,1250,47735,3575896755,3575896795,40
2,1250,47736,3575896755,3575896795,40
2,1250,47737,3575896755,3575896795,40
2,1250,47738,3575896755,3575896795,40
2,1250,47739,3575896755,3575896797,42
2,1250,47740,3575896755,3575896797,42
2,1250,47741,3575896755,3575896798,43
2,1250,47742,3575896755,3575896799,44
2,1250,47743,3575896755,3575896800,45
2,1250,47744,3575896755,3575896800,45
2,1250,47745,3575896755,3575896801,46
2,1250,47746,3575896755,3575896802,47
2,1250,47747,3575896755,3575896802,47
2,1250,47748,3575896755,3575896802,47
2,1250,47749,3575896755,3575896802,47
2,1250,47750,3575896755,3575896803,48
2,1250,47751,3575896755,3575896805,50
2,1251,47752,3575896818,3575896818,0
2,1251,47753,3575896818,3575896818,0
2,1251,47754,3575896818,3575896818,0
2,1251,47755,3575896818,3575896818,0
2,1251,47756,3575896818,3575896818,0
2,1251,47757,3575896818,3575896818,0
2,1251,47758,3575896818,3575896818,0
2,1251,47759,3575896818,3575896818,0
2,1251,47760,3575896818,3575896819,1
2,1251,47761,3575896818,3575896822,4
2,1251,47762,3575896818,3575896823,5
2,1251,47763,3575896818,3575896823,5
2,1251,47764,3575896818,3575896824,6
2,1251,47765,3575896818,3575896826,8
2,1251,47766,3575896818,3575896826,8
2,1251,47767,3575896818,3575896827,9
2,1251,47768,3575896818,3575896828,10
2,1251,47769,3575896818,3575896829,11
2,1251,47770,3575896818,3575896829,11
2,1251,47771,3575896818,3575896830,12
2,1251,47772,3575896818,3575896831,13
2,1251,47773,3575896818,3575896831,13
2,1251,47774,3575896818,3575896832,14
2,1251,47775,3575896818,3575896833,15
2,1251,47776,3575896818,3575896835,17
2,1251,47777,3575896818,3575896835,17
2,1251,47778,3575896818,3575896836,18
2,1251,47779,3575896818,3575896836,18
2,1251,47780,3575896818,3575896837,19
2,1251,47781,3575896818,3575896839,21
2,1251,47782,3575896818,3575896840,22
2,1251,47783,3575896818,3575896840,22
2,1251,47784,3575896818,3575896840,22
2,1251,47785,3575896818,3575896840,22
2,1251,47786,3575896818,3575896842,24
2,1251,47787,3575896818,3575896843,25
2,1251,47788,3575896818,3575896843,25
2,1251,47789,3575896818,3575896843,25
2,1251,47790,3575896818,3575896845,27
2,1251,47791,3575896818,3575896846,28
2,1251,47792,3575896818,3575896847,29
2,1251,47793,3575896818,3575896849,31
2,1251,47794,3575896818,3575896852,34
2,1251,47795,3575896818,3575896854,36
2,1251,47796,3575896818,3575896854,36
2,1251,47797,3575896818,3575896854,36
2,1251,47798,3575896818,3575896854,36
2,1251,47799,3575896818,3575896855,37
2,1251,47800,3575896818,3575896855,37
2,1251,47801,3575896818,3575896859,41
2,1251,47802,3575896818,3575896859,41
2,1251,47803,3575896818,3575896861,43
2,1251,47804,3575896818,3575896861,43
2,1251,47805,3575896818,3575896861,43
2,1251,47806,3575896818,3575896864,46
2,1251,47807,3575896818,3575896866,48
2,1251,47808,3575896818,3575896866,48
2,1252,47809,3575896884,3575896884,0
2,1252,47810,3575896884,3575896884,0
2,1252,47811,3575896884,3575896884,0
2,1252,47812,3575896884,3575896884,0
2,1252,47813,3575896884,3575896884,0
2,1252,47814,3575896884,3575896884,0
2,1252,47815,3575896884,3575896886,2
2,1252,47816,3575896884,3575896886,2
2,1252,47817,3575896884,3575896889,5
2,1252,47818,3575896884,3575896890,6
2,1252,47819,3575896884,3575896890,6
2,1252,47820,3575896884,3575896891,7
2,1252,47821,3575896884,3575896892,8
2,1252,47822,3575896884,3575896892,8
2,1252,47823,3575896884,3575896892,8
2,1252,47824,3575896884,3575896892,8
2,1252,47825,3575896884,3575896893,9
2,1252,47826,3575896884,3575896893,9
2,1252,47827,3575896884,3575896894,10
2,1252,47828,3575896884,3575896895,11
2,1252,47829,3575896884,3575896895,11
2,1252,47830,3575896884,3575896895,11
2,1252,47831,3575896884,3575896896,12
2,1252,47832,3575896884,3575896897,13
2,1252,47833,3575896884,3575896898,14
2,1252,47834,3575896884,3575896898,14
2,1252,47835,3575896884,3575896899,15
2,1252,47836,3575896884,3575896899,15
2,1252,47837,3575896884,3575896900,16
2,1252,47838,3575896884,3575896902,18
2,1252,47839,3575896884,3575896903,19
2,1252,47840,3575896884,3575896903,19
2,1252,47841,3575896884,3575896903,19
2,1252,47842,3575896884,3575896903,19
2,1252,47843,3575896884,3575896904,20
2,1252,47844,3575896884,3575896904,20
2,1252,47845,3575896884,3575896906,22
2,1252,47846,3575896884,3575896906,22
2,1252,47847,3575896884,3575896906,22
2,1252,47848,3575896884,3575896907,23
2,1252,47849,3575896884,3575896907,23
2,1252,47850,3575896884,3575896907,23
2,1252,47851,3575896884,3575896907,23
2,1252,47852,3575896884,3575896907,23
2,1252,47853,3575896884,3575896908,24
2,1252,47854,3575896884,3575896910,26
2,1252,47855,3575896884,3575896910,26
2,1252,47856,3575896884,3575896910,26
2,1252,47857,3575896884,3575896911,27
2,1252,47858,3575896884,3575896912,28
2,1252,47859,3575896884,3575896912,28
2,1252,47860,3575896884,3575896913,29
2,1252,47861,3575896884,3575896913,29
2,1252,47862,3575896884,3575896914,30
2,1252,47863,3575896884,3575896915,31
2,1252,47864,3575896884,3575896915,31
2,1252,47865,3575896884,3575896915,31
2,1252,47866,3575896884,3575896916,32
2,1252,47867,3575896884,3575896916,32
2,1252,47868,3575896884,3575896917,33
2,1252,47869,3575896884,3575896917,33
2,1252,47870,3575896884,3575896918,34
2,1252,47871,3575896884,3575896918,34
2,1252,47872,3575896884,3575896919,35
2,1252,47873,3575896884,3575896919,35
2,1252,47874,3575896884,3575896921,37
2,1252,47875,3575896884,3575896921,37
2,1252,47876,3575896884,3575896923,39
2,1252,47877,3575896884,3575896923,39
2,1252,47878,3575896884,3575896925,41
2,1252,47879,3575896884,3575896925,41
2,1252,47880,3575896884,3575896926,42
2,1252,47881,3575896884,3575896927,43
2,1252,47882,3575896884,3575896928,44
2,1252,47883,3575896884,3575896929,45
2,1252,47884,3575896884,3575896930,46
2,1252,47885,3575896884,3575896931,47
2,1252,47886,3575896884,3575896931,47
2,1252,47887,3575896884,3575896931,47
2,1252,47888,3575896884,3575896931,47
2,1252,47889,3575896884,3575896933,49
2,1252,47890,3575896884,3575896933,49
2,1252,47891,3575896884,3575896934,50
2,1253,47892,3575896946,3575896946,0
2,1253,47893,3575896946,3575896946,0
2,1253,47894,3575896946,3575896946,0
2,1253,47895,3575896946,3575896946,0
2,1253,47896,3575896946,3575896946,0
2,1253,47897,3575896946,3575896946,0
2,1253,47898,3575896946,3575896946,0
2,1253,47899,3575896946,3575896946,0
2,1253,47900,3575896946,3575896946,0
2,1253,47901,3575896946,3575896946,0
2,1253,47902,3575896946,3575896946,0
2,1253,47903,3575896946,3575896946,0
2,1253,47904,3575896946,3575896946,0
2,1253,47905,3575896946,3575896946,0
2,1253,47906,3575896946,3575896947,1
2,1253,47907,3575896946,3575896947,1
2,1253,47908,3575896946,3575896948,2
2,1253,47909,3575896946,3575896949,3
2,1253,47910,3575896946,3575896949,3
2,1253,47911,3575896946,3575896950,4
2,1253,47912,3575896946,3575896950,4
2,1253,47913,3575896946,3575896951,5
2,1253,47914,3575896946,3575896951,5
2,1253,47915,3575896946,3575896952,6
2,1253,47916,3575896946,3575896952,6
2,1253,47917,3575896946,3575896952,6
2,1253,47918,3575896946,3575896954,8
2,1253,47919,3575896946,3575896954,8
2,1253,47920,3575896946,3575896955,9
2,1253,47921,3575896946,3575896959,13
2,1253,47922,3575896946,3575896959,13
2,1253,47923,3575896946,3575896960,14
2,1253,47924,3575896946,3575896960,14
2,1253,47925,3575896946,3575896960,14
2,1253,47926,3575896946,3575896960,14
2,1253,47927,3575896946,3575896961,15
2,1253,47928,3575896946,3575896964,18
2,1253,47929,3575896946,3575896965,19
2,1253,47930,3575896946,3575896965,19
2,1253,47931,3575896946,3575896965,19
2,1253,47932,3575896946,3575896965,19
2,1253,47933,3575896946,3575896966,20
2,1253,47934,3575896946,3575896966,20
2,1253,47935,3575896946,3575896967,21
2,1253,47936,3575896946,3575896967,21
2,1253,47937,3575896946,3575896968,22
2,1253,47938,3575896946,3575896968,22
2,1253,47939,3575896946,3575896969,23
2,1253,47940,3575896946,3575896969,23
2,1253,47941,3575896946,3575896970,24
2,1253,47942,3575896946,3575896970,24
2,1253,47943,3575896946,3575896974,28
2,1253,47944,3575896946,3575896975,29
2,1253,47945,3575896946,3575896975,29
2,1253,47946,3575896946,3575896975,29
2,1253,47947,3575896946,3575896977,31
2,1253,47948,3575896946,3575896977,31
2,1253,47949,3575896946,3575896978,32
2,1253,47950,3575896946,3575896981,35
2,1253,47951,3575896946,3575896982,36
2,1253,47952,3575896946,3575896982,36
2,1253,47953,3575896946,3575896983,37
2,1253,47954,3575896946,3575896985,39
2,1253,47955,3575896946,3575896986,40
2,1253,47956,3575896946,3575896986,40
2,1253,47957,3575896946,3575896988,42
2,1253,47958,3575896946,3575896988,42
2,1253,47959,3575896946,3575896989,43
2,1253,47960,3575896946,3575896989,43
2,1253,47961,3575896946,3575896990,44
2,1253,47962,3575896946,3575896990,44
2,1253,47963,3575896946,3575896991,45
2,1253,47964,3575896946,3575896991,45
2,1253,47965,3575896946,3575896993,47
2,1253,47966,3575896946,3575896994,48
2,1253,47967,3575896946,3575896994,48
2,1253,47968,3575896946,3575896994,48
2,1253,47969,3575896946,3575896995,49
2,1253,47970,3575896946,3575896995,49
2,1253,47971,3575896946,3575896995,49
2,1253,47972,3575896946,3575896996,50
2,1254,47973,3575897014,3575897014,0
2,1254,47974,3575897014,3575897014,0
2,1254,47975,3575897014,3575897014,0
2,1254,47976,3575897014,3575897014,0
2,1254,47977,3575897014,3575897014,0
2,1254,47978,3575897014,3575897014,0
2,1254,47979,3575897014,3575897014,0
2,1254,47980,3575897014,3575897014,0
2,1254,47981,3575897014,3575897014,0
2,1254,47982,3575897014,3575897014,0
2,1254,47983,3575897014,3575897014,0
2,1254,47984,3575897014,3575897014,0
2,1254,47985,3575897014,3575897014,0
2,1254,47986,3575897014,3575897014,0
2,1254,47987,3575897014,3575897014,0
2,1254,47988,3575897014,3575897014,0
2,1254,47989,3575897014,3575897014,0
2,1254,47990,3575897014,3575897014,0
2,1254,47991,3575897014,3575897014,0
2,1254,47992,3575897014,3575897014,0
2,1254,47993,3575897014,3575897014,0
2,1254,47994,3575897014,3575897022,8
2,1254,47995,3575897014,3575897022,8
2,1254,47996,3575897014,3575897022,8
2,1254,47997,3575897014,3575897026,12
2,1254,47998,3575897014,3575897027,13
2,1254,47999,3575897014,3575897029,15
2,1254,48000,3575897014,3575897029,15
2,1254,48001,3575897014,3575897030,16
2,1254,48002,3575897014,3575897031,17
2,1254,48003,3575897014,3575897031,17
2,1254,48004,3575897014,3575897032,18
2,1254,48005,3575897014,3575897033,19
2,1254,48006,3575897014,3575897036,22
2,1254,48007,3575897014,3575897036,22
2,1254,48008,3575897014,3575897036,22
2,1254,48009,3575897014,3575897036,22
2,1254,48010,3575897014,3575897039,25
2,1254,48011,3575897014,3575897040,26
2,1254,48012,3575897014,3575897040,26
2,1254,48013,3575897014,3575897040,26
2,1254,48014,3575897014,3575897041,27
2,1254,48015,3575897014,3575897043,29
2,1254,48016,3575897014,3575897043,29
2,1254,48017,3575897014,3575897044,30
2,1254,48018,3575897014,3575897044,30
2,1254,48019,3575897014,3575897045,31
2,1254,48020,3575897014,3575897047,33
2,1254,48021,3575897014,3575897048,34
2,1254,48022,3575897014,3575897049,35
2,1254,48023,3575897014,3575897053,39
2,1254,48024,3575897014,3575897053,39
2,1254,48025,3575897014,3575897053,39
2,1254,48026,3575897014,3575897054,40
2,1254,48027,3575897014,3575897054,40
2,1254,48028,3575897014,3575897056,42
2,1254,48029,3575897014,3575897056,42
2,1254,48030,3575897014,3575897059,45
2,1254,48031,3575897014,3575897060,46
2,1254,48032,3575897014,3575897060,46
2,1254,48033,3575897014,3575897060,46
2,1254,48034,3575897014,3575897061,47
2,1254,48035,3575897014,3575897063,49
2,1254,48036,3575897014,3575897064,50
2,1255,48037,3575897078,3575897078,0
2,1255,48038,3575897078,3575897078,0
2,1255,48039,3575897078,3575897078,0
2,1255,48040,3575897078,3575897078,0
2,1255,48041,3575897078,3575897081,3
2,1255,48042,3575897078,3575897083,5
2,1255,48043,3575897078,3575897084,6
2,1255,48044,3575897078,3575897086,8
2,1255,48045,3575897078,3575897086,8
2,1255,48046,3575897078,3575897086,8
2,1255,48047,3575897078,3575897087,9
2,1255,48048,3575897078,3575897089,11
2,1255,48049,3575897078,3575897089,11
2,1255,48050,3575897078,3575897090,12
2,1255,48051,3575897078,3575897090,12
2,1255,48052,3575897078,3575897090,12
2,1255,48053,3575897078,3575897092,14
2,1255,48054,3575897078,3575897092,14
2,1255,48055,3575897078,3575897092,14
2,1255,48056,3575897078,3575897092,14
2,1255,48057,3575897078,3575897093,15
2,1255,48058,3575897078,3575897093,15
2,1255,48059,3575897078,3575897094,16
2,1255,48060,3575897078,3575897095,17
2,1255,48061,3575897078,3575897096,18
2,1255,48062,3575897078,3575897096,18
2,1255,48063,3575897078,3575897098,20
2,1255,48064,3575897078,3575897098,20
2,1255,48065,3575897078,3575897098,20
2,1255,48066,3575897078,3575897098,20
2,1255,48067,3575897078,3575897099,21
2,1255,48068,3575897078,3575897102,24
2,1255,48069,3575897078,3575897102,24
2,1255,48070,3575897078,3575897102,24
2,1255,48071,3575897078,3575897103,25
2,1255,48072,3575897078,3575897103,25
2,1255,48073,3575897078,3575897103,25
2,1255,48074,3575897078,3575897104,26
2,1255,48075,3575897078,3575897104,26
2,1255,48076,3575897078,3575897105,27
2,1255,48077,3575897078,3575897106,28
2,1255,48078,3575897078,3575897106,28
2,1255,48079,3575897078,3575897107,29
2,1255,48080,3575897078,3575897107,29
2,1255,48081,3575897078,3575897107,29
2,1255,48082,3575897078,3575897107,29
2,1255,48083,3575897078,3575897109,31
2,1255,48084,3575897078,3575897109,31
2,1255,48085,3575897078,3575897110,32
2,1255,48086,3575897078,3575897111,33
2,1255,48087,3575897078,3575897111,33
2,1255,48088,3575897078,3575897112,34
2,1255,48089,3575897078,3575897113,35
2,1255,48090,3575897078,3575897113,35
2,1255,48091,3575897078,3575897114,36
2,1255,48092,3575897078,3575897115,37
2,1255,48093,3575897078,3575897115,37
2,1255,48094,3575897078,3575897116,38
2,1255,48095,3575897078,3575897116,38
2,1255,48096,3575897078,3575897117,39
2,1255,48097,3575897078,3575897117,39
2,1255,48098,3575897078,3575897118,40
2,1255,48099,3575897078,3575897118,40
2,1255,48100,3575897078,3575897119,41
2,1255,48101,3575897078,3575897119,41
2,1255,48102,3575897078,3575897119,41
2,1255,48103,3575897078,3575897123,45
2,1255,48104,3575897078,3575897124,46
2,1255,48105,3575897078,3575897126,48
2,1255,48106,3575897078,3575897126,48
2,1255,48107,3575897078,3575897127,49
2,1255,48108,3575897078,3575897127,49
2,1256,48109,3575897142,3575897142,0
2,1256,48110,3575897142,3575897142,0
2,1256,48111,3575897142,3575897142,0
2,1256,48112,3575897142,3575897142,0
2,1256,48113,3575897142,3575897142,0
2,1256,48114,3575897142,3575897142,0
2,1256,48115,3575897142,3575897142,0
2,1256,48116,3575897142,3575897142,0
2,1256,48117,3575897142,3575897142,0
2,1256,48118,3575897142,3575897142,0
2,1256,48119,3575897142,3575897142,0
2,1256,48120,3575897142,3575897142,0
2,1256,48121,3575897142,3575897142,0
2,1256,48122,3575897142,3575897142,0
2,1256,48123,3575897142,3575897142,0
2,1256,48124,3575897142,3575897142,0
2,1256,48125,3575897142,3575897143,1
2,1256,48126,3575897142,3575897145,3
2,1256,48127,3575897142,3575897145,3
2,1256,48128,3575897142,3575897145,3
2,1256,48129,3575897142,3575897145,3
2,1256,48130,3575897142,3575897145,3
2,1256,48131,3575897142,3575897146,4
2,1256,48132,3575897142,3575897147,5
2,1256,48133,3575897142,3575897147,5
2,1256,48134,3575897142,3575897148,6
2,1256,48135,3575897142,3575897148,6
2,1256,48136,3575897142,3575897149,7
2,1256,48137,3575897142,3575897150,8
2,1256,48138,3575897142,3575897150,8
2,1256,48139,3575897142,3575897150,8
2,1256,48140,3575897142,3575897151,9
2,1256,48141,3575897142,3575897151,9
2,1256,48142,3575897142,3575897151,9
2,1256,48143,3575897142,3575897152,10
2,1256,48144,3575897142,3575897152,10
2,1256,48145,3575897142,3575897152,10
2,1256,48146,3575897142,3575897154,12
2,1256,48147,3575897142,3575897154,12
2,1256,48148,3575897142,3575897155,13
2,1256,48149,3575897142,3575897157,15
2,1256,48150,3575897142,3575897159,17
2,1256,48151,3575897142,3575897159,17
2,1256,48152,3575897142,3575897159,17
2,1256,48153,3575897142,3575897160,18
2,1256,48154,3575897142,3575897160,18
2,1256,48155,3575897142,3575897161,19
2,1256,48156,3575897142,3575897161,19
2,1256,48157,3575897142,3575897164,22
2,1256,48158,3575897142,3575897165,23
2,1256,48159,3575897142,3575897165,23
2,1256,48160,3575897142,3575897165,23
2,1256,48161,3575897142,3575897165,23
2,1256,48162,3575897142,3575897166,24
2,1256,48163,3575897142,3575897167,25
2,1256,48164,3575897142,3575897167,25
2,1256,48165,3575897142,3575897168,26
2,1256,48166,3575897142,3575897168,26
2,1256,48167,3575897142,3575897168,26
2,1256,48168,3575897142,3575897170,28
2,1256,48169,3575897142,3575897170,28
2,1256,48170,3575897142,3575897170,28
2,1256,48171,3575897142,3575897171,29
2,1256,48172,3575897142,3575897173,31
2,1256,48173,3575897142,3575897175,33
2,1256,48174,3575897142,3575897175,33
2,1256,48175,3575897142,3575897176,34
2,1256,48176,3575897142,3575897177,35
2,1256,48177,3575897142,3575897177,35
2,1256,48178,3575897142,3575897178,36
2,1256,48179,3575897142,3575897180,38
2,1256,48180,3575897142,3575897181,39
2,1256,48181,3575897142,3575897182,40
2,1256,48182,3575897142,3575897182,40
2,1256,48183,3575897142,3575897184,42
2,1256,48184,3575897142,3575897184,42
2,1256,48185,3575897142,3575897185,43
2,1256,48186,3575897142,3575897185,43
2,1256,48187,3575897142,3575897186,44
2,1256,48188,3575897142,3575897187,45
2,1256,48189,3575897142,3575897188,46
2,1256,48190,3575897142,3575897188,46
2,1256,48191,3575897142,3575897189,47
2,1256,48192,3575897142,3575897189,47
2,1256,48193,3575897142,3575897189,47
2,1256,48194,3575897142,3575897191,49
2,1256,48195,3575897142,3575897191,49
2,1257,48196,3575897209,3575897209,0
2,1257,48197,3575897209,3575897209,0
2,1257,48198,3575897209,3575897209,0
2,1257,48199,3575897209,3575897209,0
2,1257,48200,3575897209,3575897209,0
2,1257,48201,3575897209,3575897209,0
2,1257,48202,3575897209,3575897209,0
2,1257,48203,3575897209,3575897209,0
2,1257,48204,3575897209,3575897209,0
2,1257,48205,3575897209,3575897209,0
2,1257,48206,3575897209,3575897209,0
2,1257,48207,3575897209,3575897209,0
2,1257,48208,3575897209,3575897209,0
2,1257,48209,3575897209,3575897209,0
2,1257,48210,3575897209,3575897209,0
2,1257,48211,3575897209,3575897209,0
2,1257,48212,3575897209,3575897209,0
2,1257,48213,3575897209,3575897209,0
2,1257,48214,3575897209,3575897209,0
2,1257,48215,3575897209,3575897209,0
2,1257,48216,3575897209,3575897209,0
2,1257,48217,3575897209,3575897209,0
2,1257,48218,3575897209,3575897209,0
2,1257,48219,3575897209,3575897210,1
2,1257,48220,3575897209,3575897211,2
2,1257,48221,3575897209,3575897213,4
2,1257,48222,3575897209,3575897213,4
2,1257,48223,3575897209,3575897214,5
2,1257,48224,3575897209,3575897220,11
2,1257,48225,3575897209,3575897222,13
2,1257,48226,3575897209,3575897222,13
2,1257,48227,3575897209,3575897222,13
2,1257,48228,3575897209,3575897226,17
2,1257,48229,3575897209,3575897227,18
2,1257,48230,3575897209,3575897227,18
2,1257,48231,3575897209,3575897229,20
2,1257,48232,3575897209,3575897229,20
2,1257,48233,3575897209,3575897229,20
2,1257,48234,3575897209,3575897230,21
2,1257,48235,3575897209,3575897232,23
2,1257,48236,3575897209,3575897232,23
2,1257,48237,3575897209,3575897232,23
2,1257,48238,3575897209,3575897232,23
2,1257,48239,3575897209,3575897233,24
2,1257,48240,3575897209,3575897236,27
2,1257,48241,3575897209,3575897236,27
2,1257,48242,3575897209,3575897237,28
2,1257,48243,3575897209,3575897239,30
2,1257,48244,3575897209,3575897240,31
2,1257,48245,3575897209,3575897240,31
2,1257,48246,3575897209,3575897241,32
2,1257,48247,3575897209,3575897241,32
2,1257,48248,3575897209,3575897243,34
2,1257,48249,3575897209,3575897244,35
2,1257,48250,3575897209,3575897245,36
2,1257,48251,3575897209,3575897245,36
2,1257,48252,3575897209,3575897248,39
2,1257,48253,3575897209,3575897248,39
2,1257,48254,3575897209,3575897249,40
2,1257,48255,3575897209,3575897253,44
2,1257,48256,3575897209,3575897254,45
2,1257,48257,3575897209,3575897254,45
2,1257,48258,3575897209,3575897255,46
2,1257,48259,3575897209,3575897255,46
2,1257,48260,3575897209,3575897256,47
2,1257,48261,3575897209,3575897256,47
2,1257,48262,3575897209,3575897259,50
2,1258,48263,3575897271,3575897271,0
2,1258,48264,3575897271,3575897272,1
2,1258,48265,3575897271,3575897272,1
2,1258,48266,3575897271,3575897272,1
2,1258,48267,3575897271,3575897272,1
2,1258,48268,3575897271,3575897272,1
2,1258,48269,3575897271,3575897272,1
2,1258,48270,3575897271,3575897272,1
2,1258,48271,3575897271,3575897272,1
2,1258,48272,3575897271,3575897276,5
2,1258,48273,3575897271,3575897281,10
2,1258,48274,3575897271,3575897284,13
2,1258,48275,3575897271,3575897285,14
2,1258,48276,3575897271,3575897286,15
2,1258,48277,3575897271,3575897286,15
2,1258,48278,3575897271,3575897286,15
2,1258,48279,3575897271,3575897289,18
2,1258,48280,3575897271,3575897290,19
2,1258,48281,3575897271,3575897290,19
2,1258,48282,3575897271,3575897290,19
2,1258,48283,3575897271,3575897292,21
2,1258,48284,3575897271,3575897292,21
2,1258,48285,3575897271,3575897292,21
2,1258,48286,3575897271,3575897292,21
2,1258,48287,3575897271,3575897293,22
2,1258,48288,3575897271,3575897293,22
2,1258,48289,3575897271,3575897294,23
2,1258,48290,3575897271,3575897295,24
2,1258,48291,3575897271,3575897295,24
2,1258,48292,3575897271,3575897295,24
2,1258,48293,3575897271,3575897296,25
2,1258,48294,3575897271,3575897297,26
2,1258,48295,3575897271,3575897298,27
2,1258,48296,3575897271,3575897298,27
2,1258,48297,3575897271,3575897299,28
2,1258,48298,3575897271,3575897299,28
2,1258,48299,3575897271,3575897302,31
2,1258,48300,3575897271,3575897302,31
2,1258,48301,3575897271,3575897303,32
2,1258,48302,3575897271,3575897303,32
2,1258,48303,3575897271,3575897303,32
2,1258,48304,3575897271,3575897303,32
2,1258,48305,3575897271,3575897304,33
2,1258,48306,3575897271,3575897304,33
2,1258,48307,3575897271,3575897305,34
2,1258,48308,3575897271,3575897306,35
2,1258,48309,3575897271,3575897307,36
2,1258,48310,3575897271,3575897307,36
2,1258,48311,3575897271,3575897307,36
2,1258,48312,3575897271,3575897307,36
2,1258,48313,3575897271,3575897308,37
2,1258,48314,3575897271,3575897308,37
2,1258,48315,3575897271,3575897309,38
2,1258,48316,3575897271,3575897310,39
2,1258,48317,3575897271,3575897311,40
2,1258,48318,3575897271,3575897312,41
2,1258,48319,3575897271,3575897313,42
2,1258,48320,3575897271,3575897313,42
2,1258,48321,3575897271,3575897313,42
2,1258,48322,3575897271,3575897313,42
2,1258,48323,3575897271,3575897315,44
2,1258,48324,3575897271,3575897316,45
2,1258,48325,3575897271,3575897316,45
2,1258,48326,3575897271,3575897316,45
2,1258,48327,3575897271,3575897316,45
2,1258,48328,3575897271,3575897316,45
2,1258,48329,3575897271,3575897317,46
2,1258,48330,3575897271,3575897317,46
2,1258,48331,3575897271,3575897318,47
2,1258,48332,3575897271,3575897318,47
2,1258,48333,3575897271,3575897319,48
2,1258,48334,3575897271,3575897319,48
2,1258,48335,3575897271,3575897321,50
2,1259,48336,3575897337,3575897337,0
2,1259,48337,3575897337,3575897337,0
2,1259,48338,3575897337,3575897337,0
2,1259,48339,3575897337,3575897337,0
2,1259,48340,3575897337,3575897337,0
2,1259,48341,3575897337,3575897337,0
2,1259,48342,3575897337,3575897337,0
2,1259,48343,3575897337,3575897337,0
2,1259,48344,3575897337,3575897337,0
2,1259,48345,3575897337,3575897337,0
2,1259,48346,3575897337,3575897337,0
2,1259,48347,3575897337,3575897337,0
2,1259,48348,3575897337,3575897337,0
2,1259,48349,3575897337,3575897337,0
2,1259,48350,3575897337,3575897337,0
2,1259,48351,3575897337,3575897337,0
2,1259,48352,3575897337,3575897337,0
2,1259,48353,3575897337,3575897337,0
2,1259,48354,3575897337,3575897339,2
2,1259,48355,3575897337,3575897340,3
2,1259,48356,3575897337,3575897343,6
2,1259,48357,3575897337,3575897344,7
2,1259,48358,3575897337,3575897344,7
2,1259,48359,3575897337,3575897344,7
2,1259,48360,3575897337,3575897345,8
2,1259,48361,3575897337,3575897345,8
2,1259,48362,3575897337,3575897347,10
2,1259,48363,3575897337,3575897348,11
2,1259,48364,3575897337,3575897348,11
2,1259,48365,3575897337,3575897349,12
2,1259,48366,3575897337,3575897349,12
2,1259,48367,3575897337,3575897350,13
2,1259,48368,3575897337,3575897350,13
2,1259,48369,3575897337,3575897350,13
2,1259,48370,3575897337,3575897351,14
2,1259,48371,3575897337,3575897352,15
2,1259,48372,3575897337,3575897352,15
2,1259,48373,3575897337,3575897353,16
2,1259,48374,3575897337,3575897353,16
2,1259,48375,3575897337,3575897354,17
2,1259,48376,3575897337,3575897356,19
2,1259,48377,3575897337,3575897358,21
2,1259,48378,3575897337,3575897359,22
2,1259,48379,3575897337,3575897359,22
2,1259,48380,3575897337,3575897360,23
2,1259,48381,3575897337,3575897360,23
2,1259,48382,3575897337,3575897360,23
2,1259,48383,3575897337,3575897361,24
2,1259,48384,3575897337,3575897362,25
2,1259,48385,3575897337,3575897364,27
2,1259,48386,3575897337,3575897365,28
2,1259,48387,3575897337,3575897365,28
2,1259,48388,3575897337,3575897366,29
2,1259,48389,3575897337,3575897366,29
2,1259,48390,3575897337,3575897366,29
2,1259,48391,3575897337,3575897366,29
2,1259,48392,3575897337,3575897368,31
2,1259,48393,3575897337,3575897368,31
2,1259,48394,3575897337,3575897368,31
2,1259,48395,3575897337,3575897368,31
2,1259,48396,3575897337,3575897369,32
2,1259,48397,3575897337,3575897370,33
2,1259,48398,3575897337,3575897370,33
2,1259,48399,3575897337,3575897370,33
2,1259,48400,3575897337,3575897371,34
2,1259,48401,3575897337,3575897373,36
2,1259,48402,3575897337,3575897374,37
2,1259,48403,3575897337,3575897375,38
2,1259,48404,3575897337,3575897376,39
2,1259,48405,3575897337,3575897376,39
2,1259,48406,3575897337,3575897377,40
2,1259,48407,3575897337,3575897377,40
2,1259,48408,3575897337,3575897377,40
2,1259,48409,3575897337,3575897378,41
2,1259,48410,3575897337,3575897380,43
2,1259,48411,3575897337,3575897382,45
2,1259,48412,3575897337,3575897382,45
2,1259,48413,3575897337,3575897382,45
2,1259,48414,3575897337,3575897384,47
2,1259,48415,3575897337,3575897384,47
2,1259,48416,3575897337,3575897385,48
2,1259,48417,3575897337,3575897385,48
2,1259,48418,3575897337,3575897386,49
2,1260,48419,3575897402,3575897402,0
2,1260,48420,3575897402,3575897402,0
2,1260,48421,3575897402,3575897402,0
2,1260,48422,3575897402,3575897402,0
2,1260,48423,3575897402,3575897402,0
2,1260,48424,3575897402,3575897402,0
2,1260,48425,3575897402,3575897402,0
2,1260,48426,3575897402,3575897402,0
2,1260,48427,3575897402,3575897402,0
2,1260,48428,3575897402,3575897402,0
2,1260,48429,3575897402,3575897402,0
2,1260,48430,3575897402,3575897402,0
2,1260,48431,3575897402,3575897402,0
2,1260,48432,3575897402,3575897402,0
2,1260,48433,3575897402,3575897402,0
2,1260,48434,3575897402,3575897402,0
2,1260,48435,3575897402,3575897402,0
2,1260,48436,3575897402,3575897402,0
2,1260,48437,3575897402,3575897402,0
2,1260,48438,3575897402,3575897402,0
2,1260,48439,3575897402,3575897402,0
2,1260,48440,3575897402,3575897402,0
2,1260,48441,3575897402,3575897402,0
2,1260,48442,3575897402,3575897403,1
2,1260,48443,3575897402,3575897404,2
2,1260,48444,3575897402,3575897404,2
2,1260,48445,3575897402,3575897404,2
2,1260,48446,3575897402,3575897405,3
2,1260,48447,3575897402,3575897406,4
2,1260,48448,3575897402,3575897408,6
2,1260,48449,3575897402,3575897409,7
2,1260,48450,3575897402,3575897410,8
2,1260,48451,3575897402,3575897411,9
2,1260,48452,3575897402,3575897413,11
2,1260,48453,3575897402,3575897413,11
2,1260,48454,3575897402,3575897423,21
2,1260,48455,3575897402,3575897423,21
2,1260,48456,3575897402,3575897424,22
2,1260,48457,3575897402,3575897427,25
2,1260,48458,3575897402,3575897427,25
2,1260,48459,3575897402,3575897429,27
2,1260,48460,3575897402,3575897429,27
2,1260,48461,3575897402,3575897430,28
2,1260,48462,3575897402,3575897430,28
2,1260,48463,3575897402,3575897432,30
2,1260,48464,3575897402,3575897432,30
2,1260,48465,3575897402,3575897432,30
2,1260,48466,3575897402,3575897433,31
2,1260,48467,3575897402,3575897433,31
2,1260,48468,3575897402,3575897436,34
2,1260,48469,3575897402,3575897436,34
2,1260,48470,3575897402,3575897438,36
2,1260,48471,3575897402,3575897439,37
2,1260,48472,3575897402,3575897440,38
2,1260,48473,3575897402,3575897440,38
2,1260,48474,3575897402,3575897441,39
2,1260,48475,3575897402,3575897441,39
2,1260,48476,3575897402,3575897443,41
2,1260,48477,3575897402,3575897444,42
2,1260,48478,3575897402,3575897445,43
2,1260,48479,3575897402,3575897445,43
2,1260,48480,3575897402,3575897445,43
2,1260,48481,3575897402,3575897447,45
2,1260,48482,3575897402,3575897447,45
2,1261,48483,3575897468,3575897468,0
2,1261,48484,3575897468,3575897468,0
2,1261,48485,3575897468,3575897468,0
2,1261,48486,3575897468,3575897468,0
2,1261,48487,3575897468,3575897468,0
2,1261,48488,3575897468,3575897468,0
2,1261,48489,3575897468,3575897468,0
2,1261,48490,3575897468,3575897468,0
2,1261,48491,3575897468,3575897468,0
2,1261,48492,3575897468,3575897468,0
2,1261,48493,3575897468,3575897468,0
2,1261,48494,3575897468,3575897468,0
2,1261,48495,3575897468,3575897468,0
2,1261,48496,3575897468,3575897468,0
2,1261,48497,3575897468,3575897468,0
2,1261,48498,3575897468,3575897468,0
2,1261,48499,3575897468,3575897468,0
2,1261,48500,3575897468,3575897468,0
2,1261,48501,3575897468,3575897468,0
2,1261,48502,3575897468,3575897472,4
2,1261,48503,3575897468,3575897473,5
2,1261,48504,3575897468,3575897476,8
2,1261,48505,3575897468,3575897477,9
2,1261,48506,3575897468,3575897481,13
2,1261,48507,3575897468,3575897484,16
2,1261,48508,3575897468,3575897485,17
2,1261,48509,3575897468,3575897486,18
2,1261,48510,3575897468,3575897486,18
2,1261,48511,3575897468,3575897488,20
2,1261,48512,3575897468,3575897490,22
2,1261,48513,3575897468,3575897490,22
2,1261,48514,3575897468,3575897491,23
2,1261,48515,3575897468,3575897491,23
2,1261,48516,3575897468,3575897492,24
2,1261,48517,3575897468,3575897492,24
2,1261,48518,3575897468,3575897492,24
2,1261,48519,3575897468,3575897493,25
2,1261,48520,3575897468,3575897493,25
2,1261,48521,3575897468,3575897493,25
2,1261,48522,3575897468,3575897494,26
2,1261,48523,3575897468,3575897495,27
2,1261,48524,3575897468,3575897495,27
2,1261,48525,3575897468,3575897496,28
2,1261,48526,3575897468,3575897497,29
2,1261,48527,3575897468,3575897497,29
2,1261,48528,3575897468,3575897498,30
2,1261,48529,3575897468,3575897498,30
2,1261,48530,3575897468,3575897499,31
2,1261,48531,3575897468,3575897499,31
2,1261,48532,3575897468,3575897501,33
2,1261,48533,3575897468,3575897502,34
2,1261,48534,3575897468,3575897503,35
2,1261,48535,3575897468,3575897503,35
2,1261,48536,3575897468,3575897503,35
2,1261,48537,3575897468,3575897504,36
2,1261,48538,3575897468,3575897504,36
2,1261,48539,3575897468,3575897505,37
2,1261,48540,3575897468,3575897506,38
2,1261,48541,3575897468,3575897506,38
2,1261,48542,3575897468,3575897507,39
2,1261,48543,3575897468,3575897507,39
2,1261,48544,3575897468,3575897507,39
2,1261,48545,3575897468,3575897508,40
2,1261,48546,3575897468,3575897508,40
2,1261,48547,3575897468,3575897509,41
2,1261,48548,3575897468,3575897509,41
2,1261,48549,3575897468,3575897509,41
2,1261,48550,3575897468,3575897510,42
2,1261,48551,3575897468,3575897510,42
2,1261,48552,3575897468,3575897511,43
2,1261,48553,3575897468,3575897511,43
2,1261,48554,3575897468,3575897512,44
2,1261,48555,3575897468,3575897513,45
2,1261,48556,3575897468,3575897513,45
2,1261,48557,3575897468,3575897514,46
2,1261,48558,3575897468,3575897515,47
2,1261,48559,3575897468,3575897515,47
2,1261,48560,3575897468,3575897516,48
2,1261,48561,3575897468,3575897516,48
2,1261,48562,3575897468,3575897516,48
2,1261,48563,3575897468,3575897517,49
2,1261,48564,3575897468,3575897517,49
2,1261,48565,3575897468,3575897517,49
2,1261,48566,3575897468,3575897517,49
2,1261,48567,3575897468,3575897518,50
2,1262,48568,3575897531,3575897531,0
2,1262,48569,3575897531,3575897531,0
2,1262,48570,3575897531,3575897531,0
2,1262,48571,3575897531,3575897531,0
2,1262,48572,3575897531,3575897531,0
2,1262,48573,3575897531,3575897531,0
2,1262,48574,3575897531,3575897531,0
2,1262,48575,3575897531,3575897531,0
2,1262,48576,3575897531,3575897531,0
2,1262,48577,3575897531,3575897531,0
2,1262,48578,3575897531,3575897532,1
2,1262,48579,3575897531,3575897532,1
2,1262,48580,3575897531,3575897532,1
2,1262,48581,3575897531,3575897532,1
2,1262,48582,3575897531,3575897532,1
2,1262,48583,3575897531,3575897532,1
2,1262,48584,3575897531,3575897532,1
2,1262,48585,3575897531,3575897532,1
2,1262,48586,3575897531,3575897532,1
2,1262,48587,3575897531,3575897533,2
2,1262,48588,3575897531,3575897533,2
2,1262,48589,3575897531,3575897533,2
2,1262,48590,3575897531,3575897533,2
2,1262,48591,3575897531,3575897534,3
2,1262,48592,3575897531,3575897534,3
2,1262,48593,3575897531,3575897535,4
2,1262,48594,3575897531,3575897538,7
2,1262,48595,3575897531,3575897538,7
2,1262,48596,3575897531,3575897540,9
2,1262,48597,3575897531,3575897543,12
2,1262,48598,3575897531,3575897543,12
2,1262,48599,3575897531,3575897543,12
2,1262,48600,3575897531,3575897544,13
2,1262,48601,3575897531,3575897544,13
2,1262,48602,3575897531,3575897545,14
2,1262,48603,3575897531,3575897545,14
2,1262,48604,3575897531,3575897547,16
2,1262,48605,3575897531,3575897547,16
2,1262,48606,3575897531,3575897547,16
2,1262,48607,3575897531,3575897548,17
2,1262,48608,3575897531,3575897548,17
2,1262,48609,3575897531,3575897549,18
2,1262,48610,3575897531,3575897549,18
2,1262,48611,3575897531,3575897550,19
2,1262,48612,3575897531,3575897551,20
2,1262,48613,3575897531,3575897551,20
2,1262,48614,3575897531,3575897551,20
2,1262,48615,3575897531,3575897552,21
2,1262,48616,3575897531,3575897553,22
2,1262,48617,3575897531,3575897553,22
2,1262,48618,3575897531,3575897553,22
2,1262,48619,3575897531,3575897555,24
2,1262,48620,3575897531,3575897557,26
2,1262,48621,3575897531,3575897558,27
2,1262,48622,3575897531,3575897558,27
2,1262,48623,3575897531,3575897559,28
2,1262,48624,3575897531,3575897560,29
2,1262,48625,3575897531,3575897560,29
2,1262,48626,3575897531,3575897561,30
2,1262,48627,3575897531,3575897563,32
2,1262,48628,3575897531,3575897564,33
2,1262,48629,3575897531,3575897565,34
2,1262,48630,3575897531,3575897565,34
2,1262,48631,3575897531,3575897565,34
2,1262,48632,3575897531,3575897566,35
2,1262,48633,3575897531,3575897567,36
2,1262,48634,3575897531,3575897567,36
2,1262,48635,3575897531,3575897567,36
2,1262,48636,3575897531,3575897568,37
2,1262,48637,3575897531,3575897568,37
2,1262,48638,3575897531,3575897569,38
2,1262,48639,3575897531,3575897569,38
2,1262,48640,3575897531,3575897572,41
2,1262,48641,3575897531,3575897573,42
2,1262,48642,3575897531,3575897574,43
2,1262,48643,3575897531,3575897575,44
2,1262,48644,3575897531,3575897576,45
2,1262,48645,3575897531,3575897576,45
2,1262,48646,3575897531,3575897576,45
2,1262,48647,3575897531,3575897577,46
2,1262,48648,3575897531,3575897580,49
2,1262,48649,3575897531,3575897581,50
2,1263,48650,3575897597,3575897597,0
2,1263,48651,3575897597,3575897597,0
2,1263,48652,3575897597,3575897597,0
2,1263,48653,3575897597,3575897597,0
2,1263,48654,3575897597,3575897597,0
2,1263,48655,3575897597,3575897597,0
2,1263,48656,3575897597,3575897597,0
2,1263,48657,3575897597,3575897597,0
2,1263,48658,3575897597,3575897597,0
2,1263,48659,3575897597,3575897597,0
2,1263,48660,3575897597,3575897597,0
2,1263,48661,3575897597,3575897597,0
2,1263,48662,3575897597,3575897597,0
2,1263,48663,3575897597,3575897597,0
2,1263,48664,3575897597,3575897597,0
2,1263,48665,3575897597,3575897597,0
2,1263,48666,3575897597,3575897597,0
2,1263,48667,3575897597,3575897597,0
2,1263,48668,3575897597,3575897597,0
2,1263,48669,3575897597,3575897597,0
2,1263,48670,3575897597,3575897597,0
2,1263,48671,3575897597,3575897597,0
2,1263,48672,3575897597,3575897597,0
2,1263,48673,3575897597,3575897597,0
2,1263,48674,3575897597,3575897597,0
2,1263,48675,3575897597,3575897597,0
2,1263,48676,3575897597,3575897597,0
2,1263,48677,3575897597,3575897598,1
2,1263,48678,3575897597,3575897600,3
2,1263,48679,3575897597,3575897600,3
2,1263,48680,3575897597,3575897600,3
2,1263,48681,3575897597,3575897602,5
2,1263,48682,3575897597,3575897603,6
2,1263,48683,3575897597,3575897603,6
2,1263,48684,3575897597,3575897603,6
2,1263,48685,3575897597,3575897603,6
2,1263,48686,3575897597,3575897604,7
2,1263,48687,3575897597,3575897604,7
2,1263,48688,3575897597,3575897604,7
2,1263,48689,3575897597,3575897605,8
2,1263,48690,3575897597,3575897607,10
2,1263,48691,3575897597,3575897608,11
2,1263,48692,3575897597,3575897609,12
2,1263,48693,3575897597,3575897612,15
2,1263,48694,3575897597,3575897612,15
2,1263,48695,3575897597,3575897619,22
2,1263,48696,3575897597,3575897622,25
2,1263,48697,3575897597,3575897622,25
2,1263,48698,3575897597,3575897623,26
2,1263,48699,3575897597,3575897625,28
2,1263,48700,3575897597,3575897625,28
2,1263,48701,3575897597,3575897626,29
2,1263,48702,3575897597,3575897627,30
2,1263,48703,3575897597,3575897628,31
2,1263,48704,3575897597,3575897628,31
2,1263,48705,3575897597,3575897629,32
2,1263,48706,3575897597,3575897629,32
2,1263,48707,3575897597,3575897631,34
2,1263,48708,3575897597,3575897632,35
2,1263,48709,3575897597,3575897632,35
2,1263,48710,3575897597,3575897633,36
2,1263,48711,3575897597,3575897636,39
2,1263,48712,3575897597,3575897636,39
2,1263,48713,3575897597,3575897637,40
2,1263,48714,3575897597,3575897639,42
2,1263,48715,3575897597,3575897639,42
2,1263,48716,3575897597,3575897640,43
2,1263,48717,3575897597,3575897640,43
2,1263,48718,3575897597,3575897641,44
2,1263,48719,3575897597,3575897643,46
2,1263,48720,3575897597,3575897643,46
2,1263,48721,3575897597,3575897643,46
2,1263,48722,3575897597,3575897644,47
2,1263,48723,3575897597,3575897644,47
2,1263,48724,3575897597,3575897645,48
2,1263,48725,3575897597,3575897646,49
2,1264,48726,3575897661,3575897661,0
2,1264,48727,3575897661,3575897661,0
2,1264,48728,3575897661,3575897661,0
2,1264,48729,3575897661,3575897661,0
2,1264,48730,3575897661,3575897661,0
2,1264,48731,3575897661,3575897661,0
2,1264,48732,3575897661,3575897661,0
2,1264,48733,3575897661,3575897661,0
2,1264,48734,3575897661,3575897661,0
2,1264,48735,3575897661,3575897661,0
2,1264,48736,3575897661,3575897661,0
2,1264,48737,3575897661,3575897661,0
2,1264,48738,3575897661,3575897662,1
2,1264,48739,3575897661,3575897664,3
2,1264,48740,3575897661,3575897665,4
2,1264,48741,3575897661,3575897666,5
2,1264,48742,3575897661,3575897667,6
2,1264,48743,3575897661,3575897672,11
2,1264,48744,3575897661,3575897673,12
2,1264,48745,3575897661,3575897677,16
2,1264,48746,3575897661,3575897677,16
2,1264,48747,3575897661,3575897682,21
2,1264,48748,3575897661,3575897684,23
2,1264,48749,3575897661,3575897685,24
2,1264,48750,3575897661,3575897686,25
2,1264,48751,3575897661,3575897686,25
2,1264,48752,3575897661,3575897686,25
2,1264,48753,3575897661,3575897689,28
2,1264,48754,3575897661,3575897690,29
2,1264,48755,3575897661,3575897690,29
2,1264,48756,3575897661,3575897690,29
2,1264,48757,3575897661,3575897691,30
2,1264,48758,3575897661,3575897692,31
2,1264,48759,3575897661,3575897692,31
2,1264,48760,3575897661,3575897692,31
2,1264,48761,3575897661,3575897692,31
2,1264,48762,3575897661,3575897693,32
2,1264,48763,3575897661,3575897693,32
2,1264,48764,3575897661,3575897694,33
2,1264,48765,3575897661,3575897695,34
2,1264,48766,3575897661,3575897695,34
2,1264,48767,3575897661,3575897695,34
2,1264,48768,3575897661,3575897696,35
2,1264,48769,3575897661,3575897697,36
2,1264,48770,3575897661,3575897699,38
2,1264,48771,3575897661,3575897700,39
2,1264,48772,3575897661,3575897701,40
2,1264,48773,3575897661,3575897702,41
2,1264,48774,3575897661,3575897702,41
2,1264,48775,3575897661,3575897703,42
2,1264,48776,3575897661,3575897703,42
2,1264,48777,3575897661,3575897704,43
2,1264,48778,3575897661,3575897704,43
2,1264,48779,3575897661,3575897704,43
2,1264,48780,3575897661,3575897706,45
2,1264,48781,3575897661,3575897706,45
2,1264,48782,3575897661,3575897706,45
2,1264,48783,3575897661,3575897707,46
2,1264,48784,3575897661,3575897707,46
2,1264,48785,3575897661,3575897707,46
2,1264,48786,3575897661,3575897708,47
2,1264,48787,3575897661,3575897708,47
2,1264,48788,3575897661,3575897708,47
2,1264,48789,3575897661,3575897709,48
2,1264,48790,3575897661,3575897710,49
2,1264,48791,3575897661,3575897710,49
2,1264,48792,3575897661,3575897710,49
2,1264,48793,3575897661,3575897710,49
2,1265,48794,3575897725,3575897725,0
2,1265,48795,3575897725,3575897725,0
2,1265,48796,3575897725,3575897725,0
2,1265,48797,3575897725,3575897725,0
2,1265,48798,3575897725,3575897725,0
2,1265,48799,3575897725,3575897725,0
2,1265,48800,3575897725,3575897725,0
2,1265,48801,3575897725,3575897725,0
2,1265,48802,3575897725,3575897725,0
2,1265,48803,3575897725,3575897725,0
2,1265,48804,3575897725,3575897725,0
2,1265,48805,3575897725,3575897725,0
2,1265,48806,3575897725,3575897725,0
2,1265,48807,3575897725,3575897725,0
2,1265,48808,3575897725,3575897725,0
2,1265,48809,3575897725,3575897725,0
2,1265,48810,3575897725,3575897725,0
2,1265,48811,3575897725,3575897725,0
2,1265,48812,3575897725,3575897725,0
2,1265,48813,3575897725,3575897725,0
2,1265,48814,3575897725,3575897725,0
2,1265,48815,3575897725,3575897725,0
2,1265,48816,3575897725,3575897725,0
2,1265,48817,3575897725,3575897725,0
2,1265,48818,3575897725,3575897725,0
2,1265,48819,3575897725,3575897727,2
2,1265,48820,3575897725,3575897728,3
2,1265,48821,3575897725,3575897729,4
2,1265,48822,3575897725,3575897730,5
2,1265,48823,3575897725,3575897731,6
2,1265,48824,3575897725,3575897731,6
2,1265,48825,3575897725,3575897731,6
2,1265,48826,3575897725,3575897732,7
2,1265,48827,3575897725,3575897733,8
2,1265,48828,3575897725,3575897733,8
2,1265,48829,3575897725,3575897733,8
2,1265,48830,3575897725,3575897734,9
2,1265,48831,3575897725,3575897735,10
2,1265,48832,3575897725,3575897739,14
2,1265,48833,3575897725,3575897743,18
2,1265,48834,3575897725,3575897745,20
2,1265,48835,3575897725,3575897745,20
2,1265,48836,3575897725,3575897745,20
2,1265,48837,3575897725,3575897745,20
2,1265,48838,3575897725,3575897745,20
2,1265,48839,3575897725,3575897747,22
2,1265,48840,3575897725,3575897747,22
2,1265,48841,3575897725,3575897748,23
2,1265,48842,3575897725,3575897748,23
2,1265,48843,3575897725,3575897748,23
2,1265,48844,3575897725,3575897749,24
2,1265,48845,3575897725,3575897750,25
2,1265,48846,3575897725,3575897750,25
2,1265,48847,3575897725,3575897751,26
2,1265,48848,3575897725,3575897751,26
2,1265,48849,3575897725,3575897752,27
2,1265,48850,3575897725,3575897753,28
2,1265,48851,3575897725,3575897753,28
2,1265,48852,3575897725,3575897756,31
2,1265,48853,3575897725,3575897757,32
2,1265,48854,3575897725,3575897758,33
2,1265,48855,3575897725,3575897758,33
2,1265,48856,3575897725,3575897760,35
2,1265,48857,3575897725,3575897760,35
2,1265,48858,3575897725,3575897760,35
2,1265,48859,3575897725,3575897762,37
2,1265,48860,3575897725,3575897763,38
2,1265,48861,3575897725,3575897764,39
2,1265,48862,3575897725,3575897765,40
2,1265,48863,3575897725,3575897765,40
2,1265,48864,3575897725,3575897765,40
2,1265,48865,3575897725,3575897765,40
2,1265,48866,3575897725,3575897766,41
2,1265,48867,3575897725,3575897766,41
2,1265,48868,3575897725,3575897767,42
2,1265,48869,3575897725,3575897767,42
2,1265,48870,3575897725,3575897768,43
2,1265,48871,3575897725,3575897769,44
2,1265,48872,3575897725,3575897769,44
2,1265,48873,3575897725,3575897769,44
2,1265,48874,3575897725,3575897769,44
2,1265,48875,3575897725,3575897770,45
2,1265,48876,3575897725,3575897770,45
2,1265,48877,3575897725,3575897774,49
2,1265,48878,3575897725,3575897774,49
2,1265,48879,3575897725,3575897775,50
2,1266,48880,3575897791,3575897791,0
2,1266,48881,3575897791,3575897791,0
2,1266,48882,3575897791,3575897791,0
2,1266,48883,3575897791,3575897791,0
2,1266,48884,3575897791,3575897791,0
2,1266,48885,3575897791,3575897791,0
2,1266,48886,3575897791,3575897791,0
2,1266,48887,3575897791,3575897791,0
2,1266,48888,3575897791,3575897791,0
2,1266,48889,3575897791,3575897791,0
2,1266,48890,3575897791,3575897791,0
2,1266,48891,3575897791,3575897791,0
2,1266,48892,3575897791,3575897791,0
2,1266,48893,3575897791,3575897791,0
2,1266,48894,3575897791,3575897791,0
2,1266,48895,3575897791,3575897791,0
2,1266,48896,3575897791,3575897791,0
2,1266,48897,3575897791,3575897791,0
2,1266,48898,3575897791,3575897791,0
2,1266,48899,3575897791,3575897791,0
2,1266,48900,3575897791,3575897791,0
2,1266,48901,3575897791,3575897791,0
2,1266,48902,3575897791,3575897791,0
2,1266,48903,3575897791,3575897791,0
2,1266,48904,3575897791,3575897791,0
2,1266,48905,3575897791,3575897792,1
2,1266,48906,3575897791,3575897793,2
2,1266,48907,3575897791,3575897794,3
2,1266,48908,3575897791,3575897794,3
2,1266,48909,3575897791,3575897795,4
2,1266,48910,3575897791,3575897795,4
2,1266,48911,3575897791,3575897796,5
2,1266,48912,3575897791,3575897796,5
2,1266,48913,3575897791,3575897796,5
2,1266,48914,3575897791,3575897797,6
2,1266,48915,3575897791,3575897798,7
2,1266,48916,3575897791,3575897799,8
2,1266,48917,3575897791,3575897800,9
2,1266,48918,3575897791,3575897800,9
2,1266,48919,3575897791,3575897801,10
2,1266,48920,3575897791,3575897802,11
2,1266,48921,3575897791,3575897802,11
2,1266,48922,3575897791,3575897803,12
2,1266,48923,3575897791,3575897803,12
2,1266,48924,3575897791,3575897803,12
2,1266,48925,3575897791,3575897803,12
2,1266,48926,3575897791,3575897804,13
2,1266,48927,3575897791,3575897805,14
2,1266,48928,3575897791,3575897808,17
2,1266,48929,3575897791,3575897810,19
2,1266,48930,3575897791,3575897811,20
2,1266,48931,3575897791,3575897812,21
2,1266,48932,3575897791,3575897821,30
2,1266,48933,3575897791,3575897822,31
2,1266,48934,3575897791,3575897823,32
2,1266,48935,3575897791,3575897824,33
2,1266,48936,3575897791,3575897826,35
2,1266,48937,3575897791,3575897827,36
2,1266,48938,3575897791,3575897829,38
2,1266,48939,3575897791,3575897829,38
2,1266,48940,3575897791,3575897832,41
2,1266,48941,3575897791,3575897832,41
2,1266,48942,3575897791,3575897832,41
2,1266,48943,3575897791,3575897834,43
2,1266,48944,3575897791,3575897835,44
2,1266,48945,3575897791,3575897836,45
2,1266,48946,3575897791,3575897836,45
2,1266,48947,3575897791,3575897837,46
2,1266,48948,3575897791,3575897838,47
2,1266,48949,3575897791,3575897840,49
2,1266,48950,3575897791,3575897840,49
2,1266,48951,3575897791,3575897840,49
2,1267,48952,3575897855,3575897855,0
2,1267,48953,3575897855,3575897855,0
2,1267,48954,3575897855,3575897855,0
2,1267,48955,3575897855,3575897855,0
2,1267,48956,3575897855,3575897855,0
2,1267,48957,3575897855,3575897855,0
2,1267,48958,3575897855,3575897855,0
2,1267,48959,3575897855,3575897855,0
2,1267,48960,3575897855,3575897855,0
2,1267,48961,3575897855,3575897855,0
2,1267,48962,3575897855,3575897855,0
2,1267,48963,3575897855,3575897855,0
2,1267,48964,3575897855,3575897855,0
2,1267,48965,3575897855,3575897855,0
2,1267,48966,3575897855,3575897855,0
2,1267,48967,3575897855,3575897855,0
2,1267,48968,3575897855,3575897856,1
2,1267,48969,3575897855,3575897860,5
2,1267,48970,3575897855,3575897860,5
2,1267,48971,3575897855,3575897861,6
2,1267,48972,3575897855,3575897861,6
2,1267,48973,3575897855,3575897862,7
2,1267,48974,3575897855,3575897863,8
2,1267,48975,3575897855,3575897865,10
2,1267,48976,3575897855,3575897866,11
2,1267,48977,3575897855,3575897868,13
2,1267,48978,3575897855,3575897872,17
2,1267,48979,3575897855,3575897873,18
2,1267,48980,3575897855,3575897876,21
2,1267,48981,3575897855,3575897881,26
2,1267,48982,3575897855,3575897884,29
2,1267,48983,3575897855,3575897886,31
2,1267,48984,3575897855,3575897886,31
2,1267,48985,3575897855,3575897886,31
2,1267,48986,3575897855,3575897887,32
2,1267,48987,3575897855,3575897889,34
2,1267,48988,3575897855,3575897889,34
2,1267,48989,3575897855,3575897890,35
2,1267,48990,3575897855,3575897891,36
2,1267,48991,3575897855,3575897892,37
2,1267,48992,3575897855,3575897892,37
2,1267,48993,3575897855,3575897892,37
2,1267,48994,3575897855,3575897892,37
2,1267,48995,3575897855,3575897892,37
2,1267,48996,3575897855,3575897893,38
2,1267,48997,3575897855,3575897896,41
2,1267,48998,3575897855,3575897896,41
2,1267,48999,3575897855,3575897897,42
2,1267,49000,3575897855,3575897897,42
2,1267,49001,3575897855,3575897898,43
2,1267,49002,3575897855,3575897899,44
2,1267,49003,3575897855,3575897899,44
2,1267,49004,3575897855,3575897900,45
2,1267,49005,3575897855,3575897902,47
2,1267,49006,3575897855,3575897903,48
2,1267,49007,3575897855,3575897904,49
2,1267,49008,3575897855,3575897904,49
2,1267,49009,3575897855,3575897904,49
2,1268,49010,3575897922,3575897922,0
2,1268,49011,3575897922,3575897922,0
2,1268,49012,3575897922,3575897922,0
2,1268,49013,3575897922,3575897922,0
2,1268,49014,3575897922,3575897922,0
2,1268,49015,3575897922,3575897922,0
2,1268,49016,3575897922,3575897922,0
2,1268,49017,3575897922,3575897922,0
2,1268,49018,3575897922,3575897922,0
2,1268,49019,3575897922,3575897922,0
2,1268,49020,3575897922,3575897922,0
2,1268,49021,3575897922,3575897922,0
2,1268,49022,3575897922,3575897922,0
2,1268,49023,3575897922,3575897922,0
2,1268,49024,3575897922,3575897922,0
2,1268,49025,3575897922,3575897922,0
2,1268,49026,3575897922,3575897922,0
2,1268,49027,3575897922,3575897922,0
2,1268,49028,3575897922,3575897922,0
2,1268,49029,3575897922,3575897922,0
2,1268,49030,3575897922,3575897922,0
2,1268,49031,3575897922,3575897922,0
2,1268,49032,3575897922,3575897922,0
2,1268,49033,3575897922,3575897922,0
2,1268,49034,3575897922,3575897922,0
2,1268,49035,3575897922,3575897922,0
2,1268,49036,3575897922,3575897922,0
2,1268,49037,3575897922,3575897922,0
2,1268,49038,3575897922,3575897922,0
2,1268,49039,3575897922,3575897922,0
2,1268,49040,3575897922,3575897922,0
2,1268,49041,3575897922,3575897922,0
2,1268,49042,3575897922,3575897922,0
2,1268,49043,3575897922,3575897922,0
2,1268,49044,3575897922,3575897922,0
2,1268,49045,3575897922,3575897922,0
2,1268,49046,3575897922,3575897922,0
2,1268,49047,3575897922,3575897922,0
2,1268,49048,3575897922,3575897922,0
2,1268,49049,3575897922,3575897923,1
2,1268,49050,3575897922,3575897925,3
2,1268,49051,3575897922,3575897925,3
2,1268,49052,3575897922,3575897926,4
2,1268,49053,3575897922,3575897926,4
2,1268,49054,3575897922,3575897929,7
2,1268,49055,3575897922,3575897929,7
2,1268,49056,3575897922,3575897930,8
2,1268,49057,3575897922,3575897931,9
2,1268,49058,3575897922,3575897931,9
2,1268,49059,3575897922,3575897932,10
2,1268,49060,3575897922,3575897933,11
2,1268,49061,3575897922,3575897933,11
2,1268,49062,3575897922,3575897933,11
2,1268,49063,3575897922,3575897934,12
2,1268,49064,3575897922,3575897934,12
2,1268,49065,3575897922,3575897934,12
2,1268,49066,3575897922,3575897935,13
2,1268,49067,3575897922,3575897936,14
2,1268,49068,3575897922,3575897938,16
2,1268,49069,3575897922,3575897940,18
2,1268,49070,3575897922,3575897943,21
2,1268,49071,3575897922,3575897944,22
2,1268,49072,3575897922,3575897944,22
2,1268,49073,3575897922,3575897945,23
2,1268,49074,3575897922,3575897945,23
2,1268,49075,3575897922,3575897945,23
2,1268,49076,3575897922,3575897945,23
2,1268,49077,3575897922,3575897947,25
2,1268,49078,3575897922,3575897947,25
2,1268,49079,3575897922,3575897947,25
2,1268,49080,3575897922,3575897947,25
2,1268,49081,3575897922,3575897948,26
2,1268,49082,3575897922,3575897948,26
2,1268,49083,3575897922,3575897949,27
2,1268,49084,3575897922,3575897950,28
2,1268,49085,3575897922,3575897950,28
2,1268,49086,3575897922,3575897951,29
2,1268,49087,3575897922,3575897951,29
2,1268,49088,3575897922,3575897952,30
2,1268,49089,3575897922,3575897952,30
2,1268,49090,3575897922,3575897953,31
2,1268,49091,3575897922,3575897953,31
2,1268,49092,3575897922,3575897953,31
2,1268,49093,3575897922,3575897954,32
2,1268,49094,3575897922,3575897956,34
2,1268,49095,3575897922,3575897957,35
2,1268,49096,3575897922,3575897959,37
2,1268,49097,3575897922,3575897959,37
2,1268,49098,3575897922,3575897960,38
2,1268,49099,3575897922,3575897961,39
2,1268,49100,3575897922,3575897961,39
2,1268,49101,3575897922,3575897961,39
2,1268,49102,3575897922,3575897962,40
2,1268,49103,3575897922,3575897964,42
2,1268,49104,3575897922,3575897965,43
2,1268,49105,3575897922,3575897965,43
2,1268,49106,3575897922,3575897966,44
2,1268,49107,3575897922,3575897966,44
2,1268,49108,3575897922,3575897966,44
2,1268,49109,3575897922,3575897967,45
2,1268,49110,3575897922,3575897968,46
2,1268,49111,3575897922,3575897969,47
2,1268,49112,3575897922,3575897969,47
2,1268,49113,3575897922,3575897969,47
2,1268,49114,3575897922,3575897970,48
2,1268,49115,3575897922,3575897970,48
2,1268,49116,3575897922,3575897970,48
2,1269,49117,3575897986,3575897986,0
2,1269,49118,3575897986,3575897986,0
2,1269,49119,3575897986,3575897986,0
2,1269,49120,3575897986,3575897986,0
2,1269,49121,3575897986,3575897986,0
2,1269,49122,3575897986,3575897986,0
2,1269,49123,3575897986,3575897986,0
2,1269,49124,3575897986,3575897986,0
2,1269,49125,3575897986,3575897986,0
2,1269,49126,3575897986,3575897986,0
2,1269,49127,3575897986,3575897986,0
2,1269,49128,3575897986,3575897986,0
2,1269,49129,3575897986,3575897986,0
2,1269,49130,3575897986,3575897986,0
2,1269,49131,3575897986,3575897986,0
2,1269,49132,3575897986,3575897986,0
2,1269,49133,3575897986,3575897986,0
2,1269,49134,3575897986,3575897986,0
2,1269,49135,3575897986,3575897986,0
2,1269,49136,3575897986,3575897987,1
2,1269,49137,3575897986,3575897988,2
2,1269,49138,3575897986,3575897989,3
2,1269,49139,3575897986,3575897989,3
2,1269,49140,3575897986,3575897990,4
2,1269,49141,3575897986,3575897991,5
2,1269,49142,3575897986,3575897991,5
2,1269,49143,3575897986,3575897991,5
2,1269,49144,3575897986,3575897991,5
2,1269,49145,3575897986,3575897993,7
2,1269,49146,3575897986,3575897994,8
2,1269,49147,3575897986,3575897994,8
2,1269,49148,3575897986,3575897994,8
2,1269,49149,3575897986,3575897994,8
2,1269,49150,3575897986,3575897995,9
2,1269,49151,3575897986,3575897996,10
2,1269,49152,3575897986,3575897996,10
2,1269,49153,3575897986,3575897998,12
2,1269,49154,3575897986,3575897998,12
2,1269,49155,3575897986,3575897999,13
2,1269,49156,3575897986,3575898000,14
2,1269,49157,3575897986,3575898000,14
2,1269,49158,3575897986,3575898002,16
2,1269,49159,3575897986,3575898002,16
2,1269,49160,3575897986,3575898002,16
2,1269,49161,3575897986,3575898003,17
2,1269,49162,3575897986,3575898003,17
2,1269,49163,3575897986,3575898004,18
2,1269,49164,3575897986,3575898004,18
2,1269,49165,3575897986,3575898005,19
2,1269,49166,3575897986,3575898005,19
2,1269,49167,3575897986,3575898006,20
2,1269,49168,3575897986,3575898009,23
2,1269,49169,3575897986,3575898010,24
2,1269,49170,3575897986,3575898011,25
2,1269,49171,3575897986,3575898013,27
2,1269,49172,3575897986,3575898013,27
2,1269,49173,3575897986,3575898014,28
2,1269,49174,3575897986,3575898022,36
2,1269,49175,3575897986,3575898022,36
2,1269,49176,3575897986,3575898023,37
2,1269,49177,3575897986,3575898024,38
2,1269,49178,3575897986,3575898026,40
2,1269,49179,3575897986,3575898027,41
2,1269,49180,3575897986,3575898027,41
2,1269,49181,3575897986,3575898028,42
2,1269,49182,3575897986,3575898029,43
2,1269,49183,3575897986,3575898029,43
2,1269,49184,3575897986,3575898031,45
2,1269,49185,3575897986,3575898032,46
2,1269,49186,3575897986,3575898032,46
2,1269,49187,3575897986,3575898034,48
2,1269,49188,3575897986,3575898035,49
2,1269,49189,3575897986,3575898036,50
2,1270,49190,3575898052,3575898052,0
2,1270,49191,3575898052,3575898052,0
2,1270,49192,3575898052,3575898052,0
2,1270,49193,3575898052,3575898052,0
2,1270,49194,3575898052,3575898052,0
2,1270,49195,3575898052,3575898052,0
2,1270,49196,3575898052,3575898052,0
2,1270,49197,3575898052,3575898052,0
2,1270,49198,3575898052,3575898052,0
2,1270,49199,3575898052,3575898052,0
2,1270,49200,3575898052,3575898052,0
2,1270,49201,3575898052,3575898052,0
2,1270,49202,3575898052,3575898052,0
2,1270,49203,3575898052,3575898052,0
2,1270,49204,3575898052,3575898052,0
2,1270,49205,3575898052,3575898054,2
2,1270,49206,3575898052,3575898054,2
2,1270,49207,3575898052,3575898054,2
2,1270,49208,3575898052,3575898055,3
2,1270,49209,3575898052,3575898055,3
2,1270,49210,3575898052,3575898056,4
2,1270,49211,3575898052,3575898056,4
2,1270,49212,3575898052,3575898059,7
2,1270,49213,3575898052,3575898060,8
2,1270,49214,3575898052,3575898061,9
2,1270,49215,3575898052,3575898061,9
2,1270,49216,3575898052,3575898063,11
2,1270,49217,3575898052,3575898065,13
2,1270,49218,3575898052,3575898066,14
2,1270,49219,3575898052,3575898069,17
2,1270,49220,3575898052,3575898073,21
2,1270,49221,3575898052,3575898073,21
2,1270,49222,3575898052,3575898077,25
2,1270,49223,3575898052,3575898077,25
2,1270,49224,3575898052,3575898081,29
2,1270,49225,3575898052,3575898084,32
2,1270,49226,3575898052,3575898085,33
2,1270,49227,3575898052,3575898086,34
2,1270,49228,3575898052,3575898091,39
2,1270,49229,3575898052,3575898091,39
2,1270,49230,3575898052,3575898091,39
2,1270,49231,3575898052,3575898091,39
2,1270,49232,3575898052,3575898092,40
2,1270,49233,3575898052,3575898092,40
2,1270,49234,3575898052,3575898092,40
2,1270,49235,3575898052,3575898093,41
2,1270,49236,3575898052,3575898093,41
2,1270,49237,3575898052,3575898094,42
2,1270,49238,3575898052,3575898095,43
2,1270,49239,3575898052,3575898095,43
2,1270,49240,3575898052,3575898096,44
2,1270,49241,3575898052,3575898097,45
2,1270,49242,3575898052,3575898097,45
2,1270,49243,3575898052,3575898098,46
2,1270,49244,3575898052,3575898099,47
2,1270,49245,3575898052,3575898099,47
2,1270,49246,3575898052,3575898102,50
2,1271,49247,3575898115,3575898115,0
2,1271,49248,3575898115,3575898115,0
2,1271,49249,3575898115,3575898115,0
2,1271,49250,3575898115,3575898115,0
2,1271,49251,3575898115,3575898115,0
2,1271,49252,3575898115,3575898115,0
2,1271,49253,3575898115,3575898115,0
2,1271,49254,3575898115,3575898115,0
2,1271,49255,3575898115,3575898115,0
2,1271,49256,3575898115,3575898115,0
2,1271,49257,3575898115,3575898115,0
2,1271,49258,3575898115,3575898115,0
2,1271,49259,3575898115,3575898115,0
2,1271,49260,3575898115,3575898115,0
2,1271,49261,3575898115,3575898115,0
2,1271,49262,3575898115,3575898115,0
2,1271,49263,3575898115,3575898115,0
2,1271,49264,3575898115,3575898115,0
2,1271,49265,3575898115,3575898115,0
2,1271,49266,3575898115,3575898115,0
2,1271,49267,3575898115,3575898115,0
2,1271,49268,3575898115,3575898115,0
2,1271,49269,3575898115,3575898115,0
2,1271,49270,3575898115,3575898115,0
2,1271,49271,3575898115,3575898115,0
2,1271,49272,3575898115,3575898115,0
2,1271,49273,3575898115,3575898116,1
2,1271,49274,3575898115,3575898116,1
2,1271,49275,3575898115,3575898116,1
2,1271,49276,3575898115,3575898116,1
2,1271,49277,3575898115,3575898118,3
2,1271,49278,3575898115,3575898118,3
2,1271,49279,3575898115,3575898119,4
2,1271,49280,3575898115,3575898120,5
2,1271,49281,3575898115,3575898120,5
2,1271,49282,3575898115,3575898120,5
2,1271,49283,3575898115,3575898120,5
2,1271,49284,3575898115,3575898121,6
2,1271,49285,3575898115,3575898122,7
2,1271,49286,3575898115,3575898124,9
2,1271,49287,3575898115,3575898125,10
2,1271,49288,3575898115,3575898126,11
2,1271,49289,3575898115,3575898126,11
2,1271,49290,3575898115,3575898127,12
2,1271,49291,3575898115,3575898129,14
2,1271,49292,3575898115,3575898130,15
2,1271,49293,3575898115,3575898130,15
2,1271,49294,3575898115,3575898131,16
2,1271,49295,3575898115,3575898131,16
2,1271,49296,3575898115,3575898132,17
2,1271,49297,3575898115,3575898133,18
2,1271,49298,3575898115,3575898133,18
2,1271,49299,3575898115,3575898133,18
2,1271,49300,3575898115,3575898134,19
2,1271,49301,3575898115,3575898135,20
2,1271,49302,3575898115,3575898135,20
2,1271,49303,3575898115,3575898135,20
2,1271,49304,3575898115,3575898138,23
2,1271,49305,3575898115,3575898138,23
2,1271,49306,3575898115,3575898140,25
2,1271,49307,3575898115,3575898143,28
2,1271,49308,3575898115,3575898143,28
2,1271,49309,3575898115,3575898144,29
2,1271,49310,3575898115,3575898144,29
2,1271,49311,3575898115,3575898145,30
2,1271,49312,3575898115,3575898145,30
2,1271,49313,3575898115,3575898146,31
2,1271,49314,3575898115,3575898147,32
2,1271,49315,3575898115,3575898147,32
2,1271,49316,3575898115,3575898148,33
2,1271,49317,3575898115,3575898148,33
2,1271,49318,3575898115,3575898149,34
2,1271,49319,3575898115,3575898149,34
2,1271,49320,3575898115,3575898150,35
2,1271,49321,3575898115,3575898151,36
2,1271,49322,3575898115,3575898151,36
2,1271,49323,3575898115,3575898151,36
2,1271,49324,3575898115,3575898152,37
2,1271,49325,3575898115,3575898153,38
2,1271,49326,3575898115,3575898154,39
2,1271,49327,3575898115,3575898154,39
2,1271,49328,3575898115,3575898154,39
2,1271,49329,3575898115,3575898157,42
2,1271,49330,3575898115,3575898157,42
2,1271,49331,3575898115,3575898159,44
2,1271,49332,3575898115,3575898159,44
2,1271,49333,3575898115,3575898160,45
2,1271,49334,3575898115,3575898161,46
2,1271,49335,3575898115,3575898161,46
2,1271,49336,3575898115,3575898162,47
2,1271,49337,3575898115,3575898164,49
2,1272,49338,3575898178,3575898178,0
2,1272,49339,3575898178,3575898178,0
2,1272,49340,3575898178,3575898178,0
2,1272,49341,3575898178,3575898178,0
2,1272,49342,3575898178,3575898178,0
2,1272,49343,3575898178,3575898178,0
2,1272,49344,3575898178,3575898178,0
2,1272,49345,3575898178,3575898178,0
2,1272,49346,3575898178,3575898178,0
2,1272,49347,3575898178,3575898178,0
2,1272,49348,3575898178,3575898178,0
2,1272,49349,3575898178,3575898178,0
2,1272,49350,3575898178,3575898178,0
2,1272,49351,3575898178,3575898178,0
2,1272,49352,3575898178,3575898178,0
2,1272,49353,3575898178,3575898178,0
2,1272,49354,3575898178,3575898178,0
2,1272,49355,3575898178,3575898179,1
2,1272,49356,3575898178,3575898179,1
2,1272,49357,3575898178,3575898179,1
2,1272,49358,3575898178,3575898179,1
2,1272,49359,3575898178,3575898179,1
2,1272,49360,3575898178,3575898179,1
2,1272,49361,3575898178,3575898179,1
2,1272,49362,3575898178,3575898181,3
2,1272,49363,3575898178,3575898182,4
2,1272,49364,3575898178,3575898183,5
2,1272,49365,3575898178,3575898184,6
2,1272,49366,3575898178,3575898184,6
2,1272,49367,3575898178,3575898186,8
2,1272,49368,3575898178,3575898186,8
2,1272,49369,3575898178,3575898189,11
2,1272,49370,3575898178,3575898189,11
2,1272,49371,3575898178,3575898190,12
2,1272,49372,3575898178,3575898191,13
2,1272,49373,3575898178,3575898191,13
2,1272,49374,3575898178,3575898191,13
2,1272,49375,3575898178,3575898192,14
2,1272,49376,3575898178,3575898192,14
2,1272,49377,3575898178,3575898193,15
2,1272,49378,3575898178,3575898194,16
2,1272,49379,3575898178,3575898194,16
2,1272,49380,3575898178,3575898194,16
2,1272,49381,3575898178,3575898194,16
2,1272,49382,3575898178,3575898195,17
2,1272,49383,3575898178,3575898195,17
2,1272,49384,3575898178,3575898196,18
2,1272,49385,3575898178,3575898196,18
2,1272,49386,3575898178,3575898198,20
2,1272,49387,3575898178,3575898198,20
2,1272,49388,3575898178,3575898199,21
2,1272,49389,3575898178,3575898202,24
2,1272,49390,3575898178,3575898202,24
2,1272,49391,3575898178,3575898203,25
2,1272,49392,3575898178,3575898203,25
2,1272,49393,3575898178,3575898203,25
2,1272,49394,3575898178,3575898203,25
2,1272,49395,3575898178,3575898203,25
2,1272,49396,3575898178,3575898203,25
2,1272,49397,3575898178,3575898205,27
2,1272,49398,3575898178,3575898205,27
2,1272,49399,3575898178,3575898206,28
2,1272,49400,3575898178,3575898206,28
2,1272,49401,3575898178,3575898207,29
2,1272,49402,3575898178,3575898209,31
2,1272,49403,3575898178,3575898209,31
2,1272,49404,3575898178,3575898212,34
2,1272,49405,3575898178,3575898212,34
2,1272,49406,3575898178,3575898213,35
2,1272,49407,3575898178,3575898214,36
2,1272,49408,3575898178,3575898222,44
2,1272,49409,3575898178,3575898222,44
2,1272,49410,3575898178,3575898223,45
2,1272,49411,3575898178,3575898224,46
2,1272,49412,3575898178,3575898226,48
2,1273,49413,3575898243,3575898243,0
2,1273,49414,3575898243,3575898243,0
2,1273,49415,3575898243,3575898243,0
2,1273,49416,3575898243,3575898243,0
2,1273,49417,3575898243,3575898243,0
2,1273,49418,3575898243,3575898243,0
2,1273,49419,3575898243,3575898243,0
2,1273,49420,3575898243,3575898243,0
2,1273,49421,3575898243,3575898243,0
2,1273,49422,3575898243,3575898243,0
2,1273,49423,3575898243,3575898243,0
2,1273,49424,3575898243,3575898243,0
2,1273,49425,3575898243,3575898243,0
2,1273,49426,3575898243,3575898243,0
2,1273,49427,3575898243,3575898243,0
2,1273,49428,3575898243,3575898243,0
2,1273,49429,3575898243,3575898243,0
2,1273,49430,3575898243,3575898243,0
2,1273,49431,3575898243,3575898243,0
2,1273,49432,3575898243,3575898243,0
2,1273,49433,3575898243,3575898244,1
2,1273,49434,3575898243,3575898244,1
2,1273,49435,3575898243,3575898245,2
2,1273,49436,3575898243,3575898245,2
2,1273,49437,3575898243,3575898247,4
2,1273,49438,3575898243,3575898249,6
2,1273,49439,3575898243,3575898252,9
2,1273,49440,3575898243,3575898254,11
2,1273,49441,3575898243,3575898254,11
2,1273,49442,3575898243,3575898254,11
2,1273,49443,3575898243,3575898255,12
2,1273,49444,3575898243,3575898255,12
2,1273,49445,3575898243,3575898256,13
2,1273,49446,3575898243,3575898256,13
2,1273,49447,3575898243,3575898257,14
2,1273,49448,3575898243,3575898259,16
2,1273,49449,3575898243,3575898260,17
2,1273,49450,3575898243,3575898261,18
2,1273,49451,3575898243,3575898261,18
2,1273,49452,3575898243,3575898264,21
2,1273,49453,3575898243,3575898266,23
2,1273,49454,3575898243,3575898267,24
2,1273,49455,3575898243,3575898269,26
2,1273,49456,3575898243,3575898273,30
2,1273,49457,3575898243,3575898274,31
2,1273,49458,3575898243,3575898276,33
2,1273,49459,3575898243,3575898277,34
2,1273,49460,3575898243,3575898281,38
2,1273,49461,3575898243,3575898284,41
2,1273,49462,3575898243,3575898286,43
2,1273,49463,3575898243,3575898286,43
2,1273,49464,3575898243,3575898286,43
2,1273,49465,3575898243,3575898287,44
2,1273,49466,3575898243,3575898291,48
2,1273,49467,3575898243,3575898291,48
2,1273,49468,3575898243,3575898292,49
2,1273,49469,3575898243,3575898292,49
2,1273,49470,3575898243,3575898292,49
2,1273,49471,3575898243,3575898293,50
2,1274,49472,3575898306,3575898306,0
2,1274,49473,3575898306,3575898306,0
2,1274,49474,3575898306,3575898306,0
2,1274,49475,3575898306,3575898306,0
2,1274,49476,3575898306,3575898306,0
2,1274,49477,3575898306,3575898306,0
2,1274,49478,3575898306,3575898306,0
2,1274,49479,3575898306,3575898306,0
2,1274,49480,3575898306,3575898306,0
2,1274,49481,3575898306,3575898306,0
2,1274,49482,3575898306,3575898306,0
2,1274,49483,3575898306,3575898306,0
2,1274,49484,3575898306,3575898306,0
2,1274,49485,3575898306,3575898306,0
2,1274,49486,3575898306,3575898306,0
2,1274,49487,3575898306,3575898306,0
2,1274,49488,3575898306,3575898306,0
2,1274,49489,3575898306,3575898306,0
2,1274,49490,3575898306,3575898306,0
2,1274,49491,3575898306,3575898308,2
2,1274,49492,3575898306,3575898308,2
2,1274,49493,3575898306,3575898308,2
2,1274,49494,3575898306,3575898308,2
2,1274,49495,3575898306,3575898310,4
2,1274,49496,3575898306,3575898310,4
2,1274,49497,3575898306,3575898311,5
2,1274,49498,3575898306,3575898312,6
2,1274,49499,3575898306,3575898312,6
2,1274,49500,3575898306,3575898313,7
2,1274,49501,3575898306,3575898313,7
2,1274,49502,3575898306,3575898313,7
2,1274,49503,3575898306,3575898313,7
2,1274,49504,3575898306,3575898314,8
2,1274,49505,3575898306,3575898315,9
2,1274,49506,3575898306,3575898315,9
2,1274,49507,3575898306,3575898316,10
2,1274,49508,3575898306,3575898317,11
2,1274,49509,3575898306,3575898317,11
2,1274,49510,3575898306,3575898317,11
2,1274,49511,3575898306,3575898318,12
2,1274,49512,3575898306,3575898318,12
2,1274,49513,3575898306,3575898319,13
2,1274,49514,3575898306,3575898319,13
2,1274,49515,3575898306,3575898320,14
2,1274,49516,3575898306,3575898320,14
2,1274,49517,3575898306,3575898321,15
2,1274,49518,3575898306,3575898321,15
2,1274,49519,3575898306,3575898322,16
2,1274,49520,3575898306,3575898322,16
2,1274,49521,3575898306,3575898324,18
2,1274,49522,3575898306,3575898325,19
2,1274,49523,3575898306,3575898326,20
2,1274,49524,3575898306,3575898326,20
2,1274,49525,3575898306,3575898327,21
2,1274,49526,3575898306,3575898327,21
2,1274,49527,3575898306,3575898329,23
2,1274,49528,3575898306,3575898329,23
2,1274,49529,3575898306,3575898331,25
2,1274,49530,3575898306,3575898331,25
2,1274,49531,3575898306,3575898332,26
2,1274,49532,3575898306,3575898332,26
2,1274,49533,3575898306,3575898333,27
2,1274,49534,3575898306,3575898334,28
2,1274,49535,3575898306,3575898334,28
2,1274,49536,3575898306,3575898334,28
2,1274,49537,3575898306,3575898334,28
2,1274,49538,3575898306,3575898334,28
2,1274,49539,3575898306,3575898335,29
2,1274,49540,3575898306,3575898336,30
2,1274,49541,3575898306,3575898338,32
2,1274,49542,3575898306,3575898339,33
2,1274,49543,3575898306,3575898339,33
2,1274,49544,3575898306,3575898344,38
2,1274,49545,3575898306,3575898344,38
2,1274,49546,3575898306,3575898345,39
2,1274,49547,3575898306,3575898345,39
2,1274,49548,3575898306,3575898345,39
2,1274