t_id, iteration_count, request_count, request_start_time, request_end_time, request_processing_time
3,120,1,3575832022,3575832067,45
3,124,2,3575832224,3575832267,43
3,128,3,3575832425,3575832467,42
3,128,4,3575832425,3575832472,47
3,129,5,3575832476,3575832522,46
3,132,6,3575832628,3575832666,38
3,132,7,3575832628,3575832672,44
3,133,8,3575832679,3575832722,43
3,136,9,3575832830,3575832866,36
3,136,10,3575832830,3575832872,42
3,136,11,3575832830,3575832877,47
3,137,12,3575832881,3575832922,41
3,140,13,3575833032,3575833066,34
3,140,14,3575833032,3575833072,40
3,140,15,3575833032,3575833078,46
3,140,16,3575833032,3575833080,48
3,141,17,3575833082,3575833122,40
3,142,18,3575833133,3575833182,49
3,144,19,3575833235,3575833266,31
3,144,20,3575833235,3575833272,37
3,144,21,3575833235,3575833278,43
3,144,22,3575833235,3575833280,45
3,145,23,3575833285,3575833322,37
3,146,24,3575833336,3575833382,46
3,148,25,3575833437,3575833467,30
3,148,26,3575833437,3575833473,36
3,148,27,3575833437,3575833478,41
3,148,28,3575833437,3575833480,43
3,149,29,3575833487,3575833521,34
3,150,30,3575833538,3575833581,43
3,151,31,3575833588,3575833636,48
3,152,32,3575833639,3575833667,28
3,152,33,3575833639,3575833674,35
3,152,34,3575833639,3575833678,39
3,152,35,3575833639,3575833680,41
3,153,36,3575833689,3575833721,32
3,154,37,3575833740,3575833781,41
3,155,38,3575833791,3575833791,0
3,155,39,3575833791,3575833836,45
3,155,40,3575833791,3575833840,49
3,156,41,3575833842,3575833866,24
3,156,42,3575833842,3575833873,31
3,156,43,3575833842,3575833877,35
3,156,44,3575833842,3575833880,38
3,157,45,3575833893,3575833921,28
3,157,46,3575833893,3575833942,49
3,158,47,3575833943,3575833980,37
3,158,48,3575833943,3575833989,46
3,159,49,3575833994,3575834036,42
3,159,50,3575833994,3575834040,46
3,160,51,3575834044,3575834066,22
3,160,52,3575834044,3575834073,29
3,160,53,3575834044,3575834077,33
3,160,54,3575834044,3575834081,37
3,161,55,3575834095,3575834121,26
3,161,56,3575834095,3575834142,47
3,161,57,3575834095,3575834144,49
3,162,58,3575834145,3575834180,35
3,162,59,3575834145,3575834190,45
3,163,60,3575834196,3575834236,40
3,163,61,3575834196,3575834240,44
3,164,62,3575834246,3575834266,20
3,164,63,3575834246,3575834273,27
3,164,64,3575834246,3575834277,31
3,164,65,3575834246,3575834281,35
3,165,66,3575834297,3575834322,25
3,165,67,3575834297,3575834343,46
3,165,68,3575834297,3575834344,47
3,166,69,3575834347,3575834347,0
3,166,70,3575834347,3575834381,34
3,166,71,3575834347,3575834389,42
3,167,72,3575834398,3575834437,39
3,167,73,3575834398,3575834439,41
3,168,74,3575834449,3575834449,0
3,168,75,3575834449,3575834466,17
3,168,76,3575834449,3575834473,24
3,168,77,3575834449,3575834478,29
3,168,78,3575834449,3575834481,32
3,169,79,3575834500,3575834520,20
3,169,80,3575834500,3575834542,42
3,169,81,3575834500,3575834543,43
3,169,82,3575834500,3575834546,46
3,170,83,3575834551,3575834581,30
3,170,84,3575834551,3575834589,38
3,170,85,3575834551,3575834599,48
3,171,86,3575834602,3575834636,34
3,171,87,3575834602,3575834638,36
3,171,88,3575834602,3575834648,46
3,172,89,3575834653,3575834665,12
3,172,90,3575834653,3575834673,20
3,172,91,3575834653,3575834679,26
3,172,92,3575834653,3575834681,28
3,172,93,3575834653,3575834702,49
3,173,94,3575834704,3575834721,17
3,173,95,3575834704,3575834741,37
3,173,96,3575834704,3575834743,39
3,173,97,3575834704,3575834745,41
3,174,98,3575834755,3575834780,25
3,174,99,3575834755,3575834788,33
3,174,100,3575834755,3575834799,44
3,175,101,3575834805,3575834836,31
3,175,102,3575834805,3575834838,33
3,175,103,3575834805,3575834848,43
3,176,104,3575834856,3575834867,11
3,176,105,3575834856,3575834873,17
3,176,106,3575834856,3575834880,24
3,176,107,3575834856,3575834881,25
3,176,108,3575834856,3575834902,46
3,177,109,3575834906,3575834922,16
3,177,110,3575834906,3575834941,35
3,177,111,3575834906,3575834943,37
3,177,112,3575834906,3575834945,39
3,177,113,3575834906,3575834955,49
3,178,114,3575834957,3575834981,24
3,178,115,3575834957,3575834988,31
3,178,116,3575834957,3575834999,42
3,178,117,3575834957,3575835006,49
3,179,118,3575835008,3575835035,27
3,179,119,3575835008,3575835039,31
3,179,120,3575835008,3575835048,40
3,180,121,3575835059,3575835067,8
3,180,122,3575835059,3575835073,14
3,180,123,3575835059,3575835079,20
3,180,124,3575835059,3575835081,22
3,180,125,3575835059,3575835102,43
3,181,126,3575835109,3575835123,14
3,181,127,3575835109,3575835141,32
3,181,128,3575835109,3575835143,34
3,181,129,3575835109,3575835145,36
3,181,130,3575835109,3575835155,46
3,182,131,3575835160,3575835181,21
3,182,132,3575835160,3575835188,28
3,182,133,3575835160,3575835199,39
3,182,134,3575835160,3575835206,46
3,182,135,3575835160,3575835209,49
3,183,136,3575835211,3575835236,25
3,183,137,3575835211,3575835239,28
3,183,138,3575835211,3575835247,36
3,184,139,3575835262,3575835267,5
3,184,140,3575835262,3575835273,11
3,184,141,3575835262,3575835279,17
3,184,142,3575835262,3575835281,19
3,184,143,3575835262,3575835302,40
3,184,144,3575835262,3575835310,48
3,185,145,3575835313,3575835324,11
3,185,146,3575835313,3575835341,28
3,185,147,3575835313,3575835343,30
3,185,148,3575835313,3575835346,33
3,185,149,3575835313,3575835355,42
3,185,150,3575835313,3575835361,48
3,186,151,3575835363,3575835381,18
3,186,152,3575835363,3575835388,25
3,186,153,3575835363,3575835399,36
3,186,154,3575835363,3575835405,42
3,186,155,3575835363,3575835409,46
3,187,156,3575835414,3575835436,22
3,187,157,3575835414,3575835439,25
3,187,158,3575835414,3575835448,34
3,188,159,3575835465,3575835467,2
3,188,160,3575835465,3575835473,8
3,188,161,3575835465,3575835480,15
3,188,162,3575835465,3575835481,16
3,188,163,3575835465,3575835502,37
3,188,164,3575835465,3575835509,44
3,188,165,3575835465,3575835513,48
3,189,166,3575835516,3575835523,7
3,189,167,3575835516,3575835541,25
3,189,168,3575835516,3575835542,26
3,189,169,3575835516,3575835545,29
3,189,170,3575835516,3575835554,38
3,189,171,3575835516,3575835561,45
3,190,172,3575835567,3575835579,12
3,190,173,3575835567,3575835587,20
3,190,174,3575835567,3575835598,31
3,190,175,3575835567,3575835604,37
3,190,176,3575835567,3575835608,41
3,191,177,3575835618,3575835635,17
3,191,178,3575835618,3575835638,20
3,191,179,3575835618,3575835647,29
3,191,180,3575835618,3575835666,48
3,192,181,3575835669,3575835673,4
3,192,182,3575835669,3575835680,11
3,192,183,3575835669,3575835682,13
3,192,184,3575835669,3575835701,32
3,192,185,3575835669,3575835710,41
3,192,186,3575835669,3575835713,44
3,193,187,3575835719,3575835723,4
3,193,188,3575835719,3575835741,22
3,193,189,3575835719,3575835742,23
3,193,190,3575835719,3575835745,26
3,193,191,3575835719,3575835754,35
3,193,192,3575835719,3575835760,41
3,194,193,3575835770,3575835780,10
3,194,194,3575835770,3575835788,18
3,194,195,3575835770,3575835798,28
3,194,196,3575835770,3575835805,35
3,194,197,3575835770,3575835809,39
3,195,198,3575835821,3575835835,14
3,195,199,3575835821,3575835838,17
3,195,200,3575835821,3575835847,26
3,195,201,3575835821,3575835867,46
3,195,202,3575835821,3575835867,46
3,196,203,3575835872,3575835874,2
3,196,204,3575835872,3575835880,8
3,196,205,3575835872,3575835882,10
3,196,206,3575835872,3575835902,30
3,196,207,3575835872,3575835910,38
3,197,208,3575835922,3575835922,0
3,197,209,3575835922,3575835941,19
3,197,210,3575835922,3575835942,20
3,197,211,3575835922,3575835946,24
3,197,212,3575835922,3575835954,32
3,197,213,3575835922,3575835960,38
3,198,214,3575835973,3575835981,8
3,198,215,3575835973,3575835989,16
3,198,216,3575835973,3575835998,25
3,198,217,3575835973,3575836005,32
3,198,218,3575835973,3575836009,36
3,199,219,3575836024,3575836035,11
3,199,220,3575836024,3575836038,14
3,199,221,3575836024,3575836047,23
3,199,222,3575836024,3575836067,43
3,199,223,3575836024,3575836067,43
3,199,224,3575836024,3575836073,49
3,200,225,3575836075,3575836080,5
3,200,226,3575836075,3575836082,7
3,200,227,3575836075,3575836102,27
3,200,228,3575836075,3575836110,35
3,200,229,3575836075,3575836123,48
3,201,230,3575836126,3575836142,16
3,201,231,3575836126,3575836142,16
3,201,232,3575836126,3575836146,20
3,201,233,3575836126,3575836154,28
3,201,234,3575836126,3575836160,34
3,202,235,3575836177,3575836181,4
3,202,236,3575836177,3575836189,12
3,202,237,3575836177,3575836198,21
3,202,238,3575836177,3575836205,28
3,202,239,3575836177,3575836209,32
3,203,240,3575836228,3575836236,8
3,203,241,3575836228,3575836238,10
3,203,242,3575836228,3575836247,19
3,203,243,3575836228,3575836267,39
3,203,244,3575836228,3575836267,39
3,203,245,3575836228,3575836273,45
3,204,246,3575836279,3575836279,0
3,204,247,3575836279,3575836282,3
3,204,248,3575836279,3575836302,23
3,204,249,3575836279,3575836310,31
3,204,250,3575836279,3575836322,43
3,205,251,3575836330,3575836342,12
3,205,252,3575836330,3575836343,13
3,205,253,3575836330,3575836346,16
3,205,254,3575836330,3575836355,25
3,205,255,3575836330,3575836361,31
3,206,256,3575836381,3575836381,0
3,206,257,3575836381,3575836388,7
3,206,258,3575836381,3575836399,18
3,206,259,3575836381,3575836404,23
3,206,260,3575836381,3575836408,27
3,207,261,3575836432,3575836436,4
3,207,262,3575836432,3575836439,7
3,207,263,3575836432,3575836448,16
3,207,264,3575836432,3575836467,35
3,207,265,3575836432,3575836468,36
3,207,266,3575836432,3575836473,41
3,207,267,3575836432,3575836479,47
3,207,268,3575836432,3575836482,50
3,208,269,3575836483,3575836501,18
3,208,270,3575836483,3575836509,26
3,208,271,3575836483,3575836522,39
3,209,272,3575836534,3575836541,7
3,209,273,3575836534,3575836542,8
3,209,274,3575836534,3575836545,11
3,209,275,3575836534,3575836554,20
3,209,276,3575836534,3575836559,25
3,209,277,3575836534,3575836580,46
3,210,278,3575836585,3575836587,2
3,210,279,3575836585,3575836598,13
3,210,280,3575836585,3575836603,18
3,210,281,3575836585,3575836608,23
3,211,282,3575836636,3575836636,0
3,211,283,3575836636,3575836638,2
3,211,284,3575836636,3575836647,11
3,211,285,3575836636,3575836666,30
3,211,286,3575836636,3575836667,31
3,211,287,3575836636,3575836673,37
3,211,288,3575836636,3575836679,43
3,211,289,3575836636,3575836682,46
3,212,290,3575836687,3575836701,14
3,212,291,3575836687,3575836709,22
3,212,292,3575836687,3575836722,35
3,213,293,3575836738,3575836741,3
3,213,294,3575836738,3575836742,4
3,213,295,3575836738,3575836745,7
3,213,296,3575836738,3575836754,16
3,213,297,3575836738,3575836759,21
3,213,298,3575836738,3575836780,42
3,213,299,3575836738,3575836787,49
3,214,300,3575836789,3575836798,9
3,214,301,3575836789,3575836805,16
3,214,302,3575836789,3575836808,19
3,214,303,3575836789,3575836836,47
3,214,304,3575836789,3575836838,49
3,215,305,3575836840,3575836847,7
3,215,306,3575836840,3575836867,27
3,215,307,3575836840,3575836867,27
3,215,308,3575836840,3575836873,33
3,215,309,3575836840,3575836880,40
3,215,310,3575836840,3575836881,41
3,216,311,3575836891,3575836901,10
3,216,312,3575836891,3575836910,19
3,216,313,3575836891,3575836923,32
3,216,314,3575836891,3575836941,50
3,217,315,3575836942,3575836943,1
3,217,316,3575836942,3575836945,3
3,217,317,3575836942,3575836954,12
3,217,318,3575836942,3575836959,17
3,217,319,3575836942,3575836981,39
3,217,320,3575836942,3575836988,46
3,218,321,3575836993,3575836998,5
3,218,322,3575836993,3575837005,12
3,218,323,3575836993,3575837008,15
3,218,324,3575836993,3575837037,44
3,218,325,3575836993,3575837038,45
3,219,326,3575837044,3575837047,3
3,219,327,3575837044,3575837067,23
3,219,328,3575837044,3575837068,24
3,219,329,3575837044,3575837073,29
3,219,330,3575837044,3575837079,35
3,219,331,3575837044,3575837082,38
3,219,332,3575837044,3575837082,38
3,220,333,3575837095,3575837101,6
3,220,334,3575837095,3575837109,14
3,220,335,3575837095,3575837122,27
3,220,336,3575837095,3575837142,47
3,220,337,3575837095,3575837143,48
3,221,338,3575837146,3575837146,0
3,221,339,3575837146,3575837154,8
3,221,340,3575837146,3575837159,13
3,221,341,3575837146,3575837182,36
3,221,342,3575837146,3575837183,37
3,221,343,3575837146,3575837187,41
3,222,344,3575837197,3575837198,1
3,222,345,3575837197,3575837205,8
3,222,346,3575837197,3575837208,11
3,222,347,3575837197,3575837236,39
3,222,348,3575837197,3575837237,40
3,223,349,3575837248,3575837248,0
3,223,350,3575837248,3575837267,19
3,223,351,3575837248,3575837269,21
3,223,352,3575837248,3575837273,25
3,223,353,3575837248,3575837279,31
3,223,354,3575837248,3575837282,34
3,223,355,3575837248,3575837282,34
3,224,356,3575837299,3575837301,2
3,224,357,3575837299,3575837310,11
3,224,358,3575837299,3575837323,24
3,224,359,3575837299,3575837335,36
3,224,360,3575837299,3575837341,42
3,224,361,3575837299,3575837343,44
3,224,362,3575837299,3575837346,47
3,225,363,3575837350,3575837354,4
3,225,364,3575837350,3575837359,9
3,225,365,3575837350,3575837381,31
3,225,366,3575837350,3575837383,33
3,225,367,3575837350,3575837388,38
3,225,368,3575837350,3575837399,49
3,226,369,3575837401,3575837405,4
3,226,370,3575837401,3575837408,7
3,226,371,3575837401,3575837436,35
3,226,372,3575837401,3575837437,36
3,226,373,3575837401,3575837448,47
3,227,374,3575837452,3575837467,15
3,227,375,3575837452,3575837469,17
3,227,376,3575837452,3575837473,21
3,227,377,3575837452,3575837479,27
3,227,378,3575837452,3575837482,30
3,227,379,3575837452,3575837483,31
3,227,380,3575837452,3575837501,49
3,228,381,3575837503,3575837509,6
3,228,382,3575837503,3575837522,19
3,228,383,3575837503,3575837534,31
3,228,384,3575837503,3575837540,37
3,228,385,3575837503,3575837542,39
3,228,386,3575837503,3575837545,42
3,229,387,3575837554,3575837554,0
3,229,388,3575837554,3575837558,4
3,229,389,3575837554,3575837581,27
3,229,390,3575837554,3575837582,28
3,229,391,3575837554,3575837587,33
3,229,392,3575837554,3575837599,45
3,230,393,3575837605,3575837605,0
3,230,394,3575837605,3575837606,1
3,230,395,3575837605,3575837635,30
3,230,396,3575837605,3575837637,32
3,230,397,3575837605,3575837647,42
3,231,398,3575837656,3575837666,10
3,231,399,3575837656,3575837669,13
3,231,400,3575837656,3575837673,17
3,231,401,3575837656,3575837679,23
3,231,402,3575837656,3575837682,26
3,231,403,3575837656,3575837683,27
3,231,404,3575837656,3575837701,45
3,232,405,3575837707,3575837709,2
3,232,406,3575837707,3575837722,15
3,232,407,3575837707,3575837734,27
3,232,408,3575837707,3575837740,33
3,232,409,3575837707,3575837741,34
3,232,410,3575837707,3575837745,38
3,232,411,3575837707,3575837754,47
3,233,412,3575837758,3575837758,0
3,233,413,3575837758,3575837780,22
3,233,414,3575837758,3575837782,24
3,233,415,3575837758,3575837787,29
3,233,416,3575837758,3575837790,32
3,233,417,3575837758,3575837799,41
3,233,418,3575837758,3575837805,47
3,233,419,3575837758,3575837807,49
3,234,420,3575837809,3575837836,27
3,234,421,3575837809,3575837837,28
3,234,422,3575837809,3575837847,38
3,235,423,3575837860,3575837866,6
3,235,424,3575837860,3575837868,8
3,235,425,3575837860,3575837873,13
3,235,426,3575837860,3575837879,19
3,235,427,3575837860,3575837882,22
3,235,428,3575837860,3575837883,23
3,235,429,3575837860,3575837901,41
3,235,430,3575837860,3575837909,49
3,236,431,3575837911,3575837922,11
3,236,432,3575837911,3575837934,23
3,236,433,3575837911,3575837941,30
3,236,434,3575837911,3575837942,31
3,236,435,3575837911,3575837945,34
3,236,436,3575837911,3575837954,43
3,236,437,3575837911,3575837958,47
3,237,438,3575837962,3575837981,19
3,237,439,3575837962,3575837982,20
3,237,440,3575837962,3575837987,25
3,237,441,3575837962,3575837990,28
3,237,442,3575837962,3575837993,31
3,237,443,3575837962,3575837999,37
3,237,444,3575837962,3575838005,43
3,237,445,3575837962,3575838008,46
3,238,446,3575838013,3575838036,23
3,238,447,3575838013,3575838037,24
3,238,448,3575838013,3575838047,34
3,239,449,3575838064,3575838066,2
3,239,450,3575838064,3575838068,4
3,239,451,3575838064,3575838073,9
3,239,452,3575838064,3575838079,15
3,239,453,3575838064,3575838082,18
3,239,454,3575838064,3575838083,19
3,239,455,3575838064,3575838101,37
3,239,456,3575838064,3575838109,45
3,240,457,3575838115,3575838122,7
3,240,458,3575838115,3575838134,19
3,240,459,3575838115,3575838141,26
3,240,460,3575838115,3575838142,27
3,240,461,3575838115,3575838146,31
3,240,462,3575838115,3575838154,39
3,241,463,3575838166,3575838180,14
3,241,464,3575838166,3575838182,16
3,241,465,3575838166,3575838188,22
3,241,466,3575838166,3575838193,27
3,241,467,3575838166,3575838199,33
3,241,468,3575838166,3575838204,38
3,241,469,3575838166,3575838207,41
3,242,470,3575838217,3575838235,18
3,242,471,3575838217,3575838238,21
3,242,472,3575838217,3575838248,31
3,242,473,3575838217,3575838266,49
3,243,474,3575838268,3575838268,0
3,243,475,3575838268,3575838273,5
3,243,476,3575838268,3575838280,12
3,243,477,3575838268,3575838282,14
3,243,478,3575838268,3575838282,14
3,243,479,3575838268,3575838301,33
3,243,480,3575838268,3575838309,41
3,244,481,3575838319,3575838321,2
3,244,482,3575838319,3575838334,15
3,244,483,3575838319,3575838340,21
3,244,484,3575838319,3575838343,24
3,244,485,3575838319,3575838346,27
3,244,486,3575838319,3575838354,35
3,245,487,3575838370,3575838381,11
3,245,488,3575838370,3575838382,12
3,245,489,3575838370,3575838389,19
3,245,490,3575838370,3575838392,22
3,245,491,3575838370,3575838399,29
3,245,492,3575838370,3575838405,35
3,245,493,3575838370,3575838408,38
3,246,494,3575838421,3575838436,15
3,246,495,3575838421,3575838438,17
3,246,496,3575838421,3575838447,26
3,246,497,3575838421,3575838466,45
3,246,498,3575838421,3575838468,47
3,247,499,3575838472,3575838473,1
3,247,500,3575838472,3575838479,7
3,247,501,3575838472,3575838482,10
3,247,502,3575838472,3575838482,10
3,247,503,3575838472,3575838501,29
3,247,504,3575838472,3575838509,37
3,247,505,3575838472,3575838522,50
3,248,506,3575838523,3575838533,10
3,248,507,3575838523,3575838539,16
3,248,508,3575838523,3575838542,19
3,248,509,3575838523,3575838545,22
3,248,510,3575838523,3575838553,30
3,248,511,3575838523,3575838558,35
3,249,512,3575838574,3575838579,5
3,249,513,3575838574,3575838581,7
3,249,514,3575838574,3575838588,14
3,249,515,3575838574,3575838591,17
3,249,516,3575838574,3575838598,24
3,249,517,3575838574,3575838600,26
3,249,518,3575838574,3575838604,30
3,249,519,3575838574,3575838607,33
3,250,520,3575838625,3575838635,10
3,250,521,3575838625,3575838638,13
3,250,522,3575838625,3575838647,22
3,250,523,3575838625,3575838649,24
3,250,524,3575838625,3575838665,40
3,250,525,3575838625,3575838667,42
3,250,526,3575838625,3575838673,48
3,251,527,3575838677,3575838679,2
3,251,528,3575838677,3575838682,5
3,251,529,3575838677,3575838682,5
3,251,530,3575838677,3575838701,24
3,251,531,3575838677,3575838709,32
3,251,532,3575838677,3575838722,45
3,252,533,3575838729,3575838733,4
3,252,534,3575838729,3575838740,11
3,252,535,3575838729,3575838742,13
3,252,536,3575838729,3575838744,15
3,252,537,3575838729,3575838754,25
3,252,538,3575838729,3575838758,29
3,253,539,3575838780,3575838780,0
3,253,540,3575838780,3575838781,1
3,253,541,3575838780,3575838787,7
3,253,542,3575838780,3575838791,11
3,253,543,3575838780,3575838798,18
3,253,544,3575838780,3575838800,20
3,253,545,3575838780,3575838802,22
3,253,546,3575838780,3575838805,25
3,253,547,3575838780,3575838807,27
3,254,548,3575838831,3575838835,4
3,254,549,3575838831,3575838837,6
3,254,550,3575838831,3575838847,16
3,254,551,3575838831,3575838849,18
3,254,552,3575838831,3575838865,34
3,254,553,3575838831,3575838867,36
3,254,554,3575838831,3575838873,42
3,255,555,3575838882,3575838882,0
3,255,556,3575838882,3575838882,0
3,255,557,3575838882,3575838901,19
3,255,558,3575838882,3575838909,27
3,255,559,3575838882,3575838922,40
3,256,560,3575838933,3575838933,0
3,256,561,3575838933,3575838940,7
3,256,562,3575838933,3575838943,10
3,256,563,3575838933,3575838945,12
3,256,564,3575838933,3575838954,21
3,256,565,3575838933,3575838958,25
3,256,566,3575838933,3575838981,48
3,256,567,3575838933,3575838982,49
3,257,568,3575838984,3575838988,4
3,257,569,3575838984,3575838991,7
3,257,570,3575838984,3575838998,14
3,257,571,3575838984,3575839000,16
3,257,572,3575838984,3575839002,18
3,257,573,3575838984,3575839004,20
3,257,574,3575838984,3575839005,21
3,257,575,3575838984,3575839008,24
3,258,576,3575839035,3575839036,1
3,258,577,3575839035,3575839037,2
3,258,578,3575839035,3575839047,12
3,258,579,3575839035,3575839050,15
3,258,580,3575839035,3575839055,20
3,258,581,3575839035,3575839066,31
3,258,582,3575839035,3575839067,32
3,258,583,3575839035,3575839073,38
3,258,584,3575839035,3575839082,47
3,258,585,3575839035,3575839082,47
3,259,586,3575839087,3575839101,14
3,259,587,3575839087,3575839110,23
3,259,588,3575839087,3575839122,35
3,259,589,3575839087,3575839134,47
3,260,590,3575839138,3575839141,3
3,260,591,3575839138,3575839143,5
3,260,592,3575839138,3575839146,8
3,260,593,3575839138,3575839154,16
3,260,594,3575839138,3575839159,21
3,260,595,3575839138,3575839180,42
3,260,596,3575839138,3575839182,44
3,260,597,3575839138,3575839188,50
3,261,598,3575839190,3575839191,1
3,261,599,3575839190,3575839198,8
3,261,600,3575839190,3575839200,10
3,261,601,3575839190,3575839202,12
3,261,602,3575839190,3575839204,14
3,261,603,3575839190,3575839205,15
3,261,604,3575839190,3575839208,18
3,261,605,3575839190,3575839236,46
3,261,606,3575839190,3575839238,48
3,262,607,3575839241,3575839248,7
3,262,608,3575839241,3575839250,9
3,262,609,3575839241,3575839256,15
3,262,610,3575839241,3575839266,25
3,262,611,3575839241,3575839267,26
3,262,612,3575839241,3575839273,32
3,262,613,3575839241,3575839279,38
3,262,614,3575839241,3575839282,41
3,262,615,3575839241,3575839283,42
3,263,616,3575839292,3575839301,9
3,263,617,3575839292,3575839310,18
3,263,618,3575839292,3575839322,30
3,263,619,3575839292,3575839334,42
3,263,620,3575839292,3575839340,48
3,264,621,3575839343,3575839343,0
3,264,622,3575839343,3575839346,3
3,264,623,3575839343,3575839354,11
3,264,624,3575839343,3575839359,16
3,264,625,3575839343,3575839380,37
3,264,626,3575839343,3575839383,40
3,264,627,3575839343,3575839387,44
3,264,628,3575839343,3575839391,48
3,265,629,3575839394,3575839399,5
3,265,630,3575839394,3575839401,7
3,265,631,3575839394,3575839402,8
3,265,632,3575839394,3575839404,10
3,265,633,3575839394,3575839405,11
3,265,634,3575839394,3575839408,14
3,265,635,3575839394,3575839436,42
3,265,636,3575839394,3575839438,44
3,266,637,3575839445,3575839448,3
3,266,638,3575839445,3575839450,5
3,266,639,3575839445,3575839455,10
3,266,640,3575839445,3575839461,16
3,266,641,3575839445,3575839466,21
3,266,642,3575839445,3575839467,22
3,266,643,3575839445,3575839473,28
3,266,644,3575839445,3575839480,35
3,266,645,3575839445,3575839482,37
3,266,646,3575839445,3575839483,38
3,267,647,3575839496,3575839500,4
3,267,648,3575839496,3575839509,13
3,267,649,3575839496,3575839521,25
3,267,650,3575839496,3575839533,37
3,267,651,3575839496,3575839539,43
3,267,652,3575839496,3575839543,47
3,267,653,3575839496,3575839545,49
3,268,654,3575839547,3575839554,7
3,268,655,3575839547,3575839559,12
3,268,656,3575839547,3575839580,33
3,268,657,3575839547,3575839582,35
3,268,658,3575839547,3575839588,41
3,268,659,3575839547,3575839590,43
3,269,660,3575839598,3575839598,0
3,269,661,3575839598,3575839599,1
3,269,662,3575839598,3575839602,4
3,269,663,3575839598,3575839603,5
3,269,664,3575839598,3575839604,6
3,269,665,3575839598,3575839606,8
3,269,666,3575839598,3575839635,37
3,269,667,3575839598,3575839637,39
3,269,668,3575839598,3575839647,49
3,270,669,3575839649,3575839649,0
3,270,670,3575839649,3575839655,6
3,270,671,3575839649,3575839659,10
3,270,672,3575839649,3575839661,12
3,270,673,3575839649,3575839666,17
3,270,674,3575839649,3575839666,17
3,270,675,3575839649,3575839672,23
3,270,676,3575839649,3575839673,24
3,270,677,3575839649,3575839680,31
3,270,678,3575839649,3575839682,33
3,270,679,3575839649,3575839683,34
3,271,680,3575839701,3575839701,0
3,271,681,3575839701,3575839709,8
3,271,682,3575839701,3575839721,20
3,271,683,3575839701,3575839732,31
3,271,684,3575839701,3575839741,40
3,271,685,3575839701,3575839743,42
3,271,686,3575839701,3575839744,43
3,272,687,3575839753,3575839755,2
3,272,688,3575839753,3575839758,5
3,272,689,3575839753,3575839779,26
3,272,690,3575839753,3575839782,29
3,272,691,3575839753,3575839787,34
3,272,692,3575839753,3575839792,39
3,272,693,3575839753,3575839798,45
3,272,694,3575839753,3575839799,46
3,272,695,3575839753,3575839801,48
3,273,696,3575839804,3575839804,0
3,273,697,3575839804,3575839805,1
3,273,698,3575839804,3575839806,2
3,273,699,3575839804,3575839835,31
3,273,700,3575839804,3575839838,34
3,273,701,3575839804,3575839847,43
3,273,702,3575839804,3575839849,45
3,274,703,3575839855,3575839855,0
3,274,704,3575839855,3575839859,4
3,274,705,3575839855,3575839862,7
3,274,706,3575839855,3575839866,11
3,274,707,3575839855,3575839866,11
3,274,708,3575839855,3575839872,17
3,274,709,3575839855,3575839873,18
3,274,710,3575839855,3575839879,24
3,274,711,3575839855,3575839882,27
3,274,712,3575839855,3575839884,29
3,274,713,3575839855,3575839901,46
3,275,714,3575839906,3575839910,4
3,275,715,3575839906,3575839921,15
3,275,716,3575839906,3575839933,27
3,275,717,3575839906,3575839940,34
3,275,718,3575839906,3575839945,39
3,275,719,3575839906,3575839954,48
3,276,720,3575839957,3575839958,1
3,276,721,3575839957,3575839981,24
3,276,722,3575839957,3575839982,25
3,276,723,3575839957,3575839988,31
3,276,724,3575839957,3575839992,35
3,276,725,3575839957,3575839998,41
3,276,726,3575839957,3575839999,42
3,276,727,3575839957,3575840001,44
3,276,728,3575839957,3575840004,47
3,276,729,3575839957,3575840006,49
3,277,730,3575840009,3575840009,0
3,277,731,3575840009,3575840035,26
3,277,732,3575840009,3575840038,29
3,277,733,3575840009,3575840047,38
3,277,734,3575840009,3575840049,40
3,277,735,3575840009,3575840055,46
3,278,736,3575840061,3575840061,0
3,278,737,3575840061,3575840062,1
3,278,738,3575840061,3575840066,5
3,278,739,3575840061,3575840067,6
3,278,740,3575840061,3575840072,11
3,278,741,3575840061,3575840074,13
3,278,742,3575840061,3575840079,18
3,278,743,3575840061,3575840082,21
3,278,744,3575840061,3575840084,23
3,278,745,3575840061,3575840101,40
3,278,746,3575840061,3575840110,49
3,279,747,3575840112,3575840119,7
3,279,748,3575840112,3575840121,9
3,279,749,3575840112,3575840134,22
3,279,750,3575840112,3575840140,28
3,279,751,3575840112,3575840143,31
3,279,752,3575840112,3575840146,34
3,279,753,3575840112,3575840154,42
3,279,754,3575840112,3575840159,47
3,280,755,3575840163,3575840181,18
3,280,756,3575840163,3575840182,19
3,280,757,3575840163,3575840189,26
3,280,758,3575840163,3575840192,29
3,280,759,3575840163,3575840198,35
3,280,760,3575840163,3575840200,37
3,280,761,3575840163,3575840201,38
3,280,762,3575840163,3575840203,40
3,280,763,3575840163,3575840206,43
3,280,764,3575840163,3575840209,46
3,281,765,3575840215,3575840235,20
3,281,766,3575840215,3575840238,23
3,281,767,3575840215,3575840248,33
3,281,768,3575840215,3575840249,34
3,281,769,3575840215,3575840255,40
3,281,770,3575840215,3575840259,44
3,281,771,3575840215,3575840262,47
3,282,772,3575840266,3575840266,0
3,282,773,3575840266,3575840266,0
3,282,774,3575840266,3575840270,4
3,282,775,3575840266,3575840272,6
3,282,776,3575840266,3575840274,8
3,282,777,3575840266,3575840280,14
3,282,778,3575840266,3575840282,16
3,282,779,3575840266,3575840284,18
3,282,780,3575840266,3575840301,35
3,282,781,3575840266,3575840310,44
3,283,782,3575840317,3575840319,2
3,283,783,3575840317,3575840322,5
3,283,784,3575840317,3575840334,17
3,283,785,3575840317,3575840340,23
3,283,786,3575840317,3575840343,26
3,283,787,3575840317,3575840347,30
3,283,788,3575840317,3575840354,37
3,283,789,3575840317,3575840359,42
3,284,790,3575840368,3575840372,4
3,284,791,3575840368,3575840381,13
3,284,792,3575840368,3575840382,14
3,284,793,3575840368,3575840389,21
3,284,794,3575840368,3575840393,25
3,284,795,3575840368,3575840399,31
3,284,796,3575840368,3575840400,32
3,284,797,3575840368,3575840401,33
3,284,798,3575840368,3575840403,35
3,284,799,3575840368,3575840406,38
3,284,800,3575840368,3575840408,40
3,285,801,3575840420,3575840436,16
3,285,802,3575840420,3575840437,17
3,285,803,3575840420,3575840448,28
3,285,804,3575840420,3575840450,30
3,285,805,3575840420,3575840454,34
3,285,806,3575840420,3575840459,39
3,285,807,3575840420,3575840462,42
3,285,808,3575840420,3575840466,46
3,285,809,3575840420,3575840467,47
3,286,810,3575840471,3575840471,0
3,286,811,3575840471,3575840472,1
3,286,812,3575840471,3575840474,3
3,286,813,3575840471,3575840479,8
3,286,814,3575840471,3575840482,11
3,286,815,3575840471,3575840484,13
3,286,816,3575840471,3575840501,30
3,286,817,3575840471,3575840511,40
3,286,818,3575840471,3575840519,48
3,287,819,3575840522,3575840522,0
3,287,820,3575840522,3575840533,11
3,287,821,3575840522,3575840539,17
3,287,822,3575840522,3575840542,20
3,287,823,3575840522,3575840546,24
3,287,824,3575840522,3575840553,31
3,287,825,3575840522,3575840558,36
3,287,826,3575840522,3575840570,48
3,288,827,3575840573,3575840580,7
3,288,828,3575840573,3575840581,8
3,288,829,3575840573,3575840587,14
3,288,830,3575840573,3575840592,19
3,288,831,3575840573,3575840598,25
3,288,832,3575840573,3575840599,26
3,288,833,3575840573,3575840600,27
3,288,834,3575840573,3575840602,29
3,288,835,3575840573,3575840605,32
3,288,836,3575840573,3575840607,34
3,289,837,3575840625,3575840635,10
3,289,838,3575840625,3575840638,13
3,289,839,3575840625,3575840647,22
3,289,840,3575840625,3575840648,23
3,289,841,3575840625,3575840653,28
3,289,842,3575840625,3575840658,33
3,289,843,3575840625,3575840660,35
3,289,844,3575840625,3575840665,40
3,289,845,3575840625,3575840665,40
3,289,846,3575840625,3575840670,45
3,289,847,3575840625,3575840672,47
3,289,848,3575840625,3575840675,50
3,290,849,3575840677,3575840679,2
3,290,850,3575840677,3575840682,5
3,290,851,3575840677,3575840684,7
3,290,852,3575840677,3575840701,24
3,290,853,3575840677,3575840711,34
3,290,854,3575840677,3575840719,42
3,290,855,3575840677,3575840722,45
3,291,856,3575840729,3575840733,4
3,291,857,3575840729,3575840741,12
3,291,858,3575840729,3575840742,13
3,291,859,3575840729,3575840746,17
3,291,860,3575840729,3575840754,25
3,291,861,3575840729,3575840759,30
3,291,862,3575840729,3575840770,41
3,292,863,3575840781,3575840781,0
3,292,864,3575840781,3575840781,0
3,292,865,3575840781,3575840787,6
3,292,866,3575840781,3575840791,10
3,292,867,3575840781,3575840798,17
3,292,868,3575840781,3575840799,18
3,292,869,3575840781,3575840801,20
3,292,870,3575840781,3575840804,23
3,292,871,3575840781,3575840805,24
3,292,872,3575840781,3575840807,26
3,292,873,3575840781,3575840827,46
3,293,874,3575840832,3575840835,3
3,293,875,3575840832,3575840837,5
3,293,876,3575840832,3575840847,15
3,293,877,3575840832,3575840849,17
3,293,878,3575840832,3575840854,22
3,293,879,3575840832,3575840858,26
3,293,880,3575840832,3575840861,29
3,293,881,3575840832,3575840865,33
3,293,882,3575840832,3575840867,35
3,293,883,3575840832,3575840870,38
3,293,884,3575840832,3575840872,40
3,293,885,3575840832,3575840875,43
3,293,886,3575840832,3575840879,47
3,293,887,3575840832,3575840882,50
3,294,888,3575840883,3575840884,1
3,294,889,3575840883,3575840901,18
3,294,890,3575840883,3575840911,28
3,294,891,3575840883,3575840919,36
3,294,892,3575840883,3575840922,39
3,294,893,3575840883,3575840928,45
3,295,894,3575840935,3575840935,0
3,295,895,3575840935,3575840941,6
3,295,896,3575840935,3575840946,11
3,295,897,3575840935,3575840954,19
3,295,898,3575840935,3575840958,23
3,295,899,3575840935,3575840971,36
3,295,900,3575840935,3575840980,45
3,295,901,3575840935,3575840982,47
3,296,902,3575840987,3575840988,1
3,296,903,3575840987,3575840991,4
3,296,904,3575840987,3575840998,11
3,296,905,3575840987,3575840999,12
3,296,906,3575840987,3575841000,13
3,296,907,3575840987,3575841003,16
3,296,908,3575840987,3575841005,18
3,296,909,3575840987,3575841008,21
3,296,910,3575840987,3575841027,40
3,296,911,3575840987,3575841035,48
3,297,912,3575841039,3575841039,0
3,297,913,3575841039,3575841047,8
3,297,914,3575841039,3575841049,10
3,297,915,3575841039,3575841055,16
3,297,916,3575841039,3575841058,19
3,297,917,3575841039,3575841061,22
3,297,918,3575841039,3575841065,26
3,297,919,3575841039,3575841066,27
3,297,920,3575841039,3575841070,31
3,297,921,3575841039,3575841072,33
3,297,922,3575841039,3575841075,36
3,297,923,3575841039,3575841079,40
3,297,924,3575841039,3575841082,43
3,297,925,3575841039,3575841084,45
3,298,926,3575841090,3575841101,11
3,298,927,3575841090,3575841111,21
3,298,928,3575841090,3575841119,29
3,298,929,3575841090,3575841121,31
3,298,930,3575841090,3575841134,44
3,299,931,3575841142,3575841142,0
3,299,932,3575841142,3575841143,1
3,299,933,3575841142,3575841146,4
3,299,934,3575841142,3575841154,12
3,299,935,3575841142,3575841159,17
3,299,936,3575841142,3575841171,29
3,299,937,3575841142,3575841181,39
3,299,938,3575841142,3575841182,40
3,299,939,3575841142,3575841182,40
3,299,940,3575841142,3575841187,45
3,299,941,3575841142,3575841192,50
3,300,942,3575841194,3575841198,4
3,300,943,3575841194,3575841199,5
3,300,944,3575841194,3575841201,7
3,300,945,3575841194,3575841204,10
3,300,946,3575841194,3575841205,11
3,300,947,3575841194,3575841208,14
3,300,948,3575841194,3575841227,33
3,300,949,3575841194,3575841235,41
3,300,950,3575841194,3575841237,43
3,301,951,3575841246,3575841248,2
3,301,952,3575841246,3575841248,2
3,301,953,3575841246,3575841255,9
3,301,954,3575841246,3575841259,13
3,301,955,3575841246,3575841261,15
3,301,956,3575841246,3575841265,19
3,301,957,3575841246,3575841266,20
3,301,958,3575841246,3575841270,24
3,301,959,3575841246,3575841272,26
3,301,960,3575841246,3575841275,29
3,301,961,3575841246,3575841282,36
3,301,962,3575841246,3575841284,38
3,302,963,3575841298,3575841302,4
3,302,964,3575841298,3575841310,12
3,302,965,3575841298,3575841319,21
3,302,966,3575841298,3575841322,24
3,302,967,3575841298,3575841341,43
3,302,968,3575841298,3575841343,45
3,302,969,3575841298,3575841346,48
3,303,970,3575841350,3575841354,4
3,303,971,3575841350,3575841359,9
3,303,972,3575841350,3575841370,20
3,303,973,3575841350,3575841381,31
3,303,974,3575841350,3575841382,32
3,303,975,3575841350,3575841382,32
3,303,976,3575841350,3575841387,37
3,303,977,3575841350,3575841391,41
3,303,978,3575841350,3575841400,50
3,304,979,3575841402,3575841402,0
3,304,980,3575841402,3575841402,0
3,304,981,3575841402,3575841404,2
3,304,982,3575841402,3575841405,3
3,304,983,3575841402,3575841407,5
3,304,984,3575841402,3575841426,24
3,304,985,3575841402,3575841436,34
3,304,986,3575841402,3575841438,36
3,304,987,3575841402,3575841448,46
3,304,988,3575841402,3575841449,47
3,305,989,3575841454,3575841455,1
3,305,990,3575841454,3575841459,5
3,305,991,3575841454,3575841462,8
3,305,992,3575841454,3575841465,11
3,305,993,3575841454,3575841466,12
3,305,994,3575841454,3575841470,16
3,305,995,3575841454,3575841472,18
3,305,996,3575841454,3575841475,21
3,305,997,3575841454,3575841482,28
3,305,998,3575841454,3575841484,30
3,305,999,3575841454,3575841502,48
3,306,1000,3575841506,3575841510,4
3,306,1001,3575841506,3575841518,12
3,306,1002,3575841506,3575841521,15
3,306,1003,3575841506,3575841540,34
3,306,1004,3575841506,3575841542,36
3,306,1005,3575841506,3575841545,39
3,306,1006,3575841506,3575841553,47
3,307,1007,3575841558,3575841558,0
3,307,1008,3575841558,3575841570,12
3,307,1009,3575841558,3575841580,22
3,307,1010,3575841558,3575841581,23
3,307,1011,3575841558,3575841581,23
3,307,1012,3575841558,3575841586,28
3,307,1013,3575841558,3575841587,29
3,307,1014,3575841558,3575841591,33
3,307,1015,3575841558,3575841598,40
3,307,1016,3575841558,3575841599,41
3,307,1017,3575841558,3575841601,43
3,307,1018,3575841558,3575841603,45
3,307,1019,3575841558,3575841604,46
3,307,1020,3575841558,3575841606,48
3,308,1021,3575841611,3575841626,15
3,308,1022,3575841611,3575841635,24
3,308,1023,3575841611,3575841638,27
3,308,1024,3575841611,3575841647,36
3,308,1025,3575841611,3575841649,38
3,308,1026,3575841611,3575841654,43
3,308,1027,3575841611,3575841658,47
3,309,1028,3575841663,3575841663,0
3,309,1029,3575841663,3575841665,2
3,309,1030,3575841663,3575841665,2
3,309,1031,3575841663,3575841669,6
3,309,1032,3575841663,3575841672,9
3,309,1033,3575841663,3575841675,12
3,309,1034,3575841663,3575841677,14
3,309,1035,3575841663,3575841682,19
3,309,1036,3575841663,3575841684,21
3,309,1037,3575841663,3575841702,39
3,309,1038,3575841663,3575841709,46
3,310,1039,3575841715,3575841718,3
3,310,1040,3575841715,3575841721,6
3,310,1041,3575841715,3575841733,18
3,310,1042,3575841715,3575841740,25
3,310,1043,3575841715,3575841742,27
3,310,1044,3575841715,3575841745,30
3,310,1045,3575841715,3575841754,39
3,310,1046,3575841715,3575841758,43
3,311,1047,3575841767,3575841770,3
3,311,1048,3575841767,3575841780,13
3,311,1049,3575841767,3575841781,14
3,311,1050,3575841767,3575841781,14
3,311,1051,3575841767,3575841786,19
3,311,1052,3575841767,3575841787,20
3,311,1053,3575841767,3575841792,25
3,311,1054,3575841767,3575841798,31
3,311,1055,3575841767,3575841799,32
3,311,1056,3575841767,3575841801,34
3,311,1057,3575841767,3575841804,37
3,311,1058,3575841767,3575841805,38
3,311,1059,3575841767,3575841806,39
3,312,1060,3575841819,3575841826,7
3,312,1061,3575841819,3575841835,16
3,312,1062,3575841819,3575841838,19
3,312,1063,3575841819,3575841847,28
3,312,1064,3575841819,3575841849,30
3,312,1065,3575841819,3575841855,36
3,312,1066,3575841819,3575841858,39
3,312,1067,3575841819,3575841861,42
3,312,1068,3575841819,3575841865,46
3,312,1069,3575841819,3575841867,48
3,313,1070,3575841871,3575841871,0
3,313,1071,3575841871,3575841872,1
3,313,1072,3575841871,3575841875,4
3,313,1073,3575841871,3575841877,6
3,313,1074,3575841871,3575841879,8
3,313,1075,3575841871,3575841882,11
3,313,1076,3575841871,3575841884,13
3,313,1077,3575841871,3575841891,20
3,313,1078,3575841871,3575841903,32
3,313,1079,3575841871,3575841910,39
3,313,1080,3575841871,3575841918,47
3,314,1081,3575841922,3575841922,0
3,314,1082,3575841922,3575841933,11
3,314,1083,3575841922,3575841941,19
3,314,1084,3575841922,3575841943,21
3,314,1085,3575841922,3575841945,23
3,314,1086,3575841922,3575841954,32
3,314,1087,3575841922,3575841958,36
3,314,1088,3575841922,3575841969,47
3,315,1089,3575841974,3575841980,6
3,315,1090,3575841974,3575841981,7
3,315,1091,3575841974,3575841982,8
3,315,1092,3575841974,3575841986,12
3,315,1093,3575841974,3575841987,13
3,315,1094,3575841974,3575841991,17
3,315,1095,3575841974,3575841998,24
3,315,1096,3575841974,3575841999,25
3,315,1097,3575841974,3575842000,26
3,315,1098,3575841974,3575842003,29
3,315,1099,3575841974,3575842005,31
3,315,1100,3575841974,3575842007,33
3,316,1101,3575842026,3575842026,0
3,316,1102,3575842026,3575842035,9
3,316,1103,3575842026,3575842038,12
3,316,1104,3575842026,3575842042,16
3,316,1105,3575842026,3575842047,21
3,316,1106,3575842026,3575842049,23
3,316,1107,3575842026,3575842055,29
3,316,1108,3575842026,3575842058,32
3,316,1109,3575842026,3575842061,35
3,316,1110,3575842026,3575842065,39
3,316,1111,3575842026,3575842066,40
3,316,1112,3575842026,3575842069,43
3,316,1113,3575842026,3575842072,46
3,316,1114,3575842026,3575842075,49
3,317,1115,3575842077,3575842078,1
3,317,1116,3575842077,3575842080,3
3,317,1117,3575842077,3575842082,5
3,317,1118,3575842077,3575842086,9
3,317,1119,3575842077,3575842090,13
3,317,1120,3575842077,3575842103,26
3,317,1121,3575842077,3575842109,32
3,317,1122,3575842077,3575842118,41
3,317,1123,3575842077,3575842120,43
3,318,1124,3575842129,3575842134,5
3,318,1125,3575842129,3575842140,11
3,318,1126,3575842129,3575842143,14
3,318,1127,3575842129,3575842146,17
3,318,1128,3575842129,3575842154,25
3,318,1129,3575842129,3575842159,30
3,318,1130,3575842129,3575842171,42
3,319,1131,3575842180,3575842180,0
3,319,1132,3575842180,3575842181,1
3,319,1133,3575842180,3575842182,2
3,319,1134,3575842180,3575842186,6
3,319,1135,3575842180,3575842187,7
3,319,1136,3575842180,3575842192,12
3,319,1137,3575842180,3575842198,18
3,319,1138,3575842180,3575842199,19
3,319,1139,3575842180,3575842201,21
3,319,1140,3575842180,3575842204,24
3,319,1141,3575842180,3575842204,24
3,319,1142,3575842180,3575842208,28
3,319,1143,3575842180,3575842226,46
3,320,1144,3575842231,3575842236,5
3,320,1145,3575842231,3575842238,7
3,320,1146,3575842231,3575842242,11
3,320,1147,3575842231,3575842245,14
3,320,1148,3575842231,3575842248,17
3,320,1149,3575842231,3575842248,17
3,320,1150,3575842231,3575842254,23
3,320,1151,3575842231,3575842260,29
3,320,1152,3575842231,3575842260,29
3,320,1153,3575842231,3575842265,34
3,320,1154,3575842231,3575842266,35
3,320,1155,3575842231,3575842269,38
3,320,1156,3575842231,3575842272,41
3,320,1157,3575842231,3575842275,44
3,320,1158,3575842231,3575842278,47
3,320,1159,3575842231,3575842280,49
3,321,1160,3575842283,3575842283,0
3,321,1161,3575842283,3575842286,3
3,321,1162,3575842283,3575842290,7
3,321,1163,3575842283,3575842302,19
3,321,1164,3575842283,3575842310,27
3,321,1165,3575842283,3575842318,35
3,321,1166,3575842283,3575842322,39
3,322,1167,3575842334,3575842334,0
3,322,1168,3575842334,3575842340,6
3,322,1169,3575842334,3575842343,9
3,322,1170,3575842334,3575842346,12
3,322,1171,3575842334,3575842354,20
3,322,1172,3575842334,3575842359,25
3,322,1173,3575842334,3575842370,36
3,322,1174,3575842334,3575842380,46
3,322,1175,3575842334,3575842381,47
3,322,1176,3575842334,3575842382,48
3,323,1177,3575842386,3575842387,1
3,323,1178,3575842386,3575842388,2
3,323,1179,3575842386,3575842391,5
3,323,1180,3575842386,3575842399,13
3,323,1181,3575842386,3575842400,14
3,323,1182,3575842386,3575842401,15
3,323,1183,3575842386,3575842404,18
3,323,1184,3575842386,3575842405,19
3,323,1185,3575842386,3575842408,22
3,323,1186,3575842386,3575842424,38
3,323,1187,3575842386,3575842426,40
3,324,1188,3575842438,3575842438,0
3,324,1189,3575842438,3575842438,0
3,324,1190,3575842438,3575842442,4
3,324,1191,3575842438,3575842444,6
3,324,1192,3575842438,3575842447,9
3,324,1193,3575842438,3575842448,10
3,324,1194,3575842438,3575842450,12
3,324,1195,3575842438,3575842455,17
3,324,1196,3575842438,3575842459,21
3,324,1197,3575842438,3575842462,24
3,324,1198,3575842438,3575842465,27
3,324,1199,3575842438,3575842467,29
3,324,1200,3575842438,3575842469,31
3,324,1201,3575842438,3575842472,34
3,324,1202,3575842438,3575842475,37
3,324,1203,3575842438,3575842478,40
3,324,1204,3575842438,3575842479,41
3,324,1205,3575842438,3575842482,44
3,324,1206,3575842438,3575842486,48
3,325,1207,3575842489,3575842489,0
3,325,1208,3575842489,3575842494,5
3,325,1209,3575842489,3575842502,13
3,325,1210,3575842489,3575842509,20
3,325,1211,3575842489,3575842517,28
3,325,1212,3575842489,3575842521,32
3,325,1213,3575842489,3575842533,44
3,326,1214,3575842541,3575842541,0
3,326,1215,3575842541,3575842542,1
3,326,1216,3575842541,3575842544,3
3,326,1217,3575842541,3575842553,12
3,326,1218,3575842541,3575842558,17
3,326,1219,3575842541,3575842570,29
3,326,1220,3575842541,3575842580,39
3,326,1221,3575842541,3575842580,39
3,326,1222,3575842541,3575842581,40
3,326,1223,3575842541,3575842586,45
3,326,1224,3575842541,3575842587,46
3,326,1225,3575842541,3575842591,50
3,327,1226,3575842593,3575842598,5
3,327,1227,3575842593,3575842599,6
3,327,1228,3575842593,3575842600,7
3,327,1229,3575842593,3575842603,10
3,327,1230,3575842593,3575842604,11
3,327,1231,3575842593,3575842607,14
3,327,1232,3575842593,3575842622,29
3,327,1233,3575842593,3575842625,32
3,327,1234,3575842593,3575842635,42
3,327,1235,3575842593,3575842638,45
3,327,1236,3575842593,3575842642,49
3,328,1237,3575842645,3575842645,0
3,328,1238,3575842645,3575842646,1
3,328,1239,3575842645,3575842647,2
3,328,1240,3575842645,3575842649,4
3,328,1241,3575842645,3575842653,8
3,328,1242,3575842645,3575842658,13
3,328,1243,3575842645,3575842661,16
3,328,1244,3575842645,3575842665,20
3,328,1245,3575842645,3575842667,22
3,328,1246,3575842645,3575842668,23
3,328,1247,3575842645,3575842672,27
3,328,1248,3575842645,3575842675,30
3,328,1249,3575842645,3575842678,33
3,328,1250,3575842645,3575842679,34
3,328,1251,3575842645,3575842682,37
3,328,1252,3575842645,3575842686,41
3,328,1253,3575842645,3575842689,44
3,328,1254,3575842645,3575842694,49
3,329,1255,3575842697,3575842701,4
3,329,1256,3575842697,3575842710,13
3,329,1257,3575842697,3575842718,21
3,329,1258,3575842697,3575842721,24
3,329,1259,3575842697,3575842733,36
3,329,1260,3575842697,3575842740,43
3,329,1261,3575842697,3575842742,45
3,329,1262,3575842697,3575842745,48
3,330,1263,3575842749,3575842754,5
3,330,1264,3575842749,3575842758,9
3,330,1265,3575842749,3575842770,21
3,330,1266,3575842749,3575842780,31
3,330,1267,3575842749,3575842780,31
3,330,1268,3575842749,3575842781,32
3,330,1269,3575842749,3575842786,37
3,330,1270,3575842749,3575842787,38
3,330,1271,3575842749,3575842792,43
3,330,1272,3575842749,3575842798,49
3,330,1273,3575842749,3575842799,50
3,331,1274,3575842802,3575842802,0
3,331,1275,3575842802,3575842804,2
3,331,1276,3575842802,3575842805,3
3,331,1277,3575842802,3575842808,6
3,331,1278,3575842802,3575842822,20
3,331,1279,3575842802,3575842825,23
3,331,1280,3575842802,3575842835,33
3,331,1281,3575842802,3575842838,36
3,331,1282,3575842802,3575842842,40
3,331,1283,3575842802,3575842843,41
3,331,1284,3575842802,3575842846,44
3,331,1285,3575842802,3575842847,45
3,331,1286,3575842802,3575842849,47
3,331,1287,3575842802,3575842852,50
3,332,1288,3575842854,3575842855,1
3,332,1289,3575842854,3575842859,5
3,332,1290,3575842854,3575842861,7
3,332,1291,3575842854,3575842865,11
3,332,1292,3575842854,3575842866,12
3,332,1293,3575842854,3575842868,14
3,332,1294,3575842854,3575842872,18
3,332,1295,3575842854,3575842875,21
3,332,1296,3575842854,3575842877,23
3,332,1297,3575842854,3575842879,25
3,332,1298,3575842854,3575842882,28
3,332,1299,3575842854,3575842886,32
3,332,1300,3575842854,3575842890,36
3,332,1301,3575842854,3575842894,40
3,332,1302,3575842854,3575842902,48
3,333,1303,3575842906,3575842910,4
3,333,1304,3575842906,3575842917,11
3,333,1305,3575842906,3575842921,15
3,333,1306,3575842906,3575842933,27
3,333,1307,3575842906,3575842940,34
3,333,1308,3575842906,3575842943,37
3,333,1309,3575842906,3575842945,39
3,333,1310,3575842906,3575842954,48
3,334,1311,3575842958,3575842958,0
3,334,1312,3575842958,3575842969,11
3,334,1313,3575842958,3575842981,23
3,334,1314,3575842958,3575842982,24
3,334,1315,3575842958,3575842982,24
3,334,1316,3575842958,3575842987,29
3,334,1317,3575842958,3575842987,29
3,334,1318,3575842958,3575842991,33
3,334,1319,3575842958,3575842998,40
3,334,1320,3575842958,3575843000,42
3,334,1321,3575842958,3575843000,42
3,334,1322,3575842958,3575843004,46
3,334,1323,3575842958,3575843005,47
3,334,1324,3575842958,3575843007,49
3,335,1325,3575843011,3575843025,14
3,335,1326,3575843011,3575843035,24
3,335,1327,3575843011,3575843038,27
3,335,1328,3575843011,3575843042,31
3,335,1329,3575843011,3575843043,32
3,335,1330,3575843011,3575843046,35
3,335,1331,3575843011,3575843047,36
3,335,1332,3575843011,3575843049,38
3,335,1333,3575843011,3575843052,41
3,335,1334,3575843011,3575843055,44
3,335,1335,3575843011,3575843058,47
3,335,1336,3575843011,3575843061,50
3,336,1337,3575843063,3575843065,2
3,336,1338,3575843063,3575843067,4
3,336,1339,3575843063,3575843069,6
3,336,1340,3575843063,3575843072,9
3,336,1341,3575843063,3575843075,12
3,336,1342,3575843063,3575843077,14
3,336,1343,3575843063,3575843080,17
3,336,1344,3575843063,3575843082,19
3,336,1345,3575843063,3575843086,23
3,336,1346,3575843063,3575843089,26
3,336,1347,3575843063,3575843094,31
3,336,1348,3575843063,3575843102,39
3,336,1349,3575843063,3575843110,47
3,337,1350,3575843115,3575843117,2
3,337,1351,3575843115,3575843120,5
3,337,1352,3575843115,3575843134,19
3,337,1353,3575843115,3575843140,25
3,337,1354,3575843115,3575843142,27
3,337,1355,3575843115,3575843146,31
3,337,1356,3575843115,3575843155,40
3,337,1357,3575843115,3575843160,45
3,338,1358,3575843167,3575843171,4
3,338,1359,3575843167,3575843181,14
3,338,1360,3575843167,3575843181,14
3,338,1361,3575843167,3575843182,15
3,338,1362,3575843167,3575843187,20
3,338,1363,3575843167,3575843187,20
3,338,1364,3575843167,3575843192,25
3,338,1365,3575843167,3575843198,31
3,338,1366,3575843167,3575843200,33
3,338,1367,3575843167,3575843201,34
3,338,1368,3575843167,3575843204,37
3,338,1369,3575843167,3575843205,38
3,338,1370,3575843167,3575843207,40
3,338,1371,3575843167,3575843207,40
3,339,1372,3575843219,3575843225,6
3,339,1373,3575843219,3575843235,16
3,339,1374,3575843219,3575843238,19
3,339,1375,3575843219,3575843242,23
3,339,1376,3575843219,3575843243,24
3,339,1377,3575843219,3575843246,27
3,339,1378,3575843219,3575843248,29
3,339,1379,3575843219,3575843249,30
3,339,1380,3575843219,3575843252,33
3,339,1381,3575843219,3575843255,36
3,339,1382,3575843219,3575843259,40
3,339,1383,3575843219,3575843259,40
3,339,1384,3575843219,3575843261,42
3,339,1385,3575843219,3575843265,46
3,339,1386,3575843219,3575843266,47
3,339,1387,3575843219,3575843269,50
3,340,1388,3575843271,3575843272,1
3,340,1389,3575843271,3575843276,5
3,340,1390,3575843271,3575843278,7
3,340,1391,3575843271,3575843279,8
3,340,1392,3575843271,3575843282,11
3,340,1393,3575843271,3575843286,15
3,340,1394,3575843271,3575843289,18
3,340,1395,3575843271,3575843295,24
3,340,1396,3575843271,3575843301,30
3,340,1397,3575843271,3575843310,39
3,340,1398,3575843271,3575843317,46
3,341,1399,3575843323,3575843323,0
3,341,1400,3575843323,3575843334,11
3,341,1401,3575843323,3575843340,17
3,341,1402,3575843323,3575843343,20
3,341,1403,3575843323,3575843346,23
3,341,1404,3575843323,3575843354,31
3,341,1405,3575843323,3575843359,36
3,341,1406,3575843323,3575843362,39
3,341,1407,3575843323,3575843371,48
3,342,1408,3575843375,3575843381,6
3,342,1409,3575843375,3575843382,7
3,342,1410,3575843375,3575843382,7
3,342,1411,3575843375,3575843387,12
3,342,1412,3575843375,3575843387,12
3,342,1413,3575843375,3575843391,16
3,342,1414,3575843375,3575843399,24
3,342,1415,3575843375,3575843400,25
3,342,1416,3575843375,3575843400,25
3,342,1417,3575843375,3575843404,29
3,342,1418,3575843375,3575843404,29
3,342,1419,3575843375,3575843405,30
3,342,1420,3575843375,3575843407,32
3,342,1421,3575843375,3575843407,32
3,342,1422,3575843375,3575843423,48
3,342,1423,3575843375,3575843425,50
3,343,1424,3575843428,3575843436,8
3,343,1425,3575843428,3575843438,10
3,343,1426,3575843428,3575843442,14
3,343,1427,3575843428,3575843443,15
3,343,1428,3575843428,3575843446,18
3,343,1429,3575843428,3575843448,20
3,343,1430,3575843428,3575843450,22
3,343,1431,3575843428,3575843452,24
3,343,1432,3575843428,3575843454,26
3,343,1433,3575843428,3575843459,31
3,343,1434,3575843428,3575843460,32
3,343,1435,3575843428,3575843461,33
3,343,1436,3575843428,3575843463,35
3,343,1437,3575843428,3575843465,37
3,343,1438,3575843428,3575843466,38
3,343,1439,3575843428,3575843469,41
3,343,1440,3575843428,3575843472,44
3,343,1441,3575843428,3575843476,48
3,343,1442,3575843428,3575843477,49
3,344,1443,3575843481,3575843481,0
3,344,1444,3575843481,3575843482,1
3,344,1445,3575843481,3575843486,5
3,344,1446,3575843481,3575843489,8
3,344,1447,3575843481,3575843493,12
3,344,1448,3575843481,3575843501,20
3,344,1449,3575843481,3575843508,27
3,344,1450,3575843481,3575843516,35
3,344,1451,3575843481,3575843520,39
3,345,1452,3575843533,3575843533,0
3,345,1453,3575843533,3575843539,6
3,345,1454,3575843533,3575843542,9
3,345,1455,3575843533,3575843546,13
3,345,1456,3575843533,3575843553,20
3,345,1457,3575843533,3575843558,25
3,345,1458,3575843533,3575843561,28
3,345,1459,3575843533,3575843563,30
3,345,1460,3575843533,3575843570,37
3,345,1461,3575843533,3575843580,47
3,345,1462,3575843533,3575843580,47
3,345,1463,3575843533,3575843581,48
3,346,1464,3575843585,3575843585,0
3,346,1465,3575843585,3575843588,3
3,346,1466,3575843585,3575843591,6
3,346,1467,3575843585,3575843598,13
3,346,1468,3575843585,3575843598,13
3,346,1469,3575843585,3575843601,16
3,346,1470,3575843585,3575843603,18
3,346,1471,3575843585,3575843603,18
3,346,1472,3575843585,3575843603,18
3,346,1473,3575843585,3575843606,21
3,346,1474,3575843585,3575843606,21
3,346,1475,3575843585,3575843623,38
3,346,1476,3575843585,3575843625,40
3,347,1477,3575843637,3575843637,0
3,347,1478,3575843637,3575843638,1
3,347,1479,3575843637,3575843641,4
3,347,1480,3575843637,3575843642,5
3,347,1481,3575843637,3575843645,8
3,347,1482,3575843637,3575843648,11
3,347,1483,3575843637,3575843649,12
3,347,1484,3575843637,3575843651,14
3,347,1485,3575843637,3575843654,17
3,347,1486,3575843637,3575843658,21
3,347,1487,3575843637,3575843659,22
3,347,1488,3575843637,3575843661,24
3,347,1489,3575843637,3575843663,26
3,347,1490,3575843637,3575843665,28
3,347,1491,3575843637,3575843665,28
3,347,1492,3575843637,3575843668,31
3,347,1493,3575843637,3575843672,35
3,347,1494,3575843637,3575843676,39
3,347,1495,3575843637,3575843677,40
3,347,1496,3575843637,3575843679,42
3,347,1497,3575843637,3575843681,44
3,347,1498,3575843637,3575843686,49
3,348,1499,3575843689,3575843690,1
3,348,1500,3575843689,3575843693,4
3,348,1501,3575843689,3575843708,19
3,348,1502,3575843689,3575843716,27
3,348,1503,3575843689,3575843720,31
3,348,1504,3575843689,3575843734,45
3,349,1505,3575843741,3575843741,0
3,349,1506,3575843741,3575843741,0
3,349,1507,3575843741,3575843747,6
3,349,1508,3575843741,3575843754,13
3,349,1509,3575843741,3575843761,20
3,349,1510,3575843741,3575843763,22
3,349,1511,3575843741,3575843769,28
3,349,1512,3575843741,3575843780,39
3,349,1513,3575843741,3575843781,40
3,349,1514,3575843741,3575843781,40
3,349,1515,3575843741,3575843786,45
3,349,1516,3575843741,3575843787,46
3,350,1517,3575843793,3575843793,0
3,350,1518,3575843793,3575843798,5
3,350,1519,3575843793,3575843798,5
3,350,1520,3575843793,3575843800,7
3,350,1521,3575843793,3575843803,10
3,350,1522,3575843793,3575843804,11
3,350,1523,3575843793,3575843804,11
3,350,1524,3575843793,3575843806,13
3,350,1525,3575843793,3575843807,14
3,350,1526,3575843793,3575843817,24
3,350,1527,3575843793,3575843825,32
3,350,1528,3575843793,3575843835,42
3,350,1529,3575843793,3575843838,45
3,350,1530,3575843793,3575843841,48
3,350,1531,3575843793,3575843843,50
3,351,1532,3575843845,3575843845,0
3,351,1533,3575843845,3575843848,3
3,351,1534,3575843845,3575843849,4
3,351,1535,3575843845,3575843851,6
3,351,1536,3575843845,3575843855,10
3,351,1537,3575843845,3575843858,13
3,351,1538,3575843845,3575843859,14
3,351,1539,3575843845,3575843861,16
3,351,1540,3575843845,3575843865,20
3,351,1541,3575843845,3575843866,21
3,351,1542,3575843845,3575843868,23
3,351,1543,3575843845,3575843872,27
3,351,1544,3575843845,3575843876,31
3,351,1545,3575843845,3575843878,33
3,351,1546,3575843845,3575843880,35
3,351,1547,3575843845,3575843881,36
3,351,1548,3575843845,3575843886,41
3,351,1549,3575843845,3575843890,45
3,351,1550,3575843845,3575843893,48
3,352,1551,3575843897,3575843901,4
3,352,1552,3575843897,3575843909,12
3,352,1553,3575843897,3575843917,20
3,352,1554,3575843897,3575843921,24
3,352,1555,3575843897,3575843933,36
3,352,1556,3575843897,3575843941,44
3,352,1557,3575843897,3575843943,46
3,352,1558,3575843897,3575843946,49
3,353,1559,3575843949,3575843954,5
3,353,1560,3575843949,3575843961,12
3,353,1561,3575843949,3575843963,14
3,353,1562,3575843949,3575843970,21
3,353,1563,3575843949,3575843970,21
3,353,1564,3575843949,3575843980,31
3,353,1565,3575843949,3575843981,32
3,353,1566,3575843949,3575843982,33
3,353,1567,3575843949,3575843986,37
3,353,1568,3575843949,3575843988,39
3,353,1569,3575843949,3575843992,43
3,353,1570,3575843949,3575843998,49
3,353,1571,3575843949,3575843999,50
3,354,1572,3575844001,3575844001,0
3,354,1573,3575844001,3575844003,2
3,354,1574,3575844001,3575844004,3
3,354,1575,3575844001,3575844005,4
3,354,1576,3575844001,3575844006,5
3,354,1577,3575844001,3575844008,7
3,354,1578,3575844001,3575844018,17
3,354,1579,3575844001,3575844021,20
3,354,1580,3575844001,3575844024,23
3,354,1581,3575844001,3575844035,34
3,354,1582,3575844001,3575844038,37
3,354,1583,3575844001,3575844041,40
3,354,1584,3575844001,3575844044,43
3,354,1585,3575844001,3575844045,44
3,354,1586,3575844001,3575844048,47
3,354,1587,3575844001,3575844049,48
3,355,1588,3575844054,3575844054,0
3,355,1589,3575844054,3575844056,2
3,355,1590,3575844054,3575844058,4
3,355,1591,3575844054,3575844059,5
3,355,1592,3575844054,3575844061,7
3,355,1593,3575844054,3575844065,11
3,355,1594,3575844054,3575844066,12
3,355,1595,3575844054,3575844069,15
3,355,1596,3575844054,3575844073,19
3,355,1597,3575844054,3575844076,22
3,355,1598,3575844054,3575844078,24
3,355,1599,3575844054,3575844079,25
3,355,1600,3575844054,3575844081,27
3,355,1601,3575844054,3575844086,32
3,355,1602,3575844054,3575844089,35
3,355,1603,3575844054,3575844094,40
3,356,1604,3575844106,3575844109,3
3,356,1605,3575844106,3575844117,11
3,356,1606,3575844106,3575844121,15
3,356,1607,3575844106,3575844134,28
3,356,1608,3575844106,3575844141,35
3,356,1609,3575844106,3575844143,37
3,356,1610,3575844106,3575844146,40
3,356,1611,3575844106,3575844154,48
3,357,1612,3575844158,3575844159,1
3,357,1613,3575844158,3575844161,3
3,357,1614,3575844158,3575844164,6
3,357,1615,3575844158,3575844170,12
3,357,1616,3575844158,3575844171,13
3,357,1617,3575844158,3575844181,23
3,357,1618,3575844158,3575844181,23
3,357,1619,3575844158,3575844182,24
3,357,1620,3575844158,3575844185,27
3,357,1621,3575844158,3575844188,30
3,357,1622,3575844158,3575844192,34
3,357,1623,3575844158,3575844199,41
3,357,1624,3575844158,3575844199,41
3,357,1625,3575844158,3575844200,42
3,357,1626,3575844158,3575844203,45
3,357,1627,3575844158,3575844204,46
3,357,1628,3575844158,3575844204,46
3,357,1629,3575844158,3575844206,48
3,357,1630,3575844158,3575844207,49
3,358,1631,3575844210,3575844217,7
3,358,1632,3575844210,3575844220,10
3,358,1633,3575844210,3575844223,13
3,358,1634,3575844210,3575844225,15
3,358,1635,3575844210,3575844235,25
3,358,1636,3575844210,3575844237,27
3,358,1637,3575844210,3575844241,31
3,358,1638,3575844210,3575844243,33
3,358,1639,3575844210,3575844246,36
3,358,1640,3575844210,3575844248,38
3,358,1641,3575844210,3575844249,39
3,358,1642,3575844210,3575844251,41
3,358,1643,3575844210,3575844255,45
3,358,1644,3575844210,3575844259,49
3,358,1645,3575844210,3575844260,50
3,359,1646,3575844262,3575844262,0
3,359,1647,3575844262,3575844265,3
3,359,1648,3575844262,3575844266,4
3,359,1649,3575844262,3575844269,7
3,359,1650,3575844262,3575844273,11
3,359,1651,3575844262,3575844276,14
3,359,1652,3575844262,3575844278,16
3,359,1653,3575844262,3575844280,18
3,359,1654,3575844262,3575844281,19
3,359,1655,3575844262,3575844286,24
3,359,1656,3575844262,3575844289,27
3,359,1657,3575844262,3575844295,33
3,359,1658,3575844262,3575844301,39
3,359,1659,3575844262,3575844309,47
3,360,1660,3575844314,3575844317,3
3,360,1661,3575844314,3575844321,7
3,360,1662,3575844314,3575844334,20
3,360,1663,3575844314,3575844340,26
3,360,1664,3575844314,3575844343,29
3,360,1665,3575844314,3575844347,33
3,360,1666,3575844314,3575844354,40
3,360,1667,3575844314,3575844360,46
3,360,1668,3575844314,3575844361,47
3,360,1669,3575844314,3575844363,49
3,361,1670,3575844366,3575844369,3
3,361,1671,3575844366,3575844371,5
3,361,1672,3575844366,3575844382,16
3,361,1673,3575844366,3575844382,16
3,361,1674,3575844366,3575844382,16
3,361,1675,3575844366,3575844385,19
3,361,1676,3575844366,3575844389,23
3,361,1677,3575844366,3575844392,26
3,361,1678,3575844366,3575844399,33
3,361,1679,3575844366,3575844400,34
3,361,1680,3575844366,3575844401,35
3,361,1681,3575844366,3575844403,37
3,361,1682,3575844366,3575844404,38
3,361,1683,3575844366,3575844405,39
3,361,1684,3575844366,3575844406,40
3,361,1685,3575844366,3575844407,41
3,362,1686,3575844418,3575844418,0
3,362,1687,3575844418,3575844420,2
3,362,1688,3575844418,3575844421,3
3,362,1689,3575844418,3575844423,5
3,362,1690,3575844418,3575844425,7
3,362,1691,3575844418,3575844436,18
3,362,1692,3575844418,3575844438,20
3,362,1693,3575844418,3575844441,23
3,362,1694,3575844418,3575844443,25
3,362,1695,3575844418,3575844446,28
3,362,1696,3575844418,3575844448,30
3,362,1697,3575844418,3575844450,32
3,362,1698,3575844418,3575844451,33
3,362,1699,3575844418,3575844456,38
3,362,1700,3575844418,3575844459,41
3,362,1701,3575844418,3575844460,42
3,362,1702,3575844418,3575844462,44
3,362,1703,3575844418,3575844463,45
3,362,1704,3575844418,3575844465,47
3,362,1705,3575844418,3575844466,48
3,363,1706,3575844470,3575844470,0
3,363,1707,3575844470,3575844473,3
3,363,1708,3575844470,3575844476,6
3,363,1709,3575844470,3575844480,10
3,363,1710,3575844470,3575844481,11
3,363,1711,3575844470,3575844486,16
3,363,1712,3575844470,3575844490,20
3,363,1713,3575844470,3575844495,25
3,363,1714,3575844470,3575844501,31
3,363,1715,3575844470,3575844509,39
3,363,1716,3575844470,3575844517,47
3,364,1717,3575844522,3575844522,0
3,364,1718,3575844522,3575844539,17
3,364,1719,3575844522,3575844541,19
3,364,1720,3575844522,3575844546,24
3,364,1721,3575844522,3575844553,31
3,364,1722,3575844522,3575844559,37
3,364,1723,3575844522,3575844560,38
3,364,1724,3575844522,3575844562,40
3,364,1725,3575844522,3575844568,46
3,364,1726,3575844522,3575844569,47
3,365,1727,3575844574,3575844581,7
3,365,1728,3575844574,3575844581,7
3,365,1729,3575844574,3575844581,7
3,365,1730,3575844574,3575844584,10
3,365,1731,3575844574,3575844591,17
3,365,1732,3575844574,3575844599,25
3,365,1733,3575844574,3575844599,25
3,365,1734,3575844574,3575844601,27
3,365,1735,3575844574,3575844602,28
3,365,1736,3575844574,3575844603,29
3,365,1737,3575844574,3575844604,30
3,365,1738,3575844574,3575844605,31
3,365,1739,3575844574,3575844607,33
3,365,1740,3575844574,3575844617,43
3,365,1741,3575844574,3575844620,46
3,365,1742,3575844574,3575844621,47
3,365,1743,3575844574,3575844622,48
3,366,1744,3575844626,3575844626,0
3,366,1745,3575844626,3575844627,1
3,366,1746,3575844626,3575844635,9
3,366,1747,3575844626,3575844638,12
3,366,1748,3575844626,3575844640,14
3,366,1749,3575844626,3575844643,17
3,366,1750,3575844626,3575844645,19
3,366,1751,3575844626,3575844647,21
3,366,1752,3575844626,3575844649,23
3,366,1753,3575844626,3575844650,24
3,366,1754,3575844626,3575844655,29
3,366,1755,3575844626,3575844658,32
3,366,1756,3575844626,3575844658,32
3,366,1757,3575844626,3575844660,34
3,366,1758,3575844626,3575844662,36
3,366,1759,3575844626,3575844665,39
3,366,1760,3575844626,3575844665,39
3,366,1761,3575844626,3575844668,42
3,366,1762,3575844626,3575844673,47
3,366,1763,3575844626,3575844676,50
3,367,1764,3575844678,3575844679,1
3,367,1765,3575844678,3575844682,4
3,367,1766,3575844678,3575844687,9
3,367,1767,3575844678,3575844689,11
3,367,1768,3575844678,3575844695,17
3,367,1769,3575844678,3575844701,23
3,367,1770,3575844678,3575844708,30
3,367,1771,3575844678,3575844717,39
3,367,1772,3575844678,3575844721,43
3,368,1773,3575844730,3575844740,10
3,368,1774,3575844730,3575844742,12
3,368,1775,3575844730,3575844746,16
3,368,1776,3575844730,3575844754,24
3,368,1777,3575844730,3575844758,28
3,368,1778,3575844730,3575844760,30
3,368,1779,3575844730,3575844763,33
3,368,1780,3575844730,3575844768,38
3,368,1781,3575844730,3575844769,39
3,369,1782,3575844782,3575844782,0
3,369,1783,3575844782,3575844782,0
3,369,1784,3575844782,3575844782,0
3,369,1785,3575844782,3575844784,2
3,369,1786,3575844782,3575844792,10
3,369,1787,3575844782,3575844798,16
3,369,1788,3575844782,3575844799,17
3,369,1789,3575844782,3575844800,18
3,369,1790,3575844782,3575844803,21
3,369,1791,3575844782,3575844804,22
3,369,1792,3575844782,3575844804,22
3,369,1793,3575844782,3575844805,23
3,369,1794,3575844782,3575844806,24
3,369,1795,3575844782,3575844817,35
3,369,1796,3575844782,3575844819,37
3,369,1797,3575844782,3575844821,39
3,369,1798,3575844782,3575844821,39
3,369,1799,3575844782,3575844825,43
3,369,1800,3575844782,3575844827,45
3,370,1801,3575844835,3575844836,1
3,370,1802,3575844835,3575844838,3
3,370,1803,3575844835,3575844841,6
3,370,1804,3575844835,3575844843,8
3,370,1805,3575844835,3575844845,10
3,370,1806,3575844835,3575844846,11
3,370,1807,3575844835,3575844849,14
3,370,1808,3575844835,3575844850,15
3,370,1809,3575844835,3575844854,19
3,370,1810,3575844835,3575844858,23
3,370,1811,3575844835,3575844858,23
3,370,1812,3575844835,3575844860,25
3,370,1813,3575844835,3575844862,27
3,370,1814,3575844835,3575844865,30
3,370,1815,3575844835,3575844866,31
3,370,1816,3575844835,3575844868,33
3,370,1817,3575844835,3575844876,41
3,370,1818,3575844835,3575844880,45
3,370,1819,3575844835,3575844881,46
3,371,1820,3575844888,3575844888,0
3,371,1821,3575844888,3575844890,2
3,371,1822,3575844888,3575844895,7
3,371,1823,3575844888,3575844901,13
3,371,1824,3575844888,3575844909,21
3,371,1825,3575844888,3575844917,29
3,371,1826,3575844888,3575844921,33
3,372,1827,3575844941,3575844941,0
3,372,1828,3575844941,3575844943,2
3,372,1829,3575844941,3575844947,6
3,372,1830,3575844941,3575844954,13
3,372,1831,3575844941,3575844958,17
3,372,1832,3575844941,3575844960,19
3,372,1833,3575844941,3575844962,21
3,372,1834,3575844941,3575844969,28
3,372,1835,3575844941,3575844971,30
3,372,1836,3575844941,3575844982,41
3,372,1837,3575844941,3575844982,41
3,372,1838,3575844941,3575844982,41
3,372,1839,3575844941,3575844984,43
3,373,1840,3575844993,3575844993,0
3,373,1841,3575844993,3575844998,5
3,373,1842,3575844993,3575845000,7
3,373,1843,3575844993,3575845001,8
3,373,1844,3575844993,3575845003,10
3,373,1845,3575844993,3575845004,11
3,373,1846,3575844993,3575845005,12
3,373,1847,3575844993,3575845006,13
3,373,1848,3575844993,3575845008,15
3,373,1849,3575844993,3575845018,25
3,373,1850,3575844993,3575845020,27
3,373,1851,3575844993,3575845021,28
3,373,1852,3575844993,3575845022,29
3,373,1853,3575844993,3575845026,33
3,373,1854,3575844993,3575845027,34
3,373,1855,3575844993,3575845036,43
3,373,1856,3575844993,3575845038,45
3,373,1857,3575844993,3575845041,48
3,374,1858,3575845045,3575845045,0
3,374,1859,3575845045,3575845045,0
3,374,1860,3575845045,3575845047,2
3,374,1861,3575845045,3575845050,5
3,374,1862,3575845045,3575845050,5
3,374,1863,3575845045,3575845055,10
3,374,1864,3575845045,3575845058,13
3,374,1865,3575845045,3575845059,14
3,374,1866,3575845045,3575845061,16
3,374,1867,3575845045,3575845062,17
3,374,1868,3575845045,3575845065,20
3,374,1869,3575845045,3575845066,21
3,374,1870,3575845045,3575845069,24
3,374,1871,3575845045,3575845077,32
3,374,1872,3575845045,3575845077,32
3,374,1873,3575845045,3575845079,34
3,374,1874,3575845045,3575845081,36
3,374,1875,3575845045,3575845087,42
3,374,1876,3575845045,3575845090,45
3,374,1877,3575845045,3575845095,50
3,375,1878,3575845097,3575845100,3
3,375,1879,3575845097,3575845110,13
3,375,1880,3575845097,3575845118,21
3,375,1881,3575845097,3575845121,24
3,375,1882,3575845097,3575845134,37
3,375,1883,3575845097,3575845140,43
3,375,1884,3575845097,3575845143,46
3,376,1885,3575845150,3575845150,0
3,376,1886,3575845150,3575845154,4
3,376,1887,3575845150,3575845159,9
3,376,1888,3575845150,3575845161,11
3,376,1889,3575845150,3575845163,13
3,376,1890,3575845150,3575845168,18
3,376,1891,3575845150,3575845171,21
3,376,1892,3575845150,3575845182,32
3,376,1893,3575845150,3575845183,33
3,376,1894,3575845150,3575845183,33
3,376,1895,3575845150,3575845185,35
3,376,1896,3575845150,3575845191,41
3,376,1897,3575845150,3575845198,48
3,377,1898,3575845203,3575845203,0
3,377,1899,3575845203,3575845203,0
3,377,1900,3575845203,3575845203,0
3,377,1901,3575845203,3575845204,1
3,377,1902,3575845203,3575845205,2
3,377,1903,3575845203,3575845206,3
3,377,1904,3575845203,3575845208,5
3,377,1905,3575845203,3575845218,15
3,377,1906,3575845203,3575845221,18
3,377,1907,3575845203,3575845221,18
3,377,1908,3575845203,3575845221,18
3,377,1909,3575845203,3575845226,23
3,377,1910,3575845203,3575845227,24
3,377,1911,3575845203,3575845236,33
3,377,1912,3575845203,3575845237,34
3,377,1913,3575845203,3575845241,38
3,377,1914,3575845203,3575845244,41
3,377,1915,3575845203,3575845245,42
3,377,1916,3575845203,3575845248,45
3,377,1917,3575845203,3575845249,46
3,377,1918,3575845203,3575845250,47
3,378,1919,3575845255,3575845255,0
3,378,1920,3575845255,3575845258,3
3,378,1921,3575845255,3575845259,4
3,378,1922,3575845255,3575845260,5
3,378,1923,3575845255,3575845262,7
3,378,1924,3575845255,3575845265,10
3,378,1925,3575845255,3575845266,11
3,378,1926,3575845255,3575845269,14
3,378,1927,3575845255,3575845273,18
3,378,1928,3575845255,3575845278,23
3,378,1929,3575845255,3575845280,25
3,378,1930,3575845255,3575845282,27
3,378,1931,3575845255,3575845286,31
3,378,1932,3575845255,3575845287,32
3,378,1933,3575845255,3575845289,34
3,378,1934,3575845255,3575845295,40
3,378,1935,3575845255,3575845301,46
3,379,1936,3575845307,3575845310,3
3,379,1937,3575845307,3575845318,11
3,379,1938,3575845307,3575845322,15
3,379,1939,3575845307,3575845334,27
3,379,1940,3575845307,3575845341,34
3,379,1941,3575845307,3575845343,36
3,379,1942,3575845307,3575845347,40
3,379,1943,3575845307,3575845354,47
3,380,1944,3575845359,3575845359,0
3,380,1945,3575845359,3575845361,2
3,380,1946,3575845359,3575845364,5
3,380,1947,3575845359,3575845369,10
3,380,1948,3575845359,3575845372,13
3,380,1949,3575845359,3575845382,23
3,380,1950,3575845359,3575845382,23
3,380,1951,3575845359,3575845383,24
3,380,1952,3575845359,3575845385,26
3,380,1953,3575845359,3575845392,33
3,380,1954,3575845359,3575845400,41
3,380,1955,3575845359,3575845401,42
3,380,1956,3575845359,3575845401,42
3,380,1957,3575845359,3575845403,44
3,380,1958,3575845359,3575845404,45
3,380,1959,3575845359,3575845405,46
3,380,1960,3575845359,3575845406,47
3,380,1961,3575845359,3575845408,49
3,381,1962,3575845411,3575845418,7
3,381,1963,3575845411,3575845421,10
3,381,1964,3575845411,3575845421,10
3,381,1965,3575845411,3575845422,11
3,381,1966,3575845411,3575845426,15
3,381,1967,3575845411,3575845427,16
3,381,1968,3575845411,3575845436,25
3,381,1969,3575845411,3575845437,26
3,381,1970,3575845411,3575845439,28
3,381,1971,3575845411,3575845441,30
3,381,1972,3575845411,3575845443,32
3,381,1973,3575845411,3575845446,35
3,381,1974,3575845411,3575845448,37
3,381,1975,3575845411,3575845449,38
3,381,1976,3575845411,3575845454,43
3,381,1977,3575845411,3575845459,48
3,381,1978,3575845411,3575845459,48
3,382,1979,3575845463,3575845463,0
3,382,1980,3575845463,3575845463,0
3,382,1981,3575845463,3575845465,2
3,382,1982,3575845463,3575845466,3
3,382,1983,3575845463,3575845469,6
3,382,1984,3575845463,3575845474,11
3,382,1985,3575845463,3575845478,15
3,382,1986,3575845463,3575845479,16
3,382,1987,3575845463,3575845482,19
3,382,1988,3575845463,3575845487,24
3,382,1989,3575845463,3575845487,24
3,382,1990,3575845463,3575845489,26
3,382,1991,3575845463,3575845495,32
3,382,1992,3575845463,3575845501,38
3,382,1993,3575845463,3575845510,47
3,383,1994,3575845515,3575845517,2
3,383,1995,3575845515,3575845521,6
3,383,1996,3575845515,3575845533,18
3,383,1997,3575845515,3575845540,25
3,383,1998,3575845515,3575845542,27
3,383,1999,3575845515,3575845546,31
3,383,2000,3575845515,3575845553,38
3,383,2001,3575845515,3575845558,43
3,383,2002,3575845515,3575845560,45
3,383,2003,3575845515,3575845563,48
3,384,2004,3575845567,3575845567,0
3,384,2005,3575845567,3575845570,3
3,384,2006,3575845567,3575845581,14
3,384,2007,3575845567,3575845581,14
3,384,2008,3575845567,3575845582,15
3,384,2009,3575845567,3575845585,18
3,384,2010,3575845567,3575845590,23
3,384,2011,3575845567,3575845590,23
3,384,2012,3575845567,3575845598,31
3,384,2013,3575845567,3575845600,33
3,384,2014,3575845567,3575845600,33
3,384,2015,3575845567,3575845601,34
3,384,2016,3575845567,3575845603,36
3,384,2017,3575845567,3575845605,38
3,384,2018,3575845567,3575845605,38
3,384,2019,3575845567,3575845607,40
3,385,2020,3575845619,3575845619,0
3,385,2021,3575845619,3575845620,1
3,385,2022,3575845619,3575845621,2
3,385,2023,3575845619,3575845625,6
3,385,2024,3575845619,3575845626,7
3,385,2025,3575845619,3575845635,16
3,385,2026,3575845619,3575845637,18
3,385,2027,3575845619,3575845637,18
3,385,2028,3575845619,3575845640,21
3,385,2029,3575845619,3575845642,23
3,385,2030,3575845619,3575845645,26
3,385,2031,3575845619,3575845647,28
3,385,2032,3575845619,3575845648,29
3,385,2033,3575845619,3575845653,34
3,385,2034,3575845619,3575845658,39
3,385,2035,3575845619,3575845658,39
3,385,2036,3575845619,3575845660,41
3,385,2037,3575845619,3575845661,42
3,385,2038,3575845619,3575845665,46
3,385,2039,3575845619,3575845665,46
3,385,2040,3575845619,3575845668,49
3,386,2041,3575845671,3575845674,3
3,386,2042,3575845671,3575845678,7
3,386,2043,3575845671,3575845679,8
3,386,2044,3575845671,3575845682,11
3,386,2045,3575845671,3575845687,16
3,386,2046,3575845671,3575845687,16
3,386,2047,3575845671,3575845689,18
3,386,2048,3575845671,3575845696,25
3,386,2049,3575845671,3575845701,30
3,386,2050,3575845671,3575845710,39
3,386,2051,3575845671,3575845717,46
3,386,2052,3575845671,3575845721,50
3,387,2053,3575845723,3575845733,10
3,387,2054,3575845723,3575845740,17
3,387,2055,3575845723,3575845742,19
3,387,2056,3575845723,3575845746,23
3,387,2057,3575845723,3575845754,31
3,387,2058,3575845723,3575845758,35
3,387,2059,3575845723,3575845760,37
3,387,2060,3575845723,3575845762,39
3,387,2061,3575845723,3575845768,45
3,387,2062,3575845723,3575845770,47
3,388,2063,3575845775,3575845781,6
3,388,2064,3575845775,3575845781,6
3,388,2065,3575845775,3575845783,8
3,388,2066,3575845775,3575845784,9
3,388,2067,3575845775,3575845789,14
3,388,2068,3575845775,3575845792,17
3,388,2069,3575845775,3575845799,24
3,388,2070,3575845775,3575845800,25
3,388,2071,3575845775,3575845801,26
3,388,2072,3575845775,3575845803,28
3,388,2073,3575845775,3575845804,29
3,388,2074,3575845775,3575845805,30
3,388,2075,3575845775,3575845806,31
3,388,2076,3575845775,3575845817,42
3,388,2077,3575845775,3575845819,44
3,388,2078,3575845775,3575845821,46
3,389,2079,3575845827,3575845827,0
3,389,2080,3575845827,3575845827,0
3,389,2081,3575845827,3575845835,8
3,389,2082,3575845827,3575845838,11
3,389,2083,3575845827,3575845838,11
3,389,2084,3575845827,3575845841,14
3,389,2085,3575845827,3575845843,16
3,389,2086,3575845827,3575845845,18
3,389,2087,3575845827,3575845847,20
3,389,2088,3575845827,3575845849,22
3,389,2089,3575845827,3575845851,24
3,389,2090,3575845827,3575845855,28
3,389,2091,3575845827,3575845857,30
3,389,2092,3575845827,3575845858,31
3,389,2093,3575845827,3575845861,34
3,389,2094,3575845827,3575845862,35
3,389,2095,3575845827,3575845865,38
3,389,2096,3575845827,3575845867,40
3,389,2097,3575845827,3575845868,41
3,389,2098,3575845827,3575845874,47
3,389,2099,3575845827,3575845877,50
3,390,2100,3575845879,3575845880,1
3,390,2101,3575845879,3575845882,3
3,390,2102,3575845879,3575845887,8
3,390,2103,3575845879,3575845887,8
3,390,2104,3575845879,3575845889,10
3,390,2105,3575845879,3575845894,15
3,390,2106,3575845879,3575845895,16
3,390,2107,3575845879,3575845901,22
3,390,2108,3575845879,3575845910,31
3,390,2109,3575845879,3575845918,39
3,390,2110,3575845879,3575845921,42
3,391,2111,3575845931,3575845933,2
3,391,2112,3575845931,3575845940,9
3,391,2113,3575845931,3575845943,12
3,391,2114,3575845931,3575845945,14
3,391,2115,3575845931,3575845946,15
3,391,2116,3575845931,3575845954,23
3,391,2117,3575845931,3575845958,27
3,391,2118,3575845931,3575845960,29
3,391,2119,3575845931,3575845963,32
3,391,2120,3575845931,3575845970,39
3,391,2121,3575845931,3575845981,50
3,392,2122,3575845983,3575845983,0
3,392,2123,3575845983,3575845983,0
3,392,2124,3575845983,3575845984,1
3,392,2125,3575845983,3575845989,6
3,392,2126,3575845983,3575845992,9
3,392,2127,3575845983,3575845998,15
3,392,2128,3575845983,3575845999,16
3,392,2129,3575845983,3575846001,18
3,392,2130,3575845983,3575846003,20
3,392,2131,3575845983,3575846004,21
3,392,2132,3575845983,3575846006,23
3,392,2133,3575845983,3575846008,25
3,392,2134,3575845983,3575846017,34
3,392,2135,3575845983,3575846020,37
3,392,2136,3575845983,3575846021,38
3,392,2137,3575845983,3575846021,38
3,392,2138,3575845983,3575846026,43
3,392,2139,3575845983,3575846026,43
3,393,2140,3575846036,3575846036,0
3,393,2141,3575846036,3575846037,1
3,393,2142,3575846036,3575846038,2
3,393,2143,3575846036,3575846041,5
3,393,2144,3575846036,3575846044,8
3,393,2145,3575846036,3575846045,9
3,393,2146,3575846036,3575846047,11
3,393,2147,3575846036,3575846049,13
3,393,2148,3575846036,3575846051,15
3,393,2149,3575846036,3575846055,19
3,393,2150,3575846036,3575846057,21
3,393,2151,3575846036,3575846058,22
3,393,2152,3575846036,3575846061,25
3,393,2153,3575846036,3575846062,26
3,393,2154,3575846036,3575846065,29
3,393,2155,3575846036,3575846067,31
3,393,2156,3575846036,3575846069,33
3,393,2157,3575846036,3575846074,38
3,393,2158,3575846036,3575846077,41
3,393,2159,3575846036,3575846080,44
3,393,2160,3575846036,3575846082,46
3,394,2161,3575846088,3575846088,0
3,394,2162,3575846088,3575846088,0
3,394,2163,3575846088,3575846090,2
3,394,2164,3575846088,3575846094,6
3,394,2165,3575846088,3575846095,7
3,394,2166,3575846088,3575846102,14
3,394,2167,3575846088,3575846110,22
3,394,2168,3575846088,3575846115,27
3,394,2169,3575846088,3575846118,30
3,394,2170,3575846088,3575846121,33
3,394,2171,3575846088,3575846134,46
3,395,2172,3575846140,3575846140,0
3,395,2173,3575846140,3575846142,2
3,395,2174,3575846140,3575846145,5
3,395,2175,3575846140,3575846146,6
3,395,2176,3575846140,3575846154,14
3,395,2177,3575846140,3575846159,19
3,395,2178,3575846140,3575846161,21
3,395,2179,3575846140,3575846162,22
3,395,2180,3575846140,3575846170,30
3,395,2181,3575846140,3575846182,42
3,395,2182,3575846140,3575846182,42
3,395,2183,3575846140,3575846184,44
3,395,2184,3575846140,3575846185,45
3,395,2185,3575846140,3575846189,49
3,396,2186,3575846192,3575846192,0
3,396,2187,3575846192,3575846198,6
3,396,2188,3575846192,3575846198,6
3,396,2189,3575846192,3575846200,8
3,396,2190,3575846192,3575846200,8
3,396,2191,3575846192,3575846203,11
3,396,2192,3575846192,3575846204,12
3,396,2193,3575846192,3575846205,13
3,396,2194,3575846192,3575846206,14
3,396,2195,3575846192,3575846207,15
3,396,2196,3575846192,3575846218,26
3,396,2197,3575846192,3575846220,28
3,396,2198,3575846192,3575846220,28
3,396,2199,3575846192,3575846222,30
3,396,2200,3575846192,3575846226,34
3,396,2201,3575846192,3575846226,34
3,396,2202,3575846192,3575846236,44
3,396,2203,3575846192,3575846238,46
3,396,2204,3575846192,3575846238,46
3,396,2205,3575846192,3575846241,49
3,397,2206,3575846244,3575846244,0
3,397,2207,3575846244,3575846245,1
3,397,2208,3575846244,3575846248,4
3,397,2209,3575846244,3575846249,5
3,397,2210,3575846244,3575846251,7
3,397,2211,3575846244,3575846255,11
3,397,2212,3575846244,3575846257,13
3,397,2213,3575846244,3575846259,15
3,397,2214,3575846244,3575846260,16
3,397,2215,3575846244,3575846263,19
3,397,2216,3575846244,3575846265,21
3,397,2217,3575846244,3575846267,23
3,397,2218,3575846244,3575846269,25
3,397,2219,3575846244,3575846273,29
3,397,2220,3575846244,3575846277,33
3,397,2221,3575846244,3575846281,37
3,397,2222,3575846244,3575846282,38
3,397,2223,3575846244,3575846287,43
3,397,2224,3575846244,3575846288,44
3,397,2225,3575846244,3575846290,46
3,398,2226,3575846296,3575846296,0
3,398,2227,3575846296,3575846296,0
3,398,2228,3575846296,3575846302,6
3,398,2229,3575846296,3575846310,14
3,398,2230,3575846296,3575846316,20
3,398,2231,3575846296,3575846318,22
3,398,2232,3575846296,3575846322,26
3,398,2233,3575846296,3575846334,38
3,398,2234,3575846296,3575846340,44
3,398,2235,3575846296,3575846342,46
3,398,2236,3575846296,3575846345,49
3,398,2237,3575846296,3575846346,50
3,399,2238,3575846348,3575846354,6
3,399,2239,3575846348,3575846359,11
3,399,2240,3575846348,3575846361,13
3,399,2241,3575846348,3575846364,16
3,399,2242,3575846348,3575846368,20
3,399,2243,3575846348,3575846371,23
3,399,2244,3575846348,3575846381,33
3,399,2245,3575846348,3575846382,34
3,399,2246,3575846348,3575846384,36
3,399,2247,3575846348,3575846386,38
3,399,2248,3575846348,3575846390,42
3,399,2249,3575846348,3575846393,45
3,399,2250,3575846348,3575846398,50
3,400,2251,3575846400,3575846400,0
3,400,2252,3575846400,3575846400,0
3,400,2253,3575846400,3575846401,1
3,400,2254,3575846400,3575846403,3
3,400,2255,3575846400,3575846404,4
3,400,2256,3575846400,3575846404,4
3,400,2257,3575846400,3575846406,6
3,400,2258,3575846400,3575846407,7
3,400,2259,3575846400,3575846417,17
3,400,2260,3575846400,3575846420,20
3,400,2261,3575846400,3575846420,20
3,400,2262,3575846400,3575846422,22
3,400,2263,3575846400,3575846426,26
3,400,2264,3575846400,3575846427,27
3,400,2265,3575846400,3575846436,36
3,400,2266,3575846400,3575846438,38
3,400,2267,3575846400,3575846438,38
3,400,2268,3575846400,3575846441,41
3,400,2269,3575846400,3575846444,44
3,400,2270,3575846400,3575846446,46
3,400,2271,3575846400,3575846448,48
3,400,2272,3575846400,3575846450,50
3,401,2273,3575846452,3575846452,0
3,401,2274,3575846452,3575846454,2
3,401,2275,3575846452,3575846457,5
3,401,2276,3575846452,3575846459,7
3,401,2277,3575846452,3575846461,9
3,401,2278,3575846452,3575846462,10
3,401,2279,3575846452,3575846465,13
3,401,2280,3575846452,3575846467,15
3,401,2281,3575846452,3575846470,18
3,401,2282,3575846452,3575846474,22
3,401,2283,3575846452,3575846478,26
3,401,2284,3575846452,3575846480,28
3,401,2285,3575846452,3575846483,31
3,401,2286,3575846452,3575846487,35
3,401,2287,3575846452,3575846489,37
3,401,2288,3575846452,3575846489,37
3,401,2289,3575846452,3575846494,42
3,402,2290,3575846505,3575846509,4
3,402,2291,3575846505,3575846514,9
3,402,2292,3575846505,3575846517,12
3,402,2293,3575846505,3575846533,28
3,402,2294,3575846505,3575846540,35
3,402,2295,3575846505,3575846542,37
3,402,2296,3575846505,3575846544,39
3,402,2297,3575846505,3575846545,40
3,402,2298,3575846505,3575846553,48
3,403,2299,3575846558,3575846558,0
3,403,2300,3575846558,3575846560,2
3,403,2301,3575846558,3575846562,4
3,403,2302,3575846558,3575846568,10
3,403,2303,3575846558,3575846569,11
3,403,2304,3575846558,3575846581,23
3,403,2305,3575846558,3575846581,23
3,403,2306,3575846558,3575846585,27
3,403,2307,3575846558,3575846588,30
3,403,2308,3575846558,3575846592,34
3,403,2309,3575846558,3575846597,39
3,403,2310,3575846558,3575846598,40
3,403,2311,3575846558,3575846599,41
3,403,2312,3575846558,3575846601,43
3,403,2313,3575846558,3575846602,44
3,403,2314,3575846558,3575846602,44
3,403,2315,3575846558,3575846604,46
3,403,2316,3575846558,3575846605,47
3,403,2317,3575846558,3575846607,49
3,404,2318,3575846610,3575846617,7
3,404,2319,3575846610,3575846619,9
3,404,2320,3575846610,3575846620,10
3,404,2321,3575846610,3575846622,12
3,404,2322,3575846610,3575846624,14
3,404,2323,3575846610,3575846626,16
3,404,2324,3575846610,3575846635,25
3,404,2325,3575846610,3575846637,27
3,404,2326,3575846610,3575846638,28
3,404,2327,3575846610,3575846640,30
3,404,2328,3575846610,3575846642,32
3,404,2329,3575846610,3575846645,35
3,404,2330,3575846610,3575846647,37
3,404,2331,3575846610,3575846648,38
3,404,2332,3575846610,3575846650,40
3,404,2333,3575846610,3575846653,43
3,404,2334,3575846610,3575846654,44
3,404,2335,3575846610,3575846656,46
3,404,2336,3575846610,3575846658,48
3,404,2337,3575846610,3575846660,50
3,405,2338,3575846662,3575846662,0
3,405,2339,3575846662,3575846665,3
3,405,2340,3575846662,3575846666,4
3,405,2341,3575846662,3575846669,7
3,405,2342,3575846662,3575846674,12
3,405,2343,3575846662,3575846677,15
3,405,2344,3575846662,3575846680,18
3,405,2345,3575846662,3575846683,21
3,405,2346,3575846662,3575846687,25
3,405,2347,3575846662,3575846688,26
3,405,2348,3575846662,3575846689,27
3,405,2349,3575846662,3575846702,40
3,405,2350,3575846662,3575846709,47
3,406,2351,3575846714,3575846715,1
3,406,2352,3575846714,3575846717,3
3,406,2353,3575846714,3575846721,7
3,406,2354,3575846714,3575846733,19
3,406,2355,3575846714,3575846740,26
3,406,2356,3575846714,3575846742,28
3,406,2357,3575846714,3575846745,31
3,406,2358,3575846714,3575846745,31
3,406,2359,3575846714,3575846746,32
3,406,2360,3575846714,3575846754,40
3,406,2361,3575846714,3575846758,44
3,406,2362,3575846714,3575846760,46
3,406,2363,3575846714,3575846763,49
3,407,2364,3575846767,3575846770,3
3,407,2365,3575846767,3575846781,14
3,407,2366,3575846767,3575846781,14
3,407,2367,3575846767,3575846784,17
3,407,2368,3575846767,3575846789,22
3,407,2369,3575846767,3575846792,25
3,407,2370,3575846767,3575846797,30
3,407,2371,3575846767,3575846798,31
3,407,2372,3575846767,3575846799,32
3,407,2373,3575846767,3575846801,34
3,407,2374,3575846767,3575846803,36
3,407,2375,3575846767,3575846804,37
3,407,2376,3575846767,3575846804,37
3,407,2377,3575846767,3575846805,38
3,407,2378,3575846767,3575846807,40
3,408,2379,3575846819,3575846819,0
3,408,2380,3575846819,3575846819,0
3,408,2381,3575846819,3575846820,1
3,408,2382,3575846819,3575846822,3
3,408,2383,3575846819,3575846825,6
3,408,2384,3575846819,3575846826,7
3,408,2385,3575846819,3575846835,16
3,408,2386,3575846819,3575846837,18
3,408,2387,3575846819,3575846838,19
3,408,2388,3575846819,3575846841,22
3,408,2389,3575846819,3575846843,24
3,408,2390,3575846819,3575846845,26
3,408,2391,3575846819,3575846847,28
3,408,2392,3575846819,3575846848,29
3,408,2393,3575846819,3575846850,31
3,408,2394,3575846819,3575846853,34
3,408,2395,3575846819,3575846854,35
3,408,2396,3575846819,3575846857,38
3,408,2397,3575846819,3575846858,39
3,408,2398,3575846819,3575846861,42
3,408,2399,3575846819,3575846861,42
3,408,2400,3575846819,3575846865,46
3,408,2401,3575846819,3575846867,48
3,409,2402,3575846872,3575846872,0
3,409,2403,3575846872,3575846874,2
3,409,2404,3575846872,3575846877,5
3,409,2405,3575846872,3575846880,8
3,409,2406,3575846872,3575846883,11
3,409,2407,3575846872,3575846887,15
3,409,2408,3575846872,3575846889,17
3,409,2409,3575846872,3575846889,17
3,409,2410,3575846872,3575846894,22
3,409,2411,3575846872,3575846902,30
3,409,2412,3575846872,3575846908,36
3,409,2413,3575846872,3575846916,44
3,409,2414,3575846872,3575846917,45
3,409,2415,3575846872,3575846921,49
3,410,2416,3575846924,3575846933,9
3,410,2417,3575846924,3575846940,16
3,410,2418,3575846924,3575846942,18
3,410,2419,3575846924,3575846945,21
3,410,2420,3575846924,3575846945,21
3,410,2421,3575846924,3575846946,22
3,410,2422,3575846924,3575846954,30
3,410,2423,3575846924,3575846958,34
3,410,2424,3575846924,3575846960,36
3,410,2425,3575846924,3575846963,39
3,410,2426,3575846924,3575846970,46
3,411,2427,3575846977,3575846981,4
3,411,2428,3575846977,3575846982,5
3,411,2429,3575846977,3575846984,7
3,411,2430,3575846977,3575846985,8
3,411,2431,3575846977,3575846989,12
3,411,2432,3575846977,3575846992,15
3,411,2433,3575846977,3575846997,20
3,411,2434,3575846977,3575846999,22
3,411,2435,3575846977,3575846999,22
3,411,2436,3575846977,3575847001,24
3,411,2437,3575846977,3575847003,26
3,411,2438,3575846977,3575847004,27
3,411,2439,3575846977,3575847004,27
3,411,2440,3575846977,3575847006,29
3,411,2441,3575846977,3575847008,31
3,411,2442,3575846977,3575847016,39
3,411,2443,3575846977,3575847020,43
3,411,2444,3575846977,3575847021,44
3,411,2445,3575846977,3575847022,45
3,411,2446,3575846977,3575847025,48
3,411,2447,3575846977,3575847026,49
3,412,2448,3575847029,3575847035,6
3,412,2449,3575847029,3575847037,8
3,412,2450,3575847029,3575847038,9
3,412,2451,3575847029,3575847041,12
3,412,2452,3575847029,3575847043,14
3,412,2453,3575847029,3575847045,16
3,412,2454,3575847029,3575847047,18
3,412,2455,3575847029,3575847048,19
3,412,2456,3575847029,3575847053,24
3,412,2457,3575847029,3575847055,26
3,412,2458,3575847029,3575847057,28
3,412,2459,3575847029,3575847058,29
3,412,2460,3575847029,3575847060,31
3,412,2461,3575847029,3575847062,33
3,412,2462,3575847029,3575847065,36
3,412,2463,3575847029,3575847067,38
3,412,2464,3575847029,3575847069,40
3,412,2465,3575847029,3575847074,45
3,412,2466,3575847029,3575847078,49
3,413,2467,3575847082,3575847082,0
3,413,2468,3575847082,3575847083,1
3,413,2469,3575847082,3575847087,5
3,413,2470,3575847082,3575847088,6
3,413,2471,3575847082,3575847090,8
3,413,2472,3575847082,3575847094,12
3,413,2473,3575847082,3575847095,13
3,413,2474,3575847082,3575847102,20
3,413,2475,3575847082,3575847109,27
3,413,2476,3575847082,3575847115,33
3,413,2477,3575847082,3575847117,35
3,413,2478,3575847082,3575847121,39
3,414,2479,3575847134,3575847134,0
3,414,2480,3575847134,3575847140,6
3,414,2481,3575847134,3575847143,9
3,414,2482,3575847134,3575847145,11
3,414,2483,3575847134,3575847146,12
3,414,2484,3575847134,3575847147,13
3,414,2485,3575847134,3575847154,20
3,414,2486,3575847134,3575847159,25
3,414,2487,3575847134,3575847161,27
3,414,2488,3575847134,3575847163,29
3,414,2489,3575847134,3575847169,35
3,414,2490,3575847134,3575847170,36
3,414,2491,3575847134,3575847181,47
3,414,2492,3575847134,3575847182,48
3,414,2493,3575847134,3575847184,50
3,415,2494,3575847186,3575847186,0
3,415,2495,3575847186,3575847188,2
3,415,2496,3575847186,3575847192,6
3,415,2497,3575847186,3575847196,10
3,415,2498,3575847186,3575847199,13
3,415,2499,3575847186,3575847199,13
3,415,2500,3575847186,3575847201,15
3,415,2501,3575847186,3575847203,17
3,415,2502,3575847186,3575847204,18
3,415,2503,3575847186,3575847204,18
3,415,2504,3575847186,3575847206,20
3,415,2505,3575847186,3575847207,21
3,415,2506,3575847186,3575847217,31
3,415,2507,3575847186,3575847219,33
3,415,2508,3575847186,3575847221,35
3,415,2509,3575847186,3575847222,36
3,415,2510,3575847186,3575847225,39
3,415,2511,3575847186,3575847226,40
3,415,2512,3575847186,3575847235,49
3,416,2513,3575847239,3575847239,0
3,416,2514,3575847239,3575847239,0
3,416,2515,3575847239,3575847241,2
3,416,2516,3575847239,3575847244,5
3,416,2517,3575847239,3575847246,7
3,416,2518,3575847239,3575847248,9
3,416,2519,3575847239,3575847249,10
3,416,2520,3575847239,3575847252,13
3,416,2521,3575847239,3575847256,17
3,416,2522,3575847239,3575847257,18
3,416,2523,3575847239,3575847259,20
3,416,2524,3575847239,3575847261,22
3,416,2525,3575847239,3575847262,23
3,416,2526,3575847239,3575847265,26
3,416,2527,3575847239,3575847267,28
3,416,2528,3575847239,3575847269,30
3,416,2529,3575847239,3575847274,35
3,416,2530,3575847239,3575847277,38
3,416,2531,3575847239,3575847282,43
3,416,2532,3575847239,3575847283,44
3,416,2533,3575847239,3575847287,48
3,416,2534,3575847239,3575847288,49
3,417,2535,3575847291,3575847291,0
3,417,2536,3575847291,3575847294,3
3,417,2537,3575847291,3575847295,4
3,417,2538,3575847291,3575847302,11
3,417,2539,3575847291,3575847309,18
3,417,2540,3575847291,3575847315,24
3,417,2541,3575847291,3575847317,26
3,417,2542,3575847291,3575847322,31
3,417,2543,3575847291,3575847334,43
3,417,2544,3575847291,3575847340,49
3,418,2545,3575847344,3575847344,0
3,418,2546,3575847344,3575847344,0
3,418,2547,3575847344,3575847345,1
3,418,2548,3575847344,3575847347,3
3,418,2549,3575847344,3575847354,10
3,418,2550,3575847344,3575847359,15
3,418,2551,3575847344,3575847361,17
3,418,2552,3575847344,3575847364,20
3,418,2553,3575847344,3575847369,25
3,418,2554,3575847344,3575847371,27
3,418,2555,3575847344,3575847381,37
3,418,2556,3575847344,3575847383,39
3,418,2557,3575847344,3575847383,39
3,418,2558,3575847344,3575847385,41
3,418,2559,3575847344,3575847392,48
3,419,2560,3575847396,3575847397,1
3,419,2561,3575847396,3575847399,3
3,419,2562,3575847396,3575847400,4
3,419,2563,3575847396,3575847400,4
3,419,2564,3575847396,3575847403,7
3,419,2565,3575847396,3575847404,8
3,419,2566,3575847396,3575847404,8
3,419,2567,3575847396,3575847406,10
3,419,2568,3575847396,3575847408,12
3,419,2569,3575847396,3575847416,20
3,419,2570,3575847396,3575847421,25
3,419,2571,3575847396,3575847422,26
3,419,2572,3575847396,3575847425,29
3,419,2573,3575847396,3575847427,31
3,419,2574,3575847396,3575847436,40
3,419,2575,3575847396,3575847438,42
3,419,2576,3575847396,3575847438,42
3,419,2577,3575847396,3575847441,45
3,419,2578,3575847396,3575847444,48
3,419,2579,3575847396,3575847445,49
3,420,2580,3575847449,3575847449,0
3,420,2581,3575847449,3575847450,1
3,420,2582,3575847449,3575847452,3
3,420,2583,3575847449,3575847456,7
3,420,2584,3575847449,3575847457,8
3,420,2585,3575847449,3575847460,11
3,420,2586,3575847449,3575847461,12
3,420,2587,3575847449,3575847463,14
3,420,2588,3575847449,3575847465,16
3,420,2589,3575847449,3575847465,16
3,420,2590,3575847449,3575847467,18
3,420,2591,3575847449,3575847469,20
3,420,2592,3575847449,3575847474,25
3,420,2593,3575847449,3575847477,28
3,420,2594,3575847449,3575847481,32
3,420,2595,3575847449,3575847483,34
3,420,2596,3575847449,3575847487,38
3,420,2597,3575847449,3575847488,39
3,420,2598,3575847449,3575847490,41
3,420,2599,3575847449,3575847494,45
3,420,2600,3575847449,3575847495,46
3,421,2601,3575847502,3575847502,0
3,421,2602,3575847502,3575847508,6
3,421,2603,3575847502,3575847517,15
3,421,2604,3575847502,3575847521,19
3,421,2605,3575847502,3575847533,31
3,421,2606,3575847502,3575847539,37
3,421,2607,3575847502,3575847542,40
3,421,2608,3575847502,3575847543,41
3,421,2609,3575847502,3575847545,43
3,421,2610,3575847502,3575847545,43
3,422,2611,3575847555,3575847555,0
3,422,2612,3575847555,3575847558,3
3,422,2613,3575847555,3575847560,5
3,422,2614,3575847555,3575847563,8
3,422,2615,3575847555,3575847567,12
3,422,2616,3575847555,3575847570,15
3,422,2617,3575847555,3575847580,25
3,422,2618,3575847555,3575847581,26
3,422,2619,3575847555,3575847583,28
3,422,2620,3575847555,3575847585,30
3,422,2621,3575847555,3575847591,36
3,422,2622,3575847555,3575847596,41
3,422,2623,3575847555,3575847598,43
3,422,2624,3575847555,3575847599,44
3,422,2625,3575847555,3575847600,45
3,422,2626,3575847555,3575847602,47
3,422,2627,3575847555,3575847603,48
3,422,2628,3575847555,3575847604,49
3,422,2629,3575847555,3575847605,50
3,423,2630,3575847607,3575847616,9
3,423,2631,3575847607,3575847618,11
3,423,2632,3575847607,3575847620,13
3,423,2633,3575847607,3575847621,14
3,423,2634,3575847607,3575847625,18
3,423,2635,3575847607,3575847626,19
3,423,2636,3575847607,3575847635,28
3,423,2637,3575847607,3575847636,29
3,423,2638,3575847607,3575847637,30
3,423,2639,3575847607,3575847640,33
3,423,2640,3575847607,3575847642,35
3,423,2641,3575847607,3575847645,38
3,423,2642,3575847607,3575847647,40
3,423,2643,3575847607,3575847648,41
3,423,2644,3575847607,3575847650,43
3,423,2645,3575847607,3575847652,45
3,423,2646,3575847607,3575847654,47
3,423,2647,3575847607,3575847656,49
3,424,2648,3575847660,3575847660,0
3,424,2649,3575847660,3575847661,1
3,424,2650,3575847660,3575847662,2
3,424,2651,3575847660,3575847664,4
3,424,2652,3575847660,3575847665,5
3,424,2653,3575847660,3575847667,7
3,424,2654,3575847660,3575847668,8
3,424,2655,3575847660,3575847675,15
3,424,2656,3575847660,3575847677,17
3,424,2657,3575847660,3575847681,21
3,424,2658,3575847660,3575847683,23
3,424,2659,3575847660,3575847687,27
3,424,2660,3575847660,3575847688,28
3,424,2661,3575847660,3575847690,30
3,424,2662,3575847660,3575847694,34
3,424,2663,3575847660,3575847695,35
3,424,2664,3575847660,3575847701,41
3,424,2665,3575847660,3575847708,48
3,425,2666,3575847713,3575847717,4
3,425,2667,3575847713,3575847722,9
3,425,2668,3575847713,3575847733,20
3,425,2669,3575847713,3575847740,27
3,425,2670,3575847713,3575847742,29
3,425,2671,3575847713,3575847744,31
3,425,2672,3575847713,3575847745,32
3,425,2673,3575847713,3575847745,32
3,425,2674,3575847713,3575847754,41
3,425,2675,3575847713,3575847758,45
3,425,2676,3575847713,3575847760,47
3,425,2677,3575847713,3575847763,50
3,426,2678,3575847765,3575847769,4
3,426,2679,3575847765,3575847769,4
3,426,2680,3575847765,3575847780,15
3,426,2681,3575847765,3575847781,16
3,426,2682,3575847765,3575847783,18
3,426,2683,3575847765,3575847785,20
3,426,2684,3575847765,3575847788,23
3,426,2685,3575847765,3575847792,27
3,426,2686,3575847765,3575847796,31
3,426,2687,3575847765,3575847799,34
3,426,2688,3575847765,3575847799,34
3,426,2689,3575847765,3575847800,35
3,426,2690,3575847765,3575847803,38
3,426,2691,3575847765,3575847803,38
3,426,2692,3575847765,3575847804,39
3,426,2693,3575847765,3575847805,40
3,426,2694,3575847765,3575847807,42
3,427,2695,3575847819,3575847819,0
3,427,2696,3575847819,3575847820,1
3,427,2697,3575847819,3575847821,2
3,427,2698,3575847819,3575847821,2
3,427,2699,3575847819,3575847825,6
3,427,2700,3575847819,3575847826,7
3,427,2701,3575847819,3575847835,16
3,427,2702,3575847819,3575847837,18
3,427,2703,3575847819,3575847838,19
3,427,2704,3575847819,3575847841,22
3,427,2705,3575847819,3575847843,24
3,427,2706,3575847819,3575847845,26
3,427,2707,3575847819,3575847847,28
3,427,2708,3575847819,3575847848,29
3,427,2709,3575847819,3575847850,31
3,427,2710,3575847819,3575847851,32
3,427,2711,3575847819,3575847855,36
3,427,2712,3575847819,3575847857,38
3,427,2713,3575847819,3575847858,39
3,427,2714,3575847819,3575847860,41
3,427,2715,3575847819,3575847861,42
3,427,2716,3575847819,3575847865,46
3,427,2717,3575847819,3575847865,46
3,427,2718,3575847819,3575847867,48
3,427,2719,3575847819,3575847869,50
3,428,2720,3575847871,3575847871,0
3,428,2721,3575847871,3575847875,4
3,428,2722,3575847871,3575847877,6
3,428,2723,3575847871,3575847882,11
3,428,2724,3575847871,3575847883,12
3,428,2725,3575847871,3575847887,16
3,428,2726,3575847871,3575847888,17
3,428,2727,3575847871,3575847890,19
3,428,2728,3575847871,3575847894,23
3,428,2729,3575847871,3575847895,24
3,428,2730,3575847871,3575847901,30
3,428,2731,3575847871,3575847908,37
3,428,2732,3575847871,3575847917,46
3,429,2733,3575847924,3575847924,0
3,429,2734,3575847924,3575847924,0
3,429,2735,3575847924,3575847933,9
3,429,2736,3575847924,3575847942,18
3,429,2737,3575847924,3575847943,19
3,429,2738,3575847924,3575847944,20
3,429,2739,3575847924,3575847944,20
3,429,2740,3575847924,3575847947,23
3,429,2741,3575847924,3575847954,30
3,429,2742,3575847924,3575847958,34
3,429,2743,3575847924,3575847960,36
3,429,2744,3575847924,3575847964,40
3,429,2745,3575847924,3575847968,44
3,429,2746,3575847924,3575847970,46
3,430,2747,3575847977,3575847981,4
3,430,2748,3575847977,3575847982,5
3,430,2749,3575847977,3575847983,6
3,430,2750,3575847977,3575847985,8
3,430,2751,3575847977,3575847989,12
3,430,2752,3575847977,3575847992,15
3,430,2753,3575847977,3575847997,20
3,430,2754,3575847977,3575847998,21
3,430,2755,3575847977,3575847999,22
3,430,2756,3575847977,3575848000,23
3,430,2757,3575847977,3575848003,26
3,430,2758,3575847977,3575848004,27
3,430,2759,3575847977,3575848005,28
3,430,2760,3575847977,3575848006,29
3,430,2761,3575847977,3575848008,31
3,430,2762,3575847977,3575848015,38
3,430,2763,3575847977,3575848021,44
3,430,2764,3575847977,3575848021,44
3,430,2765,3575847977,3575848022,45
3,430,2766,3575847977,3575848025,48
3,430,2767,3575847977,3575848026,49
3,431,2768,3575848030,3575848035,5
3,431,2769,3575848030,3575848036,6
3,431,2770,3575848030,3575848038,8
3,431,2771,3575848030,3575848041,11
3,431,2772,3575848030,3575848044,14
3,431,2773,3575848030,3575848044,14
3,431,2774,3575848030,3575848047,17
3,431,2775,3575848030,3575848048,18
3,431,2776,3575848030,3575848050,20
3,431,2777,3575848030,3575848052,22
3,431,2778,3575848030,3575848055,25
3,431,2779,3575848030,3575848057,27
3,431,2780,3575848030,3575848058,28
3,431,2781,3575848030,3575848061,31
3,431,2782,3575848030,3575848062,32
3,431,2783,3575848030,3575848065,35
3,431,2784,3575848030,3575848065,35
3,431,2785,3575848030,3575848067,37
3,431,2786,3575848030,3575848069,39
3,431,2787,3575848030,3575848071,41
3,431,2788,3575848030,3575848075,45
3,431,2789,3575848030,3575848077,47
3,432,2790,3575848083,3575848083,0
3,432,2791,3575848083,3575848083,0
3,432,2792,3575848083,3575848086,3
3,432,2793,3575848083,3575848088,5
3,432,2794,3575848083,3575848090,7
3,432,2795,3575848083,3575848094,11
3,432,2796,3575848083,3575848095,12
3,432,2797,3575848083,3575848101,18
3,432,2798,3575848083,3575848108,25
3,432,2799,3575848083,3575848117,34
3,432,2800,3575848083,3575848121,38
3,432,2801,3575848083,3575848122,39
3,433,2802,3575848136,3575848136,0
3,433,2803,3575848136,3575848141,5
3,433,2804,3575848136,3575848144,8
3,433,2805,3575848136,3575848144,8
3,433,2806,3575848136,3575848146,10
3,433,2807,3575848136,3575848147,11
3,433,2808,3575848136,3575848154,18
3,433,2809,3575848136,3575848159,23
3,433,2810,3575848136,3575848161,25
3,433,2811,3575848136,3575848164,28
3,433,2812,3575848136,3575848168,32
3,433,2813,3575848136,3575848171,35
3,433,2814,3575848136,3575848181,45
3,433,2815,3575848136,3575848182,46
3,433,2816,3575848136,3575848183,47
3,434,2817,3575848189,3575848189,0
3,434,2818,3575848189,3575848189,0
3,434,2819,3575848189,3575848192,3
3,434,2820,3575848189,3575848197,8
3,434,2821,3575848189,3575848198,9
3,434,2822,3575848189,3575848199,10
3,434,2823,3575848189,3575848200,11
3,434,2824,3575848189,3575848203,14
3,434,2825,3575848189,3575848204,15
3,434,2826,3575848189,3575848205,16
3,434,2827,3575848189,3575848206,17
3,434,2828,3575848189,3575848207,18
3,434,2829,3575848189,3575848216,27
3,434,2830,3575848189,3575848220,31
3,434,2831,3575848189,3575848221,32
3,434,2832,3575848189,3575848222,33
3,434,2833,3575848189,3575848226,37
3,434,2834,3575848189,3575848226,37
3,434,2835,3575848189,3575848235,46
3,434,2836,3575848189,3575848237,48
3,434,2837,3575848189,3575848238,49
3,435,2838,3575848242,3575848242,0
3,435,2839,3575848242,3575848244,2
3,435,2840,3575848242,3575848246,4
3,435,2841,3575848242,3575848248,6
3,435,2842,3575848242,3575848249,7
3,435,2843,3575848242,3575848250,8
3,435,2844,3575848242,3575848252,10
3,435,2845,3575848242,3575848256,14
3,435,2846,3575848242,3575848257,15
3,435,2847,3575848242,3575848260,18
3,435,2848,3575848242,3575848260,18
3,435,2849,3575848242,3575848263,21
3,435,2850,3575848242,3575848264,22
3,435,2851,3575848242,3575848265,23
3,435,2852,3575848242,3575848268,26
3,435,2853,3575848242,3575848269,27
3,435,2854,3575848242,3575848271,29
3,435,2855,3575848242,3575848276,34
3,435,2856,3575848242,3575848276,34
3,435,2857,3575848242,3575848277,35
3,435,2858,3575848242,3575848281,39
3,435,2859,3575848242,3575848283,41
3,435,2860,3575848242,3575848287,45
3,435,2861,3575848242,3575848288,46
3,435,2862,3575848242,3575848290,48
3,436,2863,3575848296,3575848296,0
3,436,2864,3575848296,3575848301,5
3,436,2865,3575848296,3575848309,13
3,436,2866,3575848296,3575848317,21
3,436,2867,3575848296,3575848321,25
3,436,2868,3575848296,3575848322,26
3,436,2869,3575848296,3575848327,31
3,436,2870,3575848296,3575848334,38
3,436,2871,3575848296,3575848341,45
3,436,2872,3575848296,3575848343,47
3,436,2873,3575848296,3575848344,48
3,437,2874,3575848349,3575848349,0
3,437,2875,3575848349,3575848349,0
3,437,2876,3575848349,3575848354,5
3,437,2877,3575848349,3575848359,10
3,437,2878,3575848349,3575848361,12
3,437,2879,3575848349,3575848364,15
3,437,2880,3575848349,3575848368,19
3,437,2881,3575848349,3575848370,21
3,437,2882,3575848349,3575848381,32
3,437,2883,3575848349,3575848382,33
3,437,2884,3575848349,3575848383,34
3,437,2885,3575848349,3575848386,37
3,437,2886,3575848349,3575848390,41
3,437,2887,3575848349,3575848392,43
3,437,2888,3575848349,3575848397,48
3,438,2889,3575848401,3575848401,0
3,438,2890,3575848401,3575848401,0
3,438,2891,3575848401,3575848401,0
3,438,2892,3575848401,3575848403,2
3,438,2893,3575848401,3575848404,3
3,438,2894,3575848401,3575848405,4
3,438,2895,3575848401,3575848406,5
3,438,2896,3575848401,3575848407,6
3,438,2897,3575848401,3575848416,15
3,438,2898,3575848401,3575848420,19
3,438,2899,3575848401,3575848421,20
3,438,2900,3575848401,3575848422,21
3,438,2901,3575848401,3575848424,23
3,438,2902,3575848401,3575848426,25
3,438,2903,3575848401,3575848427,26
3,438,2904,3575848401,3575848436,35
3,438,2905,3575848401,3575848437,36
3,438,2906,3575848401,3575848438,37
3,438,2907,3575848401,3575848441,40
3,438,2908,3575848401,3575848443,42
3,438,2909,3575848401,3575848446,45
3,438,2910,3575848401,3575848448,47
3,438,2911,3575848401,3575848450,49
3,438,2912,3575848401,3575848450,49
3,439,2913,3575848454,3575848454,0
3,439,2914,3575848454,3575848455,1
3,439,2915,3575848454,3575848457,3
3,439,2916,3575848454,3575848459,5
3,439,2917,3575848454,3575848462,8
3,439,2918,3575848454,3575848462,8
3,439,2919,3575848454,3575848464,10
3,439,2920,3575848454,3575848465,11
3,439,2921,3575848454,3575848468,14
3,439,2922,3575848454,3575848469,15
3,439,2923,3575848454,3575848470,16
3,439,2924,3575848454,3575848476,22
3,439,2925,3575848454,3575848476,22
3,439,2926,3575848454,3575848476,22
3,439,2927,3575848454,3575848477,23
3,439,2928,3575848454,3575848481,27
3,439,2929,3575848454,3575848487,33
3,439,2930,3575848454,3575848488,34
3,439,2931,3575848454,3575848489,35
3,439,2932,3575848454,3575848494,40
3,439,2933,3575848454,3575848500,46
3,440,2934,3575848507,3575848508,1
3,440,2935,3575848507,3575848516,9
3,440,2936,3575848507,3575848520,13
3,440,2937,3575848507,3575848521,14
3,440,2938,3575848507,3575848527,20
3,440,2939,3575848507,3575848541,34
3,440,2940,3575848507,3575848543,36
3,440,2941,3575848507,3575848543,36
3,440,2942,3575848507,3575848544,37
3,440,2943,3575848507,3575848546,39
3,440,2944,3575848507,3575848553,46
3,441,2945,3575848560,3575848560,0
3,441,2946,3575848560,3575848560,0
3,441,2947,3575848560,3575848562,2
3,441,2948,3575848560,3575848568,8
3,441,2949,3575848560,3575848569,9
3,441,2950,3575848560,3575848580,20
3,441,2951,3575848560,3575848581,21
3,441,2952,3575848560,3575848583,23
3,441,2953,3575848560,3575848585,25
3,441,2954,3575848560,3575848589,29
3,441,2955,3575848560,3575848591,31
3,441,2956,3575848560,3575848596,36
3,441,2957,3575848560,3575848598,38
3,441,2958,3575848560,3575848598,38
3,441,2959,3575848560,3575848600,40
3,441,2960,3575848560,3575848602,42
3,441,2961,3575848560,3575848603,43
3,441,2962,3575848560,3575848604,44
3,441,2963,3575848560,3575848605,45
3,441,2964,3575848560,3575848607,47
3,442,2965,3575848613,3575848615,2
3,442,2966,3575848613,3575848620,7
3,442,2967,3575848613,3575848620,7
3,442,2968,3575848613,3575848621,8
3,442,2969,3575848613,3575848623,10
3,442,2970,3575848613,3575848626,13
3,442,2971,3575848613,3575848626,13
3,442,2972,3575848613,3575848635,22
3,442,2973,3575848613,3575848636,23
3,442,2974,3575848613,3575848638,25
3,442,2975,3575848613,3575848640,27
3,442,2976,3575848613,3575848642,29
3,442,2977,3575848613,3575848644,31
3,442,2978,3575848613,3575848647,34
3,442,2979,3575848613,3575848650,37
3,442,2980,3575848613,3575848650,37
3,442,2981,3575848613,3575848651,38
3,442,2982,3575848613,3575848655,42
3,442,2983,3575848613,3575848656,43
3,442,2984,3575848613,3575848658,45
3,442,2985,3575848613,3575848661,48
3,442,2986,3575848613,3575848661,48
3,443,2987,3575848666,3575848666,0
3,443,2988,3575848666,3575848666,0
3,443,2989,3575848666,3575848667,1
3,443,2990,3575848666,3575848668,2
3,443,2991,3575848666,3575848670,4
3,443,2992,3575848666,3575848676,10
3,443,2993,3575848666,3575848676,10
3,443,2994,3575848666,3575848676,10
3,443,2995,3575848666,3575848677,11
3,443,2996,3575848666,3575848682,16
3,443,2997,3575848666,3575848687,21
3,443,2998,3575848666,3575848688,22
3,443,2999,3575848666,3575848690,24
3,443,3000,3575848666,3575848694,28
3,443,3001,3575848666,3575848701,35
3,443,3002,3575848666,3575848708,42
3,444,3003,3575848719,3575848719,0
3,444,3004,3575848719,3575848720,1
3,444,3005,3575848719,3575848721,2
3,444,3006,3575848719,3575848726,7
3,444,3007,3575848719,3575848740,21
3,444,3008,3575848719,3575848743,24
3,444,3009,3575848719,3575848744,25
3,444,3010,3575848719,3575848745,26
3,444,3011,3575848719,3575848746,27
3,444,3012,3575848719,3575848754,35
3,444,3013,3575848719,3575848758,39
3,444,3014,3575848719,3575848762,43
3,444,3015,3575848719,3575848763,44
3,444,3016,3575848719,3575848769,50
3,445,3017,3575848771,3575848771,0
3,445,3018,3575848771,3575848780,9
3,445,3019,3575848771,3575848781,10
3,445,3020,3575848771,3575848782,11
3,445,3021,3575848771,3575848783,12
3,445,3022,3575848771,3575848785,14
3,445,3023,3575848771,3575848789,18
3,445,3024,3575848771,3575848792,21
3,445,3025,3575848771,3575848797,26
3,445,3026,3575848771,3575848798,27
3,445,3027,3575848771,3575848799,28
3,445,3028,3575848771,3575848800,29
3,445,3029,3575848771,3575848802,31
3,445,3030,3575848771,3575848804,33
3,445,3031,3575848771,3575848805,34
3,445,3032,3575848771,3575848805,34
3,445,3033,3575848771,3575848807,36
3,445,3034,3575848771,3575848816,45
3,445,3035,3575848771,3575848819,48
3,445,3036,3575848771,3575848821,50
3,446,3037,3575848823,3575848823,0
3,446,3038,3575848823,3575848823,0
3,446,3039,3575848823,3575848826,3
3,446,3040,3575848823,3575848826,3
3,446,3041,3575848823,3575848835,12
3,446,3042,3575848823,3575848837,14
3,446,3043,3575848823,3575848838,15
3,446,3044,3575848823,3575848841,18
3,446,3045,3575848823,3575848842,19
3,446,3046,3575848823,3575848845,22
3,446,3047,3575848823,3575848847,24
3,446,3048,3575848823,3575848850,27
3,446,3049,3575848823,3575848850,27
3,446,3050,3575848823,3575848852,29
3,446,3051,3575848823,3575848854,31
3,446,3052,3575848823,3575848857,34
3,446,3053,3575848823,3575848858,35
3,446,3054,3575848823,3575848861,38
3,446,3055,3575848823,3575848861,38
3,446,3056,3575848823,3575848863,40
3,446,3057,3575848823,3575848865,42
3,446,3058,3575848823,3575848867,44
3,446,3059,3575848823,3575848868,45
3,446,3060,3575848823,3575848869,46
3,447,3061,3575848876,3575848876,0
3,447,3062,3575848876,3575848877,1
3,447,3063,3575848876,3575848877,1
3,447,3064,3575848876,3575848877,1
3,447,3065,3575848876,3575848883,7
3,447,3066,3575848876,3575848883,7
3,447,3067,3575848876,3575848887,11
3,447,3068,3575848876,3575848888,12
3,447,3069,3575848876,3575848890,14
3,447,3070,3575848876,3575848894,18
3,447,3071,3575848876,3575848901,25
3,447,3072,3575848876,3575848908,32
3,447,3073,3575848876,3575848917,41
3,447,3074,3575848876,3575848920,44
3,447,3075,3575848876,3575848921,45
3,448,3076,3575848929,3575848929,0
3,448,3077,3575848929,3575848933,4
3,448,3078,3575848929,3575848940,11
3,448,3079,3575848929,3575848943,14
3,448,3080,3575848929,3575848944,15
3,448,3081,3575848929,3575848945,16
3,448,3082,3575848929,3575848946,17
3,448,3083,3575848929,3575848954,25
3,448,3084,3575848929,3575848958,29
3,448,3085,3575848929,3575848962,33
3,448,3086,3575848929,3575848963,34
3,448,3087,3575848929,3575848969,40
3,448,3088,3575848929,3575848970,41
3,449,3089,3575848982,3575848982,0
3,449,3090,3575848982,3575848982,0
3,449,3091,3575848982,3575848983,1
3,449,3092,3575848982,3575848983,1
3,449,3093,3575848982,3575848985,3
3,449,3094,3575848982,3575848989,7
3,449,3095,3575848982,3575848992,10
3,449,3096,3575848982,3575848997,15
3,449,3097,3575848982,3575848998,16
3,449,3098,3575848982,3575848999,17
3,449,3099,3575848982,3575849001,19
3,449,3100,3575848982,3575849003,21
3,449,3101,3575848982,3575849004,22
3,449,3102,3575848982,3575849005,23
3,449,3103,3575848982,3575849006,24
3,449,3104,3575848982,3575849008,26
3,449,3105,3575848982,3575849015,33
3,449,3106,3575848982,3575849020,38
3,449,3107,3575848982,3575849020,38
3,449,3108,3575848982,3575849022,40
3,449,3109,3575848982,3575849023,41
3,449,3110,3575848982,3575849026,44
3,449,3111,3575848982,3575849026,44
3,450,3112,3575849035,3575849036,1
3,450,3113,3575849035,3575849036,1
3,450,3114,3575849035,3575849041,6
3,450,3115,3575849035,3575849044,9
3,450,3116,3575849035,3575849045,10
3,450,3117,3575849035,3575849047,12
3,450,3118,3575849035,3575849050,15
3,450,3119,3575849035,3575849050,15
3,450,3120,3575849035,3575849052,17
3,450,3121,3575849035,3575849055,20
3,450,3122,3575849035,3575849057,22
3,450,3123,3575849035,3575849059,24
3,450,3124,3575849035,3575849061,26
3,450,3125,3575849035,3575849062,27
3,450,3126,3575849035,3575849063,28
3,450,3127,3575849035,3575849066,31
3,450,3128,3575849035,3575849067,32
3,450,3129,3575849035,3575849069,34
3,450,3130,3575849035,3575849070,35
3,450,3131,3575849035,3575849076,41
3,450,3132,3575849035,3575849077,42
3,450,3133,3575849035,3575849077,42
3,450,3134,3575849035,3575849077,42
3,450,3135,3575849035,3575849083,48
3,450,3136,3575849035,3575849083,48
3,451,3137,3575849088,3575849088,0
3,451,3138,3575849088,3575849089,1
3,451,3139,3575849088,3575849090,2
3,451,3140,3575849088,3575849094,6
3,451,3141,3575849088,3575849101,13
3,451,3142,3575849088,3575849109,21
3,451,3143,3575849088,3575849117,29
3,451,3144,3575849088,3575849120,32
3,451,3145,3575849088,3575849121,33
3,451,3146,3575849088,3575849128,40
3,451,3147,3575849088,3575849134,46
3,451,3148,3575849088,3575849138,50
3,452,3149,3575849142,3575849142,0
3,452,3150,3575849142,3575849143,1
3,452,3151,3575849142,3575849143,1
3,452,3152,3575849142,3575849146,4
3,452,3153,3575849142,3575849146,4
3,452,3154,3575849142,3575849154,12
3,452,3155,3575849142,3575849160,18
3,452,3156,3575849142,3575849162,20
3,452,3157,3575849142,3575849164,22
3,452,3158,3575849142,3575849169,27
3,452,3159,3575849142,3575849171,29
3,452,3160,3575849142,3575849181,39
3,452,3161,3575849142,3575849182,40
3,452,3162,3575849142,3575849182,40
3,452,3163,3575849142,3575849183,41
3,452,3164,3575849142,3575849185,43
3,452,3165,3575849142,3575849188,46
3,452,3166,3575849142,3575849189,47
3,452,3167,3575849142,3575849191,49
3,453,3168,3575849195,3575849197,2
3,453,3169,3575849195,3575849198,3
3,453,3170,3575849195,3575849199,4
3,453,3171,3575849195,3575849201,6
3,453,3172,3575849195,3575849203,8
3,453,3173,3575849195,3575849204,9
3,453,3174,3575849195,3575849205,10
3,453,3175,3575849195,3575849206,11
3,453,3176,3575849195,3575849208,13
3,453,3177,3575849195,3575849215,20
3,453,3178,3575849195,3575849221,26
3,453,3179,3575849195,3575849221,26
3,453,3180,3575849195,3575849223,28
3,453,3181,3575849195,3575849225,30
3,453,3182,3575849195,3575849226,31
3,453,3183,3575849195,3575849236,41
3,453,3184,3575849195,3575849237,42
3,453,3185,3575849195,3575849239,44
3,453,3186,3575849195,3575849241,46
3,453,3187,3575849195,3575849244,49
3,454,3188,3575849248,3575849248,0
3,454,3189,3575849248,3575849248,0
3,454,3190,3575849248,3575849250,2
3,454,3191,3575849248,3575849251,3
3,454,3192,3575849248,3575849252,4
3,454,3193,3575849248,3575849255,7
3,454,3194,3575849248,3575849258,10
3,454,3195,3575849248,3575849259,11
3,454,3196,3575849248,3575849261,13
3,454,3197,3575849248,3575849262,14
3,454,3198,3575849248,3575849264,16
3,454,3199,3575849248,3575849265,17
3,454,3200,3575849248,3575849268,20
3,454,3201,3575849248,3575849269,21
3,454,3202,3575849248,3575849269,21
3,454,3203,3575849248,3575849276,28
3,454,3204,3575849248,3575849277,29
3,454,3205,3575849248,3575849277,29
3,454,3206,3575849248,3575849278,30
3,454,3207,3575849248,3575849282,34
3,454,3208,3575849248,3575849283,35
3,454,3209,3575849248,3575849287,39
3,454,3210,3575849248,3575849288,40
3,454,3211,3575849248,3575849289,41
3,454,3212,3575849248,3575849294,46
3,455,3213,3575849300,3575849301,1
3,455,3214,3575849300,3575849309,9
3,455,3215,3575849300,3575849317,17
3,455,3216,3575849300,3575849320,20
3,455,3217,3575849300,3575849321,21
3,455,3218,3575849300,3575849328,28
3,455,3219,3575849300,3575849334,34
3,455,3220,3575849300,3575849338,38
3,455,3221,3575849300,3575849340,40
3,455,3222,3575849300,3575849344,44
3,455,3223,3575849300,3575849344,44
3,455,3224,3575849300,3575849346,46
3,455,3225,3575849300,3575849346,46
3,456,3226,3575849353,3575849354,1
3,456,3227,3575849353,3575849359,6
3,456,3228,3575849353,3575849362,9
3,456,3229,3575849353,3575849364,11
3,456,3230,3575849353,3575849369,16
3,456,3231,3575849353,3575849371,18
3,456,3232,3575849353,3575849381,28
3,456,3233,3575849353,3575849382,29
3,456,3234,3575849353,3575849382,29
3,456,3235,3575849353,3575849383,30
3,456,3236,3575849353,3575849385,32
3,456,3237,3575849353,3575849388,35
3,456,3238,3575849353,3575849388,35
3,456,3239,3575849353,3575849390,37
3,456,3240,3575849353,3575849392,39
3,456,3241,3575849353,3575849399,46
3,456,3242,3575849353,3575849400,47
3,456,3243,3575849353,3575849401,48
3,457,3244,3575849407,3575849407,0
3,457,3245,3575849407,3575849407,0
3,457,3246,3575849407,3575849407,0
3,457,3247,3575849407,3575849407,0
3,457,3248,3575849407,3575849408,1
3,457,3249,3575849407,3575849415,8
3,457,3250,3575849407,3575849420,13
3,457,3251,3575849407,3575849421,14
3,457,3252,3575849407,3575849421,14
3,457,3253,3575849407,3575849423,16
3,457,3254,3575849407,3575849425,18
3,457,3255,3575849407,3575849427,20
3,457,3256,3575849407,3575849436,29
3,457,3257,3575849407,3575849437,30
3,457,3258,3575849407,3575849438,31
3,457,3259,3575849407,3575849439,32
3,457,3260,3575849407,3575849441,34
3,457,3261,3575849407,3575849442,35
3,457,3262,3575849407,3575849444,37
3,457,3263,3575849407,3575849446,39
3,457,3264,3575849407,3575849448,41
3,457,3265,3575849407,3575849450,43
3,457,3266,3575849407,3575849451,44
3,457,3267,3575849407,3575849453,46
3,457,3268,3575849407,3575849455,48
3,458,3269,3575849462,3575849462,0
3,458,3270,3575849462,3575849462,0
3,458,3271,3575849462,3575849462,0
3,458,3272,3575849462,3575849463,1
3,458,3273,3575849462,3575849465,3
3,458,3274,3575849462,3575849465,3
3,458,3275,3575849462,3575849467,5
3,458,3276,3575849462,3575849469,7
3,458,3277,3575849462,3575849470,8
3,458,3278,3575849462,3575849476,14
3,458,3279,3575849462,3575849477,15
3,458,3280,3575849462,3575849477,15
3,458,3281,3575849462,3575849478,16
3,458,3282,3575849462,3575849483,21
3,458,3283,3575849462,3575849483,21
3,458,3284,3575849462,3575849487,25
3,458,3285,3575849462,3575849488,26
3,458,3286,3575849462,3575849490,28
3,458,3287,3575849462,3575849494,32
3,458,3288,3575849462,3575849501,39
3,458,3289,3575849462,3575849509,47
3,459,3290,3575849515,3575849516,1
3,459,3291,3575849515,3575849520,5
3,459,3292,3575849515,3575849521,6
3,459,3293,3575849515,3575849526,11
3,459,3294,3575849515,3575849533,18
3,459,3295,3575849515,3575849537,22
3,459,3296,3575849515,3575849539,24
3,459,3297,3575849515,3575849542,27
3,459,3298,3575849515,3575849544,29
3,459,3299,3575849515,3575849544,29
3,459,3300,3575849515,3575849545,30
3,459,3301,3575849515,3575849545,30
3,459,3302,3575849515,3575849553,38
3,459,3303,3575849515,3575849559,44
3,459,3304,3575849515,3575849561,46
3,459,3305,3575849515,3575849563,48
3,460,3306,3575849568,3575849568,0
3,460,3307,3575849568,3575849570,2
3,460,3308,3575849568,3575849580,12
3,460,3309,3575849568,3575849581,13
3,460,3310,3575849568,3575849582,14
3,460,3311,3575849568,3575849582,14
3,460,3312,3575849568,3575849584,16
3,460,3313,3575849568,3575849587,19
3,460,3314,3575849568,3575849588,20
3,460,3315,3575849568,3575849589,21
3,460,3316,3575849568,3575849590,22
3,460,3317,3575849568,3575849596,28
3,460,3318,3575849568,3575849598,30
3,460,3319,3575849568,3575849598,30
3,460,3320,3575849568,3575849601,33
3,460,3321,3575849568,3575849602,34
3,460,3322,3575849568,3575849603,35
3,460,3323,3575849568,3575849603,35
3,460,3324,3575849568,3575849606,38
3,460,3325,3575849568,3575849608,40
3,460,3326,3575849568,3575849616,48
3,461,3327,3575849621,3575849621,0
3,461,3328,3575849621,3575849621,0
3,461,3329,3575849621,3575849621,0
3,461,3330,3575849621,3575849623,2
3,461,3331,3575849621,3575849625,4
3,461,3332,3575849621,3575849626,5
3,461,3333,3575849621,3575849635,14
3,461,3334,3575849621,3575849636,15
3,461,3335,3575849621,3575849638,17
3,461,3336,3575849621,3575849638,17
3,461,3337,3575849621,3575849640,19
3,461,3338,3575849621,3575849640,19
3,461,3339,3575849621,3575849642,21
3,461,3340,3575849621,3575849645,24
3,461,3341,3575849621,3575849647,26
3,461,3342,3575849621,3575849650,29
3,461,3343,3575849621,3575849650,29
3,461,3344,3575849621,3575849652,31
3,461,3345,3575849621,3575849654,33
3,461,3346,3575849621,3575849657,36
3,461,3347,3575849621,3575849658,37
3,461,3348,3575849621,3575849661,40
3,461,3349,3575849621,3575849662,41
3,461,3350,3575849621,3575849663,42
3,461,3351,3575849621,3575849666,45
3,461,3352,3575849621,3575849666,45
3,461,3353,3575849621,3575849669,48
3,461,3354,3575849621,3575849669,48
3,462,3355,3575849674,3575849676,2
3,462,3356,3575849674,3575849677,3
3,462,3357,3575849674,3575849677,3
3,462,3358,3575849674,3575849682,8
3,462,3359,3575849674,3575849683,9
3,462,3360,3575849674,3575849687,13
3,462,3361,3575849674,3575849689,15
3,462,3362,3575849674,3575849689,15
3,462,3363,3575849674,3575849694,20
3,462,3364,3575849674,3575849710,36
3,462,3365,3575849674,3575849716,42
3,462,3366,3575849674,3575849721,47
3,462,3367,3575849674,3575849721,47
3,463,3368,3575849727,3575849727,0
3,463,3369,3575849727,3575849732,5
3,463,3370,3575849727,3575849737,10
3,463,3371,3575849727,3575849740,13
3,463,3372,3575849727,3575849744,17
3,463,3373,3575849727,3575849744,17
3,463,3374,3575849727,3575849744,17
3,463,3375,3575849727,3575849744,17
3,463,3376,3575849727,3575849746,19
3,463,3377,3575849727,3575849754,27
3,463,3378,3575849727,3575849761,34
3,463,3379,3575849727,3575849764,37
3,463,3380,3575849727,3575849768,41
3,463,3381,3575849727,3575849770,43
3,464,3382,3575849780,3575849780,0
3,464,3383,3575849780,3575849781,1
3,464,3384,3575849780,3575849782,2
3,464,3385,3575849780,3575849782,2
3,464,3386,3575849780,3575849784,4
3,464,3387,3575849780,3575849787,7
3,464,3388,3575849780,3575849788,8
3,464,3389,3575849780,3575849789,9
3,464,3390,3575849780,3575849791,11
3,464,3391,3575849780,3575849796,16
3,464,3392,3575849780,3575849797,17
3,464,3393,3575849780,3575849799,19
3,464,3394,3575849780,3575849799,19
3,464,3395,3575849780,3575849800,20
3,464,3396,3575849780,3575849803,23
3,464,3397,3575849780,3575849803,23
3,464,3398,3575849780,3575849804,24
3,464,3399,3575849780,3575849806,26
3,464,3400,3575849780,3575849808,28
3,464,3401,3575849780,3575849815,35
3,464,3402,3575849780,3575849819,39
3,464,3403,3575849780,3575849819,39
3,464,3404,3575849780,3575849821,41
3,464,3405,3575849780,3575849822,42
3,464,3406,3575849780,3575849825,45
3,464,3407,3575849780,3575849826,46
3,465,3408,3575849833,3575849835,2
3,465,3409,3575849833,3575849837,4
3,465,3410,3575849833,3575849837,4
3,465,3411,3575849833,3575849838,5
3,465,3412,3575849833,3575849841,8
3,465,3413,3575849833,3575849841,8
3,465,3414,3575849833,3575849842,9
3,465,3415,3575849833,3575849845,12
3,465,3416,3575849833,3575849847,14
3,465,3417,3575849833,3575849850,17
3,465,3418,3575849833,3575849851,18
3,465,3419,3575849833,3575849852,19
3,465,3420,3575849833,3575849855,22
3,465,3421,3575849833,3575849857,24
3,465,3422,3575849833,3575849858,25
3,465,3423,3575849833,3575849862,29
3,465,3424,3575849833,3575849863,30
3,465,3425,3575849833,3575849866,33
3,465,3426,3575849833,3575849866,33
3,465,3427,3575849833,3575849869,36
3,465,3428,3575849833,3575849869,36
3,465,3429,3575849833,3575849876,43
3,465,3430,3575849833,3575849877,44
3,465,3431,3575849833,3575849877,44
3,465,3432,3575849833,3575849882,49
3,466,3433,3575849886,3575849886,0
3,466,3434,3575849886,3575849887,1
3,466,3435,3575849886,3575849889,3
3,466,3436,3575849886,3575849890,4
3,466,3437,3575849886,3575849895,9
3,466,3438,3575849886,3575849899,13
3,466,3439,3575849886,3575849901,15
3,466,3440,3575849886,3575849911,25
3,466,3441,3575849886,3575849917,31
3,466,3442,3575849886,3575849920,34
3,466,3443,3575849886,3575849920,34
3,466,3444,3575849886,3575849927,41
3,466,3445,3575849886,3575849933,47
3,467,3446,3575849939,3575849939,0
3,467,3447,3575849939,3575849941,2
3,467,3448,3575849939,3575849944,5
3,467,3449,3575849939,3575849944,5
3,467,3450,3575849939,3575849944,5
3,467,3451,3575849939,3575849945,6
3,467,3452,3575849939,3575849947,8
3,467,3453,3575849939,3575849954,15
3,467,3454,3575849939,3575849961,22
3,467,3455,3575849939,3575849963,24
3,467,3456,3575849939,3575849968,29
3,467,3457,3575849939,3575849971,32
3,467,3458,3575849939,3575849981,42
3,467,3459,3575849939,3575849981,42
3,467,3460,3575849939,3575849982,43
3,467,3461,3575849939,3575849982,43
3,467,3462,3575849939,3575849985,46
3,467,3463,3575849939,3575849988,49
3,467,3464,3575849939,3575849988,49
3,467,3465,3575849939,3575849989,50
3,468,3466,3575849992,3575849992,0
3,468,3467,3575849992,3575849997,5
3,468,3468,3575849992,3575849997,5
3,468,3469,3575849992,3575850000,8
3,468,3470,3575849992,3575850000,8
3,468,3471,3575849992,3575850000,8
3,468,3472,3575849992,3575850003,11
3,468,3473,3575849992,3575850003,11
3,468,3474,3575849992,3575850005,13
3,468,3475,3575849992,3575850006,14
3,468,3476,3575849992,3575850007,15
3,468,3477,3575849992,3575850016,24
3,468,3478,3575849992,3575850019,27
3,468,3479,3575849992,3575850020,28
3,468,3480,3575849992,3575850022,30
3,468,3481,3575849992,3575850023,31
3,468,3482,3575849992,3575850024,32
3,468,3483,3575849992,3575850027,35
3,468,3484,3575849992,3575850035,43
3,468,3485,3575849992,3575850037,45
3,468,3486,3575849992,3575850037,45
3,468,3487,3575849992,3575850038,46
3,468,3488,3575849992,3575850041,49
3,468,3489,3575849992,3575850041,49
3,469,3490,3575850045,3575850045,0
3,469,3491,3575850045,3575850045,0
3,469,3492,3575850045,3575850047,2
3,469,3493,3575850045,3575850050,5
3,469,3494,3575850045,3575850051,6
3,469,3495,3575850045,3575850052,7
3,469,3496,3575850045,3575850055,10
3,469,3497,3575850045,3575850057,12
3,469,3498,3575850045,3575850058,13
3,469,3499,3575850045,3575850061,16
3,469,3500,3575850045,3575850064,19
3,469,3501,3575850045,3575850066,21
3,469,3502,3575850045,3575850066,21
3,469,3503,3575850045,3575850069,24
3,469,3504,3575850045,3575850069,24
3,469,3505,3575850045,3575850076,31
3,469,3506,3575850045,3575850077,32
3,469,3507,3575850045,3575850077,32
3,469,3508,3575850045,3575850083,38
3,469,3509,3575850045,3575850083,38
3,469,3510,3575850045,3575850087,42
3,469,3511,3575850045,3575850089,44
3,469,3512,3575850045,3575850089,44
3,469,3513,3575850045,3575850095,50
3,470,3514,3575850097,3575850098,1
3,470,3515,3575850097,3575850101,4
3,470,3516,3575850097,3575850111,14
3,470,3517,3575850097,3575850118,21
3,470,3518,3575850097,3575850121,24
3,470,3519,3575850097,3575850121,24
3,470,3520,3575850097,3575850127,30
3,470,3521,3575850097,3575850134,37
3,470,3522,3575850097,3575850138,41
3,470,3523,3575850097,3575850140,43
3,470,3524,3575850097,3575850144,47
3,470,3525,3575850097,3575850144,47
3,470,3526,3575850097,3575850144,47
3,470,3527,3575850097,3575850146,49
3,470,3528,3575850097,3575850146,49
3,471,3529,3575850150,3575850154,4
3,471,3530,3575850150,3575850161,11
3,471,3531,3575850150,3575850164,14
3,471,3532,3575850150,3575850169,19
3,471,3533,3575850150,3575850171,21
3,471,3534,3575850150,3575850181,31
3,471,3535,3575850150,3575850181,31
3,471,3536,3575850150,3575850182,32
3,471,3537,3575850150,3575850182,32
3,471,3538,3575850150,3575850184,34
3,471,3539,3575850150,3575850188,38
3,471,3540,3575850150,3575850188,38
3,471,3541,3575850150,3575850188,38
3,471,3542,3575850150,3575850192,42
3,471,3543,3575850150,3575850197,47
3,471,3544,3575850150,3575850197,47
3,471,3545,3575850150,3575850199,49
3,471,3546,3575850150,3575850200,50
3,472,3547,3575850203,3575850203,0
3,472,3548,3575850203,3575850203,0
3,472,3549,3575850203,3575850204,1
3,472,3550,3575850203,3575850204,1
3,472,3551,3575850203,3575850207,4
3,472,3552,3575850203,3575850208,5
3,472,3553,3575850203,3575850215,12
3,472,3554,3575850203,3575850219,16
3,472,3555,3575850203,3575850221,18
3,472,3556,3575850203,3575850221,18
3,472,3557,3575850203,3575850225,22
3,472,3558,3575850203,3575850227,24
3,472,3559,3575850203,3575850235,32
3,472,3560,3575850203,3575850237,34
3,472,3561,3575850203,3575850238,35
3,472,3562,3575850203,3575850238,35
3,472,3563,3575850203,3575850240,37
3,472,3564,3575850203,3575850241,38
3,472,3565,3575850203,3575850245,42
3,472,3566,3575850203,3575850246,43
3,472,3567,3575850203,3575850248,45
3,472,3568,3575850203,3575850250,47
3,472,3569,3575850203,3575850250,47
3,472,3570,3575850203,3575850251,48
3,473,3571,3575850258,3575850258,0
3,473,3572,3575850258,3575850258,0
3,473,3573,3575850258,3575850259,1
3,473,3574,3575850258,3575850262,4
3,473,3575,3575850258,3575850264,6
3,473,3576,3575850258,3575850266,8
3,473,3577,3575850258,3575850269,11
3,473,3578,3575850258,3575850276,18
3,473,3579,3575850258,3575850278,20
3,473,3580,3575850258,3575850283,25
3,473,3581,3575850258,3575850283,25
3,473,3582,3575850258,3575850287,29
3,473,3583,3575850258,3575850289,31
3,473,3584,3575850258,3575850289,31
3,473,3585,3575850258,3575850296,38
3,473,3586,3575850258,3575850299,41
3,473,3587,3575850258,3575850301,43
3,474,3588,3575850312,3575850312,0
3,474,3589,3575850312,3575850317,5
3,474,3590,3575850312,3575850321,9
3,474,3591,3575850312,3575850322,10
3,474,3592,3575850312,3575850327,15
3,474,3593,3575850312,3575850333,21
3,474,3594,3575850312,3575850338,26
3,474,3595,3575850312,3575850341,29
3,474,3596,3575850312,3575850344,32
3,474,3597,3575850312,3575850344,32
3,474,3598,3575850312,3575850345,33
3,474,3599,3575850312,3575850346,34
3,474,3600,3575850312,3575850346,34
3,474,3601,3575850312,3575850354,42
3,474,3602,3575850312,3575850359,47
3,474,3603,3575850312,3575850361,49
3,475,3604,3575850365,3575850365,0
3,475,3605,3575850365,3575850368,3
3,475,3606,3575850365,3575850371,6
3,475,3607,3575850365,3575850381,16
3,475,3608,3575850365,3575850382,17
3,475,3609,3575850365,3575850382,17
3,475,3610,3575850365,3575850382,17
3,475,3611,3575850365,3575850386,21
3,475,3612,3575850365,3575850387,22
3,475,3613,3575850365,3575850388,23
3,475,3614,3575850365,3575850389,24
3,475,3615,3575850365,3575850392,27
3,475,3616,3575850365,3575850397,32
3,475,3617,3575850365,3575850397,32
3,475,3618,3575850365,3575850399,34
3,475,3619,3575850365,3575850400,35
3,475,3620,3575850365,3575850402,37
3,475,3621,3575850365,3575850403,38
3,475,3622,3575850365,3575850403,38
3,475,3623,3575850365,3575850404,39
3,475,3624,3575850365,3575850407,42
3,475,3625,3575850365,3575850407,42
3,476,3626,3575850418,3575850418,0
3,476,3627,3575850418,3575850420,2
3,476,3628,3575850418,3575850421,3
3,476,3629,3575850418,3575850422,4
3,476,3630,3575850418,3575850425,7
3,476,3631,3575850418,3575850427,9
3,476,3632,3575850418,3575850436,18
3,476,3633,3575850418,3575850438,20
3,476,3634,3575850418,3575850438,20
3,476,3635,3575850418,3575850438,20
3,476,3636,3575850418,3575850441,23
3,476,3637,3575850418,3575850441,23
3,476,3638,3575850418,3575850445,27
3,476,3639,3575850418,3575850446,28
3,476,3640,3575850418,3575850448,30
3,476,3641,3575850418,3575850450,32
3,476,3642,3575850418,3575850451,33
3,476,3643,3575850418,3575850452,34
3,476,3644,3575850418,3575850455,37
3,476,3645,3575850418,3575850456,38
3,476,3646,3575850418,3575850457,39
3,476,3647,3575850418,3575850459,41
3,476,3648,3575850418,3575850462,44
3,476,3649,3575850418,3575850464,46
3,476,3650,3575850418,3575850466,48
3,477,3651,3575850471,3575850471,0
3,477,3652,3575850471,3575850471,0
3,477,3653,3575850471,3575850476,5
3,477,3654,3575850471,3575850478,7
3,477,3655,3575850471,3575850483,12
3,477,3656,3575850471,3575850483,12
3,477,3657,3575850471,3575850488,17
3,477,3658,3575850471,3575850490,19
3,477,3659,3575850471,3575850490,19
3,477,3660,3575850471,3575850495,24
3,477,3661,3575850471,3575850498,27
3,477,3662,3575850471,3575850501,30
3,477,3663,3575850471,3575850511,40
3,477,3664,3575850471,3575850517,46
3,477,3665,3575850471,3575850520,49
3,478,3666,3575850525,3575850525,0
3,478,3667,3575850525,3575850525,0
3,478,3668,3575850525,3575850526,1
3,478,3669,3575850525,3575850533,8
3,478,3670,3575850525,3575850537,12
3,478,3671,3575850525,3575850539,14
3,478,3672,3575850525,3575850543,18
3,478,3673,3575850525,3575850543,18
3,478,3674,3575850525,3575850543,18
3,478,3675,3575850525,3575850545,20
3,478,3676,3575850525,3575850545,20
3,478,3677,3575850525,3575850553,28
3,478,3678,3575850525,3575850558,33
3,478,3679,3575850525,3575850560,35
3,478,3680,3575850525,3575850564,39
3,478,3681,3575850525,3575850568,43
3,478,3682,3575850525,3575850570,45
3,479,3683,3575850579,3575850580,1
3,479,3684,3575850579,3575850580,1
3,479,3685,3575850579,3575850581,2
3,479,3686,3575850579,3575850581,2
3,479,3687,3575850579,3575850585,6
3,479,3688,3575850579,3575850586,7
3,479,3689,3575850579,3575850588,9
3,479,3690,3575850579,3575850589,10
3,479,3691,3575850579,3575850591,12
3,479,3692,3575850579,3575850596,17
3,479,3693,3575850579,3575850596,17
3,479,3694,3575850579,3575850598,19
3,479,3695,3575850579,3575850599,20
3,479,3696,3575850579,3575850601,22
3,479,3697,3575850579,3575850602,23
3,479,3698,3575850579,3575850603,24
3,479,3699,3575850579,3575850604,25
3,479,3700,3575850579,3575850606,27
3,479,3701,3575850579,3575850606,27
3,479,3702,3575850579,3575850616,37
3,479,3703,3575850579,3575850618,39
3,479,3704,3575850579,3575850620,41
3,479,3705,3575850579,3575850620,41
3,479,3706,3575850579,3575850625,46
3,479,3707,3575850579,3575850626,47
3,480,3708,3575850632,3575850635,3
3,480,3709,3575850632,3575850636,4
3,480,3710,3575850632,3575850637,5
3,480,3711,3575850632,3575850640,8
3,480,3712,3575850632,3575850640,8
3,480,3713,3575850632,3575850643,11
3,480,3714,3575850632,3575850645,13
3,480,3715,3575850632,3575850647,15
3,480,3716,3575850632,3575850649,17
3,480,3717,3575850632,3575850650,18
3,480,3718,3575850632,3575850652,20
3,480,3719,3575850632,3575850654,22
3,480,3720,3575850632,3575850656,24
3,480,3721,3575850632,3575850658,26
3,480,3722,3575850632,3575850662,30
3,480,3723,3575850632,3575850663,31
3,480,3724,3575850632,3575850665,33
3,480,3725,3575850632,3575850669,37
3,480,3726,3575850632,3575850669,37
3,480,3727,3575850632,3575850676,44
3,480,3728,3575850632,3575850677,45
3,481,3729,3575850685,3575850685,0
3,481,3730,3575850685,3575850685,0
3,481,3731,3575850685,3575850689,4
3,481,3732,3575850685,3575850690,5
3,481,3733,3575850685,3575850690,5
3,481,3734,3575850685,3575850695,10
3,481,3735,3575850685,3575850698,13
3,481,3736,3575850685,3575850701,16
3,481,3737,3575850685,3575850710,25
3,481,3738,3575850685,3575850717,32
3,481,3739,3575850685,3575850721,36
3,481,3740,3575850685,3575850722,37
3,481,3741,3575850685,3575850726,41
3,481,3742,3575850685,3575850727,42
3,481,3743,3575850685,3575850733,48
3,482,3744,3575850738,3575850739,1
3,482,3745,3575850738,3575850741,3
3,482,3746,3575850738,3575850743,5
3,482,3747,3575850738,3575850743,5
3,482,3748,3575850738,3575850743,5
3,482,3749,3575850738,3575850745,7
3,482,3750,3575850738,3575850746,8
3,482,3751,3575850738,3575850754,16
3,482,3752,3575850738,3575850758,20
3,482,3753,3575850738,3575850760,22
3,482,3754,3575850738,3575850764,26
3,482,3755,3575850738,3575850769,31
3,482,3756,3575850738,3575850770,32
3,482,3757,3575850738,3575850780,42
3,482,3758,3575850738,3575850780,42
3,482,3759,3575850738,3575850781,43
3,482,3760,3575850738,3575850781,43
3,482,3761,3575850738,3575850785,47
3,482,3762,3575850738,3575850787,49
3,483,3763,3575850791,3575850791,0
3,483,3764,3575850791,3575850791,0
3,483,3765,3575850791,3575850792,1
3,483,3766,3575850791,3575850796,5
3,483,3767,3575850791,3575850796,5
3,483,3768,3575850791,3575850798,7
3,483,3769,3575850791,3575850799,8
3,483,3770,3575850791,3575850801,10
3,483,3771,3575850791,3575850803,12
3,483,3772,3575850791,3575850803,12
3,483,3773,3575850791,3575850805,14
3,483,3774,3575850791,3575850806,15
3,483,3775,3575850791,3575850807,16
3,483,3776,3575850791,3575850816,25
3,483,3777,3575850791,3575850819,28
3,483,3778,3575850791,3575850819,28
3,483,3779,3575850791,3575850821,30
3,483,3780,3575850791,3575850824,33
3,483,3781,3575850791,3575850827,36
3,483,3782,3575850791,3575850835,44
3,483,3783,3575850791,3575850836,45
3,483,3784,3575850791,3575850838,47
3,483,3785,3575850791,3575850840,49
3,483,3786,3575850791,3575850841,50
3,484,3787,3575850844,3575850844,0
3,484,3788,3575850844,3575850845,1
3,484,3789,3575850844,3575850847,3
3,484,3790,3575850844,3575850850,6
3,484,3791,3575850844,3575850850,6
3,484,3792,3575850844,3575850852,8
3,484,3793,3575850844,3575850855,11
3,484,3794,3575850844,3575850856,12
3,484,3795,3575850844,3575850858,14
3,484,3796,3575850844,3575850862,18
3,484,3797,3575850844,3575850864,20
3,484,3798,3575850844,3575850865,21
3,484,3799,3575850844,3575850867,23
3,484,3800,3575850844,3575850869,25
3,484,3801,3575850844,3575850869,25
3,484,3802,3575850844,3575850876,32
3,484,3803,3575850844,3575850877,33
3,484,3804,3575850844,3575850884,40
3,484,3805,3575850844,3575850884,40
3,484,3806,3575850844,3575850889,45
3,484,3807,3575850844,3575850889,45
3,484,3808,3575850844,3575850889,45
3,485,3809,3575850897,3575850897,0
3,485,3810,3575850897,3575850899,2
3,485,3811,3575850897,3575850901,4
3,485,3812,3575850897,3575850911,14
3,485,3813,3575850897,3575850917,20
3,485,3814,3575850897,3575850920,23
3,485,3815,3575850897,3575850923,26
3,485,3816,3575850897,3575850927,30
3,485,3817,3575850897,3575850928,31
3,485,3818,3575850897,3575850934,37
3,485,3819,3575850897,3575850937,40
3,485,3820,3575850897,3575850941,44
3,485,3821,3575850897,3575850942,45
3,485,3822,3575850897,3575850943,46
3,485,3823,3575850897,3575850944,47
3,485,3824,3575850897,3575850945,48
3,486,3825,3575850950,3575850954,4
3,486,3826,3575850950,3575850958,8
3,486,3827,3575850950,3575850960,10
3,486,3828,3575850950,3575850965,15
3,486,3829,3575850950,3575850968,18
3,486,3830,3575850950,3575850969,19
3,486,3831,3575850950,3575850981,31
3,486,3832,3575850950,3575850981,31
3,486,3833,3575850950,3575850981,31
3,486,3834,3575850950,3575850982,32
3,486,3835,3575850950,3575850985,35
3,486,3836,3575850950,3575850987,37
3,486,3837,3575850950,3575850988,38
3,486,3838,3575850950,3575850989,39
3,486,3839,3575850950,3575850992,42
3,486,3840,3575850950,3575850996,46
3,486,3841,3575850950,3575850997,47
3,486,3842,3575850950,3575850999,49
3,487,3843,3575851003,3575851003,0
3,487,3844,3575851003,3575851003,0
3,487,3845,3575851003,3575851003,0
3,487,3846,3575851003,3575851004,1
3,487,3847,3575851003,3575851005,2
3,487,3848,3575851003,3575851005,2
3,487,3849,3575851003,3575851007,4
3,487,3850,3575851003,3575851016,13
3,487,3851,3575851003,3575851019,16
3,487,3852,3575851003,3575851021,18
3,487,3853,3575851003,3575851022,19
3,487,3854,3575851003,3575851025,22
3,487,3855,3575851003,3575851027,24
3,487,3856,3575851003,3575851035,32
3,487,3857,3575851003,3575851036,33
3,487,3858,3575851003,3575851038,35
3,487,3859,3575851003,3575851038,35
3,487,3860,3575851003,3575851040,37
3,487,3861,3575851003,3575851041,38
3,487,3862,3575851003,3575851043,40
3,487,3863,3575851003,3575851046,43
3,487,3864,3575851003,3575851047,44
3,487,3865,3575851003,3575851049,46
3,487,3866,3575851003,3575851050,47
3,487,3867,3575851003,3575851052,49
3,488,3868,3575851057,3575851057,0
3,488,3869,3575851057,3575851057,0
3,488,3870,3575851057,3575851058,1
3,488,3871,3575851057,3575851062,5
3,488,3872,3575851057,3575851063,6
3,488,3873,3575851057,3575851065,8
3,488,3874,3575851057,3575851065,8
3,488,3875,3575851057,3575851067,10
3,488,3876,3575851057,3575851069,12
3,488,3877,3575851057,3575851069,12
3,488,3878,3575851057,3575851076,19
3,488,3879,3575851057,3575851077,20
3,488,3880,3575851057,3575851083,26
3,488,3881,3575851057,3575851085,28
3,488,3882,3575851057,3575851089,32
3,488,3883,3575851057,3575851089,32
3,488,3884,3575851057,3575851090,33
3,488,3885,3575851057,3575851096,39
3,488,3886,3575851057,3575851098,41
3,488,3887,3575851057,3575851101,44
3,489,3888,3575851111,3575851111,0
3,489,3889,3575851111,3575851117,6
3,489,3890,3575851111,3575851120,9
3,489,3891,3575851111,3575851123,12
3,489,3892,3575851111,3575851127,16
3,489,3893,3575851111,3575851128,17
3,489,3894,3575851111,3575851133,22
3,489,3895,3575851111,3575851137,26
3,489,3896,3575851111,3575851141,30
3,489,3897,3575851111,3575851143,32
3,489,3898,3575851111,3575851143,32
3,489,3899,3575851111,3575851144,33
3,489,3900,3575851111,3575851145,34
3,489,3901,3575851111,3575851154,43
3,489,3902,3575851111,3575851159,48
3,490,3903,3575851164,3575851164,0
3,490,3904,3575851164,3575851165,1
3,490,3905,3575851164,3575851168,4
3,490,3906,3575851164,3575851171,7
3,490,3907,3575851164,3575851181,17
3,490,3908,3575851164,3575851181,17
3,490,3909,3575851164,3575851181,17
3,490,3910,3575851164,3575851182,18
3,490,3911,3575851164,3575851185,21
3,490,3912,3575851164,3575851187,23
3,490,3913,3575851164,3575851188,24
3,490,3914,3575851164,3575851189,25
3,490,3915,3575851164,3575851191,27
3,490,3916,3575851164,3575851196,32
3,490,3917,3575851164,3575851197,33
3,490,3918,3575851164,3575851200,36
3,490,3919,3575851164,3575851201,37
3,490,3920,3575851164,3575851203,39
3,490,3921,3575851164,3575851203,39
3,490,3922,3575851164,3575851204,40
3,490,3923,3575851164,3575851206,42
3,490,3924,3575851164,3575851208,44
3,491,3925,3575851217,3575851217,0
3,491,3926,3575851217,3575851219,2
3,491,3927,3575851217,3575851220,3
3,491,3928,3575851217,3575851222,5
3,491,3929,3575851217,3575851225,8
3,491,3930,3575851217,3575851227,10
3,491,3931,3575851217,3575851235,18
3,491,3932,3575851217,3575851237,20
3,491,3933,3575851217,3575851238,21
3,491,3934,3575851217,3575851238,21
3,491,3935,3575851217,3575851241,24
3,491,3936,3575851217,3575851241,24
3,491,3937,3575851217,3575851244,27
3,491,3938,3575851217,3575851246,29
3,491,3939,3575851217,3575851248,31
3,491,3940,3575851217,3575851250,33
3,491,3941,3575851217,3575851250,33
3,491,3942,3575851217,3575851252,35
3,491,3943,3575851217,3575851255,38
3,491,3944,3575851217,3575851256,39
3,491,3945,3575851217,3575851258,41
3,491,3946,3575851217,3575851259,42
3,491,3947,3575851217,3575851262,45
3,491,3948,3575851217,3575851264,47
3,491,3949,3575851217,3575851265,48
3,491,3950,3575851217,3575851265,48
3,492,3951,3575851271,3575851271,0
3,492,3952,3575851271,3575851271,0
3,492,3953,3575851271,3575851271,0
3,492,3954,3575851271,3575851276,5
3,492,3955,3575851271,3575851278,7
3,492,3956,3575851271,3575851284,13
3,492,3957,3575851271,3575851284,13
3,492,3958,3575851271,3575851289,18
3,492,3959,3575851271,3575851289,18
3,492,3960,3575851271,3575851290,19
3,492,3961,3575851271,3575851296,25
3,492,3962,3575851271,3575851298,27
3,492,3963,3575851271,3575851301,30
3,492,3964,3575851271,3575851311,40
3,492,3965,3575851271,3575851317,46
3,492,3966,3575851271,3575851318,47
3,492,3967,3575851271,3575851320,49
3,493,3968,3575851325,3575851325,0
3,493,3969,3575851325,3575851327,2
3,493,3970,3575851325,3575851328,3
3,493,3971,3575851325,3575851334,9
3,493,3972,3575851325,3575851337,12
3,493,3973,3575851325,3575851340,15
3,493,3974,3575851325,3575851343,18
3,493,3975,3575851325,3575851344,19
3,493,3976,3575851325,3575851344,19
3,493,3977,3575851325,3575851346,21
3,493,3978,3575851325,3575851346,21
3,493,3979,3575851325,3575851354,29
3,493,3980,3575851325,3575851359,34
3,493,3981,3575851325,3575851361,36
3,493,3982,3575851325,3575851365,40
3,493,3983,3575851325,3575851368,43
3,493,3984,3575851325,3575851369,44
3,493,3985,3575851325,3575851371,46
3,494,3986,3575851379,3575851381,2
3,494,3987,3575851379,3575851381,2
3,494,3988,3575851379,3575851381,2
3,494,3989,3575851379,3575851382,3
3,494,3990,3575851379,3575851385,6
3,494,3991,3575851379,3575851387,8
3,494,3992,3575851379,3575851389,10
3,494,3993,3575851379,3575851390,11
3,494,3994,3575851379,3575851392,13
3,494,3995,3575851379,3575851396,17
3,494,3996,3575851379,3575851397,18
3,494,3997,3575851379,3575851399,20
3,494,3998,3575851379,3575851400,21
3,494,3999,3575851379,3575851401,22
3,494,4000,3575851379,3575851403,24
3,494,4001,3575851379,3575851403,24
3,494,4002,3575851379,3575851405,26
3,494,4003,3575851379,3575851406,27
3,494,4004,3575851379,3575851407,28
3,494,4005,3575851379,3575851416,37
3,494,4006,3575851379,3575851419,40
3,494,4007,3575851379,3575851421,42
3,494,4008,3575851379,3575851422,43
3,494,4009,3575851379,3575851425,46
3,494,4010,3575851379,3575851427,48
3,495,4011,3575851432,3575851437,5
3,495,4012,3575851432,3575851438,6
3,495,4013,3575851432,3575851438,6
3,495,4014,3575851432,3575851438,6
3,495,4015,3575851432,3575851440,8
3,495,4016,3575851432,3575851441,9
3,495,4017,3575851432,3575851444,12
3,495,4018,3575851432,3575851446,14
3,495,4019,3575851432,3575851448,16
3,495,4020,3575851432,3575851450,18
3,495,4021,3575851432,3575851450,18
3,495,4022,3575851432,3575851453,21
3,495,4023,3575851432,3575851454,22
3,495,4024,3575851432,3575851455,23
3,495,4025,3575851432,3575851457,25
3,495,4026,3575851432,3575851460,28
3,495,4027,3575851432,3575851462,30
3,495,4028,3575851432,3575851464,32
3,495,4029,3575851432,3575851465,33
3,495,4030,3575851432,3575851465,33
3,495,4031,3575851432,3575851468,36
3,495,4032,3575851432,3575851468,36
3,495,4033,3575851432,3575851469,37
3,495,4034,3575851432,3575851470,38
3,495,4035,3575851432,3575851476,44
3,495,4036,3575851432,3575851477,45
3,496,4037,3575851485,3575851485,0
3,496,4038,3575851485,3575851488,3
3,496,4039,3575851485,3575851489,4
3,496,4040,3575851485,3575851490,5
3,496,4041,3575851485,3575851496,11
3,496,4042,3575851485,3575851498,13
3,496,4043,3575851485,3575851500,15
3,496,4044,3575851485,3575851510,25
3,496,4045,3575851485,3575851516,31
3,496,4046,3575851485,3575851517,32
3,496,4047,3575851485,3575851520,35
3,496,4048,3575851485,3575851522,37
3,496,4049,3575851485,3575851526,41
3,496,4050,3575851485,3575851533,48
3,497,4051,3575851538,3575851538,0
3,497,4052,3575851538,3575851539,1
3,497,4053,3575851538,3575851542,4
3,497,4054,3575851538,3575851542,4
3,497,4055,3575851538,3575851543,5
3,497,4056,3575851538,3575851545,7
3,497,4057,3575851538,3575851545,7
3,497,4058,3575851538,3575851553,15
3,497,4059,3575851538,3575851559,21
3,497,4060,3575851538,3575851560,22
3,497,4061,3575851538,3575851565,27
3,497,4062,3575851538,3575851568,30
3,497,4063,3575851538,3575851569,31
3,497,4064,3575851538,3575851571,33
3,497,4065,3575851538,3575851580,42
3,497,4066,3575851538,3575851580,42
3,497,4067,3575851538,3575851581,43
3,497,4068,3575851538,3575851581,43
3,497,4069,3575851538,3575851584,46
3,497,4070,3575851538,3575851586,48
3,498,4071,3575851592,3575851592,0
3,498,4072,3575851592,3575851592,0
3,498,4073,3575851592,3575851592,0
3,498,4074,3575851592,3575851595,3
3,498,4075,3575851592,3575851596,4
3,498,4076,3575851592,3575851598,6
3,498,4077,3575851592,3575851599,7
3,498,4078,3575851592,3575851600,8
3,498,4079,3575851592,3575851604,12
3,498,4080,3575851592,3575851606,14
3,498,4081,3575851592,3575851606,14
3,498,4082,3575851592,3575851615,23
3,498,4083,3575851592,3575851618,26
3,498,4084,3575851592,3575851620,28
3,498,4085,3575851592,3575851620,28
3,498,4086,3575851592,3575851622,30
3,498,4087,3575851592,3575851625,33
3,498,4088,3575851592,3575851626,34
3,498,4089,3575851592,3575851635,43
3,498,4090,3575851592,3575851637,45
3,498,4091,3575851592,3575851638,46
3,498,4092,3575851592,3575851639,47
3,498,4093,3575851592,3575851640,48
3,498,4094,3575851592,3575851642,50
3,499,4095,3575851646,3575851646,0
3,499,4096,3575851646,3575851647,1
3,499,4097,3575851646,3575851648,2
3,499,4098,3575851646,3575851650,4
3,499,4099,3575851646,3575851652,6
3,499,4100,3575851646,3575851653,7
3,499,4101,3575851646,3575851654,8
3,499,4102,3575851646,3575851657,11
3,499,4103,3575851646,3575851659,13
3,499,4104,3575851646,3575851662,16
3,499,4105,3575851646,3575851664,18
3,499,4106,3575851646,3575851664,18
3,499,4107,3575851646,3575851665,19
3,499,4108,3575851646,3575851667,21
3,499,4109,3575851646,3575851668,22
3,499,4110,3575851646,3575851669,23
3,499,4111,3575851646,3575851669,23
3,499,4112,3575851646,3575851676,30
3,499,4113,3575851646,3575851676,30
3,499,4114,3575851646,3575851678,32
3,499,4115,3575851646,3575851683,37
3,499,4116,3575851646,3575851684,38
3,499,4117,3575851646,3575851688,42
3,499,4118,3575851646,3575851689,43
3,499,4119,3575851646,3575851689,43
3,499,4120,3575851646,3575851697,51
3,500,4121,3575851700,3575851700,0
3,500,4122,3575851700,3575851700,0
3,500,4123,3575851700,3575851710,10
3,500,4124,3575851700,3575851716,16
3,500,4125,3575851700,3575851717,17
3,500,4126,3575851700,3575851721,21
3,500,4127,3575851700,3575851722,22
3,500,4128,3575851700,3575851725,25
3,500,4129,3575851700,3575851727,27
3,500,4130,3575851700,3575851733,33
3,500,4131,3575851700,3575851737,37
3,500,4132,3575851700,3575851740,40
3,500,4133,3575851700,3575851742,42
3,500,4134,3575851700,3575851743,43
3,500,4135,3575851700,3575851743,43
3,500,4136,3575851700,3575851745,45
3,500,4137,3575851700,3575851746,46
3,501,4138,3575851753,3575851754,1
3,501,4139,3575851753,3575851758,5
3,501,4140,3575851753,3575851760,7
3,501,4141,3575851753,3575851765,12
3,501,4142,3575851753,3575851768,15
3,501,4143,3575851753,3575851770,17
3,501,4144,3575851753,3575851771,18
3,501,4145,3575851753,3575851780,27
3,501,4146,3575851753,3575851780,27
3,501,4147,3575851753,3575851781,28
3,501,4148,3575851753,3575851781,28
3,501,4149,3575851753,3575851784,31
3,501,4150,3575851753,3575851786,33
3,501,4151,3575851753,3575851790,37
3,501,4152,3575851753,3575851790,37
3,501,4153,3575851753,3575851792,39
3,501,4154,3575851753,3575851795,42
3,501,4155,3575851753,3575851796,43
3,501,4156,3575851753,3575851798,45
3,501,4157,3575851753,3575851799,46
3,501,4158,3575851753,3575851800,47
3,502,4159,3575851806,3575851806,0
3,502,4160,3575851806,3575851806,0
3,502,4161,3575851806,3575851806,0
3,502,4162,3575851806,3575851807,1
3,502,4163,3575851806,3575851816,10
3,502,4164,3575851806,3575851820,14
3,502,4165,3575851806,3575851820,14
3,502,4166,3575851806,3575851821,15
3,502,4167,3575851806,3575851822,16
3,502,4168,3575851806,3575851825,19
3,502,4169,3575851806,3575851826,20
3,502,4170,3575851806,3575851835,29
3,502,4171,3575851806,3575851836,30
3,502,4172,3575851806,3575851838,32
3,502,4173,3575851806,3575851838,32
3,502,4174,3575851806,3575851840,34
3,502,4175,3575851806,3575851841,35
3,502,4176,3575851806,3575851843,37
3,502,4177,3575851806,3575851845,39
3,502,4178,3575851806,3575851847,41
3,502,4179,3575851806,3575851848,42
3,502,4180,3575851806,3575851850,44
3,502,4181,3575851806,3575851852,46
3,502,4182,3575851806,3575851854,48
3,502,4183,3575851806,3575851855,49
3,503,4184,3575851860,3575851860,0
3,503,4185,3575851860,3575851860,0
3,503,4186,3575851860,3575851863,3
3,503,4187,3575851860,3575851863,3
3,503,4188,3575851860,3575851864,4
3,503,4189,3575851860,3575851865,5
3,503,4190,3575851860,3575851867,7
3,503,4191,3575851860,3575851868,8
3,503,4192,3575851860,3575851869,9
3,503,4193,3575851860,3575851869,9
3,503,4194,3575851860,3575851876,16
3,503,4195,3575851860,3575851877,17
3,503,4196,3575851860,3575851877,17
3,503,4197,3575851860,3575851883,23
3,503,4198,3575851860,3575851885,25
3,503,4199,3575851860,3575851888,28
3,503,4200,3575851860,3575851890,30
3,503,4201,3575851860,3575851890,30
3,503,4202,3575851860,3575851896,36
3,503,4203,3575851860,3575851897,37
3,503,4204,3575851860,3575851900,40
3,504,4205,3575851913,3575851913,0
3,504,4206,3575851913,3575851917,4
3,504,4207,3575851913,3575851918,5
3,504,4208,3575851913,3575851920,7
3,504,4209,3575851913,3575851921,8
3,504,4210,3575851913,3575851926,13
3,504,4211,3575851913,3575851927,14
3,504,4212,3575851913,3575851933,20
3,504,4213,3575851913,3575851937,24
3,504,4214,3575851913,3575851940,27
3,504,4215,3575851913,3575851943,30
3,504,4216,3575851913,3575851943,30
3,504,4217,3575851913,3575851944,31
3,504,4218,3575851913,3575851945,32
3,504,4219,3575851913,3575851946,33
3,504,4220,3575851913,3575851955,42
3,504,4221,3575851913,3575851958,45
3,504,4222,3575851913,3575851961,48
3,505,4223,3575851967,3575851967,0
3,505,4224,3575851967,3575851968,1
3,505,4225,3575851967,3575851970,3
3,505,4226,3575851967,3575851971,4
3,505,4227,3575851967,3575851979,12
3,505,4228,3575851967,3575851981,14
3,505,4229,3575851967,3575851981,14
3,505,4230,3575851967,3575851981,14
3,505,4231,3575851967,3575851982,15
3,505,4232,3575851967,3575851984,17
3,505,4233,3575851967,3575851987,20
3,505,4234,3575851967,3575851990,23
3,505,4235,3575851967,3575851990,23
3,505,4236,3575851967,3575851992,25
3,505,4237,3575851967,3575851995,28
3,505,4238,3575851967,3575851997,30
3,505,4239,3575851967,3575851998,31
3,505,4240,3575851967,3575851999,32
3,505,4241,3575851967,3575852000,33
3,505,4242,3575851967,3575852003,36
3,505,4243,3575851967,3575852004,37
3,505,4244,3575851967,3575852005,38
3,505,4245,3575851967,3575852007,40
3,505,4246,3575851967,3575852008,41
3,505,4247,3575851967,3575852016,49
3,506,4248,3575852020,3575852020,0
3,506,4249,3575852020,3575852021,1
3,506,4250,3575852020,3575852022,2
3,506,4251,3575852020,3575852023,3
3,506,4252,3575852020,3575852026,6
3,506,4253,3575852020,3575852026,6
3,506,4254,3575852020,3575852030,10
3,506,4255,3575852020,3575852035,15
3,506,4256,3575852020,3575852037,17
3,506,4257,3575852020,3575852038,18
3,506,4258,3575852020,3575852040,20
3,506,4259,3575852020,3575852041,21
3,506,4260,3575852020,3575852044,24
3,506,4261,3575852020,3575852047,27
3,506,4262,3575852020,3575852049,29
3,506,4263,3575852020,3575852050,30
3,506,4264,3575852020,3575852051,31
3,506,4265,3575852020,3575852054,34
3,506,4266,3575852020,3575852055,35
3,506,4267,3575852020,3575852057,37
3,506,4268,3575852020,3575852059,39
3,506,4269,3575852020,3575852062,42
3,506,4270,3575852020,3575852064,44
3,506,4271,3575852020,3575852065,45
3,506,4272,3575852020,3575852065,45
3,506,4273,3575852020,3575852068,48
3,506,4274,3575852020,3575852068,48
3,506,4275,3575852020,3575852069,49
3,506,4276,3575852020,3575852069,49
3,507,4277,3575852073,3575852076,3
3,507,4278,3575852073,3575852077,4
3,507,4279,3575852073,3575852078,5
3,507,4280,3575852073,3575852084,11
3,507,4281,3575852073,3575852084,11
3,507,4282,3575852073,3575852088,15
3,507,4283,3575852073,3575852089,16
3,507,4284,3575852073,3575852090,17
3,507,4285,3575852073,3575852097,24
3,507,4286,3575852073,3575852098,25
3,507,4287,3575852073,3575852100,27
3,507,4288,3575852073,3575852110,37
3,507,4289,3575852073,3575852117,44
3,507,4290,3575852073,3575852118,45
3,507,4291,3575852073,3575852120,47
3,507,4292,3575852073,3575852122,49
3,508,4293,3575852126,3575852126,0
3,508,4294,3575852126,3575852133,7
3,508,4295,3575852126,3575852137,11
3,508,4296,3575852126,3575852141,15
3,508,4297,3575852126,3575852142,16
3,508,4298,3575852126,3575852143,17
3,508,4299,3575852126,3575852144,18
3,508,4300,3575852126,3575852145,19
3,508,4301,3575852126,3575852147,21
3,508,4302,3575852126,3575852154,28
3,508,4303,3575852126,3575852159,33
3,508,4304,3575852126,3575852161,35
3,508,4305,3575852126,3575852164,38
3,508,4306,3575852126,3575852169,43
3,508,4307,3575852126,3575852170,44
3,508,4308,3575852126,3575852171,45
3,509,4309,3575852181,3575852181,0
3,509,4310,3575852181,3575852181,0
3,509,4311,3575852181,3575852181,0
3,509,4312,3575852181,3575852181,0
3,509,4313,3575852181,3575852182,1
3,509,4314,3575852181,3575852185,4
3,509,4315,3575852181,3575852188,7
3,509,4316,3575852181,3575852189,8
3,509,4317,3575852181,3575852190,9
3,509,4318,3575852181,3575852192,11
3,509,4319,3575852181,3575852195,14
3,509,4320,3575852181,3575852197,16
3,509,4321,3575852181,3575852198,17
3,509,4322,3575852181,3575852200,19
3,509,4323,3575852181,3575852201,20
3,509,4324,3575852181,3575852203,22
3,509,4325,3575852181,3575852204,23
3,509,4326,3575852181,3575852204,23
3,509,4327,3575852181,3575852207,26
3,509,4328,3575852181,3575852208,27
3,509,4329,3575852181,3575852215,34
3,509,4330,3575852181,3575852220,39
3,509,4331,3575852181,3575852221,40
3,509,4332,3575852181,3575852221,40
3,509,4333,3575852181,3575852222,41
3,509,4334,3575852181,3575852226,45
3,509,4335,3575852181,3575852226,45
3,509,4336,3575852181,3575852230,49
3,510,4337,3575852235,3575852235,0
3,510,4338,3575852235,3575852235,0
3,510,4339,3575852235,3575852237,2
3,510,4340,3575852235,3575852238,3
3,510,4341,3575852235,3575852238,3
3,510,4342,3575852235,3575852241,6
3,510,4343,3575852235,3575852241,6
3,510,4344,3575852235,3575852244,9
3,510,4345,3575852235,3575852248,13
3,510,4346,3575852235,3575852248,13
3,510,4347,3575852235,3575852250,15
3,510,4348,3575852235,3575852252,17
3,510,4349,3575852235,3575852254,19
3,510,4350,3575852235,3575852255,20
3,510,4351,3575852235,3575852258,23
3,510,4352,3575852235,3575852259,24
3,510,4353,3575852235,3575852262,27
3,510,4354,3575852235,3575852264,29
3,510,4355,3575852235,3575852264,29
3,510,4356,3575852235,3575852265,30
3,510,4357,3575852235,3575852267,32
3,510,4358,3575852235,3575852268,33
3,510,4359,3575852235,3575852269,34
3,510,4360,3575852235,3575852270,35
3,510,4361,3575852235,3575852275,40
3,510,4362,3575852235,3575852277,42
3,510,4363,3575852235,3575852278,43
3,510,4364,3575852235,3575852283,48
3,510,4365,3575852235,3575852284,49
3,510,4366,3575852235,3575852284,49
3,511,4367,3575852289,3575852289,0
3,511,4368,3575852289,3575852290,1
3,511,4369,3575852289,3575852291,2
3,511,4370,3575852289,3575852297,8
3,511,4371,3575852289,3575852298,9
3,511,4372,3575852289,3575852300,11
3,511,4373,3575852289,3575852310,21
3,511,4374,3575852289,3575852317,28
3,511,4375,3575852289,3575852318,29
3,511,4376,3575852289,3575852321,32
3,511,4377,3575852289,3575852322,33
3,511,4378,3575852289,3575852326,37
3,511,4379,3575852289,3575852334,45
3,511,4380,3575852289,3575852337,48
3,512,4381,3575852343,3575852343,0
3,512,4382,3575852343,3575852343,0
3,512,4383,3575852343,3575852344,1
3,512,4384,3575852343,3575852344,1
3,512,4385,3575852343,3575852346,3
3,512,4386,3575852343,3575852354,11
3,512,4387,3575852343,3575852359,16
3,512,4388,3575852343,3575852365,22
3,512,4389,3575852343,3575852369,26
3,512,4390,3575852343,3575852370,27
3,512,4391,3575852343,3575852371,28
3,512,4392,3575852343,3575852379,36
3,512,4393,3575852343,3575852381,38
3,512,4394,3575852343,3575852381,38
3,512,4395,3575852343,3575852381,38
3,512,4396,3575852343,3575852382,39
3,512,4397,3575852343,3575852386,43
3,512,4398,3575852343,3575852386,43
3,512,4399,3575852343,3575852387,44
3,512,4400,3575852343,3575852390,47
3,512,4401,3575852343,3575852390,47
3,512,4402,3575852343,3575852392,49
3,513,4403,3575852396,3575852396,0
3,513,4404,3575852396,3575852397,1
3,513,4405,3575852396,3575852399,3
3,513,4406,3575852396,3575852400,4
3,513,4407,3575852396,3575852400,4
3,513,4408,3575852396,3575852404,8
3,513,4409,3575852396,3575852404,8
3,513,4410,3575852396,3575852404,8
3,513,4411,3575852396,3575852407,11
3,513,4412,3575852396,3575852408,12
3,513,4413,3575852396,3575852415,19
3,513,4414,3575852396,3575852420,24
3,513,4415,3575852396,3575852421,25
3,513,4416,3575852396,3575852422,26
3,513,4417,3575852396,3575852423,27
3,513,4418,3575852396,3575852426,30
3,513,4419,3575852396,3575852427,31
3,513,4420,3575852396,3575852429,33
3,513,4421,3575852396,3575852432,36
3,513,4422,3575852396,3575852436,40
3,513,4423,3575852396,3575852437,41
3,513,4424,3575852396,3575852438,42
3,513,4425,3575852396,3575852439,43
3,513,4426,3575852396,3575852441,45
3,513,4427,3575852396,3575852441,45
3,513,4428,3575852396,3575852444,48
3,513,4429,3575852396,3575852446,50
3,514,4430,3575852449,3575852449,0
3,514,4431,3575852449,3575852450,1
3,514,4432,3575852449,3575852450,1
3,514,4433,3575852449,3575852453,4
3,514,4434,3575852449,3575852455,6
3,514,4435,3575852449,3575852455,6
3,514,4436,3575852449,3575852457,8
3,514,4437,3575852449,3575852459,10
3,514,4438,3575852449,3575852463,14
3,514,4439,3575852449,3575852464,15
3,514,4440,3575852449,3575852464,15
3,514,4441,3575852449,3575852466,17
3,514,4442,3575852449,3575852467,18
3,514,4443,3575852449,3575852469,20
3,514,4444,3575852449,3575852469,20
3,514,4445,3575852449,3575852469,20
3,514,4446,3575852449,3575852476,27
3,514,4447,3575852449,3575852477,28
3,514,4448,3575852449,3575852478,29
3,514,4449,3575852449,3575852484,35
3,514,4450,3575852449,3575852484,35
3,514,4451,3575852449,3575852484,35
3,514,4452,3575852449,3575852488,39
3,514,4453,3575852449,3575852490,41
3,514,4454,3575852449,3575852491,42
3,514,4455,3575852449,3575852497,48
3,514,4456,3575852449,3575852498,49
3,515,4457,3575852505,3575852505,0
3,515,4458,3575852505,3575852509,4
3,515,4459,3575852505,3575852517,12
3,515,4460,3575852505,3575852517,12
3,515,4461,3575852505,3575852519,14
3,515,4462,3575852505,3575852521,16
3,515,4463,3575852505,3575852526,21
3,515,4464,3575852505,3575852532,27
3,515,4465,3575852505,3575852536,31
3,515,4466,3575852505,3575852540,35
3,515,4467,3575852505,3575852542,37
3,515,4468,3575852505,3575852543,38
3,515,4469,3575852505,3575852544,39
3,515,4470,3575852505,3575852544,39
3,515,4471,3575852505,3575852553,48
3,516,4472,3575852558,3575852558,0
3,516,4473,3575852558,3575852563,5
3,516,4474,3575852558,3575852567,9
3,516,4475,3575852558,3575852569,11
3,516,4476,3575852558,3575852570,12
3,516,4477,3575852558,3575852578,20
3,516,4478,3575852558,3575852580,22
3,516,4479,3575852558,3575852580,22
3,516,4480,3575852558,3575852581,23
3,516,4481,3575852558,3575852581,23
3,516,4482,3575852558,3575852585,27
3,516,4483,3575852558,3575852585,27
3,516,4484,3575852558,3575852586,28
3,516,4485,3575852558,3575852587,29
3,516,4486,3575852558,3575852588,30
3,516,4487,3575852558,3575852589,31
3,516,4488,3575852558,3575852590,32
3,516,4489,3575852558,3575852595,37
3,516,4490,3575852558,3575852596,38
3,516,4491,3575852558,3575852598,40
3,516,4492,3575852558,3575852598,40
3,516,4493,3575852558,3575852601,43
3,516,4494,3575852558,3575852603,45
3,516,4495,3575852558,3575852603,45
3,516,4496,3575852558,3575852604,46
3,516,4497,3575852558,3575852606,48
3,516,4498,3575852558,3575852607,49
3,517,4499,3575852611,3575852616,5
3,517,4500,3575852611,3575852619,8
3,517,4501,3575852611,3575852620,9
3,517,4502,3575852611,3575852621,10
3,517,4503,3575852611,3575852622,11
3,517,4504,3575852611,3575852625,14
3,517,4505,3575852611,3575852626,15
3,517,4506,3575852611,3575852629,18
3,517,4507,3575852611,3575852632,21
3,517,4508,3575852611,3575852635,24
3,517,4509,3575852611,3575852637,26
3,517,4510,3575852611,3575852638,27
3,517,4511,3575852611,3575852638,27
3,517,4512,3575852611,3575852640,29
3,517,4513,3575852611,3575852640,29
3,517,4514,3575852611,3575852643,32
3,517,4515,3575852611,3575852645,34
3,517,4516,3575852611,3575852647,36
3,517,4517,3575852611,3575852649,38
3,517,4518,3575852611,3575852650,39
3,517,4519,3575852611,3575852652,41
3,517,4520,3575852611,3575852654,43
3,517,4521,3575852611,3575852654,43
3,517,4522,3575852611,3575852658,47
3,518,4523,3575852664,3575852664,0
3,518,4524,3575852664,3575852664,0
3,518,4525,3575852664,3575852664,0
3,518,4526,3575852664,3575852666,2
3,518,4527,3575852664,3575852666,2
3,518,4528,3575852664,3575852668,4
3,518,4529,3575852664,3575852668,4
3,518,4530,3575852664,3575852669,5
3,518,4531,3575852664,3575852676,12
3,518,4532,3575852664,3575852677,13
3,518,4533,3575852664,3575852678,14
3,518,4534,3575852664,3575852683,19
3,518,4535,3575852664,3575852684,20
3,518,4536,3575852664,3575852684,20
3,518,4537,3575852664,3575852688,24
3,518,4538,3575852664,3575852689,25
3,518,4539,3575852664,3575852698,34
3,518,4540,3575852664,3575852698,34
3,518,4541,3575852664,3575852700,36
3,518,4542,3575852664,3575852709,45
3,519,4543,3575852717,3575852717,0
3,519,4544,3575852717,3575852717,0
3,519,4545,3575852717,3575852720,3
3,519,4546,3575852717,3575852721,4
3,519,4547,3575852717,3575852726,9
3,519,4548,3575852717,3575852733,16
3,519,4549,3575852717,3575852736,19
3,519,4550,3575852717,3575852740,23
3,519,4551,3575852717,3575852742,25
3,519,4552,3575852717,3575852743,26
3,519,4553,3575852717,3575852743,26
3,519,4554,3575852717,3575852745,28
3,519,4555,3575852717,3575852745,28
3,519,4556,3575852717,3575852754,37
3,519,4557,3575852717,3575852758,41
3,519,4558,3575852717,3575852760,43
3,519,4559,3575852717,3575852763,46
3,519,4560,3575852717,3575852767,50
3,520,4561,3575852771,3575852771,0
3,520,4562,3575852771,3575852771,0
3,520,4563,3575852771,3575852778,7
3,520,4564,3575852771,3575852780,9
3,520,4565,3575852771,3575852780,9
3,520,4566,3575852771,3575852781,10
3,520,4567,3575852771,3575852781,10
3,520,4568,3575852771,3575852785,14
3,520,4569,3575852771,3575852785,14
3,520,4570,3575852771,3575852786,15
3,520,4571,3575852771,3575852787,16
3,520,4572,3575852771,3575852788,17
3,520,4573,3575852771,3575852790,19
3,520,4574,3575852771,3575852791,20
3,520,4575,3575852771,3575852795,24
3,520,4576,3575852771,3575852796,25
3,520,4577,3575852771,3575852798,27
3,520,4578,3575852771,3575852798,27
3,520,4579,3575852771,3575852801,30
3,520,4580,3575852771,3575852804,33
3,520,4581,3575852771,3575852805,34
3,520,4582,3575852771,3575852806,35
3,520,4583,3575852771,3575852806,35
3,520,4584,3575852771,3575852816,45
3,520,4585,3575852771,3575852819,48
3,520,4586,3575852771,3575852820,49
3,520,4587,3575852771,3575852821,50
3,521,4588,3575852825,3575852825,0
3,521,4589,3575852825,3575852825,0
3,521,4590,3575852825,3575852826,1
3,521,4591,3575852825,3575852829,4
3,521,4592,3575852825,3575852831,6
3,521,4593,3575852825,3575852836,11
3,521,4594,3575852825,3575852837,12
3,521,4595,3575852825,3575852838,13
3,521,4596,3575852825,3575852838,13
3,521,4597,3575852825,3575852839,14
3,521,4598,3575852825,3575852841,16
3,521,4599,3575852825,3575852843,18
3,521,4600,3575852825,3575852845,20
3,521,4601,3575852825,3575852847,22
3,521,4602,3575852825,3575852849,24
3,521,4603,3575852825,3575852850,25
3,521,4604,3575852825,3575852852,27
3,521,4605,3575852825,3575852854,29
3,521,4606,3575852825,3575852854,29
3,521,4607,3575852825,3575852856,31
3,521,4608,3575852825,3575852858,33
3,521,4609,3575852825,3575852861,36
3,521,4610,3575852825,3575852863,38
3,521,4611,3575852825,3575852864,39
3,521,4612,3575852825,3575852867,42
3,521,4613,3575852825,3575852867,42
3,521,4614,3575852825,3575852868,43
3,521,4615,3575852825,3575852868,43
3,521,4616,3575852825,3575852869,44
3,522,4617,3575852880,3575852880,0
3,522,4618,3575852880,3575852880,0
3,522,4619,3575852880,3575852880,0
3,522,4620,3575852880,3575852884,4
3,522,4621,3575852880,3575852884,4
3,522,4622,3575852880,3575852885,5
3,522,4623,3575852880,3575852888,8
3,522,4624,3575852880,3575852889,9
3,522,4625,3575852880,3575852898,18
3,522,4626,3575852880,3575852898,18
3,522,4627,3575852880,3575852901,21
3,522,4628,3575852880,3575852909,29
3,522,4629,3575852880,3575852917,37
3,522,4630,3575852880,3575852917,37
3,522,4631,3575852880,3575852920,40
3,522,4632,3575852880,3575852921,41
3,522,4633,3575852880,3575852927,47
3,523,4634,3575852934,3575852934,0
3,523,4635,3575852934,3575852937,3
3,523,4636,3575852934,3575852941,7
3,523,4637,3575852934,3575852943,9
3,523,4638,3575852934,3575852943,9
3,523,4639,3575852934,3575852944,10
3,523,4640,3575852934,3575852945,11
3,523,4641,3575852934,3575852946,12
3,523,4642,3575852934,3575852955,21
3,523,4643,3575852934,3575852958,24
3,523,4644,3575852934,3575852960,26
3,523,4645,3575852934,3575852963,29
3,523,4646,3575852934,3575852967,33
3,523,4647,3575852934,3575852970,36
3,523,4648,3575852934,3575852970,36
3,523,4649,3575852934,3575852978,44
3,523,4650,3575852934,3575852981,47
3,523,4651,3575852934,3575852981,47
3,523,4652,3575852934,3575852981,47
3,523,4653,3575852934,3575852982,48
3,524,4654,3575852987,3575852987,0
3,524,4655,3575852987,3575852987,0
3,524,4656,3575852987,3575852987,0
3,524,4657,3575852987,3575852987,0
3,524,4658,3575852987,3575852988,1
3,524,4659,3575852987,3575852989,2
3,524,4660,3575852987,3575852992,5
3,524,4661,3575852987,3575852995,8
3,524,4662,3575852987,3575852997,10
3,524,4663,3575852987,3575852998,11
3,524,4664,3575852987,3575852998,11
3,524,4665,3575852987,3575853001,14
3,524,4666,3575852987,3575853003,16
3,524,4667,3575852987,3575853005,18
3,524,4668,3575852987,3575853006,19
3,524,4669,3575852987,3575853007,20
3,524,4670,3575852987,3575853016,29
3,524,4671,3575852987,3575853019,32
3,524,4672,3575852987,3575853020,33
3,524,4673,3575852987,3575853022,35
3,524,4674,3575852987,3575853022,35
3,524,4675,3575852987,3575853025,38
3,524,4676,3575852987,3575853026,39
3,524,4677,3575852987,3575853029,42
3,524,4678,3575852987,3575853032,45
3,524,4679,3575852987,3575853036,49
3,524,4680,3575852987,3575853037,50
3,525,4681,3575853041,3575853041,0
3,525,4682,3575853041,3575853041,0
3,525,4683,3575853041,3575853041,0
3,525,4684,3575853041,3575853041,0
3,525,4685,3575853041,3575853044,3
3,525,4686,3575853041,3575853044,3
3,525,4687,3575853041,3575853045,4
3,525,4688,3575853041,3575853047,6
3,525,4689,3575853041,3575853048,7
3,525,4690,3575853041,3575853052,11
3,525,4691,3575853041,3575853052,11
3,525,4692,3575853041,3575853054,13
3,525,4693,3575853041,3575853055,14
3,525,4694,3575853041,3575853059,18
3,525,4695,3575853041,3575853061,20
3,525,4696,3575853041,3575853063,22
3,525,4697,3575853041,3575853064,23
3,525,4698,3575853041,3575853066,25
3,525,4699,3575853041,3575853067,26
3,525,4700,3575853041,3575853068,27
3,525,4701,3575853041,3575853069,28
3,525,4702,3575853041,3575853069,28
3,525,4703,3575853041,3575853077,36
3,525,4704,3575853041,3575853078,37
3,525,4705,3575853041,3575853078,37
3,525,4706,3575853041,3575853084,43
3,525,4707,3575853041,3575853084,43
3,525,4708,3575853041,3575853084,43
3,525,4709,3575853041,3575853088,47
3,525,4710,3575853041,3575853089,48
3,526,4711,3575853095,3575853098,3
3,526,4712,3575853095,3575853098,3
3,526,4713,3575853095,3575853101,6
3,526,4714,3575853095,3575853108,13
3,526,4715,3575853095,3575853117,22
3,526,4716,3575853095,3575853117,22
3,526,4717,3575853095,3575853120,25
3,526,4718,3575853095,3575853121,26
3,526,4719,3575853095,3575853128,33
3,526,4720,3575853095,3575853134,39
3,526,4721,3575853095,3575853137,42
3,526,4722,3575853095,3575853140,45
3,526,4723,3575853095,3575853143,48
3,526,4724,3575853095,3575853143,48
3,526,4725,3575853095,3575853144,49
3,527,4726,3575853149,3575853149,0
3,527,4727,3575853149,3575853155,6
3,527,4728,3575853149,3575853159,10
3,527,4729,3575853149,3575853161,12
3,527,4730,3575853149,3575853164,15
3,527,4731,3575853149,3575853168,19
3,527,4732,3575853149,3575853170,21
3,527,4733,3575853149,3575853171,22
3,527,4734,3575853149,3575853181,32
3,527,4735,3575853149,3575853181,32
3,527,4736,3575853149,3575853182,33
3,527,4737,3575853149,3575853185,36
3,527,4738,3575853149,3575853187,38
3,527,4739,3575853149,3575853187,38
3,527,4740,3575853149,3575853187,38
3,527,4741,3575853149,3575853189,40
3,527,4742,3575853149,3575853189,40
3,527,4743,3575853149,3575853192,43
3,527,4744,3575853149,3575853195,46
3,527,4745,3575853149,3575853197,48
3,527,4746,3575853149,3575853198,49
3,527,4747,3575853149,3575853198,49
3,527,4748,3575853149,3575853198,49
3,528,4749,3575853204,3575853204,0
3,528,4750,3575853204,3575853204,0
3,528,4751,3575853204,3575853204,0
3,528,4752,3575853204,3575853205,1
3,528,4753,3575853204,3575853207,3
3,528,4754,3575853204,3575853208,4
3,528,4755,3575853204,3575853216,12
3,528,4756,3575853204,3575853219,15
3,528,4757,3575853204,3575853221,17
3,528,4758,3575853204,3575853223,19
3,528,4759,3575853204,3575853225,21
3,528,4760,3575853204,3575853226,22
3,528,4761,3575853204,3575853228,24
3,528,4762,3575853204,3575853232,28
3,528,4763,3575853204,3575853236,32
3,528,4764,3575853204,3575853237,33
3,528,4765,3575853204,3575853238,34
3,528,4766,3575853204,3575853238,34
3,528,4767,3575853204,3575853240,36
3,528,4768,3575853204,3575853241,37
3,528,4769,3575853204,3575853244,40
3,528,4770,3575853204,3575853244,40
3,528,4771,3575853204,3575853246,42
3,528,4772,3575853204,3575853248,44
3,528,4773,3575853204,3575853248,44
3,528,4774,3575853204,3575853252,48
3,528,4775,3575853204,3575853252,48
3,529,4776,3575853258,3575853258,0
3,529,4777,3575853258,3575853258,0
3,529,4778,3575853258,3575853259,1
3,529,4779,3575853258,3575853263,5
3,529,4780,3575853258,3575853264,6
3,529,4781,3575853258,3575853264,6
3,529,4782,3575853258,3575853266,8
3,529,4783,3575853258,3575853267,9
3,529,4784,3575853258,3575853269,11
3,529,4785,3575853258,3575853269,11
3,529,4786,3575853258,3575853270,12
3,529,4787,3575853258,3575853277,19
3,529,4788,3575853258,3575853278,20
3,529,4789,3575853258,3575853278,20
3,529,4790,3575853258,3575853283,25
3,529,4791,3575853258,3575853284,26
3,529,4792,3575853258,3575853285,27
3,529,4793,3575853258,3575853288,30
3,529,4794,3575853258,3575853290,32
3,529,4795,3575853258,3575853298,40
3,529,4796,3575853258,3575853299,41
3,529,4797,3575853258,3575853301,43
3,530,4798,3575853312,3575853312,0
3,530,4799,3575853312,3575853317,5
3,530,4800,3575853312,3575853317,5
3,530,4801,3575853312,3575853321,9
3,530,4802,3575853312,3575853322,10
3,530,4803,3575853312,3575853328,16
3,530,4804,3575853312,3575853334,22
3,530,4805,3575853312,3575853337,25
3,530,4806,3575853312,3575853340,28
3,530,4807,3575853312,3575853343,31
3,530,4808,3575853312,3575853344,32
3,530,4809,3575853312,3575853344,32
3,530,4810,3575853312,3575853345,33
3,530,4811,3575853312,3575853355,43
3,530,4812,3575853312,3575853359,47
3,530,4813,3575853312,3575853361,49
3,531,4814,3575853367,3575853367,0
3,531,4815,3575853367,3575853368,1
3,531,4816,3575853367,3575853371,4
3,531,4817,3575853367,3575853371,4
3,531,4818,3575853367,3575853378,11
3,531,4819,3575853367,3575853381,14
3,531,4820,3575853367,3575853381,14
3,531,4821,3575853367,3575853382,15
3,531,4822,3575853367,3575853385,18
3,531,4823,3575853367,3575853386,19
3,531,4824,3575853367,3575853387,20
3,531,4825,3575853367,3575853387,20
3,531,4826,3575853367,3575853389,22
3,531,4827,3575853367,3575853390,23
3,531,4828,3575853367,3575853392,25
3,531,4829,3575853367,3575853395,28
3,531,4830,3575853367,3575853397,30
3,531,4831,3575853367,3575853398,31
3,531,4832,3575853367,3575853399,32
3,531,4833,3575853367,3575853399,32
3,531,4834,3575853367,3575853401,34
3,531,4835,3575853367,3575853403,36
3,531,4836,3575853367,3575853403,36
3,531,4837,3575853367,3575853405,38
3,531,4838,3575853367,3575853407,40
3,531,4839,3575853367,3575853407,40
3,531,4840,3575853367,3575853416,49
3,532,4841,3575853422,3575853422,0
3,532,4842,3575853422,3575853422,0
3,532,4843,3575853422,3575853422,0
3,532,4844,3575853422,3575853425,3
3,532,4845,3575853422,3575853427,5
3,532,4846,3575853422,3575853429,7
3,532,4847,3575853422,3575853431,9
3,532,4848,3575853422,3575853436,14
3,532,4849,3575853422,3575853437,15
3,532,4850,3575853422,3575853438,16
3,532,4851,3575853422,3575853438,16
3,532,4852,3575853422,3575853441,19
3,532,4853,3575853422,3575853441,19
3,532,4854,3575853422,3575853444,22
3,532,4855,3575853422,3575853445,23
3,532,4856,3575853422,3575853446,24
3,532,4857,3575853422,3575853448,26
3,532,4858,3575853422,3575853450,28
3,532,4859,3575853422,3575853450,28
3,532,4860,3575853422,3575853453,31
3,532,4861,3575853422,3575853453,31
3,532,4862,3575853422,3575853455,33
3,532,4863,3575853422,3575853459,37
3,532,4864,3575853422,3575853462,40
3,532,4865,3575853422,3575853463,41
3,532,4866,3575853422,3575853465,43
3,532,4867,3575853422,3575853466,44
3,532,4868,3575853422,3575853467,45
3,532,4869,3575853422,3575853469,47
3,532,4870,3575853422,3575853469,47
3,532,4871,3575853422,3575853469,47
3,533,4872,3575853476,3575853476,0
3,533,4873,3575853476,3575853477,1
3,533,4874,3575853476,3575853477,1
3,533,4875,3575853476,3575853483,7
3,533,4876,3575853476,3575853483,7
3,533,4877,3575853476,3575853487,11
3,533,4878,3575853476,3575853489,13
3,533,4879,3575853476,3575853497,21
3,533,4880,3575853476,3575853497,21
3,533,4881,3575853476,3575853500,24
3,533,4882,3575853476,3575853500,24
3,533,4883,3575853476,3575853507,31
3,533,4884,3575853476,3575853516,40
3,533,4885,3575853476,3575853516,40
3,533,4886,3575853476,3575853520,44
3,533,4887,3575853476,3575853520,44
3,534,4888,3575853530,3575853530,0
3,534,4889,3575853530,3575853533,3
3,534,4890,3575853530,3575853536,6
3,534,4891,3575853530,3575853539,9
3,534,4892,3575853530,3575853542,12
3,534,4893,3575853530,3575853543,13
3,534,4894,3575853530,3575853543,13
3,534,4895,3575853530,3575853545,15
3,534,4896,3575853530,3575853545,15
3,534,4897,3575853530,3575853552,22
3,534,4898,3575853530,3575853554,24
3,534,4899,3575853530,3575853559,29
3,534,4900,3575853530,3575853560,30
3,534,4901,3575853530,3575853564,34
3,534,4902,3575853530,3575853567,37
3,534,4903,3575853530,3575853570,40
3,534,4904,3575853530,3575853570,40
3,534,4905,3575853530,3575853577,47
3,535,4906,3575853584,3575853584,0
3,535,4907,3575853584,3575853584,0
3,535,4908,3575853584,3575853584,0
3,535,4909,3575853584,3575853584,0
3,535,4910,3575853584,3575853585,1
3,535,4911,3575853584,3575853586,2
3,535,4912,3575853584,3575853587,3
3,535,4913,3575853584,3575853588,4
3,535,4914,3575853584,3575853588,4
3,535,4915,3575853584,3575853591,7
3,535,4916,3575853584,3575853595,11
3,535,4917,3575853584,3575853596,12
3,535,4918,3575853584,3575853597,13
3,535,4919,3575853584,3575853598,14
3,535,4920,3575853584,3575853599,15
3,535,4921,3575853584,3575853601,17
3,535,4922,3575853584,3575853602,18
3,535,4923,3575853584,3575853603,19
3,535,4924,3575853584,3575853606,22
3,535,4925,3575853584,3575853607,23
3,535,4926,3575853584,3575853615,31
3,535,4927,3575853584,3575853619,35
3,535,4928,3575853584,3575853619,35
3,535,4929,3575853584,3575853621,37
3,535,4930,3575853584,3575853622,38
3,535,4931,3575853584,3575853625,41
3,535,4932,3575853584,3575853626,42
3,535,4933,3575853584,3575853627,43
3,535,4934,3575853584,3575853631,47
3,536,4935,3575853637,3575853637,0
3,536,4936,3575853637,3575853637,0
3,536,4937,3575853637,3575853637,0
3,536,4938,3575853637,3575853638,1
3,536,4939,3575853637,3575853639,2
3,536,4940,3575853637,3575853640,3
3,536,4941,3575853637,3575853642,5
3,536,4942,3575853637,3575853643,6
3,536,4943,3575853637,3575853645,8
3,536,4944,3575853637,3575853647,10
3,536,4945,3575853637,3575853649,12
3,536,4946,3575853637,3575853650,13
3,536,4947,3575853637,3575853652,15
3,536,4948,3575853637,3575853652,15
3,536,4949,3575853637,3575853654,17
3,536,4950,3575853637,3575853654,17
3,536,4951,3575853637,3575853656,19
3,536,4952,3575853637,3575853658,21
3,536,4953,3575853637,3575853663,26
3,536,4954,3575853637,3575853664,27
3,536,4955,3575853637,3575853666,29
3,536,4956,3575853637,3575853666,29
3,536,4957,3575853637,3575853668,31
3,536,4958,3575853637,3575853668,31
3,536,4959,3575853637,3575853669,32
3,536,4960,3575853637,3575853676,39
3,536,4961,3575853637,3575853677,40
3,536,4962,3575853637,3575853677,40
3,536,4963,3575853637,3575853683,46
3,536,4964,3575853637,3575853684,47
3,537,4965,3575853691,3575853691,0
3,537,4966,3575853691,3575853691,0
3,537,4967,3575853691,3575853697,6
3,537,4968,3575853691,3575853698,7
3,537,4969,3575853691,3575853700,9
3,537,4970,3575853691,3575853700,9
3,537,4971,3575853691,3575853708,17
3,537,4972,3575853691,3575853716,25
3,537,4973,3575853691,3575853716,25
3,537,4974,3575853691,3575853720,29
3,537,4975,3575853691,3575853721,30
3,537,4976,3575853691,3575853727,36
3,537,4977,3575853691,3575853733,42
3,537,4978,3575853691,3575853736,45
3,538,4979,3575853744,3575853745,1
3,538,4980,3575853744,3575853745,1
3,538,4981,3575853744,3575853745,1
3,538,4982,3575853744,3575853745,1
3,538,4983,3575853744,3575853745,1
3,538,4984,3575853744,3575853745,1
3,538,4985,3575853744,3575853752,8
3,538,4986,3575853744,3575853754,10
3,538,4987,3575853744,3575853758,14
3,538,4988,3575853744,3575853760,16
3,538,4989,3575853744,3575853764,20
3,538,4990,3575853744,3575853767,23
3,538,4991,3575853744,3575853769,25
3,538,4992,3575853744,3575853770,26
3,538,4993,3575853744,3575853778,34
3,538,4994,3575853744,3575853779,35
3,538,4995,3575853744,3575853780,36
3,538,4996,3575853744,3575853781,37
3,538,4997,3575853744,3575853781,37
3,538,4998,3575853744,3575853784,40
3,538,4999,3575853744,3575853785,41
3,538,5000,3575853744,3575853786,42
3,538,5001,3575853744,3575853786,42
3,538,5002,3575853744,3575853788,44
3,538,5003,3575853744,3575853788,44
3,538,5004,3575853744,3575853792,48
3,539,5005,3575853798,3575853798,0
3,539,5006,3575853798,3575853798,0
3,539,5007,3575853798,3575853799,1
3,539,5008,3575853798,3575853799,1
3,539,5009,3575853798,3575853801,3
3,539,5010,3575853798,3575853802,4
3,539,5011,3575853798,3575853804,6
3,539,5012,3575853798,3575853805,7
3,539,5013,3575853798,3575853806,8
3,539,5014,3575853798,3575853806,8
3,539,5015,3575853798,3575853816,18
3,539,5016,3575853798,3575853820,22
3,539,5017,3575853798,3575853820,22
3,539,5018,3575853798,3575853821,23
3,539,5019,3575853798,3575853821,23
3,539,5020,3575853798,3575853825,27
3,539,5021,3575853798,3575853826,28
3,539,5022,3575853798,3575853829,31
3,539,5023,3575853798,3575853831,33
3,539,5024,3575853798,3575853835,37
3,539,5025,3575853798,3575853837,39
3,539,5026,3575853798,3575853837,39
3,539,5027,3575853798,3575853838,40
3,539,5028,3575853798,3575853840,42
3,539,5029,3575853798,3575853841,43
3,539,5030,3575853798,3575853842,44
3,539,5031,3575853798,3575853843,45
3,539,5032,3575853798,3575853845,47
3,539,5033,3575853798,3575853847,49
3,540,5034,3575853852,3575853852,0
3,540,5035,3575853852,3575853852,0
3,540,5036,3575853852,3575853852,0
3,540,5037,3575853852,3575853853,1
3,540,5038,3575853852,3575853854,2
3,540,5039,3575853852,3575853855,3
3,540,5040,3575853852,3575853855,3
3,540,5041,3575853852,3575853856,4
3,540,5042,3575853852,3575853858,6
3,540,5043,3575853852,3575853864,12
3,540,5044,3575853852,3575853864,12
3,540,5045,3575853852,3575853866,14
3,540,5046,3575853852,3575853867,15
3,540,5047,3575853852,3575853868,16
3,540,5048,3575853852,3575853869,17
3,540,5049,3575853852,3575853869,17
3,540,5050,3575853852,3575853876,24
3,540,5051,3575853852,3575853877,25
3,540,5052,3575853852,3575853878,26
3,540,5053,3575853852,3575853883,31
3,540,5054,3575853852,3575853883,31
3,540,5055,3575853852,3575853884,32
3,540,5056,3575853852,3575853887,35
3,540,5057,3575853852,3575853889,37
3,540,5058,3575853852,3575853897,45
3,540,5059,3575853852,3575853898,46
3,540,5060,3575853852,3575853900,48
3,540,5061,3575853852,3575853900,48
3,541,5062,3575853906,3575853908,2
3,541,5063,3575853906,3575853909,3
3,541,5064,3575853906,3575853916,10
3,541,5065,3575853906,3575853917,11
3,541,5066,3575853906,3575853920,14
3,541,5067,3575853906,3575853927,21
3,541,5068,3575853906,3575853933,27
3,541,5069,3575853906,3575853937,31
3,541,5070,3575853906,3575853941,35
3,541,5071,3575853906,3575853943,37
3,541,5072,3575853906,3575853943,37
3,541,5073,3575853906,3575853944,38
3,541,5074,3575853906,3575853946,40
3,541,5075,3575853906,3575853946,40
3,541,5076,3575853906,3575853952,46
3,541,5077,3575853906,3575853954,48
3,542,5078,3575853960,3575853960,0
3,542,5079,3575853960,3575853960,0
3,542,5080,3575853960,3575853964,4
3,542,5081,3575853960,3575853967,7
3,542,5082,3575853960,3575853969,9
3,542,5083,3575853960,3575853970,10
3,542,5084,3575853960,3575853979,19
3,542,5085,3575853960,3575853981,21
3,542,5086,3575853960,3575853981,21
3,542,5087,3575853960,3575853981,21
3,542,5088,3575853960,3575853982,22
3,542,5089,3575853960,3575853984,24
3,542,5090,3575853960,3575853985,25
3,542,5091,3575853960,3575853986,26
3,542,5092,3575853960,3575853987,27
3,542,5093,3575853960,3575853989,29
3,542,5094,3575853960,3575853989,29
3,542,5095,3575853960,3575853991,31
3,542,5096,3575853960,3575853995,35
3,542,5097,3575853960,3575853998,38
3,542,5098,3575853960,3575853998,38
3,542,5099,3575853960,3575853999,39
3,542,5100,3575853960,3575854000,40
3,542,5101,3575853960,3575854003,43
3,542,5102,3575853960,3575854004,44
3,542,5103,3575853960,3575854005,45
3,542,5104,3575853960,3575854006,46
3,542,5105,3575853960,3575854008,48
3,543,5106,3575854014,3575854015,1
3,543,5107,3575854014,3575854019,5
3,543,5108,3575854014,3575854021,7
3,543,5109,3575854014,3575854021,7
3,543,5110,3575854014,3575854021,7
3,543,5111,3575854014,3575854025,11
3,543,5112,3575854014,3575854026,12
3,543,5113,3575854014,3575854029,15
3,543,5114,3575854014,3575854031,17
3,543,5115,3575854014,3575854036,22
3,543,5116,3575854014,3575854038,24
3,543,5117,3575854014,3575854038,24
3,543,5118,3575854014,3575854039,25
3,543,5119,3575854014,3575854039,25
3,543,5120,3575854014,3575854041,27
3,543,5121,3575854014,3575854044,30
3,543,5122,3575854014,3575854044,30
3,543,5123,3575854014,3575854045,31
3,543,5124,3575854014,3575854047,33
3,543,5125,3575854014,3575854049,35
3,543,5126,3575854014,3575854050,36
3,543,5127,3575854014,3575854052,38
3,543,5128,3575854014,3575854053,39
3,543,5129,3575854014,3575854054,40
3,543,5130,3575854014,3575854055,41
3,543,5131,3575854014,3575854056,42
3,543,5132,3575854014,3575854057,43
3,543,5133,3575854014,3575854058,44
3,543,5134,3575854014,3575854061,47
3,543,5135,3575854014,3575854063,49
3,544,5136,3575854069,3575854069,0
3,544,5137,3575854069,3575854069,0
3,544,5138,3575854069,3575854069,0
3,544,5139,3575854069,3575854069,0
3,544,5140,3575854069,3575854069,0
3,544,5141,3575854069,3575854069,0
3,544,5142,3575854069,3575854076,7
3,544,5143,3575854069,3575854077,8
3,544,5144,3575854069,3575854077,8
3,544,5145,3575854069,3575854083,14
3,544,5146,3575854069,3575854083,14
3,544,5147,3575854069,3575854083,14
3,544,5148,3575854069,3575854090,21
3,544,5149,3575854069,3575854097,28
3,544,5150,3575854069,3575854098,29
3,544,5151,3575854069,3575854100,31
3,544,5152,3575854069,3575854100,31
3,544,5153,3575854069,3575854108,39
3,544,5154,3575854069,3575854108,39
3,544,5155,3575854069,3575854117,48
3,544,5156,3575854069,3575854117,48
3,545,5157,3575854123,3575854123,0
3,545,5158,3575854123,3575854123,0
3,545,5159,3575854123,3575854126,3
3,545,5160,3575854123,3575854137,14
3,545,5161,3575854123,3575854141,18
3,545,5162,3575854123,3575854143,20
3,545,5163,3575854123,3575854143,20
3,545,5164,3575854123,3575854144,21
3,545,5165,3575854123,3575854145,22
3,545,5166,3575854123,3575854146,23
3,545,5167,3575854123,3575854152,29
3,545,5168,3575854123,3575854154,31
3,545,5169,3575854123,3575854159,36
3,545,5170,3575854123,3575854161,38
3,545,5171,3575854123,3575854164,41
3,545,5172,3575854123,3575854168,45
3,545,5173,3575854123,3575854170,47
3,545,5174,3575854123,3575854171,48
3,546,5175,3575854177,3575854179,2
3,546,5176,3575854177,3575854181,4
3,546,5177,3575854177,3575854181,4
3,546,5178,3575854177,3575854181,4
3,546,5179,3575854177,3575854182,5
3,546,5180,3575854177,3575854184,7
3,546,5181,3575854177,3575854185,8
3,546,5182,3575854177,3575854186,9
3,546,5183,3575854177,3575854187,10
3,546,5184,3575854177,3575854189,12
3,546,5185,3575854177,3575854189,12
3,546,5186,3575854177,3575854192,15
3,546,5187,3575854177,3575854195,18
3,546,5188,3575854177,3575854197,20
3,546,5189,3575854177,3575854198,21
3,546,5190,3575854177,3575854198,21
3,546,5191,3575854177,3575854200,23
3,546,5192,3575854177,3575854201,24
3,546,5193,3575854177,3575854203,26
3,546,5194,3575854177,3575854204,27
3,546,5195,3575854177,3575854205,28
3,546,5196,3575854177,3575854206,29
3,546,5197,3575854177,3575854207,30
3,546,5198,3575854177,3575854213,36
3,546,5199,3575854177,3575854216,39
3,546,5200,3575854177,3575854219,42
3,546,5201,3575854177,3575854221,44
3,546,5202,3575854177,3575854221,44
3,546,5203,3575854177,3575854222,45
3,546,5204,3575854177,3575854225,48
3,546,5205,3575854177,3575854226,49
3,547,5206,3575854234,3575854234,0
3,547,5207,3575854234,3575854234,0
3,547,5208,3575854234,3575854236,2
3,547,5209,3575854234,3575854237,3
3,547,5210,3575854234,3575854238,4
3,547,5211,3575854234,3575854239,5
3,547,5212,3575854234,3575854240,6
3,547,5213,3575854234,3575854241,7
3,547,5214,3575854234,3575854243,9
3,547,5215,3575854234,3575854244,10
3,547,5216,3575854234,3575854246,12
3,547,5217,3575854234,3575854248,14
3,547,5218,3575854234,3575854249,15
3,547,5219,3575854234,3575854249,15
3,547,5220,3575854234,3575854252,18
3,547,5221,3575854234,3575854253,19
3,547,5222,3575854234,3575854254,20
3,547,5223,3575854234,3575854255,21
3,547,5224,3575854234,3575854255,21
3,547,5225,3575854234,3575854257,23
3,547,5226,3575854234,3575854260,26
3,547,5227,3575854234,3575854260,26
3,547,5228,3575854234,3575854263,29
3,547,5229,3575854234,3575854264,30
3,547,5230,3575854234,3575854265,31
3,547,5231,3575854234,3575854265,31
3,547,5232,3575854234,3575854266,32
3,547,5233,3575854234,3575854267,33
3,547,5234,3575854234,3575854269,35
3,547,5235,3575854234,3575854269,35
3,547,5236,3575854234,3575854269,35
3,547,5237,3575854234,3575854276,42
3,547,5238,3575854234,3575854277,43
3,547,5239,3575854234,3575854278,44
3,547,5240,3575854234,3575854283,49
3,547,5241,3575854234,3575854283,49
3,547,5242,3575854234,3575854283,49
3,548,5243,3575854288,3575854289,1
3,548,5244,3575854288,3575854290,2
3,548,5245,3575854288,3575854297,9
3,548,5246,3575854288,3575854298,10
3,548,5247,3575854288,3575854300,12
3,548,5248,3575854288,3575854300,12
3,548,5249,3575854288,3575854308,20
3,548,5250,3575854288,3575854309,21
3,548,5251,3575854288,3575854314,26
3,548,5252,3575854288,3575854317,29
3,548,5253,3575854288,3575854317,29
3,548,5254,3575854288,3575854320,32
3,548,5255,3575854288,3575854321,33
3,548,5256,3575854288,3575854327,39
3,548,5257,3575854288,3575854337,49
3,549,5258,3575854342,3575854342,0
3,549,5259,3575854342,3575854343,1
3,549,5260,3575854342,3575854344,2
3,549,5261,3575854342,3575854344,2
3,549,5262,3575854342,3575854346,4
3,549,5263,3575854342,3575854346,4
3,549,5264,3575854342,3575854352,10
3,549,5265,3575854342,3575854354,12
3,549,5266,3575854342,3575854360,18
3,549,5267,3575854342,3575854361,19
3,549,5268,3575854342,3575854364,22
3,549,5269,3575854342,3575854368,26
3,549,5270,3575854342,3575854371,29
3,549,5271,3575854342,3575854371,29
3,549,5272,3575854342,3575854379,37
3,549,5273,3575854342,3575854381,39
3,549,5274,3575854342,3575854381,39
3,549,5275,3575854342,3575854381,39
3,549,5276,3575854342,3575854382,40
3,549,5277,3575854342,3575854385,43
3,549,5278,3575854342,3575854385,43
3,549,5279,3575854342,3575854387,45
3,549,5280,3575854342,3575854387,45
3,549,5281,3575854342,3575854388,46
3,549,5282,3575854342,3575854389,47
3,549,5283,3575854342,3575854391,49
3,550,5284,3575854396,3575854396,0
3,550,5285,3575854396,3575854399,3
3,550,5286,3575854396,3575854399,3
3,550,5287,3575854396,3575854400,4
3,550,5288,3575854396,3575854400,4
3,550,5289,3575854396,3575854403,7
3,550,5290,3575854396,3575854404,8
3,550,5291,3575854396,3575854405,9
3,550,5292,3575854396,3575854407,11
3,550,5293,3575854396,3575854407,11
3,550,5294,3575854396,3575854413,17
3,550,5295,3575854396,3575854415,19
3,550,5296,3575854396,3575854417,21
3,550,5297,3575854396,3575854419,23
3,550,5298,3575854396,3575854421,25
3,550,5299,3575854396,3575854421,25
3,550,5300,3575854396,3575854422,26
3,550,5301,3575854396,3575854426,30
3,550,5302,3575854396,3575854427,31
3,550,5303,3575854396,3575854429,33
3,550,5304,3575854396,3575854432,36
3,550,5305,3575854396,3575854436,40
3,550,5306,3575854396,3575854438,42
3,550,5307,3575854396,3575854438,42
3,550,5308,3575854396,3575854440,44
3,550,5309,3575854396,3575854441,45
3,550,5310,3575854396,3575854441,45
3,550,5311,3575854396,3575854443,47
3,550,5312,3575854396,3575854444,48
3,551,5313,3575854450,3575854450,0
3,551,5314,3575854450,3575854450,0
3,551,5315,3575854450,3575854450,0
3,551,5316,3575854450,3575854450,0
3,551,5317,3575854450,3575854453,3
3,551,5318,3575854450,3575854453,3
3,551,5319,3575854450,3575854454,4
3,551,5320,3575854450,3575854454,4
3,551,5321,3575854450,3575854456,6
3,551,5322,3575854450,3575854457,7
3,551,5323,3575854450,3575854460,10
3,551,5324,3575854450,3575854461,11
3,551,5325,3575854450,3575854462,12
3,551,5326,3575854450,3575854464,14
3,551,5327,3575854450,3575854464,14
3,551,5328,3575854450,3575854464,14
3,551,5329,3575854450,3575854466,16
3,551,5330,3575854450,3575854467,17
3,551,5331,3575854450,3575854468,18
3,551,5332,3575854450,3575854469,19
3,551,5333,3575854450,3575854470,20
3,551,5334,3575854450,3575854476,26
3,551,5335,3575854450,3575854478,28
3,551,5336,3575854450,3575854483,33
3,551,5337,3575854450,3575854483,33
3,551,5338,3575854450,3575854489,39
3,551,5339,3575854450,3575854489,39
3,551,5340,3575854450,3575854498,48
3,551,5341,3575854450,3575854498,48
3,552,5342,3575854504,3575854504,0
3,552,5343,3575854504,3575854504,0
3,552,5344,3575854504,3575854507,3
3,552,5345,3575854504,3575854508,4
3,552,5346,3575854504,3575854513,9
3,552,5347,3575854504,3575854516,12
3,552,5348,3575854504,3575854516,12
3,552,5349,3575854504,3575854520,16
3,552,5350,3575854504,3575854521,17
3,552,5351,3575854504,3575854525,21
3,552,5352,3575854504,3575854533,29
3,552,5353,3575854504,3575854536,32
3,552,5354,3575854504,3575854540,36
3,552,5355,3575854504,3575854541,37
3,552,5356,3575854504,3575854543,39
3,552,5357,3575854504,3575854543,39
3,552,5358,3575854504,3575854545,41
3,552,5359,3575854504,3575854545,41
3,552,5360,3575854504,3575854551,47
3,552,5361,3575854504,3575854553,49
3,553,5362,3575854558,3575854560,2
3,553,5363,3575854558,3575854563,5
3,553,5364,3575854558,3575854567,9
3,553,5365,3575854558,3575854570,12
3,553,5366,3575854558,3575854570,12
3,553,5367,3575854558,3575854578,20
3,553,5368,3575854558,3575854579,21
3,553,5369,3575854558,3575854580,22
3,553,5370,3575854558,3575854581,23
3,553,5371,3575854558,3575854581,23
3,553,5372,3575854558,3575854584,26
3,553,5373,3575854558,3575854584,26
3,553,5374,3575854558,3575854586,28
3,553,5375,3575854558,3575854586,28
3,553,5376,3575854558,3575854589,31
3,553,5377,3575854558,3575854589,31
3,553,5378,3575854558,3575854591,33
3,553,5379,3575854558,3575854595,37
3,553,5380,3575854558,3575854598,40
3,553,5381,3575854558,3575854598,40
3,553,5382,3575854558,3575854600,42
3,553,5383,3575854558,3575854601,43
3,553,5384,3575854558,3575854602,44
3,553,5385,3575854558,3575854603,45
3,553,5386,3575854558,3575854604,46
3,553,5387,3575854558,3575854606,48
3,553,5388,3575854558,3575854607,49
3,554,5389,3575854611,3575854612,1
3,554,5390,3575854611,3575854616,5
3,554,5391,3575854611,3575854616,5
3,554,5392,3575854611,3575854618,7
3,554,5393,3575854611,3575854620,9
3,554,5394,3575854611,3575854620,9
3,554,5395,3575854611,3575854621,10
3,554,5396,3575854611,3575854625,14
3,554,5397,3575854611,3575854626,15
3,554,5398,3575854611,3575854628,17
3,554,5399,3575854611,3575854631,20
3,554,5400,3575854611,3575854635,24
3,554,5401,3575854611,3575854637,26
3,554,5402,3575854611,3575854637,26
3,554,5403,3575854611,3575854638,27
3,554,5404,3575854611,3575854640,29
3,554,5405,3575854611,3575854640,29
3,554,5406,3575854611,3575854642,31
3,554,5407,3575854611,3575854642,31
3,554,5408,3575854611,3575854645,34
3,554,5409,3575854611,3575854647,36
3,554,5410,3575854611,3575854648,37
3,554,5411,3575854611,3575854649,38
3,554,5412,3575854611,3575854652,41
3,554,5413,3575854611,3575854652,41
3,554,5414,3575854611,3575854653,42
3,554,5415,3575854611,3575854654,43
3,554,5416,3575854611,3575854654,43
3,554,5417,3575854611,3575854657,46
3,554,5418,3575854611,3575854659,48
3,554,5419,3575854611,3575854659,48
3,555,5420,3575854665,3575854665,0
3,555,5421,3575854665,3575854665,0
3,555,5422,3575854665,3575854665,0
3,555,5423,3575854665,3575854665,0
3,555,5424,3575854665,3575854665,0
3,555,5425,3575854665,3575854666,1
3,555,5426,3575854665,3575854668,3
3,555,5427,3575854665,3575854668,3
3,555,5428,3575854665,3575854669,4
3,555,5429,3575854665,3575854676,11
3,555,5430,3575854665,3575854677,12
3,555,5431,3575854665,3575854678,13
3,555,5432,3575854665,3575854683,18
3,555,5433,3575854665,3575854683,18
3,555,5434,3575854665,3575854689,24
3,555,5435,3575854665,3575854690,25
3,555,5436,3575854665,3575854698,33
3,555,5437,3575854665,3575854699,34
3,555,5438,3575854665,3575854701,36
3,555,5439,3575854665,3575854702,37
3,555,5440,3575854665,3575854707,42
3,555,5441,3575854665,3575854708,43
3,555,5442,3575854665,3575854713,48
3,556,5443,3575854719,3575854719,0
3,556,5444,3575854719,3575854719,0
3,556,5445,3575854719,3575854720,1
3,556,5446,3575854719,3575854721,2
3,556,5447,3575854719,3575854726,7
3,556,5448,3575854719,3575854733,14
3,556,5449,3575854719,3575854736,17
3,556,5450,3575854719,3575854740,21
3,556,5451,3575854719,3575854742,23
3,556,5452,3575854719,3575854743,24
3,556,5453,3575854719,3575854744,25
3,556,5454,3575854719,3575854746,27
3,556,5455,3575854719,3575854751,32
3,556,5456,3575854719,3575854754,35
3,556,5457,3575854719,3575854760,41
3,556,5458,3575854719,3575854762,43
3,556,5459,3575854719,3575854768,49
3,557,5460,3575854773,3575854773,0
3,557,5461,3575854773,3575854773,0
3,557,5462,3575854773,3575854773,0
3,557,5463,3575854773,3575854778,5
3,557,5464,3575854773,3575854780,7
3,557,5465,3575854773,3575854780,7
3,557,5466,3575854773,3575854781,8
3,557,5467,3575854773,3575854781,8
3,557,5468,3575854773,3575854784,11
3,557,5469,3575854773,3575854785,12
3,557,5470,3575854773,3575854786,13
3,557,5471,3575854773,3575854786,13
3,557,5472,3575854773,3575854788,15
3,557,5473,3575854773,3575854788,15
3,557,5474,3575854773,3575854792,19
3,557,5475,3575854773,3575854796,23
3,557,5476,3575854773,3575854798,25
3,557,5477,3575854773,3575854798,25
3,557,5478,3575854773,3575854800,27
3,557,5479,3575854773,3575854801,28
3,557,5480,3575854773,3575854803,30
3,557,5481,3575854773,3575854804,31
3,557,5482,3575854773,3575854805,32
3,557,5483,3575854773,3575854806,33
3,557,5484,3575854773,3575854806,33
3,557,5485,3575854773,3575854813,40
3,557,5486,3575854773,3575854816,43
3,557,5487,3575854773,3575854817,44
3,557,5488,3575854773,3575854819,46
3,557,5489,3575854773,3575854819,46
3,557,5490,3575854773,3575854821,48
3,557,5491,3575854773,3575854822,49
3,557,5492,3575854773,3575854822,49
3,558,5493,3575854828,3575854828,0
3,558,5494,3575854828,3575854828,0
3,558,5495,3575854828,3575854829,1
3,558,5496,3575854828,3575854830,2
3,558,5497,3575854828,3575854835,7
3,558,5498,3575854828,3575854836,8
3,558,5499,3575854828,3575854837,9
3,558,5500,3575854828,3575854839,11
3,558,5501,3575854828,3575854841,13
3,558,5502,3575854828,3575854841,13
3,558,5503,3575854828,3575854843,15
3,558,5504,3575854828,3575854843,15
3,558,5505,3575854828,3575854845,17
3,558,5506,3575854828,3575854847,19
3,558,5507,3575854828,3575854848,20
3,558,5508,3575854828,3575854849,21
3,558,5509,3575854828,3575854852,24
3,558,5510,3575854828,3575854852,24
3,558,5511,3575854828,3575854853,25
3,558,5512,3575854828,3575854854,26
3,558,5513,3575854828,3575854855,27
3,558,5514,3575854828,3575854856,28
3,558,5515,3575854828,3575854859,31
3,558,5516,3575854828,3575854859,31
3,558,5517,3575854828,3575854861,33
3,558,5518,3575854828,3575854863,35
3,558,5519,3575854828,3575854863,35
3,558,5520,3575854828,3575854865,37
3,558,5521,3575854828,3575854865,37
3,558,5522,3575854828,3575854866,38
3,558,5523,3575854828,3575854868,40
3,558,5524,3575854828,3575854868,40
3,558,5525,3575854828,3575854869,41
3,558,5526,3575854828,3575854876,48
3,558,5527,3575854828,3575854876,48
3,559,5528,3575854882,3575854882,0
3,559,5529,3575854882,3575854883,1
3,559,5530,3575854882,3575854883,1
3,559,5531,3575854882,3575854884,2
3,559,5532,3575854882,3575854889,7
3,559,5533,3575854882,3575854889,7
3,559,5534,3575854882,3575854897,15
3,559,5535,3575854882,3575854898,16
3,559,5536,3575854882,3575854901,19
3,559,5537,3575854882,3575854902,20
3,559,5538,3575854882,3575854908,26
3,559,5539,3575854882,3575854908,26
3,559,5540,3575854882,3575854913,31
3,559,5541,3575854882,3575854916,34
3,559,5542,3575854882,3575854917,35
3,559,5543,3575854882,3575854920,38
3,559,5544,3575854882,3575854921,39
3,559,5545,3575854882,3575854926,44
3,560,5546,3575854936,3575854936,0
3,560,5547,3575854936,3575854937,1
3,560,5548,3575854936,3575854941,5
3,560,5549,3575854936,3575854943,7
3,560,5550,3575854936,3575854943,7
3,560,5551,3575854936,3575854947,11
3,560,5552,3575854936,3575854951,15
3,560,5553,3575854936,3575854954,18
3,560,5554,3575854936,3575854958,22
3,560,5555,3575854936,3575854960,24
3,560,5556,3575854936,3575854963,27
3,560,5557,3575854936,3575854969,33
3,560,5558,3575854936,3575854970,34
3,560,5559,3575854936,3575854970,34
3,560,5560,3575854936,3575854970,34
3,560,5561,3575854936,3575854974,38
3,560,5562,3575854936,3575854978,42
3,560,5563,3575854936,3575854980,44
3,560,5564,3575854936,3575854981,45
3,560,5565,3575854936,3575854982,46
3,560,5566,3575854936,3575854982,46
3,560,5567,3575854936,3575854985,49
3,560,5568,3575854936,3575854985,49
3,561,5569,3575854990,3575854990,0
3,561,5570,3575854990,3575854990,0
3,561,5571,3575854990,3575854990,0
3,561,5572,3575854990,3575854991,1
3,561,5573,3575854990,3575854996,6
3,561,5574,3575854990,3575854997,7
3,561,5575,3575854990,3575854999,9
3,561,5576,3575854990,3575854999,9
3,561,5577,3575854990,3575855000,10
3,561,5578,3575854990,3575855000,10
3,561,5579,3575854990,3575855003,13
3,561,5580,3575854990,3575855004,14
3,561,5581,3575854990,3575855005,15
3,561,5582,3575854990,3575855006,16
3,561,5583,3575854990,3575855007,17
3,561,5584,3575854990,3575855013,23
3,561,5585,3575854990,3575855016,26
3,561,5586,3575854990,3575855017,27
3,561,5587,3575854990,3575855019,29
3,561,5588,3575854990,3575855020,30
3,561,5589,3575854990,3575855021,31
3,561,5590,3575854990,3575855022,32
3,561,5591,3575854990,3575855022,32
3,561,5592,3575854990,3575855025,35
3,561,5593,3575854990,3575855026,36
3,561,5594,3575854990,3575855029,39
3,561,5595,3575854990,3575855032,42
3,561,5596,3575854990,3575855035,45
3,561,5597,3575854990,3575855036,46
3,561,5598,3575854990,3575855039,49
3,562,5599,3575855044,3575855044,0
3,562,5600,3575855044,3575855044,0
3,562,5601,3575855044,3575855044,0
3,562,5602,3575855044,3575855044,0
3,562,5603,3575855044,3575855045,1
3,562,5604,3575855044,3575855047,3
3,562,5605,3575855044,3575855048,4
3,562,5606,3575855044,3575855049,5
3,562,5607,3575855044,3575855052,8
3,562,5608,3575855044,3575855052,8
3,562,5609,3575855044,3575855053,9
3,562,5610,3575855044,3575855055,11
3,562,5611,3575855044,3575855055,11
3,562,5612,3575855044,3575855057,13
3,562,5613,3575855044,3575855059,15
3,562,5614,3575855044,3575855059,15
3,562,5615,3575855044,3575855061,17
3,562,5616,3575855044,3575855063,19
3,562,5617,3575855044,3575855064,20
3,562,5618,3575855044,3575855065,21
3,562,5619,3575855044,3575855065,21
3,562,5620,3575855044,3575855066,22
3,562,5621,3575855044,3575855068,24
3,562,5622,3575855044,3575855069,25
3,562,5623,3575855044,3575855069,25
3,562,5624,3575855044,3575855076,32
3,562,5625,3575855044,3575855077,33
3,562,5626,3575855044,3575855081,37
3,562,5627,3575855044,3575855083,39
3,562,5628,3575855044,3575855083,39
3,562,5629,3575855044,3575855089,45
3,562,5630,3575855044,3575855089,45
3,563,5631,3575855100,3575855100,0
3,563,5632,3575855100,3575855100,0
3,563,5633,3575855100,3575855101,1
3,563,5634,3575855100,3575855102,2
3,563,5635,3575855100,3575855107,7
3,563,5636,3575855100,3575855109,9
3,563,5637,3575855100,3575855113,13
3,563,5638,3575855100,3575855117,17
3,563,5639,3575855100,3575855117,17
3,563,5640,3575855100,3575855120,20
3,563,5641,3575855100,3575855121,21
3,563,5642,3575855100,3575855127,27
3,563,5643,3575855100,3575855135,35
3,563,5644,3575855100,3575855137,37
3,563,5645,3575855100,3575855140,40
3,563,5646,3575855100,3575855143,43
3,563,5647,3575855100,3575855143,43
3,563,5648,3575855100,3575855144,44
3,563,5649,3575855100,3575855146,46
3,563,5650,3575855100,3575855146,46
3,564,5651,3575855154,3575855154,0
3,564,5652,3575855154,3575855154,0
3,564,5653,3575855154,3575855159,5
3,564,5654,3575855154,3575855161,7
3,564,5655,3575855154,3575855163,9
3,564,5656,3575855154,3575855168,14
3,564,5657,3575855154,3575855170,16
3,564,5658,3575855154,3575855170,16
3,564,5659,3575855154,3575855171,17
3,564,5660,3575855154,3575855175,21
3,564,5661,3575855154,3575855178,24
3,564,5662,3575855154,3575855180,26
3,564,5663,3575855154,3575855181,27
3,564,5664,3575855154,3575855182,28
3,564,5665,3575855154,3575855182,28
3,564,5666,3575855154,3575855185,31
3,564,5667,3575855154,3575855186,32
3,564,5668,3575855154,3575855188,34
3,564,5669,3575855154,3575855189,35
3,564,5670,3575855154,3575855196,42
3,564,5671,3575855154,3575855197,43
3,564,5672,3575855154,3575855198,44
3,564,5673,3575855154,3575855199,45
3,564,5674,3575855154,3575855200,46
3,564,5675,3575855154,3575855200,46
3,564,5676,3575855154,3575855203,49
3,564,5677,3575855154,3575855204,50
3,565,5678,3575855208,3575855208,0
3,565,5679,3575855208,3575855208,0
3,565,5680,3575855208,3575855208,0
3,565,5681,3575855208,3575855213,5
3,565,5682,3575855208,3575855216,8
3,565,5683,3575855208,3575855217,9
3,565,5684,3575855208,3575855220,12
3,565,5685,3575855208,3575855220,12
3,565,5686,3575855208,3575855221,13
3,565,5687,3575855208,3575855222,14
3,565,5688,3575855208,3575855222,14
3,565,5689,3575855208,3575855225,17
3,565,5690,3575855208,3575855226,18
3,565,5691,3575855208,3575855229,21
3,565,5692,3575855208,3575855232,24
3,565,5693,3575855208,3575855235,27
3,565,5694,3575855208,3575855237,29
3,565,5695,3575855208,3575855239,31
3,565,5696,3575855208,3575855239,31
3,565,5697,3575855208,3575855241,33
3,565,5698,3575855208,3575855243,35
3,565,5699,3575855208,3575855243,35
3,565,5700,3575855208,3575855244,36
3,565,5701,3575855208,3575855246,38
3,565,5702,3575855208,3575855248,40
3,565,5703,3575855208,3575855248,40
3,565,5704,3575855208,3575855249,41
3,565,5705,3575855208,3575855252,44
3,565,5706,3575855208,3575855253,45
3,565,5707,3575855208,3575855253,45
3,565,5708,3575855208,3575855255,47
3,565,5709,3575855208,3575855255,47
3,565,5710,3575855208,3575855257,49
3,566,5711,3575855262,3575855262,0
3,566,5712,3575855262,3575855262,0
3,566,5713,3575855262,3575855263,1
3,566,5714,3575855262,3575855264,2
3,566,5715,3575855262,3575855264,2
3,566,5716,3575855262,3575855265,3
3,566,5717,3575855262,3575855266,4
3,566,5718,3575855262,3575855269,7
3,566,5719,3575855262,3575855269,7
3,566,5720,3575855262,3575855269,7
3,566,5721,3575855262,3575855276,14
3,566,5722,3575855262,3575855277,15
3,566,5723,3575855262,3575855279,17
3,566,5724,3575855262,3575855280,18
3,566,5725,3575855262,3575855284,22
3,566,5726,3575855262,3575855284,22
3,566,5727,3575855262,3575855289,27
3,566,5728,3575855262,3575855290,28
3,566,5729,3575855262,3575855297,35
3,566,5730,3575855262,3575855298,36
3,566,5731,3575855262,3575855301,39
3,566,5732,3575855262,3575855302,40
3,566,5733,3575855262,3575855307,45
3,566,5734,3575855262,3575855309,47
3,567,5735,3575855316,3575855316,0
3,567,5736,3575855316,3575855317,1
3,567,5737,3575855316,3575855317,1
3,567,5738,3575855316,3575855321,5
3,567,5739,3575855316,3575855322,6
3,567,5740,3575855316,3575855328,12
3,567,5741,3575855316,3575855335,19
3,567,5742,3575855316,3575855337,21
3,567,5743,3575855316,3575855340,24
3,567,5744,3575855316,3575855343,27
3,567,5745,3575855316,3575855344,28
3,567,5746,3575855316,3575855344,28
3,567,5747,3575855316,3575855346,30
3,567,5748,3575855316,3575855346,30
3,567,5749,3575855316,3575855352,36
3,567,5750,3575855316,3575855354,38
3,567,5751,3575855316,3575855360,44
3,567,5752,3575855316,3575855361,45
3,567,5753,3575855316,3575855364,48
3,568,5754,3575855370,3575855370,0
3,568,5755,3575855370,3575855371,1
3,568,5756,3575855370,3575855371,1
3,568,5757,3575855370,3575855372,2
3,568,5758,3575855370,3575855375,5
3,568,5759,3575855370,3575855378,8
3,568,5760,3575855370,3575855380,10
3,568,5761,3575855370,3575855381,11
3,568,5762,3575855370,3575855382,12
3,568,5763,3575855370,3575855382,12
3,568,5764,3575855370,3575855385,15
3,568,5765,3575855370,3575855387,17
3,568,5766,3575855370,3575855387,17
3,568,5767,3575855370,3575855390,20
3,568,5768,3575855370,3575855392,22
3,568,5769,3575855370,3575855396,26
3,568,5770,3575855370,3575855397,27
3,568,5771,3575855370,3575855399,29
3,568,5772,3575855370,3575855399,29
3,568,5773,3575855370,3575855400,30
3,568,5774,3575855370,3575855401,31
3,568,5775,3575855370,3575855403,33
3,568,5776,3575855370,3575855405,35
3,568,5777,3575855370,3575855405,35
3,568,5778,3575855370,3575855406,36
3,568,5779,3575855370,3575855408,38
3,568,5780,3575855370,3575855414,44
3,568,5781,3575855370,3575855416,46
3,568,5782,3575855370,3575855417,47
3,569,5783,3575855426,3575855426,0
3,569,5784,3575855426,3575855426,0
3,569,5785,3575855426,3575855426,0
3,569,5786,3575855426,3575855426,0
3,569,5787,3575855426,3575855426,0
3,569,5788,3575855426,3575855427,1
3,569,5789,3575855426,3575855429,3
3,569,5790,3575855426,3575855432,6
3,569,5791,3575855426,3575855436,10
3,569,5792,3575855426,3575855438,12
3,569,5793,3575855426,3575855439,13
3,569,5794,3575855426,3575855440,14
3,569,5795,3575855426,3575855443,17
3,569,5796,3575855426,3575855443,17
3,569,5797,3575855426,3575855444,18
3,569,5798,3575855426,3575855447,21
3,569,5799,3575855426,3575855448,22
3,569,5800,3575855426,3575855450,24
3,569,5801,3575855426,3575855450,24
3,569,5802,3575855426,3575855452,26
3,569,5803,3575855426,3575855453,27
3,569,5804,3575855426,3575855454,28
3,569,5805,3575855426,3575855454,28
3,569,5806,3575855426,3575855455,29
3,569,5807,3575855426,3575855457,31
3,569,5808,3575855426,3575855459,33
3,569,5809,3575855426,3575855460,34
3,569,5810,3575855426,3575855463,37
3,569,5811,3575855426,3575855464,38
3,569,5812,3575855426,3575855465,39
3,569,5813,3575855426,3575855465,39
3,569,5814,3575855426,3575855466,40
3,569,5815,3575855426,3575855469,43
3,569,5816,3575855426,3575855470,44
3,570,5817,3575855480,3575855480,0
3,570,5818,3575855480,3575855480,0
3,570,5819,3575855480,3575855480,0
3,570,5820,3575855480,3575855480,0
3,570,5821,3575855480,3575855481,1
3,570,5822,3575855480,3575855482,2
3,570,5823,3575855480,3575855483,3
3,570,5824,3575855480,3575855484,4
3,570,5825,3575855480,3575855488,8
3,570,5826,3575855480,3575855489,9
3,570,5827,3575855480,3575855496,16
3,570,5828,3575855480,3575855497,17
3,570,5829,3575855480,3575855500,20
3,570,5830,3575855480,3575855501,21
3,570,5831,3575855480,3575855506,26
3,570,5832,3575855480,3575855507,27
3,570,5833,3575855480,3575855512,32
3,570,5834,3575855480,3575855516,36
3,570,5835,3575855480,3575855516,36
3,570,5836,3575855480,3575855519,39
3,570,5837,3575855480,3575855520,40
3,570,5838,3575855480,3575855527,47
3,571,5839,3575855534,3575855534,0
3,571,5840,3575855534,3575855536,2
3,571,5841,3575855534,3575855539,5
3,571,5842,3575855534,3575855542,8
3,571,5843,3575855534,3575855543,9
3,571,5844,3575855534,3575855543,9
3,571,5845,3575855534,3575855545,11
3,571,5846,3575855534,3575855546,12
3,571,5847,3575855534,3575855551,17
3,571,5848,3575855534,3575855554,20
3,571,5849,3575855534,3575855558,24
3,571,5850,3575855534,3575855560,26
3,571,5851,3575855534,3575855564,30
3,571,5852,3575855534,3575855567,33
3,571,5853,3575855534,3575855569,35
3,571,5854,3575855534,3575855570,36
3,571,5855,3575855534,3575855571,37
3,571,5856,3575855534,3575855574,40
3,571,5857,3575855534,3575855577,43
3,571,5858,3575855534,3575855580,46
3,571,5859,3575855534,3575855581,47
3,571,5860,3575855534,3575855581,47
3,571,5861,3575855534,3575855582,48
3,572,5862,3575855589,3575855589,0
3,572,5863,3575855589,3575855589,0
3,572,5864,3575855589,3575855589,0
3,572,5865,3575855589,3575855589,0
3,572,5866,3575855589,3575855590,1
3,572,5867,3575855589,3575855591,2
3,572,5868,3575855589,3575855596,7
3,572,5869,3575855589,3575855598,9
3,572,5870,3575855589,3575855598,9
3,572,5871,3575855589,3575855599,10
3,572,5872,3575855589,3575855601,12
3,572,5873,3575855589,3575855602,13
3,572,5874,3575855589,3575855603,14
3,572,5875,3575855589,3575855605,16
3,572,5876,3575855589,3575855605,16
3,572,5877,3575855589,3575855607,18
3,572,5878,3575855589,3575855613,24
3,572,5879,3575855589,3575855615,26
3,572,5880,3575855589,3575855616,27
3,572,5881,3575855589,3575855619,30
3,572,5882,3575855589,3575855620,31
3,572,5883,3575855589,3575855620,31
3,572,5884,3575855589,3575855621,32
3,572,5885,3575855589,3575855623,34
3,572,5886,3575855589,3575855625,36
3,572,5887,3575855589,3575855626,37
3,572,5888,3575855589,3575855629,40
3,572,5889,3575855589,3575855631,42
3,572,5890,3575855589,3575855634,45
3,572,5891,3575855589,3575855635,46
3,572,5892,3575855589,3575855636,47
3,572,5893,3575855589,3575855638,49
3,572,5894,3575855589,3575855638,49
3,573,5895,3575855643,3575855643,0
3,573,5896,3575855643,3575855643,0
3,573,5897,3575855643,3575855643,0
3,573,5898,3575855643,3575855646,3
3,573,5899,3575855643,3575855647,4
3,573,5900,3575855643,3575855649,6
3,573,5901,3575855643,3575855649,6
3,573,5902,3575855643,3575855651,8
3,573,5903,3575855643,3575855653,10
3,573,5904,3575855643,3575855653,10
3,573,5905,3575855643,3575855655,12
3,573,5906,3575855643,3575855658,15
3,573,5907,3575855643,3575855660,17
3,573,5908,3575855643,3575855662,19
3,573,5909,3575855643,3575855663,20
3,573,5910,3575855643,3575855663,20
3,573,5911,3575855643,3575855663,20
3,573,5912,3575855643,3575855665,22
3,573,5913,3575855643,3575855665,22
3,573,5914,3575855643,3575855668,25
3,573,5915,3575855643,3575855669,26
3,573,5916,3575855643,3575855677,34
3,573,5917,3575855643,3575855677,34
3,573,5918,3575855643,3575855678,35
3,573,5919,3575855643,3575855679,36
3,573,5920,3575855643,3575855681,38
3,573,5921,3575855643,3575855682,39
3,573,5922,3575855643,3575855683,40
3,573,5923,3575855643,3575855683,40
3,573,5924,3575855643,3575855688,45
3,573,5925,3575855643,3575855690,47
3,574,5926,3575855696,3575855697,1
3,574,5927,3575855696,3575855698,2
3,574,5928,3575855696,3575855700,4
3,574,5929,3575855696,3575855701,5
3,574,5930,3575855696,3575855708,12
3,574,5931,3575855696,3575855708,12
3,574,5932,3575855696,3575855716,20
3,574,5933,3575855696,3575855716,20
3,574,5934,3575855696,3575855720,24
3,574,5935,3575855696,3575855721,25
3,574,5936,3575855696,3575855727,31
3,574,5937,3575855696,3575855733,37
3,574,5938,3575855696,3575855737,41
3,574,5939,3575855696,3575855741,45
3,574,5940,3575855696,3575855742,46
3,574,5941,3575855696,3575855743,47
3,574,5942,3575855696,3575855743,47
3,574,5943,3575855696,3575855744,48
3,574,5944,3575855696,3575855746,50
3,575,5945,3575855751,3575855751,0
3,575,5946,3575855751,3575855754,3
3,575,5947,3575855751,3575855758,7
3,575,5948,3575855751,3575855760,9
3,575,5949,3575855751,3575855763,12
3,575,5950,3575855751,3575855767,16
3,575,5951,3575855751,3575855770,19
3,575,5952,3575855751,3575855770,19
3,575,5953,3575855751,3575855771,20
3,575,5954,3575855751,3575855774,23
3,575,5955,3575855751,3575855778,27
3,575,5956,3575855751,3575855781,30
3,575,5957,3575855751,3575855781,30
3,575,5958,3575855751,3575855782,31
3,575,5959,3575855751,3575855782,31
3,575,5960,3575855751,3575855784,33
3,575,5961,3575855751,3575855784,33
3,575,5962,3575855751,3575855786,35
3,575,5963,3575855751,3575855787,36
3,575,5964,3575855751,3575855790,39
3,575,5965,3575855751,3575855792,41
3,575,5966,3575855751,3575855795,44
3,575,5967,3575855751,3575855795,44
3,575,5968,3575855751,3575855798,47
3,575,5969,3575855751,3575855798,47
3,575,5970,3575855751,3575855800,49
3,575,5971,3575855751,3575855801,50
3,576,5972,3575855805,3575855805,0
3,576,5973,3575855805,3575855805,0
3,576,5974,3575855805,3575855805,0
3,576,5975,3575855805,3575855806,1
3,576,5976,3575855805,3575855807,2
3,576,5977,3575855805,3575855814,9
3,576,5978,3575855805,3575855815,10
3,576,5979,3575855805,3575855816,11
3,576,5980,3575855805,3575855819,14
3,576,5981,3575855805,3575855820,15
3,576,5982,3575855805,3575855820,15
3,576,5983,3575855805,3575855821,16
3,576,5984,3575855805,3575855823,18
3,576,5985,3575855805,3575855824,19
3,576,5986,3575855805,3575855826,21
3,576,5987,3575855805,3575855829,24
3,576,5988,3575855805,3575855831,26
3,576,5989,3575855805,3575855834,29
3,576,5990,3575855805,3575855835,30
3,576,5991,3575855805,3575855836,31
3,576,5992,3575855805,3575855838,33
3,576,5993,3575855805,3575855839,34
3,576,5994,3575855805,3575855842,37
3,576,5995,3575855805,3575855843,38
3,576,5996,3575855805,3575855843,38
3,576,5997,3575855805,3575855846,41
3,576,5998,3575855805,3575855847,42
3,576,5999,3575855805,3575855849,44
3,576,6000,3575855805,3575855849,44
3,576,6001,3575855805,3575855851,46
3,576,6002,3575855805,3575855852,47
3,576,6003,3575855805,3575855853,48
3,577,6004,3575855860,3575855860,0
3,577,6005,3575855860,3575855860,0
3,577,6006,3575855860,3575855860,0
3,577,6007,3575855860,3575855860,0
3,577,6008,3575855860,3575855862,2
3,577,6009,3575855860,3575855862,2
3,577,6010,3575855860,3575855863,3
3,577,6011,3575855860,3575855864,4
3,577,6012,3575855860,3575855865,5
3,577,6013,3575855860,3575855868,8
3,577,6014,3575855860,3575855869,9
3,577,6015,3575855860,3575855869,9
3,577,6016,3575855860,3575855877,17
3,577,6017,3575855860,3575855878,18
3,577,6018,3575855860,3575855878,18
3,577,6019,3575855860,3575855879,19
3,577,6020,3575855860,3575855881,21
3,577,6021,3575855860,3575855882,22
3,577,6022,3575855860,3575855883,23
3,577,6023,3575855860,3575855883,23
3,577,6024,3575855860,3575855888,28
3,577,6025,3575855860,3575855890,30
3,577,6026,3575855860,3575855897,37
3,577,6027,3575855860,3575855898,38
3,577,6028,3575855860,3575855900,40
3,577,6029,3575855860,3575855901,41
3,577,6030,3575855860,3575855908,48
3,577,6031,3575855860,3575855908,48
3,578,6032,3575855915,3575855915,0
3,578,6033,3575855915,3575855916,1
3,578,6034,3575855915,3575855917,2
3,578,6035,3575855915,3575855920,5
3,578,6036,3575855915,3575855921,6
3,578,6037,3575855915,3575855927,12
3,578,6038,3575855915,3575855934,19
3,578,6039,3575855915,3575855937,22
3,578,6040,3575855915,3575855941,26
3,578,6041,3575855915,3575855943,28
3,578,6042,3575855915,3575855943,28
3,578,6043,3575855915,3575855944,29
3,578,6044,3575855915,3575855945,30
3,578,6045,3575855915,3575855946,31
3,578,6046,3575855915,3575855951,36
3,578,6047,3575855915,3575855954,39
3,578,6048,3575855915,3575855958,43
3,578,6049,3575855915,3575855960,45
3,578,6050,3575855915,3575855963,48
3,579,6051,3575855970,3575855970,0
3,579,6052,3575855970,3575855970,0
3,579,6053,3575855970,3575855970,0
3,579,6054,3575855970,3575855971,1
3,579,6055,3575855970,3575855974,4
3,579,6056,3575855970,3575855978,8
3,579,6057,3575855970,3575855980,10
3,579,6058,3575855970,3575855981,11
3,579,6059,3575855970,3575855982,12
3,579,6060,3575855970,3575855982,12
3,579,6061,3575855970,3575855984,14
3,579,6062,3575855970,3575855985,15
3,579,6063,3575855970,3575855986,16
3,579,6064,3575855970,3575855987,17
3,579,6065,3575855970,3575855989,19
3,579,6066,3575855970,3575855991,21
3,579,6067,3575855970,3575855995,25
3,579,6068,3575855970,3575855997,27
3,579,6069,3575855970,3575855998,28
3,579,6070,3575855970,3575855998,28
3,579,6071,3575855970,3575855999,29
3,579,6072,3575855970,3575856000,30
3,579,6073,3575855970,3575856003,33
3,579,6074,3575855970,3575856003,33
3,579,6075,3575855970,3575856005,35
3,579,6076,3575855970,3575856006,36
3,579,6077,3575855970,3575856007,37
3,579,6078,3575855970,3575856015,45
3,579,6079,3575855970,3575856015,45
3,579,6080,3575855970,3575856016,46
3,579,6081,3575855970,3575856019,49
3,579,6082,3575855970,3575856020,50
3,580,6083,3575856025,3575856025,0
3,580,6084,3575856025,3575856025,0
3,580,6085,3575856025,3575856025,0
3,580,6086,3575856025,3575856025,0
3,580,6087,3575856025,3575856026,1
3,580,6088,3575856025,3575856029,4
3,580,6089,3575856025,3575856032,7
3,580,6090,3575856025,3575856034,9
3,580,6091,3575856025,3575856035,10
3,580,6092,3575856025,3575856036,11
3,580,6093,3575856025,3575856038,13
3,580,6094,3575856025,3575856039,14
3,580,6095,3575856025,3575856039,14
3,580,6096,3575856025,3575856043,18
3,580,6097,3575856025,3575856043,18
3,580,6098,3575856025,3575856043,18
3,580,6099,3575856025,3575856046,21
3,580,6100,3575856025,3575856047,22
3,580,6101,3575856025,3575856048,23
3,580,6102,3575856025,3575856050,25
3,580,6103,3575856025,3575856051,26
3,580,6104,3575856025,3575856053,28
3,580,6105,3575856025,3575856053,28
3,580,6106,3575856025,3575856055,30
3,580,6107,3575856025,3575856055,30
3,580,6108,3575856025,3575856058,33
3,580,6109,3575856025,3575856059,34
3,580,6110,3575856025,3575856060,35
3,580,6111,3575856025,3575856062,37
3,580,6112,3575856025,3575856063,38
3,580,6113,3575856025,3575856063,38
3,580,6114,3575856025,3575856064,39
3,580,6115,3575856025,3575856065,40
3,580,6116,3575856025,3575856068,43
3,580,6117,3575856025,3575856069,44
3,580,6118,3575856025,3575856069,44
3,581,6119,3575856080,3575856080,0
3,581,6120,3575856080,3575856080,0
3,581,6121,3575856080,3575856080,0
3,581,6122,3575856080,3575856080,0
3,581,6123,3575856080,3575856081,1
3,581,6124,3575856080,3575856082,2
3,581,6125,3575856080,3575856084,4
3,581,6126,3575856080,3575856084,4
3,581,6127,3575856080,3575856088,8
3,581,6128,3575856080,3575856089,9
3,581,6129,3575856080,3575856097,17
3,581,6130,3575856080,3575856099,19
3,581,6131,3575856080,3575856099,19
3,581,6132,3575856080,3575856101,21
3,581,6133,3575856080,3575856108,28
3,581,6134,3575856080,3575856109,29
3,581,6135,3575856080,3575856113,33
3,581,6136,3575856080,3575856117,37
3,581,6137,3575856080,3575856117,37
3,581,6138,3575856080,3575856120,40
3,581,6139,3575856080,3575856121,41
3,581,6140,3575856080,3575856127,47
3,582,6141,3575856134,3575856134,0
3,582,6142,3575856134,3575856142,8
3,582,6143,3575856134,3575856142,8
3,582,6144,3575856134,3575856143,9
3,582,6145,3575856134,3575856143,9
3,582,6146,3575856134,3575856144,10
3,582,6147,3575856134,3575856146,12
3,582,6148,3575856134,3575856151,17
3,582,6149,3575856134,3575856154,20
3,582,6150,3575856134,3575856160,26
3,582,6151,3575856134,3575856161,27
3,582,6152,3575856134,3575856164,30
3,582,6153,3575856134,3575856168,34
3,582,6154,3575856134,3575856170,36
3,582,6155,3575856134,3575856171,37
3,582,6156,3575856134,3575856171,37
3,582,6157,3575856134,3575856174,40
3,582,6158,3575856134,3575856178,44
3,582,6159,3575856134,3575856181,47
3,582,6160,3575856134,3575856181,47
3,582,6161,3575856134,3575856182,48
3,582,6162,3575856134,3575856182,48
3,583,6163,3575856188,3575856188,0
3,583,6164,3575856188,3575856188,0
3,583,6165,3575856188,3575856188,0
3,583,6166,3575856188,3575856188,0
3,583,6167,3575856188,3575856189,1
3,583,6168,3575856188,3575856192,4
3,583,6169,3575856188,3575856194,6
3,583,6170,3575856188,3575856195,7
3,583,6171,3575856188,3575856197,9
3,583,6172,3575856188,3575856198,10
3,583,6173,3575856188,3575856198,10
3,583,6174,3575856188,3575856199,11
3,583,6175,3575856188,3575856201,13
3,583,6176,3575856188,3575856204,16
3,583,6177,3575856188,3575856206,18
3,583,6178,3575856188,3575856206,18
3,583,6179,3575856188,3575856207,19
3,583,6180,3575856188,3575856216,28
3,583,6181,3575856188,3575856216,28
3,583,6182,3575856188,3575856217,29
3,583,6183,3575856188,3575856219,31
3,583,6184,3575856188,3575856221,33
3,583,6185,3575856188,3575856221,33
3,583,6186,3575856188,3575856222,34
3,583,6187,3575856188,3575856223,35
3,583,6188,3575856188,3575856225,37
3,583,6189,3575856188,3575856226,38
3,583,6190,3575856188,3575856229,41
3,583,6191,3575856188,3575856232,44
3,583,6192,3575856188,3575856234,46
3,583,6193,3575856188,3575856235,47
3,583,6194,3575856188,3575856238,50
3,584,6195,3575856243,3575856243,0
3,584,6196,3575856243,3575856243,0
3,584,6197,3575856243,3575856243,0
3,584,6198,3575856243,3575856243,0
3,584,6199,3575856243,3575856243,0
3,584,6200,3575856243,3575856244,1
3,584,6201,3575856243,3575856246,3
3,584,6202,3575856243,3575856248,5
3,584,6203,3575856243,3575856248,5
3,584,6204,3575856243,3575856252,9
3,584,6205,3575856243,3575856253,10
3,584,6206,3575856243,3575856253,10
3,584,6207,3575856243,3575856255,12
3,584,6208,3575856243,3575856255,12
3,584,6209,3575856243,3575856259,16
3,584,6210,3575856243,3575856259,16
3,584,6211,3575856243,3575856259,16
3,584,6212,3575856243,3575856263,20
3,584,6213,3575856243,3575856263,20
3,584,6214,3575856243,3575856263,20
3,584,6215,3575856243,3575856264,21
3,584,6216,3575856243,3575856265,22
3,584,6217,3575856243,3575856266,23
3,584,6218,3575856243,3575856269,26
3,584,6219,3575856243,3575856269,26
3,584,6220,3575856243,3575856270,27
3,584,6221,3575856243,3575856277,34
3,584,6222,3575856243,3575856280,37
3,584,6223,3575856243,3575856281,38
3,584,6224,3575856243,3575856283,40
3,584,6225,3575856243,3575856283,40
3,584,6226,3575856243,3575856283,40
3,584,6227,3575856243,3575856288,45
3,584,6228,3575856243,3575856290,47
3,585,6229,3575856298,3575856298,0
3,585,6230,3575856298,3575856299,1
3,585,6231,3575856298,3575856300,2
3,585,6232,3575856298,3575856302,4
3,585,6233,3575856298,3575856308,10
3,585,6234,3575856298,3575856309,11
3,585,6235,3575856298,3575856313,15
3,585,6236,3575856298,3575856317,19
3,585,6237,3575856298,3575856317,19
3,585,6238,3575856298,3575856321,23
3,585,6239,3575856298,3575856321,23
3,585,6240,3575856298,3575856327,29
3,585,6241,3575856298,3575856334,36
3,585,6242,3575856298,3575856341,43
3,585,6243,3575856298,3575856343,45
3,585,6244,3575856298,3575856344,46
3,585,6245,3575856298,3575856344,46
3,585,6246,3575856298,3575856344,46
3,585,6247,3575856298,3575856346,48
3,586,6248,3575856352,3575856352,0
3,586,6249,3575856352,3575856354,2
3,586,6250,3575856352,3575856360,8
3,586,6251,3575856352,3575856361,9
3,586,6252,3575856352,3575856363,11
3,586,6253,3575856352,3575856368,16
3,586,6254,3575856352,3575856371,19
3,586,6255,3575856352,3575856371,19
3,586,6256,3575856352,3575856371,19
3,586,6257,3575856352,3575856373,21
3,586,6258,3575856352,3575856378,26
3,586,6259,3575856352,3575856381,29
3,586,6260,3575856352,3575856381,29
3,586,6261,3575856352,3575856382,30
3,586,6262,3575856352,3575856385,33
3,586,6263,3575856352,3575856385,33
3,586,6264,3575856352,3575856387,35
3,586,6265,3575856352,3575856388,36
3,586,6266,3575856352,3575856390,38
3,586,6267,3575856352,3575856392,40
3,586,6268,3575856352,3575856394,42
3,586,6269,3575856352,3575856395,43
3,586,6270,3575856352,3575856396,44
3,586,6271,3575856352,3575856397,45
3,586,6272,3575856352,3575856399,47
3,586,6273,3575856352,3575856399,47
3,586,6274,3575856352,3575856399,47
3,586,6275,3575856352,3575856400,48
3,587,6276,3575856407,3575856407,0
3,587,6277,3575856407,3575856407,0
3,587,6278,3575856407,3575856407,0
3,587,6279,3575856407,3575856408,1
3,587,6280,3575856407,3575856416,9
3,587,6281,3575856407,3575856416,9
3,587,6282,3575856407,3575856416,9
3,587,6283,3575856407,3575856419,12
3,587,6284,3575856407,3575856421,14
3,587,6285,3575856407,3575856422,15
3,587,6286,3575856407,3575856422,15
3,587,6287,3575856407,3575856423,16
3,587,6288,3575856407,3575856426,19
3,587,6289,3575856407,3575856428,21
3,587,6290,3575856407,3575856429,22
3,587,6291,3575856407,3575856431,24
3,587,6292,3575856407,3575856434,27
3,587,6293,3575856407,3575856436,29
3,587,6294,3575856407,3575856437,30
3,587,6295,3575856407,3575856438,31
3,587,6296,3575856407,3575856440,33
3,587,6297,3575856407,3575856440,33
3,587,6298,3575856407,3575856443,36
3,587,6299,3575856407,3575856443,36
3,587,6300,3575856407,3575856446,39
3,587,6301,3575856407,3575856448,41
3,587,6302,3575856407,3575856449,42
3,587,6303,3575856407,3575856450,43
3,587,6304,3575856407,3575856452,45
3,587,6305,3575856407,3575856453,46
3,587,6306,3575856407,3575856454,47
3,587,6307,3575856407,3575856455,48
3,587,6308,3575856407,3575856455,48
3,588,6309,3575856461,3575856461,0
3,588,6310,3575856461,3575856461,0
3,588,6311,3575856461,3575856461,0
3,588,6312,3575856461,3575856462,1
3,588,6313,3575856461,3575856463,2
3,588,6314,3575856461,3575856464,3
3,588,6315,3575856461,3575856464,3
3,588,6316,3575856461,3575856465,4
3,588,6317,3575856461,3575856466,5
3,588,6318,3575856461,3575856469,8
3,588,6319,3575856461,3575856469,8
3,588,6320,3575856461,3575856469,8
3,588,6321,3575856461,3575856477,16
3,588,6322,3575856461,3575856478,17
3,588,6323,3575856461,3575856480,19
3,588,6324,3575856461,3575856480,19
3,588,6325,3575856461,3575856483,22
3,588,6326,3575856461,3575856483,22
3,588,6327,3575856461,3575856487,26
3,588,6328,3575856461,3575856488,27
3,588,6329,3575856461,3575856495,34
3,588,6330,3575856461,3575856497,36
3,588,6331,3575856461,3575856497,36
3,588,6332,3575856461,3575856500,39
3,588,6333,3575856461,3575856500,39
3,588,6334,3575856461,3575856502,41
3,588,6335,3575856461,3575856508,47
3,588,6336,3575856461,3575856509,48
3,589,6337,3575856515,3575856515,0
3,589,6338,3575856515,3575856516,1
3,589,6339,3575856515,3575856516,1
3,589,6340,3575856515,3575856519,4
3,589,6341,3575856515,3575856521,6
3,589,6342,3575856515,3575856526,11
3,589,6343,3575856515,3575856533,18
3,589,6344,3575856515,3575856541,26
3,589,6345,3575856515,3575856542,27
3,589,6346,3575856515,3575856543,28
3,589,6347,3575856515,3575856543,28
3,589,6348,3575856515,3575856543,28
3,589,6349,3575856515,3575856551,36
3,589,6350,3575856515,3575856553,38
3,589,6351,3575856515,3575856560,45
3,589,6352,3575856515,3575856563,48
3,590,6353,3575856569,3575856569,0
3,590,6354,3575856569,3575856569,0
3,590,6355,3575856569,3575856570,1
3,590,6356,3575856569,3575856570,1
3,590,6357,3575856569,3575856573,4
3,590,6358,3575856569,3575856577,8
3,590,6359,3575856569,3575856580,11
3,590,6360,3575856569,3575856581,12
3,590,6361,3575856569,3575856581,12
3,590,6362,3575856569,3575856582,13
3,590,6363,3575856569,3575856584,15
3,590,6364,3575856569,3575856585,16
3,590,6365,3575856569,3575856586,17
3,590,6366,3575856569,3575856586,17
3,590,6367,3575856569,3575856588,19
3,590,6368,3575856569,3575856590,21
3,590,6369,3575856569,3575856593,24
3,590,6370,3575856569,3575856594,25
3,590,6371,3575856569,3575856596,27
3,590,6372,3575856569,3575856596,27
3,590,6373,3575856569,3575856598,29
3,590,6374,3575856569,3575856598,29
3,590,6375,3575856569,3575856601,32
3,590,6376,3575856569,3575856603,34
3,590,6377,3575856569,3575856606,37
3,590,6378,3575856569,3575856606,37
3,590,6379,3575856569,3575856607,38
3,590,6380,3575856569,3575856615,46
3,590,6381,3575856569,3575856615,46
3,590,6382,3575856569,3575856616,47
3,590,6383,3575856569,3575856618,49
3,591,6384,3575856624,3575856624,0
3,591,6385,3575856624,3575856624,0
3,591,6386,3575856624,3575856624,0
3,591,6387,3575856624,3575856624,0
3,591,6388,3575856624,3575856625,1
3,591,6389,3575856624,3575856627,3
3,591,6390,3575856624,3575856628,4
3,591,6391,3575856624,3575856631,7
3,591,6392,3575856624,3575856633,9
3,591,6393,3575856624,3575856635,11
3,591,6394,3575856624,3575856636,12
3,591,6395,3575856624,3575856637,13
3,591,6396,3575856624,3575856639,15
3,591,6397,3575856624,3575856640,16
3,591,6398,3575856624,3575856642,18
3,591,6399,3575856624,3575856642,18
3,591,6400,3575856624,3575856645,21
3,591,6401,3575856624,3575856647,23
3,591,6402,3575856624,3575856649,25
3,591,6403,3575856624,3575856649,25
3,591,6404,3575856624,3575856651,27
3,591,6405,3575856624,3575856652,28
3,591,6406,3575856624,3575856652,28
3,591,6407,3575856624,3575856654,30
3,591,6408,3575856624,3575856654,30
3,591,6409,3575856624,3575856658,34
3,591,6410,3575856624,3575856658,34
3,591,6411,3575856624,3575856659,35
3,591,6412,3575856624,3575856662,38
3,591,6413,3575856624,3575856662,38
3,591,6414,3575856624,3575856662,38
3,591,6415,3575856624,3575856665,41
3,591,6416,3575856624,3575856665,41
3,591,6417,3575856624,3575856668,44
3,591,6418,3575856624,3575856668,44
3,591,6419,3575856624,3575856669,45
3,592,6420,3575856679,3575856679,0
3,592,6421,3575856679,3575856679,0
3,592,6422,3575856679,3575856680,1
3,592,6423,3575856679,3575856681,2
3,592,6424,3575856679,3575856683,4
3,592,6425,3575856679,3575856683,4
3,592,6426,3575856679,3575856686,7
3,592,6427,3575856679,3575856688,9
3,592,6428,3575856679,3575856689,10
3,592,6429,3575856679,3575856697,18
3,592,6430,3575856679,3575856698,19
3,592,6431,3575856679,3575856699,20
3,592,6432,3575856679,3575856701,22
3,592,6433,3575856679,3575856702,23
3,592,6434,3575856679,3575856702,23
3,592,6435,3575856679,3575856708,29
3,592,6436,3575856679,3575856709,30
3,592,6437,3575856679,3575856712,33
3,592,6438,3575856679,3575856716,37
3,592,6439,3575856679,3575856716,37
3,592,6440,3575856679,3575856720,41
3,592,6441,3575856679,3575856720,41
3,592,6442,3575856679,3575856727,48
3,593,6443,3575856733,3575856733,0
3,593,6444,3575856733,3575856736,3
3,593,6445,3575856733,3575856741,8
3,593,6446,3575856733,3575856742,9
3,593,6447,3575856733,3575856743,10
3,593,6448,3575856733,3575856743,10
3,593,6449,3575856733,3575856744,11
3,593,6450,3575856733,3575856751,18
3,593,6451,3575856733,3575856754,21
3,593,6452,3575856733,3575856760,27
3,593,6453,3575856733,3575856762,29
3,593,6454,3575856733,3575856767,34
3,593,6455,3575856733,3575856769,36
3,593,6456,3575856733,3575856769,36
3,593,6457,3575856733,3575856770,37
3,593,6458,3575856733,3575856772,39
3,593,6459,3575856733,3575856778,45
3,593,6460,3575856733,3575856780,47
3,593,6461,3575856733,3575856781,48
3,593,6462,3575856733,3575856781,48
3,593,6463,3575856733,3575856782,49
3,594,6464,3575856788,3575856788,0
3,594,6465,3575856788,3575856788,0
3,594,6466,3575856788,3575856788,0
3,594,6467,3575856788,3575856788,0
3,594,6468,3575856788,3575856789,1
3,594,6469,3575856788,3575856792,4
3,594,6470,3575856788,3575856794,6
3,594,6471,3575856788,3575856795,7
3,594,6472,3575856788,3575856796,8
3,594,6473,3575856788,3575856798,10
3,594,6474,3575856788,3575856799,11
3,594,6475,3575856788,3575856801,13
3,594,6476,3575856788,3575856804,16
3,594,6477,3575856788,3575856804,16
3,594,6478,3575856788,3575856805,17
3,594,6479,3575856788,3575856807,19
3,594,6480,3575856788,3575856807,19
3,594,6481,3575856788,3575856815,27
3,594,6482,3575856788,3575856816,28
3,594,6483,3575856788,3575856816,28
3,594,6484,3575856788,3575856819,31
3,594,6485,3575856788,3575856820,32
3,594,6486,3575856788,3575856820,32
3,594,6487,3575856788,3575856821,33
3,594,6488,3575856788,3575856822,34
3,594,6489,3575856788,3575856823,35
3,594,6490,3575856788,3575856825,37
3,594,6491,3575856788,3575856827,39
3,594,6492,3575856788,3575856831,43
3,594,6493,3575856788,3575856833,45
3,594,6494,3575856788,3575856835,47
3,594,6495,3575856788,3575856836,48
3,594,6496,3575856788,3575856837,49
3,595,6497,3575856842,3575856842,0
3,595,6498,3575856842,3575856842,0
3,595,6499,3575856842,3575856843,1
3,595,6500,3575856842,3575856843,1
3,595,6501,3575856842,3575856843,1
3,595,6502,3575856842,3575856845,3
3,595,6503,3575856842,3575856847,5
3,595,6504,3575856842,3575856849,7
3,595,6505,3575856842,3575856850,8
3,595,6506,3575856842,3575856851,9
3,595,6507,3575856842,3575856852,10
3,595,6508,3575856842,3575856853,11
3,595,6509,3575856842,3575856854,12
3,595,6510,3575856842,3575856855,13
3,595,6511,3575856842,3575856858,16
3,595,6512,3575856842,3575856858,16
3,595,6513,3575856842,3575856859,17
3,595,6514,3575856842,3575856862,20
3,595,6515,3575856842,3575856862,20
3,595,6516,3575856842,3575856863,21
3,595,6517,3575856842,3575856865,23
3,595,6518,3575856842,3575856866,24
3,595,6519,3575856842,3575856868,26
3,595,6520,3575856842,3575856869,27
3,595,6521,3575856842,3575856869,27
3,595,6522,3575856842,3575856877,35
3,595,6523,3575856842,3575856878,36
3,595,6524,3575856842,3575856878,36
3,595,6525,3575856842,3575856880,38
3,595,6526,3575856842,3575856880,38
3,595,6527,3575856842,3575856883,41
3,595,6528,3575856842,3575856884,42
3,595,6529,3575856842,3575856886,44
3,595,6530,3575856842,3575856888,46
3,595,6531,3575856842,3575856890,48
3,596,6532,3575856896,3575856897,1
3,596,6533,3575856896,3575856898,2
3,596,6534,3575856896,3575856900,4
3,596,6535,3575856896,3575856901,5
3,596,6536,3575856896,3575856901,5
3,596,6537,3575856896,3575856902,6
3,596,6538,3575856896,3575856908,12
3,596,6539,3575856896,3575856908,12
3,596,6540,3575856896,3575856909,13
3,596,6541,3575856896,3575856912,16
3,596,6542,3575856896,3575856916,20
3,596,6543,3575856896,3575856917,21
3,596,6544,3575856896,3575856920,24
3,596,6545,3575856896,3575856921,25
3,596,6546,3575856896,3575856926,30
3,596,6547,3575856896,3575856934,38
3,596,6548,3575856896,3575856937,41
3,596,6549,3575856896,3575856940,44
3,596,6550,3575856896,3575856942,46
3,596,6551,3575856896,3575856943,47
3,596,6552,3575856896,3575856943,47
3,596,6553,3575856896,3575856943,47
3,596,6554,3575856896,3575856945,49
3,597,6555,3575856950,3575856954,4
3,597,6556,3575856950,3575856959,9
3,597,6557,3575856950,3575856960,10
3,597,6558,3575856950,3575856963,13
3,597,6559,3575856950,3575856967,17
3,597,6560,3575856950,3575856969,19
3,597,6561,3575856950,3575856970,20
3,597,6562,3575856950,3575856970,20
3,597,6563,3575856950,3575856973,23
3,597,6564,3575856950,3575856978,28
3,597,6565,3575856950,3575856980,30
3,597,6566,3575856950,3575856981,31
3,597,6567,3575856950,3575856982,32
3,597,6568,3575856950,3575856984,34
3,597,6569,3575856950,3575856984,34
3,597,6570,3575856950,3575856986,36
3,597,6571,3575856950,3575856987,37
3,597,6572,3575856950,3575856989,39
3,597,6573,3575856950,3575856991,41
3,597,6574,3575856950,3575856994,44
3,597,6575,3575856950,3575856995,45
3,597,6576,3575856950,3575856996,46
3,597,6577,3575856950,3575856997,47
3,597,6578,3575856950,3575856998,48
3,597,6579,3575856950,3575856998,48
3,597,6580,3575856950,3575856999,49
3,598,6581,3575857004,3575857004,0
3,598,6582,3575857004,3575857004,0
3,598,6583,3575857004,3575857006,2
3,598,6584,3575857004,3575857007,3
3,598,6585,3575857004,3575857007,3
3,598,6586,3575857004,3575857015,11
3,598,6587,3575857004,3575857016,12
3,598,6588,3575857004,3575857020,16
3,598,6589,3575857004,3575857021,17
3,598,6590,3575857004,3575857022,18
3,598,6591,3575857004,3575857022,18
3,598,6592,3575857004,3575857023,19
3,598,6593,3575857004,3575857025,21
3,598,6594,3575857004,3575857027,23
3,598,6595,3575857004,3575857032,28
3,598,6596,3575857004,3575857033,29
3,598,6597,3575857004,3575857035,31
3,598,6598,3575857004,3575857036,32
3,598,6599,3575857004,3575857038,34
3,598,6600,3575857004,3575857039,35
3,598,6601,3575857004,3575857041,37
3,598,6602,3575857004,3575857043,39
3,598,6603,3575857004,3575857043,39
3,598,6604,3575857004,3575857044,40
3,598,6605,3575857004,3575857047,43
3,598,6606,3575857004,3575857049,45
3,598,6607,3575857004,3575857050,46
3,598,6608,3575857004,3575857051,47
3,598,6609,3575857004,3575857052,48
3,598,6610,3575857004,3575857053,49
3,599,6611,3575857058,3575857058,0
3,599,6612,3575857058,3575857058,0
3,599,6613,3575857058,3575857058,0
3,599,6614,3575857058,3575857058,0
3,599,6615,3575857058,3575857060,2
3,599,6616,3575857058,3575857061,3
3,599,6617,3575857058,3575857062,4
3,599,6618,3575857058,3575857064,6
3,599,6619,3575857058,3575857064,6
3,599,6620,3575857058,3575857065,7
3,599,6621,3575857058,3575857066,8
3,599,6622,3575857058,3575857068,10
3,599,6623,3575857058,3575857068,10
3,599,6624,3575857058,3575857069,11
3,599,6625,3575857058,3575857077,19
3,599,6626,3575857058,3575857078,20
3,599,6627,3575857058,3575857080,22
3,599,6628,3575857058,3575857081,23
3,599,6629,3575857058,3575857084,26
3,599,6630,3575857058,3575857084,26
3,599,6631,3575857058,3575857086,28
3,599,6632,3575857058,3575857088,30
3,599,6633,3575857058,3575857089,31
3,599,6634,3575857058,3575857097,39
3,599,6635,3575857058,3575857098,40
3,599,6636,3575857058,3575857100,42
3,599,6637,3575857058,3575857100,42
3,599,6638,3575857058,3575857101,43
3,599,6639,3575857058,3575857102,44
3,599,6640,3575857058,3575857108,50
3,600,6641,3575857112,3575857112,0
3,600,6642,3575857112,3575857113,1
3,600,6643,3575857112,3575857113,1
3,600,6644,3575857112,3575857113,1
3,600,6645,3575857112,3575857118,6
3,600,6646,3575857112,3575857118,6
3,600,6647,3575857112,3575857120,8
3,600,6648,3575857112,3575857121,9
3,600,6649,3575857112,3575857127,15
3,600,6650,3575857112,3575857133,21
3,600,6651,3575857112,3575857137,25
3,600,6652,3575857112,3575857140,28
3,600,6653,3575857112,3575857142,30
3,600,6654,3575857112,3575857142,30
3,600,6655,3575857112,3575857143,31
3,600,6656,3575857112,3575857144,32
3,600,6657,3575857112,3575857145,33
3,600,6658,3575857112,3575857154,42
3,600,6659,3575857112,3575857159,47
3,600,6660,3575857112,3575857161,49
3,600,6661,3575857112,3575857162,50
3,601,6662,3575857168,3575857168,0
3,601,6663,3575857168,3575857170,2
3,601,6664,3575857168,3575857170,2
3,601,6665,3575857168,3575857171,3
3,601,6666,3575857168,3575857172,4
3,601,6667,3575857168,3575857178,10
3,601,6668,3575857168,3575857180,12
3,601,6669,3575857168,3575857181,13
3,601,6670,3575857168,3575857182,14
3,601,6671,3575857168,3575857182,14
3,601,6672,3575857168,3575857184,16
3,601,6673,3575857168,3575857185,17
3,601,6674,3575857168,3575857186,18
3,601,6675,3575857168,3575857188,20
3,601,6676,3575857168,3575857189,21
3,601,6677,3575857168,3575857192,24
3,601,6678,3575857168,3575857193,25
3,601,6679,3575857168,3575857196,28
3,601,6680,3575857168,3575857197,29
3,601,6681,3575857168,3575857198,30
3,601,6682,3575857168,3575857199,31
3,601,6683,3575857168,3575857199,31
3,601,6684,3575857168,3575857200,32
3,601,6685,3575857168,3575857204,36
3,601,6686,3575857168,3575857206,38
3,601,6687,3575857168,3575857207,39
3,601,6688,3575857168,3575857207,39
3,601,6689,3575857168,3575857216,48
3,601,6690,3575857168,3575857216,48
3,601,6691,3575857168,3575857216,48
3,602,6692,3575857223,3575857223,0
3,602,6693,3575857223,3575857223,0
3,602,6694,3575857223,3575857223,0
3,602,6695,3575857223,3575857223,0
3,602,6696,3575857223,3575857223,0
3,602,6697,3575857223,3575857223,0
3,602,6698,3575857223,3575857226,3
3,602,6699,3575857223,3575857230,7
3,602,6700,3575857223,3575857231,8
3,602,6701,3575857223,3575857233,10
3,602,6702,3575857223,3575857235,12
3,602,6703,3575857223,3575857237,14
3,602,6704,3575857223,3575857238,15
3,602,6705,3575857223,3575857239,16
3,602,6706,3575857223,3575857241,18
3,602,6707,3575857223,3575857243,20
3,602,6708,3575857223,3575857243,20
3,602,6709,3575857223,3575857244,21
3,602,6710,3575857223,3575857246,23
3,602,6711,3575857223,3575857248,25
3,602,6712,3575857223,3575857249,26
3,602,6713,3575857223,3575857250,27
3,602,6714,3575857223,3575857251,28
3,602,6715,3575857223,3575857252,29
3,602,6716,3575857223,3575857253,30
3,602,6717,3575857223,3575857254,31
3,602,6718,3575857223,3575857256,33
3,602,6719,3575857223,3575857258,35
3,602,6720,3575857223,3575857259,36
3,602,6721,3575857223,3575857259,36
3,602,6722,3575857223,3575857263,40
3,602,6723,3575857223,3575857263,40
3,602,6724,3575857223,3575857264,41
3,602,6725,3575857223,3575857264,41
3,602,6726,3575857223,3575857265,42
3,602,6727,3575857223,3575857269,46
3,602,6728,3575857223,3575857269,46
3,602,6729,3575857223,3575857270,47
3,603,6730,3575857278,3575857278,0
3,603,6731,3575857278,3575857278,0
3,603,6732,3575857278,3575857281,3
3,603,6733,3575857278,3575857282,4
3,603,6734,3575857278,3575857284,6
3,603,6735,3575857278,3575857284,6
3,603,6736,3575857278,3575857286,8
3,603,6737,3575857278,3575857287,9
3,603,6738,3575857278,3575857290,12
3,603,6739,3575857278,3575857297,19
3,603,6740,3575857278,3575857298,20
3,603,6741,3575857278,3575857301,23
3,603,6742,3575857278,3575857301,23
3,603,6743,3575857278,3575857302,24
3,603,6744,3575857278,3575857308,30
3,603,6745,3575857278,3575857309,31
3,603,6746,3575857278,3575857309,31
3,603,6747,3575857278,3575857312,34
3,603,6748,3575857278,3575857313,35
3,603,6749,3575857278,3575857317,39
3,603,6750,3575857278,3575857318,40
3,603,6751,3575857278,3575857320,42
3,603,6752,3575857278,3575857322,44
3,603,6753,3575857278,3575857327,49
3,604,6754,3575857333,3575857334,1
3,604,6755,3575857333,3575857337,4
3,604,6756,3575857333,3575857342,9
3,604,6757,3575857333,3575857343,10
3,604,6758,3575857333,3575857343,10
3,604,6759,3575857333,3575857344,11
3,604,6760,3575857333,3575857346,13
3,604,6761,3575857333,3575857352,19
3,604,6762,3575857333,3575857354,21
3,604,6763,3575857333,3575857359,26
3,604,6764,3575857333,3575857361,28
3,604,6765,3575857333,3575857364,31
3,604,6766,3575857333,3575857368,35
3,604,6767,3575857333,3575857370,37
3,604,6768,3575857333,3575857370,37
3,604,6769,3575857333,3575857371,38
3,604,6770,3575857333,3575857378,45
3,604,6771,3575857333,3575857381,48
3,604,6772,3575857333,3575857381,48
3,604,6773,3575857333,3575857382,49
3,605,6774,3575857388,3575857388,0
3,605,6775,3575857388,3575857388,0
3,605,6776,3575857388,3575857388,0
3,605,6777,3575857388,3575857388,0
3,605,6778,3575857388,3575857390,2
3,605,6779,3575857388,3575857391,3
3,605,6780,3575857388,3575857393,5
3,605,6781,3575857388,3575857395,7
3,605,6782,3575857388,3575857396,8
3,605,6783,3575857388,3575857397,9
3,605,6784,3575857388,3575857399,11
3,605,6785,3575857388,3575857400,12
3,605,6786,3575857388,3575857400,12
3,605,6787,3575857388,3575857404,16
3,605,6788,3575857388,3575857404,16
3,605,6789,3575857388,3575857405,17
3,605,6790,3575857388,3575857406,18
3,605,6791,3575857388,3575857408,20
3,605,6792,3575857388,3575857416,28
3,605,6793,3575857388,3575857416,28
3,605,6794,3575857388,3575857416,28
3,605,6795,3575857388,3575857419,31
3,605,6796,3575857388,3575857421,33
3,605,6797,3575857388,3575857421,33
3,605,6798,3575857388,3575857422,34
3,605,6799,3575857388,3575857423,35
3,605,6800,3575857388,3575857426,38
3,605,6801,3575857388,3575857431,43
3,605,6802,3575857388,3575857431,43
3,605,6803,3575857388,3575857433,45
3,605,6804,3575857388,3575857436,48
3,605,6805,3575857388,3575857437,49
3,605,6806,3575857388,3575857438,50
3,606,6807,3575857445,3575857445,0
3,606,6808,3575857445,3575857445,0
3,606,6809,3575857445,3575857445,0
3,606,6810,3575857445,3575857445,0
3,606,6811,3575857445,3575857445,0
3,606,6812,3575857445,3575857446,1
3,606,6813,3575857445,3575857448,3
3,606,6814,3575857445,3575857450,5
3,606,6815,3575857445,3575857450,5
3,606,6816,3575857445,3575857451,6
3,606,6817,3575857445,3575857453,8
3,606,6818,3575857445,3575857454,9
3,606,6819,3575857445,3575857455,10
3,606,6820,3575857445,3575857459,14
3,606,6821,3575857445,3575857459,14
3,606,6822,3575857445,3575857459,14
3,606,6823,3575857445,3575857463,18
3,606,6824,3575857445,3575857464,19
3,606,6825,3575857445,3575857464,19
3,606,6826,3575857445,3575857464,19
3,606,6827,3575857445,3575857465,20
3,606,6828,3575857445,3575857469,24
3,606,6829,3575857445,3575857469,24
3,606,6830,3575857445,3575857469,24
3,606,6831,3575857445,3575857477,32
3,606,6832,3575857445,3575857479,34
3,606,6833,3575857445,3575857481,36
3,606,6834,3575857445,3575857482,37
3,606,6835,3575857445,3575857483,38
3,606,6836,3575857445,3575857484,39
3,606,6837,3575857445,3575857486,41
3,606,6838,3575857445,3575857488,43
3,606,6839,3575857445,3575857491,46
3,607,6840,3575857499,3575857499,0
3,607,6841,3575857499,3575857499,0
3,607,6842,3575857499,3575857500,1
3,607,6843,3575857499,3575857500,1
3,607,6844,3575857499,3575857500,1
3,607,6845,3575857499,3575857507,8
3,607,6846,3575857499,3575857507,8
3,607,6847,3575857499,3575857508,9
3,607,6848,3575857499,3575857512,13
3,607,6849,3575857499,3575857512,13
3,607,6850,3575857499,3575857516,17
3,607,6851,3575857499,3575857517,18
3,607,6852,3575857499,3575857518,19
3,607,6853,3575857499,3575857519,20
3,607,6854,3575857499,3575857520,21
3,607,6855,3575857499,3575857526,27
3,607,6856,3575857499,3575857533,34
3,607,6857,3575857499,3575857536,37
3,607,6858,3575857499,3575857541,42
3,607,6859,3575857499,3575857542,43
3,607,6860,3575857499,3575857543,44
3,607,6861,3575857499,3575857543,44
3,607,6862,3575857499,3575857545,46
3,608,6863,3575857553,3575857553,0
3,608,6864,3575857553,3575857553,0
3,608,6865,3575857553,3575857558,5
3,608,6866,3575857553,3575857560,7
3,608,6867,3575857553,3575857562,9
3,608,6868,3575857553,3575857567,14
3,608,6869,3575857553,3575857569,16
3,608,6870,3575857553,3575857570,17
3,608,6871,3575857553,3575857570,17
3,608,6872,3575857553,3575857571,18
3,608,6873,3575857553,3575857571,18
3,608,6874,3575857553,3575857577,24
3,608,6875,3575857553,3575857580,27
3,608,6876,3575857553,3575857581,28
3,608,6877,3575857553,3575857581,28
3,608,6878,3575857553,3575857581,28
3,608,6879,3575857553,3575857583,30
3,608,6880,3575857553,3575857585,32
3,608,6881,3575857553,3575857586,33
3,608,6882,3575857553,3575857586,33
3,608,6883,3575857553,3575857588,35
3,608,6884,3575857553,3575857591,38
3,608,6885,3575857553,3575857593,40
3,608,6886,3575857553,3575857594,41
3,608,6887,3575857553,3575857595,42
3,608,6888,3575857553,3575857596,43
3,608,6889,3575857553,3575857598,45
3,608,6890,3575857553,3575857599,46
3,608,6891,3575857553,3575857599,46
3,608,6892,3575857553,3575857601,48
3,609,6893,3575857608,3575857608,0
3,609,6894,3575857608,3575857608,0
3,609,6895,3575857608,3575857608,0
3,609,6896,3575857608,3575857608,0
3,609,6897,3575857608,3575857615,7
3,609,6898,3575857608,3575857616,8
3,609,6899,3575857608,3575857616,8
3,609,6900,3575857608,3575857618,10
3,609,6901,3575857608,3575857620,12
3,609,6902,3575857608,3575857621,13
3,609,6903,3575857608,3575857625,17
3,609,6904,3575857608,3575857626,18
3,609,6905,3575857608,3575857630,22
3,609,6906,3575857608,3575857630,22
3,609,6907,3575857608,3575857633,25
3,609,6908,3575857608,3575857636,28
3,609,6909,3575857608,3575857637,29
3,609,6910,3575857608,3575857637,29
3,609,6911,3575857608,3575857638,30
3,609,6912,3575857608,3575857639,31
3,609,6913,3575857608,3575857642,34
3,609,6914,3575857608,3575857642,34
3,609,6915,3575857608,3575857644,36
3,609,6916,3575857608,3575857645,37
3,609,6917,3575857608,3575857647,39
3,609,6918,3575857608,3575857649,41
3,609,6919,3575857608,3575857650,42
3,609,6920,3575857608,3575857650,42
3,609,6921,3575857608,3575857651,43
3,609,6922,3575857608,3575857652,44
3,609,6923,3575857608,3575857654,46
3,609,6924,3575857608,3575857657,49
3,610,6925,3575857663,3575857663,0
3,610,6926,3575857663,3575857663,0
3,610,6927,3575857663,3575857663,0
3,610,6928,3575857663,3575857663,0
3,610,6929,3575857663,3575857663,0
3,610,6930,3575857663,3575857665,2
3,610,6931,3575857663,3575857665,2
3,610,6932,3575857663,3575857668,5
3,610,6933,3575857663,3575857669,6
3,610,6934,3575857663,3575857669,6
3,610,6935,3575857663,3575857677,14
3,610,6936,3575857663,3575857679,16
3,610,6937,3575857663,3575857681,18
3,610,6938,3575857663,3575857682,19
3,610,6939,3575857663,3575857683,20
3,610,6940,3575857663,3575857684,21
3,610,6941,3575857663,3575857686,23
3,610,6942,3575857663,3575857688,25
3,610,6943,3575857663,3575857691,28
3,610,6944,3575857663,3575857698,35
3,610,6945,3575857663,3575857698,35
3,610,6946,3575857663,3575857700,37
3,610,6947,3575857663,3575857700,37
3,610,6948,3575857663,3575857700,37
3,610,6949,3575857663,3575857702,39
3,610,6950,3575857663,3575857707,44
3,610,6951,3575857663,3575857708,45
3,610,6952,3575857663,3575857708,45
3,610,6953,3575857663,3575857711,48
3,610,6954,3575857663,3575857712,49
3,611,6955,3575857718,3575857718,0
3,611,6956,3575857718,3575857718,0
3,611,6957,3575857718,3575857718,0
3,611,6958,3575857718,3575857721,3
3,611,6959,3575857718,3575857721,3
3,611,6960,3575857718,3575857726,8
3,611,6961,3575857718,3575857734,16
3,611,6962,3575857718,3575857736,18
3,611,6963,3575857718,3575857741,23
3,611,6964,3575857718,3575857742,24
3,611,6965,3575857718,3575857743,25
3,611,6966,3575857718,3575857744,26
3,611,6967,3575857718,3575857745,27
3,611,6968,3575857718,3575857751,33
3,611,6969,3575857718,3575857754,36
3,611,6970,3575857718,3575857759,41
3,611,6971,3575857718,3575857760,42
3,611,6972,3575857718,3575857763,45
3,611,6973,3575857718,3575857767,49
3,612,6974,3575857775,3575857775,0
3,612,6975,3575857775,3575857775,0
3,612,6976,3575857775,3575857775,0
3,612,6977,3575857775,3575857775,0
3,612,6978,3575857775,3575857775,0
3,612,6979,3575857775,3575857778,3
3,612,6980,3575857775,3575857779,4
3,612,6981,3575857775,3575857780,5
3,612,6982,3575857775,3575857781,6
3,612,6983,3575857775,3575857783,8
3,612,6984,3575857775,3575857784,9
3,612,6985,3575857775,3575857786,11
3,612,6986,3575857775,3575857786,11
3,612,6987,3575857775,3575857789,14
3,612,6988,3575857775,3575857792,17
3,612,6989,3575857775,3575857794,19
3,612,6990,3575857775,3575857795,20
3,612,6991,3575857775,3575857796,21
3,612,6992,3575857775,3575857799,24
3,612,6993,3575857775,3575857799,24
3,612,6994,3575857775,3575857799,24
3,612,6995,3575857775,3575857801,26
3,612,6996,3575857775,3575857803,28
3,612,6997,3575857775,3575857804,29
3,612,6998,3575857775,3575857806,31
3,612,6999,3575857775,3575857807,32
3,612,7000,3575857775,3575857807,32
3,612,7001,3575857775,3575857815,40
3,612,7002,3575857775,3575857816,41
3,612,7003,3575857775,3575857816,41
3,612,7004,3575857775,3575857819,44
3,612,7005,3575857775,3575857820,45
3,612,7006,3575857775,3575857821,46
3,612,7007,3575857775,3575857821,46
3,613,7008,3575857830,3575857830,0
3,613,7009,3575857830,3575857830,0
3,613,7010,3575857830,3575857831,1
3,613,7011,3575857830,3575857833,3
3,613,7012,3575857830,3575857836,6
3,613,7013,3575857830,3575857836,6
3,613,7014,3575857830,3575857837,7
3,613,7015,3575857830,3575857838,8
3,613,7016,3575857830,3575857840,10
3,613,7017,3575857830,3575857842,12
3,613,7018,3575857830,3575857843,13
3,613,7019,3575857830,3575857843,13
3,613,7020,3575857830,3575857846,16
3,613,7021,3575857830,3575857847,17
3,613,7022,3575857830,3575857849,19
3,613,7023,3575857830,3575857849,19
3,613,7024,3575857830,3575857850,20
3,613,7025,3575857830,3575857852,22
3,613,7026,3575857830,3575857853,23
3,613,7027,3575857830,3575857854,24
3,613,7028,3575857830,3575857855,25
3,613,7029,3575857830,3575857857,27
3,613,7030,3575857830,3575857860,30
3,613,7031,3575857830,3575857862,32
3,613,7032,3575857830,3575857863,33
3,613,7033,3575857830,3575857863,33
3,613,7034,3575857830,3575857864,34
3,613,7035,3575857830,3575857866,36
3,613,7036,3575857830,3575857867,37
3,613,7037,3575857830,3575857868,38
3,613,7038,3575857830,3575857868,38
3,613,7039,3575857830,3575857869,39
3,613,7040,3575857830,3575857879,49
3,614,7041,3575857885,3575857885,0
3,614,7042,3575857885,3575857885,0
3,614,7043,3575857885,3575857885,0
3,614,7044,3575857885,3575857885,0
3,614,7045,3575857885,3575857886,1
3,614,7046,3575857885,3575857888,3
3,614,7047,3575857885,3575857891,6
3,614,7048,3575857885,3575857898,13
3,614,7049,3575857885,3575857899,14
3,614,7050,3575857885,3575857900,15
3,614,7051,3575857885,3575857900,15
3,614,7052,3575857885,3575857901,16
3,614,7053,3575857885,3575857902,17
3,614,7054,3575857885,3575857907,22
3,614,7055,3575857885,3575857908,23
3,614,7056,3575857885,3575857908,23
3,614,7057,3575857885,3575857912,27
3,614,7058,3575857885,3575857912,27
3,614,7059,3575857885,3575857917,32
3,614,7060,3575857885,3575857917,32
3,614,7061,3575857885,3575857918,33
3,614,7062,3575857885,3575857921,36
3,614,7063,3575857885,3575857921,36
3,614,7064,3575857885,3575857926,41
3,614,7065,3575857885,3575857934,49
3,615,7066,3575857940,3575857940,0
3,615,7067,3575857940,3575857941,1
3,615,7068,3575857940,3575857943,3
3,615,7069,3575857940,3575857943,3
3,615,7070,3575857940,3575857945,5
3,615,7071,3575857940,3575857954,14
3,615,7072,3575857940,3575857958,18
3,615,7073,3575857940,3575857960,20
3,615,7074,3575857940,3575857963,23
3,615,7075,3575857940,3575857967,27
3,615,7076,3575857940,3575857969,29
3,615,7077,3575857940,3575857970,30
3,615,7078,3575857940,3575857970,30
3,615,7079,3575857940,3575857971,31
3,615,7080,3575857940,3575857973,33
3,615,7081,3575857940,3575857978,38
3,615,7082,3575857940,3575857978,38
3,615,7083,3575857940,3575857981,41
3,615,7084,3575857940,3575857981,41
3,615,7085,3575857940,3575857981,41
3,615,7086,3575857940,3575857982,42
3,615,7087,3575857940,3575857983,43
3,615,7088,3575857940,3575857985,45
3,615,7089,3575857940,3575857986,46
3,615,7090,3575857940,3575857987,47
3,615,7091,3575857940,3575857990,50
3,616,7092,3575857995,3575857995,0
3,616,7093,3575857995,3575857995,0
3,616,7094,3575857995,3575857995,0
3,616,7095,3575857995,3575857997,2
3,616,7096,3575857995,3575857999,4
3,616,7097,3575857995,3575857999,4
3,616,7098,3575857995,3575858000,5
3,616,7099,3575857995,3575858001,6
3,616,7100,3575857995,3575858003,8
3,616,7101,3575857995,3575858004,9
3,616,7102,3575857995,3575858007,12
3,616,7103,3575857995,3575858007,12
3,616,7104,3575857995,3575858007,12
3,616,7105,3575857995,3575858015,20
3,616,7106,3575857995,3575858015,20
3,616,7107,3575857995,3575858017,22
3,616,7108,3575857995,3575858019,24
3,616,7109,3575857995,3575858020,25
3,616,7110,3575857995,3575858021,26
3,616,7111,3575857995,3575858021,26
3,616,7112,3575857995,3575858026,31
3,616,7113,3575857995,3575858026,31
3,616,7114,3575857995,3575858029,34
3,616,7115,3575857995,3575858030,35
3,616,7116,3575857995,3575858031,36
3,616,7117,3575857995,3575858033,38
3,616,7118,3575857995,3575858036,41
3,616,7119,3575857995,3575858036,41
3,616,7120,3575857995,3575858038,43
3,616,7121,3575857995,3575858038,43
3,616,7122,3575857995,3575858039,44
3,616,7123,3575857995,3575858042,47
3,617,7124,3575858049,3575858050,1
3,617,7125,3575858049,3575858050,1
3,617,7126,3575858049,3575858050,1
3,617,7127,3575858049,3575858050,1
3,617,7128,3575858049,3575858050,1
3,617,7129,3575858049,3575858053,4
3,617,7130,3575858049,3575858053,4
3,617,7131,3575858049,3575858054,5
3,617,7132,3575858049,3575858054,5
3,617,7133,3575858049,3575858057,8
3,617,7134,3575858049,3575858061,12
3,617,7135,3575858049,3575858061,12
3,617,7136,3575858049,3575858063,14
3,617,7137,3575858049,3575858063,14
3,617,7138,3575858049,3575858064,15
3,617,7139,3575858049,3575858065,16
3,617,7140,3575858049,3575858066,17
3,617,7141,3575858049,3575858069,20
3,617,7142,3575858049,3575858069,20
3,617,7143,3575858049,3575858079,30
3,617,7144,3575858049,3575858081,32
3,617,7145,3575858049,3575858082,33
3,617,7146,3575858049,3575858083,34
3,617,7147,3575858049,3575858085,36
3,617,7148,3575858049,3575858086,37
3,617,7149,3575858049,3575858088,39
3,617,7150,3575858049,3575858092,43
3,617,7151,3575858049,3575858098,49
3,617,7152,3575858049,3575858098,49
3,618,7153,3575858104,3575858104,0
3,618,7154,3575858104,3575858104,0
3,618,7155,3575858104,3575858104,0
3,618,7156,3575858104,3575858104,0
3,618,7157,3575858104,3575858107,3
3,618,7158,3575858104,3575858107,3
3,618,7159,3575858104,3575858108,4
3,618,7160,3575858104,3575858112,8
3,618,7161,3575858104,3575858113,9
3,618,7162,3575858104,3575858117,13
3,618,7163,3575858104,3575858118,14
3,618,7164,3575858104,3575858118,14
3,618,7165,3575858104,3575858120,16
3,618,7166,3575858104,3575858120,16
3,618,7167,3575858104,3575858127,23
3,618,7168,3575858104,3575858135,31
3,618,7169,3575858104,3575858138,34
3,618,7170,3575858104,3575858141,37
3,618,7171,3575858104,3575858143,39
3,618,7172,3575858104,3575858143,39
3,618,7173,3575858104,3575858144,40
3,618,7174,3575858104,3575858145,41
3,618,7175,3575858104,3575858154,50
3,619,7176,3575858158,3575858159,1
3,619,7177,3575858158,3575858161,3
3,619,7178,3575858158,3575858163,5
3,619,7179,3575858158,3575858168,10
3,619,7180,3575858158,3575858169,11
3,619,7181,3575858158,3575858170,12
3,619,7182,3575858158,3575858171,13
3,619,7183,3575858158,3575858171,13
3,619,7184,3575858158,3575858178,20
3,619,7185,3575858158,3575858178,20
3,619,7186,3575858158,3575858180,22
3,619,7187,3575858158,3575858181,23
3,619,7188,3575858158,3575858182,24
3,619,7189,3575858158,3575858182,24
3,619,7190,3575858158,3575858184,26
3,619,7191,3575858158,3575858185,27
3,619,7192,3575858158,3575858185,27
3,619,7193,3575858158,3575858191,33
3,619,7194,3575858158,3575858192,34
3,619,7195,3575858158,3575858195,37
3,619,7196,3575858158,3575858195,37
3,619,7197,3575858158,3575858197,39
3,619,7198,3575858158,3575858199,41
3,619,7199,3575858158,3575858199,41
3,619,7200,3575858158,3575858200,42
3,619,7201,3575858158,3575858201,43
3,619,7202,3575858158,3575858203,45
3,619,7203,3575858158,3575858207,49
3,619,7204,3575858158,3575858207,49
3,619,7205,3575858158,3575858208,50
3,620,7206,3575858212,3575858216,4
3,620,7207,3575858212,3575858216,4
3,620,7208,3575858212,3575858217,5
3,620,7209,3575858212,3575858219,7
3,620,7210,3575858212,3575858220,8
3,620,7211,3575858212,3575858221,9
3,620,7212,3575858212,3575858222,10
3,620,7213,3575858212,3575858222,10
3,620,7214,3575858212,3575858225,13
3,620,7215,3575858212,3575858226,14
3,620,7216,3575858212,3575858229,17
3,620,7217,3575858212,3575858230,18
3,620,7218,3575858212,3575858232,20
3,620,7219,3575858212,3575858236,24
3,620,7220,3575858212,3575858237,25
3,620,7221,3575858212,3575858238,26
3,620,7222,3575858212,3575858238,26
3,620,7223,3575858212,3575858241,29
3,620,7224,3575858212,3575858242,30
3,620,7225,3575858212,3575858246,34
3,620,7226,3575858212,3575858248,36
3,620,7227,3575858212,3575858249,37
3,620,7228,3575858212,3575858250,38
3,620,7229,3575858212,3575858250,38
3,620,7230,3575858212,3575858253,41
3,620,7231,3575858212,3575858256,44
3,620,7232,3575858212,3575858257,45
3,620,7233,3575858212,3575858262,50
3,621,7234,3575858267,3575858267,0
3,621,7235,3575858267,3575858267,0
3,621,7236,3575858267,3575858267,0
3,621,7237,3575858267,3575858267,0
3,621,7238,3575858267,3575858267,0
3,621,7239,3575858267,3575858267,0
3,621,7240,3575858267,3575858269,2
3,621,7241,3575858267,3575858269,2
3,621,7242,3575858267,3575858277,10
3,621,7243,3575858267,3575858279,12
3,621,7244,3575858267,3575858281,14
3,621,7245,3575858267,3575858282,15
3,621,7246,3575858267,3575858283,16
3,621,7247,3575858267,3575858284,17
3,621,7248,3575858267,3575858286,19
3,621,7249,3575858267,3575858288,21
3,621,7250,3575858267,3575858291,24
3,621,7251,3575858267,3575858298,31
3,621,7252,3575858267,3575858299,32
3,621,7253,3575858267,3575858300,33
3,621,7254,3575858267,3575858300,33
3,621,7255,3575858267,3575858303,36
3,621,7256,3575858267,3575858304,37
3,621,7257,3575858267,3575858307,40
3,621,7258,3575858267,3575858308,41
3,621,7259,3575858267,3575858309,42
3,621,7260,3575858267,3575858312,45
3,621,7261,3575858267,3575858313,46
3,621,7262,3575858267,3575858317,50
3,622,7263,3575858321,3575858321,0
3,622,7264,3575858321,3575858321,0
3,622,7265,3575858321,3575858321,0
3,622,7266,3575858321,3575858322,1
3,622,7267,3575858321,3575858326,5
3,622,7268,3575858321,3575858335,14
3,622,7269,3575858321,3575858338,17
3,622,7270,3575858321,3575858341,20
3,622,7271,3575858321,3575858342,21
3,622,7272,3575858321,3575858344,23
3,622,7273,3575858321,3575858346,25
3,622,7274,3575858321,3575858352,31
3,622,7275,3575858321,3575858354,33
3,622,7276,3575858321,3575858361,40
3,622,7277,3575858321,3575858364,43
3,622,7278,3575858321,3575858368,47
3,622,7279,3575858321,3575858369,48
3,622,7280,3575858321,3575858370,49
3,622,7281,3575858321,3575858371,50
3,623,7282,3575858375,3575858375,0
3,623,7283,3575858375,3575858375,0
3,623,7284,3575858375,3575858378,3
3,623,7285,3575858375,3575858381,6
3,623,7286,3575858375,3575858381,6
3,623,7287,3575858375,3575858381,6
3,623,7288,3575858375,3575858382,7
3,623,7289,3575858375,3575858382,7
3,623,7290,3575858375,3575858384,9
3,623,7291,3575858375,3575858385,10
3,623,7292,3575858375,3575858387,12
3,623,7293,3575858375,3575858387,12
3,623,7294,3575858375,3575858391,16
3,623,7295,3575858375,3575858391,16
3,623,7296,3575858375,3575858392,17
3,623,7297,3575858375,3575858394,19
3,623,7298,3575858375,3575858395,20
3,623,7299,3575858375,3575858397,22
3,623,7300,3575858375,3575858399,24
3,623,7301,3575858375,3575858399,24
3,623,7302,3575858375,3575858400,25
3,623,7303,3575858375,3575858401,26
3,623,7304,3575858375,3575858403,28
3,623,7305,3575858375,3575858404,29
3,623,7306,3575858375,3575858407,32
3,623,7307,3575858375,3575858408,33
3,623,7308,3575858375,3575858408,33
3,623,7309,3575858375,3575858416,41
3,623,7310,3575858375,3575858416,41
3,623,7311,3575858375,3575858417,42
3,623,7312,3575858375,3575858420,45
3,623,7313,3575858375,3575858421,46
3,623,7314,3575858375,3575858422,47
3,623,7315,3575858375,3575858424,49
3,624,7316,3575858429,3575858429,0
3,624,7317,3575858429,3575858429,0
3,624,7318,3575858429,3575858430,1
3,624,7319,3575858429,3575858430,1
3,624,7320,3575858429,3575858432,3
3,624,7321,3575858429,3575858433,4
3,624,7322,3575858429,3575858436,7
3,624,7323,3575858429,3575858438,9
3,624,7324,3575858429,3575858438,9
3,624,7325,3575858429,3575858438,9
3,624,7326,3575858429,3575858439,10
3,624,7327,3575858429,3575858441,12
3,624,7328,3575858429,3575858443,14
3,624,7329,3575858429,3575858443,14
3,624,7330,3575858429,3575858445,16
3,624,7331,3575858429,3575858446,17
3,624,7332,3575858429,3575858448,19
3,624,7333,3575858429,3575858449,20
3,624,7334,3575858429,3575858450,21
3,624,7335,3575858429,3575858454,25
3,624,7336,3575858429,3575858455,26
3,624,7337,3575858429,3575858458,29
3,624,7338,3575858429,3575858462,33
3,624,7339,3575858429,3575858462,33
3,624,7340,3575858429,3575858464,35
3,624,7341,3575858429,3575858465,36
3,624,7342,3575858429,3575858466,37
3,624,7343,3575858429,3575858467,38
3,624,7344,3575858429,3575858469,40
3,624,7345,3575858429,3575858469,40
3,624,7346,3575858429,3575858477,48
3,625,7347,3575858484,3575858484,0
3,625,7348,3575858484,3575858484,0
3,625,7349,3575858484,3575858484,0
3,625,7350,3575858484,3575858484,0
3,625,7351,3575858484,3575858484,0
3,625,7352,3575858484,3575858485,1
3,625,7353,3575858484,3575858487,3
3,625,7354,3575858484,3575858491,7
3,625,7355,3575858484,3575858497,13
3,625,7356,3575858484,3575858497,13
3,625,7357,3575858484,3575858500,16
3,625,7358,3575858484,3575858500,16
3,625,7359,3575858484,3575858502,18
3,625,7360,3575858484,3575858503,19
3,625,7361,3575858484,3575858506,22
3,625,7362,3575858484,3575858508,24
3,625,7363,3575858484,3575858511,27
3,625,7364,3575858484,3575858512,28
3,625,7365,3575858484,3575858516,32
3,625,7366,3575858484,3575858517,33
3,625,7367,3575858484,3575858517,33
3,625,7368,3575858484,3575858519,35
3,625,7369,3575858484,3575858521,37
3,625,7370,3575858484,3575858526,42
3,626,7371,3575858539,3575858539,0
3,626,7372,3575858539,3575858539,0
3,626,7373,3575858539,3575858539,0
3,626,7374,3575858539,3575858541,2
3,626,7375,3575858539,3575858542,3
3,626,7376,3575858539,3575858543,4
3,626,7377,3575858539,3575858544,5
3,626,7378,3575858539,3575858551,12
3,626,7379,3575858539,3575858553,14
3,626,7380,3575858539,3575858563,24
3,626,7381,3575858539,3575858567,28
3,626,7382,3575858539,3575858569,30
3,626,7383,3575858539,3575858570,31
3,626,7384,3575858539,3575858570,31
3,626,7385,3575858539,3575858570,31
3,626,7386,3575858539,3575858572,33
3,626,7387,3575858539,3575858577,38
3,626,7388,3575858539,3575858577,38
3,626,7389,3575858539,3575858580,41
3,626,7390,3575858539,3575858580,41
3,626,7391,3575858539,3575858581,42
3,626,7392,3575858539,3575858581,42
3,626,7393,3575858539,3575858582,43
3,626,7394,3575858539,3575858584,45
3,626,7395,3575858539,3575858586,47
3,626,7396,3575858539,3575858586,47
3,627,7397,3575858594,3575858594,0
3,627,7398,3575858594,3575858594,0
3,627,7399,3575858594,3575858594,0
3,627,7400,3575858594,3575858595,1
3,627,7401,3575858594,3575858596,2
3,627,7402,3575858594,3575858598,4
3,627,7403,3575858594,3575858599,5
3,627,7404,3575858594,3575858599,5
3,627,7405,3575858594,3575858600,6
3,627,7406,3575858594,3575858601,7
3,627,7407,3575858594,3575858606,12
3,627,7408,3575858594,3575858607,13
3,627,7409,3575858594,3575858608,14
3,627,7410,3575858594,3575858615,21
3,627,7411,3575858594,3575858616,22
3,627,7412,3575858594,3575858616,22
3,627,7413,3575858594,3575858618,24
3,627,7414,3575858594,3575858619,25
3,627,7415,3575858594,3575858620,26
3,627,7416,3575858594,3575858621,27
3,627,7417,3575858594,3575858622,28
3,627,7418,3575858594,3575858626,32
3,627,7419,3575858594,3575858626,32
3,627,7420,3575858594,3575858629,35
3,627,7421,3575858594,3575858629,35
3,627,7422,3575858594,3575858632,38
3,627,7423,3575858594,3575858635,41
3,627,7424,3575858594,3575858636,42
3,627,7425,3575858594,3575858637,43
3,627,7426,3575858594,3575858638,44
3,627,7427,3575858594,3575858638,44
3,627,7428,3575858594,3575858641,47
3,627,7429,3575858594,3575858642,48
3,627,7430,3575858594,3575858643,49
3,627,7431,3575858594,3575858643,49
3,628,7432,3575858649,3575858649,0
3,628,7433,3575858649,3575858649,0
3,628,7434,3575858649,3575858649,0
3,628,7435,3575858649,3575858649,0
3,628,7436,3575858649,3575858650,1
3,628,7437,3575858649,3575858652,3
3,628,7438,3575858649,3575858654,5
3,628,7439,3575858649,3575858655,6
3,628,7440,3575858649,3575858657,8
3,628,7441,3575858649,3575858660,11
3,628,7442,3575858649,3575858661,12
3,628,7443,3575858649,3575858662,13
3,628,7444,3575858649,3575858663,14
3,628,7445,3575858649,3575858664,15
3,628,7446,3575858649,3575858665,16
3,628,7447,3575858649,3575858666,17
3,628,7448,3575858649,3575858668,19
3,628,7449,3575858649,3575858668,19
3,628,7450,3575858649,3575858669,20
3,628,7451,3575858649,3575858679,30
3,628,7452,3575858649,3575858680,31
3,628,7453,3575858649,3575858681,32
3,628,7454,3575858649,3575858683,34
3,628,7455,3575858649,3575858684,35
3,628,7456,3575858649,3575858685,36
3,628,7457,3575858649,3575858687,38
3,628,7458,3575858649,3575858691,42
3,628,7459,3575858649,3575858697,48
3,628,7460,3575858649,3575858697,48
3,629,7461,3575858704,3575858704,0
3,629,7462,3575858704,3575858704,0
3,629,7463,3575858704,3575858704,0
3,629,7464,3575858704,3575858704,0
3,629,7465,3575858704,3575858707,3
3,629,7466,3575858704,3575858707,3
3,629,7467,3575858704,3575858708,4
3,629,7468,3575858704,3575858710,6
3,629,7469,3575858704,3575858713,9
3,629,7470,3575858704,3575858716,12
3,629,7471,3575858704,3575858717,13
3,629,7472,3575858704,3575858717,13
3,629,7473,3575858704,3575858721,17
3,629,7474,3575858704,3575858721,17
3,629,7475,3575858704,3575858726,22
3,629,7476,3575858704,3575858735,31
3,629,7477,3575858704,3575858737,33
3,629,7478,3575858704,3575858738,34
3,629,7479,3575858704,3575858741,37
3,629,7480,3575858704,3575858742,38
3,629,7481,3575858704,3575858743,39
3,629,7482,3575858704,3575858745,41
3,629,7483,3575858704,3575858745,41
3,629,7484,3575858704,3575858751,47
3,630,7485,3575858759,3575858759,0
3,630,7486,3575858759,3575858760,1
3,630,7487,3575858759,3575858762,3
3,630,7488,3575858759,3575858767,8
3,630,7489,3575858759,3575858768,9
3,630,7490,3575858759,3575858770,11
3,630,7491,3575858759,3575858770,11
3,630,7492,3575858759,3575858770,11
3,630,7493,3575858759,3575858773,14
3,630,7494,3575858759,3575858777,18
3,630,7495,3575858759,3575858778,19
3,630,7496,3575858759,3575858780,21
3,630,7497,3575858759,3575858781,22
3,630,7498,3575858759,3575858781,22
3,630,7499,3575858759,3575858781,22
3,630,7500,3575858759,3575858782,23
3,630,7501,3575858759,3575858783,24
3,630,7502,3575858759,3575858785,26
3,630,7503,3575858759,3575858785,26
3,630,7504,3575858759,3575858787,28
3,630,7505,3575858759,3575858792,33
3,630,7506,3575858759,3575858793,34
3,630,7507,3575858759,3575858793,34
3,630,7508,3575858759,3575858794,35
3,630,7509,3575858759,3575858795,36
3,630,7510,3575858759,3575858798,39
3,630,7511,3575858759,3575858799,40
3,630,7512,3575858759,3575858800,41
3,630,7513,3575858759,3575858801,42
3,630,7514,3575858759,3575858803,44
3,630,7515,3575858759,3575858804,45
3,630,7516,3575858759,3575858806,47
3,630,7517,3575858759,3575858807,48
3,630,7518,3575858759,3575858808,49
3,631,7519,3575858814,3575858815,1
3,631,7520,3575858814,3575858816,2
3,631,7521,3575858814,3575858816,2
3,631,7522,3575858814,3575858820,6
3,631,7523,3575858814,3575858820,6
3,631,7524,3575858814,3575858820,6
3,631,7525,3575858814,3575858821,7
3,631,7526,3575858814,3575858822,8
3,631,7527,3575858814,3575858826,12
3,631,7528,3575858814,3575858826,12
3,631,7529,3575858814,3575858828,14
3,631,7530,3575858814,3575858829,15
3,631,7531,3575858814,3575858832,18
3,631,7532,3575858814,3575858835,21
3,631,7533,3575858814,3575858837,23
3,631,7534,3575858814,3575858837,23
3,631,7535,3575858814,3575858839,25
3,631,7536,3575858814,3575858841,27
3,631,7537,3575858814,3575858842,28
3,631,7538,3575858814,3575858843,29
3,631,7539,3575858814,3575858844,30
3,631,7540,3575858814,3575858845,31
3,631,7541,3575858814,3575858847,33
3,631,7542,3575858814,3575858849,35
3,631,7543,3575858814,3575858849,35
3,631,7544,3575858814,3575858850,36
3,631,7545,3575858814,3575858851,37
3,631,7546,3575858814,3575858854,40
3,631,7547,3575858814,3575858855,41
3,631,7548,3575858814,3575858857,43
3,631,7549,3575858814,3575858861,47
3,631,7550,3575858814,3575858862,48
3,631,7551,3575858814,3575858864,50
3,632,7552,3575858870,3575858870,0
3,632,7553,3575858870,3575858870,0
3,632,7554,3575858870,3575858870,0
3,632,7555,3575858870,3575858870,0
3,632,7556,3575858870,3575858870,0
3,632,7557,3575858870,3575858870,0
3,632,7558,3575858870,3575858875,5
3,632,7559,3575858870,3575858877,7
3,632,7560,3575858870,3575858879,9
3,632,7561,3575858870,3575858881,11
3,632,7562,3575858870,3575858881,11
3,632,7563,3575858870,3575858883,13
3,632,7564,3575858870,3575858884,14
3,632,7565,3575858870,3575858885,15
3,632,7566,3575858870,3575858888,18
3,632,7567,3575858870,3575858891,21
3,632,7568,3575858870,3575858897,27
3,632,7569,3575858870,3575858897,27
3,632,7570,3575858870,3575858899,29
3,632,7571,3575858870,3575858900,30
3,632,7572,3575858870,3575858902,32
3,632,7573,3575858870,3575858903,33
3,632,7574,3575858870,3575858906,36
3,632,7575,3575858870,3575858907,37
3,632,7576,3575858870,3575858907,37
3,632,7577,3575858870,3575858912,42
3,632,7578,3575858870,3575858913,43
3,632,7579,3575858870,3575858917,47
3,632,7580,3575858870,3575858917,47
3,632,7581,3575858870,3575858917,47
3,632,7582,3575858870,3575858920,50
3,633,7583,3575858926,3575858926,0
3,633,7584,3575858926,3575858926,0
3,633,7585,3575858926,3575858935,9
3,633,7586,3575858926,3575858937,11
3,633,7587,3575858926,3575858938,12
3,633,7588,3575858926,3575858941,15
3,633,7589,3575858926,3575858943,17
3,633,7590,3575858926,3575858943,17
3,633,7591,3575858926,3575858943,17
3,633,7592,3575858926,3575858944,18
3,633,7593,3575858926,3575858944,18
3,633,7594,3575858926,3575858951,25
3,633,7595,3575858926,3575858954,28
3,633,7596,3575858926,3575858958,32
3,633,7597,3575858926,3575858960,34
3,633,7598,3575858926,3575858962,36
3,633,7599,3575858926,3575858968,42
3,633,7600,3575858926,3575858968,42
3,633,7601,3575858926,3575858970,44
3,633,7602,3575858926,3575858970,44
3,633,7603,3575858926,3575858970,44
3,633,7604,3575858926,3575858973,47
3,634,7605,3575858981,3575858981,0
3,634,7606,3575858981,3575858981,0
3,634,7607,3575858981,3575858981,0
3,634,7608,3575858981,3575858982,1
3,634,7609,3575858981,3575858982,1
3,634,7610,3575858981,3575858983,2
3,634,7611,3575858981,3575858983,2
3,634,7612,3575858981,3575858984,3
3,634,7613,3575858981,3575858985,4
3,634,7614,3575858981,3575858987,6
3,634,7615,3575858981,3575858992,11
3,634,7616,3575858981,3575858993,12
3,634,7617,3575858981,3575858994,13
3,634,7618,3575858981,3575858995,14
3,634,7619,3575858981,3575858997,16
3,634,7620,3575858981,3575858998,17
3,634,7621,3575858981,3575859000,19
3,634,7622,3575858981,3575859001,20
3,634,7623,3575858981,3575859003,22
3,634,7624,3575858981,3575859006,25
3,634,7625,3575858981,3575859008,27
3,634,7626,3575858981,3575859008,27
3,634,7627,3575858981,3575859016,35
3,634,7628,3575858981,3575859016,35
3,634,7629,3575858981,3575859016,35
3,634,7630,3575858981,3575859020,39
3,634,7631,3575858981,3575859021,40
3,634,7632,3575858981,3575859022,41
3,634,7633,3575858981,3575859026,45
3,634,7634,3575858981,3575859026,45
3,634,7635,3575858981,3575859028,47
3,634,7636,3575858981,3575859028,47
3,635,7637,3575859035,3575859035,0
3,635,7638,3575859035,3575859036,1
3,635,7639,3575859035,3575859037,2
3,635,7640,3575859035,3575859038,3
3,635,7641,3575859035,3575859039,4
3,635,7642,3575859035,3575859041,6
3,635,7643,3575859035,3575859043,8
3,635,7644,3575859035,3575859043,8
3,635,7645,3575859035,3575859047,12
3,635,7646,3575859035,3575859049,14
3,635,7647,3575859035,3575859049,14
3,635,7648,3575859035,3575859050,15
3,635,7649,3575859035,3575859055,20
3,635,7650,3575859035,3575859055,20
3,635,7651,3575859035,3575859057,22
3,635,7652,3575859035,3575859061,26
3,635,7653,3575859035,3575859061,26
3,635,7654,3575859035,3575859063,28
3,635,7655,3575859035,3575859064,29
3,635,7656,3575859035,3575859064,29
3,635,7657,3575859035,3575859067,32
3,635,7658,3575859035,3575859068,33
3,635,7659,3575859035,3575859068,33
3,635,7660,3575859035,3575859069,34
3,635,7661,3575859035,3575859069,34
3,635,7662,3575859035,3575859076,41
3,635,7663,3575859035,3575859077,42
3,635,7664,3575859035,3575859079,44
3,635,7665,3575859035,3575859081,46
3,635,7666,3575859035,3575859081,46
3,635,7667,3575859035,3575859083,48
3,635,7668,3575859035,3575859084,49
3,636,7669,3575859090,3575859090,0
3,636,7670,3575859090,3575859090,0
3,636,7671,3575859090,3575859091,1
3,636,7672,3575859090,3575859097,7
3,636,7673,3575859090,3575859097,7
3,636,7674,3575859090,3575859100,10
3,636,7675,3575859090,3575859100,10
3,636,7676,3575859090,3575859103,13
3,636,7677,3575859090,3575859103,13
3,636,7678,3575859090,3575859107,17
3,636,7679,3575859090,3575859107,17
3,636,7680,3575859090,3575859109,19
3,636,7681,3575859090,3575859111,21
3,636,7682,3575859090,3575859113,23
3,636,7683,3575859090,3575859117,27
3,636,7684,3575859090,3575859117,27
3,636,7685,3575859090,3575859119,29
3,636,7686,3575859090,3575859120,30
3,636,7687,3575859090,3575859121,31
3,636,7688,3575859090,3575859126,36
3,636,7689,3575859090,3575859135,45
3,636,7690,3575859090,3575859137,47
3,636,7691,3575859090,3575859137,47
3,637,7692,3575859145,3575859145,0
3,637,7693,3575859145,3575859145,0
3,637,7694,3575859145,3575859145,0
3,637,7695,3575859145,3575859145,0
3,637,7696,3575859145,3575859150,5
3,637,7697,3575859145,3575859154,9
3,637,7698,3575859145,3575859160,15
3,637,7699,3575859145,3575859161,16
3,637,7700,3575859145,3575859163,18
3,637,7701,3575859145,3575859168,23
3,637,7702,3575859145,3575859168,23
3,637,7703,3575859145,3575859170,25
3,637,7704,3575859145,3575859170,25
3,637,7705,3575859145,3575859170,25
3,637,7706,3575859145,3575859173,28
3,637,7707,3575859145,3575859177,32
3,637,7708,3575859145,3575859181,36
3,637,7709,3575859145,3575859181,36
3,637,7710,3575859145,3575859181,36
3,637,7711,3575859145,3575859182,37
3,637,7712,3575859145,3575859184,39
3,637,7713,3575859145,3575859184,39
3,637,7714,3575859145,3575859185,40
3,637,7715,3575859145,3575859186,41
3,637,7716,3575859145,3575859192,47
3,637,7717,3575859145,3575859192,47
3,637,7718,3575859145,3575859193,48
3,638,7719,3575859200,3575859200,0
3,638,7720,3575859200,3575859200,0
3,638,7721,3575859200,3575859200,0
3,638,7722,3575859200,3575859200,0
3,638,7723,3575859200,3575859200,0
3,638,7724,3575859200,3575859201,1
3,638,7725,3575859200,3575859201,1
3,638,7726,3575859200,3575859203,3
3,638,7727,3575859200,3575859204,4
3,638,7728,3575859200,3575859206,6
3,638,7729,3575859200,3575859209,9
3,638,7730,3575859200,3575859209,9
3,638,7731,3575859200,3575859216,16
3,638,7732,3575859200,3575859216,16
3,638,7733,3575859200,3575859216,16
3,638,7734,3575859200,3575859220,20
3,638,7735,3575859200,3575859220,20
3,638,7736,3575859200,3575859220,20
3,638,7737,3575859200,3575859222,22
3,638,7738,3575859200,3575859226,26
3,638,7739,3575859200,3575859226,26
3,638,7740,3575859200,3575859229,29
3,638,7741,3575859200,3575859229,29
3,638,7742,3575859200,3575859232,32
3,638,7743,3575859200,3575859235,35
3,638,7744,3575859200,3575859235,35
3,638,7745,3575859200,3575859237,37
3,638,7746,3575859200,3575859238,38
3,638,7747,3575859200,3575859239,39
3,638,7748,3575859200,3575859242,42
3,638,7749,3575859200,3575859243,43
3,638,7750,3575859200,3575859243,43
3,638,7751,3575859200,3575859244,44
3,638,7752,3575859200,3575859247,47
3,638,7753,3575859200,3575859248,48
3,638,7754,3575859200,3575859249,49
3,639,7755,3575859255,3575859255,0
3,639,7756,3575859255,3575859255,0
3,639,7757,3575859255,3575859255,0
3,639,7758,3575859255,3575859255,0
3,639,7759,3575859255,3575859255,0
3,639,7760,3575859255,3575859255,0
3,639,7761,3575859255,3575859261,6
3,639,7762,3575859255,3575859262,7
3,639,7763,3575859255,3575859262,7
3,639,7764,3575859255,3575859264,9
3,639,7765,3575859255,3575859265,10
3,639,7766,3575859255,3575859266,11
3,639,7767,3575859255,3575859268,13
3,639,7768,3575859255,3575859269,14
3,639,7769,3575859255,3575859270,15
3,639,7770,3575859255,3575859270,15
3,639,7771,3575859255,3575859276,21
3,639,7772,3575859255,3575859277,22
3,639,7773,3575859255,3575859279,24
3,639,7774,3575859255,3575859280,25
3,639,7775,3575859255,3575859282,27
3,639,7776,3575859255,3575859283,28
3,639,7777,3575859255,3575859284,29
3,639,7778,3575859255,3575859285,30
3,639,7779,3575859255,3575859289,34
3,639,7780,3575859255,3575859292,37
3,639,7781,3575859255,3575859297,42
3,639,7782,3575859255,3575859297,42
3,639,7783,3575859255,3575859300,45
3,639,7784,3575859255,3575859301,46
3,639,7785,3575859255,3575859303,48
3,639,7786,3575859255,3575859303,48
3,639,7787,3575859255,3575859304,49
3,640,7788,3575859310,3575859310,0
3,640,7789,3575859310,3575859310,0
3,640,7790,3575859310,3575859310,0
3,640,7791,3575859310,3575859312,2
3,640,7792,3575859310,3575859313,3
3,640,7793,3575859310,3575859317,7
3,640,7794,3575859310,3575859318,8
3,640,7795,3575859310,3575859318,8
3,640,7796,3575859310,3575859321,11
3,640,7797,3575859310,3575859322,12
3,640,7798,3575859310,3575859327,17
3,640,7799,3575859310,3575859335,25
3,640,7800,3575859310,3575859337,27
3,640,7801,3575859310,3575859338,28
3,640,7802,3575859310,3575859342,32
3,640,7803,3575859310,3575859343,33
3,640,7804,3575859310,3575859344,34
3,640,7805,3575859310,3575859344,34
3,640,7806,3575859310,3575859352,42
3,640,7807,3575859310,3575859354,44
3,641,7808,3575859365,3575859365,0
3,641,7809,3575859365,3575859365,0
3,641,7810,3575859365,3575859368,3
3,641,7811,3575859365,3575859368,3
3,641,7812,3575859365,3575859371,6
3,641,7813,3575859365,3575859371,6
3,641,7814,3575859365,3575859371,6
3,641,7815,3575859365,3575859372,7
3,641,7816,3575859365,3575859377,12
3,641,7817,3575859365,3575859378,13
3,641,7818,3575859365,3575859381,16
3,641,7819,3575859365,3575859381,16
3,641,7820,3575859365,3575859382,17
3,641,7821,3575859365,3575859384,19
3,641,7822,3575859365,3575859384,19
3,641,7823,3575859365,3575859386,21
3,641,7824,3575859365,3575859387,22
3,641,7825,3575859365,3575859392,27
3,641,7826,3575859365,3575859392,27
3,641,7827,3575859365,3575859393,28
3,641,7828,3575859365,3575859395,30
3,641,7829,3575859365,3575859396,31
3,641,7830,3575859365,3575859396,31
3,641,7831,3575859365,3575859398,33
3,641,7832,3575859365,3575859398,33
3,641,7833,3575859365,3575859400,35
3,641,7834,3575859365,3575859401,36
3,641,7835,3575859365,3575859402,37
3,641,7836,3575859365,3575859404,39
3,641,7837,3575859365,3575859406,41
3,641,7838,3575859365,3575859409,44
3,641,7839,3575859365,3575859409,44
3,642,7840,3575859419,3575859419,0
3,642,7841,3575859419,3575859419,0
3,642,7842,3575859419,3575859419,0
3,642,7843,3575859419,3575859419,0
3,642,7844,3575859419,3575859420,1
3,642,7845,3575859419,3575859420,1
3,642,7846,3575859419,3575859422,3
3,642,7847,3575859419,3575859423,4
3,642,7848,3575859419,3575859426,7
3,642,7849,3575859419,3575859428,9
3,642,7850,3575859419,3575859429,10
3,642,7851,3575859419,3575859429,10
3,642,7852,3575859419,3575859434,15
3,642,7853,3575859419,3575859436,17
3,642,7854,3575859419,3575859437,18
3,642,7855,3575859419,3575859437,18
3,642,7856,3575859419,3575859439,20
3,642,7857,3575859419,3575859442,23
3,642,7858,3575859419,3575859443,24
3,642,7859,3575859419,3575859444,25
3,642,7860,3575859419,3575859444,25
3,642,7861,3575859419,3575859446,27
3,642,7862,3575859419,3575859448,29
3,642,7863,3575859419,3575859449,30
3,642,7864,3575859419,3575859449,30
3,642,7865,3575859419,3575859452,33
3,642,7866,3575859419,3575859453,34
3,642,7867,3575859419,3575859455,36
3,642,7868,3575859419,3575859456,37
3,642,7869,3575859419,3575859457,38
3,642,7870,3575859419,3575859461,42
3,642,7871,3575859419,3575859462,43
3,642,7872,3575859419,3575859463,44
3,642,7873,3575859419,3575859464,45
3,642,7874,3575859419,3575859466,47
3,642,7875,3575859419,3575859469,50
3,643,7876,3575859476,3575859476,0
3,643,7877,3575859476,3575859476,0
3,643,7878,3575859476,3575859476,0
3,643,7879,3575859476,3575859477,1
3,643,7880,3575859476,3575859479,3
3,643,7881,3575859476,3575859480,4
3,643,7882,3575859476,3575859482,6
3,643,7883,3575859476,3575859483,7
3,643,7884,3575859476,3575859484,8
3,643,7885,3575859476,3575859486,10
3,643,7886,3575859476,3575859488,12
3,643,7887,3575859476,3575859491,15
3,643,7888,3575859476,3575859497,21
3,643,7889,3575859476,3575859498,22
3,643,7890,3575859476,3575859501,25
3,643,7891,3575859476,3575859501,25
3,643,7892,3575859476,3575859502,26
3,643,7893,3575859476,3575859503,27
3,643,7894,3575859476,3575859505,29
3,643,7895,3575859476,3575859508,32
3,643,7896,3575859476,3575859508,32
3,643,7897,3575859476,3575859509,33
3,643,7898,3575859476,3575859511,35
3,643,7899,3575859476,3575859513,37
3,643,7900,3575859476,3575859516,40
3,643,7901,3575859476,3575859518,42
3,643,7902,3575859476,3575859518,42
3,643,7903,3575859476,3575859521,45
3,643,7904,3575859476,3575859522,46
3,644,7905,3575859532,3575859532,0
3,644,7906,3575859532,3575859534,2
3,644,7907,3575859532,3575859538,6
3,644,7908,3575859532,3575859541,9
3,644,7909,3575859532,3575859542,10
3,644,7910,3575859532,3575859543,11
3,644,7911,3575859532,3575859543,11
3,644,7912,3575859532,3575859545,13
3,644,7913,3575859532,3575859545,13
3,644,7914,3575859532,3575859553,21
3,644,7915,3575859532,3575859559,27
3,644,7916,3575859532,3575859562,30
3,644,7917,3575859532,3575859562,30
3,644,7918,3575859532,3575859567,35
3,644,7919,3575859532,3575859569,37
3,644,7920,3575859532,3575859570,38
3,644,7921,3575859532,3575859570,38
3,644,7922,3575859532,3575859571,39
3,644,7923,3575859532,3575859571,39
3,644,7924,3575859532,3575859576,44
3,644,7925,3575859532,3575859577,45
3,644,7926,3575859532,3575859580,48
3,644,7927,3575859532,3575859580,48
3,644,7928,3575859532,3575859581,49
3,645,7929,3575859587,3575859587,0
3,645,7930,3575859587,3575859587,0
3,645,7931,3575859587,3575859587,0
3,645,7932,3575859587,3575859587,0
3,645,7933,3575859587,3575859587,0
3,645,7934,3575859587,3575859587,0
3,645,7935,3575859587,3575859591,4
3,645,7936,3575859587,3575859592,5
3,645,7937,3575859587,3575859592,5
3,645,7938,3575859587,3575859594,7
3,645,7939,3575859587,3575859594,7
3,645,7940,3575859587,3575859595,8
3,645,7941,3575859587,3575859597,10
3,645,7942,3575859587,3575859597,10
3,645,7943,3575859587,3575859599,12
3,645,7944,3575859587,3575859601,14
3,645,7945,3575859587,3575859602,15
3,645,7946,3575859587,3575859603,16
3,645,7947,3575859587,3575859604,17
3,645,7948,3575859587,3575859605,18
3,645,7949,3575859587,3575859607,20
3,645,7950,3575859587,3575859609,22
3,645,7951,3575859587,3575859615,28
3,645,7952,3575859587,3575859616,29
3,645,7953,3575859587,3575859616,29
3,645,7954,3575859587,3575859618,31
3,645,7955,3575859587,3575859619,32
3,645,7956,3575859587,3575859620,33
3,645,7957,3575859587,3575859621,34
3,645,7958,3575859587,3575859622,35
3,645,7959,3575859587,3575859625,38
3,645,7960,3575859587,3575859628,41
3,645,7961,3575859587,3575859629,42
3,645,7962,3575859587,3575859633,46
3,645,7963,3575859587,3575859635,48
3,645,7964,3575859587,3575859636,49
3,646,7965,3575859642,3575859642,0
3,646,7966,3575859642,3575859642,0
3,646,7967,3575859642,3575859642,0
3,646,7968,3575859642,3575859642,0
3,646,7969,3575859642,3575859643,1
3,646,7970,3575859642,3575859645,3
3,646,7971,3575859642,3575859647,5
3,646,7972,3575859642,3575859648,6
3,646,7973,3575859642,3575859649,7
3,646,7974,3575859642,3575859651,9
3,646,7975,3575859642,3575859652,10
3,646,7976,3575859642,3575859653,11
3,646,7977,3575859642,3575859653,11
3,646,7978,3575859642,3575859654,12
3,646,7979,3575859642,3575859656,14
3,646,7980,3575859642,3575859656,14
3,646,7981,3575859642,3575859660,18
3,646,7982,3575859642,3575859662,20
3,646,7983,3575859642,3575859662,20
3,646,7984,3575859642,3575859665,23
3,646,7985,3575859642,3575859667,25
3,646,7986,3575859642,3575859668,26
3,646,7987,3575859642,3575859673,31
3,646,7988,3575859642,3575859676,34
3,646,7989,3575859642,3575859678,36
3,646,7990,3575859642,3575859679,37
3,646,7991,3575859642,3575859680,38
3,646,7992,3575859642,3575859681,39
3,646,7993,3575859642,3575859683,41
3,646,7994,3575859642,3575859684,42
3,646,7995,3575859642,3575859686,44
3,646,7996,3575859642,3575859688,46
3,646,7997,3575859642,3575859691,49
3,647,7998,3575859696,3575859697,1
3,647,7999,3575859696,3575859698,2
3,647,8000,3575859696,3575859701,5
3,647,8001,3575859696,3575859702,6
3,647,8002,3575859696,3575859702,6
3,647,8003,3575859696,3575859703,7
3,647,8004,3575859696,3575859705,9
3,647,8005,3575859696,3575859708,12
3,647,8006,3575859696,3575859708,12
3,647,8007,3575859696,3575859708,12
3,647,8008,3575859696,3575859711,15
3,647,8009,3575859696,3575859713,17
3,647,8010,3575859696,3575859713,17
3,647,8011,3575859696,3575859716,20
3,647,8012,3575859696,3575859718,22
3,647,8013,3575859696,3575859718,22
3,647,8014,3575859696,3575859720,24
3,647,8015,3575859696,3575859723,27
3,647,8016,3575859696,3575859727,31
3,647,8017,3575859696,3575859734,38
3,647,8018,3575859696,3575859736,40
3,647,8019,3575859696,3575859739,43
3,647,8020,3575859696,3575859742,46
3,647,8021,3575859696,3575859742,46
3,647,8022,3575859696,3575859744,48
3,647,8023,3575859696,3575859744,48
3,647,8024,3575859696,3575859745,49
3,648,8025,3575859753,3575859755,2
3,648,8026,3575859753,3575859758,5
3,648,8027,3575859753,3575859762,9
3,648,8028,3575859753,3575859763,10
3,648,8029,3575859753,3575859767,14
3,648,8030,3575859753,3575859768,15
3,648,8031,3575859753,3575859770,17
3,648,8032,3575859753,3575859770,17
3,648,8033,3575859753,3575859772,19
3,648,8034,3575859753,3575859773,20
3,648,8035,3575859753,3575859777,24
3,648,8036,3575859753,3575859781,28
3,648,8037,3575859753,3575859781,28
3,648,8038,3575859753,3575859782,29
3,648,8039,3575859753,3575859785,32
3,648,8040,3575859753,3575859785,32
3,648,8041,3575859753,3575859786,33
3,648,8042,3575859753,3575859786,33
3,648,8043,3575859753,3575859792,39
3,648,8044,3575859753,3575859792,39
3,648,8045,3575859753,3575859793,40
3,648,8046,3575859753,3575859794,41
3,648,8047,3575859753,3575859794,41
3,648,8048,3575859753,3575859795,42
3,648,8049,3575859753,3575859797,44
3,648,8050,3575859753,3575859797,44
3,648,8051,3575859753,3575859799,46
3,648,8052,3575859753,3575859800,47
3,648,8053,3575859753,3575859803,50
3,649,8054,3575859808,3575859808,0
3,649,8055,3575859808,3575859808,0
3,649,8056,3575859808,3575859808,0
3,649,8057,3575859808,3575859809,1
3,649,8058,3575859808,3575859809,1
3,649,8059,3575859808,3575859816,8
3,649,8060,3575859808,3575859816,8
3,649,8061,3575859808,3575859816,8
3,649,8062,3575859808,3575859819,11
3,649,8063,3575859808,3575859820,12
3,649,8064,3575859808,3575859820,12
3,649,8065,3575859808,3575859821,13
3,649,8066,3575859808,3575859823,15
3,649,8067,3575859808,3575859825,17
3,649,8068,3575859808,3575859828,20
3,649,8069,3575859808,3575859828,20
3,649,8070,3575859808,3575859830,22
3,649,8071,3575859808,3575859833,25
3,649,8072,3575859808,3575859835,27
3,649,8073,3575859808,3575859836,28
3,649,8074,3575859808,3575859839,31
3,649,8075,3575859808,3575859841,33
3,649,8076,3575859808,3575859842,34
3,649,8077,3575859808,3575859842,34
3,649,8078,3575859808,3575859843,35
3,649,8079,3575859808,3575859845,37
3,649,8080,3575859808,3575859847,39
3,649,8081,3575859808,3575859848,40
3,649,8082,3575859808,3575859849,41
3,649,8083,3575859808,3575859851,43
3,649,8084,3575859808,3575859852,44
3,649,8085,3575859808,3575859854,46
3,649,8086,3575859808,3575859855,47
3,649,8087,3575859808,3575859856,48
3,650,8088,3575859866,3575859866,0
3,650,8089,3575859866,3575859866,0
3,650,8090,3575859866,3575859866,0
3,650,8091,3575859866,3575859866,0
3,650,8092,3575859866,3575859866,0
3,650,8093,3575859866,3575859867,1
3,650,8094,3575859866,3575859868,2
3,650,8095,3575859866,3575859871,5
3,650,8096,3575859866,3575859872,6
3,650,8097,3575859866,3575859875,9
3,650,8098,3575859866,3575859878,12
3,650,8099,3575859866,3575859879,13
3,650,8100,3575859866,3575859881,15
3,650,8101,3575859866,3575859882,16
3,650,8102,3575859866,3575859883,17
3,650,8103,3575859866,3575859884,18
3,650,8104,3575859866,3575859886,20
3,650,8105,3575859866,3575859888,22
3,650,8106,3575859866,3575859892,26
3,650,8107,3575859866,3575859897,31
3,650,8108,3575859866,3575859898,32
3,650,8109,3575859866,3575859901,35
3,650,8110,3575859866,3575859902,36
3,650,8111,3575859866,3575859902,36
3,650,8112,3575859866,3575859903,37
3,650,8113,3575859866,3575859904,38
3,650,8114,3575859866,3575859908,42
3,650,8115,3575859866,3575859908,42
3,650,8116,3575859866,3575859909,43
3,650,8117,3575859866,3575859911,45
3,650,8118,3575859866,3575859913,47
3,650,8119,3575859866,3575859913,47
3,650,8120,3575859866,3575859916,50
3,651,8121,3575859922,3575859922,0
3,651,8122,3575859922,3575859922,0
3,651,8123,3575859922,3575859922,0
3,651,8124,3575859922,3575859922,0
3,651,8125,3575859922,3575859927,5
3,651,8126,3575859922,3575859934,12
3,651,8127,3575859922,3575859937,15
3,651,8128,3575859922,3575859939,17
3,651,8129,3575859922,3575859942,20
3,651,8130,3575859922,3575859943,21
3,651,8131,3575859922,3575859944,22
3,651,8132,3575859922,3575859944,22
3,651,8133,3575859922,3575859945,23
3,651,8134,3575859922,3575859951,29
3,651,8135,3575859922,3575859954,32
3,651,8136,3575859922,3575859958,36
3,651,8137,3575859922,3575859962,40
3,651,8138,3575859922,3575859963,41
3,651,8139,3575859922,3575859967,45
3,651,8140,3575859922,3575859969,47
3,651,8141,3575859922,3575859970,48
3,651,8142,3575859922,3575859970,48
3,651,8143,3575859922,3575859972,50
3,652,8144,3575859977,3575859977,0
3,652,8145,3575859977,3575859977,0
3,652,8146,3575859977,3575859978,1
3,652,8147,3575859977,3575859981,4
3,652,8148,3575859977,3575859981,4
3,652,8149,3575859977,3575859982,5
3,652,8150,3575859977,3575859982,5
3,652,8151,3575859977,3575859983,6
3,652,8152,3575859977,3575859984,7
3,652,8153,3575859977,3575859985,8
3,652,8154,3575859977,3575859987,10
3,652,8155,3575859977,3575859987,10
3,652,8156,3575859977,3575859991,14
3,652,8157,3575859977,3575859992,15
3,652,8158,3575859977,3575859993,16
3,652,8159,3575859977,3575859993,16
3,652,8160,3575859977,3575859995,18
3,652,8161,3575859977,3575859995,18
3,652,8162,3575859977,3575859998,21
3,652,8163,3575859977,3575859998,21
3,652,8164,3575859977,3575859998,21
3,652,8165,3575859977,3575860000,23
3,652,8166,3575859977,3575860004,27
3,652,8167,3575859977,3575860004,27
3,652,8168,3575859977,3575860004,27
3,652,8169,3575859977,3575860006,29
3,652,8170,3575859977,3575860009,32
3,652,8171,3575859977,3575860009,32
3,652,8172,3575859977,3575860015,38
3,652,8173,3575859977,3575860015,38
3,652,8174,3575859977,3575860016,39
3,652,8175,3575859977,3575860019,42
3,652,8176,3575859977,3575860020,43
3,652,8177,3575859977,3575860021,44
3,652,8178,3575859977,3575860021,44
3,652,8179,3575859977,3575860023,46
3,652,8180,3575859977,3575860025,48
3,653,8181,3575860033,3575860033,0
3,653,8182,3575860033,3575860033,0
3,653,8183,3575860033,3575860033,0
3,653,8184,3575860033,3575860033,0
3,653,8185,3575860033,3575860033,0
3,653,8186,3575860033,3575860035,2
3,653,8187,3575860033,3575860036,3
3,653,8188,3575860033,3575860038,5
3,653,8189,3575860033,3575860039,6
3,653,8190,3575860033,3575860041,8
3,653,8191,3575860033,3575860042,9
3,653,8192,3575860033,3575860043,10
3,653,8193,3575860033,3575860044,11
3,653,8194,3575860033,3575860045,12
3,653,8195,3575860033,3575860046,13
3,653,8196,3575860033,3575860048,15
3,653,8197,3575860033,3575860049,16
3,653,8198,3575860033,3575860052,19
3,653,8199,3575860033,3575860053,20
3,653,8200,3575860033,3575860055,22
3,653,8201,3575860033,3575860056,23
3,653,8202,3575860033,3575860057,24
3,653,8203,3575860033,3575860060,27
3,653,8204,3575860033,3575860063,30
3,653,8205,3575860033,3575860063,30
3,653,8206,3575860033,3575860064,31
3,653,8207,3575860033,3575860064,31
3,653,8208,3575860033,3575860066,33
3,653,8209,3575860033,3575860066,33
3,653,8210,3575860033,3575860067,34
3,653,8211,3575860033,3575860070,37
3,653,8212,3575860033,3575860071,38
3,653,8213,3575860033,3575860073,40
3,653,8214,3575860033,3575860076,43
3,653,8215,3575860033,3575860078,45
3,653,8216,3575860033,3575860081,48
3,653,8217,3575860033,3575860081,48
3,654,8218,3575860090,3575860090,0
3,654,8219,3575860090,3575860090,0
3,654,8220,3575860090,3575860090,0
3,654,8221,3575860090,3575860092,2
3,654,8222,3575860090,3575860097,7
3,654,8223,3575860090,3575860098,8
3,654,8224,3575860090,3575860101,11
3,654,8225,3575860090,3575860103,13
3,654,8226,3575860090,3575860103,13
3,654,8227,3575860090,3575860103,13
3,654,8228,3575860090,3575860104,14
3,654,8229,3575860090,3575860108,18
3,654,8230,3575860090,3575860109,19
3,654,8231,3575860090,3575860110,20
3,654,8232,3575860090,3575860111,21
3,654,8233,3575860090,3575860113,23
3,654,8234,3575860090,3575860118,28
3,654,8235,3575860090,3575860118,28
3,654,8236,3575860090,3575860118,28
3,654,8237,3575860090,3575860120,30
3,654,8238,3575860090,3575860123,33
3,654,8239,3575860090,3575860127,37
3,654,8240,3575860090,3575860134,44
3,654,8241,3575860090,3575860137,47
3,654,8242,3575860090,3575860138,48
3,655,8243,3575860145,3575860145,0
3,655,8244,3575860145,3575860145,0
3,655,8245,3575860145,3575860145,0
3,655,8246,3575860145,3575860145,0
3,655,8247,3575860145,3575860154,9
3,655,8248,3575860145,3575860162,17
3,655,8249,3575860145,3575860163,18
3,655,8250,3575860145,3575860167,22
3,655,8251,3575860145,3575860168,23
3,655,8252,3575860145,3575860169,24
3,655,8253,3575860145,3575860170,25
3,655,8254,3575860145,3575860173,28
3,655,8255,3575860145,3575860173,28
3,655,8256,3575860145,3575860177,32
3,655,8257,3575860145,3575860180,35
3,655,8258,3575860145,3575860181,36
3,655,8259,3575860145,3575860182,37
3,655,8260,3575860145,3575860183,38
3,655,8261,3575860145,3575860184,39
3,655,8262,3575860145,3575860185,40
3,655,8263,3575860145,3575860187,42
3,655,8264,3575860145,3575860187,42
3,655,8265,3575860145,3575860191,46
3,655,8266,3575860145,3575860192,47
3,655,8267,3575860145,3575860193,48
3,655,8268,3575860145,3575860195,50
3,656,8269,3575860201,3575860201,0
3,656,8270,3575860201,3575860201,0
3,656,8271,3575860201,3575860201,0
3,656,8272,3575860201,3575860201,0
3,656,8273,3575860201,3575860201,0
3,656,8274,3575860201,3575860203,2
3,656,8275,3575860201,3575860204,3
3,656,8276,3575860201,3575860207,6
3,656,8277,3575860201,3575860209,8
3,656,8278,3575860201,3575860209,8
3,656,8279,3575860201,3575860215,14
3,656,8280,3575860201,3575860215,14
3,656,8281,3575860201,3575860217,16
3,656,8282,3575860201,3575860221,20
3,656,8283,3575860201,3575860221,20
3,656,8284,3575860201,3575860222,21
3,656,8285,3575860201,3575860222,21
3,656,8286,3575860201,3575860225,24
3,656,8287,3575860201,3575860229,28
3,656,8288,3575860201,3575860229,28
3,656,8289,3575860201,3575860232,31
3,656,8290,3575860201,3575860232,31
3,656,8291,3575860201,3575860234,33
3,656,8292,3575860201,3575860236,35
3,656,8293,3575860201,3575860236,35
3,656,8294,3575860201,3575860238,37
3,656,8295,3575860201,3575860239,38
3,656,8296,3575860201,3575860241,40
3,656,8297,3575860201,3575860242,41
3,656,8298,3575860201,3575860244,43
3,656,8299,3575860201,3575860245,44
3,656,8300,3575860201,3575860248,47
3,656,8301,3575860201,3575860248,47
3,656,8302,3575860201,3575860249,48
3,657,8303,3575860256,3575860256,0
3,657,8304,3575860256,3575860256,0
3,657,8305,3575860256,3575860256,0
3,657,8306,3575860256,3575860257,1
3,657,8307,3575860256,3575860258,2
3,657,8308,3575860256,3575860260,4
3,657,8309,3575860256,3575860263,7
3,657,8310,3575860256,3575860264,8
3,657,8311,3575860256,3575860264,8
3,657,8312,3575860256,3575860264,8
3,657,8313,3575860256,3575860266,10
3,657,8314,3575860256,3575860267,11
3,657,8315,3575860256,3575860267,11
3,657,8316,3575860256,3575860270,14
3,657,8317,3575860256,3575860271,15
3,657,8318,3575860256,3575860271,15
3,657,8319,3575860256,3575860274,18
3,657,8320,3575860256,3575860276,20
3,657,8321,3575860256,3575860278,22
3,657,8322,3575860256,3575860279,23
3,657,8323,3575860256,3575860282,26
3,657,8324,3575860256,3575860282,26
3,657,8325,3575860256,3575860283,27
3,657,8326,3575860256,3575860284,28
3,657,8327,3575860256,3575860286,30
3,657,8328,3575860256,3575860288,32
3,657,8329,3575860256,3575860292,36
3,657,8330,3575860256,3575860297,41
3,657,8331,3575860256,3575860298,42
3,657,8332,3575860256,3575860301,45
3,657,8333,3575860256,3575860302,46
3,657,8334,3575860256,3575860302,46
3,657,8335,3575860256,3575860303,47
3,657,8336,3575860256,3575860304,48
3,658,8337,3575860309,3575860309,0
3,658,8338,3575860309,3575860309,0
3,658,8339,3575860309,3575860310,1
3,658,8340,3575860309,3575860312,3
3,658,8341,3575860309,3575860313,4
3,658,8342,3575860309,3575860313,4
3,658,8343,3575860309,3575860318,9
3,658,8344,3575860309,3575860318,9
3,658,8345,3575860309,3575860320,11
3,658,8346,3575860309,3575860323,14
3,658,8347,3575860309,3575860327,18
3,658,8348,3575860309,3575860334,25
3,658,8349,3575860309,3575860337,28
3,658,8350,3575860309,3575860339,30
3,658,8351,3575860309,3575860342,33
3,658,8352,3575860309,3575860344,35
3,658,8353,3575860309,3575860344,35
3,658,8354,3575860309,3575860344,35
3,658,8355,3575860309,3575860352,43
3,658,8356,3575860309,3575860354,45
3,659,8357,3575860365,3575860365,0
3,659,8358,3575860365,3575860365,0
3,659,8359,3575860365,3575860365,0
3,659,8360,3575860365,3575860368,3
3,659,8361,3575860365,3575860369,4
3,659,8362,3575860365,3575860369,4
3,659,8363,3575860365,3575860371,6
3,659,8364,3575860365,3575860372,7
3,659,8365,3575860365,3575860374,9
3,659,8366,3575860365,3575860374,9
3,659,8367,3575860365,3575860377,12
3,659,8368,3575860365,3575860378,13
3,659,8369,3575860365,3575860381,16
3,659,8370,3575860365,3575860381,16
3,659,8371,3575860365,3575860382,17
3,659,8372,3575860365,3575860383,18
3,659,8373,3575860365,3575860383,18
3,659,8374,3575860365,3575860385,20
3,659,8375,3575860365,3575860385,20
3,659,8376,3575860365,3575860387,22
3,659,8377,3575860365,3575860387,22
3,659,8378,3575860365,3575860392,27
3,659,8379,3575860365,3575860394,29
3,659,8380,3575860365,3575860395,30
3,659,8381,3575860365,3575860395,30
3,659,8382,3575860365,3575860396,31
3,659,8383,3575860365,3575860397,32
3,659,8384,3575860365,3575860398,33
3,659,8385,3575860365,3575860399,34
3,659,8386,3575860365,3575860402,37
3,659,8387,3575860365,3575860403,38
3,659,8388,3575860365,3575860404,39
3,659,8389,3575860365,3575860407,42
3,659,8390,3575860365,3575860409,44
3,659,8391,3575860365,3575860409,44
3,660,8392,3575860420,3575860420,0
3,660,8393,3575860420,3575860420,0
3,660,8394,3575860420,3575860420,0
3,660,8395,3575860420,3575860420,0
3,660,8396,3575860420,3575860420,0
3,660,8397,3575860420,3575860421,1
3,660,8398,3575860420,3575860421,1
3,660,8399,3575860420,3575860423,3
3,660,8400,3575860420,3575860425,5
3,660,8401,3575860420,3575860428,8
3,660,8402,3575860420,3575860429,9
3,660,8403,3575860420,3575860431,11
3,660,8404,3575860420,3575860432,12
3,660,8405,3575860420,3575860433,13
3,660,8406,3575860420,3575860436,16
3,660,8407,3575860420,3575860437,17
3,660,8408,3575860420,3575860439,19
3,660,8409,3575860420,3575860442,22
3,660,8410,3575860420,3575860443,23
3,660,8411,3575860420,3575860444,24
3,660,8412,3575860420,3575860445,25
3,660,8413,3575860420,3575860446,26
3,660,8414,3575860420,3575860448,28
3,660,8415,3575860420,3575860449,29
3,660,8416,3575860420,3575860449,29
3,660,8417,3575860420,3575860452,32
3,660,8418,3575860420,3575860452,32
3,660,8419,3575860420,3575860454,34
3,660,8420,3575860420,3575860455,35
3,660,8421,3575860420,3575860455,35
3,660,8422,3575860420,3575860456,36
3,660,8423,3575860420,3575860457,37
3,660,8424,3575860420,3575860460,40
3,660,8425,3575860420,3575860463,43
3,660,8426,3575860420,3575860463,43
3,660,8427,3575860420,3575860463,43
3,660,8428,3575860420,3575860464,44
3,660,8429,3575860420,3575860466,46
3,660,8430,3575860420,3575860466,46
3,660,8431,3575860420,3575860468,48
3,661,8432,3575860475,3575860475,0
3,661,8433,3575860475,3575860475,0
3,661,8434,3575860475,3575860475,0
3,661,8435,3575860475,3575860475,0
3,661,8436,3575860475,3575860475,0
3,661,8437,3575860475,3575860476,1
3,661,8438,3575860475,3575860479,4
3,661,8439,3575860475,3575860480,5
3,661,8440,3575860475,3575860481,6
3,661,8441,3575860475,3575860482,7
3,661,8442,3575860475,3575860483,8
3,661,8443,3575860475,3575860486,11
3,661,8444,3575860475,3575860487,12
3,661,8445,3575860475,3575860492,17
3,661,8446,3575860475,3575860496,21
3,661,8447,3575860475,3575860498,23
3,661,8448,3575860475,3575860501,26
3,661,8449,3575860475,3575860501,26
3,661,8450,3575860475,3575860501,26
3,661,8451,3575860475,3575860503,28
3,661,8452,3575860475,3575860503,28
3,661,8453,3575860475,3575860508,33
3,661,8454,3575860475,3575860510,35
3,661,8455,3575860475,3575860510,35
3,661,8456,3575860475,3575860510,35
3,661,8457,3575860475,3575860512,37
3,661,8458,3575860475,3575860517,42
3,661,8459,3575860475,3575860517,42
3,661,8460,3575860475,3575860518,43
3,661,8461,3575860475,3575860520,45
3,661,8462,3575860475,3575860522,47
3,661,8463,3575860475,3575860522,47
3,662,8464,3575860531,3575860531,0
3,662,8465,3575860531,3575860533,2
3,662,8466,3575860531,3575860536,5
3,662,8467,3575860531,3575860542,11
3,662,8468,3575860531,3575860542,11
3,662,8469,3575860531,3575860544,13
3,662,8470,3575860531,3575860544,13
3,662,8471,3575860531,3575860551,20
3,662,8472,3575860531,3575860553,22
3,662,8473,3575860531,3575860558,27
3,662,8474,3575860531,3575860562,31
3,662,8475,3575860531,3575860563,32
3,662,8476,3575860531,3575860566,35
3,662,8477,3575860531,3575860568,37
3,662,8478,3575860531,3575860569,38
3,662,8479,3575860531,3575860570,39
3,662,8480,3575860531,3575860570,39
3,662,8481,3575860531,3575860571,40
3,662,8482,3575860531,3575860573,42
3,662,8483,3575860531,3575860574,43
3,662,8484,3575860531,3575860576,45
3,662,8485,3575860531,3575860579,48
3,662,8486,3575860531,3575860580,49
3,662,8487,3575860531,3575860581,50
3,663,8488,3575860587,3575860587,0
3,663,8489,3575860587,3575860587,0
3,663,8490,3575860587,3575860587,0
3,663,8491,3575860587,3575860587,0
3,663,8492,3575860587,3575860587,0
3,663,8493,3575860587,3575860587,0
3,663,8494,3575860587,3575860591,4
3,663,8495,3575860587,3575860591,4
3,663,8496,3575860587,3575860594,7
3,663,8497,3575860587,3575860595,8
3,663,8498,3575860587,3575860595,8
3,663,8499,3575860587,3575860595,8
3,663,8500,3575860587,3575860596,9
3,663,8501,3575860587,3575860597,10
3,663,8502,3575860587,3575860599,12
3,663,8503,3575860587,3575860600,13
3,663,8504,3575860587,3575860603,16
3,663,8505,3575860587,3575860603,16
3,663,8506,3575860587,3575860603,16
3,663,8507,3575860587,3575860607,20
3,663,8508,3575860587,3575860608,21
3,663,8509,3575860587,3575860609,22
3,663,8510,3575860587,3575860614,27
3,663,8511,3575860587,3575860616,29
3,663,8512,3575860587,3575860617,30
3,663,8513,3575860587,3575860618,31
3,663,8514,3575860587,3575860619,32
3,663,8515,3575860587,3575860619,32
3,663,8516,3575860587,3575860621,34
3,663,8517,3575860587,3575860622,35
3,663,8518,3575860587,3575860624,37
3,663,8519,3575860587,3575860628,41
3,663,8520,3575860587,3575860629,42
3,663,8521,3575860587,3575860631,44
3,663,8522,3575860587,3575860632,45
3,663,8523,3575860587,3575860635,48
3,663,8524,3575860587,3575860636,49
3,663,8525,3575860587,3575860637,50
3,664,8526,3575860644,3575860644,0
3,664,8527,3575860644,3575860644,0
3,664,8528,3575860644,3575860644,0
3,664,8529,3575860644,3575860645,1
3,664,8530,3575860644,3575860645,1
3,664,8531,3575860644,3575860647,3
3,664,8532,3575860644,3575860648,4
3,664,8533,3575860644,3575860649,5
3,664,8534,3575860644,3575860651,7
3,664,8535,3575860644,3575860652,8
3,664,8536,3575860644,3575860653,9
3,664,8537,3575860644,3575860654,10
3,664,8538,3575860644,3575860655,11
3,664,8539,3575860644,3575860656,12
3,664,8540,3575860644,3575860659,15
3,664,8541,3575860644,3575860661,17
3,664,8542,3575860644,3575860661,17
3,664,8543,3575860644,3575860662,18
3,664,8544,3575860644,3575860663,19
3,664,8545,3575860644,3575860664,20
3,664,8546,3575860644,3575860665,21
3,664,8547,3575860644,3575860666,22
3,664,8548,3575860644,3575860669,25
3,664,8549,3575860644,3575860670,26
3,664,8550,3575860644,3575860670,26
3,664,8551,3575860644,3575860673,29
3,664,8552,3575860644,3575860674,30
3,664,8553,3575860644,3575860676,32
3,664,8554,3575860644,3575860676,32
3,664,8555,3575860644,3575860677,33
3,664,8556,3575860644,3575860678,34
3,664,8557,3575860644,3575860680,36
3,664,8558,3575860644,3575860681,37
3,664,8559,3575860644,3575860681,37
3,664,8560,3575860644,3575860682,38
3,664,8561,3575860644,3575860683,39
3,664,8562,3575860644,3575860685,41
3,664,8563,3575860644,3575860687,43
3,664,8564,3575860644,3575860692,48
3,665,8565,3575860700,3575860700,0
3,665,8566,3575860700,3575860700,0
3,665,8567,3575860700,3575860701,1
3,665,8568,3575860700,3575860701,1
3,665,8569,3575860700,3575860701,1
3,665,8570,3575860700,3575860703,3
3,665,8571,3575860700,3575860704,4
3,665,8572,3575860700,3575860709,9
3,665,8573,3575860700,3575860709,9
3,665,8574,3575860700,3575860710,10
3,665,8575,3575860700,3575860712,12
3,665,8576,3575860700,3575860713,13
3,665,8577,3575860700,3575860717,17
3,665,8578,3575860700,3575860717,17
3,665,8579,3575860700,3575860718,18
3,665,8580,3575860700,3575860720,20
3,665,8581,3575860700,3575860722,22
3,665,8582,3575860700,3575860722,22
3,665,8583,3575860700,3575860726,26
3,665,8584,3575860700,3575860733,33
3,665,8585,3575860700,3575860736,36
3,665,8586,3575860700,3575860742,42
3,665,8587,3575860700,3575860742,42
3,665,8588,3575860700,3575860744,44
3,665,8589,3575860700,3575860744,44
3,666,8590,3575860756,3575860756,0
3,666,8591,3575860756,3575860756,0
3,666,8592,3575860756,3575860758,2
3,666,8593,3575860756,3575860762,6
3,666,8594,3575860756,3575860762,6
3,666,8595,3575860756,3575860766,10
3,666,8596,3575860756,3575860768,12
3,666,8597,3575860756,3575860769,13
3,666,8598,3575860756,3575860770,14
3,666,8599,3575860756,3575860770,14
3,666,8600,3575860756,3575860771,15
3,666,8601,3575860756,3575860772,16
3,666,8602,3575860756,3575860778,22
3,666,8603,3575860756,3575860780,24
3,666,8604,3575860756,3575860781,25
3,666,8605,3575860756,3575860782,26
3,666,8606,3575860756,3575860783,27
3,666,8607,3575860756,3575860784,28
3,666,8608,3575860756,3575860785,29
3,666,8609,3575860756,3575860786,30
3,666,8610,3575860756,3575860786,30
3,666,8611,3575860756,3575860791,35
3,666,8612,3575860756,3575860792,36
3,666,8613,3575860756,3575860793,37
3,666,8614,3575860756,3575860795,39
3,666,8615,3575860756,3575860795,39
3,666,8616,3575860756,3575860796,40
3,666,8617,3575860756,3575860797,41
3,666,8618,3575860756,3575860799,43
3,666,8619,3575860756,3575860800,44
3,666,8620,3575860756,3575860803,47
3,666,8621,3575860756,3575860803,47
3,666,8622,3575860756,3575860804,48
3,667,8623,3575860813,3575860813,0
3,667,8624,3575860813,3575860813,0
3,667,8625,3575860813,3575860813,0
3,667,8626,3575860813,3575860816,3
3,667,8627,3575860813,3575860820,7
3,667,8628,3575860813,3575860820,7
3,667,8629,3575860813,3575860820,7
3,667,8630,3575860813,3575860823,10
3,667,8631,3575860813,3575860825,12
3,667,8632,3575860813,3575860828,15
3,667,8633,3575860813,3575860828,15
3,667,8634,3575860813,3575860829,16
3,667,8635,3575860813,3575860830,17
3,667,8636,3575860813,3575860832,19
3,667,8637,3575860813,3575860832,19
3,667,8638,3575860813,3575860835,22
3,667,8639,3575860813,3575860837,24
3,667,8640,3575860813,3575860838,25
3,667,8641,3575860813,3575860843,30
3,667,8642,3575860813,3575860843,30
3,667,8643,3575860813,3575860845,32
3,667,8644,3575860813,3575860845,32
3,667,8645,3575860813,3575860847,34
3,667,8646,3575860813,3575860849,36
3,667,8647,3575860813,3575860849,36
3,667,8648,3575860813,3575860851,38
3,667,8649,3575860813,3575860851,38
3,667,8650,3575860813,3575860854,41
3,667,8651,3575860813,3575860854,41
3,667,8652,3575860813,3575860854,41
3,667,8653,3575860813,3575860856,43
3,667,8654,3575860813,3575860856,43
3,667,8655,3575860813,3575860859,46
3,667,8656,3575860813,3575860862,49
3,667,8657,3575860813,3575860862,49
3,668,8658,3575860869,3575860869,0
3,668,8659,3575860869,3575860869,0
3,668,8660,3575860869,3575860869,0
3,668,8661,3575860869,3575860869,0
3,668,8662,3575860869,3575860869,0
3,668,8663,3575860869,3575860869,0
3,668,8664,3575860869,3575860870,1
3,668,8665,3575860869,3575860871,2
3,668,8666,3575860869,3575860872,3
3,668,8667,3575860869,3575860874,5
3,668,8668,3575860869,3575860876,7
3,668,8669,3575860869,3575860876,7
3,668,8670,3575860869,3575860878,9
3,668,8671,3575860869,3575860879,10
3,668,8672,3575860869,3575860881,12
3,668,8673,3575860869,3575860881,12
3,668,8674,3575860869,3575860883,14
3,668,8675,3575860869,3575860884,15
3,668,8676,3575860869,3575860885,16
3,668,8677,3575860869,3575860887,18
3,668,8678,3575860869,3575860891,22
3,668,8679,3575860869,3575860897,28
3,668,8680,3575860869,3575860898,29
3,668,8681,3575860869,3575860901,32
3,668,8682,3575860869,3575860901,32
3,668,8683,3575860869,3575860903,34
3,668,8684,3575860869,3575860904,35
3,668,8685,3575860869,3575860909,40
3,668,8686,3575860869,3575860910,41
3,668,8687,3575860869,3575860912,43
3,668,8688,3575860869,3575860913,44
3,668,8689,3575860869,3575860917,48
3,668,8690,3575860869,3575860917,48
3,668,8691,3575860869,3575860918,49
3,669,8692,3575860924,3575860924,0
3,669,8693,3575860924,3575860924,0
3,669,8694,3575860924,3575860924,0
3,669,8695,3575860924,3575860926,2
3,669,8696,3575860924,3575860933,9
3,669,8697,3575860924,3575860939,15
3,669,8698,3575860924,3575860942,18
3,669,8699,3575860924,3575860943,19
3,669,8700,3575860924,3575860944,20
3,669,8701,3575860924,3575860945,21
3,669,8702,3575860924,3575860954,30
3,669,8703,3575860924,3575860958,34
3,669,8704,3575860924,3575860962,38
3,669,8705,3575860924,3575860963,39
3,669,8706,3575860924,3575860966,42
3,669,8707,3575860924,3575860968,44
3,669,8708,3575860924,3575860969,45
3,669,8709,3575860924,3575860970,46
3,669,8710,3575860924,3575860970,46
3,669,8711,3575860924,3575860971,47
3,670,8712,3575860980,3575860981,1
3,670,8713,3575860980,3575860982,2
3,670,8714,3575860980,3575860982,2
3,670,8715,3575860980,3575860982,2
3,670,8716,3575860980,3575860985,5
3,670,8717,3575860980,3575860985,5
3,670,8718,3575860980,3575860987,7
3,670,8719,3575860980,3575860987,7
3,670,8720,3575860980,3575860991,11
3,670,8721,3575860980,3575860992,12
3,670,8722,3575860980,3575860993,13
3,670,8723,3575860980,3575860994,14
3,670,8724,3575860980,3575860996,16
3,670,8725,3575860980,3575860996,16
3,670,8726,3575860980,3575860996,16
3,670,8727,3575860980,3575860997,17
3,670,8728,3575860980,3575860999,19
3,670,8729,3575860980,3575861000,20
3,670,8730,3575860980,3575861003,23
3,670,8731,3575860980,3575861003,23
3,670,8732,3575860980,3575861008,28
3,670,8733,3575860980,3575861009,29
3,670,8734,3575860980,3575861009,29
3,670,8735,3575860980,3575861016,36
3,670,8736,3575860980,3575861017,37
3,670,8737,3575860980,3575861019,39
3,670,8738,3575860980,3575861019,39
3,670,8739,3575860980,3575861020,40
3,670,8740,3575860980,3575861022,42
3,670,8741,3575860980,3575861023,43
3,670,8742,3575860980,3575861025,45
3,670,8743,3575860980,3575861028,48
3,670,8744,3575860980,3575861029,49
3,670,8745,3575860980,3575861029,49
3,671,8746,3575861036,3575861036,0
3,671,8747,3575861036,3575861036,0
3,671,8748,3575861036,3575861036,0
3,671,8749,3575861036,3575861036,0
3,671,8750,3575861036,3575861036,0
3,671,8751,3575861036,3575861038,2
3,671,8752,3575861036,3575861038,2
3,671,8753,3575861036,3575861039,3
3,671,8754,3575861036,3575861043,7
3,671,8755,3575861036,3575861044,8
3,671,8756,3575861036,3575861046,10
3,671,8757,3575861036,3575861047,11
3,671,8758,3575861036,3575861048,12
3,671,8759,3575861036,3575861049,13
3,671,8760,3575861036,3575861051,15
3,671,8761,3575861036,3575861053,17
3,671,8762,3575861036,3575861054,18
3,671,8763,3575861036,3575861055,19
3,671,8764,3575861036,3575861057,21
3,671,8765,3575861036,3575861057,21
3,671,8766,3575861036,3575861060,24
3,671,8767,3575861036,3575861062,26
3,671,8768,3575861036,3575861063,27
3,671,8769,3575861036,3575861063,27
3,671,8770,3575861036,3575861064,28
3,671,8771,3575861036,3575861064,28
3,671,8772,3575861036,3575861066,30
3,671,8773,3575861036,3575861067,31
3,671,8774,3575861036,3575861069,33
3,671,8775,3575861036,3575861070,34
3,671,8776,3575861036,3575861071,35
3,671,8777,3575861036,3575861073,37
3,671,8778,3575861036,3575861075,39
3,671,8779,3575861036,3575861076,40
3,671,8780,3575861036,3575861076,40
3,671,8781,3575861036,3575861077,41
3,671,8782,3575861036,3575861078,42
3,671,8783,3575861036,3575861081,45
3,671,8784,3575861036,3575861082,46
3,671,8785,3575861036,3575861082,46
3,671,8786,3575861036,3575861085,49
3,671,8787,3575861036,3575861085,49
3,672,8788,3575861092,3575861092,0
3,672,8789,3575861092,3575861092,0
3,672,8790,3575861092,3575861099,7
3,672,8791,3575861092,3575861100,8
3,672,8792,3575861092,3575861101,9
3,672,8793,3575861092,3575861102,10
3,672,8794,3575861092,3575861104,12
3,672,8795,3575861092,3575861109,17
3,672,8796,3575861092,3575861110,18
3,672,8797,3575861092,3575861111,19
3,672,8798,3575861092,3575861113,21
3,672,8799,3575861092,3575861114,22
3,672,8800,3575861092,3575861117,25
3,672,8801,3575861092,3575861117,25
3,672,8802,3575861092,3575861119,27
3,672,8803,3575861092,3575861120,28
3,672,8804,3575861092,3575861122,30
3,672,8805,3575861092,3575861123,31
3,672,8806,3575861092,3575861127,35
3,672,8807,3575861092,3575861134,42
3,672,8808,3575861092,3575861134,42
3,672,8809,3575861092,3575861137,45
3,672,8810,3575861092,3575861139,47
3,673,8811,3575861147,3575861148,1
3,673,8812,3575861147,3575861148,1
3,673,8813,3575861147,3575861148,1
3,673,8814,3575861147,3575861148,1
3,673,8815,3575861147,3575861148,1
3,673,8816,3575861147,3575861151,4
3,673,8817,3575861147,3575861154,7
3,673,8818,3575861147,3575861159,12
3,673,8819,3575861147,3575861162,15
3,673,8820,3575861147,3575861163,16
3,673,8821,3575861147,3575861167,20
3,673,8822,3575861147,3575861168,21
3,673,8823,3575861147,3575861168,21
3,673,8824,3575861147,3575861170,23
3,673,8825,3575861147,3575861170,23
3,673,8826,3575861147,3575861171,24
3,673,8827,3575861147,3575861178,31
3,673,8828,3575861147,3575861179,32
3,673,8829,3575861147,3575861182,35
3,673,8830,3575861147,3575861184,37
3,673,8831,3575861147,3575861184,37
3,673,8832,3575861147,3575861184,37
3,673,8833,3575861147,3575861187,40
3,673,8834,3575861147,3575861188,41
3,673,8835,3575861147,3575861192,45
3,673,8836,3575861147,3575861192,45
3,673,8837,3575861147,3575861193,46
3,673,8838,3575861147,3575861194,47
3,673,8839,3575861147,3575861195,48
3,673,8840,3575861147,3575861196,49
3,673,8841,3575861147,3575861196,49
3,673,8842,3575861147,3575861197,50
3,674,8843,3575861202,3575861202,0
3,674,8844,3575861202,3575861202,0
3,674,8845,3575861202,3575861203,1
3,674,8846,3575861202,3575861204,2
3,674,8847,3575861202,3575861204,2
3,674,8848,3575861202,3575861208,6
3,674,8849,3575861202,3575861209,7
3,674,8850,3575861202,3575861209,7
3,674,8851,3575861202,3575861216,14
3,674,8852,3575861202,3575861216,14
3,674,8853,3575861202,3575861219,17
3,674,8854,3575861202,3575861219,17
3,674,8855,3575861202,3575861220,18
3,674,8856,3575861202,3575861222,20
3,674,8857,3575861202,3575861223,21
3,674,8858,3575861202,3575861224,22
3,674,8859,3575861202,3575861228,26
3,674,8860,3575861202,3575861229,27
3,674,8861,3575861202,3575861229,27
3,674,8862,3575861202,3575861231,29
3,674,8863,3575861202,3575861232,30
3,674,8864,3575861202,3575861232,30
3,674,8865,3575861202,3575861233,31
3,674,8866,3575861202,3575861236,34
3,674,8867,3575861202,3575861237,35
3,674,8868,3575861202,3575861238,36
3,674,8869,3575861202,3575861242,40
3,674,8870,3575861202,3575861243,41
3,674,8871,3575861202,3575861243,41
3,674,8872,3575861202,3575861245,43
3,674,8873,3575861202,3575861248,46
3,674,8874,3575861202,3575861249,47
3,674,8875,3575861202,3575861249,47
3,674,8876,3575861202,3575861251,49
3,675,8877,3575861258,3575861259,1
3,675,8878,3575861258,3575861259,1
3,675,8879,3575861258,3575861259,1
3,675,8880,3575861258,3575861259,1
3,675,8881,3575861258,3575861259,1
3,675,8882,3575861258,3575861259,1
3,675,8883,3575861258,3575861259,1
3,675,8884,3575861258,3575861262,4
3,675,8885,3575861258,3575861263,5
3,675,8886,3575861258,3575861264,6
3,675,8887,3575861258,3575861264,6
3,675,8888,3575861258,3575861266,8
3,675,8889,3575861258,3575861269,11
3,675,8890,3575861258,3575861270,12
3,675,8891,3575861258,3575861271,13
3,675,8892,3575861258,3575861273,15
3,675,8893,3575861258,3575861275,17
3,675,8894,3575861258,3575861276,18
3,675,8895,3575861258,3575861277,19
3,675,8896,3575861258,3575861278,20
3,675,8897,3575861258,3575861281,23
3,675,8898,3575861258,3575861283,25
3,675,8899,3575861258,3575861283,25
3,675,8900,3575861258,3575861285,27
3,675,8901,3575861258,3575861285,27
3,675,8902,3575861258,3575861287,29
3,675,8903,3575861258,3575861292,34
3,675,8904,3575861258,3575861298,40
3,675,8905,3575861258,3575861301,43
3,675,8906,3575861258,3575861301,43
3,675,8907,3575861258,3575861302,44
3,675,8908,3575861258,3575861303,45
3,675,8909,3575861258,3575861304,46
3,676,8910,3575861313,3575861313,0
3,676,8911,3575861313,3575861313,0
3,676,8912,3575861313,3575861313,0
3,676,8913,3575861313,3575861313,0
3,676,8914,3575861313,3575861317,4
3,676,8915,3575861313,3575861318,5
3,676,8916,3575861313,3575861319,6
3,676,8917,3575861313,3575861320,7
3,676,8918,3575861313,3575861323,10
3,676,8919,3575861313,3575861323,10
3,676,8920,3575861313,3575861327,14
3,676,8921,3575861313,3575861334,21
3,676,8922,3575861313,3575861334,21
3,676,8923,3575861313,3575861337,24
3,676,8924,3575861313,3575861339,26
3,676,8925,3575861313,3575861343,30
3,676,8926,3575861313,3575861343,30
3,676,8927,3575861313,3575861344,31
3,676,8928,3575861313,3575861344,31
3,676,8929,3575861313,3575861347,34
3,676,8930,3575861313,3575861352,39
3,676,8931,3575861313,3575861355,42
3,677,8932,3575861368,3575861368,0
3,677,8933,3575861368,3575861368,0
3,677,8934,3575861368,3575861368,0
3,677,8935,3575861368,3575861368,0
3,677,8936,3575861368,3575861368,0
3,677,8937,3575861368,3575861369,1
3,677,8938,3575861368,3575861371,3
3,677,8939,3575861368,3575861371,3
3,677,8940,3575861368,3575861373,5
3,677,8941,3575861368,3575861379,11
3,677,8942,3575861368,3575861381,13
3,677,8943,3575861368,3575861381,13
3,677,8944,3575861368,3575861383,15
3,677,8945,3575861368,3575861384,16
3,677,8946,3575861368,3575861385,17
3,677,8947,3575861368,3575861386,18
3,677,8948,3575861368,3575861387,19
3,677,8949,3575861368,3575861388,20
3,677,8950,3575861368,3575861388,20
3,677,8951,3575861368,3575861392,24
3,677,8952,3575861368,3575861393,25
3,677,8953,3575861368,3575861394,26
3,677,8954,3575861368,3575861395,27
3,677,8955,3575861368,3575861395,27
3,677,8956,3575861368,3575861396,28
3,677,8957,3575861368,3575861396,28
3,677,8958,3575861368,3575861397,29
3,677,8959,3575861368,3575861399,31
3,677,8960,3575861368,3575861401,33
3,677,8961,3575861368,3575861403,35
3,677,8962,3575861368,3575861404,36
3,677,8963,3575861368,3575861404,36
3,677,8964,3575861368,3575861408,40
3,677,8965,3575861368,3575861409,41
3,677,8966,3575861368,3575861410,42
3,677,8967,3575861368,3575861415,47
3,677,8968,3575861368,3575861416,48
3,677,8969,3575861368,3575861417,49
3,678,8970,3575861425,3575861425,0
3,678,8971,3575861425,3575861425,0
3,678,8972,3575861425,3575861425,0
3,678,8973,3575861425,3575861425,0
3,678,8974,3575861425,3575861425,0
3,678,8975,3575861425,3575861429,4
3,678,8976,3575861425,3575861429,4
3,678,8977,3575861425,3575861430,5
3,678,8978,3575861425,3575861432,7
3,678,8979,3575861425,3575861432,7
3,678,8980,3575861425,3575861434,9
3,678,8981,3575861425,3575861434,9
3,678,8982,3575861425,3575861436,11
3,678,8983,3575861425,3575861437,12
3,678,8984,3575861425,3575861438,13
3,678,8985,3575861425,3575861439,14
3,678,8986,3575861425,3575861440,15
3,678,8987,3575861425,3575861442,17
3,678,8988,3575861425,3575861443,18
3,678,8989,3575861425,3575861443,18
3,678,8990,3575861425,3575861445,20
3,678,8991,3575861425,3575861447,22
3,678,8992,3575861425,3575861448,23
3,678,8993,3575861425,3575861449,24
3,678,8994,3575861425,3575861450,25
3,678,8995,3575861425,3575861451,26
3,678,8996,3575861425,3575861453,28
3,678,8997,3575861425,3575861454,29
3,678,8998,3575861425,3575861457,32
3,678,8999,3575861425,3575861457,32
3,678,9000,3575861425,3575861459,34
3,678,9001,3575861425,3575861462,37
3,678,9002,3575861425,3575861462,37
3,678,9003,3575861425,3575861464,39
3,678,9004,3575861425,3575861464,39
3,678,9005,3575861425,3575861464,39
3,678,9006,3575861425,3575861466,41
3,678,9007,3575861425,3575861468,43
3,678,9008,3575861425,3575861469,44
3,678,9009,3575861425,3575861471,46
3,678,9010,3575861425,3575861471,46
3,678,9011,3575861425,3575861473,48
3,679,9012,3575861480,3575861480,0
3,679,9013,3575861480,3575861480,0
3,679,9014,3575861480,3575861480,0
3,679,9015,3575861480,3575861480,0
3,679,9016,3575861480,3575861480,0
3,679,9017,3575861480,3575861480,0
3,679,9018,3575861480,3575861482,2
3,679,9019,3575861480,3575861483,3
3,679,9020,3575861480,3575861483,3
3,679,9021,3575861480,3575861486,6
3,679,9022,3575861480,3575861491,11
3,679,9023,3575861480,3575861497,17
3,679,9024,3575861480,3575861500,20
3,679,9025,3575861480,3575861500,20
3,679,9026,3575861480,3575861501,21
3,679,9027,3575861480,3575861502,22
3,679,9028,3575861480,3575861503,23
3,679,9029,3575861480,3575861508,28
3,679,9030,3575861480,3575861509,29
3,679,9031,3575861480,3575861511,31
3,679,9032,3575861480,3575861512,32
3,679,9033,3575861480,3575861516,36
3,679,9034,3575861480,3575861517,37
3,679,9035,3575861480,3575861518,38
3,679,9036,3575861480,3575861519,39
3,679,9037,3575861480,3575861521,41
3,679,9038,3575861480,3575861521,41
3,679,9039,3575861480,3575861526,46
3,680,9040,3575861535,3575861535,0
3,680,9041,3575861535,3575861535,0
3,680,9042,3575861535,3575861536,1
3,680,9043,3575861535,3575861538,3
3,680,9044,3575861535,3575861542,7
3,680,9045,3575861535,3575861542,7
3,680,9046,3575861535,3575861543,8
3,680,9047,3575861535,3575861544,9
3,680,9048,3575861535,3575861545,10
3,680,9049,3575861535,3575861559,24
3,680,9050,3575861535,3575861562,27
3,680,9051,3575861535,3575861563,28
3,680,9052,3575861535,3575861565,30
3,680,9053,3575861535,3575861567,32
3,680,9054,3575861535,3575861567,32
3,680,9055,3575861535,3575861569,34
3,680,9056,3575861535,3575861570,35
3,680,9057,3575861535,3575861570,35
3,680,9058,3575861535,3575861570,35
3,680,9059,3575861535,3575861572,37
3,680,9060,3575861535,3575861577,42
3,680,9061,3575861535,3575861579,44
3,680,9062,3575861535,3575861580,45
3,680,9063,3575861535,3575861581,46
3,680,9064,3575861535,3575861582,47
3,680,9065,3575861535,3575861585,50
3,681,9066,3575861592,3575861592,0
3,681,9067,3575861592,3575861592,0
3,681,9068,3575861592,3575861592,0
3,681,9069,3575861592,3575861592,0
3,681,9070,3575861592,3575861592,0
3,681,9071,3575861592,3575861593,1
3,681,9072,3575861592,3575861593,1
3,681,9073,3575861592,3575861594,2
3,681,9074,3575861592,3575861595,3
3,681,9075,3575861592,3575861595,3
3,681,9076,3575861592,3575861596,4
3,681,9077,3575861592,3575861599,7
3,681,9078,3575861592,3575861601,9
3,681,9079,3575861592,3575861602,10
3,681,9080,3575861592,3575861603,11
3,681,9081,3575861592,3575861603,11
3,681,9082,3575861592,3575861607,15
3,681,9083,3575861592,3575861608,16
3,681,9084,3575861592,3575861610,18
3,681,9085,3575861592,3575861614,22
3,681,9086,3575861592,3575861615,23
3,681,9087,3575861592,3575861620,28
3,681,9088,3575861592,3575861620,28
3,681,9089,3575861592,3575861620,28
3,681,9090,3575861592,3575861620,28
3,681,9091,3575861592,3575861622,30
3,681,9092,3575861592,3575861625,33
3,681,9093,3575861592,3575861628,36
3,681,9094,3575861592,3575861628,36
3,681,9095,3575861592,3575861629,37
3,681,9096,3575861592,3575861630,38
3,681,9097,3575861592,3575861632,40
3,681,9098,3575861592,3575861632,40
3,681,9099,3575861592,3575861633,41
3,681,9100,3575861592,3575861635,43
3,681,9101,3575861592,3575861636,44
3,681,9102,3575861592,3575861638,46
3,681,9103,3575861592,3575861639,47
3,681,9104,3575861592,3575861640,48
3,682,9105,3575861648,3575861648,0
3,682,9106,3575861648,3575861648,0
3,682,9107,3575861648,3575861648,0
3,682,9108,3575861648,3575861648,0
3,682,9109,3575861648,3575861648,0
3,682,9110,3575861648,3575861649,1
3,682,9111,3575861648,3575861650,2
3,682,9112,3575861648,3575861652,4
3,682,9113,3575861648,3575861652,4
3,682,9114,3575861648,3575861653,5
3,682,9115,3575861648,3575861656,8
3,682,9116,3575861648,3575861656,8
3,682,9117,3575861648,3575861657,9
3,682,9118,3575861648,3575861658,10
3,682,9119,3575861648,3575861661,13
3,682,9120,3575861648,3575861661,13
3,682,9121,3575861648,3575861663,15
3,682,9122,3575861648,3575861664,16
3,682,9123,3575861648,3575861665,17
3,682,9124,3575861648,3575861667,19
3,682,9125,3575861648,3575861668,20
3,682,9126,3575861648,3575861670,22
3,682,9127,3575861648,3575861670,22
3,682,9128,3575861648,3575861673,25
3,682,9129,3575861648,3575861676,28
3,682,9130,3575861648,3575861676,28
3,682,9131,3575861648,3575861677,29
3,682,9132,3575861648,3575861677,29
3,682,9133,3575861648,3575861679,31
3,682,9134,3575861648,3575861680,32
3,682,9135,3575861648,3575861683,35
3,682,9136,3575861648,3575861683,35
3,682,9137,3575861648,3575861684,36
3,682,9138,3575861648,3575861686,38
3,682,9139,3575861648,3575861697,49
3,683,9140,3575861704,3575861704,0
3,683,9141,3575861704,3575861704,0
3,683,9142,3575861704,3575861704,0
3,683,9143,3575861704,3575861704,0
3,683,9144,3575861704,3575861708,4
3,683,9145,3575861704,3575861709,5
3,683,9146,3575861704,3575861712,8
3,683,9147,3575861704,3575861712,8
3,683,9148,3575861704,3575861712,8
3,683,9149,3575861704,3575861716,12
3,683,9150,3575861704,3575861718,14
3,683,9151,3575861704,3575861720,16
3,683,9152,3575861704,3575861721,17
3,683,9153,3575861704,3575861726,22
3,683,9154,3575861704,3575861733,29
3,683,9155,3575861704,3575861736,32
3,683,9156,3575861704,3575861738,34
3,683,9157,3575861704,3575861743,39
3,683,9158,3575861704,3575861743,39
3,683,9159,3575861704,3575861744,40
3,683,9160,3575861704,3575861745,41
3,683,9161,3575861704,3575861746,42
3,683,9162,3575861704,3575861751,47
3,684,9163,3575861760,3575861760,0
3,684,9164,3575861760,3575861763,3
3,684,9165,3575861760,3575861763,3
3,684,9166,3575861760,3575861765,5
3,684,9167,3575861760,3575861767,7
3,684,9168,3575861760,3575861769,9
3,684,9169,3575861760,3575861770,10
3,684,9170,3575861760,3575861770,10
3,684,9171,3575861760,3575861770,10
3,684,9172,3575861760,3575861772,12
3,684,9173,3575861760,3575861778,18
3,684,9174,3575861760,3575861778,18
3,684,9175,3575861760,3575861780,20
3,684,9176,3575861760,3575861781,21
3,684,9177,3575861760,3575861783,23
3,684,9178,3575861760,3575861783,23
3,684,9179,3575861760,3575861785,25
3,684,9180,3575861760,3575861786,26
3,684,9181,3575861760,3575861787,27
3,684,9182,3575861760,3575861788,28
3,684,9183,3575861760,3575861792,32
3,684,9184,3575861760,3575861792,32
3,684,9185,3575861760,3575861794,34
3,684,9186,3575861760,3575861794,34
3,684,9187,3575861760,3575861795,35
3,684,9188,3575861760,3575861795,35
3,684,9189,3575861760,3575861796,36
3,684,9190,3575861760,3575861800,40
3,684,9191,3575861760,3575861802,42
3,684,9192,3575861760,3575861803,43
3,684,9193,3575861760,3575861803,43
3,684,9194,3575861760,3575861807,47
3,684,9195,3575861760,3575861808,48
3,684,9196,3575861760,3575861810,50
3,685,9197,3575861816,3575861816,0
3,685,9198,3575861816,3575861816,0
3,685,9199,3575861816,3575861819,3
3,685,9200,3575861816,3575861821,5
3,685,9201,3575861816,3575861821,5
3,685,9202,3575861816,3575861822,6
3,685,9203,3575861816,3575861824,8
3,685,9204,3575861816,3575861828,12
3,685,9205,3575861816,3575861829,13
3,685,9206,3575861816,3575861829,13
3,685,9207,3575861816,3575861831,15
3,685,9208,3575861816,3575861832,16
3,685,9209,3575861816,3575861832,16
3,685,9210,3575861816,3575861834,18
3,685,9211,3575861816,3575861835,19
3,685,9212,3575861816,3575861836,20
3,685,9213,3575861816,3575861838,22
3,685,9214,3575861816,3575861838,22
3,685,9215,3575861816,3575861839,23
3,685,9216,3575861816,3575861841,25
3,685,9217,3575861816,3575861842,26
3,685,9218,3575861816,3575861842,26
3,685,9219,3575861816,3575861845,29
3,685,9220,3575861816,3575861848,32
3,685,9221,3575861816,3575861849,33
3,685,9222,3575861816,3575861849,33
3,685,9223,3575861816,3575861851,35
3,685,9224,3575861816,3575861853,37
3,685,9225,3575861816,3575861853,37
3,685,9226,3575861816,3575861856,40
3,685,9227,3575861816,3575861856,40
3,685,9228,3575861816,3575861858,42
3,685,9229,3575861816,3575861860,44
3,685,9230,3575861816,3575861862,46
3,685,9231,3575861816,3575861862,46
3,685,9232,3575861816,3575861863,47
3,685,9233,3575861816,3575861863,47
3,685,9234,3575861816,3575861864,48
3,686,9235,3575861871,3575861871,0
3,686,9236,3575861871,3575861871,0
3,686,9237,3575861871,3575861871,0
3,686,9238,3575861871,3575861871,0
3,686,9239,3575861871,3575861873,2
3,686,9240,3575861871,3575861876,5
3,686,9241,3575861871,3575861876,5
3,686,9242,3575861871,3575861877,6
3,686,9243,3575861871,3575861878,7
3,686,9244,3575861871,3575861879,8
3,686,9245,3575861871,3575861880,9
3,686,9246,3575861871,3575861882,11
3,686,9247,3575861871,3575861884,13
3,686,9248,3575861871,3575861885,14
3,686,9249,3575861871,3575861886,15
3,686,9250,3575861871,3575861891,20
3,686,9251,3575861871,3575861898,27
3,686,9252,3575861871,3575861900,29
3,686,9253,3575861871,3575861900,29
3,686,9254,3575861871,3575861900,29
3,686,9255,3575861871,3575861902,31
3,686,9256,3575861871,3575861908,37
3,686,9257,3575861871,3575861909,38
3,686,9258,3575861871,3575861912,41
3,686,9259,3575861871,3575861916,45
3,686,9260,3575861871,3575861917,46
3,686,9261,3575861871,3575861918,47
3,686,9262,3575861871,3575861920,49
3,686,9263,3575861871,3575861921,50
3,687,9264,3575861926,3575861926,0
3,687,9265,3575861926,3575861932,6
3,687,9266,3575861926,3575861933,7
3,687,9267,3575861926,3575861937,11
3,687,9268,3575861926,3575861938,12
3,687,9269,3575861926,3575861942,16
3,687,9270,3575861926,3575861943,17
3,687,9271,3575861926,3575861943,17
3,687,9272,3575861926,3575861945,19
3,687,9273,3575861926,3575861945,19
3,687,9274,3575861926,3575861946,20
3,687,9275,3575861926,3575861951,25
3,687,9276,3575861926,3575861955,29
3,687,9277,3575861926,3575861960,34
3,687,9278,3575861926,3575861963,37
3,687,9279,3575861926,3575861964,38
3,687,9280,3575861926,3575861966,40
3,687,9281,3575861926,3575861967,41
3,687,9282,3575861926,3575861968,42
3,687,9283,3575861926,3575861969,43
3,687,9284,3575861926,3575861969,43
3,687,9285,3575861926,3575861970,44
3,687,9286,3575861926,3575861970,44
3,687,9287,3575861926,3575861973,47
3,688,9288,3575861981,3575861981,0
3,688,9289,3575861981,3575861981,0
3,688,9290,3575861981,3575861983,2
3,688,9291,3575861981,3575861983,2
3,688,9292,3575861981,3575861984,3
3,688,9293,3575861981,3575861985,4
3,688,9294,3575861981,3575861986,5
3,688,9295,3575861981,3575861987,6
3,688,9296,3575861981,3575861988,7
3,688,9297,3575861981,3575861992,11
3,688,9298,3575861981,3575861992,11
3,688,9299,3575861981,3575861994,13
3,688,9300,3575861981,3575861995,14
3,688,9301,3575861981,3575861995,14
3,688,9302,3575861981,3575861995,14
3,688,9303,3575861981,3575861995,14
3,688,9304,3575861981,3575861997,16
3,688,9305,3575861981,3575861997,16
3,688,9306,3575861981,3575861999,18
3,688,9307,3575861981,3575862003,22
3,688,9308,3575861981,3575862003,22
3,688,9309,3575861981,3575862003,22
3,688,9310,3575861981,3575862004,23
3,688,9311,3575861981,3575862007,26
3,688,9312,3575861981,3575862009,28
3,688,9313,3575861981,3575862010,29
3,688,9314,3575861981,3575862015,34
3,688,9315,3575861981,3575862016,35
3,688,9316,3575861981,3575862017,36
3,688,9317,3575861981,3575862020,39
3,688,9318,3575861981,3575862020,39
3,688,9319,3575861981,3575862021,40
3,688,9320,3575861981,3575862021,40
3,688,9321,3575861981,3575862022,41
3,688,9322,3575861981,3575862025,44
3,688,9323,3575861981,3575862028,47
3,688,9324,3575861981,3575862028,47
3,688,9325,3575861981,3575862029,48
3,689,9326,3575862036,3575862036,0
3,689,9327,3575862036,3575862036,0
3,689,9328,3575862036,3575862036,0
3,689,9329,3575862036,3575862036,0
3,689,9330,3575862036,3575862036,0
3,689,9331,3575862036,3575862036,0
3,689,9332,3575862036,3575862038,2
3,689,9333,3575862036,3575862039,3
3,689,9334,3575862036,3575862041,5
3,689,9335,3575862036,3575862042,6
3,689,9336,3575862036,3575862043,7
3,689,9337,3575862036,3575862046,10
3,689,9338,3575862036,3575862046,10
3,689,9339,3575862036,3575862048,12
3,689,9340,3575862036,3575862049,13
3,689,9341,3575862036,3575862050,14
3,689,9342,3575862036,3575862051,15
3,689,9343,3575862036,3575862053,17
3,689,9344,3575862036,3575862053,17
3,689,9345,3575862036,3575862053,17
3,689,9346,3575862036,3575862057,21
3,689,9347,3575862036,3575862057,21
3,689,9348,3575862036,3575862058,22
3,689,9349,3575862036,3575862061,25
3,689,9350,3575862036,3575862062,26
3,689,9351,3575862036,3575862063,27
3,689,9352,3575862036,3575862063,27
3,689,9353,3575862036,3575862064,28
3,689,9354,3575862036,3575862065,29
3,689,9355,3575862036,3575862069,33
3,689,9356,3575862036,3575862069,33
3,689,9357,3575862036,3575862069,33
3,689,9358,3575862036,3575862070,34
3,689,9359,3575862036,3575862073,37
3,689,9360,3575862036,3575862075,39
3,689,9361,3575862036,3575862076,40
3,689,9362,3575862036,3575862078,42
3,689,9363,3575862036,3575862078,42
3,689,9364,3575862036,3575862079,43
3,689,9365,3575862036,3575862079,43
3,689,9366,3575862036,3575862082,46
3,689,9367,3575862036,3575862084,48
3,689,9368,3575862036,3575862085,49
3,689,9369,3575862036,3575862085,49
3,690,9370,3575862091,3575862091,0
3,690,9371,3575862091,3575862091,0
3,690,9372,3575862091,3575862098,7
3,690,9373,3575862091,3575862099,8
3,690,9374,3575862091,3575862100,9
3,690,9375,3575862091,3575862100,9
3,690,9376,3575862091,3575862102,11
3,690,9377,3575862091,3575862103,12
3,690,9378,3575862091,3575862108,17
3,690,9379,3575862091,3575862110,19
3,690,9380,3575862091,3575862111,20
3,690,9381,3575862091,3575862113,22
3,690,9382,3575862091,3575862113,22
3,690,9383,3575862091,3575862117,26
3,690,9384,3575862091,3575862117,26
3,690,9385,3575862091,3575862118,27
3,690,9386,3575862091,3575862121,30
3,690,9387,3575862091,3575862121,30
3,690,9388,3575862091,3575862122,31
3,690,9389,3575862091,3575862127,36
3,690,9390,3575862091,3575862132,41
3,690,9391,3575862091,3575862134,43
3,690,9392,3575862091,3575862137,46
3,690,9393,3575862091,3575862138,47
3,691,9394,3575862146,3575862146,0
3,691,9395,3575862146,3575862146,0
3,691,9396,3575862146,3575862146,0
3,691,9397,3575862146,3575862146,0
3,691,9398,3575862146,3575862146,0
3,691,9399,3575862146,3575862146,0
3,691,9400,3575862146,3575862151,5
3,691,9401,3575862146,3575862152,6
3,691,9402,3575862146,3575862155,9
3,691,9403,3575862146,3575862159,13
3,691,9404,3575862146,3575862163,17
3,691,9405,3575862146,3575862164,18
3,691,9406,3575862146,3575862167,21
3,691,9407,3575862146,3575862169,23
3,691,9408,3575862146,3575862169,23
3,691,9409,3575862146,3575862169,23
3,691,9410,3575862146,3575862170,24
3,691,9411,3575862146,3575862170,24
3,691,9412,3575862146,3575862170,24
3,691,9413,3575862146,3575862178,32
3,691,9414,3575862146,3575862178,32
3,691,9415,3575862146,3575862181,35
3,691,9416,3575862146,3575862181,35
3,691,9417,3575862146,3575862183,37
3,691,9418,3575862146,3575862184,38
3,691,9419,3575862146,3575862185,39
3,691,9420,3575862146,3575862186,40
3,691,9421,3575862146,3575862187,41
3,691,9422,3575862146,3575862188,42
3,691,9423,3575862146,3575862192,46
3,691,9424,3575862146,3575862192,46
3,691,9425,3575862146,3575862194,48
3,691,9426,3575862146,3575862195,49
3,691,9427,3575862146,3575862195,49
3,691,9428,3575862146,3575862195,49
3,691,9429,3575862146,3575862196,50
3,692,9430,3575862201,3575862201,0
3,692,9431,3575862201,3575862201,0
3,692,9432,3575862201,3575862201,0
3,692,9433,3575862201,3575862202,1
3,692,9434,3575862201,3575862203,2
3,692,9435,3575862201,3575862204,3
3,692,9436,3575862201,3575862208,7
3,692,9437,3575862201,3575862209,8
3,692,9438,3575862201,3575862210,9
3,692,9439,3575862201,3575862216,15
3,692,9440,3575862201,3575862216,15
3,692,9441,3575862201,3575862217,16
3,692,9442,3575862201,3575862220,19
3,692,9443,3575862201,3575862221,20
3,692,9444,3575862201,3575862222,21
3,692,9445,3575862201,3575862225,24
3,692,9446,3575862201,3575862228,27
3,692,9447,3575862201,3575862229,28
3,692,9448,3575862201,3575862230,29
3,692,9449,3575862201,3575862231,30
3,692,9450,3575862201,3575862232,31
3,692,9451,3575862201,3575862233,32
3,692,9452,3575862201,3575862234,33
3,692,9453,3575862201,3575862236,35
3,692,9454,3575862201,3575862236,35
3,692,9455,3575862201,3575862238,37
3,692,9456,3575862201,3575862238,37
3,692,9457,3575862201,3575862239,38
3,692,9458,3575862201,3575862241,40
3,692,9459,3575862201,3575862242,41
3,692,9460,3575862201,3575862244,43
3,692,9461,3575862201,3575862245,44
3,692,9462,3575862201,3575862248,47
3,692,9463,3575862201,3575862250,49
3,692,9464,3575862201,3575862251,50
3,693,9465,3575862257,3575862257,0
3,693,9466,3575862257,3575862257,0
3,693,9467,3575862257,3575862257,0
3,693,9468,3575862257,3575862257,0
3,693,9469,3575862257,3575862258,1
3,693,9470,3575862257,3575862261,4
3,693,9471,3575862257,3575862262,5
3,693,9472,3575862257,3575862262,5
3,693,9473,3575862257,3575862263,6
3,693,9474,3575862257,3575862264,7
3,693,9475,3575862257,3575862265,8
3,693,9476,3575862257,3575862269,12
3,693,9477,3575862257,3575862269,12
3,693,9478,3575862257,3575862269,12
3,693,9479,3575862257,3575862269,12
3,693,9480,3575862257,3575862277,20
3,693,9481,3575862257,3575862278,21
3,693,9482,3575862257,3575862278,21
3,693,9483,3575862257,3575862279,22
3,693,9484,3575862257,3575862279,22
3,693,9485,3575862257,3575862281,24
3,693,9486,3575862257,3575862282,25
3,693,9487,3575862257,3575862284,27
3,693,9488,3575862257,3575862284,27
3,693,9489,3575862257,3575862285,28
3,693,9490,3575862257,3575862286,29
3,693,9491,3575862257,3575862292,35
3,693,9492,3575862257,3575862298,41
3,693,9493,3575862257,3575862300,43
3,693,9494,3575862257,3575862300,43
3,693,9495,3575862257,3575862301,44
3,693,9496,3575862257,3575862302,45
3,693,9497,3575862257,3575862303,46
3,694,9498,3575862312,3575862312,0
3,694,9499,3575862312,3575862312,0
3,694,9500,3575862312,3575862312,0
3,694,9501,3575862312,3575862313,1
3,694,9502,3575862312,3575862318,6
3,694,9503,3575862312,3575862318,6
3,694,9504,3575862312,3575862320,8
3,694,9505,3575862312,3575862322,10
3,694,9506,3575862312,3575862323,11
3,694,9507,3575862312,3575862327,15
3,694,9508,3575862312,3575862332,20
3,694,9509,3575862312,3575862334,22
3,694,9510,3575862312,3575862337,25
3,694,9511,3575862312,3575862338,26
3,694,9512,3575862312,3575862342,30
3,694,9513,3575862312,3575862344,32
3,694,9514,3575862312,3575862345,33
3,694,9515,3575862312,3575862345,33
3,694,9516,3575862312,3575862347,35
3,694,9517,3575862312,3575862352,40
3,694,9518,3575862312,3575862352,40
3,694,9519,3575862312,3575862355,43
3,694,9520,3575862312,3575862359,47
3,695,9521,3575862369,3575862369,0
3,695,9522,3575862369,3575862369,0
3,695,9523,3575862369,3575862369,0
3,695,9524,3575862369,3575862369,0
3,695,9525,3575862369,3575862369,0
3,695,9526,3575862369,3575862370,1
3,695,9527,3575862369,3575862370,1
3,695,9528,3575862369,3575862371,2
3,695,9529,3575862369,3575862373,4
3,695,9530,3575862369,3575862378,9
3,695,9531,3575862369,3575862378,9
3,695,9532,3575862369,3575862381,12
3,695,9533,3575862369,3575862381,12
3,695,9534,3575862369,3575862383,14
3,695,9535,3575862369,3575862384,15
3,695,9536,3575862369,3575862386,17
3,695,9537,3575862369,3575862386,17
3,695,9538,3575862369,3575862386,17
3,695,9539,3575862369,3575862387,18
3,695,9540,3575862369,3575862387,18
3,695,9541,3575862369,3575862392,23
3,695,9542,3575862369,3575862395,26
3,695,9543,3575862369,3575862395,26
3,695,9544,3575862369,3575862395,26
3,695,9545,3575862369,3575862396,27
3,695,9546,3575862369,3575862396,27
3,695,9547,3575862369,3575862397,28
3,695,9548,3575862369,3575862401,32
3,695,9549,3575862369,3575862403,34
3,695,9550,3575862369,3575862403,34
3,695,9551,3575862369,3575862403,34
3,695,9552,3575862369,3575862404,35
3,695,9553,3575862369,3575862410,41
3,695,9554,3575862369,3575862410,41
3,695,9555,3575862369,3575862411,42
3,695,9556,3575862369,3575862416,47
3,695,9557,3575862369,3575862416,47
3,695,9558,3575862369,3575862416,47
3,696,9559,3575862424,3575862424,0
3,696,9560,3575862424,3575862424,0
3,696,9561,3575862424,3575862424,0
3,696,9562,3575862424,3575862424,0
3,696,9563,3575862424,3575862424,0
3,696,9564,3575862424,3575862429,5
3,696,9565,3575862424,3575862429,5
3,696,9566,3575862424,3575862431,7
3,696,9567,3575862424,3575862432,8
3,696,9568,3575862424,3575862432,8
3,696,9569,3575862424,3575862434,10
3,696,9570,3575862424,3575862434,10
3,696,9571,3575862424,3575862436,12
3,696,9572,3575862424,3575862436,12
3,696,9573,3575862424,3575862438,14
3,696,9574,3575862424,3575862439,15
3,696,9575,3575862424,3575862441,17
3,696,9576,3575862424,3575862442,18
3,696,9577,3575862424,3575862444,20
3,696,9578,3575862424,3575862445,21
3,696,9579,3575862424,3575862446,22
3,696,9580,3575862424,3575862448,24
3,696,9581,3575862424,3575862449,25
3,696,9582,3575862424,3575862451,27
3,696,9583,3575862424,3575862452,28
3,696,9584,3575862424,3575862453,29
3,696,9585,3575862424,3575862454,30
3,696,9586,3575862424,3575862455,31
3,696,9587,3575862424,3575862456,32
3,696,9588,3575862424,3575862457,33
3,696,9589,3575862424,3575862459,35
3,696,9590,3575862424,3575862461,37
3,696,9591,3575862424,3575862462,38
3,696,9592,3575862424,3575862463,39
3,696,9593,3575862424,3575862463,39
3,696,9594,3575862424,3575862465,41
3,696,9595,3575862424,3575862465,41
3,696,9596,3575862424,3575862469,45
3,696,9597,3575862424,3575862469,45
3,696,9598,3575862424,3575862470,46
3,697,9599,3575862481,3575862481,0
3,697,9600,3575862481,3575862481,0
3,697,9601,3575862481,3575862481,0
3,697,9602,3575862481,3575862481,0
3,697,9603,3575862481,3575862481,0
3,697,9604,3575862481,3575862481,0
3,697,9605,3575862481,3575862483,2
3,697,9606,3575862481,3575862483,2
3,697,9607,3575862481,3575862484,3
3,697,9608,3575862481,3575862484,3
3,697,9609,3575862481,3575862485,4
3,697,9610,3575862481,3575862490,9
3,697,9611,3575862481,3575862497,16
3,697,9612,3575862481,3575862500,19
3,697,9613,3575862481,3575862500,19
3,697,9614,3575862481,3575862501,20
3,697,9615,3575862481,3575862502,21
3,697,9616,3575862481,3575862507,26
3,697,9617,3575862481,3575862511,30
3,697,9618,3575862481,3575862511,30
3,697,9619,3575862481,3575862512,31
3,697,9620,3575862481,3575862512,31
3,697,9621,3575862481,3575862516,35
3,697,9622,3575862481,3575862517,36
3,697,9623,3575862481,3575862517,36
3,697,9624,3575862481,3575862519,38
3,697,9625,3575862481,3575862521,40
3,697,9626,3575862481,3575862521,40
3,697,9627,3575862481,3575862525,44
3,698,9628,3575862538,3575862538,0
3,698,9629,3575862538,3575862538,0
3,698,9630,3575862538,3575862538,0
3,698,9631,3575862538,3575862543,5
3,698,9632,3575862538,3575862544,6
3,698,9633,3575862538,3575862544,6
3,698,9634,3575862538,3575862546,8
3,698,9635,3575862538,3575862550,12
3,698,9636,3575862538,3575862551,13
3,698,9637,3575862538,3575862559,21
3,698,9638,3575862538,3575862562,24
3,698,9639,3575862538,3575862563,25
3,698,9640,3575862538,3575862566,28
3,698,9641,3575862538,3575862569,31
3,698,9642,3575862538,3575862569,31
3,698,9643,3575862538,3575862569,31
3,698,9644,3575862538,3575862570,32
3,698,9645,3575862538,3575862570,32
3,698,9646,3575862538,3575862572,34
3,698,9647,3575862538,3575862577,39
3,698,9648,3575862538,3575862578,40
3,698,9649,3575862538,3575862580,42
3,698,9650,3575862538,3575862581,43
3,698,9651,3575862538,3575862582,44
3,698,9652,3575862538,3575862583,45
3,698,9653,3575862538,3575862584,46
3,698,9654,3575862538,3575862585,47
3,698,9655,3575862538,3575862586,48
3,698,9656,3575862538,3575862587,49
3,698,9657,3575862538,3575862587,49
3,699,9658,3575862593,3575862593,0
3,699,9659,3575862593,3575862593,0
3,699,9660,3575862593,3575862594,1
3,699,9661,3575862593,3575862594,1
3,699,9662,3575862593,3575862595,2
3,699,9663,3575862593,3575862595,2
3,699,9664,3575862593,3575862595,2
3,699,9665,3575862593,3575862596,3
3,699,9666,3575862593,3575862600,7
3,699,9667,3575862593,3575862602,9
3,699,9668,3575862593,3575862603,10
3,699,9669,3575862593,3575862608,15
3,699,9670,3575862593,3575862608,15
3,699,9671,3575862593,3575862611,18
3,699,9672,3575862593,3575862615,22
3,699,9673,3575862593,3575862619,26
3,699,9674,3575862593,3575862621,28
3,699,9675,3575862593,3575862622,29
3,699,9676,3575862593,3575862622,29
3,699,9677,3575862593,3575862625,32
3,699,9678,3575862593,3575862628,35
3,699,9679,3575862593,3575862629,36
3,699,9680,3575862593,3575862630,37
3,699,9681,3575862593,3575862630,37
3,699,9682,3575862593,3575862631,38
3,699,9683,3575862593,3575862633,40
3,699,9684,3575862593,3575862633,40
3,699,9685,3575862593,3575862635,42
3,699,9686,3575862593,3575862636,43
3,699,9687,3575862593,3575862637,44
3,699,9688,3575862593,3575862637,44
3,699,9689,3575862593,3575862638,45
3,699,9690,3575862593,3575862639,46
3,699,9691,3575862593,3575862642,49
3,700,9692,3575862649,3575862649,0
3,700,9693,3575862649,3575862649,0
3,700,9694,3575862649,3575862649,0
3,700,9695,3575862649,3575862649,0
3,700,9696,3575862649,3575862650,1
3,700,9697,3575862649,3575862651,2
3,700,9698,3575862649,3575862652,3
3,700,9699,3575862649,3575862653,4
3,700,9700,3575862649,3575862655,6
3,700,9701,3575862649,3575862659,10
3,700,9702,3575862649,3575862661,12
3,700,9703,3575862649,3575862661,12
3,700,9704,3575862649,3575862662,13
3,700,9705,3575862649,3575862662,13
3,700,9706,3575862649,3575862664,15
3,700,9707,3575862649,3575862664,15
3,700,9708,3575862649,3575862668,19
3,700,9709,3575862649,3575862668,19
3,700,9710,3575862649,3575862668,19
3,700,9711,3575862649,3575862669,20
3,700,9712,3575862649,3575862677,28
3,700,9713,3575862649,3575862677,28
3,700,9714,3575862649,3575862678,29
3,700,9715,3575862649,3575862681,32
3,700,9716,3575862649,3575862682,33
3,700,9717,3575862649,3575862683,34
3,700,9718,3575862649,3575862683,34
3,700,9719,3575862649,3575862683,34
3,700,9720,3575862649,3575862685,36
3,700,9721,3575862649,3575862691,42
3,700,9722,3575862649,3575862697,48
3,700,9723,3575862649,3575862699,50
3,701,9724,3575862706,3575862706,0
3,701,9725,3575862706,3575862706,0
3,701,9726,3575862706,3575862706,0
3,701,9727,3575862706,3575862707,1
3,701,9728,3575862706,3575862711,5
3,701,9729,3575862706,3575862711,5
3,701,9730,3575862706,3575862711,5
3,701,9731,3575862706,3575862712,6
3,701,9732,3575862706,3575862716,10
3,701,9733,3575862706,3575862717,11
3,701,9734,3575862706,3575862717,11
3,701,9735,3575862706,3575862720,14
3,701,9736,3575862706,3575862722,16
3,701,9737,3575862706,3575862722,16
3,701,9738,3575862706,3575862726,20
3,701,9739,3575862706,3575862733,27
3,701,9740,3575862706,3575862736,30
3,701,9741,3575862706,3575862737,31
3,701,9742,3575862706,3575862742,36
3,701,9743,3575862706,3575862742,36
3,701,9744,3575862706,3575862743,37
3,701,9745,3575862706,3575862744,38
3,701,9746,3575862706,3575862745,39
3,701,9747,3575862706,3575862746,40
3,701,9748,3575862706,3575862751,45
3,701,9749,3575862706,3575862751,45
3,702,9750,3575862762,3575862762,0
3,702,9751,3575862762,3575862762,0
3,702,9752,3575862762,3575862763,1
3,702,9753,3575862762,3575862766,4
3,702,9754,3575862762,3575862769,7
3,702,9755,3575862762,3575862769,7
3,702,9756,3575862762,3575862769,7
3,702,9757,3575862762,3575862770,8
3,702,9758,3575862762,3575862770,8
3,702,9759,3575862762,3575862773,11
3,702,9760,3575862762,3575862778,16
3,702,9761,3575862762,3575862780,18
3,702,9762,3575862762,3575862781,19
3,702,9763,3575862762,3575862782,20
3,702,9764,3575862762,3575862783,21
3,702,9765,3575862762,3575862785,23
3,702,9766,3575862762,3575862785,23
3,702,9767,3575862762,3575862785,23
3,702,9768,3575862762,3575862786,24
3,702,9769,3575862762,3575862787,25
3,702,9770,3575862762,3575862791,29
3,702,9771,3575862762,3575862792,30
3,702,9772,3575862762,3575862794,32
3,702,9773,3575862762,3575862794,32
3,702,9774,3575862762,3575862794,32
3,702,9775,3575862762,3575862795,33
3,702,9776,3575862762,3575862800,38
3,702,9777,3575862762,3575862801,39
3,702,9778,3575862762,3575862803,41
3,702,9779,3575862762,3575862803,41
3,702,9780,3575862762,3575862803,41
3,702,9781,3575862762,3575862803,41
3,702,9782,3575862762,3575862808,46
3,702,9783,3575862762,3575862808,46
3,702,9784,3575862762,3575862811,49
3,703,9785,3575862817,3575862817,0
3,703,9786,3575862817,3575862817,0
3,703,9787,3575862817,3575862817,0
3,703,9788,3575862817,3575862820,3
3,703,9789,3575862817,3575862820,3
3,703,9790,3575862817,3575862821,4
3,703,9791,3575862817,3575862821,4
3,703,9792,3575862817,3575862822,5
3,703,9793,3575862817,3575862826,9
3,703,9794,3575862817,3575862829,12
3,703,9795,3575862817,3575862830,13
3,703,9796,3575862817,3575862830,13
3,703,9797,3575862817,3575862831,14
3,703,9798,3575862817,3575862831,14
3,703,9799,3575862817,3575862834,17
3,703,9800,3575862817,3575862834,17
3,703,9801,3575862817,3575862836,19
3,703,9802,3575862817,3575862838,21
3,703,9803,3575862817,3575862838,21
3,703,9804,3575862817,3575862842,25
3,703,9805,3575862817,3575862844,27
3,703,9806,3575862817,3575862845,28
3,703,9807,3575862817,3575862845,28
3,703,9808,3575862817,3575862847,30
3,703,9809,3575862817,3575862848,31
3,703,9810,3575862817,3575862849,32
3,703,9811,3575862817,3575862851,34
3,703,9812,3575862817,3575862852,35
3,703,9813,3575862817,3575862853,36
3,703,9814,3575862817,3575862854,37
3,703,9815,3575862817,3575862856,39
3,703,9816,3575862817,3575862856,39
3,703,9817,3575862817,3575862860,43
3,703,9818,3575862817,3575862860,43
3,703,9819,3575862817,3575862862,45
3,703,9820,3575862817,3575862864,47
3,703,9821,3575862817,3575862864,47
3,703,9822,3575862817,3575862864,47
3,703,9823,3575862817,3575862865,48
3,704,9824,3575862874,3575862874,0
3,704,9825,3575862874,3575862874,0
3,704,9826,3575862874,3575862874,0
3,704,9827,3575862874,3575862874,0
3,704,9828,3575862874,3575862876,2
3,704,9829,3575862874,3575862877,3
3,704,9830,3575862874,3575862877,3
3,704,9831,3575862874,3575862878,4
3,704,9832,3575862874,3575862879,5
3,704,9833,3575862874,3575862880,6
3,704,9834,3575862874,3575862882,8
3,704,9835,3575862874,3575862883,9
3,704,9836,3575862874,3575862884,10
3,704,9837,3575862874,3575862885,11
3,704,9838,3575862874,3575862890,16
3,704,9839,3575862874,3575862897,23
3,704,9840,3575862874,3575862900,26
3,704,9841,3575862874,3575862900,26
3,704,9842,3575862874,3575862901,27
3,704,9843,3575862874,3575862901,27
3,704,9844,3575862874,3575862902,28
3,704,9845,3575862874,3575862907,33
3,704,9846,3575862874,3575862911,37
3,704,9847,3575862874,3575862912,38
3,704,9848,3575862874,3575862912,38
3,704,9849,3575862874,3575862912,38
3,704,9850,3575862874,3575862917,43
3,704,9851,3575862874,3575862917,43
3,704,9852,3575862874,3575862917,43
3,704,9853,3575862874,3575862920,46
3,704,9854,3575862874,3575862922,48
3,704,9855,3575862874,3575862922,48
3,705,9856,3575862930,3575862930,0
3,705,9857,3575862930,3575862933,3
3,705,9858,3575862930,3575862937,7
3,705,9859,3575862930,3575862942,12
3,705,9860,3575862930,3575862943,13
3,705,9861,3575862930,3575862943,13
3,705,9862,3575862930,3575862944,14
3,705,9863,3575862930,3575862945,15
3,705,9864,3575862930,3575862946,16
3,705,9865,3575862930,3575862950,20
3,705,9866,3575862930,3575862960,30
3,705,9867,3575862930,3575862962,32
3,705,9868,3575862930,3575862962,32
3,705,9869,3575862930,3575862966,36
3,705,9870,3575862930,3575862969,39
3,705,9871,3575862930,3575862969,39
3,705,9872,3575862930,3575862970,40
3,705,9873,3575862930,3575862970,40
3,705,9874,3575862930,3575862970,40
3,705,9875,3575862930,3575862977,47
3,705,9876,3575862930,3575862978,48
3,706,9877,3575862987,3575862987,0
3,706,9878,3575862987,3575862987,0
3,706,9879,3575862987,3575862987,0
3,706,9880,3575862987,3575862987,0
3,706,9881,3575862987,3575862987,0
3,706,9882,3575862987,3575862987,0
3,706,9883,3575862987,3575862987,0
3,706,9884,3575862987,3575862987,0
3,706,9885,3575862987,3575862992,5
3,706,9886,3575862987,3575862992,5
3,706,9887,3575862987,3575862994,7
3,706,9888,3575862987,3575862995,8
3,706,9889,3575862987,3575862995,8
3,706,9890,3575862987,3575862996,9
3,706,9891,3575862987,3575862996,9
3,706,9892,3575862987,3575862997,10
3,706,9893,3575862987,3575863000,13
3,706,9894,3575862987,3575863002,15
3,706,9895,3575862987,3575863003,16
3,706,9896,3575862987,3575863003,16
3,706,9897,3575862987,3575863004,17
3,706,9898,3575862987,3575863008,21
3,706,9899,3575862987,3575863009,22
3,706,9900,3575862987,3575863011,24
3,706,9901,3575862987,3575863015,28
3,706,9902,3575862987,3575863016,29
3,706,9903,3575862987,3575863017,30
3,706,9904,3575862987,3575863020,33
3,706,9905,3575862987,3575863020,33
3,706,9906,3575862987,3575863021,34
3,706,9907,3575862987,3575863022,35
3,706,9908,3575862987,3575863022,35
3,706,9909,3575862987,3575863025,38
3,706,9910,3575862987,3575863029,42
3,706,9911,3575862987,3575863031,44
3,706,9912,3575862987,3575863031,44
3,706,9913,3575862987,3575863032,45
3,706,9914,3575862987,3575863032,45
3,706,9915,3575862987,3575863034,47
3,706,9916,3575862987,3575863035,48
3,706,9917,3575862987,3575863035,48
3,706,9918,3575862987,3575863037,50
3,707,9919,3575863043,3575863043,0
3,707,9920,3575863043,3575863043,0
3,707,9921,3575863043,3575863043,0
3,707,9922,3575863043,3575863043,0
3,707,9923,3575863043,3575863043,0
3,707,9924,3575863043,3575863045,2
3,707,9925,3575863043,3575863047,4
3,707,9926,3575863043,3575863048,5
3,707,9927,3575863043,3575863049,6
3,707,9928,3575863043,3575863052,9
3,707,9929,3575863043,3575863052,9
3,707,9930,3575863043,3575863054,11
3,707,9931,3575863043,3575863055,12
3,707,9932,3575863043,3575863057,14
3,707,9933,3575863043,3575863060,17
3,707,9934,3575863043,3575863061,18
3,707,9935,3575863043,3575863061,18
3,707,9936,3575863043,3575863063,20
3,707,9937,3575863043,3575863064,21
3,707,9938,3575863043,3575863064,21
3,707,9939,3575863043,3575863064,21
3,707,9940,3575863043,3575863065,22
3,707,9941,3575863043,3575863067,24
3,707,9942,3575863043,3575863068,25
3,707,9943,3575863043,3575863069,26
3,707,9944,3575863043,3575863069,26
3,707,9945,3575863043,3575863069,26
3,707,9946,3575863043,3575863077,34
3,707,9947,3575863043,3575863077,34
3,707,9948,3575863043,3575863078,35
3,707,9949,3575863043,3575863079,36
3,707,9950,3575863043,3575863080,37
3,707,9951,3575863043,3575863081,38
3,707,9952,3575863043,3575863082,39
3,707,9953,3575863043,3575863084,41
3,707,9954,3575863043,3575863084,41
3,707,9955,3575863043,3575863085,42
3,707,9956,3575863043,3575863090,47
3,708,9957,3575863099,3575863099,0
3,708,9958,3575863099,3575863099,0
3,708,9959,3575863099,3575863100,1
3,708,9960,3575863099,3575863101,2
3,708,9961,3575863099,3575863101,2
3,708,9962,3575863099,3575863103,4
3,708,9963,3575863099,3575863107,8
3,708,9964,3575863099,3575863111,12
3,708,9965,3575863099,3575863112,13
3,708,9966,3575863099,3575863112,13
3,708,9967,3575863099,3575863113,14
3,708,9968,3575863099,3575863117,18
3,708,9969,3575863099,3575863118,19
3,708,9970,3575863099,3575863118,19
3,708,9971,3575863099,3575863120,21
3,708,9972,3575863099,3575863121,22
3,708,9973,3575863099,3575863122,23
3,708,9974,3575863099,3575863129,30
3,708,9975,3575863099,3575863137,38
3,708,9976,3575863099,3575863138,39
3,708,9977,3575863099,3575863143,44
3,708,9978,3575863099,3575863143,44
3,708,9979,3575863099,3575863144,45
3,708,9980,3575863099,3575863145,46
3,708,9981,3575863099,3575863146,47
3,709,9982,3575863156,3575863156,0
3,709,9983,3575863156,3575863156,0
3,709,9984,3575863156,3575863156,0
3,709,9985,3575863156,3575863160,4
3,709,9986,3575863156,3575863162,6
3,709,9987,3575863156,3575863167,11
3,709,9988,3575863156,3575863168,12
3,709,9989,3575863156,3575863170,14
3,709,9990,3575863156,3575863170,14
3,709,9991,3575863156,3575863170,14
3,709,9992,3575863156,3575863170,14
3,709,9993,3575863156,3575863170,14
3,709,9994,3575863156,3575863172,16
3,709,9995,3575863156,3575863177,21
3,709,9996,3575863156,3575863178,22
3,709,9997,3575863156,3575863181,25
3,709,9998,3575863156,3575863184,28
3,709,9999,3575863156,3575863185,29
3,709,10000,3575863156,3575863187,31
3,709,10001,3575863156,3575863187,31
3,709,10002,3575863156,3575863187,31
3,709,10003,3575863156,3575863192,36
3,709,10004,3575863156,3575863192,36
3,709,10005,3575863156,3575863194,38
3,709,10006,3575863156,3575863195,39
3,709,10007,3575863156,3575863196,40
3,709,10008,3575863156,3575863197,41
3,709,10009,3575863156,3575863200,44
3,709,10010,3575863156,3575863202,46
3,709,10011,3575863156,3575863204,48
3,709,10012,3575863156,3575863204,48
3,709,10013,3575863156,3575863205,49
3,710,10014,3575863212,3575863212,0
3,710,10015,3575863212,3575863212,0
3,710,10016,3575863212,3575863212,0
3,710,10017,3575863212,3575863216,4
3,710,10018,3575863212,3575863216,4
3,710,10019,3575863212,3575863217,5
3,710,10020,3575863212,3575863217,5
3,710,10021,3575863212,3575863219,7
3,710,10022,3575863212,3575863222,10
3,710,10023,3575863212,3575863222,10
3,710,10024,3575863212,3575863222,10
3,710,10025,3575863212,3575863223,11
3,710,10026,3575863212,3575863225,13
3,710,10027,3575863212,3575863229,17
3,710,10028,3575863212,3575863231,19
3,710,10029,3575863212,3575863231,19
3,710,10030,3575863212,3575863231,19
3,710,10031,3575863212,3575863231,19
3,710,10032,3575863212,3575863235,23
3,710,10033,3575863212,3575863235,23
3,710,10034,3575863212,3575863236,24
3,710,10035,3575863212,3575863237,25
3,710,10036,3575863212,3575863238,26
3,710,10037,3575863212,3575863240,28
3,710,10038,3575863212,3575863241,29
3,710,10039,3575863212,3575863243,31
3,710,10040,3575863212,3575863244,32
3,710,10041,3575863212,3575863245,33
3,710,10042,3575863212,3575863246,34
3,710,10043,3575863212,3575863248,36
3,710,10044,3575863212,3575863249,37
3,710,10045,3575863212,3575863250,38
3,710,10046,3575863212,3575863252,40
3,710,10047,3575863212,3575863253,41
3,710,10048,3575863212,3575863253,41
3,710,10049,3575863212,3575863254,42
3,710,10050,3575863212,3575863255,43
3,710,10051,3575863212,3575863257,45
3,710,10052,3575863212,3575863261,49
3,710,10053,3575863212,3575863261,49
3,711,10054,3575863268,3575863268,0
3,711,10055,3575863268,3575863268,0
3,711,10056,3575863268,3575863268,0
3,711,10057,3575863268,3575863268,0
3,711,10058,3575863268,3575863268,0
3,711,10059,3575863268,3575863268,0
3,711,10060,3575863268,3575863268,0
3,711,10061,3575863268,3575863268,0
3,711,10062,3575863268,3575863269,1
3,711,10063,3575863268,3575863269,1
3,711,10064,3575863268,3575863269,1
3,711,10065,3575863268,3575863277,9
3,711,10066,3575863268,3575863277,9
3,711,10067,3575863268,3575863278,10
3,711,10068,3575863268,3575863279,11
3,711,10069,3575863268,3575863281,13
3,711,10070,3575863268,3575863282,14
3,711,10071,3575863268,3575863283,15
3,711,10072,3575863268,3575863283,15
3,711,10073,3575863268,3575863284,16
3,711,10074,3575863268,3575863284,16
3,711,10075,3575863268,3575863291,23
3,711,10076,3575863268,3575863297,29
3,711,10077,3575863268,3575863299,31
3,711,10078,3575863268,3575863301,33
3,711,10079,3575863268,3575863301,33
3,711,10080,3575863268,3575863304,36
3,711,10081,3575863268,3575863307,39
3,711,10082,3575863268,3575863311,43
3,711,10083,3575863268,3575863311,43
3,711,10084,3575863268,3575863312,44
3,711,10085,3575863268,3575863313,45
3,711,10086,3575863268,3575863317,49
3,711,10087,3575863268,3575863317,49
3,711,10088,3575863268,3575863318,50
3,712,10089,3575863325,3575863325,0
3,712,10090,3575863325,3575863325,0
3,712,10091,3575863325,3575863325,0
3,712,10092,3575863325,3575863330,5
3,712,10093,3575863325,3575863338,13
3,712,10094,3575863325,3575863343,18
3,712,10095,3575863325,3575863343,18
3,712,10096,3575863325,3575863344,19
3,712,10097,3575863325,3575863345,20
3,712,10098,3575863325,3575863345,20
3,712,10099,3575863325,3575863346,21
3,712,10100,3575863325,3575863351,26
3,712,10101,3575863325,3575863352,27
3,712,10102,3575863325,3575863354,29
3,712,10103,3575863325,3575863361,36
3,712,10104,3575863325,3575863364,39
3,712,10105,3575863325,3575863367,42
3,712,10106,3575863325,3575863369,44
3,712,10107,3575863325,3575863369,44
3,712,10108,3575863325,3575863369,44
3,712,10109,3575863325,3575863370,45
3,712,10110,3575863325,3575863371,46
3,712,10111,3575863325,3575863371,46
3,712,10112,3575863325,3575863373,48
3,713,10113,3575863382,3575863382,0
3,713,10114,3575863382,3575863382,0
3,713,10115,3575863382,3575863382,0
3,713,10116,3575863382,3575863384,2
3,713,10117,3575863382,3575863384,2
3,713,10118,3575863382,3575863385,3
3,713,10119,3575863382,3575863386,4
3,713,10120,3575863382,3575863386,4
3,713,10121,3575863382,3575863387,5
3,713,10122,3575863382,3575863388,6
3,713,10123,3575863382,3575863392,10
3,713,10124,3575863382,3575863392,10
3,713,10125,3575863382,3575863395,13
3,713,10126,3575863382,3575863396,14
3,713,10127,3575863382,3575863396,14
3,713,10128,3575863382,3575863397,15
3,713,10129,3575863382,3575863400,18
3,713,10130,3575863382,3575863404,22
3,713,10131,3575863382,3575863405,23
3,713,10132,3575863382,3575863406,24
3,713,10133,3575863382,3575863408,26
3,713,10134,3575863382,3575863409,27
3,713,10135,3575863382,3575863411,29
3,713,10136,3575863382,3575863416,34
3,713,10137,3575863382,3575863416,34
3,713,10138,3575863382,3575863416,34
3,713,10139,3575863382,3575863419,37
3,713,10140,3575863382,3575863420,38
3,713,10141,3575863382,3575863421,39
3,713,10142,3575863382,3575863423,41
3,713,10143,3575863382,3575863424,42
3,713,10144,3575863382,3575863426,44
3,713,10145,3575863382,3575863429,47
3,713,10146,3575863382,3575863431,49
3,713,10147,3575863382,3575863431,49
3,713,10148,3575863382,3575863431,49
3,713,10149,3575863382,3575863432,50
3,714,10150,3575863439,3575863439,0
3,714,10151,3575863439,3575863439,0
3,714,10152,3575863439,3575863439,0
3,714,10153,3575863439,3575863439,0
3,714,10154,3575863439,3575863439,0
3,714,10155,3575863439,3575863439,0
3,714,10156,3575863439,3575863439,0
3,714,10157,3575863439,3575863441,2
3,714,10158,3575863439,3575863444,5
3,714,10159,3575863439,3575863444,5
3,714,10160,3575863439,3575863445,6
3,714,10161,3575863439,3575863446,7
3,714,10162,3575863439,3575863448,9
3,714,10163,3575863439,3575863449,10
3,714,10164,3575863439,3575863451,12
3,714,10165,3575863439,3575863452,13
3,714,10166,3575863439,3575863453,14
3,714,10167,3575863439,3575863453,14
3,714,10168,3575863439,3575863456,17
3,714,10169,3575863439,3575863457,18
3,714,10170,3575863439,3575863460,21
3,714,10171,3575863439,3575863461,22
3,714,10172,3575863439,3575863462,23
3,714,10173,3575863439,3575863462,23
3,714,10174,3575863439,3575863464,25
3,714,10175,3575863439,3575863464,25
3,714,10176,3575863439,3575863465,26
3,714,10177,3575863439,3575863465,26
3,714,10178,3575863439,3575863467,28
3,714,10179,3575863439,3575863468,29
3,714,10180,3575863439,3575863469,30
3,714,10181,3575863439,3575863469,30
3,714,10182,3575863439,3575863469,30
3,714,10183,3575863439,3575863478,39
3,714,10184,3575863439,3575863478,39
3,714,10185,3575863439,3575863479,40
3,714,10186,3575863439,3575863480,41
3,714,10187,3575863439,3575863480,41
3,714,10188,3575863439,3575863482,43
3,714,10189,3575863439,3575863483,44
3,714,10190,3575863439,3575863484,45
3,714,10191,3575863439,3575863485,46
3,715,10192,3575863496,3575863496,0
3,715,10193,3575863496,3575863496,0
3,715,10194,3575863496,3575863499,3
3,715,10195,3575863496,3575863499,3
3,715,10196,3575863496,3575863500,4
3,715,10197,3575863496,3575863500,4
3,715,10198,3575863496,3575863503,7
3,715,10199,3575863496,3575863506,10
3,715,10200,3575863496,3575863510,14
3,715,10201,3575863496,3575863511,15
3,715,10202,3575863496,3575863511,15
3,715,10203,3575863496,3575863512,16
3,715,10204,3575863496,3575863516,20
3,715,10205,3575863496,3575863516,20
3,715,10206,3575863496,3575863517,21
3,715,10207,3575863496,3575863519,23
3,715,10208,3575863496,3575863522,26
3,715,10209,3575863496,3575863522,26
3,715,10210,3575863496,3575863529,33
3,715,10211,3575863496,3575863537,41
3,715,10212,3575863496,3575863542,46
3,715,10213,3575863496,3575863542,46
3,715,10214,3575863496,3575863543,47
3,715,10215,3575863496,3575863544,48
3,715,10216,3575863496,3575863544,48
3,715,10217,3575863496,3575863544,48
3,716,10218,3575863552,3575863552,0
3,716,10219,3575863552,3575863552,0
3,716,10220,3575863552,3575863553,1
3,716,10221,3575863552,3575863561,9
3,716,10222,3575863552,3575863563,11
3,716,10223,3575863552,3575863566,14
3,716,10224,3575863552,3575863568,16
3,716,10225,3575863552,3575863568,16
3,716,10226,3575863552,3575863569,17
3,716,10227,3575863552,3575863569,17
3,716,10228,3575863552,3575863570,18
3,716,10229,3575863552,3575863570,18
3,716,10230,3575863552,3575863571,19
3,716,10231,3575863552,3575863577,25
3,716,10232,3575863552,3575863577,25
3,716,10233,3575863552,3575863578,26
3,716,10234,3575863552,3575863580,28
3,716,10235,3575863552,3575863581,29
3,716,10236,3575863552,3575863583,31
3,716,10237,3575863552,3575863583,31
3,716,10238,3575863552,3575863585,33
3,716,10239,3575863552,3575863585,33
3,716,10240,3575863552,3575863586,34
3,716,10241,3575863552,3575863587,35
3,716,10242,3575863552,3575863588,36
3,716,10243,3575863552,3575863591,39
3,716,10244,3575863552,3575863594,42
3,716,10245,3575863552,3575863594,42
3,716,10246,3575863552,3575863595,43
3,716,10247,3575863552,3575863596,44
3,716,10248,3575863552,3575863599,47
3,716,10249,3575863552,3575863601,49
3,717,10250,3575863610,3575863610,0
3,717,10251,3575863610,3575863610,0
3,717,10252,3575863610,3575863610,0
3,717,10253,3575863610,3575863610,0
3,717,10254,3575863610,3575863610,0
3,717,10255,3575863610,3575863611,1
3,717,10256,3575863610,3575863615,5
3,717,10257,3575863610,3575863615,5
3,717,10258,3575863610,3575863615,5
3,717,10259,3575863610,3575863616,6
3,717,10260,3575863610,3575863619,9
3,717,10261,3575863610,3575863620,10
3,717,10262,3575863610,3575863621,11
3,717,10263,3575863610,3575863623,13
3,717,10264,3575863610,3575863625,15
3,717,10265,3575863610,3575863627,17
3,717,10266,3575863610,3575863628,18
3,717,10267,3575863610,3575863630,20
3,717,10268,3575863610,3575863630,20
3,717,10269,3575863610,3575863630,20
3,717,10270,3575863610,3575863632,22
3,717,10271,3575863610,3575863634,24
3,717,10272,3575863610,3575863634,24
3,717,10273,3575863610,3575863636,26
3,717,10274,3575863610,3575863637,27
3,717,10275,3575863610,3575863638,28
3,717,10276,3575863610,3575863638,28
3,717,10277,3575863610,3575863639,29
3,717,10278,3575863610,3575863642,32
3,717,10279,3575863610,3575863644,34
3,717,10280,3575863610,3575863644,34
3,717,10281,3575863610,3575863645,35
3,717,10282,3575863610,3575863648,38
3,717,10283,3575863610,3575863648,38
3,717,10284,3575863610,3575863649,39
3,717,10285,3575863610,3575863651,41
3,717,10286,3575863610,3575863652,42
3,717,10287,3575863610,3575863653,43
3,717,10288,3575863610,3575863653,43
3,717,10289,3575863610,3575863655,45
3,717,10290,3575863610,3575863659,49
3,717,10291,3575863610,3575863660,50
3,718,10292,3575863666,3575863666,0
3,718,10293,3575863666,3575863666,0
3,718,10294,3575863666,3575863666,0
3,718,10295,3575863666,3575863666,0
3,718,10296,3575863666,3575863666,0
3,718,10297,3575863666,3575863666,0
3,718,10298,3575863666,3575863666,0
3,718,10299,3575863666,3575863668,2
3,718,10300,3575863666,3575863668,2
3,718,10301,3575863666,3575863668,2
3,718,10302,3575863666,3575863669,3
3,718,10303,3575863666,3575863677,11
3,718,10304,3575863666,3575863678,12
3,718,10305,3575863666,3575863678,12
3,718,10306,3575863666,3575863679,13
3,718,10307,3575863666,3575863679,13
3,718,10308,3575863666,3575863680,14
3,718,10309,3575863666,3575863683,17
3,718,10310,3575863666,3575863684,18
3,718,10311,3575863666,3575863684,18
3,718,10312,3575863666,3575863685,19
3,718,10313,3575863666,3575863691,25
3,718,10314,3575863666,3575863696,30
3,718,10315,3575863666,3575863699,33
3,718,10316,3575863666,3575863700,34
3,718,10317,3575863666,3575863700,34
3,718,10318,3575863666,3575863700,34
3,718,10319,3575863666,3575863702,36
3,718,10320,3575863666,3575863710,44
3,718,10321,3575863666,3575863711,45
3,718,10322,3575863666,3575863711,45
3,718,10323,3575863666,3575863712,46
3,718,10324,3575863666,3575863716,50
3,719,10325,3575863722,3575863722,0
3,719,10326,3575863722,3575863722,0
3,719,10327,3575863722,3575863722,0
3,719,10328,3575863722,3575863722,0
3,719,10329,3575863722,3575863722,0
3,719,10330,3575863722,3575863729,7
3,719,10331,3575863722,3575863729,7
3,719,10332,3575863722,3575863733,11
3,719,10333,3575863722,3575863737,15
3,719,10334,3575863722,3575863742,20
3,719,10335,3575863722,3575863743,21
3,719,10336,3575863722,3575863743,21
3,719,10337,3575863722,3575863744,22
3,719,10338,3575863722,3575863744,22
3,719,10339,3575863722,3575863745,23
3,719,10340,3575863722,3575863750,28
3,719,10341,3575863722,3575863751,29
3,719,10342,3575863722,3575863761,39
3,719,10343,3575863722,3575863761,39
3,719,10344,3575863722,3575863767,45
3,719,10345,3575863722,3575863768,46
3,719,10346,3575863722,3575863769,47
3,719,10347,3575863722,3575863769,47
3,719,10348,3575863722,3575863770,48
3,719,10349,3575863722,3575863770,48
3,719,10350,3575863722,3575863770,48
3,720,10351,3575863778,3575863778,0
3,720,10352,3575863778,3575863778,0
3,720,10353,3575863778,3575863778,0
3,720,10354,3575863778,3575863779,1
3,720,10355,3575863778,3575863780,2
3,720,10356,3575863778,3575863781,3
3,720,10357,3575863778,3575863783,5
3,720,10358,3575863778,3575863783,5
3,720,10359,3575863778,3575863785,7
3,720,10360,3575863778,3575863785,7
3,720,10361,3575863778,3575863785,7
3,720,10362,3575863778,3575863787,9
3,720,10363,3575863778,3575863789,11
3,720,10364,3575863778,3575863792,14
3,720,10365,3575863778,3575863792,14
3,720,10366,3575863778,3575863794,16
3,720,10367,3575863778,3575863794,16
3,720,10368,3575863778,3575863795,17
3,720,10369,3575863778,3575863795,17
3,720,10370,3575863778,3575863795,17
3,720,10371,3575863778,3575863796,18
3,720,10372,3575863778,3575863800,22
3,720,10373,3575863778,3575863801,23
3,720,10374,3575863778,3575863803,25
3,720,10375,3575863778,3575863804,26
3,720,10376,3575863778,3575863808,30
3,720,10377,3575863778,3575863808,30
3,720,10378,3575863778,3575863811,33
3,720,10379,3575863778,3575863815,37
3,720,10380,3575863778,3575863815,37
3,720,10381,3575863778,3575863816,38
3,720,10382,3575863778,3575863819,41
3,720,10383,3575863778,3575863820,42
3,720,10384,3575863778,3575863821,43
3,720,10385,3575863778,3575863822,44
3,720,10386,3575863778,3575863823,45
3,720,10387,3575863778,3575863824,46
3,720,10388,3575863778,3575863827,49
3,721,10389,3575863835,3575863835,0
3,721,10390,3575863835,3575863835,0
3,721,10391,3575863835,3575863835,0
3,721,10392,3575863835,3575863835,0
3,721,10393,3575863835,3575863835,0
3,721,10394,3575863835,3575863835,0
3,721,10395,3575863835,3575863835,0
3,721,10396,3575863835,3575863837,2
3,721,10397,3575863835,3575863838,3
3,721,10398,3575863835,3575863838,3
3,721,10399,3575863835,3575863838,3
3,721,10400,3575863835,3575863839,4
3,721,10401,3575863835,3575863844,9
3,721,10402,3575863835,3575863844,9
3,721,10403,3575863835,3575863845,10
3,721,10404,3575863835,3575863848,13
3,721,10405,3575863835,3575863848,13
3,721,10406,3575863835,3575863850,15
3,721,10407,3575863835,3575863851,16
3,721,10408,3575863835,3575863853,18
3,721,10409,3575863835,3575863854,19
3,721,10410,3575863835,3575863855,20
3,721,10411,3575863835,3575863856,21
3,721,10412,3575863835,3575863860,25
3,721,10413,3575863835,3575863860,25
3,721,10414,3575863835,3575863861,26
3,721,10415,3575863835,3575863862,27
3,721,10416,3575863835,3575863863,28
3,721,10417,3575863835,3575863864,29
3,721,10418,3575863835,3575863864,29
3,721,10419,3575863835,3575863866,31
3,721,10420,3575863835,3575863866,31
3,721,10421,3575863835,3575863868,33
3,721,10422,3575863835,3575863868,33
3,721,10423,3575863835,3575863869,34
3,721,10424,3575863835,3575863869,34
3,721,10425,3575863835,3575863876,41
3,721,10426,3575863835,3575863877,42
3,721,10427,3575863835,3575863877,42
3,721,10428,3575863835,3575863879,44
3,721,10429,3575863835,3575863881,46
3,721,10430,3575863835,3575863883,48
3,721,10431,3575863835,3575863884,49
3,721,10432,3575863835,3575863885,50
3,722,10433,3575863892,3575863892,0
3,722,10434,3575863892,3575863892,0
3,722,10435,3575863892,3575863896,4
3,722,10436,3575863892,3575863899,7
3,722,10437,3575863892,3575863900,8
3,722,10438,3575863892,3575863900,8
3,722,10439,3575863892,3575863900,8
3,722,10440,3575863892,3575863903,11
3,722,10441,3575863892,3575863907,15
3,722,10442,3575863892,3575863911,19
3,722,10443,3575863892,3575863911,19
3,722,10444,3575863892,3575863912,20
3,722,10445,3575863892,3575863916,24
3,722,10446,3575863892,3575863917,25
3,722,10447,3575863892,3575863920,28
3,722,10448,3575863892,3575863920,28
3,722,10449,3575863892,3575863921,29
3,722,10450,3575863892,3575863922,30
3,722,10451,3575863892,3575863929,37
3,722,10452,3575863892,3575863929,37
3,722,10453,3575863892,3575863933,41
3,722,10454,3575863892,3575863937,45
3,722,10455,3575863892,3575863937,45
3,723,10456,3575863948,3575863948,0
3,723,10457,3575863948,3575863948,0
3,723,10458,3575863948,3575863948,0
3,723,10459,3575863948,3575863948,0
3,723,10460,3575863948,3575863948,0
3,723,10461,3575863948,3575863948,0
3,723,10462,3575863948,3575863951,3
3,723,10463,3575863948,3575863952,4
3,723,10464,3575863948,3575863961,13
3,723,10465,3575863948,3575863964,16
3,723,10466,3575863948,3575863966,18
3,723,10467,3575863948,3575863969,21
3,723,10468,3575863948,3575863969,21
3,723,10469,3575863948,3575863970,22
3,723,10470,3575863948,3575863970,22
3,723,10471,3575863948,3575863970,22
3,723,10472,3575863948,3575863970,22
3,723,10473,3575863948,3575863974,26
3,723,10474,3575863948,3575863977,29
3,723,10475,3575863948,3575863977,29
3,723,10476,3575863948,3575863979,31
3,723,10477,3575863948,3575863982,34
3,723,10478,3575863948,3575863982,34
3,723,10479,3575863948,3575863983,35
3,723,10480,3575863948,3575863984,36
3,723,10481,3575863948,3575863985,37
3,723,10482,3575863948,3575863986,38
3,723,10483,3575863948,3575863986,38
3,723,10484,3575863948,3575863989,41
3,723,10485,3575863948,3575863992,44
3,723,10486,3575863948,3575863992,44
3,723,10487,3575863948,3575863994,46
3,723,10488,3575863948,3575863996,48
3,723,10489,3575863948,3575863997,49
3,724,10490,3575864004,3575864004,0
3,724,10491,3575864004,3575864004,0
3,724,10492,3575864004,3575864004,0
3,724,10493,3575864004,3575864004,0
3,724,10494,3575864004,3575864004,0
3,724,10495,3575864004,3575864008,4
3,724,10496,3575864004,3575864009,5
3,724,10497,3575864004,3575864012,8
3,724,10498,3575864004,3575864015,11
3,724,10499,3575864004,3575864015,11
3,724,10500,3575864004,3575864015,11
3,724,10501,3575864004,3575864015,11
3,724,10502,3575864004,3575864020,16
3,724,10503,3575864004,3575864022,18
3,724,10504,3575864004,3575864022,18
3,724,10505,3575864004,3575864025,21
3,724,10506,3575864004,3575864027,23
3,724,10507,3575864004,3575864029,25
3,724,10508,3575864004,3575864030,26
3,724,10509,3575864004,3575864031,27
3,724,10510,3575864004,3575864031,27
3,724,10511,3575864004,3575864034,30
3,724,10512,3575864004,3575864035,31
3,724,10513,3575864004,3575864037,33
3,724,10514,3575864004,3575864037,33
3,724,10515,3575864004,3575864038,34
3,724,10516,3575864004,3575864039,35
3,724,10517,3575864004,3575864040,36
3,724,10518,3575864004,3575864044,40
3,724,10519,3575864004,3575864044,40
3,724,10520,3575864004,3575864045,41
3,724,10521,3575864004,3575864048,44
3,724,10522,3575864004,3575864048,44
3,724,10523,3575864004,3575864051,47
3,724,10524,3575864004,3575864052,48
3,724,10525,3575864004,3575864053,49
3,724,10526,3575864004,3575864053,49
3,725,10527,3575864063,3575864063,0
3,725,10528,3575864063,3575864063,0
3,725,10529,3575864063,3575864063,0
3,725,10530,3575864063,3575864063,0
3,725,10531,3575864063,3575864063,0
3,725,10532,3575864063,3575864063,0
3,725,10533,3575864063,3575864063,0
3,725,10534,3575864063,3575864063,0
3,725,10535,3575864063,3575864065,2
3,725,10536,3575864063,3575864065,2
3,725,10537,3575864063,3575864066,3
3,725,10538,3575864063,3575864067,4
3,725,10539,3575864063,3575864068,5
3,725,10540,3575864063,3575864069,6
3,725,10541,3575864063,3575864069,6
3,725,10542,3575864063,3575864070,7
3,725,10543,3575864063,3575864077,14
3,725,10544,3575864063,3575864077,14
3,725,10545,3575864063,3575864078,15
3,725,10546,3575864063,3575864079,16
3,725,10547,3575864063,3575864080,17
3,725,10548,3575864063,3575864083,20
3,725,10549,3575864063,3575864083,20
3,725,10550,3575864063,3575864084,21
3,725,10551,3575864063,3575864085,22
3,725,10552,3575864063,3575864085,22
3,725,10553,3575864063,3575864090,27
3,725,10554,3575864063,3575864096,33
3,725,10555,3575864063,3575864099,36
3,725,10556,3575864063,3575864099,36
3,725,10557,3575864063,3575864100,37
3,725,10558,3575864063,3575864100,37
3,725,10559,3575864063,3575864104,41
3,725,10560,3575864063,3575864107,44
3,725,10561,3575864063,3575864111,48
3,725,10562,3575864063,3575864111,48
3,726,10563,3575864120,3575864120,0
3,726,10564,3575864120,3575864120,0
3,726,10565,3575864120,3575864120,0
3,726,10566,3575864120,3575864120,0
3,726,10567,3575864120,3575864120,0
3,726,10568,3575864120,3575864122,2
3,726,10569,3575864120,3575864122,2
3,726,10570,3575864120,3575864129,9
3,726,10571,3575864120,3575864130,10
3,726,10572,3575864120,3575864133,13
3,726,10573,3575864120,3575864137,17
3,726,10574,3575864120,3575864143,23
3,726,10575,3575864120,3575864144,24
3,726,10576,3575864120,3575864144,24
3,726,10577,3575864120,3575864145,25
3,726,10578,3575864120,3575864145,25
3,726,10579,3575864120,3575864146,26
3,726,10580,3575864120,3575864151,31
3,726,10581,3575864120,3575864161,41
3,726,10582,3575864120,3575864164,44
3,726,10583,3575864120,3575864166,46
3,726,10584,3575864120,3575864169,49
3,727,10585,3575864176,3575864176,0
3,727,10586,3575864176,3575864176,0
3,727,10587,3575864176,3575864176,0
3,727,10588,3575864176,3575864176,0
3,727,10589,3575864176,3575864176,0
3,727,10590,3575864176,3575864177,1
3,727,10591,3575864176,3575864179,3
3,727,10592,3575864176,3575864179,3
3,727,10593,3575864176,3575864182,6
3,727,10594,3575864176,3575864184,8
3,727,10595,3575864176,3575864185,9
3,727,10596,3575864176,3575864186,10
3,727,10597,3575864176,3575864186,10
3,727,10598,3575864176,3575864186,10
3,727,10599,3575864176,3575864187,11
3,727,10600,3575864176,3575864189,13
3,727,10601,3575864176,3575864192,16
3,727,10602,3575864176,3575864192,16
3,727,10603,3575864176,3575864194,18
3,727,10604,3575864176,3575864194,18
3,727,10605,3575864176,3575864195,19
3,727,10606,3575864176,3575864196,20
3,727,10607,3575864176,3575864196,20
3,727,10608,3575864176,3575864197,21
3,727,10609,3575864176,3575864201,25
3,727,10610,3575864176,3575864203,27
3,727,10611,3575864176,3575864203,27
3,727,10612,3575864176,3575864204,28
3,727,10613,3575864176,3575864206,30
3,727,10614,3575864176,3575864208,32
3,727,10615,3575864176,3575864210,34
3,727,10616,3575864176,3575864212,36
3,727,10617,3575864176,3575864215,39
3,727,10618,3575864176,3575864216,40
3,727,10619,3575864176,3575864219,43
3,727,10620,3575864176,3575864220,44
3,727,10621,3575864176,3575864222,46
3,727,10622,3575864176,3575864223,47
3,727,10623,3575864176,3575864225,49
3,728,10624,3575864234,3575864234,0
3,728,10625,3575864234,3575864234,0
3,728,10626,3575864234,3575864234,0
3,728,10627,3575864234,3575864234,0
3,728,10628,3575864234,3575864234,0
3,728,10629,3575864234,3575864234,0
3,728,10630,3575864234,3575864234,0
3,728,10631,3575864234,3575864235,1
3,728,10632,3575864234,3575864237,3
3,728,10633,3575864234,3575864237,3
3,728,10634,3575864234,3575864238,4
3,728,10635,3575864234,3575864238,4
3,728,10636,3575864234,3575864239,5
3,728,10637,3575864234,3575864241,7
3,728,10638,3575864234,3575864244,10
3,728,10639,3575864234,3575864244,10
3,728,10640,3575864234,3575864245,11
3,728,10641,3575864234,3575864246,12
3,728,10642,3575864234,3575864248,14
3,728,10643,3575864234,3575864249,15
3,728,10644,3575864234,3575864252,18
3,728,10645,3575864234,3575864252,18
3,728,10646,3575864234,3575864253,19
3,728,10647,3575864234,3575864254,20
3,728,10648,3575864234,3575864255,21
3,728,10649,3575864234,3575864257,23
3,728,10650,3575864234,3575864259,25
3,728,10651,3575864234,3575864260,26
3,728,10652,3575864234,3575864263,29
3,728,10653,3575864234,3575864263,29
3,728,10654,3575864234,3575864263,29
3,728,10655,3575864234,3575864264,30
3,728,10656,3575864234,3575864266,32
3,728,10657,3575864234,3575864267,33
3,728,10658,3575864234,3575864269,35
3,728,10659,3575864234,3575864270,36
3,728,10660,3575864234,3575864270,36
3,728,10661,3575864234,3575864271,37
3,728,10662,3575864234,3575864276,42
3,728,10663,3575864234,3575864279,45
3,728,10664,3575864234,3575864280,46
3,728,10665,3575864234,3575864280,46
3,728,10666,3575864234,3575864280,46
3,728,10667,3575864234,3575864282,48
3,728,10668,3575864234,3575864283,49
3,728,10669,3575864234,3575864284,50
3,729,10670,3575864292,3575864292,0
3,729,10671,3575864292,3575864292,0
3,729,10672,3575864292,3575864292,0
3,729,10673,3575864292,3575864296,4
3,729,10674,3575864292,3575864299,7
3,729,10675,3575864292,3575864300,8
3,729,10676,3575864292,3575864301,9
3,729,10677,3575864292,3575864304,12
3,729,10678,3575864292,3575864307,15
3,729,10679,3575864292,3575864311,19
3,729,10680,3575864292,3575864312,20
3,729,10681,3575864292,3575864313,21
3,729,10682,3575864292,3575864317,25
3,729,10683,3575864292,3575864317,25
3,729,10684,3575864292,3575864320,28
3,729,10685,3575864292,3575864320,28
3,729,10686,3575864292,3575864322,30
3,729,10687,3575864292,3575864322,30
3,729,10688,3575864292,3575864329,37
3,729,10689,3575864292,3575864330,38
3,729,10690,3575864292,3575864334,42
3,729,10691,3575864292,3575864337,45
3,729,10692,3575864292,3575864338,46
3,730,10693,3575864351,3575864351,0
3,730,10694,3575864351,3575864351,0
3,730,10695,3575864351,3575864351,0
3,730,10696,3575864351,3575864351,0
3,730,10697,3575864351,3575864351,0
3,730,10698,3575864351,3575864351,0
3,730,10699,3575864351,3575864351,0
3,730,10700,3575864351,3575864352,1
3,730,10701,3575864351,3575864355,4
3,730,10702,3575864351,3575864361,10
3,730,10703,3575864351,3575864364,13
3,730,10704,3575864351,3575864366,15
3,730,10705,3575864351,3575864369,18
3,730,10706,3575864351,3575864371,20
3,730,10707,3575864351,3575864371,20
3,730,10708,3575864351,3575864372,21
3,730,10709,3575864351,3575864374,23
3,730,10710,3575864351,3575864374,23
3,730,10711,3575864351,3575864377,26
3,730,10712,3575864351,3575864379,28
3,730,10713,3575864351,3575864382,31
3,730,10714,3575864351,3575864383,32
3,730,10715,3575864351,3575864384,33
3,730,10716,3575864351,3575864386,35
3,730,10717,3575864351,3575864387,36
3,730,10718,3575864351,3575864387,36
3,730,10719,3575864351,3575864387,36
3,730,10720,3575864351,3575864389,38
3,730,10721,3575864351,3575864392,41
3,730,10722,3575864351,3575864392,41
3,730,10723,3575864351,3575864395,44
3,730,10724,3575864351,3575864397,46
3,730,10725,3575864351,3575864397,46
3,731,10726,3575864409,3575864409,0
3,731,10727,3575864409,3575864409,0
3,731,10728,3575864409,3575864409,0
3,731,10729,3575864409,3575864409,0
3,731,10730,3575864409,3575864409,0
3,731,10731,3575864409,3575864409,0
3,731,10732,3575864409,3575864409,0
3,731,10733,3575864409,3575864410,1
3,731,10734,3575864409,3575864412,3
3,731,10735,3575864409,3575864415,6
3,731,10736,3575864409,3575864415,6
3,731,10737,3575864409,3575864416,7
3,731,10738,3575864409,3575864417,8
3,731,10739,3575864409,3575864421,12
3,731,10740,3575864409,3575864422,13
3,731,10741,3575864409,3575864423,14
3,731,10742,3575864409,3575864427,18
3,731,10743,3575864409,3575864429,20
3,731,10744,3575864409,3575864430,21
3,731,10745,3575864409,3575864433,24
3,731,10746,3575864409,3575864433,24
3,731,10747,3575864409,3575864434,25
3,731,10748,3575864409,3575864435,26
3,731,10749,3575864409,3575864437,28
3,731,10750,3575864409,3575864438,29
3,731,10751,3575864409,3575864439,30
3,731,10752,3575864409,3575864439,30
3,731,10753,3575864409,3575864441,32
3,731,10754,3575864409,3575864444,35
3,731,10755,3575864409,3575864445,36
3,731,10756,3575864409,3575864446,37
3,731,10757,3575864409,3575864447,38
3,731,10758,3575864409,3575864449,40
3,731,10759,3575864409,3575864452,43
3,731,10760,3575864409,3575864453,44
3,731,10761,3575864409,3575864453,44
3,731,10762,3575864409,3575864454,45
3,731,10763,3575864409,3575864455,46
3,731,10764,3575864409,3575864455,46
3,731,10765,3575864409,3575864457,48
3,731,10766,3575864409,3575864459,50
3,732,10767,3575864468,3575864468,0
3,732,10768,3575864468,3575864468,0
3,732,10769,3575864468,3575864468,0
3,732,10770,3575864468,3575864468,0
3,732,10771,3575864468,3575864468,0
3,732,10772,3575864468,3575864469,1
3,732,10773,3575864468,3575864469,1
3,732,10774,3575864468,3575864469,1
3,732,10775,3575864468,3575864469,1
3,732,10776,3575864468,3575864469,1
3,732,10777,3575864468,3575864470,2
3,732,10778,3575864468,3575864471,3
3,732,10779,3575864468,3575864477,9
3,732,10780,3575864468,3575864478,10
3,732,10781,3575864468,3575864479,11
3,732,10782,3575864468,3575864480,12
3,732,10783,3575864468,3575864481,13
3,732,10784,3575864468,3575864482,14
3,732,10785,3575864468,3575864483,15
3,732,10786,3575864468,3575864483,15
3,732,10787,3575864468,3575864485,17
3,732,10788,3575864468,3575864486,18
3,732,10789,3575864468,3575864491,23
3,732,10790,3575864468,3575864496,28
3,732,10791,3575864468,3575864500,32
3,732,10792,3575864468,3575864501,33
3,732,10793,3575864468,3575864501,33
3,732,10794,3575864468,3575864503,35
3,732,10795,3575864468,3575864512,44
3,732,10796,3575864468,3575864513,45
3,732,10797,3575864468,3575864513,45
3,732,10798,3575864468,3575864514,46
3,732,10799,3575864468,3575864517,49
3,732,10800,3575864468,3575864517,49
3,733,10801,3575864524,3575864524,0
3,733,10802,3575864524,3575864524,0
3,733,10803,3575864524,3575864524,0
3,733,10804,3575864524,3575864524,0
3,733,10805,3575864524,3575864528,4
3,733,10806,3575864524,3575864529,5
3,733,10807,3575864524,3575864533,9
3,733,10808,3575864524,3575864537,13
3,733,10809,3575864524,3575864543,19
3,733,10810,3575864524,3575864543,19
3,733,10811,3575864524,3575864544,20
3,733,10812,3575864524,3575864544,20
3,733,10813,3575864524,3575864544,20
3,733,10814,3575864524,3575864545,21
3,733,10815,3575864524,3575864545,21
3,733,10816,3575864524,3575864551,27
3,733,10817,3575864524,3575864551,27
3,733,10818,3575864524,3575864554,30
3,733,10819,3575864524,3575864560,36
3,733,10820,3575864524,3575864560,36
3,733,10821,3575864524,3575864563,39
3,733,10822,3575864524,3575864566,42
3,733,10823,3575864524,3575864567,43
3,733,10824,3575864524,3575864570,46
3,733,10825,3575864524,3575864570,46
3,733,10826,3575864524,3575864571,47
3,733,10827,3575864524,3575864573,49
3,733,10828,3575864524,3575864573,49
3,734,10829,3575864580,3575864580,0
3,734,10830,3575864580,3575864580,0
3,734,10831,3575864580,3575864581,1
3,734,10832,3575864580,3575864582,2
3,734,10833,3575864580,3575864583,3
3,734,10834,3575864580,3575864585,5
3,734,10835,3575864580,3575864585,5
3,734,10836,3575864580,3575864585,5
3,734,10837,3575864580,3575864586,6
3,734,10838,3575864580,3575864586,6
3,734,10839,3575864580,3575864588,8
3,734,10840,3575864580,3575864591,11
3,734,10841,3575864580,3575864592,12
3,734,10842,3575864580,3575864593,13
3,734,10843,3575864580,3575864594,14
3,734,10844,3575864580,3575864594,14
3,734,10845,3575864580,3575864595,15
3,734,10846,3575864580,3575864595,15
3,734,10847,3575864580,3575864596,16
3,734,10848,3575864580,3575864596,16
3,734,10849,3575864580,3575864601,21
3,734,10850,3575864580,3575864603,23
3,734,10851,3575864580,3575864603,23
3,734,10852,3575864580,3575864607,27
3,734,10853,3575864580,3575864608,28
3,734,10854,3575864580,3575864610,30
3,734,10855,3575864580,3575864613,33
3,734,10856,3575864580,3575864614,34
3,734,10857,3575864580,3575864614,34
3,734,10858,3575864580,3575864615,35
3,734,10859,3575864580,3575864615,35
3,734,10860,3575864580,3575864618,38
3,734,10861,3575864580,3575864620,40
3,734,10862,3575864580,3575864622,42
3,734,10863,3575864580,3575864622,42
3,734,10864,3575864580,3575864622,42
3,734,10865,3575864580,3575864625,45
3,734,10866,3575864580,3575864626,46
3,734,10867,3575864580,3575864627,47
3,734,10868,3575864580,3575864629,49
3,735,10869,3575864638,3575864638,0
3,735,10870,3575864638,3575864638,0
3,735,10871,3575864638,3575864638,0
3,735,10872,3575864638,3575864638,0
3,735,10873,3575864638,3575864638,0
3,735,10874,3575864638,3575864638,0
3,735,10875,3575864638,3575864638,0
3,735,10876,3575864638,3575864638,0
3,735,10877,3575864638,3575864638,0
3,735,10878,3575864638,3575864639,1
3,735,10879,3575864638,3575864643,5
3,735,10880,3575864638,3575864644,6
3,735,10881,3575864638,3575864645,7
3,735,10882,3575864638,3575864645,7
3,735,10883,3575864638,3575864645,7
3,735,10884,3575864638,3575864647,9
3,735,10885,3575864638,3575864648,10
3,735,10886,3575864638,3575864651,13
3,735,10887,3575864638,3575864652,14
3,735,10888,3575864638,3575864652,14
3,735,10889,3575864638,3575864653,15
3,735,10890,3575864638,3575864654,16
3,735,10891,3575864638,3575864655,17
3,735,10892,3575864638,3575864656,18
3,735,10893,3575864638,3575864659,21
3,735,10894,3575864638,3575864660,22
3,735,10895,3575864638,3575864662,24
3,735,10896,3575864638,3575864663,25
3,735,10897,3575864638,3575864664,26
3,735,10898,3575864638,3575864664,26
3,735,10899,3575864638,3575864665,27
3,735,10900,3575864638,3575864668,30
3,735,10901,3575864638,3575864668,30
3,735,10902,3575864638,3575864669,31
3,735,10903,3575864638,3575864670,32
3,735,10904,3575864638,3575864670,32
3,735,10905,3575864638,3575864676,38
3,735,10906,3575864638,3575864678,40
3,735,10907,3575864638,3575864678,40
3,735,10908,3575864638,3575864680,42
3,735,10909,3575864638,3575864682,44
3,735,10910,3575864638,3575864683,45
3,735,10911,3575864638,3575864683,45
3,735,10912,3575864638,3575864685,47
3,735,10913,3575864638,3575864686,48
3,736,10914,3575864695,3575864695,0
3,736,10915,3575864695,3575864696,1
3,736,10916,3575864695,3575864698,3
3,736,10917,3575864695,3575864700,5
3,736,10918,3575864695,3575864701,6
3,736,10919,3575864695,3575864701,6
3,736,10920,3575864695,3575864703,8
3,736,10921,3575864695,3575864713,18
3,736,10922,3575864695,3575864713,18
3,736,10923,3575864695,3575864713,18
3,736,10924,3575864695,3575864713,18
3,736,10925,3575864695,3575864717,22
3,736,10926,3575864695,3575864717,22
3,736,10927,3575864695,3575864721,26
3,736,10928,3575864695,3575864722,27
3,736,10929,3575864695,3575864723,28
3,736,10930,3575864695,3575864728,33
3,736,10931,3575864695,3575864729,34
3,736,10932,3575864695,3575864732,37
3,736,10933,3575864695,3575864736,41
3,736,10934,3575864695,3575864737,42
3,736,10935,3575864695,3575864743,48
3,736,10936,3575864695,3575864744,49
3,736,10937,3575864695,3575864744,49
3,736,10938,3575864695,3575864744,49
3,736,10939,3575864695,3575864745,50
3,737,10940,3575864750,3575864752,2
3,737,10941,3575864750,3575864755,5
3,737,10942,3575864750,3575864760,10
3,737,10943,3575864750,3575864764,14
3,737,10944,3575864750,3575864765,15
3,737,10945,3575864750,3575864770,20
3,737,10946,3575864750,3575864770,20
3,737,10947,3575864750,3575864771,21
3,737,10948,3575864750,3575864773,23
3,737,10949,3575864750,3575864774,24
3,737,10950,3575864750,3575864777,27
3,737,10951,3575864750,3575864778,28
3,737,10952,3575864750,3575864781,31
3,737,10953,3575864750,3575864782,32
3,737,10954,3575864750,3575864786,36
3,737,10955,3575864750,3575864786,36
3,737,10956,3575864750,3575864786,36
3,737,10957,3575864750,3575864786,36
3,737,10958,3575864750,3575864786,36
3,737,10959,3575864750,3575864788,38
3,737,10960,3575864750,3575864792,42
3,737,10961,3575864750,3575864792,42
3,737,10962,3575864750,3575864794,44
3,737,10963,3575864750,3575864794,44
3,737,10964,3575864750,3575864796,46
3,737,10965,3575864750,3575864797,47
3,737,10966,3575864750,3575864798,48
3,738,10967,3575864808,3575864808,0
3,738,10968,3575864808,3575864808,0
3,738,10969,3575864808,3575864808,0
3,738,10970,3575864808,3575864808,0
3,738,10971,3575864808,3575864808,0
3,738,10972,3575864808,3575864809,1
3,738,10973,3575864808,3575864811,3
3,738,10974,3575864808,3575864813,5
3,738,10975,3575864808,3575864815,7
3,738,10976,3575864808,3575864816,8
3,738,10977,3575864808,3575864816,8
3,738,10978,3575864808,3575864820,12
3,738,10979,3575864808,3575864821,13
3,738,10980,3575864808,3575864822,14
3,738,10981,3575864808,3575864822,14
3,738,10982,3575864808,3575864825,17
3,738,10983,3575864808,3575864825,17
3,738,10984,3575864808,3575864829,21
3,738,10985,3575864808,3575864832,24
3,738,10986,3575864808,3575864832,24
3,738,10987,3575864808,3575864833,25
3,738,10988,3575864808,3575864834,26
3,738,10989,3575864808,3575864835,27
3,738,10990,3575864808,3575864835,27
3,738,10991,3575864808,3575864837,29
3,738,10992,3575864808,3575864838,30
3,738,10993,3575864808,3575864838,30
3,738,10994,3575864808,3575864844,36
3,738,10995,3575864808,3575864845,37
3,738,10996,3575864808,3575864845,37
3,738,10997,3575864808,3575864847,39
3,738,10998,3575864808,3575864848,40
3,738,10999,3575864808,3575864848,40
3,738,11000,3575864808,3575864851,43
3,738,11001,3575864808,3575864852,44
3,738,11002,3575864808,3575864852,44
3,738,11003,3575864808,3575864853,45
3,738,11004,3575864808,3575864855,47
3,738,11005,3575864808,3575864856,48
3,739,11006,3575864865,3575864865,0
3,739,11007,3575864865,3575864865,0
3,739,11008,3575864865,3575864865,0
3,739,11009,3575864865,3575864865,0
3,739,11010,3575864865,3575864865,0
3,739,11011,3575864865,3575864865,0
3,739,11012,3575864865,3575864865,0
3,739,11013,3575864865,3575864866,1
3,739,11014,3575864865,3575864868,3
3,739,11015,3575864865,3575864868,3
3,739,11016,3575864865,3575864869,4
3,739,11017,3575864865,3575864870,5
3,739,11018,3575864865,3575864871,6
3,739,11019,3575864865,3575864876,11
3,739,11020,3575864865,3575864878,13
3,739,11021,3575864865,3575864878,13
3,739,11022,3575864865,3575864881,16
3,739,11023,3575864865,3575864882,17
3,739,11024,3575864865,3575864883,18
3,739,11025,3575864865,3575864884,19
3,739,11026,3575864865,3575864887,22
3,739,11027,3575864865,3575864891,26
3,739,11028,3575864865,3575864896,31
3,739,11029,3575864865,3575864898,33
3,739,11030,3575864865,3575864899,34
3,739,11031,3575864865,3575864900,35
3,739,11032,3575864865,3575864901,36
3,739,11033,3575864865,3575864901,36
3,739,11034,3575864865,3575864903,38
3,739,11035,3575864865,3575864908,43
3,739,11036,3575864865,3575864912,47
3,739,11037,3575864865,3575864913,48
3,739,11038,3575864865,3575864913,48
3,739,11039,3575864865,3575864913,48
3,740,11040,3575864926,3575864926,0
3,740,11041,3575864926,3575864926,0
3,740,11042,3575864926,3575864926,0
3,740,11043,3575864926,3575864926,0
3,740,11044,3575864926,3575864926,0
3,740,11045,3575864926,3575864928,2
3,740,11046,3575864926,3575864930,4
3,740,11047,3575864926,3575864933,7
3,740,11048,3575864926,3575864937,11
3,740,11049,3575864926,3575864943,17
3,740,11050,3575864926,3575864944,18
3,740,11051,3575864926,3575864944,18
3,740,11052,3575864926,3575864945,19
3,740,11053,3575864926,3575864945,19
3,740,11054,3575864926,3575864951,25
3,740,11055,3575864926,3575864952,26
3,740,11056,3575864926,3575864954,28
3,740,11057,3575864926,3575864961,35
3,740,11058,3575864926,3575864963,37
3,740,11059,3575864926,3575864967,41
3,740,11060,3575864926,3575864970,44
3,740,11061,3575864926,3575864970,44
3,740,11062,3575864926,3575864971,45
3,740,11063,3575864926,3575864971,45
3,740,11064,3575864926,3575864973,47
3,741,11065,3575864983,3575864983,0
3,741,11066,3575864983,3575864983,0
3,741,11067,3575864983,3575864983,0
3,741,11068,3575864983,3575864983,0
3,741,11069,3575864983,3575864986,3
3,741,11070,3575864983,3575864986,3
3,741,11071,3575864983,3575864986,3
3,741,11072,3575864983,3575864987,4
3,741,11073,3575864983,3575864988,5
3,741,11074,3575864983,3575864988,5
3,741,11075,3575864983,3575864992,9
3,741,11076,3575864983,3575864992,9
3,741,11077,3575864983,3575864994,11
3,741,11078,3575864983,3575864994,11
3,741,11079,3575864983,3575864994,11
3,741,11080,3575864983,3575864996,13
3,741,11081,3575864983,3575864996,13
3,741,11082,3575864983,3575864996,13
3,741,11083,3575864983,3575864997,14
3,741,11084,3575864983,3575865001,18
3,741,11085,3575864983,3575865004,21
3,741,11086,3575864983,3575865005,22
3,741,11087,3575864983,3575865008,25
3,741,11088,3575864983,3575865008,25
3,741,11089,3575864983,3575865010,27
3,741,11090,3575864983,3575865011,28
3,741,11091,3575864983,3575865014,31
3,741,11092,3575864983,3575865015,32
3,741,11093,3575864983,3575865015,32
3,741,11094,3575864983,3575865016,33
3,741,11095,3575864983,3575865019,36
3,741,11096,3575864983,3575865020,37
3,741,11097,3575864983,3575865022,39
3,741,11098,3575864983,3575865022,39
3,741,11099,3575864983,3575865023,40
3,741,11100,3575864983,3575865025,42
3,741,11101,3575864983,3575865025,42
3,741,11102,3575864983,3575865029,46
3,741,11103,3575864983,3575865032,49
3,742,11104,3575865040,3575865040,0
3,742,11105,3575865040,3575865040,0
3,742,11106,3575865040,3575865040,0
3,742,11107,3575865040,3575865040,0
3,742,11108,3575865040,3575865040,0
3,742,11109,3575865040,3575865040,0
3,742,11110,3575865040,3575865040,0
3,742,11111,3575865040,3575865040,0
3,742,11112,3575865040,3575865040,0
3,742,11113,3575865040,3575865043,3
3,742,11114,3575865040,3575865045,5
3,742,11115,3575865040,3575865045,5
3,742,11116,3575865040,3575865045,5
3,742,11117,3575865040,3575865046,6
3,742,11118,3575865040,3575865047,7
3,742,11119,3575865040,3575865047,7
3,742,11120,3575865040,3575865048,8
3,742,11121,3575865040,3575865053,13
3,742,11122,3575865040,3575865053,13
3,742,11123,3575865040,3575865055,15
3,742,11124,3575865040,3575865056,16
3,742,11125,3575865040,3575865057,17
3,742,11126,3575865040,3575865060,20
3,742,11127,3575865040,3575865061,21
3,742,11128,3575865040,3575865063,23
3,742,11129,3575865040,3575865064,24
3,742,11130,3575865040,3575865064,24
3,742,11131,3575865040,3575865064,24
3,742,11132,3575865040,3575865065,25
3,742,11133,3575865040,3575865066,26
3,742,11134,3575865040,3575865068,28
3,742,11135,3575865040,3575865070,30
3,742,11136,3575865040,3575865070,30
3,742,11137,3575865040,3575865070,30
3,742,11138,3575865040,3575865071,31
3,742,11139,3575865040,3575865077,37
3,742,11140,3575865040,3575865077,37
3,742,11141,3575865040,3575865079,39
3,742,11142,3575865040,3575865081,41
3,742,11143,3575865040,3575865081,41
3,742,11144,3575865040,3575865083,43
3,742,11145,3575865040,3575865083,43
3,742,11146,3575865040,3575865083,43
3,742,11147,3575865040,3575865085,45
3,742,11148,3575865040,3575865088,48
3,743,11149,3575865097,3575865097,0
3,743,11150,3575865097,3575865098,1
3,743,11151,3575865097,3575865100,3
3,743,11152,3575865097,3575865100,3
3,743,11153,3575865097,3575865101,4
3,743,11154,3575865097,3575865103,6
3,743,11155,3575865097,3575865113,16
3,743,11156,3575865097,3575865113,16
3,743,11157,3575865097,3575865113,16
3,743,11158,3575865097,3575865113,16
3,743,11159,3575865097,3575865117,20
3,743,11160,3575865097,3575865118,21
3,743,11161,3575865097,3575865121,24
3,743,11162,3575865097,3575865123,26
3,743,11163,3575865097,3575865123,26
3,743,11164,3575865097,3575865128,31
3,743,11165,3575865097,3575865129,32
3,743,11166,3575865097,3575865134,37
3,743,11167,3575865097,3575865137,40
3,743,11168,3575865097,3575865137,40
3,743,11169,3575865097,3575865144,47
3,743,11170,3575865097,3575865145,48
3,743,11171,3575865097,3575865145,48
3,743,11172,3575865097,3575865145,48
3,744,11173,3575865154,3575865154,0
3,744,11174,3575865154,3575865154,0
3,744,11175,3575865154,3575865155,1
3,744,11176,3575865154,3575865162,8
3,744,11177,3575865154,3575865164,10
3,744,11178,3575865154,3575865166,12
3,744,11179,3575865154,3575865168,14
3,744,11180,3575865154,3575865169,15
3,744,11181,3575865154,3575865170,16
3,744,11182,3575865154,3575865171,17
3,744,11183,3575865154,3575865171,17
3,744,11184,3575865154,3575865173,19
3,744,11185,3575865154,3575865177,23
3,744,11186,3575865154,3575865178,24
3,744,11187,3575865154,3575865181,27
3,744,11188,3575865154,3575865182,28
3,744,11189,3575865154,3575865184,30
3,744,11190,3575865154,3575865186,32
3,744,11191,3575865154,3575865187,33
3,744,11192,3575865154,3575865187,33
3,744,11193,3575865154,3575865188,34
3,744,11194,3575865154,3575865192,38
3,744,11195,3575865154,3575865192,38
3,744,11196,3575865154,3575865194,40
3,744,11197,3575865154,3575865194,40
3,744,11198,3575865154,3575865196,42
3,744,11199,3575865154,3575865196,42
3,744,11200,3575865154,3575865197,43
3,744,11201,3575865154,3575865197,43
3,744,11202,3575865154,3575865201,47
3,745,11203,3575865211,3575865211,0
3,745,11204,3575865211,3575865211,0
3,745,11205,3575865211,3575865211,0
3,745,11206,3575865211,3575865211,0
3,745,11207,3575865211,3575865211,0
3,745,11208,3575865211,3575865212,1
3,745,11209,3575865211,3575865215,4
3,745,11210,3575865211,3575865215,4
3,745,11211,3575865211,3575865215,4
3,745,11212,3575865211,3575865216,5
3,745,11213,3575865211,3575865216,5
3,745,11214,3575865211,3575865220,9
3,745,11215,3575865211,3575865220,9
3,745,11216,3575865211,3575865223,12
3,745,11217,3575865211,3575865224,13
3,745,11218,3575865211,3575865225,14
3,745,11219,3575865211,3575865226,15
3,745,11220,3575865211,3575865229,18
3,745,11221,3575865211,3575865230,19
3,745,11222,3575865211,3575865232,21
3,745,11223,3575865211,3575865232,21
3,745,11224,3575865211,3575865234,23
3,745,11225,3575865211,3575865234,23
3,745,11226,3575865211,3575865235,24
3,745,11227,3575865211,3575865238,27
3,745,11228,3575865211,3575865239,28
3,745,11229,3575865211,3575865239,28
3,745,11230,3575865211,3575865241,30
3,745,11231,3575865211,3575865243,32
3,745,11232,3575865211,3575865246,35
3,745,11233,3575865211,3575865246,35
3,745,11234,3575865211,3575865246,35
3,745,11235,3575865211,3575865248,37
3,745,11236,3575865211,3575865248,37
3,745,11237,3575865211,3575865249,38
3,745,11238,3575865211,3575865252,41
3,745,11239,3575865211,3575865253,42
3,745,11240,3575865211,3575865254,43
3,745,11241,3575865211,3575865256,45
3,745,11242,3575865211,3575865257,46
3,745,11243,3575865211,3575865257,46
3,745,11244,3575865211,3575865260,49
3,746,11245,3575865269,3575865269,0
3,746,11246,3575865269,3575865269,0
3,746,11247,3575865269,3575865269,0
3,746,11248,3575865269,3575865269,0
3,746,11249,3575865269,3575865269,0
3,746,11250,3575865269,3575865269,0
3,746,11251,3575865269,3575865269,0
3,746,11252,3575865269,3575865269,0
3,746,11253,3575865269,3575865269,0
3,746,11254,3575865269,3575865271,2
3,746,11255,3575865269,3575865271,2
3,746,11256,3575865269,3575865277,8
3,746,11257,3575865269,3575865278,9
3,746,11258,3575865269,3575865280,11
3,746,11259,3575865269,3575865280,11
3,746,11260,3575865269,3575865282,13
3,746,11261,3575865269,3575865283,14
3,746,11262,3575865269,3575865283,14
3,746,11263,3575865269,3575865285,16
3,746,11264,3575865269,3575865288,19
3,746,11265,3575865269,3575865291,22
3,746,11266,3575865269,3575865299,30
3,746,11267,3575865269,3575865300,31
3,746,11268,3575865269,3575865300,31
3,746,11269,3575865269,3575865301,32
3,746,11270,3575865269,3575865301,32
3,746,11271,3575865269,3575865303,34
3,746,11272,3575865269,3575865308,39
3,746,11273,3575865269,3575865313,44
3,746,11274,3575865269,3575865313,44
3,746,11275,3575865269,3575865313,44
3,746,11276,3575865269,3575865313,44
3,746,11277,3575865269,3575865317,48
3,746,11278,3575865269,3575865318,49
3,747,11279,3575865325,3575865325,0
3,747,11280,3575865325,3575865325,0
3,747,11281,3575865325,3575865325,0
3,747,11282,3575865325,3575865325,0
3,747,11283,3575865325,3575865328,3
3,747,11284,3575865325,3575865329,4
3,747,11285,3575865325,3575865333,8
3,747,11286,3575865325,3575865338,13
3,747,11287,3575865325,3575865343,18
3,747,11288,3575865325,3575865344,19
3,747,11289,3575865325,3575865344,19
3,747,11290,3575865325,3575865345,20
3,747,11291,3575865325,3575865345,20
3,747,11292,3575865325,3575865351,26
3,747,11293,3575865325,3575865354,29
3,747,11294,3575865325,3575865354,29
3,747,11295,3575865325,3575865362,37
3,747,11296,3575865325,3575865362,37
3,747,11297,3575865325,3575865364,39
3,747,11298,3575865325,3575865367,42
3,747,11299,3575865325,3575865369,44
3,747,11300,3575865325,3575865370,45
3,747,11301,3575865325,3575865371,46
3,747,11302,3575865325,3575865371,46
3,747,11303,3575865325,3575865371,46
3,747,11304,3575865325,3575865373,48
3,748,11305,3575865384,3575865384,0
3,748,11306,3575865384,3575865384,0
3,748,11307,3575865384,3575865384,0
3,748,11308,3575865384,3575865384,0
3,748,11309,3575865384,3575865384,0
3,748,11310,3575865384,3575865384,0
3,748,11311,3575865384,3575865385,1
3,748,11312,3575865384,3575865386,2
3,748,11313,3575865384,3575865386,2
3,748,11314,3575865384,3575865386,2
3,748,11315,3575865384,3575865387,3
3,748,11316,3575865384,3575865388,4
3,748,11317,3575865384,3575865388,4
3,748,11318,3575865384,3575865392,8
3,748,11319,3575865384,3575865392,8
3,748,11320,3575865384,3575865394,10
3,748,11321,3575865384,3575865394,10
3,748,11322,3575865384,3575865395,11
3,748,11323,3575865384,3575865396,12
3,748,11324,3575865384,3575865396,12
3,748,11325,3575865384,3575865397,13
3,748,11326,3575865384,3575865397,13
3,748,11327,3575865384,3575865398,14
3,748,11328,3575865384,3575865401,17
3,748,11329,3575865384,3575865405,21
3,748,11330,3575865384,3575865408,24
3,748,11331,3575865384,3575865411,27
3,748,11332,3575865384,3575865413,29
3,748,11333,3575865384,3575865415,31
3,748,11334,3575865384,3575865415,31
3,748,11335,3575865384,3575865415,31
3,748,11336,3575865384,3575865415,31
3,748,11337,3575865384,3575865416,32
3,748,11338,3575865384,3575865419,35
3,748,11339,3575865384,3575865422,38
3,748,11340,3575865384,3575865423,39
3,748,11341,3575865384,3575865424,40
3,748,11342,3575865384,3575865425,41
3,748,11343,3575865384,3575865429,45
3,748,11344,3575865384,3575865429,45
3,748,11345,3575865384,3575865431,47
3,748,11346,3575865384,3575865432,48
3,748,11347,3575865384,3575865434,50
3,749,11348,3575865439,3575865439,0
3,749,11349,3575865439,3575865439,0
3,749,11350,3575865439,3575865439,0
3,749,11351,3575865439,3575865439,0
3,749,11352,3575865439,3575865439,0
3,749,11353,3575865439,3575865440,1
3,749,11354,3575865439,3575865441,2
3,749,11355,3575865439,3575865443,4
3,749,11356,3575865439,3575865445,6
3,749,11357,3575865439,3575865446,7
3,749,11358,3575865439,3575865446,7
3,749,11359,3575865439,3575865446,7
3,749,11360,3575865439,3575865448,9
3,749,11361,3575865439,3575865448,9
3,749,11362,3575865439,3575865449,10
3,749,11363,3575865439,3575865452,13
3,749,11364,3575865439,3575865452,13
3,749,11365,3575865439,3575865454,15
3,749,11366,3575865439,3575865455,16
3,749,11367,3575865439,3575865456,17
3,749,11368,3575865439,3575865457,18
3,749,11369,3575865439,3575865459,20
3,749,11370,3575865439,3575865461,22
3,749,11371,3575865439,3575865462,23
3,749,11372,3575865439,3575865464,25
3,749,11373,3575865439,3575865464,25
3,749,11374,3575865439,3575865464,25
3,749,11375,3575865439,3575865465,26
3,749,11376,3575865439,3575865466,27
3,749,11377,3575865439,3575865469,30
3,749,11378,3575865439,3575865470,31
3,749,11379,3575865439,3575865470,31
3,749,11380,3575865439,3575865470,31
3,749,11381,3575865439,3575865472,33
3,749,11382,3575865439,3575865477,38
3,749,11383,3575865439,3575865478,39
3,749,11384,3575865439,3575865478,39
3,749,11385,3575865439,3575865481,42
3,749,11386,3575865439,3575865481,42
3,749,11387,3575865439,3575865483,44
3,749,11388,3575865439,3575865483,44
3,749,11389,3575865439,3575865483,44
3,749,11390,3575865439,3575865485,46
3,749,11391,3575865439,3575865488,49
3,750,11392,3575865496,3575865496,0
3,750,11393,3575865496,3575865498,2
3,750,11394,3575865496,3575865499,3
3,750,11395,3575865496,3575865500,4
3,750,11396,3575865496,3575865500,4
3,750,11397,3575865496,3575865502,6
3,750,11398,3575865496,3575865508,12
3,750,11399,3575865496,3575865511,15
3,750,11400,3575865496,3575865512,16
3,750,11401,3575865496,3575865512,16
3,750,11402,3575865496,3575865512,16
3,750,11403,3575865496,3575865516,20
3,750,11404,3575865496,3575865517,21
3,750,11405,3575865496,3575865521,25
3,750,11406,3575865496,3575865522,26
3,750,11407,3575865496,3575865523,27
3,750,11408,3575865496,3575865527,31
3,750,11409,3575865496,3575865529,33
3,750,11410,3575865496,3575865533,37
3,750,11411,3575865496,3575865536,40
3,750,11412,3575865496,3575865537,41
3,750,11413,3575865496,3575865543,47
3,750,11414,3575865496,3575865543,47
3,750,11415,3575865496,3575865544,48
3,750,11416,3575865496,3575865544,48
3,750,11417,3575865496,3575865544,48
3,751,11418,3575865553,3575865553,0
3,751,11419,3575865553,3575865553,0
3,751,11420,3575865553,3575865553,0
3,751,11421,3575865553,3575865554,1
3,751,11422,3575865553,3575865560,7
3,751,11423,3575865553,3575865561,8
3,751,11424,3575865553,3575865562,9
3,751,11425,3575865553,3575865565,12
3,751,11426,3575865553,3575865568,15
3,751,11427,3575865553,3575865569,16
3,751,11428,3575865553,3575865570,17
3,751,11429,3575865553,3575865570,17
3,751,11430,3575865553,3575865570,17
3,751,11431,3575865553,3575865572,19
3,751,11432,3575865553,3575865576,23
3,751,11433,3575865553,3575865577,24
3,751,11434,3575865553,3575865581,28
3,751,11435,3575865553,3575865581,28
3,751,11436,3575865553,3575865583,30
3,751,11437,3575865553,3575865584,31
3,751,11438,3575865553,3575865585,32
3,751,11439,3575865553,3575865586,33
3,751,11440,3575865553,3575865586,33
3,751,11441,3575865553,3575865587,34
3,751,11442,3575865553,3575865587,34
3,751,11443,3575865553,3575865588,35
3,751,11444,3575865553,3575865591,38
3,751,11445,3575865553,3575865593,40
3,751,11446,3575865553,3575865595,42
3,751,11447,3575865553,3575865595,42
3,751,11448,3575865553,3575865596,43
3,751,11449,3575865553,3575865599,46
3,752,11450,3575865611,3575865611,0
3,752,11451,3575865611,3575865611,0
3,752,11452,3575865611,3575865611,0
3,752,11453,3575865611,3575865611,0
3,752,11454,3575865611,3575865611,0
3,752,11455,3575865611,3575865611,0
3,752,11456,3575865611,3575865613,2
3,752,11457,3575865611,3575865614,3
3,752,11458,3575865611,3575865615,4
3,752,11459,3575865611,3575865615,4
3,752,11460,3575865611,3575865617,6
3,752,11461,3575865611,3575865620,9
3,752,11462,3575865611,3575865620,9
3,752,11463,3575865611,3575865621,10
3,752,11464,3575865611,3575865622,11
3,752,11465,3575865611,3575865624,13
3,752,11466,3575865611,3575865625,14
3,752,11467,3575865611,3575865626,15
3,752,11468,3575865611,3575865628,17
3,752,11469,3575865611,3575865629,18
3,752,11470,3575865611,3575865630,19
3,752,11471,3575865611,3575865632,21
3,752,11472,3575865611,3575865633,22
3,752,11473,3575865611,3575865633,22
3,752,11474,3575865611,3575865634,23
3,752,11475,3575865611,3575865637,26
3,752,11476,3575865611,3575865637,26
3,752,11477,3575865611,3575865638,27
3,752,11478,3575865611,3575865640,29
3,752,11479,3575865611,3575865641,30
3,752,11480,3575865611,3575865645,34
3,752,11481,3575865611,3575865645,34
3,752,11482,3575865611,3575865645,34
3,752,11483,3575865611,3575865647,36
3,752,11484,3575865611,3575865647,36
3,752,11485,3575865611,3575865650,39
3,752,11486,3575865611,3575865651,40
3,752,11487,3575865611,3575865652,41
3,752,11488,3575865611,3575865652,41
3,752,11489,3575865611,3575865654,43
3,752,11490,3575865611,3575865655,44
3,752,11491,3575865611,3575865656,45
3,752,11492,3575865611,3575865657,46
3,752,11493,3575865611,3575865658,47
3,753,11494,3575865668,3575865668,0
3,753,11495,3575865668,3575865668,0
3,753,11496,3575865668,3575865668,0
3,753,11497,3575865668,3575865668,0
3,753,11498,3575865668,3575865668,0
3,753,11499,3575865668,3575865668,0
3,753,11500,3575865668,3575865669,1
3,753,11501,3575865668,3575865669,1
3,753,11502,3575865668,3575865670,2
3,753,11503,3575865668,3575865670,2
3,753,11504,3575865668,3575865672,4
3,753,11505,3575865668,3575865676,8
3,753,11506,3575865668,3575865678,10
3,753,11507,3575865668,3575865679,11
3,753,11508,3575865668,3575865681,13
3,753,11509,3575865668,3575865681,13
3,753,11510,3575865668,3575865682,14
3,753,11511,3575865668,3575865683,15
3,753,11512,3575865668,3575865686,18
3,753,11513,3575865668,3575865689,21
3,753,11514,3575865668,3575865692,24
3,753,11515,3575865668,3575865695,27
3,753,11516,3575865668,3575865698,30
3,753,11517,3575865668,3575865699,31
3,753,11518,3575865668,3575865700,32
3,753,11519,3575865668,3575865700,32
3,753,11520,3575865668,3575865700,32
3,753,11521,3575865668,3575865702,34
3,753,11522,3575865668,3575865707,39
3,753,11523,3575865668,3575865711,43
3,753,11524,3575865668,3575865712,44
3,753,11525,3575865668,3575865712,44
3,753,11526,3575865668,3575865713,45
3,753,11527,3575865668,3575865716,48
3,753,11528,3575865668,3575865717,49
3,754,11529,3575865726,3575865726,0
3,754,11530,3575865726,3575865726,0
3,754,11531,3575865726,3575865726,0
3,754,11532,3575865726,3575865727,1
3,754,11533,3575865726,3575865728,2
3,754,11534,3575865726,3575865733,7
3,754,11535,3575865726,3575865737,11
3,754,11536,3575865726,3575865743,17
3,754,11537,3575865726,3575865743,17
3,754,11538,3575865726,3575865744,18
3,754,11539,3575865726,3575865744,18
3,754,11540,3575865726,3575865744,18
3,754,11541,3575865726,3575865749,23
3,754,11542,3575865726,3575865751,25
3,754,11543,3575865726,3575865754,28
3,754,11544,3575865726,3575865754,28
3,754,11545,3575865726,3575865761,35
3,754,11546,3575865726,3575865762,36
3,754,11547,3575865726,3575865762,36
3,754,11548,3575865726,3575865765,39
3,754,11549,3575865726,3575865769,43
3,754,11550,3575865726,3575865769,43
3,754,11551,3575865726,3575865770,44
3,754,11552,3575865726,3575865770,44
3,754,11553,3575865726,3575865771,45
3,754,11554,3575865726,3575865772,46
3,754,11555,3575865726,3575865773,47
3,754,11556,3575865726,3575865775,49
3,755,11557,3575865782,3575865782,0
3,755,11558,3575865782,3575865782,0
3,755,11559,3575865782,3575865782,0
3,755,11560,3575865782,3575865782,0
3,755,11561,3575865782,3575865783,1
3,755,11562,3575865782,3575865783,1
3,755,11563,3575865782,3575865785,3
3,755,11564,3575865782,3575865786,4
3,755,11565,3575865782,3575865786,4
3,755,11566,3575865782,3575865786,4
3,755,11567,3575865782,3575865787,5
3,755,11568,3575865782,3575865789,7
3,755,11569,3575865782,3575865792,10
3,755,11570,3575865782,3575865792,10
3,755,11571,3575865782,3575865793,11
3,755,11572,3575865782,3575865793,11
3,755,11573,3575865782,3575865794,12
3,755,11574,3575865782,3575865795,13
3,755,11575,3575865782,3575865796,14
3,755,11576,3575865782,3575865796,14
3,755,11577,3575865782,3575865796,14
3,755,11578,3575865782,3575865797,15
3,755,11579,3575865782,3575865799,17
3,755,11580,3575865782,3575865805,23
3,755,11581,3575865782,3575865806,24
3,755,11582,3575865782,3575865807,25
3,755,11583,3575865782,3575865810,28
3,755,11584,3575865782,3575865814,32
3,755,11585,3575865782,3575865814,32
3,755,11586,3575865782,3575865815,33
3,755,11587,3575865782,3575865815,33
3,755,11588,3575865782,3575865815,33
3,755,11589,3575865782,3575865815,33
3,755,11590,3575865782,3575865816,34
3,755,11591,3575865782,3575865819,37
3,755,11592,3575865782,3575865820,38
3,755,11593,3575865782,3575865821,39
3,755,11594,3575865782,3575865824,42
3,755,11595,3575865782,3575865826,44
3,755,11596,3575865782,3575865826,44
3,755,11597,3575865782,3575865828,46
3,755,11598,3575865782,3575865830,48
3,755,11599,3575865782,3575865832,50
3,756,11600,3575865839,3575865839,0
3,756,11601,3575865839,3575865839,0
3,756,11602,3575865839,3575865839,0
3,756,11603,3575865839,3575865839,0
3,756,11604,3575865839,3575865839,0
3,756,11605,3575865839,3575865839,0
3,756,11606,3575865839,3575865839,0
3,756,11607,3575865839,3575865840,1
3,756,11608,3575865839,3575865841,2
3,756,11609,3575865839,3575865843,4
3,756,11610,3575865839,3575865845,6
3,756,11611,3575865839,3575865845,6
3,756,11612,3575865839,3575865845,6
3,756,11613,3575865839,3575865846,7
3,756,11614,3575865839,3575865847,8
3,756,11615,3575865839,3575865850,11
3,756,11616,3575865839,3575865851,12
3,756,11617,3575865839,3575865852,13
3,756,11618,3575865839,3575865854,15
3,756,11619,3575865839,3575865855,16
3,756,11620,3575865839,3575865857,18
3,756,11621,3575865839,3575865859,20
3,756,11622,3575865839,3575865861,22
3,756,11623,3575865839,3575865861,22
3,756,11624,3575865839,3575865863,24
3,756,11625,3575865839,3575865863,24
3,756,11626,3575865839,3575865864,25
3,756,11627,3575865839,3575865866,27
3,756,11628,3575865839,3575865866,27
3,756,11629,3575865839,3575865869,30
3,756,11630,3575865839,3575865869,30
3,756,11631,3575865839,3575865870,31
3,756,11632,3575865839,3575865870,31
3,756,11633,3575865839,3575865873,34
3,756,11634,3575865839,3575865877,38
3,756,11635,3575865839,3575865877,38
3,756,11636,3575865839,3575865879,40
3,756,11637,3575865839,3575865881,42
3,756,11638,3575865839,3575865881,42
3,756,11639,3575865839,3575865882,43
3,756,11640,3575865839,3575865883,44
3,756,11641,3575865839,3575865883,44
3,756,11642,3575865839,3575865889,50
3,757,11643,3575865898,3575865898,0
3,757,11644,3575865898,3575865898,0
3,757,11645,3575865898,3575865898,0
3,757,11646,3575865898,3575865899,1
3,757,11647,3575865898,3575865900,2
3,757,11648,3575865898,3575865900,2
3,757,11649,3575865898,3575865901,3
3,757,11650,3575865898,3575865902,4
3,757,11651,3575865898,3575865907,9
3,757,11652,3575865898,3575865912,14
3,757,11653,3575865898,3575865913,15
3,757,11654,3575865898,3575865913,15
3,757,11655,3575865898,3575865917,19
3,757,11656,3575865898,3575865918,20
3,757,11657,3575865898,3575865921,23
3,757,11658,3575865898,3575865923,25
3,757,11659,3575865898,3575865927,29
3,757,11660,3575865898,3575865928,30
3,757,11661,3575865898,3575865933,35
3,757,11662,3575865898,3575865937,39
3,757,11663,3575865898,3575865937,39
3,757,11664,3575865898,3575865943,45
3,757,11665,3575865898,3575865943,45
3,757,11666,3575865898,3575865944,46
3,757,11667,3575865898,3575865944,46
3,757,11668,3575865898,3575865945,47
3,758,11669,3575865957,3575865957,0
3,758,11670,3575865957,3575865957,0
3,758,11671,3575865957,3575865957,0
3,758,11672,3575865957,3575865961,4
3,758,11673,3575865957,3575865961,4
3,758,11674,3575865957,3575865962,5
3,758,11675,3575865957,3575865966,9
3,758,11676,3575865957,3575865969,12
3,758,11677,3575865957,3575865970,13
3,758,11678,3575865957,3575865970,13
3,758,11679,3575865957,3575865970,13
3,758,11680,3575865957,3575865971,14
3,758,11681,3575865957,3575865972,15
3,758,11682,3575865957,3575865973,16
3,758,11683,3575865957,3575865974,17
3,758,11684,3575865957,3575865977,20
3,758,11685,3575865957,3575865979,22
3,758,11686,3575865957,3575865981,24
3,758,11687,3575865957,3575865982,25
3,758,11688,3575865957,3575865983,26
3,758,11689,3575865957,3575865984,27
3,758,11690,3575865957,3575865985,28
3,758,11691,3575865957,3575865986,29
3,758,11692,3575865957,3575865987,30
3,758,11693,3575865957,3575865987,30
3,758,11694,3575865957,3575865987,30
3,758,11695,3575865957,3575865990,33
3,758,11696,3575865957,3575865992,35
3,758,11697,3575865957,3575865992,35
3,758,11698,3575865957,3575865994,37
3,758,11699,3575865957,3575865995,38
3,758,11700,3575865957,3575865996,39
3,758,11701,3575865957,3575865997,40
3,758,11702,3575865957,3575865999,42
3,758,11703,3575865957,3575866005,48
3,758,11704,3575865957,3575866005,48
3,758,11705,3575865957,3575866005,48
3,758,11706,3575865957,3575866007,50
3,759,11707,3575866013,3575866013,0
3,759,11708,3575866013,3575866013,0
3,759,11709,3575866013,3575866015,2
3,759,11710,3575866013,3575866015,2
3,759,11711,3575866013,3575866015,2
3,759,11712,3575866013,3575866015,2
3,759,11713,3575866013,3575866016,3
3,759,11714,3575866013,3575866016,3
3,759,11715,3575866013,3575866019,6
3,759,11716,3575866013,3575866020,7
3,759,11717,3575866013,3575866020,7
3,759,11718,3575866013,3575866022,9
3,759,11719,3575866013,3575866024,11
3,759,11720,3575866013,3575866025,12
3,759,11721,3575866013,3575866026,13
3,759,11722,3575866013,3575866029,16
3,759,11723,3575866013,3575866031,18
3,759,11724,3575866013,3575866032,19
3,759,11725,3575866013,3575866033,20
3,759,11726,3575866013,3575866034,21
3,759,11727,3575866013,3575866034,21
3,759,11728,3575866013,3575866038,25
3,759,11729,3575866013,3575866038,25
3,759,11730,3575866013,3575866039,26
3,759,11731,3575866013,3575866040,27
3,759,11732,3575866013,3575866044,31
3,759,11733,3575866013,3575866044,31
3,759,11734,3575866013,3575866045,32
3,759,11735,3575866013,3575866045,32
3,759,11736,3575866013,3575866045,32
3,759,11737,3575866013,3575866047,34
3,759,11738,3575866013,3575866047,34
3,759,11739,3575866013,3575866050,37
3,759,11740,3575866013,3575866053,40
3,759,11741,3575866013,3575866053,40
3,759,11742,3575866013,3575866054,41
3,759,11743,3575866013,3575866056,43
3,759,11744,3575866013,3575866057,44
3,759,11745,3575866013,3575866057,44
3,759,11746,3575866013,3575866059,46
3,759,11747,3575866013,3575866060,47
3,759,11748,3575866013,3575866062,49
3,759,11749,3575866013,3575866063,50
3,760,11750,3575866068,3575866068,0
3,760,11751,3575866068,3575866068,0
3,760,11752,3575866068,3575866068,0
3,760,11753,3575866068,3575866068,0
3,760,11754,3575866068,3575866068,0
3,760,11755,3575866068,3575866069,1
3,760,11756,3575866068,3575866069,1
3,760,11757,3575866068,3575866071,3
3,760,11758,3575866068,3575866073,5
3,760,11759,3575866068,3575866074,6
3,760,11760,3575866068,3575866078,10
3,760,11761,3575866068,3575866078,10
3,760,11762,3575866068,3575866079,11
3,760,11763,3575866068,3575866081,13
3,760,11764,3575866068,3575866081,13
3,760,11765,3575866068,3575866082,14
3,760,11766,3575866068,3575866082,14
3,760,11767,3575866068,3575866084,16
3,760,11768,3575866068,3575866086,18
3,760,11769,3575866068,3575866089,21
3,760,11770,3575866068,3575866093,25
3,760,11771,3575866068,3575866095,27
3,760,11772,3575866068,3575866099,31
3,760,11773,3575866068,3575866100,32
3,760,11774,3575866068,3575866101,33
3,760,11775,3575866068,3575866101,33
3,760,11776,3575866068,3575866104,36
3,760,11777,3575866068,3575866112,44
3,760,11778,3575866068,3575866113,45
3,760,11779,3575866068,3575866113,45
3,760,11780,3575866068,3575866117,49
3,761,11781,3575866126,3575866126,0
3,761,11782,3575866126,3575866126,0
3,761,11783,3575866126,3575866126,0
3,761,11784,3575866126,3575866126,0
3,761,11785,3575866126,3575866126,0
3,761,11786,3575866126,3575866127,1
3,761,11787,3575866126,3575866134,8
3,761,11788,3575866126,3575866137,11
3,761,11789,3575866126,3575866137,11
3,761,11790,3575866126,3575866143,17
3,761,11791,3575866126,3575866144,18
3,761,11792,3575866126,3575866144,18
3,761,11793,3575866126,3575866144,18
3,761,11794,3575866126,3575866145,19
3,761,11795,3575866126,3575866151,25
3,761,11796,3575866126,3575866152,26
3,761,11797,3575866126,3575866154,28
3,761,11798,3575866126,3575866156,30
3,761,11799,3575866126,3575866160,34
3,761,11800,3575866126,3575866161,35
3,761,11801,3575866126,3575866161,35
3,761,11802,3575866126,3575866163,37
3,761,11803,3575866126,3575866166,40
3,761,11804,3575866126,3575866169,43
3,761,11805,3575866126,3575866170,44
3,761,11806,3575866126,3575866171,45
3,761,11807,3575866126,3575866171,45
3,761,11808,3575866126,3575866173,47
3,762,11809,3575866184,3575866184,0
3,762,11810,3575866184,3575866184,0
3,762,11811,3575866184,3575866184,0
3,762,11812,3575866184,3575866184,0
3,762,11813,3575866184,3575866187,3
3,762,11814,3575866184,3575866187,3
3,762,11815,3575866184,3575866187,3
3,762,11816,3575866184,3575866187,3
3,762,11817,3575866184,3575866187,3
3,762,11818,3575866184,3575866190,6
3,762,11819,3575866184,3575866192,8
3,762,11820,3575866184,3575866193,9
3,762,11821,3575866184,3575866193,9
3,762,11822,3575866184,3575866193,9
3,762,11823,3575866184,3575866195,11
3,762,11824,3575866184,3575866195,11
3,762,11825,3575866184,3575866197,13
3,762,11826,3575866184,3575866198,14
3,762,11827,3575866184,3575866198,14
3,762,11828,3575866184,3575866201,17
3,762,11829,3575866184,3575866205,21
3,762,11830,3575866184,3575866205,21
3,762,11831,3575866184,3575866205,21
3,762,11832,3575866184,3575866207,23
3,762,11833,3575866184,3575866208,24
3,762,11834,3575866184,3575866211,27
3,762,11835,3575866184,3575866215,31
3,762,11836,3575866184,3575866215,31
3,762,11837,3575866184,3575866216,32
3,762,11838,3575866184,3575866216,32
3,762,11839,3575866184,3575866216,32
3,762,11840,3575866184,3575866217,33
3,762,11841,3575866184,3575866219,35
3,762,11842,3575866184,3575866220,36
3,762,11843,3575866184,3575866220,36
3,762,11844,3575866184,3575866224,40
3,762,11845,3575866184,3575866225,41
3,762,11846,3575866184,3575866226,42
3,762,11847,3575866184,3575866230,46
3,762,11848,3575866184,3575866231,47
3,762,11849,3575866184,3575866232,48
3,762,11850,3575866184,3575866233,49
3,762,11851,3575866184,3575866234,50
3,763,11852,3575866244,3575866244,0
3,763,11853,3575866244,3575866244,0
3,763,11854,3575866244,3575866244,0
3,763,11855,3575866244,3575866244,0
3,763,11856,3575866244,3575866244,0
3,763,11857,3575866244,3575866244,0
3,763,11858,3575866244,3575866244,0
3,763,11859,3575866244,3575866244,0
3,763,11860,3575866244,3575866245,1
3,763,11861,3575866244,3575866245,1
3,763,11862,3575866244,3575866245,1
3,763,11863,3575866244,3575866247,3
3,763,11864,3575866244,3575866248,4
3,763,11865,3575866244,3575866251,7
3,763,11866,3575866244,3575866253,9
3,763,11867,3575866244,3575866253,9
3,763,11868,3575866244,3575866253,9
3,763,11869,3575866244,3575866255,11
3,763,11870,3575866244,3575866256,12
3,763,11871,3575866244,3575866257,13
3,763,11872,3575866244,3575866259,15
3,763,11873,3575866244,3575866260,16
3,763,11874,3575866244,3575866262,18
3,763,11875,3575866244,3575866262,18
3,763,11876,3575866244,3575866265,21
3,763,11877,3575866244,3575866266,22
3,763,11878,3575866244,3575866266,22
3,763,11879,3575866244,3575866266,22
3,763,11880,3575866244,3575866269,25
3,763,11881,3575866244,3575866270,26
3,763,11882,3575866244,3575866270,26
3,763,11883,3575866244,3575866271,27
3,763,11884,3575866244,3575866273,29
3,763,11885,3575866244,3575866274,30
3,763,11886,3575866244,3575866278,34
3,763,11887,3575866244,3575866279,35
3,763,11888,3575866244,3575866281,37
3,763,11889,3575866244,3575866282,38
3,763,11890,3575866244,3575866283,39
3,763,11891,3575866244,3575866283,39
3,763,11892,3575866244,3575866287,43
3,763,11893,3575866244,3575866289,45
3,763,11894,3575866244,3575866294,50
3,764,11895,3575866300,3575866300,0
3,764,11896,3575866300,3575866300,0
3,764,11897,3575866300,3575866300,0
3,764,11898,3575866300,3575866300,0
3,764,11899,3575866300,3575866301,1
3,764,11900,3575866300,3575866301,1
3,764,11901,3575866300,3575866303,3
3,764,11902,3575866300,3575866307,7
3,764,11903,3575866300,3575866312,12
3,764,11904,3575866300,3575866312,12
3,764,11905,3575866300,3575866313,13
3,764,11906,3575866300,3575866314,14
3,764,11907,3575866300,3575866319,19
3,764,11908,3575866300,3575866322,22
3,764,11909,3575866300,3575866322,22
3,764,11910,3575866300,3575866324,24
3,764,11911,3575866300,3575866325,25
3,764,11912,3575866300,3575866326,26
3,764,11913,3575866300,3575866328,28
3,764,11914,3575866300,3575866328,28
3,764,11915,3575866300,3575866334,34
3,764,11916,3575866300,3575866337,37
3,764,11917,3575866300,3575866338,38
3,764,11918,3575866300,3575866344,44
3,764,11919,3575866300,3575866344,44
3,764,11920,3575866300,3575866344,44
3,764,11921,3575866300,3575866344,44
3,764,11922,3575866300,3575866345,45
3,765,11923,3575866360,3575866360,0
3,765,11924,3575866360,3575866360,0
3,765,11925,3575866360,3575866360,0
3,765,11926,3575866360,3575866361,1
3,765,11927,3575866360,3575866361,1
3,765,11928,3575866360,3575866364,4
3,765,11929,3575866360,3575866367,7
3,765,11930,3575866360,3575866369,9
3,765,11931,3575866360,3575866370,10
3,765,11932,3575866360,3575866371,11
3,765,11933,3575866360,3575866371,11
3,765,11934,3575866360,3575866371,11
3,765,11935,3575866360,3575866373,13
3,765,11936,3575866360,3575866375,15
3,765,11937,3575866360,3575866379,19
3,765,11938,3575866360,3575866381,21
3,765,11939,3575866360,3575866382,22
3,765,11940,3575866360,3575866386,26
3,765,11941,3575866360,3575866387,27
3,765,11942,3575866360,3575866387,27
3,765,11943,3575866360,3575866388,28
3,765,11944,3575866360,3575866388,28
3,765,11945,3575866360,3575866391,31
3,765,11946,3575866360,3575866393,33
3,765,11947,3575866360,3575866393,33
3,765,11948,3575866360,3575866395,35
3,765,11949,3575866360,3575866395,35
3,765,11950,3575866360,3575866398,38
3,765,11951,3575866360,3575866401,41
3,765,11952,3575866360,3575866406,46
3,765,11953,3575866360,3575866407,47
3,765,11954,3575866360,3575866408,48
3,766,11955,3575866417,3575866417,0
3,766,11956,3575866417,3575866417,0
3,766,11957,3575866417,3575866417,0
3,766,11958,3575866417,3575866417,0
3,766,11959,3575866417,3575866417,0
3,766,11960,3575866417,3575866419,2
3,766,11961,3575866417,3575866419,2
3,766,11962,3575866417,3575866420,3
3,766,11963,3575866417,3575866422,5
3,766,11964,3575866417,3575866424,7
3,766,11965,3575866417,3575866426,9
3,766,11966,3575866417,3575866426,9
3,766,11967,3575866417,3575866430,13
3,766,11968,3575866417,3575866431,14
3,766,11969,3575866417,3575866433,16
3,766,11970,3575866417,3575866434,17
3,766,11971,3575866417,3575866438,21
3,766,11972,3575866417,3575866439,22
3,766,11973,3575866417,3575866440,23
3,766,11974,3575866417,3575866442,25
3,766,11975,3575866417,3575866443,26
3,766,11976,3575866417,3575866444,27
3,766,11977,3575866417,3575866444,27
3,766,11978,3575866417,3575866445,28
3,766,11979,3575866417,3575866445,28
3,766,11980,3575866417,3575866446,29
3,766,11981,3575866417,3575866447,30
3,766,11982,3575866417,3575866448,31
3,766,11983,3575866417,3575866452,35
3,766,11984,3575866417,3575866453,36
3,766,11985,3575866417,3575866453,36
3,766,11986,3575866417,3575866454,37
3,766,11987,3575866417,3575866455,38
3,766,11988,3575866417,3575866455,38
3,766,11989,3575866417,3575866457,40
3,766,11990,3575866417,3575866458,41
3,766,11991,3575866417,3575866459,42
3,766,11992,3575866417,3575866461,44
3,766,11993,3575866417,3575866462,45
3,766,11994,3575866417,3575866466,49
3,766,11995,3575866417,3575866466,49
3,766,11996,3575866417,3575866467,50
3,767,11997,3575866473,3575866473,0
3,767,11998,3575866473,3575866473,0
3,767,11999,3575866473,3575866473,0
3,767,12000,3575866473,3575866473,0
3,767,12001,3575866473,3575866473,0
3,767,12002,3575866473,3575866473,0
3,767,12003,3575866473,3575866474,1
3,767,12004,3575866473,3575866478,5
3,767,12005,3575866473,3575866479,6
3,767,12006,3575866473,3575866479,6
3,767,12007,3575866473,3575866481,8
3,767,12008,3575866473,3575866481,8
3,767,12009,3575866473,3575866482,9
3,767,12010,3575866473,3575866482,9
3,767,12011,3575866473,3575866484,11
3,767,12012,3575866473,3575866486,13
3,767,12013,3575866473,3575866489,16
3,767,12014,3575866473,3575866493,20
3,767,12015,3575866473,3575866498,25
3,767,12016,3575866473,3575866499,26
3,767,12017,3575866473,3575866500,27
3,767,12018,3575866473,3575866501,28
3,767,12019,3575866473,3575866501,28
3,767,12020,3575866473,3575866503,30
3,767,12021,3575866473,3575866508,35
3,767,12022,3575866473,3575866512,39
3,767,12023,3575866473,3575866512,39
3,767,12024,3575866473,3575866513,40
3,767,12025,3575866473,3575866514,41
3,767,12026,3575866473,3575866517,44
3,767,12027,3575866473,3575866520,47
3,767,12028,3575866473,3575866522,49
3,767,12029,3575866473,3575866523,50
3,768,12030,3575866530,3575866530,0
3,768,12031,3575866530,3575866530,0
3,768,12032,3575866530,3575866530,0
3,768,12033,3575866530,3575866530,0
3,768,12034,3575866530,3575866530,0
3,768,12035,3575866530,3575866533,3
3,768,12036,3575866530,3575866536,6
3,768,12037,3575866530,3575866537,7
3,768,12038,3575866530,3575866543,13
3,768,12039,3575866530,3575866543,13
3,768,12040,3575866530,3575866544,14
3,768,12041,3575866530,3575866544,14
3,768,12042,3575866530,3575866544,14
3,768,12043,3575866530,3575866551,21
3,768,12044,3575866530,3575866552,22
3,768,12045,3575866530,3575866556,26
3,768,12046,3575866530,3575866560,30
3,768,12047,3575866530,3575866563,33
3,768,12048,3575866530,3575866566,36
3,768,12049,3575866530,3575866568,38
3,768,12050,3575866530,3575866569,39
3,768,12051,3575866530,3575866570,40
3,768,12052,3575866530,3575866570,40
3,768,12053,3575866530,3575866571,41
3,768,12054,3575866530,3575866572,42
3,768,12055,3575866530,3575866578,48
3,769,12056,3575866587,3575866587,0
3,769,12057,3575866587,3575866587,0
3,769,12058,3575866587,3575866587,0
3,769,12059,3575866587,3575866587,0
3,769,12060,3575866587,3575866587,0
3,769,12061,3575866587,3575866587,0
3,769,12062,3575866587,3575866587,0
3,769,12063,3575866587,3575866590,3
3,769,12064,3575866587,3575866592,5
3,769,12065,3575866587,3575866592,5
3,769,12066,3575866587,3575866593,6
3,769,12067,3575866587,3575866593,6
3,769,12068,3575866587,3575866594,7
3,769,12069,3575866587,3575866595,8
3,769,12070,3575866587,3575866596,9
3,769,12071,3575866587,3575866597,10
3,769,12072,3575866587,3575866597,10
3,769,12073,3575866587,3575866597,10
3,769,12074,3575866587,3575866600,13
3,769,12075,3575866587,3575866604,17
3,769,12076,3575866587,3575866605,18
3,769,12077,3575866587,3575866605,18
3,769,12078,3575866587,3575866608,21
3,769,12079,3575866587,3575866612,25
3,769,12080,3575866587,3575866614,27
3,769,12081,3575866587,3575866615,28
3,769,12082,3575866587,3575866615,28
3,769,12083,3575866587,3575866615,28
3,769,12084,3575866587,3575866615,28
3,769,12085,3575866587,3575866616,29
3,769,12086,3575866587,3575866618,31
3,769,12087,3575866587,3575866618,31
3,769,12088,3575866587,3575866621,34
3,769,12089,3575866587,3575866623,36
3,769,12090,3575866587,3575866624,37
3,769,12091,3575866587,3575866625,38
3,769,12092,3575866587,3575866629,42
3,769,12093,3575866587,3575866629,42
3,769,12094,3575866587,3575866630,43
3,769,12095,3575866587,3575866630,43
3,769,12096,3575866587,3575866632,45
3,769,12097,3575866587,3575866633,46
3,769,12098,3575866587,3575866635,48
3,770,12099,3575866646,3575866646,0
3,770,12100,3575866646,3575866646,0
3,770,12101,3575866646,3575866646,0
3,770,12102,3575866646,3575866646,0
3,770,12103,3575866646,3575866646,0
3,770,12104,3575866646,3575866646,0
3,770,12105,3575866646,3575866646,0
3,770,12106,3575866646,3575866646,0
3,770,12107,3575866646,3575866646,0
3,770,12108,3575866646,3575866647,1
3,770,12109,3575866646,3575866647,1
3,770,12110,3575866646,3575866652,6
3,770,12111,3575866646,3575866652,6
3,770,12112,3575866646,3575866653,7
3,770,12113,3575866646,3575866654,8
3,770,12114,3575866646,3575866654,8
3,770,12115,3575866646,3575866657,11
3,770,12116,3575866646,3575866658,12
3,770,12117,3575866646,3575866660,14
3,770,12118,3575866646,3575866662,16
3,770,12119,3575866646,3575866663,17
3,770,12120,3575866646,3575866664,18
3,770,12121,3575866646,3575866665,19
3,770,12122,3575866646,3575866666,20
3,770,12123,3575866646,3575866669,23
3,770,12124,3575866646,3575866669,23
3,770,12125,3575866646,3575866670,24
3,770,12126,3575866646,3575866672,26
3,770,12127,3575866646,3575866674,28
3,770,12128,3575866646,3575866674,28
3,770,12129,3575866646,3575866678,32
3,770,12130,3575866646,3575866679,33
3,770,12131,3575866646,3575866681,35
3,770,12132,3575866646,3575866682,36
3,770,12133,3575866646,3575866682,36
3,770,12134,3575866646,3575866683,37
3,770,12135,3575866646,3575866683,37
3,770,12136,3575866646,3575866687,41
3,770,12137,3575866646,3575866689,43
3,770,12138,3575866646,3575866694,48
3,771,12139,3575866703,3575866703,0
3,771,12140,3575866703,3575866703,0
3,771,12141,3575866703,3575866703,0
3,771,12142,3575866703,3575866703,0
3,771,12143,3575866703,3575866703,0
3,771,12144,3575866703,3575866707,4
3,771,12145,3575866703,3575866712,9
3,771,12146,3575866703,3575866712,9
3,771,12147,3575866703,3575866713,10
3,771,12148,3575866703,3575866715,12
3,771,12149,3575866703,3575866717,14
3,771,12150,3575866703,3575866719,16
3,771,12151,3575866703,3575866722,19
3,771,12152,3575866703,3575866723,20
3,771,12153,3575866703,3575866725,22
3,771,12154,3575866703,3575866725,22
3,771,12155,3575866703,3575866727,24
3,771,12156,3575866703,3575866727,24
3,771,12157,3575866703,3575866728,25
3,771,12158,3575866703,3575866733,30
3,771,12159,3575866703,3575866736,33
3,771,12160,3575866703,3575866737,34
3,771,12161,3575866703,3575866742,39
3,771,12162,3575866703,3575866743,40
3,771,12163,3575866703,3575866743,40
3,771,12164,3575866703,3575866744,41
3,771,12165,3575866703,3575866745,42
3,771,12166,3575866703,3575866751,48
3,772,12167,3575866759,3575866759,0
3,772,12168,3575866759,3575866760,1
3,772,12169,3575866759,3575866760,1
3,772,12170,3575866759,3575866764,5
3,772,12171,3575866759,3575866767,8
3,772,12172,3575866759,3575866768,9
3,772,12173,3575866759,3575866769,10
3,772,12174,3575866759,3575866770,11
3,772,12175,3575866759,3575866770,11
3,772,12176,3575866759,3575866771,12
3,772,12177,3575866759,3575866772,13
3,772,12178,3575866759,3575866774,15
3,772,12179,3575866759,3575866775,16
3,772,12180,3575866759,3575866778,19
3,772,12181,3575866759,3575866781,22
3,772,12182,3575866759,3575866783,24
3,772,12183,3575866759,3575866783,24
3,772,12184,3575866759,3575866786,27
3,772,12185,3575866759,3575866786,27
3,772,12186,3575866759,3575866786,27
3,772,12187,3575866759,3575866787,28
3,772,12188,3575866759,3575866787,28
3,772,12189,3575866759,3575866790,31
3,772,12190,3575866759,3575866792,33
3,772,12191,3575866759,3575866792,33
3,772,12192,3575866759,3575866793,34
3,772,12193,3575866759,3575866794,35
3,772,12194,3575866759,3575866795,36
3,772,12195,3575866759,3575866797,38
3,772,12196,3575866759,3575866797,38
3,772,12197,3575866759,3575866800,41
3,772,12198,3575866759,3575866804,45
3,772,12199,3575866759,3575866804,45
3,772,12200,3575866759,3575866804,45
3,772,12201,3575866759,3575866807,48
3,773,12202,3575866822,3575866822,0
3,773,12203,3575866822,3575866822,0
3,773,12204,3575866822,3575866822,0
3,773,12205,3575866822,3575866822,0
3,773,12206,3575866822,3575866822,0
3,773,12207,3575866822,3575866822,0
3,773,12208,3575866822,3575866822,0
3,773,12209,3575866822,3575866822,0
3,773,12210,3575866822,3575866822,0
3,773,12211,3575866822,3575866822,0
3,773,12212,3575866822,3575866824,2
3,773,12213,3575866822,3575866825,3
3,773,12214,3575866822,3575866826,4
3,773,12215,3575866822,3575866828,6
3,773,12216,3575866822,3575866829,7
3,773,12217,3575866822,3575866830,8
3,773,12218,3575866822,3575866831,9
3,773,12219,3575866822,3575866832,10
3,773,12220,3575866822,3575866834,12
3,773,12221,3575866822,3575866834,12
3,773,12222,3575866822,3575866838,16
3,773,12223,3575866822,3575866840,18
3,773,12224,3575866822,3575866841,19
3,773,12225,3575866822,3575866841,19
3,773,12226,3575866822,3575866842,20
3,773,12227,3575866822,3575866843,21
3,773,12228,3575866822,3575866844,22
3,773,12229,3575866822,3575866844,22
3,773,12230,3575866822,3575866844,22
3,773,12231,3575866822,3575866845,23
3,773,12232,3575866822,3575866847,25
3,773,12233,3575866822,3575866847,25
3,773,12234,3575866822,3575866852,30
3,773,12235,3575866822,3575866852,30
3,773,12236,3575866822,3575866852,30
3,773,12237,3575866822,3575866853,31
3,773,12238,3575866822,3575866854,32
3,773,12239,3575866822,3575866855,33
3,773,12240,3575866822,3575866857,35
3,773,12241,3575866822,3575866857,35
3,773,12242,3575866822,3575866858,36
3,773,12243,3575866822,3575866860,38
3,773,12244,3575866822,3575866862,40
3,773,12245,3575866822,3575866862,40
3,773,12246,3575866822,3575866863,41
3,773,12247,3575866822,3575866864,42
3,773,12248,3575866822,3575866866,44
3,773,12249,3575866822,3575866866,44
3,773,12250,3575866822,3575866867,45
3,773,12251,3575866822,3575866868,46
3,773,12252,3575866822,3575866869,47
3,773,12253,3575866822,3575866870,48
3,774,12254,3575866879,3575866879,0
3,774,12255,3575866879,3575866879,0
3,774,12256,3575866879,3575866879,0
3,774,12257,3575866879,3575866879,0
3,774,12258,3575866879,3575866879,0
3,774,12259,3575866879,3575866879,0
3,774,12260,3575866879,3575866881,2
3,774,12261,3575866879,3575866882,3
3,774,12262,3575866879,3575866883,4
3,774,12263,3575866879,3575866883,4
3,774,12264,3575866879,3575866884,5
3,774,12265,3575866879,3575866888,9
3,774,12266,3575866879,3575866889,10
3,774,12267,3575866879,3575866895,16
3,774,12268,3575866879,3575866895,16
3,774,12269,3575866879,3575866896,17
3,774,12270,3575866879,3575866899,20
3,774,12271,3575866879,3575866899,20
3,774,12272,3575866879,3575866900,21
3,774,12273,3575866879,3575866902,23
3,774,12274,3575866879,3575866902,23
3,774,12275,3575866879,3575866903,24
3,774,12276,3575866879,3575866907,28
3,774,12277,3575866879,3575866912,33
3,774,12278,3575866879,3575866912,33
3,774,12279,3575866879,3575866913,34
3,774,12280,3575866879,3575866915,36
3,774,12281,3575866879,3575866917,38
3,774,12282,3575866879,3575866919,40
3,774,12283,3575866879,3575866922,43
3,774,12284,3575866879,3575866922,43
3,774,12285,3575866879,3575866925,46
3,774,12286,3575866879,3575866925,46
3,774,12287,3575866879,3575866927,48
3,774,12288,3575866879,3575866927,48
3,774,12289,3575866879,3575866928,49
3,775,12290,3575866936,3575866936,0
3,775,12291,3575866936,3575866936,0
3,775,12292,3575866936,3575866937,1
3,775,12293,3575866936,3575866943,7
3,775,12294,3575866936,3575866943,7
3,775,12295,3575866936,3575866944,8
3,775,12296,3575866936,3575866945,9
3,775,12297,3575866936,3575866946,10
3,775,12298,3575866936,3575866951,15
3,775,12299,3575866936,3575866952,16
3,775,12300,3575866936,3575866956,20
3,775,12301,3575866936,3575866960,24
3,775,12302,3575866936,3575866961,25
3,775,12303,3575866936,3575866963,27
3,775,12304,3575866936,3575866966,30
3,775,12305,3575866936,3575866969,33
3,775,12306,3575866936,3575866970,34
3,775,12307,3575866936,3575866970,34
3,775,12308,3575866936,3575866972,36
3,775,12309,3575866936,3575866972,36
3,775,12310,3575866936,3575866972,36
3,775,12311,3575866936,3575866978,42
3,775,12312,3575866936,3575866981,45
3,775,12313,3575866936,3575866983,47
3,775,12314,3575866936,3575866984,48
3,776,12315,3575866993,3575866993,0
3,776,12316,3575866993,3575866993,0
3,776,12317,3575866993,3575866993,0
3,776,12318,3575866993,3575866993,0
3,776,12319,3575866993,3575866993,0
3,776,12320,3575866993,3575866993,0
3,776,12321,3575866993,3575866993,0
3,776,12322,3575866993,3575866993,0
3,776,12323,3575866993,3575866993,0
3,776,12324,3575866993,3575866995,2
3,776,12325,3575866993,3575866995,2
3,776,12326,3575866993,3575866996,3
3,776,12327,3575866993,3575866996,3
3,776,12328,3575866993,3575866996,3
3,776,12329,3575866993,3575866997,4
3,776,12330,3575866993,3575867001,8
3,776,12331,3575866993,3575867005,12
3,776,12332,3575866993,3575867006,13
3,776,12333,3575866993,3575867008,15
3,776,12334,3575866993,3575867013,20
3,776,12335,3575866993,3575867013,20
3,776,12336,3575866993,3575867015,22
3,776,12337,3575866993,3575867016,23
3,776,12338,3575866993,3575867016,23
3,776,12339,3575866993,3575867016,23
3,776,12340,3575866993,3575867017,24
3,776,12341,3575866993,3575867019,26
3,776,12342,3575866993,3575867020,27
3,776,12343,3575866993,3575867020,27
3,776,12344,3575866993,3575867021,28
3,776,12345,3575866993,3575867024,31
3,776,12346,3575866993,3575867025,32
3,776,12347,3575866993,3575867026,33
3,776,12348,3575866993,3575867029,36
3,776,12349,3575866993,3575867029,36
3,776,12350,3575866993,3575867032,39
3,776,12351,3575866993,3575867032,39
3,776,12352,3575866993,3575867032,39
3,776,12353,3575866993,3575867034,41
3,776,12354,3575866993,3575867035,42
3,776,12355,3575866993,3575867035,42
3,776,12356,3575866993,3575867038,45
3,776,12357,3575866993,3575867041,48
3,776,12358,3575866993,3575867041,48
3,776,12359,3575866993,3575867042,49
3,777,12360,3575867050,3575867050,0
3,777,12361,3575867050,3575867050,0
3,777,12362,3575867050,3575867050,0
3,777,12363,3575867050,3575867050,0
3,777,12364,3575867050,3575867050,0
3,777,12365,3575867050,3575867050,0
3,777,12366,3575867050,3575867050,0
3,777,12367,3575867050,3575867050,0
3,777,12368,3575867050,3575867052,2
3,777,12369,3575867050,3575867052,2
3,777,12370,3575867050,3575867053,3
3,777,12371,3575867050,3575867054,4
3,777,12372,3575867050,3575867054,4
3,777,12373,3575867050,3575867055,5
3,777,12374,3575867050,3575867057,7
3,777,12375,3575867050,3575867059,9
3,777,12376,3575867050,3575867060,10
3,777,12377,3575867050,3575867062,12
3,777,12378,3575867050,3575867062,12
3,777,12379,3575867050,3575867063,13
3,777,12380,3575867050,3575867065,15
3,777,12381,3575867050,3575867066,16
3,777,12382,3575867050,3575867067,17
3,777,12383,3575867050,3575867068,18
3,777,12384,3575867050,3575867069,19
3,777,12385,3575867050,3575867071,21
3,777,12386,3575867050,3575867073,23
3,777,12387,3575867050,3575867077,27
3,777,12388,3575867050,3575867079,29
3,777,12389,3575867050,3575867079,29
3,777,12390,3575867050,3575867079,29
3,777,12391,3575867050,3575867080,30
3,777,12392,3575867050,3575867081,31
3,777,12393,3575867050,3575867082,32
3,777,12394,3575867050,3575867083,33
3,777,12395,3575867050,3575867083,33
3,777,12396,3575867050,3575867088,38
3,777,12397,3575867050,3575867089,39
3,777,12398,3575867050,3575867095,45
3,777,12399,3575867050,3575867096,46
3,777,12400,3575867050,3575867096,46
3,777,12401,3575867050,3575867098,48
3,777,12402,3575867050,3575867100,50
3,778,12403,3575867111,3575867111,0
3,778,12404,3575867111,3575867111,0
3,778,12405,3575867111,3575867111,0
3,778,12406,3575867111,3575867112,1
3,778,12407,3575867111,3575867112,1
3,778,12408,3575867111,3575867113,2
3,778,12409,3575867111,3575867115,4
3,778,12410,3575867111,3575867119,8
3,778,12411,3575867111,3575867122,11
3,778,12412,3575867111,3575867123,12
3,778,12413,3575867111,3575867125,14
3,778,12414,3575867111,3575867125,14
3,778,12415,3575867111,3575867126,15
3,778,12416,3575867111,3575867128,17
3,778,12417,3575867111,3575867128,17
3,778,12418,3575867111,3575867134,23
3,778,12419,3575867111,3575867143,32
3,778,12420,3575867111,3575867143,32
3,778,12421,3575867111,3575867144,33
3,778,12422,3575867111,3575867145,34
3,778,12423,3575867111,3575867148,37
3,778,12424,3575867111,3575867150,39
3,778,12425,3575867111,3575867152,41
3,778,12426,3575867111,3575867153,42
3,778,12427,3575867111,3575867156,45
3,778,12428,3575867111,3575867161,50
3,779,12429,3575867166,3575867167,1
3,779,12430,3575867166,3575867167,1
3,779,12431,3575867166,3575867167,1
3,779,12432,3575867166,3575867167,1
3,779,12433,3575867166,3575867168,2
3,779,12434,3575867166,3575867170,4
3,779,12435,3575867166,3575867170,4
3,779,12436,3575867166,3575867170,4
3,779,12437,3575867166,3575867172,6
3,779,12438,3575867166,3575867172,6
3,779,12439,3575867166,3575867174,8
3,779,12440,3575867166,3575867181,15
3,779,12441,3575867166,3575867184,18
3,779,12442,3575867166,3575867184,18
3,779,12443,3575867166,3575867186,20
3,779,12444,3575867166,3575867186,20
3,779,12445,3575867166,3575867187,21
3,779,12446,3575867166,3575867188,22
3,779,12447,3575867166,3575867190,24
3,779,12448,3575867166,3575867193,27
3,779,12449,3575867166,3575867193,27
3,779,12450,3575867166,3575867194,28
3,779,12451,3575867166,3575867195,29
3,779,12452,3575867166,3575867196,30
3,779,12453,3575867166,3575867196,30
3,779,12454,3575867166,3575867197,31
3,779,12455,3575867166,3575867197,31
3,779,12456,3575867166,3575867201,35
3,779,12457,3575867166,3575867204,38
3,779,12458,3575867166,3575867205,39
3,779,12459,3575867166,3575867206,40
3,779,12460,3575867166,3575867208,42
3,779,12461,3575867166,3575867213,47
3,779,12462,3575867166,3575867213,47
3,779,12463,3575867166,3575867216,50
3,780,12464,3575867227,3575867227,0
3,780,12465,3575867227,3575867227,0
3,780,12466,3575867227,3575867227,0
3,780,12467,3575867227,3575867227,0
3,780,12468,3575867227,3575867227,0
3,780,12469,3575867227,3575867227,0
3,780,12470,3575867227,3575867227,0
3,780,12471,3575867227,3575867227,0
3,780,12472,3575867227,3575867227,0
3,780,12473,3575867227,3575867227,0
3,780,12474,3575867227,3575867227,0
3,780,12475,3575867227,3575867229,2
3,780,12476,3575867227,3575867229,2
3,780,12477,3575867227,3575867231,4
3,780,12478,3575867227,3575867232,5
3,780,12479,3575867227,3575867234,7
3,780,12480,3575867227,3575867235,8
3,780,12481,3575867227,3575867237,10
3,780,12482,3575867227,3575867240,13
3,780,12483,3575867227,3575867241,14
3,780,12484,3575867227,3575867242,15
3,780,12485,3575867227,3575867244,17
3,780,12486,3575867227,3575867244,17
3,780,12487,3575867227,3575867244,17
3,780,12488,3575867227,3575867244,17
3,780,12489,3575867227,3575867244,17
3,780,12490,3575867227,3575867246,19
3,780,12491,3575867227,3575867248,21
3,780,12492,3575867227,3575867248,21
3,780,12493,3575867227,3575867251,24
3,780,12494,3575867227,3575867252,25
3,780,12495,3575867227,3575867252,25
3,780,12496,3575867227,3575867253,26
3,780,12497,3575867227,3575867254,27
3,780,12498,3575867227,3575867255,28
3,780,12499,3575867227,3575867255,28
3,780,12500,3575867227,3575867257,30
3,780,12501,3575867227,3575867257,30
3,780,12502,3575867227,3575867259,32
3,780,12503,3575867227,3575867260,33
3,780,12504,3575867227,3575867262,35
3,780,12505,3575867227,3575867262,35
3,780,12506,3575867227,3575867264,37
3,780,12507,3575867227,3575867264,37
3,780,12508,3575867227,3575867266,39
3,780,12509,3575867227,3575867267,40
3,780,12510,3575867227,3575867268,41
3,780,12511,3575867227,3575867269,42
3,780,12512,3575867227,3575867272,45
3,780,12513,3575867227,3575867273,46
3,780,12514,3575867227,3575867277,50
3,781,12515,3575867284,3575867284,0
3,781,12516,3575867284,3575867284,0
3,781,12517,3575867284,3575867284,0
3,781,12518,3575867284,3575867284,0
3,781,12519,3575867284,3575867284,0
3,781,12520,3575867284,3575867284,0
3,781,12521,3575867284,3575867284,0
3,781,12522,3575867284,3575867284,0
3,781,12523,3575867284,3575867284,0
3,781,12524,3575867284,3575867288,4
3,781,12525,3575867284,3575867289,5
3,781,12526,3575867284,3575867295,11
3,781,12527,3575867284,3575867296,12
3,781,12528,3575867284,3575867297,13
3,781,12529,3575867284,3575867298,14
3,781,12530,3575867284,3575867300,16
3,781,12531,3575867284,3575867301,17
3,781,12532,3575867284,3575867304,20
3,781,12533,3575867284,3575867312,28
3,781,12534,3575867284,3575867313,29
3,781,12535,3575867284,3575867315,31
3,781,12536,3575867284,3575867317,33
3,781,12537,3575867284,3575867319,35
3,781,12538,3575867284,3575867323,39
3,781,12539,3575867284,3575867323,39
3,781,12540,3575867284,3575867325,41
3,781,12541,3575867284,3575867325,41
3,781,12542,3575867284,3575867327,43
3,781,12543,3575867284,3575867328,44
3,781,12544,3575867284,3575867328,44
3,781,12545,3575867284,3575867334,50
3,782,12546,3575867341,3575867343,2
3,782,12547,3575867341,3575867344,3
3,782,12548,3575867341,3575867345,4
3,782,12549,3575867341,3575867349,8
3,782,12550,3575867341,3575867352,11
3,782,12551,3575867341,3575867356,15
3,782,12552,3575867341,3575867360,19
3,782,12553,3575867341,3575867361,20
3,782,12554,3575867341,3575867361,20
3,782,12555,3575867341,3575867363,22
3,782,12556,3575867341,3575867366,25
3,782,12557,3575867341,3575867369,28
3,782,12558,3575867341,3575867370,29
3,782,12559,3575867341,3575867371,30
3,782,12560,3575867341,3575867371,30
3,782,12561,3575867341,3575867372,31
3,782,12562,3575867341,3575867373,32
3,782,12563,3575867341,3575867376,35
3,782,12564,3575867341,3575867378,37
3,782,12565,3575867341,3575867381,40
3,782,12566,3575867341,3575867384,43
3,782,12567,3575867341,3575867385,44
3,782,12568,3575867341,3575867386,45
3,782,12569,3575867341,3575867387,46
3,782,12570,3575867341,3575867387,46
3,782,12571,3575867341,3575867388,47
3,782,12572,3575867341,3575867391,50
3,783,12573,3575867400,3575867400,0
3,783,12574,3575867400,3575867400,0
3,783,12575,3575867400,3575867400,0
3,783,12576,3575867400,3575867400,0
3,783,12577,3575867400,3575867400,0
3,783,12578,3575867400,3575867400,0
3,783,12579,3575867400,3575867400,0
3,783,12580,3575867400,3575867400,0
3,783,12581,3575867400,3575867400,0
3,783,12582,3575867400,3575867400,0
3,783,12583,3575867400,3575867400,0
3,783,12584,3575867400,3575867401,1
3,783,12585,3575867400,3575867404,4
3,783,12586,3575867400,3575867404,4
3,783,12587,3575867400,3575867405,5
3,783,12588,3575867400,3575867406,6
3,783,12589,3575867400,3575867409,9
3,783,12590,3575867400,3575867413,13
3,783,12591,3575867400,3575867414,14
3,783,12592,3575867400,3575867415,15
3,783,12593,3575867400,3575867416,16
3,783,12594,3575867400,3575867416,16
3,783,12595,3575867400,3575867417,17
3,783,12596,3575867400,3575867417,17
3,783,12597,3575867400,3575867418,18
3,783,12598,3575867400,3575867418,18
3,783,12599,3575867400,3575867420,20
3,783,12600,3575867400,3575867421,21
3,783,12601,3575867400,3575867422,22
3,783,12602,3575867400,3575867426,26
3,783,12603,3575867400,3575867426,26
3,783,12604,3575867400,3575867426,26
3,783,12605,3575867400,3575867429,29
3,783,12606,3575867400,3575867430,30
3,783,12607,3575867400,3575867431,31
3,783,12608,3575867400,3575867432,32
3,783,12609,3575867400,3575867432,32
3,783,12610,3575867400,3575867435,35
3,783,12611,3575867400,3575867435,35
3,783,12612,3575867400,3575867436,36
3,783,12613,3575867400,3575867438,38
3,783,12614,3575867400,3575867440,40
3,783,12615,3575867400,3575867442,42
3,783,12616,3575867400,3575867442,42
3,783,12617,3575867400,3575867444,44
3,783,12618,3575867400,3575867444,44
3,783,12619,3575867400,3575867444,44
3,783,12620,3575867400,3575867444,44
3,783,12621,3575867400,3575867445,45
3,783,12622,3575867400,3575867446,46
3,783,12623,3575867400,3575867448,48
3,783,12624,3575867400,3575867449,49
3,784,12625,3575867458,3575867458,0
3,784,12626,3575867458,3575867458,0
3,784,12627,3575867458,3575867458,0
3,784,12628,3575867458,3575867458,0
3,784,12629,3575867458,3575867458,0
3,784,12630,3575867458,3575867458,0
3,784,12631,3575867458,3575867459,1
3,784,12632,3575867458,3575867459,1
3,784,12633,3575867458,3575867461,3
3,784,12634,3575867458,3575867462,4
3,784,12635,3575867458,3575867462,4
3,784,12636,3575867458,3575867465,7
3,784,12637,3575867458,3575867465,7
3,784,12638,3575867458,3575867467,9
3,784,12639,3575867458,3575867468,10
3,784,12640,3575867458,3575867469,11
3,784,12641,3575867458,3575867469,11
3,784,12642,3575867458,3575867473,15
3,784,12643,3575867458,3575867473,15
3,784,12644,3575867458,3575867477,19
3,784,12645,3575867458,3575867478,20
3,784,12646,3575867458,3575867479,21
3,784,12647,3575867458,3575867480,22
3,784,12648,3575867458,3575867480,22
3,784,12649,3575867458,3575867482,24
3,784,12650,3575867458,3575867482,24
3,784,12651,3575867458,3575867484,26
3,784,12652,3575867458,3575867484,26
3,784,12653,3575867458,3575867485,27
3,784,12654,3575867458,3575867489,31
3,784,12655,3575867458,3575867489,31
3,784,12656,3575867458,3575867494,36
3,784,12657,3575867458,3575867496,38
3,784,12658,3575867458,3575867497,39
3,784,12659,3575867458,3575867498,40
3,784,12660,3575867458,3575867499,41
3,784,12661,3575867458,3575867500,42
3,784,12662,3575867458,3575867502,44
3,784,12663,3575867458,3575867502,44
3,784,12664,3575867458,3575867503,45
3,784,12665,3575867458,3575867508,50
3,785,12666,3575867515,3575867515,0
3,785,12667,3575867515,3575867515,0
3,785,12668,3575867515,3575867515,0
3,785,12669,3575867515,3575867516,1
3,785,12670,3575867515,3575867519,4
3,785,12671,3575867515,3575867521,6
3,785,12672,3575867515,3575867523,8
3,785,12673,3575867515,3575867524,9
3,785,12674,3575867515,3575867524,9
3,785,12675,3575867515,3575867526,11
3,785,12676,3575867515,3575867527,12
3,785,12677,3575867515,3575867528,13
3,785,12678,3575867515,3575867533,18
3,785,12679,3575867515,3575867536,21
3,785,12680,3575867515,3575867537,22
3,785,12681,3575867515,3575867543,28
3,785,12682,3575867515,3575867543,28
3,785,12683,3575867515,3575867543,28
3,785,12684,3575867515,3575867544,29
3,785,12685,3575867515,3575867548,33
3,785,12686,3575867515,3575867551,36
3,785,12687,3575867515,3575867551,36
3,785,12688,3575867515,3575867553,38
3,785,12689,3575867515,3575867558,43
3,785,12690,3575867515,3575867559,44
3,785,12691,3575867515,3575867560,45
3,785,12692,3575867515,3575867560,45
3,785,12693,3575867515,3575867563,48
3,786,12694,3575867572,3575867572,0
3,786,12695,3575867572,3575867572,0
3,786,12696,3575867572,3575867572,0
3,786,12697,3575867572,3575867572,0
3,786,12698,3575867572,3575867572,0
3,786,12699,3575867572,3575867572,0
3,786,12700,3575867572,3575867573,1
3,786,12701,3575867572,3575867575,3
3,786,12702,3575867572,3575867576,4
3,786,12703,3575867572,3575867577,5
3,786,12704,3575867572,3575867582,10
3,786,12705,3575867572,3575867583,11
3,786,12706,3575867572,3575867584,12
3,786,12707,3575867572,3575867586,14
3,786,12708,3575867572,3575867586,14
3,786,12709,3575867572,3575867586,14
3,786,12710,3575867572,3575867587,15
3,786,12711,3575867572,3575867590,18
3,786,12712,3575867572,3575867592,20
3,786,12713,3575867572,3575867593,21
3,786,12714,3575867572,3575867593,21
3,786,12715,3575867572,3575867594,22
3,786,12716,3575867572,3575867594,22
3,786,12717,3575867572,3575867595,23
3,786,12718,3575867572,3575867595,23
3,786,12719,3575867572,3575867595,23
3,786,12720,3575867572,3575867596,24
3,786,12721,3575867572,3575867596,24
3,786,12722,3575867572,3575867596,24
3,786,12723,3575867572,3575867601,29
3,786,12724,3575867572,3575867602,30
3,786,12725,3575867572,3575867603,31
3,786,12726,3575867572,3575867604,32
3,786,12727,3575867572,3575867605,33
3,786,12728,3575867572,3575867608,36
3,786,12729,3575867572,3575867612,40
3,786,12730,3575867572,3575867613,41
3,786,12731,3575867572,3575867614,42
3,786,12732,3575867572,3575867615,43
3,786,12733,3575867572,3575867615,43
3,786,12734,3575867572,3575867615,43
3,786,12735,3575867572,3575867616,44
3,786,12736,3575867572,3575867617,45
3,786,12737,3575867572,3575867618,46
3,786,12738,3575867572,3575867620,48
3,786,12739,3575867572,3575867621,49
3,787,12740,3575867631,3575867631,0
3,787,12741,3575867631,3575867631,0
3,787,12742,3575867631,3575867631,0
3,787,12743,3575867631,3575867631,0
3,787,12744,3575867631,3575867631,0
3,787,12745,3575867631,3575867631,0
3,787,12746,3575867631,3575867631,0
3,787,12747,3575867631,3575867632,1
3,787,12748,3575867631,3575867634,3
3,787,12749,3575867631,3575867634,3
3,787,12750,3575867631,3575867638,7
3,787,12751,3575867631,3575867639,8
3,787,12752,3575867631,3575867640,9
3,787,12753,3575867631,3575867641,10
3,787,12754,3575867631,3575867642,11
3,787,12755,3575867631,3575867643,12
3,787,12756,3575867631,3575867643,12
3,787,12757,3575867631,3575867643,12
3,787,12758,3575867631,3575867643,12
3,787,12759,3575867631,3575867645,14
3,787,12760,3575867631,3575867647,16
3,787,12761,3575867631,3575867648,17
3,787,12762,3575867631,3575867650,19
3,787,12763,3575867631,3575867651,20
3,787,12764,3575867631,3575867652,21
3,787,12765,3575867631,3575867652,21
3,787,12766,3575867631,3575867653,22
3,787,12767,3575867631,3575867654,23
3,787,12768,3575867631,3575867655,24
3,787,12769,3575867631,3575867657,26
3,787,12770,3575867631,3575867658,27
3,787,12771,3575867631,3575867659,28
3,787,12772,3575867631,3575867660,29
3,787,12773,3575867631,3575867660,29
3,787,12774,3575867631,3575867662,31
3,787,12775,3575867631,3575867663,32
3,787,12776,3575867631,3575867666,35
3,787,12777,3575867631,3575867667,36
3,787,12778,3575867631,3575867668,37
3,787,12779,3575867631,3575867668,37
3,787,12780,3575867631,3575867668,37
3,787,12781,3575867631,3575867673,42
3,787,12782,3575867631,3575867677,46
3,787,12783,3575867631,3575867677,46
3,787,12784,3575867631,3575867679,48
3,787,12785,3575867631,3575867679,48
3,787,12786,3575867631,3575867680,49
3,787,12787,3575867631,3575867681,50
3,788,12788,3575867689,3575867689,0
3,788,12789,3575867689,3575867689,0
3,788,12790,3575867689,3575867689,0
3,788,12791,3575867689,3575867689,0
3,788,12792,3575867689,3575867689,0
3,788,12793,3575867689,3575867689,0
3,788,12794,3575867689,3575867690,1
3,788,12795,3575867689,3575867695,6
3,788,12796,3575867689,3575867697,8
3,788,12797,3575867689,3575867697,8
3,788,12798,3575867689,3575867698,9
3,788,12799,3575867689,3575867699,10
3,788,12800,3575867689,3575867700,11
3,788,12801,3575867689,3575867701,12
3,788,12802,3575867689,3575867701,12
3,788,12803,3575867689,3575867703,14
3,788,12804,3575867689,3575867707,18
3,788,12805,3575867689,3575867711,22
3,788,12806,3575867689,3575867712,23
3,788,12807,3575867689,3575867716,27
3,788,12808,3575867689,3575867716,27
3,788,12809,3575867689,3575867718,29
3,788,12810,3575867689,3575867722,33
3,788,12811,3575867689,3575867722,33
3,788,12812,3575867689,3575867724,35
3,788,12813,3575867689,3575867724,35
3,788,12814,3575867689,3575867726,37
3,788,12815,3575867689,3575867727,38
3,788,12816,3575867689,3575867728,39
3,788,12817,3575867689,3575867733,44
3,788,12818,3575867689,3575867736,47
3,788,12819,3575867689,3575867737,48
3,789,12820,3575867745,3575867745,0
3,789,12821,3575867745,3575867745,0
3,789,12822,3575867745,3575867745,0
3,789,12823,3575867745,3575867745,0
3,789,12824,3575867745,3575867749,4
3,789,12825,3575867745,3575867751,6
3,789,12826,3575867745,3575867751,6
3,789,12827,3575867745,3575867755,10
3,789,12828,3575867745,3575867757,12
3,789,12829,3575867745,3575867759,14
3,789,12830,3575867745,3575867759,14
3,789,12831,3575867745,3575867760,15
3,789,12832,3575867745,3575867762,17
3,789,12833,3575867745,3575867765,20
3,789,12834,3575867745,3575867768,23
3,789,12835,3575867745,3575867769,24
3,789,12836,3575867745,3575867770,25
3,789,12837,3575867745,3575867770,25
3,789,12838,3575867745,3575867770,25
3,789,12839,3575867745,3575867773,28
3,789,12840,3575867745,3575867775,30
3,789,12841,3575867745,3575867775,30
3,789,12842,3575867745,3575867778,33
3,789,12843,3575867745,3575867782,37
3,789,12844,3575867745,3575867783,38
3,789,12845,3575867745,3575867784,39
3,789,12846,3575867745,3575867785,40
3,789,12847,3575867745,3575867786,41
3,789,12848,3575867745,3575867786,41
3,789,12849,3575867745,3575867787,42
3,789,12850,3575867745,3575867789,44
3,789,12851,3575867745,3575867790,45
3,789,12852,3575867745,3575867792,47
3,789,12853,3575867745,3575867793,48
3,789,12854,3575867745,3575867793,48
3,789,12855,3575867745,3575867793,48
3,789,12856,3575867745,3575867793,48
3,789,12857,3575867745,3575867795,50
3,790,12858,3575867802,3575867802,0
3,790,12859,3575867802,3575867802,0
3,790,12860,3575867802,3575867802,0
3,790,12861,3575867802,3575867802,0
3,790,12862,3575867802,3575867802,0
3,790,12863,3575867802,3575867803,1
3,790,12864,3575867802,3575867804,2
3,790,12865,3575867802,3575867804,2
3,790,12866,3575867802,3575867805,3
3,790,12867,3575867802,3575867808,6
3,790,12868,3575867802,3575867812,10
3,790,12869,3575867802,3575867814,12
3,790,12870,3575867802,3575867815,13
3,790,12871,3575867802,3575867815,13
3,790,12872,3575867802,3575867815,13
3,790,12873,3575867802,3575867815,13
3,790,12874,3575867802,3575867817,15
3,790,12875,3575867802,3575867817,15
3,790,12876,3575867802,3575867818,16
3,790,12877,3575867802,3575867820,18
3,790,12878,3575867802,3575867821,19
3,790,12879,3575867802,3575867825,23
3,790,12880,3575867802,3575867826,24
3,790,12881,3575867802,3575867827,25
3,790,12882,3575867802,3575867829,27
3,790,12883,3575867802,3575867829,27
3,790,12884,3575867802,3575867831,29
3,790,12885,3575867802,3575867831,29
3,790,12886,3575867802,3575867834,32
3,790,12887,3575867802,3575867835,33
3,790,12888,3575867802,3575867835,33
3,790,12889,3575867802,3575867839,37
3,790,12890,3575867802,3575867839,37
3,790,12891,3575867802,3575867841,39
3,790,12892,3575867802,3575867841,39
3,790,12893,3575867802,3575867843,41
3,790,12894,3575867802,3575867843,41
3,790,12895,3575867802,3575867843,41
3,790,12896,3575867802,3575867844,42
3,790,12897,3575867802,3575867844,42
3,790,12898,3575867802,3575867845,43
3,790,12899,3575867802,3575867846,44
3,790,12900,3575867802,3575867848,46
3,790,12901,3575867802,3575867850,48
3,790,12902,3575867802,3575867851,49
3,790,12903,3575867802,3575867851,49
3,790,12904,3575867802,3575867853,51
3,791,12905,3575867859,3575867859,0
3,791,12906,3575867859,3575867859,0
3,791,12907,3575867859,3575867859,0
3,791,12908,3575867859,3575867859,0
3,791,12909,3575867859,3575867859,0
3,791,12910,3575867859,3575867859,0
3,791,12911,3575867859,3575867859,0
3,791,12912,3575867859,3575867860,1
3,791,12913,3575867859,3575867863,4
3,791,12914,3575867859,3575867866,7
3,791,12915,3575867859,3575867867,8
3,791,12916,3575867859,3575867868,9
3,791,12917,3575867859,3575867868,9
3,791,12918,3575867859,3575867869,10
3,791,12919,3575867859,3575867872,13
3,791,12920,3575867859,3575867873,14
3,791,12921,3575867859,3575867877,18
3,791,12922,3575867859,3575867878,19
3,791,12923,3575867859,3575867879,20
3,791,12924,3575867859,3575867881,22
3,791,12925,3575867859,3575867882,23
3,791,12926,3575867859,3575867882,23
3,791,12927,3575867859,3575867883,24
3,791,12928,3575867859,3575867883,24
3,791,12929,3575867859,3575867886,27
3,791,12930,3575867859,3575867886,27
3,791,12931,3575867859,3575867889,30
3,791,12932,3575867859,3575867890,31
3,791,12933,3575867859,3575867894,35
3,791,12934,3575867859,3575867896,37
3,791,12935,3575867859,3575867897,38
3,791,12936,3575867859,3575867899,40
3,791,12937,3575867859,3575867899,40
3,791,12938,3575867859,3575867900,41
3,791,12939,3575867859,3575867901,42
3,791,12940,3575867859,3575867902,43
3,791,12941,3575867859,3575867904,45
3,791,12942,3575867859,3575867907,48
3,792,12943,3575867916,3575867916,0
3,792,12944,3575867916,3575867916,0
3,792,12945,3575867916,3575867917,1
3,792,12946,3575867916,3575867918,2
3,792,12947,3575867916,3575867921,5
3,792,12948,3575867916,3575867922,6
3,792,12949,3575867916,3575867924,8
3,792,12950,3575867916,3575867924,8
3,792,12951,3575867916,3575867925,9
3,792,12952,3575867916,3575867927,11
3,792,12953,3575867916,3575867933,17
3,792,12954,3575867916,3575867937,21
3,792,12955,3575867916,3575867938,22
3,792,12956,3575867916,3575867944,28
3,792,12957,3575867916,3575867944,28
3,792,12958,3575867916,3575867944,28
3,792,12959,3575867916,3575867944,28
3,792,12960,3575867916,3575867949,33
3,792,12961,3575867916,3575867951,35
3,792,12962,3575867916,3575867954,38
3,792,12963,3575867916,3575867956,40
3,792,12964,3575867916,3575867957,41
3,792,12965,3575867916,3575867959,43
3,792,12966,3575867916,3575867960,44
3,792,12967,3575867916,3575867960,44
3,792,12968,3575867916,3575867963,47
3,793,12969,3575867976,3575867976,0
3,793,12970,3575867976,3575867976,0
3,793,12971,3575867976,3575867976,0
3,793,12972,3575867976,3575867976,0
3,793,12973,3575867976,3575867976,0
3,793,12974,3575867976,3575867976,0
3,793,12975,3575867976,3575867976,0
3,793,12976,3575867976,3575867976,0
3,793,12977,3575867976,3575867976,0
3,793,12978,3575867976,3575867978,2
3,793,12979,3575867976,3575867982,6
3,793,12980,3575867976,3575867983,7
3,793,12981,3575867976,3575867984,8
3,793,12982,3575867976,3575867986,10
3,793,12983,3575867976,3575867987,11
3,793,12984,3575867976,3575867988,12
3,793,12985,3575867976,3575867989,13
3,793,12986,3575867976,3575867992,16
3,793,12987,3575867976,3575867993,17
3,793,12988,3575867976,3575867993,17
3,793,12989,3575867976,3575867993,17
3,793,12990,3575867976,3575867993,17
3,793,12991,3575867976,3575867995,19
3,793,12992,3575867976,3575867997,21
3,793,12993,3575867976,3575867997,21
3,793,12994,3575867976,3575867997,21
3,793,12995,3575867976,3575867999,23
3,793,12996,3575867976,3575868002,26
3,793,12997,3575867976,3575868004,28
3,793,12998,3575867976,3575868005,29
3,793,12999,3575867976,3575868006,30
3,793,13000,3575867976,3575868013,37
3,793,13001,3575867976,3575868014,38
3,793,13002,3575867976,3575868015,39
3,793,13003,3575867976,3575868015,39
3,793,13004,3575867976,3575868015,39
3,793,13005,3575867976,3575868016,40
3,793,13006,3575867976,3575868018,42
3,793,13007,3575867976,3575868018,42
3,793,13008,3575867976,3575868018,42
3,793,13009,3575867976,3575868020,44
3,793,13010,3575867976,3575868020,44
3,793,13011,3575867976,3575868022,46
3,794,13012,3575868034,3575868034,0
3,794,13013,3575868034,3575868034,0
3,794,13014,3575868034,3575868034,0
3,794,13015,3575868034,3575868034,0
3,794,13016,3575868034,3575868034,0
3,794,13017,3575868034,3575868034,0
3,794,13018,3575868034,3575868034,0
3,794,13019,3575868034,3575868034,0
3,794,13020,3575868034,3575868034,0
3,794,13021,3575868034,3575868035,1
3,794,13022,3575868034,3575868038,4
3,794,13023,3575868034,3575868039,5
3,794,13024,3575868034,3575868041,7
3,794,13025,3575868034,3575868041,7
3,794,13026,3575868034,3575868043,9
3,794,13027,3575868034,3575868043,9
3,794,13028,3575868034,3575868043,9
3,794,13029,3575868034,3575868043,9
3,794,13030,3575868034,3575868043,9
3,794,13031,3575868034,3575868046,12
3,794,13032,3575868034,3575868048,14
3,794,13033,3575868034,3575868050,16
3,794,13034,3575868034,3575868052,18
3,794,13035,3575868034,3575868053,19
3,794,13036,3575868034,3575868053,19
3,794,13037,3575868034,3575868055,21
3,794,13038,3575868034,3575868057,23
3,794,13039,3575868034,3575868057,23
3,794,13040,3575868034,3575868058,24
3,794,13041,3575868034,3575868059,25
3,794,13042,3575868034,3575868059,25
3,794,13043,3575868034,3575868060,26
3,794,13044,3575868034,3575868063,29
3,794,13045,3575868034,3575868066,32
3,794,13046,3575868034,3575868066,32
3,794,13047,3575868034,3575868068,34
3,794,13048,3575868034,3575868068,34
3,794,13049,3575868034,3575868072,38
3,794,13050,3575868034,3575868074,40
3,794,13051,3575868034,3575868077,43
3,794,13052,3575868034,3575868079,45
3,794,13053,3575868034,3575868080,46
3,794,13054,3575868034,3575868082,48
3,794,13055,3575868034,3575868082,48
3,794,13056,3575868034,3575868083,49
3,794,13057,3575868034,3575868084,50
3,795,13058,3575868094,3575868094,0
3,795,13059,3575868094,3575868094,0
3,795,13060,3575868094,3575868094,0
3,795,13061,3575868094,3575868095,1
3,795,13062,3575868094,3575868097,3
3,795,13063,3575868094,3575868097,3
3,795,13064,3575868094,3575868098,4
3,795,13065,3575868094,3575868101,7
3,795,13066,3575868094,3575868102,8
3,795,13067,3575868094,3575868104,10
3,795,13068,3575868094,3575868107,13
3,795,13069,3575868094,3575868111,17
3,795,13070,3575868094,3575868112,18
3,795,13071,3575868094,3575868114,20
3,795,13072,3575868094,3575868118,24
3,795,13073,3575868094,3575868119,25
3,795,13074,3575868094,3575868121,27
3,795,13075,3575868094,3575868123,29
3,795,13076,3575868094,3575868124,30
3,795,13077,3575868094,3575868125,31
3,795,13078,3575868094,3575868127,33
3,795,13079,3575868094,3575868127,33
3,795,13080,3575868094,3575868127,33
3,795,13081,3575868094,3575868134,40
3,795,13082,3575868094,3575868137,43
3,795,13083,3575868094,3575868143,49
3,795,13084,3575868094,3575868144,50
3,796,13085,3575868152,3575868152,0
3,796,13086,3575868152,3575868152,0
3,796,13087,3575868152,3575868152,0
3,796,13088,3575868152,3575868152,0
3,796,13089,3575868152,3575868156,4
3,796,13090,3575868152,3575868158,6
3,796,13091,3575868152,3575868160,8
3,796,13092,3575868152,3575868161,9
3,796,13093,3575868152,3575868162,10
3,796,13094,3575868152,3575868167,15
3,796,13095,3575868152,3575868168,16
3,796,13096,3575868152,3575868168,16
3,796,13097,3575868152,3575868171,19
3,796,13098,3575868152,3575868171,19
3,796,13099,3575868152,3575868171,19
3,796,13100,3575868152,3575868174,22
3,796,13101,3575868152,3575868174,22
3,796,13102,3575868152,3575868176,24
3,796,13103,3575868152,3575868178,26
3,796,13104,3575868152,3575868182,30
3,796,13105,3575868152,3575868184,32
3,796,13106,3575868152,3575868184,32
3,796,13107,3575868152,3575868186,34
3,796,13108,3575868152,3575868187,35
3,796,13109,3575868152,3575868189,37
3,796,13110,3575868152,3575868189,37
3,796,13111,3575868152,3575868191,39
3,796,13112,3575868152,3575868192,40
3,796,13113,3575868152,3575868193,41
3,796,13114,3575868152,3575868194,42
3,796,13115,3575868152,3575868194,42
3,796,13116,3575868152,3575868195,43
3,796,13117,3575868152,3575868195,43
3,796,13118,3575868152,3575868196,44
3,796,13119,3575868152,3575868197,45
3,796,13120,3575868152,3575868197,45
3,796,13121,3575868152,3575868197,45
3,796,13122,3575868152,3575868199,47
3,797,13123,3575868209,3575868209,0
3,797,13124,3575868209,3575868209,0
3,797,13125,3575868209,3575868209,0
3,797,13126,3575868209,3575868213,4
3,797,13127,3575868209,3575868214,5
3,797,13128,3575868209,3575868215,6
3,797,13129,3575868209,3575868216,7
3,797,13130,3575868209,3575868217,8
3,797,13131,3575868209,3575868218,9
3,797,13132,3575868209,3575868218,9
3,797,13133,3575868209,3575868218,9
3,797,13134,3575868209,3575868220,11
3,797,13135,3575868209,3575868220,11
3,797,13136,3575868209,3575868222,13
3,797,13137,3575868209,3575868225,16
3,797,13138,3575868209,3575868226,17
3,797,13139,3575868209,3575868228,19
3,797,13140,3575868209,3575868229,20
3,797,13141,3575868209,3575868230,21
3,797,13142,3575868209,3575868231,22
3,797,13143,3575868209,3575868232,23
3,797,13144,3575868209,3575868233,24
3,797,13145,3575868209,3575868234,25
3,797,13146,3575868209,3575868236,27
3,797,13147,3575868209,3575868236,27
3,797,13148,3575868209,3575868239,30
3,797,13149,3575868209,3575868239,30
3,797,13150,3575868209,3575868242,33
3,797,13151,3575868209,3575868242,33
3,797,13152,3575868209,3575868243,34
3,797,13153,3575868209,3575868243,34
3,797,13154,3575868209,3575868243,34
3,797,13155,3575868209,3575868243,34
3,797,13156,3575868209,3575868244,35
3,797,13157,3575868209,3575868247,38
3,797,13158,3575868209,3575868248,39
3,797,13159,3575868209,3575868251,42
3,797,13160,3575868209,3575868252,43
3,797,13161,3575868209,3575868252,43
3,797,13162,3575868209,3575868253,44
3,797,13163,3575868209,3575868255,46
3,797,13164,3575868209,3575868257,48
3,797,13165,3575868209,3575868257,48
3,797,13166,3575868209,3575868259,50
3,798,13167,3575868266,3575868266,0
3,798,13168,3575868266,3575868266,0
3,798,13169,3575868266,3575868266,0
3,798,13170,3575868266,3575868266,0
3,798,13171,3575868266,3575868266,0
3,798,13172,3575868266,3575868266,0
3,798,13173,3575868266,3575868267,1
3,798,13174,3575868266,3575868268,2
3,798,13175,3575868266,3575868269,3
3,798,13176,3575868266,3575868273,7
3,798,13177,3575868266,3575868274,8
3,798,13178,3575868266,3575868278,12
3,798,13179,3575868266,3575868279,13
3,798,13180,3575868266,3575868279,13
3,798,13181,3575868266,3575868280,14
3,798,13182,3575868266,3575868282,16
3,798,13183,3575868266,3575868284,18
3,798,13184,3575868266,3575868284,18
3,798,13185,3575868266,3575868284,18
3,798,13186,3575868266,3575868285,19
3,798,13187,3575868266,3575868290,24
3,798,13188,3575868266,3575868290,24
3,798,13189,3575868266,3575868295,29
3,798,13190,3575868266,3575868297,31
3,798,13191,3575868266,3575868298,32
3,798,13192,3575868266,3575868298,32
3,798,13193,3575868266,3575868300,34
3,798,13194,3575868266,3575868301,35
3,798,13195,3575868266,3575868302,36
3,798,13196,3575868266,3575868304,38
3,798,13197,3575868266,3575868307,41
3,798,13198,3575868266,3575868312,46
3,798,13199,3575868266,3575868312,46
3,798,13200,3575868266,3575868314,48
3,799,13201,3575868323,3575868323,0
3,799,13202,3575868323,3575868323,0
3,799,13203,3575868323,3575868323,0
3,799,13204,3575868323,3575868323,0
3,799,13205,3575868323,3575868323,0
3,799,13206,3575868323,3575868323,0
3,799,13207,3575868323,3575868324,1
3,799,13208,3575868323,3575868325,2
3,799,13209,3575868323,3575868327,4
3,799,13210,3575868323,3575868327,4
3,799,13211,3575868323,3575868327,4
3,799,13212,3575868323,3575868334,11
3,799,13213,3575868323,3575868337,14
3,799,13214,3575868323,3575868338,15
3,799,13215,3575868323,3575868343,20
3,799,13216,3575868323,3575868344,21
3,799,13217,3575868323,3575868345,22
3,799,13218,3575868323,3575868349,26
3,799,13219,3575868323,3575868352,29
3,799,13220,3575868323,3575868354,31
3,799,13221,3575868323,3575868356,33
3,799,13222,3575868323,3575868357,34
3,799,13223,3575868323,3575868357,34
3,799,13224,3575868323,3575868361,38
3,799,13225,3575868323,3575868364,41
3,799,13226,3575868323,3575868366,43
3,799,13227,3575868323,3575868368,45
3,799,13228,3575868323,3575868369,46
3,799,13229,3575868323,3575868371,48
3,799,13230,3575868323,3575868371,48
3,799,13231,3575868323,3575868371,48
3,800,13232,3575868383,3575868383,0
3,800,13233,3575868383,3575868383,0
3,800,13234,3575868383,3575868383,0
3,800,13235,3575868383,3575868383,0
3,800,13236,3575868383,3575868383,0
3,800,13237,3575868383,3575868383,0
3,800,13238,3575868383,3575868384,1
3,800,13239,3575868383,3575868386,3
3,800,13240,3575868383,3575868387,4
3,800,13241,3575868383,3575868387,4
3,800,13242,3575868383,3575868389,6
3,800,13243,3575868383,3575868390,7
3,800,13244,3575868383,3575868391,8
3,800,13245,3575868383,3575868393,10
3,800,13246,3575868383,3575868393,10
3,800,13247,3575868383,3575868393,10
3,800,13248,3575868383,3575868394,11
3,800,13249,3575868383,3575868395,12
3,800,13250,3575868383,3575868395,12
3,800,13251,3575868383,3575868397,14
3,800,13252,3575868383,3575868397,14
3,800,13253,3575868383,3575868397,14
3,800,13254,3575868383,3575868398,15
3,800,13255,3575868383,3575868398,15
3,800,13256,3575868383,3575868403,20
3,800,13257,3575868383,3575868404,21
3,800,13258,3575868383,3575868407,24
3,800,13259,3575868383,3575868407,24
3,800,13260,3575868383,3575868412,29
3,800,13261,3575868383,3575868414,31
3,800,13262,3575868383,3575868415,32
3,800,13263,3575868383,3575868416,33
3,800,13264,3575868383,3575868416,33
3,800,13265,3575868383,3575868417,34
3,800,13266,3575868383,3575868418,35
3,800,13267,3575868383,3575868418,35
3,800,13268,3575868383,3575868419,36
3,800,13269,3575868383,3575868421,38
3,800,13270,3575868383,3575868421,38
3,800,13271,3575868383,3575868426,43
3,800,13272,3575868383,3575868427,44
3,800,13273,3575868383,3575868429,46
3,800,13274,3575868383,3575868430,47
3,800,13275,3575868383,3575868431,48
3,800,13276,3575868383,3575868432,49
3,801,13277,3575868442,3575868442,0
3,801,13278,3575868442,3575868442,0
3,801,13279,3575868442,3575868442,0
3,801,13280,3575868442,3575868442,0
3,801,13281,3575868442,3575868442,0
3,801,13282,3575868442,3575868442,0
3,801,13283,3575868442,3575868443,1
3,801,13284,3575868442,3575868443,1
3,801,13285,3575868442,3575868443,1
3,801,13286,3575868442,3575868444,2
3,801,13287,3575868442,3575868444,2
3,801,13288,3575868442,3575868447,5
3,801,13289,3575868442,3575868448,6
3,801,13290,3575868442,3575868451,9
3,801,13291,3575868442,3575868452,10
3,801,13292,3575868442,3575868453,11
3,801,13293,3575868442,3575868453,11
3,801,13294,3575868442,3575868454,12
3,801,13295,3575868442,3575868456,14
3,801,13296,3575868442,3575868457,15
3,801,13297,3575868442,3575868457,15
3,801,13298,3575868442,3575868459,17
3,801,13299,3575868442,3575868460,18
3,801,13300,3575868442,3575868460,18
3,801,13301,3575868442,3575868463,21
3,801,13302,3575868442,3575868463,21
3,801,13303,3575868442,3575868465,23
3,801,13304,3575868442,3575868466,24
3,801,13305,3575868442,3575868467,25
3,801,13306,3575868442,3575868468,26
3,801,13307,3575868442,3575868469,27
3,801,13308,3575868442,3575868472,30
3,801,13309,3575868442,3575868474,32
3,801,13310,3575868442,3575868478,36
3,801,13311,3575868442,3575868478,36
3,801,13312,3575868442,3575868480,38
3,801,13313,3575868442,3575868481,39
3,801,13314,3575868442,3575868482,40
3,801,13315,3575868442,3575868483,41
3,801,13316,3575868442,3575868484,42
3,801,13317,3575868442,3575868485,43
3,801,13318,3575868442,3575868485,43
3,801,13319,3575868442,3575868490,48
3,801,13320,3575868442,3575868490,48
3,802,13321,3575868500,3575868500,0
3,802,13322,3575868500,3575868500,0
3,802,13323,3575868500,3575868500,0
3,802,13324,3575868500,3575868500,0
3,802,13325,3575868500,3575868500,0
3,802,13326,3575868500,3575868500,0
3,802,13327,3575868500,3575868501,1
3,802,13328,3575868500,3575868501,1
3,802,13329,3575868500,3575868503,3
3,802,13330,3575868500,3575868506,6
3,802,13331,3575868500,3575868511,11
3,802,13332,3575868500,3575868511,11
3,802,13333,3575868500,3575868513,13
3,802,13334,3575868500,3575868517,17
3,802,13335,3575868500,3575868518,18
3,802,13336,3575868500,3575868519,19
3,802,13337,3575868500,3575868522,22
3,802,13338,3575868500,3575868522,22
3,802,13339,3575868500,3575868522,22
3,802,13340,3575868500,3575868523,23
3,802,13341,3575868500,3575868524,24
3,802,13342,3575868500,3575868526,26
3,802,13343,3575868500,3575868527,27
3,802,13344,3575868500,3575868527,27
3,802,13345,3575868500,3575868536,36
3,802,13346,3575868500,3575868536,36
3,802,13347,3575868500,3575868543,43
3,802,13348,3575868500,3575868543,43
3,802,13349,3575868500,3575868544,44
3,802,13350,3575868500,3575868544,44
3,802,13351,3575868500,3575868549,49
3,803,13352,3575868559,3575868559,0
3,803,13353,3575868559,3575868559,0
3,803,13354,3575868559,3575868559,0
3,803,13355,3575868559,3575868559,0
3,803,13356,3575868559,3575868560,1
3,803,13357,3575868559,3575868560,1
3,803,13358,3575868559,3575868562,3
3,803,13359,3575868559,3575868565,6
3,803,13360,3575868559,3575868569,10
3,803,13361,3575868559,3575868569,10
3,803,13362,3575868559,3575868569,10
3,803,13363,3575868559,3575868570,11
3,803,13364,3575868559,3575868575,16
3,803,13365,3575868559,3575868576,17
3,803,13366,3575868559,3575868577,18
3,803,13367,3575868559,3575868577,18
3,803,13368,3575868559,3575868581,22
3,803,13369,3575868559,3575868583,24
3,803,13370,3575868559,3575868584,25
3,803,13371,3575868559,3575868586,27
3,803,13372,3575868559,3575868586,27
3,803,13373,3575868559,3575868586,27
3,803,13374,3575868559,3575868589,30
3,803,13375,3575868559,3575868590,31
3,803,13376,3575868559,3575868590,31
3,803,13377,3575868559,3575868592,33
3,803,13378,3575868559,3575868593,34
3,803,13379,3575868559,3575868593,34
3,803,13380,3575868559,3575868593,34
3,803,13381,3575868559,3575868594,35
3,803,13382,3575868559,3575868595,36
3,803,13383,3575868559,3575868596,37
3,803,13384,3575868559,3575868596,37
3,803,13385,3575868559,3575868597,38
3,803,13386,3575868559,3575868597,38
3,803,13387,3575868559,3575868602,43
3,803,13388,3575868559,3575868603,44
3,803,13389,3575868559,3575868603,44
3,803,13390,3575868559,3575868606,47
3,803,13391,3575868559,3575868606,47
3,803,13392,3575868559,3575868607,48
3,804,13393,3575868616,3575868616,0
3,804,13394,3575868616,3575868616,0
3,804,13395,3575868616,3575868616,0
3,804,13396,3575868616,3575868616,0
3,804,13397,3575868616,3575868616,0
3,804,13398,3575868616,3575868616,0
3,804,13399,3575868616,3575868617,1
3,804,13400,3575868616,3575868619,3
3,804,13401,3575868616,3575868620,4
3,804,13402,3575868616,3575868620,4
3,804,13403,3575868616,3575868625,9
3,804,13404,3575868616,3575868626,10
3,804,13405,3575868616,3575868628,12
3,804,13406,3575868616,3575868629,13
3,804,13407,3575868616,3575868629,13
3,804,13408,3575868616,3575868630,14
3,804,13409,3575868616,3575868631,15
3,804,13410,3575868616,3575868633,17
3,804,13411,3575868616,3575868634,18
3,804,13412,3575868616,3575868634,18
3,804,13413,3575868616,3575868635,19
3,804,13414,3575868616,3575868636,20
3,804,13415,3575868616,3575868638,22
3,804,13416,3575868616,3575868639,23
3,804,13417,3575868616,3575868641,25
3,804,13418,3575868616,3575868641,25
3,804,13419,3575868616,3575868642,26
3,804,13420,3575868616,3575868642,26
3,804,13421,3575868616,3575868643,27
3,804,13422,3575868616,3575868644,28
3,804,13423,3575868616,3575868645,29
3,804,13424,3575868616,3575868646,30
3,804,13425,3575868616,3575868647,31
3,804,13426,3575868616,3575868649,33
3,804,13427,3575868616,3575868651,35
3,804,13428,3575868616,3575868652,36
3,804,13429,3575868616,3575868653,37
3,804,13430,3575868616,3575868653,37
3,804,13431,3575868616,3575868655,39
3,804,13432,3575868616,3575868656,40
3,804,13433,3575868616,3575868657,41
3,804,13434,3575868616,3575868658,42
3,804,13435,3575868616,3575868658,42
3,804,13436,3575868616,3575868659,43
3,804,13437,3575868616,3575868662,46
3,804,13438,3575868616,3575868662,46
3,804,13439,3575868616,3575868664,48
3,804,13440,3575868616,3575868665,49
3,805,13441,3575868675,3575868675,0
3,805,13442,3575868675,3575868675,0
3,805,13443,3575868675,3575868675,0
3,805,13444,3575868675,3575868675,0
3,805,13445,3575868675,3575868675,0
3,805,13446,3575868675,3575868675,0
3,805,13447,3575868675,3575868681,6
3,805,13448,3575868675,3575868682,7
3,805,13449,3575868675,3575868683,8
3,805,13450,3575868675,3575868684,9
3,805,13451,3575868675,3575868685,10
3,805,13452,3575868675,3575868685,10
3,805,13453,3575868675,3575868691,16
3,805,13454,3575868675,3575868691,16
3,805,13455,3575868675,3575868695,20
3,805,13456,3575868675,3575868696,21
3,805,13457,3575868675,3575868697,22
3,805,13458,3575868675,3575868698,23
3,805,13459,3575868675,3575868699,24
3,805,13460,3575868675,3575868701,26
3,805,13461,3575868675,3575868701,26
3,805,13462,3575868675,3575868703,28
3,805,13463,3575868675,3575868707,32
3,805,13464,3575868675,3575868711,36
3,805,13465,3575868675,3575868711,36
3,805,13466,3575868675,3575868713,38
3,805,13467,3575868675,3575868717,42
3,805,13468,3575868675,3575868718,43
3,805,13469,3575868675,3575868719,44
3,805,13470,3575868675,3575868721,46
3,805,13471,3575868675,3575868723,48
3,805,13472,3575868675,3575868723,48
3,805,13473,3575868675,3575868723,48
3,805,13474,3575868675,3575868724,49
3,806,13475,3575868732,3575868732,0
3,806,13476,3575868732,3575868732,0
3,806,13477,3575868732,3575868732,0
3,806,13478,3575868732,3575868734,2
3,806,13479,3575868732,3575868737,5
3,806,13480,3575868732,3575868737,5
3,806,13481,3575868732,3575868743,11
3,806,13482,3575868732,3575868744,12
3,806,13483,3575868732,3575868745,13
3,806,13484,3575868732,3575868749,17
3,806,13485,3575868732,3575868751,19
3,806,13486,3575868732,3575868751,19
3,806,13487,3575868732,3575868753,21
3,806,13488,3575868732,3575868755,23
3,806,13489,3575868732,3575868756,24
3,806,13490,3575868732,3575868758,26
3,806,13491,3575868732,3575868759,27
3,806,13492,3575868732,3575868760,28
3,806,13493,3575868732,3575868763,31
3,806,13494,3575868732,3575868765,33
3,806,13495,3575868732,3575868769,37
3,806,13496,3575868732,3575868770,38
3,806,13497,3575868732,3575868770,38
3,806,13498,3575868732,3575868775,43
3,806,13499,3575868732,3575868776,44
3,806,13500,3575868732,3575868777,45
3,806,13501,3575868732,3575868778,46
3,806,13502,3575868732,3575868781,49
3,807,13503,3575868790,3575868790,0
3,807,13504,3575868790,3575868790,0
3,807,13505,3575868790,3575868790,0
3,807,13506,3575868790,3575868790,0
3,807,13507,3575868790,3575868790,0
3,807,13508,3575868790,3575868790,0
3,807,13509,3575868790,3575868790,0
3,807,13510,3575868790,3575868790,0
3,807,13511,3575868790,3575868790,0
3,807,13512,3575868790,3575868791,1
3,807,13513,3575868790,3575868792,2
3,807,13514,3575868790,3575868793,3
3,807,13515,3575868790,3575868793,3
3,807,13516,3575868790,3575868794,4
3,807,13517,3575868790,3575868794,4
3,807,13518,3575868790,3575868795,5
3,807,13519,3575868790,3575868796,6
3,807,13520,3575868790,3575868796,6
3,807,13521,3575868790,3575868797,7
3,807,13522,3575868790,3575868798,8
3,807,13523,3575868790,3575868798,8
3,807,13524,3575868790,3575868803,13
3,807,13525,3575868790,3575868803,13
3,807,13526,3575868790,3575868804,14
3,807,13527,3575868790,3575868806,16
3,807,13528,3575868790,3575868806,16
3,807,13529,3575868790,3575868812,22
3,807,13530,3575868790,3575868815,25
3,807,13531,3575868790,3575868815,25
3,807,13532,3575868790,3575868815,25
3,807,13533,3575868790,3575868815,25
3,807,13534,3575868790,3575868815,25
3,807,13535,3575868790,3575868816,26
3,807,13536,3575868790,3575868818,28
3,807,13537,3575868790,3575868820,30
3,807,13538,3575868790,3575868820,30
3,807,13539,3575868790,3575868821,31
3,807,13540,3575868790,3575868825,35
3,807,13541,3575868790,3575868826,36
3,807,13542,3575868790,3575868828,38
3,807,13543,3575868790,3575868830,40
3,807,13544,3575868790,3575868831,41
3,807,13545,3575868790,3575868831,41
3,807,13546,3575868790,3575868831,41
3,807,13547,3575868790,3575868833,43
3,807,13548,3575868790,3575868833,43
3,807,13549,3575868790,3575868834,44
3,807,13550,3575868790,3575868835,45
3,807,13551,3575868790,3575868836,46
3,807,13552,3575868790,3575868838,48
3,807,13553,3575868790,3575868840,50
3,808,13554,3575868847,3575868847,0
3,808,13555,3575868847,3575868847,0
3,808,13556,3575868847,3575868847,0
3,808,13557,3575868847,3575868847,0
3,808,13558,3575868847,3575868847,0
3,808,13559,3575868847,3575868847,0
3,808,13560,3575868847,3575868847,0
3,808,13561,3575868847,3575868847,0
3,808,13562,3575868847,3575868847,0
3,808,13563,3575868847,3575868847,0
3,808,13564,3575868847,3575868849,2
3,808,13565,3575868847,3575868851,4
3,808,13566,3575868847,3575868852,5
3,808,13567,3575868847,3575868854,7
3,808,13568,3575868847,3575868856,9
3,808,13569,3575868847,3575868857,10
3,808,13570,3575868847,3575868858,11
3,808,13571,3575868847,3575868859,12
3,808,13572,3575868847,3575868859,12
3,808,13573,3575868847,3575868860,13
3,808,13574,3575868847,3575868861,14
3,808,13575,3575868847,3575868862,15
3,808,13576,3575868847,3575868864,17
3,808,13577,3575868847,3575868865,18
3,808,13578,3575868847,3575868866,19
3,808,13579,3575868847,3575868866,19
3,808,13580,3575868847,3575868867,20
3,808,13581,3575868847,3575868868,21
3,808,13582,3575868847,3575868869,22
3,808,13583,3575868847,3575868872,25
3,808,13584,3575868847,3575868875,28
3,808,13585,3575868847,3575868878,31
3,808,13586,3575868847,3575868878,31
3,808,13587,3575868847,3575868878,31
3,808,13588,3575868847,3575868881,34
3,808,13589,3575868847,3575868882,35
3,808,13590,3575868847,3575868882,35
3,808,13591,3575868847,3575868883,36
3,808,13592,3575868847,3575868884,37
3,808,13593,3575868847,3575868885,38
3,808,13594,3575868847,3575868885,38
3,808,13595,3575868847,3575868891,44
3,808,13596,3575868847,3575868891,44
3,808,13597,3575868847,3575868896,49
3,808,13598,3575868847,3575868896,49
3,809,13599,3575868907,3575868907,0
3,809,13600,3575868907,3575868907,0
3,809,13601,3575868907,3575868907,0
3,809,13602,3575868907,3575868907,0
3,809,13603,3575868907,3575868907,0
3,809,13604,3575868907,3575868907,0
3,809,13605,3575868907,3575868907,0
3,809,13606,3575868907,3575868911,4
3,809,13607,3575868907,3575868912,5
3,809,13608,3575868907,3575868913,6
3,809,13609,3575868907,3575868917,10
3,809,13610,3575868907,3575868918,11
3,809,13611,3575868907,3575868919,12
3,809,13612,3575868907,3575868921,14
3,809,13613,3575868907,3575868923,16
3,809,13614,3575868907,3575868923,16
3,809,13615,3575868907,3575868924,17
3,809,13616,3575868907,3575868927,20
3,809,13617,3575868907,3575868927,20
3,809,13618,3575868907,3575868927,20
3,809,13619,3575868907,3575868934,27
3,809,13620,3575868907,3575868936,29
3,809,13621,3575868907,3575868937,30
3,809,13622,3575868907,3575868943,36
3,809,13623,3575868907,3575868944,37
3,809,13624,3575868907,3575868945,38
3,809,13625,3575868907,3575868949,42
3,809,13626,3575868907,3575868951,44
3,809,13627,3575868907,3575868951,44
3,809,13628,3575868907,3575868955,48
3,809,13629,3575868907,3575868956,49
3,809,13630,3575868907,3575868957,50
3,810,13631,3575868965,3575868965,0
3,810,13632,3575868965,3575868965,0
3,810,13633,3575868965,3575868965,0
3,810,13634,3575868965,3575868966,1
3,810,13635,3575868965,3575868969,4
3,810,13636,3575868965,3575868970,5
3,810,13637,3575868965,3575868970,5
3,810,13638,3575868965,3575868970,5
3,810,13639,3575868965,3575868971,6
3,810,13640,3575868965,3575868975,10
3,810,13641,3575868965,3575868976,11
3,810,13642,3575868965,3575868977,12
3,810,13643,3575868965,3575868978,13
3,810,13644,3575868965,3575868981,16
3,810,13645,3575868965,3575868983,18
3,810,13646,3575868965,3575868983,18
3,810,13647,3575868965,3575868984,19
3,810,13648,3575868965,3575868985,20
3,810,13649,3575868965,3575868986,21
3,810,13650,3575868965,3575868986,21
3,810,13651,3575868965,3575868988,23
3,810,13652,3575868965,3575868989,24
3,810,13653,3575868965,3575868989,24
3,810,13654,3575868965,3575868992,27
3,810,13655,3575868965,3575868993,28
3,810,13656,3575868965,3575868993,28
3,810,13657,3575868965,3575868994,29
3,810,13658,3575868965,3575868994,29
3,810,13659,3575868965,3575868995,30
3,810,13660,3575868965,3575868996,31
3,810,13661,3575868965,3575868996,31
3,810,13662,3575868965,3575868996,31
3,810,13663,3575868965,3575868997,32
3,810,13664,3575868965,3575868997,32
3,810,13665,3575868965,3575868999,34
3,810,13666,3575868965,3575869003,38
3,810,13667,3575868965,3575869003,38
3,810,13668,3575868965,3575869004,39
3,810,13669,3575868965,3575869006,41
3,810,13670,3575868965,3575869006,41
3,810,13671,3575868965,3575869012,47
3,810,13672,3575868965,3575869015,50
3,811,13673,3575869025,3575869025,0
3,811,13674,3575869025,3575869025,0
3,811,13675,3575869025,3575869025,0
3,811,13676,3575869025,3575869025,0
3,811,13677,3575869025,3575869025,0
3,811,13678,3575869025,3575869025,0
3,811,13679,3575869025,3575869025,0
3,811,13680,3575869025,3575869025,0
3,811,13681,3575869025,3575869025,0
3,811,13682,3575869025,3575869025,0
3,811,13683,3575869025,3575869026,1
3,811,13684,3575869025,3575869029,4
3,811,13685,3575869025,3575869031,6
3,811,13686,3575869025,3575869031,6
3,811,13687,3575869025,3575869031,6
3,811,13688,3575869025,3575869031,6
3,811,13689,3575869025,3575869033,8
3,811,13690,3575869025,3575869034,9
3,811,13691,3575869025,3575869034,9
3,811,13692,3575869025,3575869037,12
3,811,13693,3575869025,3575869038,13
3,811,13694,3575869025,3575869040,15
3,811,13695,3575869025,3575869041,16
3,811,13696,3575869025,3575869042,17
3,811,13697,3575869025,3575869042,17
3,811,13698,3575869025,3575869044,19
3,811,13699,3575869025,3575869044,19
3,811,13700,3575869025,3575869045,20
3,811,13701,3575869025,3575869046,21
3,811,13702,3575869025,3575869047,22
3,811,13703,3575869025,3575869051,26
3,811,13704,3575869025,3575869052,27
3,811,13705,3575869025,3575869052,27
3,811,13706,3575869025,3575869053,28
3,811,13707,3575869025,3575869054,29
3,811,13708,3575869025,3575869057,32
3,811,13709,3575869025,3575869057,32
3,811,13710,3575869025,3575869058,33
3,811,13711,3575869025,3575869059,34
3,811,13712,3575869025,3575869059,34
3,811,13713,3575869025,3575869060,35
3,811,13714,3575869025,3575869063,38
3,811,13715,3575869025,3575869063,38
3,811,13716,3575869025,3575869064,39
3,811,13717,3575869025,3575869065,40
3,811,13718,3575869025,3575869065,40
3,811,13719,3575869025,3575869066,41
3,811,13720,3575869025,3575869067,42
3,811,13721,3575869025,3575869068,43
3,811,13722,3575869025,3575869069,44
3,811,13723,3575869025,3575869072,47
3,811,13724,3575869025,3575869075,50
3,812,13725,3575869084,3575869084,0
3,812,13726,3575869084,3575869084,0
3,812,13727,3575869084,3575869084,0
3,812,13728,3575869084,3575869084,0
3,812,13729,3575869084,3575869084,0
3,812,13730,3575869084,3575869084,0
3,812,13731,3575869084,3575869085,1
3,812,13732,3575869084,3575869085,1
3,812,13733,3575869084,3575869085,1
3,812,13734,3575869084,3575869091,7
3,812,13735,3575869084,3575869093,9
3,812,13736,3575869084,3575869096,12
3,812,13737,3575869084,3575869096,12
3,812,13738,3575869084,3575869097,13
3,812,13739,3575869084,3575869097,13
3,812,13740,3575869084,3575869098,14
3,812,13741,3575869084,3575869099,15
3,812,13742,3575869084,3575869100,16
3,812,13743,3575869084,3575869101,17
3,812,13744,3575869084,3575869104,20
3,812,13745,3575869084,3575869107,23
3,812,13746,3575869084,3575869111,27
3,812,13747,3575869084,3575869112,28
3,812,13748,3575869084,3575869113,29
3,812,13749,3575869084,3575869117,33
3,812,13750,3575869084,3575869118,34
3,812,13751,3575869084,3575869119,35
3,812,13752,3575869084,3575869121,37
3,812,13753,3575869084,3575869122,38
3,812,13754,3575869084,3575869123,39
3,812,13755,3575869084,3575869123,39
3,812,13756,3575869084,3575869124,40
3,812,13757,3575869084,3575869127,43
3,812,13758,3575869084,3575869127,43
3,812,13759,3575869084,3575869127,43
3,812,13760,3575869084,3575869128,44
3,813,13761,3575869141,3575869141,0
3,813,13762,3575869141,3575869141,0
3,813,13763,3575869141,3575869141,0
3,813,13764,3575869141,3575869143,2
3,813,13765,3575869141,3575869144,3
3,813,13766,3575869141,3575869144,3
3,813,13767,3575869141,3575869149,8
3,813,13768,3575869141,3575869151,10
3,813,13769,3575869141,3575869151,10
3,813,13770,3575869141,3575869154,13
3,813,13771,3575869141,3575869155,14
3,813,13772,3575869141,3575869156,15
3,813,13773,3575869141,3575869157,16
3,813,13774,3575869141,3575869159,18
3,813,13775,3575869141,3575869162,21
3,813,13776,3575869141,3575869166,25
3,813,13777,3575869141,3575869169,28
3,813,13778,3575869141,3575869169,28
3,813,13779,3575869141,3575869170,29
3,813,13780,3575869141,3575869170,29
3,813,13781,3575869141,3575869171,30
3,813,13782,3575869141,3575869175,34
3,813,13783,3575869141,3575869176,35
3,813,13784,3575869141,3575869176,35
3,813,13785,3575869141,3575869177,36
3,813,13786,3575869141,3575869181,40
3,813,13787,3575869141,3575869183,42
3,813,13788,3575869141,3575869184,43
3,813,13789,3575869141,3575869186,45
3,813,13790,3575869141,3575869186,45
3,813,13791,3575869141,3575869187,46
3,813,13792,3575869141,3575869187,46
3,813,13793,3575869141,3575869189,48
3,813,13794,3575869141,3575869190,49
3,814,13795,3575869200,3575869200,0
3,814,13796,3575869200,3575869200,0
3,814,13797,3575869200,3575869200,0
3,814,13798,3575869200,3575869200,0
3,814,13799,3575869200,3575869200,0
3,814,13800,3575869200,3575869200,0
3,814,13801,3575869200,3575869200,0
3,814,13802,3575869200,3575869200,0
3,814,13803,3575869200,3575869200,0
3,814,13804,3575869200,3575869200,0
3,814,13805,3575869200,3575869201,1
3,814,13806,3575869200,3575869202,2
3,814,13807,3575869200,3575869203,3
3,814,13808,3575869200,3575869204,4
3,814,13809,3575869200,3575869206,6
3,814,13810,3575869200,3575869206,6
3,814,13811,3575869200,3575869212,12
3,814,13812,3575869200,3575869215,15
3,814,13813,3575869200,3575869215,15
3,814,13814,3575869200,3575869216,16
3,814,13815,3575869200,3575869217,17
3,814,13816,3575869200,3575869217,17
3,814,13817,3575869200,3575869218,18
3,814,13818,3575869200,3575869219,19
3,814,13819,3575869200,3575869219,19
3,814,13820,3575869200,3575869219,19
3,814,13821,3575869200,3575869222,22
3,814,13822,3575869200,3575869224,24
3,814,13823,3575869200,3575869226,26
3,814,13824,3575869200,3575869227,27
3,814,13825,3575869200,3575869229,29
3,814,13826,3575869200,3575869231,31
3,814,13827,3575869200,3575869231,31
3,814,13828,3575869200,3575869232,32
3,814,13829,3575869200,3575869232,32
3,814,13830,3575869200,3575869232,32
3,814,13831,3575869200,3575869234,34
3,814,13832,3575869200,3575869234,34
3,814,13833,3575869200,3575869235,35
3,814,13834,3575869200,3575869236,36
3,814,13835,3575869200,3575869237,37
3,814,13836,3575869200,3575869238,38
3,814,13837,3575869200,3575869241,41
3,814,13838,3575869200,3575869241,41
3,814,13839,3575869200,3575869242,42
3,814,13840,3575869200,3575869242,42
3,814,13841,3575869200,3575869244,44
3,814,13842,3575869200,3575869245,45
3,814,13843,3575869200,3575869246,46
3,814,13844,3575869200,3575869246,46
3,814,13845,3575869200,3575869246,46
3,814,13846,3575869200,3575869248,48
3,815,13847,3575869259,3575869259,0
3,815,13848,3575869259,3575869259,0
3,815,13849,3575869259,3575869259,0
3,815,13850,3575869259,3575869259,0
3,815,13851,3575869259,3575869259,0
3,815,13852,3575869259,3575869259,0
3,815,13853,3575869259,3575869259,0
3,815,13854,3575869259,3575869259,0
3,815,13855,3575869259,3575869259,0
3,815,13856,3575869259,3575869261,2
3,815,13857,3575869259,3575869263,4
3,815,13858,3575869259,3575869263,4
3,815,13859,3575869259,3575869264,5
3,815,13860,3575869259,3575869264,5
3,815,13861,3575869259,3575869266,7
3,815,13862,3575869259,3575869267,8
3,815,13863,3575869259,3575869267,8
3,815,13864,3575869259,3575869268,9
3,815,13865,3575869259,3575869268,9
3,815,13866,3575869259,3575869273,14
3,815,13867,3575869259,3575869275,16
3,815,13868,3575869259,3575869278,19
3,815,13869,3575869259,3575869278,19
3,815,13870,3575869259,3575869278,19
3,815,13871,3575869259,3575869280,21
3,815,13872,3575869259,3575869282,23
3,815,13873,3575869259,3575869283,24
3,815,13874,3575869259,3575869283,24
3,815,13875,3575869259,3575869284,25
3,815,13876,3575869259,3575869285,26
3,815,13877,3575869259,3575869285,26
3,815,13878,3575869259,3575869285,26
3,815,13879,3575869259,3575869291,32
3,815,13880,3575869259,3575869294,35
3,815,13881,3575869259,3575869296,37
3,815,13882,3575869259,3575869296,37
3,815,13883,3575869259,3575869297,38
3,815,13884,3575869259,3575869298,39
3,815,13885,3575869259,3575869298,39
3,815,13886,3575869259,3575869299,40
3,815,13887,3575869259,3575869301,42
3,815,13888,3575869259,3575869301,42
3,815,13889,3575869259,3575869303,44
3,815,13890,3575869259,3575869307,48
3,816,13891,3575869317,3575869317,0
3,816,13892,3575869317,3575869317,0
3,816,13893,3575869317,3575869317,0
3,816,13894,3575869317,3575869319,2
3,816,13895,3575869317,3575869319,2
3,816,13896,3575869317,3575869322,5
3,816,13897,3575869317,3575869322,5
3,816,13898,3575869317,3575869323,6
3,816,13899,3575869317,3575869323,6
3,816,13900,3575869317,3575869324,7
3,816,13901,3575869317,3575869327,10
3,816,13902,3575869317,3575869327,10
3,816,13903,3575869317,3575869327,10
3,816,13904,3575869317,3575869328,11
3,816,13905,3575869317,3575869334,17
3,816,13906,3575869317,3575869337,20
3,816,13907,3575869317,3575869338,21
3,816,13908,3575869317,3575869344,27
3,816,13909,3575869317,3575869344,27
3,816,13910,3575869317,3575869344,27
3,816,13911,3575869317,3575869344,27
3,816,13912,3575869317,3575869350,33
3,816,13913,3575869317,3575869351,34
3,816,13914,3575869317,3575869352,35
3,816,13915,3575869317,3575869355,38
3,816,13916,3575869317,3575869357,40
3,816,13917,3575869317,3575869358,41
3,816,13918,3575869317,3575869360,43
3,816,13919,3575869317,3575869363,46
3,816,13920,3575869317,3575869366,49
3,817,13921,3575869376,3575869376,0
3,817,13922,3575869376,3575869376,0
3,817,13923,3575869376,3575869376,0
3,817,13924,3575869376,3575869376,0
3,817,13925,3575869376,3575869376,0
3,817,13926,3575869376,3575869376,0
3,817,13927,3575869376,3575869376,0
3,817,13928,3575869376,3575869377,1
3,817,13929,3575869376,3575869378,2
3,817,13930,3575869376,3575869378,2
3,817,13931,3575869376,3575869381,5
3,817,13932,3575869376,3575869383,7
3,817,13933,3575869376,3575869384,8
3,817,13934,3575869376,3575869387,11
3,817,13935,3575869376,3575869387,11
3,817,13936,3575869376,3575869387,11
3,817,13937,3575869376,3575869389,13
3,817,13938,3575869376,3575869389,13
3,817,13939,3575869376,3575869392,16
3,817,13940,3575869376,3575869393,17
3,817,13941,3575869376,3575869394,18
3,817,13942,3575869376,3575869394,18
3,817,13943,3575869376,3575869395,19
3,817,13944,3575869376,3575869396,20
3,817,13945,3575869376,3575869396,20
3,817,13946,3575869376,3575869396,20
3,817,13947,3575869376,3575869397,21
3,817,13948,3575869376,3575869397,21
3,817,13949,3575869376,3575869402,26
3,817,13950,3575869376,3575869403,27
3,817,13951,3575869376,3575869403,27
3,817,13952,3575869376,3575869404,28
3,817,13953,3575869376,3575869405,29
3,817,13954,3575869376,3575869406,30
3,817,13955,3575869376,3575869406,30
3,817,13956,3575869376,3575869408,32
3,817,13957,3575869376,3575869413,37
3,817,13958,3575869376,3575869415,39
3,817,13959,3575869376,3575869416,40
3,817,13960,3575869376,3575869417,41
3,817,13961,3575869376,3575869417,41
3,817,13962,3575869376,3575869417,41
3,817,13963,3575869376,3575869417,41
3,817,13964,3575869376,3575869418,42
3,817,13965,3575869376,3575869419,43
3,817,13966,3575869376,3575869420,44
3,817,13967,3575869376,3575869422,46
3,817,13968,3575869376,3575869424,48
3,818,13969,3575869435,3575869435,0
3,818,13970,3575869435,3575869435,0
3,818,13971,3575869435,3575869435,0
3,818,13972,3575869435,3575869435,0
3,818,13973,3575869435,3575869435,0
3,818,13974,3575869435,3575869435,0
3,818,13975,3575869435,3575869435,0
3,818,13976,3575869435,3575869435,0
3,818,13977,3575869435,3575869435,0
3,818,13978,3575869435,3575869435,0
3,818,13979,3575869435,3575869437,2
3,818,13980,3575869435,3575869437,2
3,818,13981,3575869435,3575869440,5
3,818,13982,3575869435,3575869441,6
3,818,13983,3575869435,3575869442,7
3,818,13984,3575869435,3575869442,7
3,818,13985,3575869435,3575869443,8
3,818,13986,3575869435,3575869444,9
3,818,13987,3575869435,3575869445,10
3,818,13988,3575869435,3575869445,10
3,818,13989,3575869435,3575869446,11
3,818,13990,3575869435,3575869446,11
3,818,13991,3575869435,3575869448,13
3,818,13992,3575869435,3575869451,16
3,818,13993,3575869435,3575869453,18
3,818,13994,3575869435,3575869453,18
3,818,13995,3575869435,3575869454,19
3,818,13996,3575869435,3575869455,20
3,818,13997,3575869435,3575869457,22
3,818,13998,3575869435,3575869458,23
3,818,13999,3575869435,3575869458,23
3,818,14000,3575869435,3575869459,24
3,818,14001,3575869435,3575869460,25
3,818,14002,3575869435,3575869461,26
3,818,14003,3575869435,3575869463,28
3,818,14004,3575869435,3575869463,28
3,818,14005,3575869435,3575869464,29
3,818,14006,3575869435,3575869464,29
3,818,14007,3575869435,3575869466,31
3,818,14008,3575869435,3575869467,32
3,818,14009,3575869435,3575869467,32
3,818,14010,3575869435,3575869468,33
3,818,14011,3575869435,3575869475,40
3,818,14012,3575869435,3575869479,44
3,818,14013,3575869435,3575869480,45
3,818,14014,3575869435,3575869481,46
3,818,14015,3575869435,3575869482,47
3,818,14016,3575869435,3575869483,48
3,818,14017,3575869435,3575869484,49
3,818,14018,3575869435,3575869484,49
3,818,14019,3575869435,3575869485,50
3,819,14020,3575869494,3575869494,0
3,819,14021,3575869494,3575869494,0
3,819,14022,3575869494,3575869494,0
3,819,14023,3575869494,3575869494,0
3,819,14024,3575869494,3575869494,0
3,819,14025,3575869494,3575869495,1
3,819,14026,3575869494,3575869496,2
3,819,14027,3575869494,3575869496,2
3,819,14028,3575869494,3575869496,2
3,819,14029,3575869494,3575869497,3
3,819,14030,3575869494,3575869498,4
3,819,14031,3575869494,3575869499,5
3,819,14032,3575869494,3575869499,5
3,819,14033,3575869494,3575869499,5
3,819,14034,3575869494,3575869503,9
3,819,14035,3575869494,3575869505,11
3,819,14036,3575869494,3575869507,13
3,819,14037,3575869494,3575869511,17
3,819,14038,3575869494,3575869512,18
3,819,14039,3575869494,3575869516,22
3,819,14040,3575869494,3575869518,24
3,819,14041,3575869494,3575869518,24
3,819,14042,3575869494,3575869520,26
3,819,14043,3575869494,3575869521,27
3,819,14044,3575869494,3575869522,28
3,819,14045,3575869494,3575869523,29
3,819,14046,3575869494,3575869523,29
3,819,14047,3575869494,3575869526,32
3,819,14048,3575869494,3575869526,32
3,819,14049,3575869494,3575869526,32
3,819,14050,3575869494,3575869528,34
3,819,14051,3575869494,3575869533,39
3,819,14052,3575869494,3575869536,42
3,819,14053,3575869494,3575869537,43
3,819,14054,3575869494,3575869543,49
3,819,14055,3575869494,3575869543,49
3,819,14056,3575869494,3575869543,49
3,819,14057,3575869494,3575869544,50
3,820,14058,3575869551,3575869551,0
3,820,14059,3575869551,3575869551,0
3,820,14060,3575869551,3575869551,0
3,820,14061,3575869551,3575869553,2
3,820,14062,3575869551,3575869554,3
3,820,14063,3575869551,3575869556,5
3,820,14064,3575869551,3575869557,6
3,820,14065,3575869551,3575869559,8
3,820,14066,3575869551,3575869563,12
3,820,14067,3575869551,3575869566,15
3,820,14068,3575869551,3575869568,17
3,820,14069,3575869551,3575869569,18
3,820,14070,3575869551,3575869570,19
3,820,14071,3575869551,3575869570,19
3,820,14072,3575869551,3575869575,24
3,820,14073,3575869551,3575869575,24
3,820,14074,3575869551,3575869575,24
3,820,14075,3575869551,3575869576,25
3,820,14076,3575869551,3575869577,26
3,820,14077,3575869551,3575869581,30
3,820,14078,3575869551,3575869583,32
3,820,14079,3575869551,3575869586,35
3,820,14080,3575869551,3575869587,36
3,820,14081,3575869551,3575869587,36
3,820,14082,3575869551,3575869587,36
3,820,14083,3575869551,3575869589,38
3,820,14084,3575869551,3575869592,41
3,820,14085,3575869551,3575869592,41
3,820,14086,3575869551,3575869593,42
3,820,14087,3575869551,3575869593,42
3,820,14088,3575869551,3575869594,43
3,820,14089,3575869551,3575869595,44
3,820,14090,3575869551,3575869595,44
3,820,14091,3575869551,3575869596,45
3,820,14092,3575869551,3575869596,45
3,820,14093,3575869551,3575869597,46
3,820,14094,3575869551,3575869597,46
3,820,14095,3575869551,3575869601,50
3,821,14096,3575869608,3575869608,0
3,821,14097,3575869608,3575869608,0
3,821,14098,3575869608,3575869608,0
3,821,14099,3575869608,3575869608,0
3,821,14100,3575869608,3575869608,0
3,821,14101,3575869608,3575869608,0
3,821,14102,3575869608,3575869612,4
3,821,14103,3575869608,3575869614,6
3,821,14104,3575869608,3575869615,7
3,821,14105,3575869608,3575869615,7
3,821,14106,3575869608,3575869616,8
3,821,14107,3575869608,3575869617,9
3,821,14108,3575869608,3575869617,9
3,821,14109,3575869608,3575869618,10
3,821,14110,3575869608,3575869618,10
3,821,14111,3575869608,3575869619,11
3,821,14112,3575869608,3575869621,13
3,821,14113,3575869608,3575869625,17
3,821,14114,3575869608,3575869625,17
3,821,14115,3575869608,3575869627,19
3,821,14116,3575869608,3575869631,23
3,821,14117,3575869608,3575869631,23
3,821,14118,3575869608,3575869631,23
3,821,14119,3575869608,3575869632,24
3,821,14120,3575869608,3575869633,25
3,821,14121,3575869608,3575869633,25
3,821,14122,3575869608,3575869634,26
3,821,14123,3575869608,3575869634,26
3,821,14124,3575869608,3575869635,27
3,821,14125,3575869608,3575869636,28
3,821,14126,3575869608,3575869638,30
3,821,14127,3575869608,3575869639,31
3,821,14128,3575869608,3575869639,31
3,821,14129,3575869608,3575869641,33
3,821,14130,3575869608,3575869642,34
3,821,14131,3575869608,3575869643,35
3,821,14132,3575869608,3575869643,35
3,821,14133,3575869608,3575869644,36
3,821,14134,3575869608,3575869645,37
3,821,14135,3575869608,3575869645,37
3,821,14136,3575869608,3575869646,38
3,821,14137,3575869608,3575869648,40
3,821,14138,3575869608,3575869650,42
3,821,14139,3575869608,3575869652,44
3,821,14140,3575869608,3575869653,45
3,821,14141,3575869608,3575869654,46
3,821,14142,3575869608,3575869656,48
3,821,14143,3575869608,3575869657,49
3,821,14144,3575869608,3575869657,49
3,821,14145,3575869608,3575869657,49
3,822,14146,3575869666,3575869666,0
3,822,14147,3575869666,3575869666,0
3,822,14148,3575869666,3575869666,0
3,822,14149,3575869666,3575869666,0
3,822,14150,3575869666,3575869666,0
3,822,14151,3575869666,3575869666,0
3,822,14152,3575869666,3575869666,0
3,822,14153,3575869666,3575869666,0
3,822,14154,3575869666,3575869666,0
3,822,14155,3575869666,3575869667,1
3,822,14156,3575869666,3575869669,3
3,822,14157,3575869666,3575869672,6
3,822,14158,3575869666,3575869675,9
3,822,14159,3575869666,3575869678,12
3,822,14160,3575869666,3575869678,12
3,822,14161,3575869666,3575869678,12
3,822,14162,3575869666,3575869680,14
3,822,14163,3575869666,3575869682,16
3,822,14164,3575869666,3575869682,16
3,822,14165,3575869666,3575869683,17
3,822,14166,3575869666,3575869684,18
3,822,14167,3575869666,3575869684,18
3,822,14168,3575869666,3575869685,19
3,822,14169,3575869666,3575869686,20
3,822,14170,3575869666,3575869686,20
3,822,14171,3575869666,3575869692,26
3,822,14172,3575869666,3575869692,26
3,822,14173,3575869666,3575869694,28
3,822,14174,3575869666,3575869694,28
3,822,14175,3575869666,3575869695,29
3,822,14176,3575869666,3575869696,30
3,822,14177,3575869666,3575869696,30
3,822,14178,3575869666,3575869698,32
3,822,14179,3575869666,3575869698,32
3,822,14180,3575869666,3575869699,33
3,822,14181,3575869666,3575869700,34
3,822,14182,3575869666,3575869700,34
3,822,14183,3575869666,3575869703,37
3,822,14184,3575869666,3575869705,39
3,822,14185,3575869666,3575869707,41
3,822,14186,3575869666,3575869710,44
3,822,14187,3575869666,3575869711,45
3,822,14188,3575869666,3575869712,46
3,822,14189,3575869666,3575869716,50
3,823,14190,3575869726,3575869726,0
3,823,14191,3575869726,3575869726,0
3,823,14192,3575869726,3575869726,0
3,823,14193,3575869726,3575869726,0
3,823,14194,3575869726,3575869726,0
3,823,14195,3575869726,3575869726,0
3,823,14196,3575869726,3575869726,0
3,823,14197,3575869726,3575869726,0
3,823,14198,3575869726,3575869726,0
3,823,14199,3575869726,3575869726,0
3,823,14200,3575869726,3575869727,1
3,823,14201,3575869726,3575869727,1
3,823,14202,3575869726,3575869732,6
3,823,14203,3575869726,3575869736,10
3,823,14204,3575869726,3575869737,11
3,823,14205,3575869726,3575869742,16
3,823,14206,3575869726,3575869742,16
3,823,14207,3575869726,3575869743,17
3,823,14208,3575869726,3575869744,18
3,823,14209,3575869726,3575869749,23
3,823,14210,3575869726,3575869749,23
3,823,14211,3575869726,3575869750,24
3,823,14212,3575869726,3575869755,29
3,823,14213,3575869726,3575869756,30
3,823,14214,3575869726,3575869758,32
3,823,14215,3575869726,3575869759,33
3,823,14216,3575869726,3575869761,35
3,823,14217,3575869726,3575869764,38
3,823,14218,3575869726,3575869766,40
3,823,14219,3575869726,3575869768,42
3,823,14220,3575869726,3575869769,43
3,823,14221,3575869726,3575869770,44
3,823,14222,3575869726,3575869771,45
3,823,14223,3575869726,3575869776,50
3,824,14224,3575869786,3575869786,0
3,824,14225,3575869786,3575869786,0
3,824,14226,3575869786,3575869786,0
3,824,14227,3575869786,3575869786,0
3,824,14228,3575869786,3575869786,0
3,824,14229,3575869786,3575869786,0
3,824,14230,3575869786,3575869786,0
3,824,14231,3575869786,3575869786,0
3,824,14232,3575869786,3575869786,0
3,824,14233,3575869786,3575869788,2
3,824,14234,3575869786,3575869789,3
3,824,14235,3575869786,3575869792,6
3,824,14236,3575869786,3575869792,6
3,824,14237,3575869786,3575869793,7
3,824,14238,3575869786,3575869793,7
3,824,14239,3575869786,3575869794,8
3,824,14240,3575869786,3575869795,9
3,824,14241,3575869786,3575869795,9
3,824,14242,3575869786,3575869795,9
3,824,14243,3575869786,3575869796,10
3,824,14244,3575869786,3575869797,11
3,824,14245,3575869786,3575869797,11
3,824,14246,3575869786,3575869801,15
3,824,14247,3575869786,3575869802,16
3,824,14248,3575869786,3575869803,17
3,824,14249,3575869786,3575869804,18
3,824,14250,3575869786,3575869805,19
3,824,14251,3575869786,3575869805,19
3,824,14252,3575869786,3575869811,25
3,824,14253,3575869786,3575869815,29
3,824,14254,3575869786,3575869815,29
3,824,14255,3575869786,3575869815,29
3,824,14256,3575869786,3575869816,30
3,824,14257,3575869786,3575869817,31
3,824,14258,3575869786,3575869818,32
3,824,14259,3575869786,3575869818,32
3,824,14260,3575869786,3575869819,33
3,824,14261,3575869786,3575869820,34
3,824,14262,3575869786,3575869825,39
3,824,14263,3575869786,3575869826,40
3,824,14264,3575869786,3575869829,43
3,824,14265,3575869786,3575869830,44
3,824,14266,3575869786,3575869831,45
3,824,14267,3575869786,3575869832,46
3,824,14268,3575869786,3575869832,46
3,824,14269,3575869786,3575869833,47
3,824,14270,3575869786,3575869834,48
3,824,14271,3575869786,3575869834,48
3,824,14272,3575869786,3575869835,49
3,825,14273,3575869844,3575869844,0
3,825,14274,3575869844,3575869844,0
3,825,14275,3575869844,3575869844,0
3,825,14276,3575869844,3575869844,0
3,825,14277,3575869844,3575869844,0
3,825,14278,3575869844,3575869844,0
3,825,14279,3575869844,3575869844,0
3,825,14280,3575869844,3575869844,0
3,825,14281,3575869844,3575869844,0
3,825,14282,3575869844,3575869845,1
3,825,14283,3575869844,3575869846,2
3,825,14284,3575869844,3575869850,6
3,825,14285,3575869844,3575869852,8
3,825,14286,3575869844,3575869853,9
3,825,14287,3575869844,3575869853,9
3,825,14288,3575869844,3575869855,11
3,825,14289,3575869844,3575869856,12
3,825,14290,3575869844,3575869857,13
3,825,14291,3575869844,3575869858,14
3,825,14292,3575869844,3575869858,14
3,825,14293,3575869844,3575869859,15
3,825,14294,3575869844,3575869862,18
3,825,14295,3575869844,3575869863,19
3,825,14296,3575869844,3575869863,19
3,825,14297,3575869844,3575869864,20
3,825,14298,3575869844,3575869864,20
3,825,14299,3575869844,3575869865,21
3,825,14300,3575869844,3575869866,22
3,825,14301,3575869844,3575869867,23
3,825,14302,3575869844,3575869867,23
3,825,14303,3575869844,3575869869,25
3,825,14304,3575869844,3575869872,28
3,825,14305,3575869844,3575869875,31
3,825,14306,3575869844,3575869878,34
3,825,14307,3575869844,3575869878,34
3,825,14308,3575869844,3575869882,38
3,825,14309,3575869844,3575869882,38
3,825,14310,3575869844,3575869883,39
3,825,14311,3575869844,3575869884,40
3,825,14312,3575869844,3575869886,42
3,825,14313,3575869844,3575869886,42
3,825,14314,3575869844,3575869892,48
3,825,14315,3575869844,3575869893,49
3,826,14316,3575869904,3575869904,0
3,826,14317,3575869904,3575869904,0
3,826,14318,3575869904,3575869904,0
3,826,14319,3575869904,3575869904,0
3,826,14320,3575869904,3575869904,0
3,826,14321,3575869904,3575869904,0
3,826,14322,3575869904,3575869904,0
3,826,14323,3575869904,3575869904,0
3,826,14324,3575869904,3575869904,0
3,826,14325,3575869904,3575869904,0
3,826,14326,3575869904,3575869906,2
3,826,14327,3575869904,3575869907,3
3,826,14328,3575869904,3575869911,7
3,826,14329,3575869904,3575869911,7
3,826,14330,3575869904,3575869912,8
3,826,14331,3575869904,3575869916,12
3,826,14332,3575869904,3575869917,13
3,826,14333,3575869904,3575869918,14
3,826,14334,3575869904,3575869919,15
3,826,14335,3575869904,3575869920,16
3,826,14336,3575869904,3575869921,17
3,826,14337,3575869904,3575869922,18
3,826,14338,3575869904,3575869922,18
3,826,14339,3575869904,3575869924,20
3,826,14340,3575869904,3575869926,22
3,826,14341,3575869904,3575869927,23
3,826,14342,3575869904,3575869927,23
3,826,14343,3575869904,3575869928,24
3,826,14344,3575869904,3575869933,29
3,826,14345,3575869904,3575869937,33
3,826,14346,3575869904,3575869938,34
3,826,14347,3575869904,3575869943,39
3,826,14348,3575869904,3575869943,39
3,826,14349,3575869904,3575869944,40
3,826,14350,3575869904,3575869950,46
3,826,14351,3575869904,3575869951,47
3,827,14352,3575869962,3575869962,0
3,827,14353,3575869962,3575869962,0
3,827,14354,3575869962,3575869962,0
3,827,14355,3575869962,3575869962,0
3,827,14356,3575869962,3575869964,2
3,827,14357,3575869962,3575869966,4
3,827,14358,3575869962,3575869968,6
3,827,14359,3575869962,3575869969,7
3,827,14360,3575869962,3575869969,7
3,827,14361,3575869962,3575869970,8
3,827,14362,3575869962,3575869970,8
3,827,14363,3575869962,3575869971,9
3,827,14364,3575869962,3575869975,13
3,827,14365,3575869962,3575869975,13
3,827,14366,3575869962,3575869976,14
3,827,14367,3575869962,3575869977,15
3,827,14368,3575869962,3575869978,16
3,827,14369,3575869962,3575869982,20
3,827,14370,3575869962,3575869982,20
3,827,14371,3575869962,3575869983,21
3,827,14372,3575869962,3575869986,24
3,827,14373,3575869962,3575869986,24
3,827,14374,3575869962,3575869986,24
3,827,14375,3575869962,3575869986,24
3,827,14376,3575869962,3575869987,25
3,827,14377,3575869962,3575869989,27
3,827,14378,3575869962,3575869992,30
3,827,14379,3575869962,3575869992,30
3,827,14380,3575869962,3575869993,31
3,827,14381,3575869962,3575869993,31
3,827,14382,3575869962,3575869995,33
3,827,14383,3575869962,3575869995,33
3,827,14384,3575869962,3575869996,34
3,827,14385,3575869962,3575869996,34
3,827,14386,3575869962,3575869997,35
3,827,14387,3575869962,3575869997,35
3,827,14388,3575869962,3575869997,35
3,827,14389,3575869962,3575870002,40
3,827,14390,3575869962,3575870002,40
3,827,14391,3575869962,3575870003,41
3,827,14392,3575869962,3575870004,42
3,827,14393,3575869962,3575870004,42
3,827,14394,3575869962,3575870005,43
3,827,14395,3575869962,3575870006,44
3,827,14396,3575869962,3575870011,49
3,828,14397,3575870020,3575870020,0
3,828,14398,3575870020,3575870020,0
3,828,14399,3575870020,3575870020,0
3,828,14400,3575870020,3575870020,0
3,828,14401,3575870020,3575870020,0
3,828,14402,3575870020,3575870020,0
3,828,14403,3575870020,3575870020,0
3,828,14404,3575870020,3575870020,0
3,828,14405,3575870020,3575870021,1
3,828,14406,3575870020,3575870021,1
3,828,14407,3575870020,3575870024,4
3,828,14408,3575870020,3575870025,5
3,828,14409,3575870020,3575870025,5
3,828,14410,3575870020,3575870028,8
3,828,14411,3575870020,3575870031,11
3,828,14412,3575870020,3575870032,12
3,828,14413,3575870020,3575870032,12
3,828,14414,3575870020,3575870033,13
3,828,14415,3575870020,3575870033,13
3,828,14416,3575870020,3575870035,15
3,828,14417,3575870020,3575870036,16
3,828,14418,3575870020,3575870037,17
3,828,14419,3575870020,3575870037,17
3,828,14420,3575870020,3575870040,20
3,828,14421,3575870020,3575870041,21
3,828,14422,3575870020,3575870042,22
3,828,14423,3575870020,3575870042,22
3,828,14424,3575870020,3575870043,23
3,828,14425,3575870020,3575870044,24
3,828,14426,3575870020,3575870044,24
3,828,14427,3575870020,3575870045,25
3,828,14428,3575870020,3575870046,26
3,828,14429,3575870020,3575870050,30
3,828,14430,3575870020,3575870052,32
3,828,14431,3575870020,3575870054,34
3,828,14432,3575870020,3575870055,35
3,828,14433,3575870020,3575870056,36
3,828,14434,3575870020,3575870057,37
3,828,14435,3575870020,3575870058,38
3,828,14436,3575870020,3575870058,38
3,828,14437,3575870020,3575870059,39
3,828,14438,3575870020,3575870063,43
3,828,14439,3575870020,3575870063,43
3,828,14440,3575870020,3575870063,43
3,828,14441,3575870020,3575870065,45
3,828,14442,3575870020,3575870065,45
3,828,14443,3575870020,3575870065,45
3,828,14444,3575870020,3575870066,46
3,828,14445,3575870020,3575870067,47
3,828,14446,3575870020,3575870067,47
3,828,14447,3575870020,3575870068,48
3,829,14448,3575870078,3575870078,0
3,829,14449,3575870078,3575870078,0
3,829,14450,3575870078,3575870078,0
3,829,14451,3575870078,3575870078,0
3,829,14452,3575870078,3575870080,2
3,829,14453,3575870078,3575870081,3
3,829,14454,3575870078,3575870081,3
3,829,14455,3575870078,3575870084,6
3,829,14456,3575870078,3575870084,6
3,829,14457,3575870078,3575870084,6
3,829,14458,3575870078,3575870086,8
3,829,14459,3575870078,3575870087,9
3,829,14460,3575870078,3575870093,15
3,829,14461,3575870078,3575870094,16
3,829,14462,3575870078,3575870095,17
3,829,14463,3575870078,3575870095,17
3,829,14464,3575870078,3575870096,18
3,829,14465,3575870078,3575870096,18
3,829,14466,3575870078,3575870096,18
3,829,14467,3575870078,3575870100,22
3,829,14468,3575870078,3575870100,22
3,829,14469,3575870078,3575870100,22
3,829,14470,3575870078,3575870104,26
3,829,14471,3575870078,3575870106,28
3,829,14472,3575870078,3575870111,33
3,829,14473,3575870078,3575870111,33
3,829,14474,3575870078,3575870113,35
3,829,14475,3575870078,3575870116,38
3,829,14476,3575870078,3575870118,40
3,829,14477,3575870078,3575870119,41
3,829,14478,3575870078,3575870119,41
3,829,14479,3575870078,3575870121,43
3,829,14480,3575870078,3575870122,44
3,829,14481,3575870078,3575870122,44
3,829,14482,3575870078,3575870122,44
3,829,14483,3575870078,3575870125,47
3,829,14484,3575870078,3575870126,48
3,829,14485,3575870078,3575870127,49
3,830,14486,3575870136,3575870136,0
3,830,14487,3575870136,3575870136,0
3,830,14488,3575870136,3575870137,1
3,830,14489,3575870136,3575870143,7
3,830,14490,3575870136,3575870143,7
3,830,14491,3575870136,3575870144,8
3,830,14492,3575870136,3575870151,15
3,830,14493,3575870136,3575870151,15
3,830,14494,3575870136,3575870154,18
3,830,14495,3575870136,3575870155,19
3,830,14496,3575870136,3575870158,22
3,830,14497,3575870136,3575870164,28
3,830,14498,3575870136,3575870166,30
3,830,14499,3575870136,3575870168,32
3,830,14500,3575870136,3575870169,33
3,830,14501,3575870136,3575870170,34
3,830,14502,3575870136,3575870170,34
3,830,14503,3575870136,3575870170,34
3,830,14504,3575870136,3575870171,35
3,830,14505,3575870136,3575870173,37
3,830,14506,3575870136,3575870174,38
3,830,14507,3575870136,3575870175,39
3,830,14508,3575870136,3575870176,40
3,830,14509,3575870136,3575870177,41
3,830,14510,3575870136,3575870178,42
3,830,14511,3575870136,3575870182,46
3,830,14512,3575870136,3575870183,47
3,830,14513,3575870136,3575870184,48
3,830,14514,3575870136,3575870186,50
3,831,14515,3575870198,3575870198,0
3,831,14516,3575870198,3575870198,0
3,831,14517,3575870198,3575870198,0
3,831,14518,3575870198,3575870198,0
3,831,14519,3575870198,3575870198,0
3,831,14520,3575870198,3575870198,0
3,831,14521,3575870198,3575870198,0
3,831,14522,3575870198,3575870198,0
3,831,14523,3575870198,3575870198,0
3,831,14524,3575870198,3575870198,0
3,831,14525,3575870198,3575870198,0
3,831,14526,3575870198,3575870198,0
3,831,14527,3575870198,3575870198,0
3,831,14528,3575870198,3575870198,0
3,831,14529,3575870198,3575870198,0
3,831,14530,3575870198,3575870198,0
3,831,14531,3575870198,3575870201,3
3,831,14532,3575870198,3575870202,4
3,831,14533,3575870198,3575870204,6
3,831,14534,3575870198,3575870204,6
3,831,14535,3575870198,3575870205,7
3,831,14536,3575870198,3575870205,7
3,831,14537,3575870198,3575870206,8
3,831,14538,3575870198,3575870207,9
3,831,14539,3575870198,3575870212,14
3,831,14540,3575870198,3575870215,17
3,831,14541,3575870198,3575870217,19
3,831,14542,3575870198,3575870217,19
3,831,14543,3575870198,3575870217,19
3,831,14544,3575870198,3575870218,20
3,831,14545,3575870198,3575870219,21
3,831,14546,3575870198,3575870219,21
3,831,14547,3575870198,3575870221,23
3,831,14548,3575870198,3575870221,23
3,831,14549,3575870198,3575870222,24
3,831,14550,3575870198,3575870223,25
3,831,14551,3575870198,3575870225,27
3,831,14552,3575870198,3575870226,28
3,831,14553,3575870198,3575870229,31
3,831,14554,3575870198,3575870231,33
3,831,14555,3575870198,3575870232,34
3,831,14556,3575870198,3575870232,34
3,831,14557,3575870198,3575870234,36
3,831,14558,3575870198,3575870234,36
3,831,14559,3575870198,3575870235,37
3,831,14560,3575870198,3575870236,38
3,831,14561,3575870198,3575870238,40
3,831,14562,3575870198,3575870238,40
3,831,14563,3575870198,3575870240,42
3,831,14564,3575870198,3575870242,44
3,831,14565,3575870198,3575870242,44
3,831,14566,3575870198,3575870242,44
3,831,14567,3575870198,3575870243,45
3,831,14568,3575870198,3575870244,46
3,831,14569,3575870198,3575870245,47
3,831,14570,3575870198,3575870245,47
3,831,14571,3575870198,3575870246,48
3,831,14572,3575870198,3575870247,49
3,831,14573,3575870198,3575870248,50
3,832,14574,3575870255,3575870255,0
3,832,14575,3575870255,3575870255,0
3,832,14576,3575870255,3575870255,0
3,832,14577,3575870255,3575870255,0
3,832,14578,3575870255,3575870256,1
3,832,14579,3575870255,3575870257,2
3,832,14580,3575870255,3575870258,3
3,832,14581,3575870255,3575870259,4
3,832,14582,3575870255,3575870260,5
3,832,14583,3575870255,3575870263,8
3,832,14584,3575870255,3575870263,8
3,832,14585,3575870255,3575870264,9
3,832,14586,3575870255,3575870264,9
3,832,14587,3575870255,3575870264,9
3,832,14588,3575870255,3575870264,9
3,832,14589,3575870255,3575870266,11
3,832,14590,3575870255,3575870267,12
3,832,14591,3575870255,3575870267,12
3,832,14592,3575870255,3575870269,14
3,832,14593,3575870255,3575870272,17
3,832,14594,3575870255,3575870276,21
3,832,14595,3575870255,3575870278,23
3,832,14596,3575870255,3575870278,23
3,832,14597,3575870255,3575870282,27
3,832,14598,3575870255,3575870282,27
3,832,14599,3575870255,3575870285,30
3,832,14600,3575870255,3575870285,30
3,832,14601,3575870255,3575870285,30
3,832,14602,3575870255,3575870287,32
3,832,14603,3575870255,3575870287,32
3,832,14604,3575870255,3575870294,39
3,832,14605,3575870255,3575870294,39
3,832,14606,3575870255,3575870296,41
3,832,14607,3575870255,3575870297,42
3,832,14608,3575870255,3575870297,42
3,832,14609,3575870255,3575870297,42
3,832,14610,3575870255,3575870298,43
3,832,14611,3575870255,3575870299,44
3,832,14612,3575870255,3575870300,45
3,832,14613,3575870255,3575870303,48
3,833,14614,3575870317,3575870317,0
3,833,14615,3575870317,3575870317,0
3,833,14616,3575870317,3575870317,0
3,833,14617,3575870317,3575870317,0
3,833,14618,3575870317,3575870317,0
3,833,14619,3575870317,3575870317,0
3,833,14620,3575870317,3575870318,1
3,833,14621,3575870317,3575870319,2
3,833,14622,3575870317,3575870319,2
3,833,14623,3575870317,3575870321,4
3,833,14624,3575870317,3575870321,4
3,833,14625,3575870317,3575870322,5
3,833,14626,3575870317,3575870322,5
3,833,14627,3575870317,3575870323,6
3,833,14628,3575870317,3575870325,8
3,833,14629,3575870317,3575870326,9
3,833,14630,3575870317,3575870327,10
3,833,14631,3575870317,3575870327,10
3,833,14632,3575870317,3575870328,11
3,833,14633,3575870317,3575870334,17
3,833,14634,3575870317,3575870337,20
3,833,14635,3575870317,3575870342,25
3,833,14636,3575870317,3575870343,26
3,833,14637,3575870317,3575870351,34
3,833,14638,3575870317,3575870351,34
3,833,14639,3575870317,3575870352,35
3,833,14640,3575870317,3575870354,37
3,833,14641,3575870317,3575870358,41
3,833,14642,3575870317,3575870363,46
3,833,14643,3575870317,3575870366,49
3,834,14644,3575870374,3575870374,0
3,834,14645,3575870374,3575870374,0
3,834,14646,3575870374,3575870375,1
3,834,14647,3575870374,3575870375,1
3,834,14648,3575870374,3575870375,1
3,834,14649,3575870374,3575870375,1
3,834,14650,3575870374,3575870376,2
3,834,14651,3575870374,3575870376,2
3,834,14652,3575870374,3575870376,2
3,834,14653,3575870374,3575870378,4
3,834,14654,3575870374,3575870382,8
3,834,14655,3575870374,3575870383,9
3,834,14656,3575870374,3575870385,11
3,834,14657,3575870374,3575870386,12
3,834,14658,3575870374,3575870387,13
3,834,14659,3575870374,3575870387,13
3,834,14660,3575870374,3575870388,14
3,834,14661,3575870374,3575870391,17
3,834,14662,3575870374,3575870392,18
3,834,14663,3575870374,3575870393,19
3,834,14664,3575870374,3575870393,19
3,834,14665,3575870374,3575870395,21
3,834,14666,3575870374,3575870396,22
3,834,14667,3575870374,3575870396,22
3,834,14668,3575870374,3575870396,22
3,834,14669,3575870374,3575870396,22
3,834,14670,3575870374,3575870397,23
3,834,14671,3575870374,3575870399,25
3,834,14672,3575870374,3575870401,27
3,834,14673,3575870374,3575870403,29
3,834,14674,3575870374,3575870405,31
3,834,14675,3575870374,3575870405,31
3,834,14676,3575870374,3575870405,31
3,834,14677,3575870374,3575870405,31
3,834,14678,3575870374,3575870406,32
3,834,14679,3575870374,3575870407,33
3,834,14680,3575870374,3575870411,37
3,834,14681,3575870374,3575870415,41
3,834,14682,3575870374,3575870417,43
3,834,14683,3575870374,3575870418,44
3,834,14684,3575870374,3575870418,44
3,834,14685,3575870374,3575870418,44
3,834,14686,3575870374,3575870419,45
3,834,14687,3575870374,3575870419,45
3,834,14688,3575870374,3575870421,47
3,834,14689,3575870374,3575870421,47
3,834,14690,3575870374,3575870423,49
3,835,14691,3575870434,3575870434,0
3,835,14692,3575870434,3575870434,0
3,835,14693,3575870434,3575870434,0
3,835,14694,3575870434,3575870434,0
3,835,14695,3575870434,3575870434,0
3,835,14696,3575870434,3575870434,0
3,835,14697,3575870434,3575870434,0
3,835,14698,3575870434,3575870434,0
3,835,14699,3575870434,3575870434,0
3,835,14700,3575870434,3575870436,2
3,835,14701,3575870434,3575870436,2
3,835,14702,3575870434,3575870437,3
3,835,14703,3575870434,3575870437,3
3,835,14704,3575870434,3575870440,6
3,835,14705,3575870434,3575870441,7
3,835,14706,3575870434,3575870442,8
3,835,14707,3575870434,3575870442,8
3,835,14708,3575870434,3575870443,9
3,835,14709,3575870434,3575870443,9
3,835,14710,3575870434,3575870444,10
3,835,14711,3575870434,3575870444,10
3,835,14712,3575870434,3575870446,12
3,835,14713,3575870434,3575870447,13
3,835,14714,3575870434,3575870448,14
3,835,14715,3575870434,3575870453,19
3,835,14716,3575870434,3575870453,19
3,835,14717,3575870434,3575870454,20
3,835,14718,3575870434,3575870456,22
3,835,14719,3575870434,3575870456,22
3,835,14720,3575870434,3575870458,24
3,835,14721,3575870434,3575870459,25
3,835,14722,3575870434,3575870459,25
3,835,14723,3575870434,3575870463,29
3,835,14724,3575870434,3575870463,29
3,835,14725,3575870434,3575870464,30
3,835,14726,3575870434,3575870464,30
3,835,14727,3575870434,3575870465,31
3,835,14728,3575870434,3575870466,32
3,835,14729,3575870434,3575870467,33
3,835,14730,3575870434,3575870468,34
3,835,14731,3575870434,3575870469,35
3,835,14732,3575870434,3575870473,39
3,835,14733,3575870434,3575870476,42
3,835,14734,3575870434,3575870478,44
3,835,14735,3575870434,3575870478,44
3,835,14736,3575870434,3575870479,45
3,835,14737,3575870434,3575870479,45
3,835,14738,3575870434,3575870480,46
3,835,14739,3575870434,3575870481,47
3,835,14740,3575870434,3575870482,48
3,835,14741,3575870434,3575870482,48
3,836,14742,3575870494,3575870494,0
3,836,14743,3575870494,3575870494,0
3,836,14744,3575870494,3575870494,0
3,836,14745,3575870494,3575870494,0
3,836,14746,3575870494,3575870494,0
3,836,14747,3575870494,3575870494,0
3,836,14748,3575870494,3575870494,0
3,836,14749,3575870494,3575870496,2
3,836,14750,3575870494,3575870496,2
3,836,14751,3575870494,3575870497,3
3,836,14752,3575870494,3575870497,3
3,836,14753,3575870494,3575870497,3
3,836,14754,3575870494,3575870499,5
3,836,14755,3575870494,3575870500,6
3,836,14756,3575870494,3575870500,6
3,836,14757,3575870494,3575870502,8
3,836,14758,3575870494,3575870506,12
3,836,14759,3575870494,3575870506,12
3,836,14760,3575870494,3575870511,17
3,836,14761,3575870494,3575870512,18
3,836,14762,3575870494,3575870516,22
3,836,14763,3575870494,3575870517,23
3,836,14764,3575870494,3575870518,24
3,836,14765,3575870494,3575870519,25
3,836,14766,3575870494,3575870520,26
3,836,14767,3575870494,3575870520,26
3,836,14768,3575870494,3575870521,27
3,836,14769,3575870494,3575870521,27
3,836,14770,3575870494,3575870522,28
3,836,14771,3575870494,3575870525,31
3,836,14772,3575870494,3575870526,32
3,836,14773,3575870494,3575870526,32
3,836,14774,3575870494,3575870527,33
3,836,14775,3575870494,3575870527,33
3,836,14776,3575870494,3575870536,42
3,836,14777,3575870494,3575870543,49
3,836,14778,3575870494,3575870543,49
3,836,14779,3575870494,3575870544,50
3,837,14780,3575870553,3575870553,0
3,837,14781,3575870553,3575870553,0
3,837,14782,3575870553,3575870553,0
3,837,14783,3575870553,3575870553,0
3,837,14784,3575870553,3575870553,0
3,837,14785,3575870553,3575870557,4
3,837,14786,3575870553,3575870558,5
3,837,14787,3575870553,3575870560,7
3,837,14788,3575870553,3575870562,9
3,837,14789,3575870553,3575870565,12
3,837,14790,3575870553,3575870567,14
3,837,14791,3575870553,3575870569,16
3,837,14792,3575870553,3575870569,16
3,837,14793,3575870553,3575870569,16
3,837,14794,3575870553,3575870570,17
3,837,14795,3575870553,3575870570,17
3,837,14796,3575870553,3575870572,19
3,837,14797,3575870553,3575870574,21
3,837,14798,3575870553,3575870575,22
3,837,14799,3575870553,3575870575,22
3,837,14800,3575870553,3575870576,23
3,837,14801,3575870553,3575870577,24
3,837,14802,3575870553,3575870580,27
3,837,14803,3575870553,3575870581,28
3,837,14804,3575870553,3575870583,30
3,837,14805,3575870553,3575870584,31
3,837,14806,3575870553,3575870585,32
3,837,14807,3575870553,3575870585,32
3,837,14808,3575870553,3575870586,33
3,837,14809,3575870553,3575870588,35
3,837,14810,3575870553,3575870591,38
3,837,14811,3575870553,3575870592,39
3,837,14812,3575870553,3575870593,40
3,837,14813,3575870553,3575870594,41
3,837,14814,3575870553,3575870595,42
3,837,14815,3575870553,3575870595,42
3,837,14816,3575870553,3575870595,42
3,837,14817,3575870553,3575870596,43
3,837,14818,3575870553,3575870596,43
3,837,14819,3575870553,3575870596,43
3,837,14820,3575870553,3575870598,45
3,837,14821,3575870553,3575870601,48
3,837,14822,3575870553,3575870602,49
3,838,14823,3575870610,3575870610,0
3,838,14824,3575870610,3575870610,0
3,838,14825,3575870610,3575870610,0
3,838,14826,3575870610,3575870610,0
3,838,14827,3575870610,3575870610,0
3,838,14828,3575870610,3575870611,1
3,838,14829,3575870610,3575870614,4
3,838,14830,3575870610,3575870615,5
3,838,14831,3575870610,3575870616,6
3,838,14832,3575870610,3575870617,7
3,838,14833,3575870610,3575870617,7
3,838,14834,3575870610,3575870618,8
3,838,14835,3575870610,3575870618,8
3,838,14836,3575870610,3575870621,11
3,838,14837,3575870610,3575870621,11
3,838,14838,3575870610,3575870622,12
3,838,14839,3575870610,3575870626,16
3,838,14840,3575870610,3575870628,18
3,838,14841,3575870610,3575870629,19
3,838,14842,3575870610,3575870631,21
3,838,14843,3575870610,3575870632,22
3,838,14844,3575870610,3575870632,22
3,838,14845,3575870610,3575870632,22
3,838,14846,3575870610,3575870633,23
3,838,14847,3575870610,3575870633,23
3,838,14848,3575870610,3575870633,23
3,838,14849,3575870610,3575870635,25
3,838,14850,3575870610,3575870635,25
3,838,14851,3575870610,3575870636,26
3,838,14852,3575870610,3575870638,28
3,838,14853,3575870610,3575870640,30
3,838,14854,3575870610,3575870640,30
3,838,14855,3575870610,3575870641,31
3,838,14856,3575870610,3575870641,31
3,838,14857,3575870610,3575870642,32
3,838,14858,3575870610,3575870643,33
3,838,14859,3575870610,3575870644,34
3,838,14860,3575870610,3575870645,35
3,838,14861,3575870610,3575870646,36
3,838,14862,3575870610,3575870647,37
3,838,14863,3575870610,3575870652,42
3,838,14864,3575870610,3575870652,42
3,838,14865,3575870610,3575870653,43
3,838,14866,3575870610,3575870653,43
3,838,14867,3575870610,3575870655,45
3,838,14868,3575870610,3575870655,45
3,838,14869,3575870610,3575870656,46
3,838,14870,3575870610,3575870657,47
3,838,14871,3575870610,3575870659,49
3,838,14872,3575870610,3575870659,49
3,839,14873,3575870668,3575870668,0
3,839,14874,3575870668,3575870668,0
3,839,14875,3575870668,3575870668,0
3,839,14876,3575870668,3575870668,0
3,839,14877,3575870668,3575870668,0
3,839,14878,3575870668,3575870668,0
3,839,14879,3575870668,3575870668,0
3,839,14880,3575870668,3575870668,0
3,839,14881,3575870668,3575870669,1
3,839,14882,3575870668,3575870673,5
3,839,14883,3575870668,3575870676,8
3,839,14884,3575870668,3575870680,12
3,839,14885,3575870668,3575870681,13
3,839,14886,3575870668,3575870682,14
3,839,14887,3575870668,3575870683,15
3,839,14888,3575870668,3575870684,16
3,839,14889,3575870668,3575870685,17
3,839,14890,3575870668,3575870685,17
3,839,14891,3575870668,3575870685,17
3,839,14892,3575870668,3575870687,19
3,839,14893,3575870668,3575870687,19
3,839,14894,3575870668,3575870693,25
3,839,14895,3575870668,3575870694,26
3,839,14896,3575870668,3575870695,27
3,839,14897,3575870668,3575870697,29
3,839,14898,3575870668,3575870697,29
3,839,14899,3575870668,3575870697,29
3,839,14900,3575870668,3575870697,29
3,839,14901,3575870668,3575870699,31
3,839,14902,3575870668,3575870699,31
3,839,14903,3575870668,3575870700,32
3,839,14904,3575870668,3575870702,34
3,839,14905,3575870668,3575870706,38
3,839,14906,3575870668,3575870707,39
3,839,14907,3575870668,3575870711,43
3,839,14908,3575870668,3575870711,43
3,839,14909,3575870668,3575870712,44
3,839,14910,3575870668,3575870716,48
3,839,14911,3575870668,3575870717,49
3,840,14912,3575870725,3575870725,0
3,840,14913,3575870725,3575870725,0
3,840,14914,3575870725,3575870725,0
3,840,14915,3575870725,3575870725,0
3,840,14916,3575870725,3575870725,0
3,840,14917,3575870725,3575870726,1
3,840,14918,3575870725,3575870726,1
3,840,14919,3575870725,3575870726,1
3,840,14920,3575870725,3575870727,2
3,840,14921,3575870725,3575870727,2
3,840,14922,3575870725,3575870727,2
3,840,14923,3575870725,3575870735,10
3,840,14924,3575870725,3575870736,11
3,840,14925,3575870725,3575870738,13
3,840,14926,3575870725,3575870742,17
3,840,14927,3575870725,3575870743,18
3,840,14928,3575870725,3575870743,18
3,840,14929,3575870725,3575870743,18
3,840,14930,3575870725,3575870744,19
3,840,14931,3575870725,3575870750,25
3,840,14932,3575870725,3575870751,26
3,840,14933,3575870725,3575870752,27
3,840,14934,3575870725,3575870754,29
3,840,14935,3575870725,3575870757,32
3,840,14936,3575870725,3575870758,33
3,840,14937,3575870725,3575870762,37
3,840,14938,3575870725,3575870766,41
3,840,14939,3575870725,3575870766,41
3,840,14940,3575870725,3575870768,43
3,840,14941,3575870725,3575870769,44
3,840,14942,3575870725,3575870770,45
3,840,14943,3575870725,3575870770,45
3,840,14944,3575870725,3575870773,48
3,840,14945,3575870725,3575870774,49
3,840,14946,3575870725,3575870774,49
3,840,14947,3575870725,3575870775,50
3,841,14948,3575870783,3575870783,0
3,841,14949,3575870783,3575870783,0
3,841,14950,3575870783,3575870783,0
3,841,14951,3575870783,3575870783,0
3,841,14952,3575870783,3575870783,0
3,841,14953,3575870783,3575870783,0
3,841,14954,3575870783,3575870785,2
3,841,14955,3575870783,3575870785,2
3,841,14956,3575870783,3575870786,3
3,841,14957,3575870783,3575870792,9
3,841,14958,3575870783,3575870793,10
3,841,14959,3575870783,3575870794,11
3,841,14960,3575870783,3575870795,12
3,841,14961,3575870783,3575870795,12
3,841,14962,3575870783,3575870795,12
3,841,14963,3575870783,3575870796,13
3,841,14964,3575870783,3575870796,13
3,841,14965,3575870783,3575870796,13
3,841,14966,3575870783,3575870798,15
3,841,14967,3575870783,3575870803,20
3,841,14968,3575870783,3575870804,21
3,841,14969,3575870783,3575870804,21
3,841,14970,3575870783,3575870805,22
3,841,14971,3575870783,3575870805,22
3,841,14972,3575870783,3575870806,23
3,841,14973,3575870783,3575870811,28
3,841,14974,3575870783,3575870815,32
3,841,14975,3575870783,3575870816,33
3,841,14976,3575870783,3575870816,33
3,841,14977,3575870783,3575870816,33
3,841,14978,3575870783,3575870818,35
3,841,14979,3575870783,3575870818,35
3,841,14980,3575870783,3575870818,35
3,841,14981,3575870783,3575870819,36
3,841,14982,3575870783,3575870821,38
3,841,14983,3575870783,3575870821,38
3,841,14984,3575870783,3575870822,39
3,841,14985,3575870783,3575870823,40
3,841,14986,3575870783,3575870825,42
3,841,14987,3575870783,3575870828,45
3,841,14988,3575870783,3575870829,46
3,841,14989,3575870783,3575870830,47
3,841,14990,3575870783,3575870832,49
3,841,14991,3575870783,3575870832,49
3,841,14992,3575870783,3575870832,49
3,841,14993,3575870783,3575870832,49
3,841,14994,3575870783,3575870833,50
3,842,14995,3575870842,3575870842,0
3,842,14996,3575870842,3575870842,0
3,842,14997,3575870842,3575870842,0
3,842,14998,3575870842,3575870842,0
3,842,14999,3575870842,3575870842,0
3,842,15000,3575870842,3575870842,0
3,842,15001,3575870842,3575870842,0
3,842,15002,3575870842,3575870842,0
3,842,15003,3575870842,3575870842,0
3,842,15004,3575870842,3575870842,0
3,842,15005,3575870842,3575870843,1
3,842,15006,3575870842,3575870843,1
3,842,15007,3575870842,3575870845,3
3,842,15008,3575870842,3575870846,4
3,842,15009,3575870842,3575870847,5
3,842,15010,3575870842,3575870852,10
3,842,15011,3575870842,3575870852,10
3,842,15012,3575870842,3575870853,11
3,842,15013,3575870842,3575870855,13
3,842,15014,3575870842,3575870856,14
3,842,15015,3575870842,3575870857,15
3,842,15016,3575870842,3575870857,15
3,842,15017,3575870842,3575870859,17
3,842,15018,3575870842,3575870860,18
3,842,15019,3575870842,3575870862,20
3,842,15020,3575870842,3575870863,21
3,842,15021,3575870842,3575870863,21
3,842,15022,3575870842,3575870864,22
3,842,15023,3575870842,3575870864,22
3,842,15024,3575870842,3575870865,23
3,842,15025,3575870842,3575870866,24
3,842,15026,3575870842,3575870866,24
3,842,15027,3575870842,3575870867,25
3,842,15028,3575870842,3575870869,27
3,842,15029,3575870842,3575870873,31
3,842,15030,3575870842,3575870876,34
3,842,15031,3575870842,3575870878,36
3,842,15032,3575870842,3575870879,37
3,842,15033,3575870842,3575870880,38
3,842,15034,3575870842,3575870881,39
3,842,15035,3575870842,3575870882,40
3,842,15036,3575870842,3575870885,43
3,842,15037,3575870842,3575870885,43
3,842,15038,3575870842,3575870886,44
3,842,15039,3575870842,3575870888,46
3,842,15040,3575870842,3575870888,46
3,843,15041,3575870902,3575870902,0
3,843,15042,3575870902,3575870902,0
3,843,15043,3575870902,3575870902,0
3,843,15044,3575870902,3575870902,0
3,843,15045,3575870902,3575870902,0
3,843,15046,3575870902,3575870902,0
3,843,15047,3575870902,3575870902,0
3,843,15048,3575870902,3575870902,0
3,843,15049,3575870902,3575870902,0
3,843,15050,3575870902,3575870902,0
3,843,15051,3575870902,3575870906,4
3,843,15052,3575870902,3575870907,5
3,843,15053,3575870902,3575870911,9
3,843,15054,3575870902,3575870911,9
3,843,15055,3575870902,3575870912,10
3,843,15056,3575870902,3575870916,14
3,843,15057,3575870902,3575870918,16
3,843,15058,3575870902,3575870918,16
3,843,15059,3575870902,3575870921,19
3,843,15060,3575870902,3575870922,20
3,843,15061,3575870902,3575870922,20
3,843,15062,3575870902,3575870923,21
3,843,15063,3575870902,3575870923,21
3,843,15064,3575870902,3575870926,24
3,843,15065,3575870902,3575870927,25
3,843,15066,3575870902,3575870927,25
3,843,15067,3575870902,3575870927,25
3,843,15068,3575870902,3575870927,25
3,843,15069,3575870902,3575870934,32
3,843,15070,3575870902,3575870934,32
3,843,15071,3575870902,3575870937,35
3,843,15072,3575870902,3575870937,35
3,843,15073,3575870902,3575870942,40
3,843,15074,3575870902,3575870943,41
3,843,15075,3575870902,3575870943,41
3,843,15076,3575870902,3575870945,43
3,843,15077,3575870902,3575870950,48
3,843,15078,3575870902,3575870952,50
3,844,15079,3575870961,3575870961,0
3,844,15080,3575870961,3575870961,0
3,844,15081,3575870961,3575870961,0
3,844,15082,3575870961,3575870961,0
3,844,15083,3575870961,3575870961,0
3,844,15084,3575870961,3575870967,6
3,844,15085,3575870961,3575870967,6
3,844,15086,3575870961,3575870969,8
3,844,15087,3575870961,3575870969,8
3,844,15088,3575870961,3575870969,8
3,844,15089,3575870961,3575870970,9
3,844,15090,3575870961,3575870970,9
3,844,15091,3575870961,3575870973,12
3,844,15092,3575870961,3575870973,12
3,844,15093,3575870961,3575870974,13
3,844,15094,3575870961,3575870974,13
3,844,15095,3575870961,3575870975,14
3,844,15096,3575870961,3575870976,15
3,844,15097,3575870961,3575870978,17
3,844,15098,3575870961,3575870981,20
3,844,15099,3575870961,3575870981,20
3,844,15100,3575870961,3575870983,22
3,844,15101,3575870961,3575870984,23
3,844,15102,3575870961,3575870985,24
3,844,15103,3575870961,3575870985,24
3,844,15104,3575870961,3575870986,25
3,844,15105,3575870961,3575870988,27
3,844,15106,3575870961,3575870990,29
3,844,15107,3575870961,3575870992,31
3,844,15108,3575870961,3575870993,32
3,844,15109,3575870961,3575870993,32
3,844,15110,3575870961,3575870994,33
3,844,15111,3575870961,3575870995,34
3,844,15112,3575870961,3575870995,34
3,844,15113,3575870961,3575870996,35
3,844,15114,3575870961,3575870997,36
3,844,15115,3575870961,3575870997,36
3,844,15116,3575870961,3575870999,38
3,844,15117,3575870961,3575871003,42
3,844,15118,3575870961,3575871004,43
3,844,15119,3575870961,3575871004,43
3,844,15120,3575870961,3575871006,45
3,844,15121,3575870961,3575871006,45
3,844,15122,3575870961,3575871007,46
3,845,15123,3575871021,3575871022,1
3,845,15124,3575871021,3575871022,1
3,845,15125,3575871021,3575871022,1
3,845,15126,3575871021,3575871022,1
3,845,15127,3575871021,3575871022,1
3,845,15128,3575871021,3575871022,1
3,845,15129,3575871021,3575871022,1
3,845,15130,3575871021,3575871022,1
3,845,15131,3575871021,3575871022,1
3,845,15132,3575871021,3575871022,1
3,845,15133,3575871021,3575871026,5
3,845,15134,3575871021,3575871029,8
3,845,15135,3575871021,3575871029,8
3,845,15136,3575871021,3575871031,10
3,845,15137,3575871021,3575871032,11
3,845,15138,3575871021,3575871032,11
3,845,15139,3575871021,3575871032,11
3,845,15140,3575871021,3575871033,12
3,845,15141,3575871021,3575871033,12
3,845,15142,3575871021,3575871033,12
3,845,15143,3575871021,3575871035,14
3,845,15144,3575871021,3575871036,15
3,845,15145,3575871021,3575871037,16
3,845,15146,3575871021,3575871037,16
3,845,15147,3575871021,3575871038,17
3,845,15148,3575871021,3575871039,18
3,845,15149,3575871021,3575871040,19
3,845,15150,3575871021,3575871041,20
3,845,15151,3575871021,3575871041,20
3,845,15152,3575871021,3575871041,20
3,845,15153,3575871021,3575871043,22
3,845,15154,3575871021,3575871043,22
3,845,15155,3575871021,3575871043,22
3,845,15156,3575871021,3575871044,23
3,845,15157,3575871021,3575871045,24
3,845,15158,3575871021,3575871046,25
3,845,15159,3575871021,3575871047,26
3,845,15160,3575871021,3575871051,30
3,845,15161,3575871021,3575871052,31
3,845,15162,3575871021,3575871053,32
3,845,15163,3575871021,3575871053,32
3,845,15164,3575871021,3575871056,35
3,845,15165,3575871021,3575871056,35
3,845,15166,3575871021,3575871056,35
3,845,15167,3575871021,3575871060,39
3,845,15168,3575871021,3575871060,39
3,845,15169,3575871021,3575871062,41
3,845,15170,3575871021,3575871063,42
3,845,15171,3575871021,3575871063,42
3,845,15172,3575871021,3575871063,42
3,845,15173,3575871021,3575871065,44
3,845,15174,3575871021,3575871065,44
3,845,15175,3575871021,3575871065,44
3,845,15176,3575871021,3575871067,46
3,845,15177,3575871021,3575871067,46
3,845,15178,3575871021,3575871069,48
3,846,15179,3575871079,3575871079,0
3,846,15180,3575871079,3575871079,0
3,846,15181,3575871079,3575871081,2
3,846,15182,3575871079,3575871083,4
3,846,15183,3575871079,3575871083,4
3,846,15184,3575871079,3575871085,6
3,846,15185,3575871079,3575871085,6
3,846,15186,3575871079,3575871088,9
3,846,15187,3575871079,3575871094,15
3,846,15188,3575871079,3575871096,17
3,846,15189,3575871079,3575871097,18
3,846,15190,3575871079,3575871097,18
3,846,15191,3575871079,3575871098,19
3,846,15192,3575871079,3575871099,20
3,846,15193,3575871079,3575871099,20
3,846,15194,3575871079,3575871100,21
3,846,15195,3575871079,3575871104,25
3,846,15196,3575871079,3575871106,27
3,846,15197,3575871079,3575871107,28
3,846,15198,3575871079,3575871111,32
3,846,15199,3575871079,3575871112,33
3,846,15200,3575871079,3575871113,34
3,846,15201,3575871079,3575871116,37
3,846,15202,3575871079,3575871118,39
3,846,15203,3575871079,3575871119,40
3,846,15204,3575871079,3575871121,42
3,846,15205,3575871079,3575871122,43
3,846,15206,3575871079,3575871123,44
3,846,15207,3575871079,3575871123,44
3,846,15208,3575871079,3575871126,47
3,846,15209,3575871079,3575871127,48
3,846,15210,3575871079,3575871127,48
3,846,15211,3575871079,3575871127,48
3,846,15212,3575871079,3575871127,48
3,847,15213,3575871139,3575871139,0
3,847,15214,3575871139,3575871139,0
3,847,15215,3575871139,3575871139,0
3,847,15216,3575871139,3575871139,0
3,847,15217,3575871139,3575871142,3
3,847,15218,3575871139,3575871143,4
3,847,15219,3575871139,3575871143,4
3,847,15220,3575871139,3575871144,5
3,847,15221,3575871139,3575871151,12
3,847,15222,3575871139,3575871152,13
3,847,15223,3575871139,3575871152,13
3,847,15224,3575871139,3575871156,17
3,847,15225,3575871139,3575871157,18
3,847,15226,3575871139,3575871159,20
3,847,15227,3575871139,3575871167,28
3,847,15228,3575871139,3575871167,28
3,847,15229,3575871139,3575871169,30
3,847,15230,3575871139,3575871169,30
3,847,15231,3575871139,3575871170,31
3,847,15232,3575871139,3575871170,31
3,847,15233,3575871139,3575871170,31
3,847,15234,3575871139,3575871174,35
3,847,15235,3575871139,3575871174,35
3,847,15236,3575871139,3575871174,35
3,847,15237,3575871139,3575871176,37
3,847,15238,3575871139,3575871176,37
3,847,15239,3575871139,3575871181,42
3,847,15240,3575871139,3575871181,42
3,847,15241,3575871139,3575871184,45
3,847,15242,3575871139,3575871184,45
3,847,15243,3575871139,3575871186,47
3,848,15244,3575871198,3575871198,0
3,848,15245,3575871198,3575871198,0
3,848,15246,3575871198,3575871198,0
3,848,15247,3575871198,3575871198,0
3,848,15248,3575871198,3575871198,0
3,848,15249,3575871198,3575871198,0
3,848,15250,3575871198,3575871198,0
3,848,15251,3575871198,3575871198,0
3,848,15252,3575871198,3575871198,0
3,848,15253,3575871198,3575871198,0
3,848,15254,3575871198,3575871198,0
3,848,15255,3575871198,3575871199,1
3,848,15256,3575871198,3575871203,5
3,848,15257,3575871198,3575871204,6
3,848,15258,3575871198,3575871206,8
3,848,15259,3575871198,3575871206,8
3,848,15260,3575871198,3575871206,8
3,848,15261,3575871198,3575871206,8
3,848,15262,3575871198,3575871207,9
3,848,15263,3575871198,3575871211,13
3,848,15264,3575871198,3575871215,17
3,848,15265,3575871198,3575871216,18
3,848,15266,3575871198,3575871217,19
3,848,15267,3575871198,3575871218,20
3,848,15268,3575871198,3575871218,20
3,848,15269,3575871198,3575871219,21
3,848,15270,3575871198,3575871219,21
3,848,15271,3575871198,3575871220,22
3,848,15272,3575871198,3575871223,25
3,848,15273,3575871198,3575871226,28
3,848,15274,3575871198,3575871229,31
3,848,15275,3575871198,3575871230,32
3,848,15276,3575871198,3575871231,33
3,848,15277,3575871198,3575871232,34
3,848,15278,3575871198,3575871232,34
3,848,15279,3575871198,3575871232,34
3,848,15280,3575871198,3575871233,35
3,848,15281,3575871198,3575871233,35
3,848,15282,3575871198,3575871233,35
3,848,15283,3575871198,3575871236,38
3,848,15284,3575871198,3575871236,38
3,848,15285,3575871198,3575871236,38
3,848,15286,3575871198,3575871237,39
3,848,15287,3575871198,3575871238,40
3,848,15288,3575871198,3575871240,42
3,848,15289,3575871198,3575871240,42
3,848,15290,3575871198,3575871241,43
3,848,15291,3575871198,3575871241,43
3,848,15292,3575871198,3575871243,45
3,848,15293,3575871198,3575871243,45
3,848,15294,3575871198,3575871244,46
3,848,15295,3575871198,3575871244,46
3,848,15296,3575871198,3575871245,47
3,849,15297,3575871260,3575871261,1
3,849,15298,3575871260,3575871261,1
3,849,15299,3575871260,3575871261,1
3,849,15300,3575871260,3575871261,1
3,849,15301,3575871260,3575871261,1
3,849,15302,3575871260,3575871261,1
3,849,15303,3575871260,3575871261,1
3,849,15304,3575871260,3575871261,1
3,849,15305,3575871260,3575871262,2
3,849,15306,3575871260,3575871262,2
3,849,15307,3575871260,3575871263,3
3,849,15308,3575871260,3575871263,3
3,849,15309,3575871260,3575871264,4
3,849,15310,3575871260,3575871264,4
3,849,15311,3575871260,3575871265,5
3,849,15312,3575871260,3575871266,6
3,849,15313,3575871260,3575871267,7
3,849,15314,3575871260,3575871267,7
3,849,15315,3575871260,3575871269,9
3,849,15316,3575871260,3575871273,13
3,849,15317,3575871260,3575871277,17
3,849,15318,3575871260,3575871278,18
3,849,15319,3575871260,3575871278,18
3,849,15320,3575871260,3575871281,21
3,849,15321,3575871260,3575871281,21
3,849,15322,3575871260,3575871282,22
3,849,15323,3575871260,3575871283,23
3,849,15324,3575871260,3575871285,25
3,849,15325,3575871260,3575871285,25
3,849,15326,3575871260,3575871285,25
3,849,15327,3575871260,3575871288,28
3,849,15328,3575871260,3575871293,33
3,849,15329,3575871260,3575871294,34
3,849,15330,3575871260,3575871296,36
3,849,15331,3575871260,3575871297,37
3,849,15332,3575871260,3575871298,38
3,849,15333,3575871260,3575871298,38
3,849,15334,3575871260,3575871299,39
3,849,15335,3575871260,3575871299,39
3,849,15336,3575871260,3575871300,40
3,849,15337,3575871260,3575871300,40
3,849,15338,3575871260,3575871303,43
3,849,15339,3575871260,3575871306,46
3,849,15340,3575871260,3575871307,47
3,850,15341,3575871321,3575871321,0
3,850,15342,3575871321,3575871321,0
3,850,15343,3575871321,3575871321,0
3,850,15344,3575871321,3575871321,0
3,850,15345,3575871321,3575871321,0
3,850,15346,3575871321,3575871321,0
3,850,15347,3575871321,3575871322,1
3,850,15348,3575871321,3575871323,2
3,850,15349,3575871321,3575871323,2
3,850,15350,3575871321,3575871324,3
3,850,15351,3575871321,3575871327,6
3,850,15352,3575871321,3575871327,6
3,850,15353,3575871321,3575871328,7
3,850,15354,3575871321,3575871328,7
3,850,15355,3575871321,3575871334,13
3,850,15356,3575871321,3575871335,14
3,850,15357,3575871321,3575871338,17
3,850,15358,3575871321,3575871342,21
3,850,15359,3575871321,3575871343,22
3,850,15360,3575871321,3575871344,23
3,850,15361,3575871321,3575871351,30
3,850,15362,3575871321,3575871352,31
3,850,15363,3575871321,3575871352,31
3,850,15364,3575871321,3575871356,35
3,850,15365,3575871321,3575871357,36
3,850,15366,3575871321,3575871358,37
3,850,15367,3575871321,3575871359,38
3,850,15368,3575871321,3575871361,40
3,850,15369,3575871321,3575871364,43
3,850,15370,3575871321,3575871368,47
3,850,15371,3575871321,3575871368,47
3,850,15372,3575871321,3575871369,48
3,850,15373,3575871321,3575871370,49
3,850,15374,3575871321,3575871371,50
3,851,15375,3575871380,3575871380,0
3,851,15376,3575871380,3575871380,0
3,851,15377,3575871380,3575871380,0
3,851,15378,3575871380,3575871380,0
3,851,15379,3575871380,3575871380,0
3,851,15380,3575871380,3575871380,0
3,851,15381,3575871380,3575871380,0
3,851,15382,3575871380,3575871384,4
3,851,15383,3575871380,3575871387,7
3,851,15384,3575871380,3575871389,9
3,851,15385,3575871380,3575871392,12
3,851,15386,3575871380,3575871392,12
3,851,15387,3575871380,3575871392,12
3,851,15388,3575871380,3575871393,13
3,851,15389,3575871380,3575871395,15
3,851,15390,3575871380,3575871395,15
3,851,15391,3575871380,3575871395,15
3,851,15392,3575871380,3575871396,16
3,851,15393,3575871380,3575871396,16
3,851,15394,3575871380,3575871396,16
3,851,15395,3575871380,3575871397,17
3,851,15396,3575871380,3575871399,19
3,851,15397,3575871380,3575871399,19
3,851,15398,3575871380,3575871401,21
3,851,15399,3575871380,3575871403,23
3,851,15400,3575871380,3575871404,24
3,851,15401,3575871380,3575871406,26
3,851,15402,3575871380,3575871406,26
3,851,15403,3575871380,3575871406,26
3,851,15404,3575871380,3575871407,27
3,851,15405,3575871380,3575871407,27
3,851,15406,3575871380,3575871411,31
3,851,15407,3575871380,3575871416,36
3,851,15408,3575871380,3575871416,36
3,851,15409,3575871380,3575871416,36
3,851,15410,3575871380,3575871418,38
3,851,15411,3575871380,3575871419,39
3,851,15412,3575871380,3575871419,39
3,851,15413,3575871380,3575871420,40
3,851,15414,3575871380,3575871421,41
3,851,15415,3575871380,3575871422,42
3,851,15416,3575871380,3575871423,43
3,851,15417,3575871380,3575871427,47
3,851,15418,3575871380,3575871428,48
3,851,15419,3575871380,3575871430,50
3,852,15420,3575871439,3575871439,0
3,852,15421,3575871439,3575871439,0
3,852,15422,3575871439,3575871439,0
3,852,15423,3575871439,3575871439,0
3,852,15424,3575871439,3575871439,0
3,852,15425,3575871439,3575871439,0
3,852,15426,3575871439,3575871439,0
3,852,15427,3575871439,3575871439,0
3,852,15428,3575871439,3575871439,0
3,852,15429,3575871439,3575871439,0
3,852,15430,3575871439,3575871439,0
3,852,15431,3575871439,3575871439,0
3,852,15432,3575871439,3575871440,1
3,852,15433,3575871439,3575871441,2
3,852,15434,3575871439,3575871441,2
3,852,15435,3575871439,3575871441,2
3,852,15436,3575871439,3575871441,2
3,852,15437,3575871439,3575871442,3
3,852,15438,3575871439,3575871443,4
3,852,15439,3575871439,3575871443,4
3,852,15440,3575871439,3575871445,6
3,852,15441,3575871439,3575871446,7
3,852,15442,3575871439,3575871446,7
3,852,15443,3575871439,3575871449,10
3,852,15444,3575871439,3575871451,12
3,852,15445,3575871439,3575871452,13
3,852,15446,3575871439,3575871454,15
3,852,15447,3575871439,3575871454,15
3,852,15448,3575871439,3575871456,17
3,852,15449,3575871439,3575871457,18
3,852,15450,3575871439,3575871457,18
3,852,15451,3575871439,3575871458,19
3,852,15452,3575871439,3575871460,21
3,852,15453,3575871439,3575871462,23
3,852,15454,3575871439,3575871462,23
3,852,15455,3575871439,3575871462,23
3,852,15456,3575871439,3575871464,25
3,852,15457,3575871439,3575871464,25
3,852,15458,3575871439,3575871465,26
3,852,15459,3575871439,3575871465,26
3,852,15460,3575871439,3575871466,27
3,852,15461,3575871439,3575871468,29
3,852,15462,3575871439,3575871469,30
3,852,15463,3575871439,3575871473,34
3,852,15464,3575871439,3575871477,38
3,852,15465,3575871439,3575871478,39
3,852,15466,3575871439,3575871479,40
3,852,15467,3575871439,3575871481,42
3,852,15468,3575871439,3575871483,44
3,852,15469,3575871439,3575871483,44
3,852,15470,3575871439,3575871485,46
3,852,15471,3575871439,3575871485,46
3,852,15472,3575871439,3575871485,46
3,852,15473,3575871439,3575871488,49
3,852,15474,3575871439,3575871488,49
3,853,15475,3575871498,3575871498,0
3,853,15476,3575871498,3575871498,0
3,853,15477,3575871498,3575871498,0
3,853,15478,3575871498,3575871498,0
3,853,15479,3575871498,3575871498,0
3,853,15480,3575871498,3575871499,1
3,853,15481,3575871498,3575871499,1
3,853,15482,3575871498,3575871499,1
3,853,15483,3575871498,3575871499,1
3,853,15484,3575871498,3575871500,2
3,853,15485,3575871498,3575871500,2
3,853,15486,3575871498,3575871502,4
3,853,15487,3575871498,3575871505,7
3,853,15488,3575871498,3575871510,12
3,853,15489,3575871498,3575871511,13
3,853,15490,3575871498,3575871515,17
3,853,15491,3575871498,3575871518,20
3,853,15492,3575871498,3575871518,20
3,853,15493,3575871498,3575871521,23
3,853,15494,3575871498,3575871521,23
3,853,15495,3575871498,3575871523,25
3,853,15496,3575871498,3575871523,25
3,853,15497,3575871498,3575871523,25
3,853,15498,3575871498,3575871526,28
3,853,15499,3575871498,3575871527,29
3,853,15500,3575871498,3575871527,29
3,853,15501,3575871498,3575871527,29
3,853,15502,3575871498,3575871532,34
3,853,15503,3575871498,3575871533,35
3,853,15504,3575871498,3575871537,39
3,853,15505,3575871498,3575871542,44
3,853,15506,3575871498,3575871542,44
3,853,15507,3575871498,3575871543,45
3,853,15508,3575871498,3575871544,46
3,854,15509,3575871558,3575871558,0
3,854,15510,3575871558,3575871558,0
3,854,15511,3575871558,3575871558,0
3,854,15512,3575871558,3575871558,0
3,854,15513,3575871558,3575871558,0
3,854,15514,3575871558,3575871560,2
3,854,15515,3575871558,3575871563,5
3,854,15516,3575871558,3575871567,9
3,854,15517,3575871558,3575871567,9
3,854,15518,3575871558,3575871569,11
3,854,15519,3575871558,3575871570,12
3,854,15520,3575871558,3575871571,13
3,854,15521,3575871558,3575871574,16
3,854,15522,3575871558,3575871575,17
3,854,15523,3575871558,3575871577,19
3,854,15524,3575871558,3575871577,19
3,854,15525,3575871558,3575871579,21
3,854,15526,3575871558,3575871580,22
3,854,15527,3575871558,3575871582,24
3,854,15528,3575871558,3575871582,24
3,854,15529,3575871558,3575871583,25
3,854,15530,3575871558,3575871586,28
3,854,15531,3575871558,3575871588,30
3,854,15532,3575871558,3575871591,33
3,854,15533,3575871558,3575871591,33
3,854,15534,3575871558,3575871593,35
3,854,15535,3575871558,3575871593,35
3,854,15536,3575871558,3575871594,36
3,854,15537,3575871558,3575871595,37
3,854,15538,3575871558,3575871595,37
3,854,15539,3575871558,3575871595,37
3,854,15540,3575871558,3575871596,38
3,854,15541,3575871558,3575871596,38
3,854,15542,3575871558,3575871598,40
3,854,15543,3575871558,3575871598,40
3,854,15544,3575871558,3575871600,42
3,854,15545,3575871558,3575871602,44
3,854,15546,3575871558,3575871604,46
3,854,15547,3575871558,3575871605,47
3,854,15548,3575871558,3575871605,47
3,854,15549,3575871558,3575871606,48
3,854,15550,3575871558,3575871607,49
3,854,15551,3575871558,3575871607,49
3,855,15552,3575871618,3575871618,0
3,855,15553,3575871618,3575871618,0
3,855,15554,3575871618,3575871618,0
3,855,15555,3575871618,3575871618,0
3,855,15556,3575871618,3575871618,0
3,855,15557,3575871618,3575871618,0
3,855,15558,3575871618,3575871618,0
3,855,15559,3575871618,3575871618,0
3,855,15560,3575871618,3575871623,5
3,855,15561,3575871618,3575871626,8
3,855,15562,3575871618,3575871628,10
3,855,15563,3575871618,3575871629,11
3,855,15564,3575871618,3575871629,11
3,855,15565,3575871618,3575871631,13
3,855,15566,3575871618,3575871632,14
3,855,15567,3575871618,3575871632,14
3,855,15568,3575871618,3575871632,14
3,855,15569,3575871618,3575871633,15
3,855,15570,3575871618,3575871634,16
3,855,15571,3575871618,3575871635,17
3,855,15572,3575871618,3575871635,17
3,855,15573,3575871618,3575871636,18
3,855,15574,3575871618,3575871636,18
3,855,15575,3575871618,3575871638,20
3,855,15576,3575871618,3575871640,22
3,855,15577,3575871618,3575871640,22
3,855,15578,3575871618,3575871640,22
3,855,15579,3575871618,3575871640,22
3,855,15580,3575871618,3575871640,22
3,855,15581,3575871618,3575871641,23
3,855,15582,3575871618,3575871642,24
3,855,15583,3575871618,3575871643,25
3,855,15584,3575871618,3575871643,25
3,855,15585,3575871618,3575871645,27
3,855,15586,3575871618,3575871646,28
3,855,15587,3575871618,3575871648,30
3,855,15588,3575871618,3575871650,32
3,855,15589,3575871618,3575871652,34
3,855,15590,3575871618,3575871653,35
3,855,15591,3575871618,3575871654,36
3,855,15592,3575871618,3575871656,38
3,855,15593,3575871618,3575871656,38
3,855,15594,3575871618,3575871657,39
3,855,15595,3575871618,3575871659,41
3,855,15596,3575871618,3575871661,43
3,855,15597,3575871618,3575871662,44
3,855,15598,3575871618,3575871662,44
3,855,15599,3575871618,3575871663,45
3,855,15600,3575871618,3575871663,45
3,855,15601,3575871618,3575871664,46
3,855,15602,3575871618,3575871664,46
3,855,15603,3575871618,3575871665,47
3,855,15604,3575871618,3575871668,50
3,856,15605,3575871678,3575871678,0
3,856,15606,3575871678,3575871678,0
3,856,15607,3575871678,3575871680,2
3,856,15608,3575871678,3575871681,3
3,856,15609,3575871678,3575871681,3
3,856,15610,3575871678,3575871683,5
3,856,15611,3575871678,3575871683,5
3,856,15612,3575871678,3575871685,7
3,856,15613,3575871678,3575871685,7
3,856,15614,3575871678,3575871686,8
3,856,15615,3575871678,3575871688,10
3,856,15616,3575871678,3575871688,10
3,856,15617,3575871678,3575871688,10
3,856,15618,3575871678,3575871693,15
3,856,15619,3575871678,3575871694,16
3,856,15620,3575871678,3575871696,18
3,856,15621,3575871678,3575871696,18
3,856,15622,3575871678,3575871698,20
3,856,15623,3575871678,3575871699,21
3,856,15624,3575871678,3575871699,21
3,856,15625,3575871678,3575871699,21
3,856,15626,3575871678,3575871700,22
3,856,15627,3575871678,3575871700,22
3,856,15628,3575871678,3575871703,25
3,856,15629,3575871678,3575871705,27
3,856,15630,3575871678,3575871711,33
3,856,15631,3575871678,3575871711,33
3,856,15632,3575871678,3575871712,34
3,856,15633,3575871678,3575871718,40
3,856,15634,3575871678,3575871720,42
3,856,15635,3575871678,3575871721,43
3,856,15636,3575871678,3575871722,44
3,856,15637,3575871678,3575871723,45
3,856,15638,3575871678,3575871724,46
3,856,15639,3575871678,3575871725,47
3,856,15640,3575871678,3575871727,49
3,856,15641,3575871678,3575871727,49
3,856,15642,3575871678,3575871727,49
3,857,15643,3575871738,3575871738,0
3,857,15644,3575871738,3575871738,0
3,857,15645,3575871738,3575871738,0
3,857,15646,3575871738,3575871738,0
3,857,15647,3575871738,3575871743,5
3,857,15648,3575871738,3575871743,5
3,857,15649,3575871738,3575871743,5
3,857,15650,3575871738,3575871745,7
3,857,15651,3575871738,3575871750,12
3,857,15652,3575871738,3575871751,13
3,857,15653,3575871738,3575871752,14
3,857,15654,3575871738,3575871755,17
3,857,15655,3575871738,3575871757,19
3,857,15656,3575871738,3575871760,22
3,857,15657,3575871738,3575871762,24
3,857,15658,3575871738,3575871766,28
3,857,15659,3575871738,3575871769,31
3,857,15660,3575871738,3575871769,31
3,857,15661,3575871738,3575871769,31
3,857,15662,3575871738,3575871770,32
3,857,15663,3575871738,3575871771,33
3,857,15664,3575871738,3575871772,34
3,857,15665,3575871738,3575871773,35
3,857,15666,3575871738,3575871774,36
3,857,15667,3575871738,3575871775,37
3,857,15668,3575871738,3575871777,39
3,857,15669,3575871738,3575871779,41
3,857,15670,3575871738,3575871779,41
3,857,15671,3575871738,3575871780,42
3,857,15672,3575871738,3575871782,44
3,857,15673,3575871738,3575871783,45
3,857,15674,3575871738,3575871783,45
3,857,15675,3575871738,3575871784,46
3,857,15676,3575871738,3575871785,47
3,857,15677,3575871738,3575871786,48
3,857,15678,3575871738,3575871787,49
3,858,15679,3575871799,3575871799,0
3,858,15680,3575871799,3575871799,0
3,858,15681,3575871799,3575871799,0
3,858,15682,3575871799,3575871799,0
3,858,15683,3575871799,3575871799,0
3,858,15684,3575871799,3575871799,0
3,858,15685,3575871799,3575871799,0
3,858,15686,3575871799,3575871799,0
3,858,15687,3575871799,3575871799,0
3,858,15688,3575871799,3575871799,0
3,858,15689,3575871799,3575871799,0
3,858,15690,3575871799,3575871799,0
3,858,15691,3575871799,3575871799,0
3,858,15692,3575871799,3575871803,4
3,858,15693,3575871799,3575871804,5
3,858,15694,3575871799,3575871805,6
3,858,15695,3575871799,3575871805,6
3,858,15696,3575871799,3575871806,7
3,858,15697,3575871799,3575871806,7
3,858,15698,3575871799,3575871807,8
3,858,15699,3575871799,3575871810,11
3,858,15700,3575871799,3575871815,16
3,858,15701,3575871799,3575871816,17
3,858,15702,3575871799,3575871816,17
3,858,15703,3575871799,3575871817,18
3,858,15704,3575871799,3575871818,19
3,858,15705,3575871799,3575871819,20
3,858,15706,3575871799,3575871820,21
3,858,15707,3575871799,3575871823,24
3,858,15708,3575871799,3575871823,24
3,858,15709,3575871799,3575871826,27
3,858,15710,3575871799,3575871829,30
3,858,15711,3575871799,3575871829,30
3,858,15712,3575871799,3575871829,30
3,858,15713,3575871799,3575871831,32
3,858,15714,3575871799,3575871832,33
3,858,15715,3575871799,3575871832,33
3,858,15716,3575871799,3575871833,34
3,858,15717,3575871799,3575871834,35
3,858,15718,3575871799,3575871835,36
3,858,15719,3575871799,3575871835,36
3,858,15720,3575871799,3575871836,37
3,858,15721,3575871799,3575871836,37
3,858,15722,3575871799,3575871837,38
3,858,15723,3575871799,3575871840,41
3,858,15724,3575871799,3575871840,41
3,858,15725,3575871799,3575871840,41
3,858,15726,3575871799,3575871841,42
3,858,15727,3575871799,3575871841,42
3,858,15728,3575871799,3575871842,43
3,858,15729,3575871799,3575871842,43
3,858,15730,3575871799,3575871843,44
3,858,15731,3575871799,3575871844,45
3,858,15732,3575871799,3575871845,46
3,858,15733,3575871799,3575871846,47
3,858,15734,3575871799,3575871848,49
3,859,15735,3575871857,3575871857,0
3,859,15736,3575871857,3575871857,0
3,859,15737,3575871857,3575871857,0
3,859,15738,3575871857,3575871857,0
3,859,15739,3575871857,3575871857,0
3,859,15740,3575871857,3575871857,0
3,859,15741,3575871857,3575871857,0
3,859,15742,3575871857,3575871860,3
3,859,15743,3575871857,3575871861,4
3,859,15744,3575871857,3575871861,4
3,859,15745,3575871857,3575871862,5
3,859,15746,3575871857,3575871863,6
3,859,15747,3575871857,3575871864,7
3,859,15748,3575871857,3575871865,8
3,859,15749,3575871857,3575871865,8
3,859,15750,3575871857,3575871866,9
3,859,15751,3575871857,3575871868,11
3,859,15752,3575871857,3575871872,15
3,859,15753,3575871857,3575871874,17
3,859,15754,3575871857,3575871879,22
3,859,15755,3575871857,3575871879,22
3,859,15756,3575871857,3575871879,22
3,859,15757,3575871857,3575871880,23
3,859,15758,3575871857,3575871882,25
3,859,15759,3575871857,3575871883,26
3,859,15760,3575871857,3575871883,26
3,859,15761,3575871857,3575871886,29
3,859,15762,3575871857,3575871886,29
3,859,15763,3575871857,3575871888,31
3,859,15764,3575871857,3575871888,31
3,859,15765,3575871857,3575871893,36
3,859,15766,3575871857,3575871894,37
3,859,15767,3575871857,3575871897,40
3,859,15768,3575871857,3575871898,41
3,859,15769,3575871857,3575871898,41
3,859,15770,3575871857,3575871899,42
3,859,15771,3575871857,3575871899,42
3,859,15772,3575871857,3575871900,43
3,859,15773,3575871857,3575871900,43
3,859,15774,3575871857,3575871900,43
3,859,15775,3575871857,3575871902,45
3,859,15776,3575871857,3575871905,48
3,860,15777,3575871917,3575871917,0
3,860,15778,3575871917,3575871917,0
3,860,15779,3575871917,3575871917,0
3,860,15780,3575871917,3575871917,0
3,860,15781,3575871917,3575871918,1
3,860,15782,3575871917,3575871918,1
3,860,15783,3575871917,3575871920,3
3,860,15784,3575871917,3575871921,4
3,860,15785,3575871917,3575871923,6
3,860,15786,3575871917,3575871923,6
3,860,15787,3575871917,3575871924,7
3,860,15788,3575871917,3575871926,9
3,860,15789,3575871917,3575871927,10
3,860,15790,3575871917,3575871927,10
3,860,15791,3575871917,3575871927,10
3,860,15792,3575871917,3575871932,15
3,860,15793,3575871917,3575871935,18
3,860,15794,3575871917,3575871937,20
3,860,15795,3575871917,3575871938,21
3,860,15796,3575871917,3575871942,25
3,860,15797,3575871917,3575871943,26
3,860,15798,3575871917,3575871943,26
3,860,15799,3575871917,3575871944,27
3,860,15800,3575871917,3575871944,27
3,860,15801,3575871917,3575871951,34
3,860,15802,3575871917,3575871951,34
3,860,15803,3575871917,3575871953,36
3,860,15804,3575871917,3575871955,38
3,860,15805,3575871917,3575871958,41
3,860,15806,3575871917,3575871958,41
3,860,15807,3575871917,3575871960,43
3,860,15808,3575871917,3575871962,45
3,861,15809,3575871977,3575871977,0
3,861,15810,3575871977,3575871977,0
3,861,15811,3575871977,3575871977,0
3,861,15812,3575871977,3575871977,0
3,861,15813,3575871977,3575871977,0
3,861,15814,3575871977,3575871977,0
3,861,15815,3575871977,3575871977,0
3,861,15816,3575871977,3575871977,0
3,861,15817,3575871977,3575871977,0
3,861,15818,3575871977,3575871977,0
3,861,15819,3575871977,3575871977,0
3,861,15820,3575871977,3575871980,3
3,861,15821,3575871977,3575871980,3
3,861,15822,3575871977,3575871981,4
3,861,15823,3575871977,3575871982,5
3,861,15824,3575871977,3575871983,6
3,861,15825,3575871977,3575871983,6
3,861,15826,3575871977,3575871984,7
3,861,15827,3575871977,3575871985,8
3,861,15828,3575871977,3575871986,9
3,861,15829,3575871977,3575871987,10
3,861,15830,3575871977,3575871992,15
3,861,15831,3575871977,3575871993,16
3,861,15832,3575871977,3575871993,16
3,861,15833,3575871977,3575871993,16
3,861,15834,3575871977,3575871994,17
3,861,15835,3575871977,3575871995,18
3,861,15836,3575871977,3575871998,21
3,861,15837,3575871977,3575871998,21
3,861,15838,3575871977,3575871998,21
3,861,15839,3575871977,3575871998,21
3,861,15840,3575871977,3575871998,21
3,861,15841,3575871977,3575871998,21
3,861,15842,3575871977,3575871999,22
3,861,15843,3575871977,3575871999,22
3,861,15844,3575871977,3575872003,26
3,861,15845,3575871977,3575872004,27
3,861,15846,3575871977,3575872005,28
3,861,15847,3575871977,3575872006,29
3,861,15848,3575871977,3575872006,29
3,861,15849,3575871977,3575872007,30
3,861,15850,3575871977,3575872007,30
3,861,15851,3575871977,3575872011,34
3,861,15852,3575871977,3575872015,38
3,861,15853,3575871977,3575872016,39
3,861,15854,3575871977,3575872017,40
3,861,15855,3575871977,3575872018,41
3,861,15856,3575871977,3575872019,42
3,861,15857,3575871977,3575872020,43
3,861,15858,3575871977,3575872020,43
3,861,15859,3575871977,3575872023,46
3,861,15860,3575871977,3575872023,46
3,861,15861,3575871977,3575872026,49
3,862,15862,3575872036,3575872036,0
3,862,15863,3575872036,3575872036,0
3,862,15864,3575872036,3575872036,0
3,862,15865,3575872036,3575872036,0
3,862,15866,3575872036,3575872036,0
3,862,15867,3575872036,3575872036,0
3,862,15868,3575872036,3575872036,0
3,862,15869,3575872036,3575872036,0
3,862,15870,3575872036,3575872036,0
3,862,15871,3575872036,3575872036,0
3,862,15872,3575872036,3575872036,0
3,862,15873,3575872036,3575872036,0
3,862,15874,3575872036,3575872038,2
3,862,15875,3575872036,3575872040,4
3,862,15876,3575872036,3575872040,4
3,862,15877,3575872036,3575872040,4
3,862,15878,3575872036,3575872041,5
3,862,15879,3575872036,3575872041,5
3,862,15880,3575872036,3575872042,6
3,862,15881,3575872036,3575872043,7
3,862,15882,3575872036,3575872044,8
3,862,15883,3575872036,3575872044,8
3,862,15884,3575872036,3575872045,9
3,862,15885,3575872036,3575872046,10
3,862,15886,3575872036,3575872049,13
3,862,15887,3575872036,3575872052,16
3,862,15888,3575872036,3575872054,18
3,862,15889,3575872036,3575872054,18
3,862,15890,3575872036,3575872054,18
3,862,15891,3575872036,3575872055,19
3,862,15892,3575872036,3575872057,21
3,862,15893,3575872036,3575872057,21
3,862,15894,3575872036,3575872060,24
3,862,15895,3575872036,3575872061,25
3,862,15896,3575872036,3575872063,27
3,862,15897,3575872036,3575872063,27
3,862,15898,3575872036,3575872064,28
3,862,15899,3575872036,3575872064,28
3,862,15900,3575872036,3575872066,30
3,862,15901,3575872036,3575872066,30
3,862,15902,3575872036,3575872066,30
3,862,15903,3575872036,3575872068,32
3,862,15904,3575872036,3575872072,36
3,862,15905,3575872036,3575872079,43
3,862,15906,3575872036,3575872080,44
3,862,15907,3575872036,3575872083,47
3,862,15908,3575872036,3575872083,47
3,862,15909,3575872036,3575872083,47
3,862,15910,3575872036,3575872085,49
3,862,15911,3575872036,3575872086,50
3,863,15912,3575872095,3575872095,0
3,863,15913,3575872095,3575872095,0
3,863,15914,3575872095,3575872095,0
3,863,15915,3575872095,3575872095,0
3,863,15916,3575872095,3575872095,0
3,863,15917,3575872095,3575872095,0
3,863,15918,3575872095,3575872096,1
3,863,15919,3575872095,3575872096,1
3,863,15920,3575872095,3575872098,3
3,863,15921,3575872095,3575872099,4
3,863,15922,3575872095,3575872099,4
3,863,15923,3575872095,3575872100,5
3,863,15924,3575872095,3575872101,6
3,863,15925,3575872095,3575872103,8
3,863,15926,3575872095,3575872105,10
3,863,15927,3575872095,3575872107,12
3,863,15928,3575872095,3575872111,16
3,863,15929,3575872095,3575872112,17
3,863,15930,3575872095,3575872113,18
3,863,15931,3575872095,3575872116,21
3,863,15932,3575872095,3575872122,27
3,863,15933,3575872095,3575872122,27
3,863,15934,3575872095,3575872123,28
3,863,15935,3575872095,3575872124,29
3,863,15936,3575872095,3575872127,32
3,863,15937,3575872095,3575872128,33
3,863,15938,3575872095,3575872128,33
3,863,15939,3575872095,3575872134,39
3,863,15940,3575872095,3575872137,42
3,863,15941,3575872095,3575872138,43
3,863,15942,3575872095,3575872142,47
3,863,15943,3575872095,3575872142,47
3,863,15944,3575872095,3575872143,48
3,863,15945,3575872095,3575872145,50
3,864,15946,3575872155,3575872155,0
3,864,15947,3575872155,3575872155,0
3,864,15948,3575872155,3575872155,0
3,864,15949,3575872155,3575872155,0
3,864,15950,3575872155,3575872158,3
3,864,15951,3575872155,3575872159,4
3,864,15952,3575872155,3575872163,8
3,864,15953,3575872155,3575872165,10
3,864,15954,3575872155,3575872167,12
3,864,15955,3575872155,3575872169,14
3,864,15956,3575872155,3575872169,14
3,864,15957,3575872155,3575872170,15
3,864,15958,3575872155,3575872170,15
3,864,15959,3575872155,3575872171,16
3,864,15960,3575872155,3575872171,16
3,864,15961,3575872155,3575872173,18
3,864,15962,3575872155,3575872175,20
3,864,15963,3575872155,3575872177,22
3,864,15964,3575872155,3575872179,24
3,864,15965,3575872155,3575872180,25
3,864,15966,3575872155,3575872180,25
3,864,15967,3575872155,3575872182,27
3,864,15968,3575872155,3575872183,28
3,864,15969,3575872155,3575872184,29
3,864,15970,3575872155,3575872186,31
3,864,15971,3575872155,3575872186,31
3,864,15972,3575872155,3575872187,32
3,864,15973,3575872155,3575872191,36
3,864,15974,3575872155,3575872192,37
3,864,15975,3575872155,3575872193,38
3,864,15976,3575872155,3575872193,38
3,864,15977,3575872155,3575872195,40
3,864,15978,3575872155,3575872195,40
3,864,15979,3575872155,3575872196,41
3,864,15980,3575872155,3575872196,41
3,864,15981,3575872155,3575872196,41
3,864,15982,3575872155,3575872197,42
3,864,15983,3575872155,3575872197,42
3,864,15984,3575872155,3575872198,43
3,864,15985,3575872155,3575872200,45
3,864,15986,3575872155,3575872203,48
3,864,15987,3575872155,3575872204,49
3,865,15988,3575872214,3575872214,0
3,865,15989,3575872214,3575872214,0
3,865,15990,3575872214,3575872214,0
3,865,15991,3575872214,3575872214,0
3,865,15992,3575872214,3575872214,0
3,865,15993,3575872214,3575872214,0
3,865,15994,3575872214,3575872216,2
3,865,15995,3575872214,3575872216,2
3,865,15996,3575872214,3575872217,3
3,865,15997,3575872214,3575872218,4
3,865,15998,3575872214,3575872219,5
3,865,15999,3575872214,3575872220,6
3,865,16000,3575872214,3575872221,7
3,865,16001,3575872214,3575872223,9
3,865,16002,3575872214,3575872224,10
3,865,16003,3575872214,3575872226,12
3,865,16004,3575872214,3575872229,15
3,865,16005,3575872214,3575872229,15
3,865,16006,3575872214,3575872231,17
3,865,16007,3575872214,3575872232,18
3,865,16008,3575872214,3575872233,19
3,865,16009,3575872214,3575872233,19
3,865,16010,3575872214,3575872234,20
3,865,16011,3575872214,3575872235,21
3,865,16012,3575872214,3575872236,22
3,865,16013,3575872214,3575872236,22
3,865,16014,3575872214,3575872237,23
3,865,16015,3575872214,3575872237,23
3,865,16016,3575872214,3575872238,24
3,865,16017,3575872214,3575872239,25
3,865,16018,3575872214,3575872240,26
3,865,16019,3575872214,3575872240,26
3,865,16020,3575872214,3575872241,27
3,865,16021,3575872214,3575872241,27
3,865,16022,3575872214,3575872243,29
3,865,16023,3575872214,3575872243,29
3,865,16024,3575872214,3575872245,31
3,865,16025,3575872214,3575872246,32
3,865,16026,3575872214,3575872246,32
3,865,16027,3575872214,3575872249,35
3,865,16028,3575872214,3575872253,39
3,865,16029,3575872214,3575872253,39
3,865,16030,3575872214,3575872253,39
3,865,16031,3575872214,3575872254,40
3,865,16032,3575872214,3575872255,41
3,865,16033,3575872214,3575872255,41
3,865,16034,3575872214,3575872257,43
3,865,16035,3575872214,3575872257,43
3,865,16036,3575872214,3575872259,45
3,865,16037,3575872214,3575872260,46
3,865,16038,3575872214,3575872262,48
3,865,16039,3575872214,3575872263,49
3,866,16040,3575872274,3575872274,0
3,866,16041,3575872274,3575872274,0
3,866,16042,3575872274,3575872274,0
3,866,16043,3575872274,3575872274,0
3,866,16044,3575872274,3575872274,0
3,866,16045,3575872274,3575872274,0
3,866,16046,3575872274,3575872274,0
3,866,16047,3575872274,3575872274,0
3,866,16048,3575872274,3575872274,0
3,866,16049,3575872274,3575872279,5
3,866,16050,3575872274,3575872280,6
3,866,16051,3575872274,3575872282,8
3,866,16052,3575872274,3575872282,8
3,866,16053,3575872274,3575872285,11
3,866,16054,3575872274,3575872287,13
3,866,16055,3575872274,3575872287,13
3,866,16056,3575872274,3575872288,14
3,866,16057,3575872274,3575872294,20
3,866,16058,3575872274,3575872294,20
3,866,16059,3575872274,3575872296,22
3,866,16060,3575872274,3575872296,22
3,866,16061,3575872274,3575872298,24
3,866,16062,3575872274,3575872299,25
3,866,16063,3575872274,3575872299,25
3,866,16064,3575872274,3575872300,26
3,866,16065,3575872274,3575872300,26
3,866,16066,3575872274,3575872301,27
3,866,16067,3575872274,3575872303,29
3,866,16068,3575872274,3575872306,32
3,866,16069,3575872274,3575872307,33
3,866,16070,3575872274,3575872312,38
3,866,16071,3575872274,3575872312,38
3,866,16072,3575872274,3575872313,39
3,866,16073,3575872274,3575872316,42
3,866,16074,3575872274,3575872318,44
3,866,16075,3575872274,3575872319,45
3,866,16076,3575872274,3575872322,48
3,866,16077,3575872274,3575872322,48
3,866,16078,3575872274,3575872323,49
3,866,16079,3575872274,3575872323,49
3,867,16080,3575872337,3575872338,1
3,867,16081,3575872337,3575872338,1
3,867,16082,3575872337,3575872338,1
3,867,16083,3575872337,3575872338,1
3,867,16084,3575872337,3575872338,1
3,867,16085,3575872337,3575872338,1
3,867,16086,3575872337,3575872342,5
3,867,16087,3575872337,3575872343,6
3,867,16088,3575872337,3575872345,8
3,867,16089,3575872337,3575872351,14
3,867,16090,3575872337,3575872352,15
3,867,16091,3575872337,3575872354,17
3,867,16092,3575872337,3575872355,18
3,867,16093,3575872337,3575872358,21
3,867,16094,3575872337,3575872359,22
3,867,16095,3575872337,3575872361,24
3,867,16096,3575872337,3575872365,28
3,867,16097,3575872337,3575872367,30
3,867,16098,3575872337,3575872369,32
3,867,16099,3575872337,3575872369,32
3,867,16100,3575872337,3575872370,33
3,867,16101,3575872337,3575872371,34
3,867,16102,3575872337,3575872371,34
3,867,16103,3575872337,3575872372,35
3,867,16104,3575872337,3575872374,37
3,867,16105,3575872337,3575872376,39
3,867,16106,3575872337,3575872376,39
3,867,16107,3575872337,3575872380,43
3,867,16108,3575872337,3575872380,43
3,867,16109,3575872337,3575872382,45
3,867,16110,3575872337,3575872382,45
3,867,16111,3575872337,3575872384,47
3,867,16112,3575872337,3575872385,48
3,867,16113,3575872337,3575872386,49
3,867,16114,3575872337,3575872387,50
3,867,16115,3575872337,3575872387,50
3,868,16116,3575872398,3575872398,0
3,868,16117,3575872398,3575872398,0
3,868,16118,3575872398,3575872398,0
3,868,16119,3575872398,3575872398,0
3,868,16120,3575872398,3575872398,0
3,868,16121,3575872398,3575872398,0
3,868,16122,3575872398,3575872398,0
3,868,16123,3575872398,3575872398,0
3,868,16124,3575872398,3575872398,0
3,868,16125,3575872398,3575872398,0
3,868,16126,3575872398,3575872398,0
3,868,16127,3575872398,3575872399,1
3,868,16128,3575872398,3575872401,3
3,868,16129,3575872398,3575872403,5
3,868,16130,3575872398,3575872404,6
3,868,16131,3575872398,3575872406,8
3,868,16132,3575872398,3575872406,8
3,868,16133,3575872398,3575872407,9
3,868,16134,3575872398,3575872407,9
3,868,16135,3575872398,3575872408,10
3,868,16136,3575872398,3575872412,14
3,868,16137,3575872398,3575872416,18
3,868,16138,3575872398,3575872416,18
3,868,16139,3575872398,3575872417,19
3,868,16140,3575872398,3575872418,20
3,868,16141,3575872398,3575872419,21
3,868,16142,3575872398,3575872419,21
3,868,16143,3575872398,3575872419,21
3,868,16144,3575872398,3575872420,22
3,868,16145,3575872398,3575872423,25
3,868,16146,3575872398,3575872423,25
3,868,16147,3575872398,3575872427,29
3,868,16148,3575872398,3575872428,30
3,868,16149,3575872398,3575872429,31
3,868,16150,3575872398,3575872430,32
3,868,16151,3575872398,3575872431,33
3,868,16152,3575872398,3575872432,34
3,868,16153,3575872398,3575872432,34
3,868,16154,3575872398,3575872434,36
3,868,16155,3575872398,3575872434,36
3,868,16156,3575872398,3575872435,37
3,868,16157,3575872398,3575872436,38
3,868,16158,3575872398,3575872436,38
3,868,16159,3575872398,3575872437,39
3,868,16160,3575872398,3575872438,40
3,868,16161,3575872398,3575872440,42
3,868,16162,3575872398,3575872440,42
3,868,16163,3575872398,3575872441,43
3,868,16164,3575872398,3575872441,43
3,868,16165,3575872398,3575872441,43
3,868,16166,3575872398,3575872441,43
3,868,16167,3575872398,3575872443,45
3,868,16168,3575872398,3575872444,46
3,868,16169,3575872398,3575872444,46
3,868,16170,3575872398,3575872446,48
3,868,16171,3575872398,3575872447,49
3,869,16172,3575872460,3575872460,0
3,869,16173,3575872460,3575872460,0
3,869,16174,3575872460,3575872460,0
3,869,16175,3575872460,3575872460,0
3,869,16176,3575872460,3575872460,0
3,869,16177,3575872460,3575872460,0
3,869,16178,3575872460,3575872460,0
3,869,16179,3575872460,3575872460,0
3,869,16180,3575872460,3575872461,1
3,869,16181,3575872460,3575872463,3
3,869,16182,3575872460,3575872463,3
3,869,16183,3575872460,3575872464,4
3,869,16184,3575872460,3575872465,5
3,869,16185,3575872460,3575872466,6
3,869,16186,3575872460,3575872466,6
3,869,16187,3575872460,3575872467,7
3,869,16188,3575872460,3575872468,8
3,869,16189,3575872460,3575872468,8
3,869,16190,3575872460,3575872469,9
3,869,16191,3575872460,3575872472,12
3,869,16192,3575872460,3575872478,18
3,869,16193,3575872460,3575872480,20
3,869,16194,3575872460,3575872480,20
3,869,16195,3575872460,3575872480,20
3,869,16196,3575872460,3575872481,21
3,869,16197,3575872460,3575872482,22
3,869,16198,3575872460,3575872483,23
3,869,16199,3575872460,3575872483,23
3,869,16200,3575872460,3575872485,25
3,869,16201,3575872460,3575872487,27
3,869,16202,3575872460,3575872488,28
3,869,16203,3575872460,3575872488,28
3,869,16204,3575872460,3575872488,28
3,869,16205,3575872460,3575872494,34
3,869,16206,3575872460,3575872494,34
3,869,16207,3575872460,3575872496,36
3,869,16208,3575872460,3575872497,37
3,869,16209,3575872460,3575872499,39
3,869,16210,3575872460,3575872500,40
3,869,16211,3575872460,3575872501,41
3,869,16212,3575872460,3575872501,41
3,869,16213,3575872460,3575872501,41
3,869,16214,3575872460,3575872504,44
3,869,16215,3575872460,3575872505,45
3,869,16216,3575872460,3575872507,47
3,869,16217,3575872460,3575872507,47
3,870,16218,3575872520,3575872520,0
3,870,16219,3575872520,3575872520,0
3,870,16220,3575872520,3575872520,0
3,870,16221,3575872520,3575872520,0
3,870,16222,3575872520,3575872520,0
3,870,16223,3575872520,3575872521,1
3,870,16224,3575872520,3575872521,1
3,870,16225,3575872520,3575872522,2
3,870,16226,3575872520,3575872523,3
3,870,16227,3575872520,3575872525,5
3,870,16228,3575872520,3575872526,6
3,870,16229,3575872520,3575872526,6
3,870,16230,3575872520,3575872527,7
3,870,16231,3575872520,3575872527,7
3,870,16232,3575872520,3575872534,14
3,870,16233,3575872520,3575872535,15
3,870,16234,3575872520,3575872536,16
3,870,16235,3575872520,3575872538,18
3,870,16236,3575872520,3575872542,22
3,870,16237,3575872520,3575872542,22
3,870,16238,3575872520,3575872543,23
3,870,16239,3575872520,3575872550,30
3,870,16240,3575872520,3575872554,34
3,870,16241,3575872520,3575872554,34
3,870,16242,3575872520,3575872557,37
3,870,16243,3575872520,3575872558,38
3,870,16244,3575872520,3575872559,39
3,870,16245,3575872520,3575872560,40
3,870,16246,3575872520,3575872565,45
3,870,16247,3575872520,3575872566,46
3,870,16248,3575872520,3575872568,48
3,870,16249,3575872520,3575872569,49
3,870,16250,3575872520,3575872569,49
3,871,16251,3575872581,3575872581,0
3,871,16252,3575872581,3575872581,0
3,871,16253,3575872581,3575872581,0
3,871,16254,3575872581,3575872581,0
3,871,16255,3575872581,3575872581,0
3,871,16256,3575872581,3575872581,0
3,871,16257,3575872581,3575872581,0
3,871,16258,3575872581,3575872581,0
3,871,16259,3575872581,3575872581,0
3,871,16260,3575872581,3575872581,0
3,871,16261,3575872581,3575872581,0
3,871,16262,3575872581,3575872582,1
3,871,16263,3575872581,3575872583,2
3,871,16264,3575872581,3575872585,4
3,871,16265,3575872581,3575872585,4
3,871,16266,3575872581,3575872586,5
3,871,16267,3575872581,3575872590,9
3,871,16268,3575872581,3575872592,11
3,871,16269,3575872581,3575872593,12
3,871,16270,3575872581,3575872594,13
3,871,16271,3575872581,3575872595,14
3,871,16272,3575872581,3575872595,14
3,871,16273,3575872581,3575872596,15
3,871,16274,3575872581,3575872596,15
3,871,16275,3575872581,3575872596,15
3,871,16276,3575872581,3575872597,16
3,871,16277,3575872581,3575872597,16
3,871,16278,3575872581,3575872598,17
3,871,16279,3575872581,3575872601,20
3,871,16280,3575872581,3575872602,21
3,871,16281,3575872581,3575872604,23
3,871,16282,3575872581,3575872605,24
3,871,16283,3575872581,3575872606,25
3,871,16284,3575872581,3575872607,26
3,871,16285,3575872581,3575872607,26
3,871,16286,3575872581,3575872610,29
3,871,16287,3575872581,3575872615,34
3,871,16288,3575872581,3575872615,34
3,871,16289,3575872581,3575872616,35
3,871,16290,3575872581,3575872616,35
3,871,16291,3575872581,3575872618,37
3,871,16292,3575872581,3575872618,37
3,871,16293,3575872581,3575872619,38
3,871,16294,3575872581,3575872619,38
3,871,16295,3575872581,3575872619,38
3,871,16296,3575872581,3575872622,41
3,871,16297,3575872581,3575872623,42
3,871,16298,3575872581,3575872625,44
3,871,16299,3575872581,3575872628,47
3,871,16300,3575872581,3575872628,47
3,871,16301,3575872581,3575872630,49
3,871,16302,3575872581,3575872631,50
3,872,16303,3575872641,3575872641,0
3,872,16304,3575872641,3575872641,0
3,872,16305,3575872641,3575872641,0
3,872,16306,3575872641,3575872641,0
3,872,16307,3575872641,3575872641,0
3,872,16308,3575872641,3575872641,0
3,872,16309,3575872641,3575872641,0
3,872,16310,3575872641,3575872641,0
3,872,16311,3575872641,3575872641,0
3,872,16312,3575872641,3575872641,0
3,872,16313,3575872641,3575872641,0
3,872,16314,3575872641,3575872641,0
3,872,16315,3575872641,3575872641,0
3,872,16316,3575872641,3575872641,0
3,872,16317,3575872641,3575872641,0
3,872,16318,3575872641,3575872643,2
3,872,16319,3575872641,3575872643,2
3,872,16320,3575872641,3575872643,2
3,872,16321,3575872641,3575872645,4
3,872,16322,3575872641,3575872646,5
3,872,16323,3575872641,3575872649,8
3,872,16324,3575872641,3575872651,10
3,872,16325,3575872641,3575872652,11
3,872,16326,3575872641,3575872653,12
3,872,16327,3575872641,3575872653,12
3,872,16328,3575872641,3575872655,14
3,872,16329,3575872641,3575872655,14
3,872,16330,3575872641,3575872656,15
3,872,16331,3575872641,3575872656,15
3,872,16332,3575872641,3575872659,18
3,872,16333,3575872641,3575872661,20
3,872,16334,3575872641,3575872661,20
3,872,16335,3575872641,3575872663,22
3,872,16336,3575872641,3575872664,23
3,872,16337,3575872641,3575872665,24
3,872,16338,3575872641,3575872665,24
3,872,16339,3575872641,3575872667,26
3,872,16340,3575872641,3575872667,26
3,872,16341,3575872641,3575872667,26
3,872,16342,3575872641,3575872668,27
3,872,16343,3575872641,3575872671,30
3,872,16344,3575872641,3575872673,32
3,872,16345,3575872641,3575872678,37
3,872,16346,3575872641,3575872679,38
3,872,16347,3575872641,3575872680,39
3,872,16348,3575872641,3575872680,39
3,872,16349,3575872641,3575872683,42
3,872,16350,3575872641,3575872683,42
3,872,16351,3575872641,3575872683,42
3,872,16352,3575872641,3575872685,44
3,872,16353,3575872641,3575872688,47
3,872,16354,3575872641,3575872688,47
3,872,16355,3575872641,3575872688,47
3,873,16356,3575872704,3575872704,0
3,873,16357,3575872704,3575872704,0
3,873,16358,3575872704,3575872704,0
3,873,16359,3575872704,3575872704,0
3,873,16360,3575872704,3575872704,0
3,873,16361,3575872704,3575872704,0
3,873,16362,3575872704,3575872704,0
3,873,16363,3575872704,3575872704,0
3,873,16364,3575872704,3575872704,0
3,873,16365,3575872704,3575872704,0
3,873,16366,3575872704,3575872707,3
3,873,16367,3575872704,3575872707,3
3,873,16368,3575872704,3575872711,7
3,873,16369,3575872704,3575872711,7
3,873,16370,3575872704,3575872712,8
3,873,16371,3575872704,3575872716,12
3,873,16372,3575872704,3575872717,13
3,873,16373,3575872704,3575872717,13
3,873,16374,3575872704,3575872721,17
3,873,16375,3575872704,3575872721,17
3,873,16376,3575872704,3575872723,19
3,873,16377,3575872704,3575872723,19
3,873,16378,3575872704,3575872725,21
3,873,16379,3575872704,3575872725,21
3,873,16380,3575872704,3575872726,22
3,873,16381,3575872704,3575872727,23
3,873,16382,3575872704,3575872728,24
3,873,16383,3575872704,3575872734,30
3,873,16384,3575872704,3575872734,30
3,873,16385,3575872704,3575872736,32
3,873,16386,3575872704,3575872738,34
3,873,16387,3575872704,3575872742,38
3,873,16388,3575872704,3575872742,38
3,873,16389,3575872704,3575872743,39
3,873,16390,3575872704,3575872744,40
3,873,16391,3575872704,3575872748,44
3,873,16392,3575872704,3575872751,47
3,874,16393,3575872765,3575872765,0
3,874,16394,3575872765,3575872765,0
3,874,16395,3575872765,3575872765,0
3,874,16396,3575872765,3575872765,0
3,874,16397,3575872765,3575872765,0
3,874,16398,3575872765,3575872765,0
3,874,16399,3575872765,3575872765,0
3,874,16400,3575872765,3575872767,2
3,874,16401,3575872765,3575872769,4
3,874,16402,3575872765,3575872769,4
3,874,16403,3575872765,3575872769,4
3,874,16404,3575872765,3575872770,5
3,874,16405,3575872765,3575872773,8
3,874,16406,3575872765,3575872775,10
3,874,16407,3575872765,3575872776,11
3,874,16408,3575872765,3575872779,14
3,874,16409,3575872765,3575872779,14
3,874,16410,3575872765,3575872779,14
3,874,16411,3575872765,3575872781,16
3,874,16412,3575872765,3575872781,16
3,874,16413,3575872765,3575872781,16
3,874,16414,3575872765,3575872783,18
3,874,16415,3575872765,3575872783,18
3,874,16416,3575872765,3575872783,18
3,874,16417,3575872765,3575872785,20
3,874,16418,3575872765,3575872785,20
3,874,16419,3575872765,3575872786,21
3,874,16420,3575872765,3575872790,25
3,874,16421,3575872765,3575872792,27
3,874,16422,3575872765,3575872792,27
3,874,16423,3575872765,3575872793,28
3,874,16424,3575872765,3575872795,30
3,874,16425,3575872765,3575872795,30
3,874,16426,3575872765,3575872795,30
3,874,16427,3575872765,3575872796,31
3,874,16428,3575872765,3575872796,31
3,874,16429,3575872765,3575872797,32
3,874,16430,3575872765,3575872797,32
3,874,16431,3575872765,3575872797,32
3,874,16432,3575872765,3575872799,34
3,874,16433,3575872765,3575872801,36
3,874,16434,3575872765,3575872803,38
3,874,16435,3575872765,3575872804,39
3,874,16436,3575872765,3575872805,40
3,874,16437,3575872765,3575872806,41
3,874,16438,3575872765,3575872807,42
3,874,16439,3575872765,3575872807,42
3,874,16440,3575872765,3575872807,42
3,874,16441,3575872765,3575872811,46
3,875,16442,3575872824,3575872824,0
3,875,16443,3575872824,3575872824,0
3,875,16444,3575872824,3575872824,0
3,875,16445,3575872824,3575872824,0
3,875,16446,3575872824,3575872824,0
3,875,16447,3575872824,3575872824,0
3,875,16448,3575872824,3575872824,0
3,875,16449,3575872824,3575872824,0
3,875,16450,3575872824,3575872825,1
3,875,16451,3575872824,3575872828,4
3,875,16452,3575872824,3575872829,5
3,875,16453,3575872824,3575872830,6
3,875,16454,3575872824,3575872831,7
3,875,16455,3575872824,3575872832,8
3,875,16456,3575872824,3575872832,8
3,875,16457,3575872824,3575872833,9
3,875,16458,3575872824,3575872833,9
3,875,16459,3575872824,3575872836,12
3,875,16460,3575872824,3575872836,12
3,875,16461,3575872824,3575872837,13
3,875,16462,3575872824,3575872838,14
3,875,16463,3575872824,3575872839,15
3,875,16464,3575872824,3575872839,15
3,875,16465,3575872824,3575872840,16
3,875,16466,3575872824,3575872840,16
3,875,16467,3575872824,3575872840,16
3,875,16468,3575872824,3575872841,17
3,875,16469,3575872824,3575872842,18
3,875,16470,3575872824,3575872843,19
3,875,16471,3575872824,3575872844,20
3,875,16472,3575872824,3575872845,21
3,875,16473,3575872824,3575872846,22
3,875,16474,3575872824,3575872848,24
3,875,16475,3575872824,3575872851,27
3,875,16476,3575872824,3575872853,29
3,875,16477,3575872824,3575872854,30
3,875,16478,3575872824,3575872854,30
3,875,16479,3575872824,3575872854,30
3,875,16480,3575872824,3575872856,32
3,875,16481,3575872824,3575872860,36
3,875,16482,3575872824,3575872861,37
3,875,16483,3575872824,3575872862,38
3,875,16484,3575872824,3575872862,38
3,875,16485,3575872824,3575872863,39
3,875,16486,3575872824,3575872866,42
3,875,16487,3575872824,3575872866,42
3,875,16488,3575872824,3575872867,43
3,875,16489,3575872824,3575872867,43
3,875,16490,3575872824,3575872867,43
3,875,16491,3575872824,3575872868,44
3,875,16492,3575872824,3575872872,48
3,876,16493,3575872881,3575872881,0
3,876,16494,3575872881,3575872881,0
3,876,16495,3575872881,3575872881,0
3,876,16496,3575872881,3575872881,0
3,876,16497,3575872881,3575872881,0
3,876,16498,3575872881,3575872881,0
3,876,16499,3575872881,3575872883,2
3,876,16500,3575872881,3575872883,2
3,876,16501,3575872881,3575872883,2
3,876,16502,3575872881,3575872885,4
3,876,16503,3575872881,3575872886,5
3,876,16504,3575872881,3575872888,7
3,876,16505,3575872881,3575872889,8
3,876,16506,3575872881,3575872889,8
3,876,16507,3575872881,3575872889,8
3,876,16508,3575872881,3575872894,13
3,876,16509,3575872881,3575872895,14
3,876,16510,3575872881,3575872896,15
3,876,16511,3575872881,3575872896,15
3,876,16512,3575872881,3575872900,19
3,876,16513,3575872881,3575872901,20
3,876,16514,3575872881,3575872901,20
3,876,16515,3575872881,3575872902,21
3,876,16516,3575872881,3575872902,21
3,876,16517,3575872881,3575872905,24
3,876,16518,3575872881,3575872907,26
3,876,16519,3575872881,3575872911,30
3,876,16520,3575872881,3575872911,30
3,876,16521,3575872881,3575872912,31
3,876,16522,3575872881,3575872917,36
3,876,16523,3575872881,3575872921,40
3,876,16524,3575872881,3575872921,40
3,876,16525,3575872881,3575872923,42
3,876,16526,3575872881,3575872924,43
3,876,16527,3575872881,3575872925,44
3,876,16528,3575872881,3575872926,45
3,876,16529,3575872881,3575872927,46
3,877,16530,3575872938,3575872938,0
3,877,16531,3575872938,3575872938,0
3,877,16532,3575872938,3575872939,1
3,877,16533,3575872938,3575872942,4
3,877,16534,3575872938,3575872942,4
3,877,16535,3575872938,3575872943,5
3,877,16536,3575872938,3575872943,5
3,877,16537,3575872938,3575872945,7
3,877,16538,3575872938,3575872949,11
3,877,16539,3575872938,3575872951,13
3,877,16540,3575872938,3575872954,16
3,877,16541,3575872938,3575872955,17
3,877,16542,3575872938,3575872958,20
3,877,16543,3575872938,3575872958,20
3,877,16544,3575872938,3575872960,22
3,877,16545,3575872938,3575872964,26
3,877,16546,3575872938,3575872965,27
3,877,16547,3575872938,3575872967,29
3,877,16548,3575872938,3575872969,31
3,877,16549,3575872938,3575872969,31
3,877,16550,3575872938,3575872969,31
3,877,16551,3575872938,3575872973,35
3,877,16552,3575872938,3575872975,37
3,877,16553,3575872938,3575872975,37
3,877,16554,3575872938,3575872976,38
3,877,16555,3575872938,3575872979,41
3,877,16556,3575872938,3575872979,41
3,877,16557,3575872938,3575872979,41
3,877,16558,3575872938,3575872980,42
3,877,16559,3575872938,3575872980,42
3,877,16560,3575872938,3575872981,43
3,877,16561,3575872938,3575872982,44
3,877,16562,3575872938,3575872983,45
3,877,16563,3575872938,3575872986,48
3,877,16564,3575872938,3575872986,48
3,877,16565,3575872938,3575872988,50
3,878,16566,3575872996,3575872996,0
3,878,16567,3575872996,3575872996,0
3,878,16568,3575872996,3575872996,0
3,878,16569,3575872996,3575872996,0
3,878,16570,3575872996,3575872996,0
3,878,16571,3575872996,3575872996,0
3,878,16572,3575872996,3575872996,0
3,878,16573,3575872996,3575872996,0
3,878,16574,3575872996,3575872996,0
3,878,16575,3575872996,3575872997,1
3,878,16576,3575872996,3575872997,1
3,878,16577,3575872996,3575872997,1
3,878,16578,3575872996,3575872998,2
3,878,16579,3575872996,3575872999,3
3,878,16580,3575872996,3575873001,5
3,878,16581,3575872996,3575873003,7
3,878,16582,3575872996,3575873004,8
3,878,16583,3575872996,3575873004,8
3,878,16584,3575872996,3575873006,10
3,878,16585,3575872996,3575873006,10
3,878,16586,3575872996,3575873007,11
3,878,16587,3575872996,3575873008,12
3,878,16588,3575872996,3575873012,16
3,878,16589,3575872996,3575873016,20
3,878,16590,3575872996,3575873016,20
3,878,16591,3575872996,3575873018,22
3,878,16592,3575872996,3575873020,24
3,878,16593,3575872996,3575873020,24
3,878,16594,3575872996,3575873020,24
3,878,16595,3575872996,3575873020,24
3,878,16596,3575872996,3575873023,27
3,878,16597,3575872996,3575873024,28
3,878,16598,3575872996,3575873025,29
3,878,16599,3575872996,3575873028,32
3,878,16600,3575872996,3575873029,33
3,878,16601,3575872996,3575873029,33
3,878,16602,3575872996,3575873032,36
3,878,16603,3575872996,3575873032,36
3,878,16604,3575872996,3575873032,36
3,878,16605,3575872996,3575873033,37
3,878,16606,3575872996,3575873033,37
3,878,16607,3575872996,3575873035,39
3,878,16608,3575872996,3575873036,40
3,878,16609,3575872996,3575873037,41
3,878,16610,3575872996,3575873037,41
3,878,16611,3575872996,3575873037,41
3,878,16612,3575872996,3575873039,43
3,878,16613,3575872996,3575873039,43
3,878,16614,3575872996,3575873040,44
3,878,16615,3575872996,3575873040,44
3,878,16616,3575872996,3575873040,44
3,878,16617,3575872996,3575873041,45
3,878,16618,3575872996,3575873043,47
3,878,16619,3575872996,3575873044,48
3,878,16620,3575872996,3575873044,48
3,878,16621,3575872996,3575873045,49
3,878,16622,3575872996,3575873046,50
3,879,16623,3575873058,3575873058,0
3,879,16624,3575873058,3575873058,0
3,879,16625,3575873058,3575873058,0
3,879,16626,3575873058,3575873058,0
3,879,16627,3575873058,3575873058,0
3,879,16628,3575873058,3575873058,0
3,879,16629,3575873058,3575873058,0
3,879,16630,3575873058,3575873058,0
3,879,16631,3575873058,3575873059,1
3,879,16632,3575873058,3575873061,3
3,879,16633,3575873058,3575873063,5
3,879,16634,3575873058,3575873063,5
3,879,16635,3575873058,3575873064,6
3,879,16636,3575873058,3575873065,7
3,879,16637,3575873058,3575873066,8
3,879,16638,3575873058,3575873066,8
3,879,16639,3575873058,3575873067,9
3,879,16640,3575873058,3575873067,9
3,879,16641,3575873058,3575873067,9
3,879,16642,3575873058,3575873068,10
3,879,16643,3575873058,3575873072,14
3,879,16644,3575873058,3575873073,15
3,879,16645,3575873058,3575873078,20
3,879,16646,3575873058,3575873079,21
3,879,16647,3575873058,3575873080,22
3,879,16648,3575873058,3575873081,23
3,879,16649,3575873058,3575873081,23
3,879,16650,3575873058,3575873083,25
3,879,16651,3575873058,3575873083,25
3,879,16652,3575873058,3575873084,26
3,879,16653,3575873058,3575873085,27
3,879,16654,3575873058,3575873087,29
3,879,16655,3575873058,3575873088,30
3,879,16656,3575873058,3575873089,31
3,879,16657,3575873058,3575873089,31
3,879,16658,3575873058,3575873089,31
3,879,16659,3575873058,3575873095,37
3,879,16660,3575873058,3575873097,39
3,879,16661,3575873058,3575873097,39
3,879,16662,3575873058,3575873098,40
3,879,16663,3575873058,3575873100,42
3,879,16664,3575873058,3575873101,43
3,879,16665,3575873058,3575873101,43
3,879,16666,3575873058,3575873102,44
3,879,16667,3575873058,3575873102,44
3,879,16668,3575873058,3575873103,45
3,879,16669,3575873058,3575873103,45
3,879,16670,3575873058,3575873105,47
3,879,16671,3575873058,3575873107,49
3,879,16672,3575873058,3575873108,50
3,880,16673,3575873121,3575873121,0
3,880,16674,3575873121,3575873121,0
3,880,16675,3575873121,3575873121,0
3,880,16676,3575873121,3575873121,0
3,880,16677,3575873121,3575873121,0
3,880,16678,3575873121,3575873121,0
3,880,16679,3575873121,3575873121,0
3,880,16680,3575873121,3575873122,1
3,880,16681,3575873121,3575873124,3
3,880,16682,3575873121,3575873124,3
3,880,16683,3575873121,3575873125,4
3,880,16684,3575873121,3575873127,6
3,880,16685,3575873121,3575873127,6
3,880,16686,3575873121,3575873127,6
3,880,16687,3575873121,3575873135,14
3,880,16688,3575873121,3575873136,15
3,880,16689,3575873121,3575873137,16
3,880,16690,3575873121,3575873139,18
3,880,16691,3575873121,3575873142,21
3,880,16692,3575873121,3575873143,22
3,880,16693,3575873121,3575873143,22
3,880,16694,3575873121,3575873143,22
3,880,16695,3575873121,3575873145,24
3,880,16696,3575873121,3575873149,28
3,880,16697,3575873121,3575873151,30
3,880,16698,3575873121,3575873151,30
3,880,16699,3575873121,3575873154,33
3,880,16700,3575873121,3575873155,34
3,880,16701,3575873121,3575873158,37
3,880,16702,3575873121,3575873159,38
3,880,16703,3575873121,3575873160,39
3,880,16704,3575873121,3575873161,40
3,880,16705,3575873121,3575873163,42
3,880,16706,3575873121,3575873166,45
3,880,16707,3575873121,3575873167,46
3,880,16708,3575873121,3575873169,48
3,880,16709,3575873121,3575873170,49
3,880,16710,3575873121,3575873170,49
3,881,16711,3575873180,3575873180,0
3,881,16712,3575873180,3575873180,0
3,881,16713,3575873180,3575873180,0
3,881,16714,3575873180,3575873180,0
3,881,16715,3575873180,3575873180,0
3,881,16716,3575873180,3575873180,0
3,881,16717,3575873180,3575873180,0
3,881,16718,3575873180,3575873180,0
3,881,16719,3575873180,3575873180,0
3,881,16720,3575873180,3575873181,1
3,881,16721,3575873180,3575873181,1
3,881,16722,3575873180,3575873182,2
3,881,16723,3575873180,3575873183,3
3,881,16724,3575873180,3575873183,3
3,881,16725,3575873180,3575873186,6
3,881,16726,3575873180,3575873187,7
3,881,16727,3575873180,3575873188,8
3,881,16728,3575873180,3575873192,12
3,881,16729,3575873180,3575873192,12
3,881,16730,3575873180,3575873194,14
3,881,16731,3575873180,3575873194,14
3,881,16732,3575873180,3575873195,15
3,881,16733,3575873180,3575873195,15
3,881,16734,3575873180,3575873196,16
3,881,16735,3575873180,3575873197,17
3,881,16736,3575873180,3575873197,17
3,881,16737,3575873180,3575873197,17
3,881,16738,3575873180,3575873197,17
3,881,16739,3575873180,3575873197,17
3,881,16740,3575873180,3575873199,19
3,881,16741,3575873180,3575873201,21
3,881,16742,3575873180,3575873203,23
3,881,16743,3575873180,3575873204,24
3,881,16744,3575873180,3575873205,25
3,881,16745,3575873180,3575873206,26
3,881,16746,3575873180,3575873206,26
3,881,16747,3575873180,3575873207,27
3,881,16748,3575873180,3575873208,28
3,881,16749,3575873180,3575873212,32
3,881,16750,3575873180,3575873216,36
3,881,16751,3575873180,3575873217,37
3,881,16752,3575873180,3575873218,38
3,881,16753,3575873180,3575873218,38
3,881,16754,3575873180,3575873219,39
3,881,16755,3575873180,3575873220,40
3,881,16756,3575873180,3575873220,40
3,881,16757,3575873180,3575873223,43
3,881,16758,3575873180,3575873225,45
3,881,16759,3575873180,3575873228,48
3,881,16760,3575873180,3575873229,49
3,881,16761,3575873180,3575873230,50
3,882,16762,3575873241,3575873241,0
3,882,16763,3575873241,3575873241,0
3,882,16764,3575873241,3575873241,0
3,882,16765,3575873241,3575873241,0
3,882,16766,3575873241,3575873241,0
3,882,16767,3575873241,3575873241,0
3,882,16768,3575873241,3575873241,0
3,882,16769,3575873241,3575873241,0
3,882,16770,3575873241,3575873241,0
3,882,16771,3575873241,3575873241,0
3,882,16772,3575873241,3575873241,0
3,882,16773,3575873241,3575873241,0
3,882,16774,3575873241,3575873241,0
3,882,16775,3575873241,3575873242,1
3,882,16776,3575873241,3575873243,2
3,882,16777,3575873241,3575873243,2
3,882,16778,3575873241,3575873243,2
3,882,16779,3575873241,3575873246,5
3,882,16780,3575873241,3575873246,5
3,882,16781,3575873241,3575873249,8
3,882,16782,3575873241,3575873252,11
3,882,16783,3575873241,3575873253,12
3,882,16784,3575873241,3575873254,13
3,882,16785,3575873241,3575873254,13
3,882,16786,3575873241,3575873256,15
3,882,16787,3575873241,3575873257,16
3,882,16788,3575873241,3575873260,19
3,882,16789,3575873241,3575873261,20
3,882,16790,3575873241,3575873263,22
3,882,16791,3575873241,3575873264,23
3,882,16792,3575873241,3575873266,25
3,882,16793,3575873241,3575873266,25
3,882,16794,3575873241,3575873267,26
3,882,16795,3575873241,3575873267,26
3,882,16796,3575873241,3575873268,27
3,882,16797,3575873241,3575873269,28
3,882,16798,3575873241,3575873272,31
3,882,16799,3575873241,3575873278,37
3,882,16800,3575873241,3575873279,38
3,882,16801,3575873241,3575873279,38
3,882,16802,3575873241,3575873281,40
3,882,16803,3575873241,3575873281,40
3,882,16804,3575873241,3575873283,42
3,882,16805,3575873241,3575873283,42
3,882,16806,3575873241,3575873284,43
3,882,16807,3575873241,3575873287,46
3,882,16808,3575873241,3575873288,47
3,882,16809,3575873241,3575873289,48
3,882,16810,3575873241,3575873289,48
3,882,16811,3575873241,3575873290,49
3,883,16812,3575873300,3575873300,0
3,883,16813,3575873300,3575873300,0
3,883,16814,3575873300,3575873300,0
3,883,16815,3575873300,3575873300,0
3,883,16816,3575873300,3575873300,0
3,883,16817,3575873300,3575873301,1
3,883,16818,3575873300,3575873301,1
3,883,16819,3575873300,3575873302,2
3,883,16820,3575873300,3575873302,2
3,883,16821,3575873300,3575873302,2
3,883,16822,3575873300,3575873303,3
3,883,16823,3575873300,3575873305,5
3,883,16824,3575873300,3575873307,7
3,883,16825,3575873300,3575873307,7
3,883,16826,3575873300,3575873311,11
3,883,16827,3575873300,3575873313,13
3,883,16828,3575873300,3575873314,14
3,883,16829,3575873300,3575873317,17
3,883,16830,3575873300,3575873317,17
3,883,16831,3575873300,3575873318,18
3,883,16832,3575873300,3575873321,21
3,883,16833,3575873300,3575873322,22
3,883,16834,3575873300,3575873324,24
3,883,16835,3575873300,3575873324,24
3,883,16836,3575873300,3575873325,25
3,883,16837,3575873300,3575873326,26
3,883,16838,3575873300,3575873327,27
3,883,16839,3575873300,3575873327,27
3,883,16840,3575873300,3575873336,36
3,883,16841,3575873300,3575873337,37
3,883,16842,3575873300,3575873339,39
3,883,16843,3575873300,3575873342,42
3,883,16844,3575873300,3575873342,42
3,883,16845,3575873300,3575873343,43
3,883,16846,3575873300,3575873344,44
3,883,16847,3575873300,3575873346,46
3,883,16848,3575873300,3575873349,49
3,883,16849,3575873300,3575873350,50
3,884,16850,3575873361,3575873361,0
3,884,16851,3575873361,3575873361,0
3,884,16852,3575873361,3575873361,0
3,884,16853,3575873361,3575873364,3
3,884,16854,3575873361,3575873365,4
3,884,16855,3575873361,3575873367,6
3,884,16856,3575873361,3575873368,7
3,884,16857,3575873361,3575873369,8
3,884,16858,3575873361,3575873370,9
3,884,16859,3575873361,3575873370,9
3,884,16860,3575873361,3575873372,11
3,884,16861,3575873361,3575873373,12
3,884,16862,3575873361,3575873375,14
3,884,16863,3575873361,3575873375,14
3,884,16864,3575873361,3575873376,15
3,884,16865,3575873361,3575873378,17
3,884,16866,3575873361,3575873379,18
3,884,16867,3575873361,3575873379,18
3,884,16868,3575873361,3575873380,19
3,884,16869,3575873361,3575873380,19
3,884,16870,3575873361,3575873380,19
3,884,16871,3575873361,3575873381,20
3,884,16872,3575873361,3575873382,21
3,884,16873,3575873361,3575873384,23
3,884,16874,3575873361,3575873386,25
3,884,16875,3575873361,3575873388,27
3,884,16876,3575873361,3575873392,31
3,884,16877,3575873361,3575873392,31
3,884,16878,3575873361,3575873392,31
3,884,16879,3575873361,3575873394,33
3,884,16880,3575873361,3575873395,34
3,884,16881,3575873361,3575873395,34
3,884,16882,3575873361,3575873396,35
3,884,16883,3575873361,3575873396,35
3,884,16884,3575873361,3575873397,36
3,884,16885,3575873361,3575873397,36
3,884,16886,3575873361,3575873397,36
3,884,16887,3575873361,3575873397,36
3,884,16888,3575873361,3575873398,37
3,884,16889,3575873361,3575873399,38
3,884,16890,3575873361,3575873401,40
3,884,16891,3575873361,3575873403,42
3,884,16892,3575873361,3575873404,43
3,884,16893,3575873361,3575873405,44
3,884,16894,3575873361,3575873406,45
3,884,16895,3575873361,3575873406,45
3,884,16896,3575873361,3575873408,47
3,885,16897,3575873422,3575873422,0
3,885,16898,3575873422,3575873422,0
3,885,16899,3575873422,3575873422,0
3,885,16900,3575873422,3575873422,0
3,885,16901,3575873422,3575873422,0
3,885,16902,3575873422,3575873422,0
3,885,16903,3575873422,3575873422,0
3,885,16904,3575873422,3575873423,1
3,885,16905,3575873422,3575873427,5
3,885,16906,3575873422,3575873428,6
3,885,16907,3575873422,3575873429,7
3,885,16908,3575873422,3575873430,8
3,885,16909,3575873422,3575873432,10
3,885,16910,3575873422,3575873433,11
3,885,16911,3575873422,3575873434,12
3,885,16912,3575873422,3575873434,12
3,885,16913,3575873422,3575873436,14
3,885,16914,3575873422,3575873436,14
3,885,16915,3575873422,3575873437,15
3,885,16916,3575873422,3575873438,16
3,885,16917,3575873422,3575873438,16
3,885,16918,3575873422,3575873438,16
3,885,16919,3575873422,3575873439,17
3,885,16920,3575873422,3575873439,17
3,885,16921,3575873422,3575873440,18
3,885,16922,3575873422,3575873440,18
3,885,16923,3575873422,3575873441,19
3,885,16924,3575873422,3575873442,20
3,885,16925,3575873422,3575873443,21
3,885,16926,3575873422,3575873444,22
3,885,16927,3575873422,3575873444,22
3,885,16928,3575873422,3575873446,24
3,885,16929,3575873422,3575873446,24
3,885,16930,3575873422,3575873449,27
3,885,16931,3575873422,3575873452,30
3,885,16932,3575873422,3575873453,31
3,885,16933,3575873422,3575873454,32
3,885,16934,3575873422,3575873454,32
3,885,16935,3575873422,3575873455,33
3,885,16936,3575873422,3575873455,33
3,885,16937,3575873422,3575873457,35
3,885,16938,3575873422,3575873458,36
3,885,16939,3575873422,3575873460,38
3,885,16940,3575873422,3575873461,39
3,885,16941,3575873422,3575873463,41
3,885,16942,3575873422,3575873463,41
3,885,16943,3575873422,3575873464,42
3,885,16944,3575873422,3575873465,43
3,885,16945,3575873422,3575873466,44
3,885,16946,3575873422,3575873467,45
3,885,16947,3575873422,3575873467,45
3,885,16948,3575873422,3575873467,45
3,885,16949,3575873422,3575873468,46
3,885,16950,3575873422,3575873469,47
3,885,16951,3575873422,3575873469,47
3,885,16952,3575873422,3575873472,50
3,886,16953,3575873483,3575873483,0
3,886,16954,3575873483,3575873483,0
3,886,16955,3575873483,3575873483,0
3,886,16956,3575873483,3575873483,0
3,886,16957,3575873483,3575873483,0
3,886,16958,3575873483,3575873483,0
3,886,16959,3575873483,3575873484,1
3,886,16960,3575873483,3575873484,1
3,886,16961,3575873483,3575873486,3
3,886,16962,3575873483,3575873486,3
3,886,16963,3575873483,3575873488,5
3,886,16964,3575873483,3575873488,5
3,886,16965,3575873483,3575873490,7
3,886,16966,3575873483,3575873494,11
3,886,16967,3575873483,3575873494,11
3,886,16968,3575873483,3575873495,12
3,886,16969,3575873483,3575873496,13
3,886,16970,3575873483,3575873497,14
3,886,16971,3575873483,3575873500,17
3,886,16972,3575873483,3575873500,17
3,886,16973,3575873483,3575873500,17
3,886,16974,3575873483,3575873501,18
3,886,16975,3575873483,3575873501,18
3,886,16976,3575873483,3575873501,18
3,886,16977,3575873483,3575873502,19
3,886,16978,3575873483,3575873504,21
3,886,16979,3575873483,3575873506,23
3,886,16980,3575873483,3575873507,24
3,886,16981,3575873483,3575873511,28
3,886,16982,3575873483,3575873512,29
3,886,16983,3575873483,3575873513,30
3,886,16984,3575873483,3575873516,33
3,886,16985,3575873483,3575873516,33
3,886,16986,3575873483,3575873516,33
3,886,16987,3575873483,3575873520,37
3,886,16988,3575873483,3575873521,38
3,886,16989,3575873483,3575873522,39
3,886,16990,3575873483,3575873524,41
3,886,16991,3575873483,3575873525,42
3,886,16992,3575873483,3575873526,43
3,886,16993,3575873483,3575873527,44
3,886,16994,3575873483,3575873528,45
3,887,16995,3575873544,3575873544,0
3,887,16996,3575873544,3575873544,0
3,887,16997,3575873544,3575873544,0
3,887,16998,3575873544,3575873544,0
3,887,16999,3575873544,3575873544,0
3,887,17000,3575873544,3575873544,0
3,887,17001,3575873544,3575873544,0
3,887,17002,3575873544,3575873544,0
3,887,17003,3575873544,3575873545,1
3,887,17004,3575873544,3575873548,4
3,887,17005,3575873544,3575873550,6
3,887,17006,3575873544,3575873551,7
3,887,17007,3575873544,3575873555,11
3,887,17008,3575873544,3575873557,13
3,887,17009,3575873544,3575873557,13
3,887,17010,3575873544,3575873562,18
3,887,17011,3575873544,3575873564,20
3,887,17012,3575873544,3575873567,23
3,887,17013,3575873544,3575873569,25
3,887,17014,3575873544,3575873569,25
3,887,17015,3575873544,3575873569,25
3,887,17016,3575873544,3575873570,26
3,887,17017,3575873544,3575873570,26
3,887,17018,3575873544,3575873571,27
3,887,17019,3575873544,3575873574,30
3,887,17020,3575873544,3575873576,32
3,887,17021,3575873544,3575873576,32
3,887,17022,3575873544,3575873578,34
3,887,17023,3575873544,3575873578,34
3,887,17024,3575873544,3575873579,35
3,887,17025,3575873544,3575873580,36
3,887,17026,3575873544,3575873580,36
3,887,17027,3575873544,3575873581,37
3,887,17028,3575873544,3575873581,37
3,887,17029,3575873544,3575873582,38
3,887,17030,3575873544,3575873583,39
3,887,17031,3575873544,3575873586,42
3,887,17032,3575873544,3575873586,42
3,887,17033,3575873544,3575873586,42
3,887,17034,3575873544,3575873590,46
3,887,17035,3575873544,3575873591,47
3,887,17036,3575873544,3575873593,49
3,887,17037,3575873544,3575873594,50
3,888,17038,3575873605,3575873605,0
3,888,17039,3575873605,3575873605,0
3,888,17040,3575873605,3575873605,0
3,888,17041,3575873605,3575873605,0
3,888,17042,3575873605,3575873605,0
3,888,17043,3575873605,3575873605,0
3,888,17044,3575873605,3575873605,0
3,888,17045,3575873605,3575873605,0
3,888,17046,3575873605,3575873605,0
3,888,17047,3575873605,3575873605,0
3,888,17048,3575873605,3575873605,0
3,888,17049,3575873605,3575873605,0
3,888,17050,3575873605,3575873605,0
3,888,17051,3575873605,3575873605,0
3,888,17052,3575873605,3575873606,1
3,888,17053,3575873605,3575873607,2
3,888,17054,3575873605,3575873611,6
3,888,17055,3575873605,3575873614,9
3,888,17056,3575873605,3575873615,10
3,888,17057,3575873605,3575873616,11
3,888,17058,3575873605,3575873619,14
3,888,17059,3575873605,3575873619,14
3,888,17060,3575873605,3575873619,14
3,888,17061,3575873605,3575873620,15
3,888,17062,3575873605,3575873622,17
3,888,17063,3575873605,3575873624,19
3,888,17064,3575873605,3575873626,21
3,888,17065,3575873605,3575873627,22
3,888,17066,3575873605,3575873628,23
3,888,17067,3575873605,3575873630,25
3,888,17068,3575873605,3575873631,26
3,888,17069,3575873605,3575873632,27
3,888,17070,3575873605,3575873633,28
3,888,17071,3575873605,3575873634,29
3,888,17072,3575873605,3575873636,31
3,888,17073,3575873605,3575873636,31
3,888,17074,3575873605,3575873637,32
3,888,17075,3575873605,3575873637,32
3,888,17076,3575873605,3575873637,32
3,888,17077,3575873605,3575873638,33
3,888,17078,3575873605,3575873638,33
3,888,17079,3575873605,3575873639,34
3,888,17080,3575873605,3575873639,34
3,888,17081,3575873605,3575873639,34
3,888,17082,3575873605,3575873641,36
3,888,17083,3575873605,3575873642,37
3,888,17084,3575873605,3575873643,38
3,888,17085,3575873605,3575873643,38
3,888,17086,3575873605,3575873645,40
3,888,17087,3575873605,3575873646,41
3,888,17088,3575873605,3575873648,43
3,888,17089,3575873605,3575873651,46
3,888,17090,3575873605,3575873652,47
3,888,17091,3575873605,3575873653,48
3,888,17092,3575873605,3575873654,49
3,888,17093,3575873605,3575873654,49
3,889,17094,3575873663,3575873663,0
3,889,17095,3575873663,3575873663,0
3,889,17096,3575873663,3575873663,0
3,889,17097,3575873663,3575873663,0
3,889,17098,3575873663,3575873663,0
3,889,17099,3575873663,3575873663,0
3,889,17100,3575873663,3575873663,0
3,889,17101,3575873663,3575873663,0
3,889,17102,3575873663,3575873666,3
3,889,17103,3575873663,3575873666,3
3,889,17104,3575873663,3575873667,4
3,889,17105,3575873663,3575873667,4
3,889,17106,3575873663,3575873668,5
3,889,17107,3575873663,3575873669,6
3,889,17108,3575873663,3575873672,9
3,889,17109,3575873663,3575873673,10
3,889,17110,3575873663,3575873678,15
3,889,17111,3575873663,3575873678,15
3,889,17112,3575873663,3575873679,16
3,889,17113,3575873663,3575873680,17
3,889,17114,3575873663,3575873680,17
3,889,17115,3575873663,3575873680,17
3,889,17116,3575873663,3575873682,19
3,889,17117,3575873663,3575873683,20
3,889,17118,3575873663,3575873684,21
3,889,17119,3575873663,3575873685,22
3,889,17120,3575873663,3575873686,23
3,889,17121,3575873663,3575873686,23
3,889,17122,3575873663,3575873688,25
3,889,17123,3575873663,3575873689,26
3,889,17124,3575873663,3575873690,27
3,889,17125,3575873663,3575873694,31
3,889,17126,3575873663,3575873695,32
3,889,17127,3575873663,3575873695,32
3,889,17128,3575873663,3575873698,35
3,889,17129,3575873663,3575873700,37
3,889,17130,3575873663,3575873700,37
3,889,17131,3575873663,3575873700,37
3,889,17132,3575873663,3575873701,38
3,889,17133,3575873663,3575873701,38
3,889,17134,3575873663,3575873702,39
3,889,17135,3575873663,3575873702,39
3,889,17136,3575873663,3575873704,41
3,889,17137,3575873663,3575873707,44
3,889,17138,3575873663,3575873711,48
3,889,17139,3575873663,3575873711,48
3,889,17140,3575873663,3575873713,50
3,890,17141,3575873723,3575873723,0
3,890,17142,3575873723,3575873723,0
3,890,17143,3575873723,3575873723,0
3,890,17144,3575873723,3575873723,0
3,890,17145,3575873723,3575873723,0
3,890,17146,3575873723,3575873724,1
3,890,17147,3575873723,3575873725,2
3,890,17148,3575873723,3575873726,3
3,890,17149,3575873723,3575873727,4
3,890,17150,3575873723,3575873727,4
3,890,17151,3575873723,3575873729,6
3,890,17152,3575873723,3575873736,13
3,890,17153,3575873723,3575873737,14
3,890,17154,3575873723,3575873738,15
3,890,17155,3575873723,3575873741,18
3,890,17156,3575873723,3575873741,18
3,890,17157,3575873723,3575873742,19
3,890,17158,3575873723,3575873743,20
3,890,17159,3575873723,3575873746,23
3,890,17160,3575873723,3575873748,25
3,890,17161,3575873723,3575873750,27
3,890,17162,3575873723,3575873754,31
3,890,17163,3575873723,3575873755,32
3,890,17164,3575873723,3575873757,34
3,890,17165,3575873723,3575873761,38
3,890,17166,3575873723,3575873763,40
3,890,17167,3575873723,3575873764,41
3,890,17168,3575873723,3575873766,43
3,890,17169,3575873723,3575873767,44
3,890,17170,3575873723,3575873768,45
3,890,17171,3575873723,3575873769,46
3,890,17172,3575873723,3575873769,46
3,890,17173,3575873723,3575873771,48
3,891,17174,3575873783,3575873783,0
3,891,17175,3575873783,3575873783,0
3,891,17176,3575873783,3575873783,0
3,891,17177,3575873783,3575873783,0
3,891,17178,3575873783,3575873783,0
3,891,17179,3575873783,3575873783,0
3,891,17180,3575873783,3575873783,0
3,891,17181,3575873783,3575873783,0
3,891,17182,3575873783,3575873783,0
3,891,17183,3575873783,3575873785,2
3,891,17184,3575873783,3575873786,3
3,891,17185,3575873783,3575873786,3
3,891,17186,3575873783,3575873791,8
3,891,17187,3575873783,3575873791,8
3,891,17188,3575873783,3575873793,10
3,891,17189,3575873783,3575873794,11
3,891,17190,3575873783,3575873795,12
3,891,17191,3575873783,3575873795,12
3,891,17192,3575873783,3575873796,13
3,891,17193,3575873783,3575873796,13
3,891,17194,3575873783,3575873796,13
3,891,17195,3575873783,3575873796,13
3,891,17196,3575873783,3575873797,14
3,891,17197,3575873783,3575873799,16
3,891,17198,3575873783,3575873799,16
3,891,17199,3575873783,3575873801,18
3,891,17200,3575873783,3575873803,20
3,891,17201,3575873783,3575873803,20
3,891,17202,3575873783,3575873804,21
3,891,17203,3575873783,3575873805,22
3,891,17204,3575873783,3575873808,25
3,891,17205,3575873783,3575873810,27
3,891,17206,3575873783,3575873815,32
3,891,17207,3575873783,3575873815,32
3,891,17208,3575873783,3575873816,33
3,891,17209,3575873783,3575873818,35
3,891,17210,3575873783,3575873819,36
3,891,17211,3575873783,3575873819,36
3,891,17212,3575873783,3575873819,36
3,891,17213,3575873783,3575873820,37
3,891,17214,3575873783,3575873825,42
3,891,17215,3575873783,3575873827,44
3,891,17216,3575873783,3575873830,47
3,891,17217,3575873783,3575873831,48
3,891,17218,3575873783,3575873832,49
3,892,17219,3575873844,3575873844,0
3,892,17220,3575873844,3575873844,0
3,892,17221,3575873844,3575873844,0
3,892,17222,3575873844,3575873844,0
3,892,17223,3575873844,3575873844,0
3,892,17224,3575873844,3575873844,0
3,892,17225,3575873844,3575873844,0
3,892,17226,3575873844,3575873844,0
3,892,17227,3575873844,3575873844,0
3,892,17228,3575873844,3575873844,0
3,892,17229,3575873844,3575873844,0
3,892,17230,3575873844,3575873844,0
3,892,17231,3575873844,3575873844,0
3,892,17232,3575873844,3575873844,0
3,892,17233,3575873844,3575873844,0
3,892,17234,3575873844,3575873844,0
3,892,17235,3575873844,3575873844,0
3,892,17236,3575873844,3575873845,1
3,892,17237,3575873844,3575873846,2
3,892,17238,3575873844,3575873848,4
3,892,17239,3575873844,3575873852,8
3,892,17240,3575873844,3575873853,9
3,892,17241,3575873844,3575873853,9
3,892,17242,3575873844,3575873854,10
3,892,17243,3575873844,3575873855,11
3,892,17244,3575873844,3575873858,14
3,892,17245,3575873844,3575873859,15
3,892,17246,3575873844,3575873859,15
3,892,17247,3575873844,3575873861,17
3,892,17248,3575873844,3575873861,17
3,892,17249,3575873844,3575873862,18
3,892,17250,3575873844,3575873863,19
3,892,17251,3575873844,3575873865,21
3,892,17252,3575873844,3575873866,22
3,892,17253,3575873844,3575873866,22
3,892,17254,3575873844,3575873867,23
3,892,17255,3575873844,3575873867,23
3,892,17256,3575873844,3575873868,24
3,892,17257,3575873844,3575873870,26
3,892,17258,3575873844,3575873872,28
3,892,17259,3575873844,3575873878,34
3,892,17260,3575873844,3575873879,35
3,892,17261,3575873844,3575873880,36
3,892,17262,3575873844,3575873880,36
3,892,17263,3575873844,3575873881,37
3,892,17264,3575873844,3575873882,38
3,892,17265,3575873844,3575873884,40
3,892,17266,3575873844,3575873885,41
3,892,17267,3575873844,3575873885,41
3,892,17268,3575873844,3575873886,42
3,892,17269,3575873844,3575873887,43
3,892,17270,3575873844,3575873888,44
3,892,17271,3575873844,3575873889,45
3,892,17272,3575873844,3575873890,46
3,893,17273,3575873904,3575873905,1
3,893,17274,3575873904,3575873905,1
3,893,17275,3575873904,3575873905,1
3,893,17276,3575873904,3575873905,1
3,893,17277,3575873904,3575873905,1
3,893,17278,3575873904,3575873905,1
3,893,17279,3575873904,3575873905,1
3,893,17280,3575873904,3575873905,1
3,893,17281,3575873904,3575873905,1
3,893,17282,3575873904,3575873905,1
3,893,17283,3575873904,3575873905,1
3,893,17284,3575873904,3575873905,1
3,893,17285,3575873904,3575873907,3
3,893,17286,3575873904,3575873907,3
3,893,17287,3575873904,3575873911,7
3,893,17288,3575873904,3575873912,8
3,893,17289,3575873904,3575873913,9
3,893,17290,3575873904,3575873916,12
3,893,17291,3575873904,3575873917,13
3,893,17292,3575873904,3575873921,17
3,893,17293,3575873904,3575873922,18
3,893,17294,3575873904,3575873922,18
3,893,17295,3575873904,3575873924,20
3,893,17296,3575873904,3575873925,21
3,893,17297,3575873904,3575873926,22
3,893,17298,3575873904,3575873927,23
3,893,17299,3575873904,3575873927,23
3,893,17300,3575873904,3575873930,26
3,893,17301,3575873904,3575873934,30
3,893,17302,3575873904,3575873936,32
3,893,17303,3575873904,3575873937,33
3,893,17304,3575873904,3575873942,38
3,893,17305,3575873904,3575873943,39
3,893,17306,3575873904,3575873943,39
3,893,17307,3575873904,3575873943,39
3,893,17308,3575873904,3575873946,42
3,893,17309,3575873904,3575873949,45
3,893,17310,3575873904,3575873951,47
3,893,17311,3575873904,3575873952,48
3,894,17312,3575873964,3575873964,0
3,894,17313,3575873964,3575873965,1
3,894,17314,3575873964,3575873965,1
3,894,17315,3575873964,3575873965,1
3,894,17316,3575873964,3575873965,1
3,894,17317,3575873964,3575873965,1
3,894,17318,3575873964,3575873965,1
3,894,17319,3575873964,3575873965,1
3,894,17320,3575873964,3575873966,2
3,894,17321,3575873964,3575873967,3
3,894,17322,3575873964,3575873967,3
3,894,17323,3575873964,3575873969,5
3,894,17324,3575873964,3575873969,5
3,894,17325,3575873964,3575873969,5
3,894,17326,3575873964,3575873970,6
3,894,17327,3575873964,3575873971,7
3,894,17328,3575873964,3575873974,10
3,894,17329,3575873964,3575873978,14
3,894,17330,3575873964,3575873978,14
3,894,17331,3575873964,3575873978,14
3,894,17332,3575873964,3575873979,15
3,894,17333,3575873964,3575873979,15
3,894,17334,3575873964,3575873981,17
3,894,17335,3575873964,3575873983,19
3,894,17336,3575873964,3575873983,19
3,894,17337,3575873964,3575873986,22
3,894,17338,3575873964,3575873986,22
3,894,17339,3575873964,3575873987,23
3,894,17340,3575873964,3575873991,27
3,894,17341,3575873964,3575873991,27
3,894,17342,3575873964,3575873992,28
3,894,17343,3575873964,3575873993,29
3,894,17344,3575873964,3575873994,30
3,894,17345,3575873964,3575873995,31
3,894,17346,3575873964,3575873995,31
3,894,17347,3575873964,3575873996,32
3,894,17348,3575873964,3575873997,33
3,894,17349,3575873964,3575873997,33
3,894,17350,3575873964,3575873998,34
3,894,17351,3575873964,3575874001,37
3,894,17352,3575873964,3575874004,40
3,894,17353,3575873964,3575874004,40
3,894,17354,3575873964,3575874006,42
3,894,17355,3575873964,3575874006,42
3,894,17356,3575873964,3575874008,44
3,894,17357,3575873964,3575874012,48
3,895,17358,3575874027,3575874027,0
3,895,17359,3575874027,3575874027,0
3,895,17360,3575874027,3575874027,0
3,895,17361,3575874027,3575874027,0
3,895,17362,3575874027,3575874027,0
3,895,17363,3575874027,3575874027,0
3,895,17364,3575874027,3575874027,0
3,895,17365,3575874027,3575874027,0
3,895,17366,3575874027,3575874027,0
3,895,17367,3575874027,3575874027,0
3,895,17368,3575874027,3575874027,0
3,895,17369,3575874027,3575874027,0
3,895,17370,3575874027,3575874028,1
3,895,17371,3575874027,3575874030,3
3,895,17372,3575874027,3575874031,4
3,895,17373,3575874027,3575874032,5
3,895,17374,3575874027,3575874032,5
3,895,17375,3575874027,3575874035,8
3,895,17376,3575874027,3575874036,9
3,895,17377,3575874027,3575874037,10
3,895,17378,3575874027,3575874038,11
3,895,17379,3575874027,3575874038,11
3,895,17380,3575874027,3575874038,11
3,895,17381,3575874027,3575874038,11
3,895,17382,3575874027,3575874039,12
3,895,17383,3575874027,3575874039,12
3,895,17384,3575874027,3575874039,12
3,895,17385,3575874027,3575874040,13
3,895,17386,3575874027,3575874040,13
3,895,17387,3575874027,3575874042,15
3,895,17388,3575874027,3575874043,16
3,895,17389,3575874027,3575874043,16
3,895,17390,3575874027,3575874044,17
3,895,17391,3575874027,3575874045,18
3,895,17392,3575874027,3575874047,20
3,895,17393,3575874027,3575874048,21
3,895,17394,3575874027,3575874052,25
3,895,17395,3575874027,3575874052,25
3,895,17396,3575874027,3575874054,27
3,895,17397,3575874027,3575874055,28
3,895,17398,3575874027,3575874057,30
3,895,17399,3575874027,3575874059,32
3,895,17400,3575874027,3575874059,32
3,895,17401,3575874027,3575874062,35
3,895,17402,3575874027,3575874062,35
3,895,17403,3575874027,3575874063,36
3,895,17404,3575874027,3575874064,37
3,895,17405,3575874027,3575874064,37
3,895,17406,3575874027,3575874066,39
3,895,17407,3575874027,3575874066,39
3,895,17408,3575874027,3575874066,39
3,895,17409,3575874027,3575874067,40
3,895,17410,3575874027,3575874068,41
3,895,17411,3575874027,3575874071,44
3,895,17412,3575874027,3575874072,45
3,895,17413,3575874027,3575874073,46
3,896,17414,3575874088,3575874088,0
3,896,17415,3575874088,3575874088,0
3,896,17416,3575874088,3575874088,0
3,896,17417,3575874088,3575874088,0
3,896,17418,3575874088,3575874088,0
3,896,17419,3575874088,3575874088,0
3,896,17420,3575874088,3575874088,0
3,896,17421,3575874088,3575874088,0
3,896,17422,3575874088,3575874088,0
3,896,17423,3575874088,3575874088,0
3,896,17424,3575874088,3575874088,0
3,896,17425,3575874088,3575874089,1
3,896,17426,3575874088,3575874090,2
3,896,17427,3575874088,3575874093,5
3,896,17428,3575874088,3575874095,7
3,896,17429,3575874088,3575874096,8
3,896,17430,3575874088,3575874097,9
3,896,17431,3575874088,3575874099,11
3,896,17432,3575874088,3575874099,11
3,896,17433,3575874088,3575874100,12
3,896,17434,3575874088,3575874100,12
3,896,17435,3575874088,3575874101,13
3,896,17436,3575874088,3575874102,14
3,896,17437,3575874088,3575874103,15
3,896,17438,3575874088,3575874103,15
3,896,17439,3575874088,3575874105,17
3,896,17440,3575874088,3575874107,19
3,896,17441,3575874088,3575874107,19
3,896,17442,3575874088,3575874111,23
3,896,17443,3575874088,3575874112,24
3,896,17444,3575874088,3575874113,25
3,896,17445,3575874088,3575874116,28
3,896,17446,3575874088,3575874117,29
3,896,17447,3575874088,3575874117,29
3,896,17448,3575874088,3575874122,34
3,896,17449,3575874088,3575874123,35
3,896,17450,3575874088,3575874124,36
3,896,17451,3575874088,3575874125,37
3,896,17452,3575874088,3575874127,39
3,896,17453,3575874088,3575874127,39
3,896,17454,3575874088,3575874127,39
3,896,17455,3575874088,3575874131,43
3,896,17456,3575874088,3575874136,48
3,897,17457,3575874152,3575874152,0
3,897,17458,3575874152,3575874152,0
3,897,17459,3575874152,3575874152,0
3,897,17460,3575874152,3575874152,0
3,897,17461,3575874152,3575874152,0
3,897,17462,3575874152,3575874152,0
3,897,17463,3575874152,3575874152,0
3,897,17464,3575874152,3575874152,0
3,897,17465,3575874152,3575874154,2
3,897,17466,3575874152,3575874156,4
3,897,17467,3575874152,3575874157,5
3,897,17468,3575874152,3575874158,6
3,897,17469,3575874152,3575874161,9
3,897,17470,3575874152,3575874162,10
3,897,17471,3575874152,3575874162,10
3,897,17472,3575874152,3575874165,13
3,897,17473,3575874152,3575874166,14
3,897,17474,3575874152,3575874167,15
3,897,17475,3575874152,3575874169,17
3,897,17476,3575874152,3575874169,17
3,897,17477,3575874152,3575874170,18
3,897,17478,3575874152,3575874170,18
3,897,17479,3575874152,3575874172,20
3,897,17480,3575874152,3575874174,22
3,897,17481,3575874152,3575874176,24
3,897,17482,3575874152,3575874176,24
3,897,17483,3575874152,3575874177,25
3,897,17484,3575874152,3575874178,26
3,897,17485,3575874152,3575874178,26
3,897,17486,3575874152,3575874180,28
3,897,17487,3575874152,3575874180,28
3,897,17488,3575874152,3575874181,29
3,897,17489,3575874152,3575874184,32
3,897,17490,3575874152,3575874185,33
3,897,17491,3575874152,3575874186,34
3,897,17492,3575874152,3575874186,34
3,897,17493,3575874152,3575874186,34
3,897,17494,3575874152,3575874187,35
3,897,17495,3575874152,3575874190,38
3,897,17496,3575874152,3575874191,39
3,897,17497,3575874152,3575874192,40
3,897,17498,3575874152,3575874194,42
3,897,17499,3575874152,3575874195,43
3,897,17500,3575874152,3575874195,43
3,897,17501,3575874152,3575874195,43
3,897,17502,3575874152,3575874195,43
3,897,17503,3575874152,3575874198,46
3,897,17504,3575874152,3575874198,46
3,897,17505,3575874152,3575874201,49
3,898,17506,3575874210,3575874210,0
3,898,17507,3575874210,3575874210,0
3,898,17508,3575874210,3575874210,0
3,898,17509,3575874210,3575874210,0
3,898,17510,3575874210,3575874210,0
3,898,17511,3575874210,3575874210,0
3,898,17512,3575874210,3575874211,1
3,898,17513,3575874210,3575874215,5
3,898,17514,3575874210,3575874215,5
3,898,17515,3575874210,3575874216,6
3,898,17516,3575874210,3575874219,9
3,898,17517,3575874210,3575874220,10
3,898,17518,3575874210,3575874220,10
3,898,17519,3575874210,3575874220,10
3,898,17520,3575874210,3575874221,11
3,898,17521,3575874210,3575874221,11
3,898,17522,3575874210,3575874222,12
3,898,17523,3575874210,3575874225,15
3,898,17524,3575874210,3575874226,16
3,898,17525,3575874210,3575874227,17
3,898,17526,3575874210,3575874229,19
3,898,17527,3575874210,3575874229,19
3,898,17528,3575874210,3575874230,20
3,898,17529,3575874210,3575874231,21
3,898,17530,3575874210,3575874232,22
3,898,17531,3575874210,3575874237,27
3,898,17532,3575874210,3575874237,27
3,898,17533,3575874210,3575874237,27
3,898,17534,3575874210,3575874238,28
3,898,17535,3575874210,3575874238,28
3,898,17536,3575874210,3575874238,28
3,898,17537,3575874210,3575874239,29
3,898,17538,3575874210,3575874239,29
3,898,17539,3575874210,3575874239,29
3,898,17540,3575874210,3575874239,29
3,898,17541,3575874210,3575874240,30
3,898,17542,3575874210,3575874240,30
3,898,17543,3575874210,3575874242,32
3,898,17544,3575874210,3575874243,33
3,898,17545,3575874210,3575874243,33
3,898,17546,3575874210,3575874244,34
3,898,17547,3575874210,3575874247,37
3,898,17548,3575874210,3575874248,38
3,898,17549,3575874210,3575874252,42
3,898,17550,3575874210,3575874252,42
3,898,17551,3575874210,3575874252,42
3,898,17552,3575874210,3575874253,43
3,898,17553,3575874210,3575874255,45
3,898,17554,3575874210,3575874255,45
3,898,17555,3575874210,3575874257,47
3,898,17556,3575874210,3575874259,49
3,898,17557,3575874210,3575874259,49
3,899,17558,3575874269,3575874269,0
3,899,17559,3575874269,3575874269,0
3,899,17560,3575874269,3575874269,0
3,899,17561,3575874269,3575874269,0
3,899,17562,3575874269,3575874269,0
3,899,17563,3575874269,3575874269,0
3,899,17564,3575874269,3575874269,0
3,899,17565,3575874269,3575874269,0
3,899,17566,3575874269,3575874271,2
3,899,17567,3575874269,3575874272,3
3,899,17568,3575874269,3575874278,9
3,899,17569,3575874269,3575874280,11
3,899,17570,3575874269,3575874281,12
3,899,17571,3575874269,3575874281,12
3,899,17572,3575874269,3575874281,12
3,899,17573,3575874269,3575874284,15
3,899,17574,3575874269,3575874285,16
3,899,17575,3575874269,3575874287,18
3,899,17576,3575874269,3575874287,18
3,899,17577,3575874269,3575874288,19
3,899,17578,3575874269,3575874289,20
3,899,17579,3575874269,3575874290,21
3,899,17580,3575874269,3575874293,24
3,899,17581,3575874269,3575874295,26
3,899,17582,3575874269,3575874296,27
3,899,17583,3575874269,3575874298,29
3,899,17584,3575874269,3575874299,30
3,899,17585,3575874269,3575874299,30
3,899,17586,3575874269,3575874300,31
3,899,17587,3575874269,3575874300,31
3,899,17588,3575874269,3575874301,32
3,899,17589,3575874269,3575874301,32
3,899,17590,3575874269,3575874303,34
3,899,17591,3575874269,3575874304,35
3,899,17592,3575874269,3575874305,36
3,899,17593,3575874269,3575874307,38
3,899,17594,3575874269,3575874307,38
3,899,17595,3575874269,3575874311,42
3,899,17596,3575874269,3575874312,43
3,899,17597,3575874269,3575874314,45
3,899,17598,3575874269,3575874316,47
3,899,17599,3575874269,3575874317,48
3,899,17600,3575874269,3575874318,49
3,900,17601,3575874328,3575874328,0
3,900,17602,3575874328,3575874328,0
3,900,17603,3575874328,3575874328,0
3,900,17604,3575874328,3575874328,0
3,900,17605,3575874328,3575874328,0
3,900,17606,3575874328,3575874328,0
3,900,17607,3575874328,3575874328,0
3,900,17608,3575874328,3575874328,0
3,900,17609,3575874328,3575874328,0
3,900,17610,3575874328,3575874331,3
3,900,17611,3575874328,3575874334,6
3,900,17612,3575874328,3575874337,9
3,900,17613,3575874328,3575874338,10
3,900,17614,3575874328,3575874343,15
3,900,17615,3575874328,3575874343,15
3,900,17616,3575874328,3575874344,16
3,900,17617,3575874328,3575874345,17
3,900,17618,3575874328,3575874348,20
3,900,17619,3575874328,3575874349,21
3,900,17620,3575874328,3575874351,23
3,900,17621,3575874328,3575874352,24
3,900,17622,3575874328,3575874356,28
3,900,17623,3575874328,3575874357,29
3,900,17624,3575874328,3575874358,30
3,900,17625,3575874328,3575874361,33
3,900,17626,3575874328,3575874362,34
3,900,17627,3575874328,3575874363,35
3,900,17628,3575874328,3575874364,36
3,900,17629,3575874328,3575874365,37
3,900,17630,3575874328,3575874366,38
3,900,17631,3575874328,3575874367,39
3,900,17632,3575874328,3575874369,41
3,900,17633,3575874328,3575874369,41
3,900,17634,3575874328,3575874370,42
3,900,17635,3575874328,3575874371,43
3,900,17636,3575874328,3575874371,43
3,900,17637,3575874328,3575874372,44
3,900,17638,3575874328,3575874374,46
3,900,17639,3575874328,3575874376,48
3,900,17640,3575874328,3575874376,48
3,900,17641,3575874328,3575874378,50
3,901,17642,3575874388,3575874388,0
3,901,17643,3575874388,3575874388,0
3,901,17644,3575874388,3575874388,0
3,901,17645,3575874388,3575874388,0
3,901,17646,3575874388,3575874388,0
3,901,17647,3575874388,3575874388,0
3,901,17648,3575874388,3575874388,0
3,901,17649,3575874388,3575874388,0
3,901,17650,3575874388,3575874388,0
3,901,17651,3575874388,3575874388,0
3,901,17652,3575874388,3575874388,0
3,901,17653,3575874388,3575874388,0
3,901,17654,3575874388,3575874388,0
3,901,17655,3575874388,3575874388,0
3,901,17656,3575874388,3575874390,2
3,901,17657,3575874388,3575874391,3
3,901,17658,3575874388,3575874392,4
3,901,17659,3575874388,3575874395,7
3,901,17660,3575874388,3575874395,7
3,901,17661,3575874388,3575874395,7
3,901,17662,3575874388,3575874395,7
3,901,17663,3575874388,3575874396,8
3,901,17664,3575874388,3575874397,9
3,901,17665,3575874388,3575874398,10
3,901,17666,3575874388,3575874398,10
3,901,17667,3575874388,3575874400,12
3,901,17668,3575874388,3575874401,13
3,901,17669,3575874388,3575874401,13
3,901,17670,3575874388,3575874405,17
3,901,17671,3575874388,3575874405,17
3,901,17672,3575874388,3575874406,18
3,901,17673,3575874388,3575874406,18
3,901,17674,3575874388,3575874407,19
3,901,17675,3575874388,3575874407,19
3,901,17676,3575874388,3575874411,23
3,901,17677,3575874388,3575874415,27
3,901,17678,3575874388,3575874416,28
3,901,17679,3575874388,3575874417,29
3,901,17680,3575874388,3575874419,31
3,901,17681,3575874388,3575874419,31
3,901,17682,3575874388,3575874419,31
3,901,17683,3575874388,3575874420,32
3,901,17684,3575874388,3575874420,32
3,901,17685,3575874388,3575874421,33
3,901,17686,3575874388,3575874421,33
3,901,17687,3575874388,3575874423,35
3,901,17688,3575874388,3575874425,37
3,901,17689,3575874388,3575874427,39
3,901,17690,3575874388,3575874427,39
3,901,17691,3575874388,3575874428,40
3,901,17692,3575874388,3575874430,42
3,901,17693,3575874388,3575874431,43
3,901,17694,3575874388,3575874431,43
3,901,17695,3575874388,3575874432,44
3,901,17696,3575874388,3575874432,44
3,901,17697,3575874388,3575874436,48
3,901,17698,3575874388,3575874437,49
3,901,17699,3575874388,3575874438,50
3,902,17700,3575874450,3575874450,0
3,902,17701,3575874450,3575874450,0
3,902,17702,3575874450,3575874450,0
3,902,17703,3575874450,3575874450,0
3,902,17704,3575874450,3575874450,0
3,902,17705,3575874450,3575874450,0
3,902,17706,3575874450,3575874450,0
3,902,17707,3575874450,3575874450,0
3,902,17708,3575874450,3575874450,0
3,902,17709,3575874450,3575874450,0
3,902,17710,3575874450,3575874450,0
3,902,17711,3575874450,3575874450,0
3,902,17712,3575874450,3575874450,0
3,902,17713,3575874450,3575874450,0
3,902,17714,3575874450,3575874450,0
3,902,17715,3575874450,3575874452,2
3,902,17716,3575874450,3575874453,3
3,902,17717,3575874450,3575874454,4
3,902,17718,3575874450,3575874454,4
3,902,17719,3575874450,3575874456,6
3,902,17720,3575874450,3575874458,8
3,902,17721,3575874450,3575874459,9
3,902,17722,3575874450,3575874460,10
3,902,17723,3575874450,3575874462,12
3,902,17724,3575874450,3575874463,13
3,902,17725,3575874450,3575874464,14
3,902,17726,3575874450,3575874465,15
3,902,17727,3575874450,3575874466,16
3,902,17728,3575874450,3575874466,16
3,902,17729,3575874450,3575874467,17
3,902,17730,3575874450,3575874467,17
3,902,17731,3575874450,3575874467,17
3,902,17732,3575874450,3575874468,18
3,902,17733,3575874450,3575874468,18
3,902,17734,3575874450,3575874470,20
3,902,17735,3575874450,3575874472,22
3,902,17736,3575874450,3575874474,24
3,902,17737,3575874450,3575874479,29
3,902,17738,3575874450,3575874480,30
3,902,17739,3575874450,3575874480,30
3,902,17740,3575874450,3575874481,31
3,902,17741,3575874450,3575874481,31
3,902,17742,3575874450,3575874482,32
3,902,17743,3575874450,3575874482,32
3,902,17744,3575874450,3575874484,34
3,902,17745,3575874450,3575874486,36
3,902,17746,3575874450,3575874486,36
3,902,17747,3575874450,3575874487,37
3,902,17748,3575874450,3575874488,38
3,902,17749,3575874450,3575874490,40
3,902,17750,3575874450,3575874491,41
3,902,17751,3575874450,3575874493,43
3,902,17752,3575874450,3575874495,45
3,902,17753,3575874450,3575874496,46
3,902,17754,3575874450,3575874497,47
3,902,17755,3575874450,3575874499,49
3,903,17756,3575874509,3575874509,0
3,903,17757,3575874509,3575874509,0
3,903,17758,3575874509,3575874509,0
3,903,17759,3575874509,3575874509,0
3,903,17760,3575874509,3575874509,0
3,903,17761,3575874509,3575874509,0
3,903,17762,3575874509,3575874509,0
3,903,17763,3575874509,3575874509,0
3,903,17764,3575874509,3575874509,0
3,903,17765,3575874509,3575874511,2
3,903,17766,3575874509,3575874512,3
3,903,17767,3575874509,3575874513,4
3,903,17768,3575874509,3575874515,6
3,903,17769,3575874509,3575874516,7
3,903,17770,3575874509,3575874517,8
3,903,17771,3575874509,3575874520,11
3,903,17772,3575874509,3575874521,12
3,903,17773,3575874509,3575874523,14
3,903,17774,3575874509,3575874523,14
3,903,17775,3575874509,3575874524,15
3,903,17776,3575874509,3575874526,17
3,903,17777,3575874509,3575874526,17
3,903,17778,3575874509,3575874527,18
3,903,17779,3575874509,3575874531,22
3,903,17780,3575874509,3575874533,24
3,903,17781,3575874509,3575874534,25
3,903,17782,3575874509,3575874535,26
3,903,17783,3575874509,3575874536,27
3,903,17784,3575874509,3575874538,29
3,903,17785,3575874509,3575874541,32
3,903,17786,3575874509,3575874542,33
3,903,17787,3575874509,3575874543,34
3,903,17788,3575874509,3575874543,34
3,903,17789,3575874509,3575874543,34
3,903,17790,3575874509,3575874547,38
3,903,17791,3575874509,3575874549,40
3,903,17792,3575874509,3575874550,41
3,903,17793,3575874509,3575874555,46
3,903,17794,3575874509,3575874556,47
3,903,17795,3575874509,3575874557,48
3,904,17796,3575874572,3575874572,0
3,904,17797,3575874572,3575874572,0
3,904,17798,3575874572,3575874572,0
3,904,17799,3575874572,3575874572,0
3,904,17800,3575874572,3575874572,0
3,904,17801,3575874572,3575874572,0
3,904,17802,3575874572,3575874572,0
3,904,17803,3575874572,3575874572,0
3,904,17804,3575874572,3575874572,0
3,904,17805,3575874572,3575874572,0
3,904,17806,3575874572,3575874573,1
3,904,17807,3575874572,3575874575,3
3,904,17808,3575874572,3575874576,4
3,904,17809,3575874572,3575874577,5
3,904,17810,3575874572,3575874578,6
3,904,17811,3575874572,3575874578,6
3,904,17812,3575874572,3575874579,7
3,904,17813,3575874572,3575874579,7
3,904,17814,3575874572,3575874579,7
3,904,17815,3575874572,3575874581,9
3,904,17816,3575874572,3575874581,9
3,904,17817,3575874572,3575874583,11
3,904,17818,3575874572,3575874585,13
3,904,17819,3575874572,3575874586,14
3,904,17820,3575874572,3575874586,14
3,904,17821,3575874572,3575874586,14
3,904,17822,3575874572,3575874589,17
3,904,17823,3575874572,3575874591,19
3,904,17824,3575874572,3575874591,19
3,904,17825,3575874572,3575874591,19
3,904,17826,3575874572,3575874594,22
3,904,17827,3575874572,3575874594,22
3,904,17828,3575874572,3575874595,23
3,904,17829,3575874572,3575874595,23
3,904,17830,3575874572,3575874595,23
3,904,17831,3575874572,3575874595,23
3,904,17832,3575874572,3575874597,25
3,904,17833,3575874572,3575874597,25
3,904,17834,3575874572,3575874599,27
3,904,17835,3575874572,3575874600,28
3,904,17836,3575874572,3575874602,30
3,904,17837,3575874572,3575874604,32
3,904,17838,3575874572,3575874605,33
3,904,17839,3575874572,3575874605,33
3,904,17840,3575874572,3575874606,34
3,904,17841,3575874572,3575874606,34
3,904,17842,3575874572,3575874607,35
3,904,17843,3575874572,3575874611,39
3,904,17844,3575874572,3575874614,42
3,904,17845,3575874572,3575874615,43
3,904,17846,3575874572,3575874616,44
3,904,17847,3575874572,3575874618,46
3,904,17848,3575874572,3575874618,46
3,904,17849,3575874572,3575874619,47
3,904,17850,3575874572,3575874620,48
3,904,17851,3575874572,3575874620,48
3,904,17852,3575874572,3575874621,49
3,905,17853,3575874631,3575874631,0
3,905,17854,3575874631,3575874631,0
3,905,17855,3575874631,3575874631,0
3,905,17856,3575874631,3575874631,0
3,905,17857,3575874631,3575874631,0
3,905,17858,3575874631,3575874631,0
3,905,17859,3575874631,3575874631,0
3,905,17860,3575874631,3575874631,0
3,905,17861,3575874631,3575874631,0
3,905,17862,3575874631,3575874632,1
3,905,17863,3575874631,3575874635,4
3,905,17864,3575874631,3575874635,4
3,905,17865,3575874631,3575874637,6
3,905,17866,3575874631,3575874638,7
3,905,17867,3575874631,3575874638,7
3,905,17868,3575874631,3575874638,7
3,905,17869,3575874631,3575874638,7
3,905,17870,3575874631,3575874638,7
3,905,17871,3575874631,3575874638,7
3,905,17872,3575874631,3575874640,9
3,905,17873,3575874631,3575874642,11
3,905,17874,3575874631,3575874642,11
3,905,17875,3575874631,3575874642,11
3,905,17876,3575874631,3575874643,12
3,905,17877,3575874631,3575874643,12
3,905,17878,3575874631,3575874645,14
3,905,17879,3575874631,3575874646,15
3,905,17880,3575874631,3575874648,17
3,905,17881,3575874631,3575874651,20
3,905,17882,3575874631,3575874652,21
3,905,17883,3575874631,3575874654,23
3,905,17884,3575874631,3575874654,23
3,905,17885,3575874631,3575874656,25
3,905,17886,3575874631,3575874658,27
3,905,17887,3575874631,3575874658,27
3,905,17888,3575874631,3575874661,30
3,905,17889,3575874631,3575874662,31
3,905,17890,3575874631,3575874663,32
3,905,17891,3575874631,3575874665,34
3,905,17892,3575874631,3575874665,34
3,905,17893,3575874631,3575874665,34
3,905,17894,3575874631,3575874666,35
3,905,17895,3575874631,3575874667,36
3,905,17896,3575874631,3575874667,36
3,905,17897,3575874631,3575874667,36
3,905,17898,3575874631,3575874670,39
3,905,17899,3575874631,3575874673,42
3,905,17900,3575874631,3575874680,49
3,905,17901,3575874631,3575874680,49
3,905,17902,3575874631,3575874680,49
3,905,17903,3575874631,3575874681,50
3,906,17904,3575874694,3575874694,0
3,906,17905,3575874694,3575874694,0
3,906,17906,3575874694,3575874694,0
3,906,17907,3575874694,3575874694,0
3,906,17908,3575874694,3575874694,0
3,906,17909,3575874694,3575874694,0
3,906,17910,3575874694,3575874694,0
3,906,17911,3575874694,3575874694,0
3,906,17912,3575874694,3575874694,0
3,906,17913,3575874694,3575874694,0
3,906,17914,3575874694,3575874696,2
3,906,17915,3575874694,3575874696,2
3,906,17916,3575874694,3575874698,4
3,906,17917,3575874694,3575874699,5
3,906,17918,3575874694,3575874700,6
3,906,17919,3575874694,3575874701,7
3,906,17920,3575874694,3575874701,7
3,906,17921,3575874694,3575874703,9
3,906,17922,3575874694,3575874705,11
3,906,17923,3575874694,3575874705,11
3,906,17924,3575874694,3575874706,12
3,906,17925,3575874694,3575874707,13
3,906,17926,3575874694,3575874707,13
3,906,17927,3575874694,3575874711,17
3,906,17928,3575874694,3575874712,18
3,906,17929,3575874694,3575874713,19
3,906,17930,3575874694,3575874716,22
3,906,17931,3575874694,3575874716,22
3,906,17932,3575874694,3575874717,23
3,906,17933,3575874694,3575874720,26
3,906,17934,3575874694,3575874720,26
3,906,17935,3575874694,3575874722,28
3,906,17936,3575874694,3575874722,28
3,906,17937,3575874694,3575874724,30
3,906,17938,3575874694,3575874725,31
3,906,17939,3575874694,3575874726,32
3,906,17940,3575874694,3575874726,32
3,906,17941,3575874694,3575874730,36
3,906,17942,3575874694,3575874733,39
3,906,17943,3575874694,3575874735,41
3,906,17944,3575874694,3575874736,42
3,906,17945,3575874694,3575874738,44
3,906,17946,3575874694,3575874741,47
3,906,17947,3575874694,3575874742,48
3,906,17948,3575874694,3575874743,49
3,906,17949,3575874694,3575874744,50
3,907,17950,3575874754,3575874754,0
3,907,17951,3575874754,3575874754,0
3,907,17952,3575874754,3575874754,0
3,907,17953,3575874754,3575874754,0
3,907,17954,3575874754,3575874754,0
3,907,17955,3575874754,3575874756,2
3,907,17956,3575874754,3575874756,2
3,907,17957,3575874754,3575874757,3
3,907,17958,3575874754,3575874760,6
3,907,17959,3575874754,3575874763,9
3,907,17960,3575874754,3575874763,9
3,907,17961,3575874754,3575874764,10
3,907,17962,3575874754,3575874766,12
3,907,17963,3575874754,3575874767,13
3,907,17964,3575874754,3575874769,15
3,907,17965,3575874754,3575874769,15
3,907,17966,3575874754,3575874769,15
3,907,17967,3575874754,3575874770,16
3,907,17968,3575874754,3575874772,18
3,907,17969,3575874754,3575874773,19
3,907,17970,3575874754,3575874775,21
3,907,17971,3575874754,3575874775,21
3,907,17972,3575874754,3575874777,23
3,907,17973,3575874754,3575874778,24
3,907,17974,3575874754,3575874778,24
3,907,17975,3575874754,3575874779,25
3,907,17976,3575874754,3575874779,25
3,907,17977,3575874754,3575874779,25
3,907,17978,3575874754,3575874779,25
3,907,17979,3575874754,3575874780,26
3,907,17980,3575874754,3575874783,29
3,907,17981,3575874754,3575874784,30
3,907,17982,3575874754,3575874785,31
3,907,17983,3575874754,3575874786,32
3,907,17984,3575874754,3575874786,32
3,907,17985,3575874754,3575874787,33
3,907,17986,3575874754,3575874788,34
3,907,17987,3575874754,3575874791,37
3,907,17988,3575874754,3575874791,37
3,907,17989,3575874754,3575874792,38
3,907,17990,3575874754,3575874793,39
3,907,17991,3575874754,3575874794,40
3,907,17992,3575874754,3575874795,41
3,907,17993,3575874754,3575874795,41
3,907,17994,3575874754,3575874795,41
3,907,17995,3575874754,3575874796,42
3,907,17996,3575874754,3575874796,42
3,907,17997,3575874754,3575874797,43
3,907,17998,3575874754,3575874797,43
3,907,17999,3575874754,3575874800,46
3,907,18000,3575874754,3575874800,46
3,907,18001,3575874754,3575874801,47
3,907,18002,3575874754,3575874803,49
3,907,18003,3575874754,3575874804,50
3,908,18004,3575874817,3575874817,0
3,908,18005,3575874817,3575874817,0
3,908,18006,3575874817,3575874817,0
3,908,18007,3575874817,3575874817,0
3,908,18008,3575874817,3575874817,0
3,908,18009,3575874817,3575874817,0
3,908,18010,3575874817,3575874817,0
3,908,18011,3575874817,3575874817,0
3,908,18012,3575874817,3575874819,2
3,908,18013,3575874817,3575874819,2
3,908,18014,3575874817,3575874819,2
3,908,18015,3575874817,3575874820,3
3,908,18016,3575874817,3575874820,3
3,908,18017,3575874817,3575874821,4
3,908,18018,3575874817,3575874821,4
3,908,18019,3575874817,3575874824,7
3,908,18020,3575874817,3575874826,9
3,908,18021,3575874817,3575874826,9
3,908,18022,3575874817,3575874828,11
3,908,18023,3575874817,3575874828,11
3,908,18024,3575874817,3575874830,13
3,908,18025,3575874817,3575874831,14
3,908,18026,3575874817,3575874832,15
3,908,18027,3575874817,3575874835,18
3,908,18028,3575874817,3575874835,18
3,908,18029,3575874817,3575874837,20
3,908,18030,3575874817,3575874838,21
3,908,18031,3575874817,3575874838,21
3,908,18032,3575874817,3575874838,21
3,908,18033,3575874817,3575874838,21
3,908,18034,3575874817,3575874838,21
3,908,18035,3575874817,3575874838,21
3,908,18036,3575874817,3575874838,21
3,908,18037,3575874817,3575874840,23
3,908,18038,3575874817,3575874842,25
3,908,18039,3575874817,3575874843,26
3,908,18040,3575874817,3575874843,26
3,908,18041,3575874817,3575874844,27
3,908,18042,3575874817,3575874845,28
3,908,18043,3575874817,3575874846,29
3,908,18044,3575874817,3575874848,31
3,908,18045,3575874817,3575874851,34
3,908,18046,3575874817,3575874852,35
3,908,18047,3575874817,3575874852,35
3,908,18048,3575874817,3575874854,37
3,908,18049,3575874817,3575874855,38
3,908,18050,3575874817,3575874856,39
3,908,18051,3575874817,3575874858,41
3,908,18052,3575874817,3575874861,44
3,908,18053,3575874817,3575874861,44
3,908,18054,3575874817,3575874865,48
3,908,18055,3575874817,3575874865,48
3,908,18056,3575874817,3575874865,48
3,908,18057,3575874817,3575874866,49
3,908,18058,3575874817,3575874866,49
3,908,18059,3575874817,3575874866,49
3,908,18060,3575874817,3575874867,50
3,909,18061,3575874877,3575874877,0
3,909,18062,3575874877,3575874877,0
3,909,18063,3575874877,3575874877,0
3,909,18064,3575874877,3575874880,3
3,909,18065,3575874877,3575874880,3
3,909,18066,3575874877,3575874880,3
3,909,18067,3575874877,3575874881,4
3,909,18068,3575874877,3575874881,4
3,909,18069,3575874877,3575874881,4
3,909,18070,3575874877,3575874882,5
3,909,18071,3575874877,3575874885,8
3,909,18072,3575874877,3575874886,9
3,909,18073,3575874877,3575874886,9
3,909,18074,3575874877,3575874886,9
3,909,18075,3575874877,3575874886,9
3,909,18076,3575874877,3575874886,9
3,909,18077,3575874877,3575874889,12
3,909,18078,3575874877,3575874891,14
3,909,18079,3575874877,3575874892,15
3,909,18080,3575874877,3575874894,17
3,909,18081,3575874877,3575874896,19
3,909,18082,3575874877,3575874896,19
3,909,18083,3575874877,3575874900,23
3,909,18084,3575874877,3575874901,24
3,909,18085,3575874877,3575874901,24
3,909,18086,3575874877,3575874903,26
3,909,18087,3575874877,3575874904,27
3,909,18088,3575874877,3575874905,28
3,909,18089,3575874877,3575874906,29
3,909,18090,3575874877,3575874907,30
3,909,18091,3575874877,3575874907,30
3,909,18092,3575874877,3575874911,34
3,909,18093,3575874877,3575874912,35
3,909,18094,3575874877,3575874913,36
3,909,18095,3575874877,3575874916,39
3,909,18096,3575874877,3575874916,39
3,909,18097,3575874877,3575874917,40
3,909,18098,3575874877,3575874921,44
3,909,18099,3575874877,3575874921,44
3,909,18100,3575874877,3575874922,45
3,909,18101,3575874877,3575874925,48
3,909,18102,3575874877,3575874926,49
3,909,18103,3575874877,3575874926,49
3,909,18104,3575874877,3575874926,49
3,909,18105,3575874877,3575874927,50
3,910,18106,3575874939,3575874939,0
3,910,18107,3575874939,3575874939,0
3,910,18108,3575874939,3575874939,0
3,910,18109,3575874939,3575874939,0
3,910,18110,3575874939,3575874939,0
3,910,18111,3575874939,3575874941,2
3,910,18112,3575874939,3575874942,3
3,910,18113,3575874939,3575874943,4
3,910,18114,3575874939,3575874943,4
3,910,18115,3575874939,3575874944,5
3,910,18116,3575874939,3575874948,9
3,910,18117,3575874939,3575874949,10
3,910,18118,3575874939,3575874951,12
3,910,18119,3575874939,3575874954,15
3,910,18120,3575874939,3575874956,17
3,910,18121,3575874939,3575874956,17
3,910,18122,3575874939,3575874957,18
3,910,18123,3575874939,3575874960,21
3,910,18124,3575874939,3575874961,22
3,910,18125,3575874939,3575874962,23
3,910,18126,3575874939,3575874964,25
3,910,18127,3575874939,3575874965,26
3,910,18128,3575874939,3575874966,27
3,910,18129,3575874939,3575874967,28
3,910,18130,3575874939,3575874968,29
3,910,18131,3575874939,3575874968,29
3,910,18132,3575874939,3575874969,30
3,910,18133,3575874939,3575874970,31
3,910,18134,3575874939,3575874970,31
3,910,18135,3575874939,3575874973,34
3,910,18136,3575874939,3575874974,35
3,910,18137,3575874939,3575874976,37
3,910,18138,3575874939,3575874977,38
3,910,18139,3575874939,3575874978,39
3,910,18140,3575874939,3575874978,39
3,910,18141,3575874939,3575874980,41
3,910,18142,3575874939,3575874980,41
3,910,18143,3575874939,3575874980,41
3,910,18144,3575874939,3575874981,42
3,910,18145,3575874939,3575874983,44
3,910,18146,3575874939,3575874985,46
3,910,18147,3575874939,3575874986,47
3,910,18148,3575874939,3575874986,47
3,910,18149,3575874939,3575874986,47
3,910,18150,3575874939,3575874988,49
3,910,18151,3575874939,3575874988,49
3,911,18152,3575875000,3575875000,0
3,911,18153,3575875000,3575875000,0
3,911,18154,3575875000,3575875000,0
3,911,18155,3575875000,3575875000,0
3,911,18156,3575875000,3575875000,0
3,911,18157,3575875000,3575875000,0
3,911,18158,3575875000,3575875000,0
3,911,18159,3575875000,3575875000,0
3,911,18160,3575875000,3575875000,0
3,911,18161,3575875000,3575875000,0
3,911,18162,3575875000,3575875000,0
3,911,18163,3575875000,3575875000,0
3,911,18164,3575875000,3575875000,0
3,911,18165,3575875000,3575875000,0
3,911,18166,3575875000,3575875001,1
3,911,18167,3575875000,3575875003,3
3,911,18168,3575875000,3575875005,5
3,911,18169,3575875000,3575875005,5
3,911,18170,3575875000,3575875006,6
3,911,18171,3575875000,3575875007,7
3,911,18172,3575875000,3575875007,7
3,911,18173,3575875000,3575875012,12
3,911,18174,3575875000,3575875015,15
3,911,18175,3575875000,3575875016,16
3,911,18176,3575875000,3575875016,16
3,911,18177,3575875000,3575875019,19
3,911,18178,3575875000,3575875020,20
3,911,18179,3575875000,3575875020,20
3,911,18180,3575875000,3575875021,21
3,911,18181,3575875000,3575875021,21
3,911,18182,3575875000,3575875022,22
3,911,18183,3575875000,3575875024,24
3,911,18184,3575875000,3575875025,25
3,911,18185,3575875000,3575875026,26
3,911,18186,3575875000,3575875026,26
3,911,18187,3575875000,3575875029,29
3,911,18188,3575875000,3575875029,29
3,911,18189,3575875000,3575875029,29
3,911,18190,3575875000,3575875030,30
3,911,18191,3575875000,3575875032,32
3,911,18192,3575875000,3575875032,32
3,911,18193,3575875000,3575875035,35
3,911,18194,3575875000,3575875036,36
3,911,18195,3575875000,3575875037,37
3,911,18196,3575875000,3575875037,37
3,911,18197,3575875000,3575875038,38
3,911,18198,3575875000,3575875038,38
3,911,18199,3575875000,3575875038,38
3,911,18200,3575875000,3575875038,38
3,911,18201,3575875000,3575875038,38
3,911,18202,3575875000,3575875038,38
3,911,18203,3575875000,3575875038,38
3,911,18204,3575875000,3575875038,38
3,911,18205,3575875000,3575875040,40
3,911,18206,3575875000,3575875042,42
3,911,18207,3575875000,3575875042,42
3,911,18208,3575875000,3575875043,43
3,911,18209,3575875000,3575875043,43
3,911,18210,3575875000,3575875044,44
3,911,18211,3575875000,3575875046,46
3,911,18212,3575875000,3575875046,46
3,911,18213,3575875000,3575875048,48
3,911,18214,3575875000,3575875049,49
3,912,18215,3575875064,3575875065,1
3,912,18216,3575875064,3575875065,1
3,912,18217,3575875064,3575875065,1
3,912,18218,3575875064,3575875065,1
3,912,18219,3575875064,3575875065,1
3,912,18220,3575875064,3575875065,1
3,912,18221,3575875064,3575875065,1
3,912,18222,3575875064,3575875065,1
3,912,18223,3575875064,3575875065,1
3,912,18224,3575875064,3575875065,1
3,912,18225,3575875064,3575875065,1
3,912,18226,3575875064,3575875065,1
3,912,18227,3575875064,3575875066,2
3,912,18228,3575875064,3575875066,2
3,912,18229,3575875064,3575875066,2
3,912,18230,3575875064,3575875067,3
3,912,18231,3575875064,3575875067,3
3,912,18232,3575875064,3575875068,4
3,912,18233,3575875064,3575875071,7
3,912,18234,3575875064,3575875073,9
3,912,18235,3575875064,3575875075,11
3,912,18236,3575875064,3575875080,16
3,912,18237,3575875064,3575875080,16
3,912,18238,3575875064,3575875080,16
3,912,18239,3575875064,3575875081,17
3,912,18240,3575875064,3575875082,18
3,912,18241,3575875064,3575875082,18
3,912,18242,3575875064,3575875083,19
3,912,18243,3575875064,3575875084,20
3,912,18244,3575875064,3575875085,21
3,912,18245,3575875064,3575875086,22
3,912,18246,3575875064,3575875086,22
3,912,18247,3575875064,3575875086,22
3,912,18248,3575875064,3575875087,23
3,912,18249,3575875064,3575875089,25
3,912,18250,3575875064,3575875092,28
3,912,18251,3575875064,3575875093,29
3,912,18252,3575875064,3575875094,30
3,912,18253,3575875064,3575875097,33
3,912,18254,3575875064,3575875097,33
3,912,18255,3575875064,3575875098,34
3,912,18256,3575875064,3575875100,36
3,912,18257,3575875064,3575875101,37
3,912,18258,3575875064,3575875101,37
3,912,18259,3575875064,3575875102,38
3,912,18260,3575875064,3575875104,40
3,912,18261,3575875064,3575875105,41
3,912,18262,3575875064,3575875105,41
3,912,18263,3575875064,3575875107,43
3,912,18264,3575875064,3575875107,43
3,912,18265,3575875064,3575875111,47
3,912,18266,3575875064,3575875112,48
3,912,18267,3575875064,3575875113,49
3,913,18268,3575875128,3575875128,0
3,913,18269,3575875128,3575875128,0
3,913,18270,3575875128,3575875128,0
3,913,18271,3575875128,3575875128,0
3,913,18272,3575875128,3575875128,0
3,913,18273,3575875128,3575875128,0
3,913,18274,3575875128,3575875128,0
3,913,18275,3575875128,3575875128,0
3,913,18276,3575875128,3575875128,0
3,913,18277,3575875128,3575875128,0
3,913,18278,3575875128,3575875128,0
3,913,18279,3575875128,3575875131,3
3,913,18280,3575875128,3575875133,5
3,913,18281,3575875128,3575875136,8
3,913,18282,3575875128,3575875137,9
3,913,18283,3575875128,3575875138,10
3,913,18284,3575875128,3575875141,13
3,913,18285,3575875128,3575875142,14
3,913,18286,3575875128,3575875142,14
3,913,18287,3575875128,3575875144,16
3,913,18288,3575875128,3575875148,20
3,913,18289,3575875128,3575875149,21
3,913,18290,3575875128,3575875151,23
3,913,18291,3575875128,3575875156,28
3,913,18292,3575875128,3575875156,28
3,913,18293,3575875128,3575875156,28
3,913,18294,3575875128,3575875159,31
3,913,18295,3575875128,3575875161,33
3,913,18296,3575875128,3575875163,35
3,913,18297,3575875128,3575875164,36
3,913,18298,3575875128,3575875164,36
3,913,18299,3575875128,3575875166,38
3,913,18300,3575875128,3575875167,39
3,913,18301,3575875128,3575875169,41
3,913,18302,3575875128,3575875169,41
3,913,18303,3575875128,3575875170,42
3,913,18304,3575875128,3575875170,42
3,913,18305,3575875128,3575875170,42
3,913,18306,3575875128,3575875171,43
3,913,18307,3575875128,3575875173,45
3,913,18308,3575875128,3575875174,46
3,913,18309,3575875128,3575875177,49
3,913,18310,3575875128,3575875178,50
3,914,18311,3575875191,3575875191,0
3,914,18312,3575875191,3575875191,0
3,914,18313,3575875191,3575875191,0
3,914,18314,3575875191,3575875191,0
3,914,18315,3575875191,3575875191,0
3,914,18316,3575875191,3575875191,0
3,914,18317,3575875191,3575875191,0
3,914,18318,3575875191,3575875191,0
3,914,18319,3575875191,3575875191,0
3,914,18320,3575875191,3575875191,0
3,914,18321,3575875191,3575875191,0
3,914,18322,3575875191,3575875191,0
3,914,18323,3575875191,3575875192,1
3,914,18324,3575875191,3575875193,2
3,914,18325,3575875191,3575875194,3
3,914,18326,3575875191,3575875194,3
3,914,18327,3575875191,3575875194,3
3,914,18328,3575875191,3575875195,4
3,914,18329,3575875191,3575875195,4
3,914,18330,3575875191,3575875196,5
3,914,18331,3575875191,3575875196,5
3,914,18332,3575875191,3575875196,5
3,914,18333,3575875191,3575875196,5
3,914,18334,3575875191,3575875197,6
3,914,18335,3575875191,3575875200,9
3,914,18336,3575875191,3575875200,9
3,914,18337,3575875191,3575875201,10
3,914,18338,3575875191,3575875202,11
3,914,18339,3575875191,3575875203,12
3,914,18340,3575875191,3575875205,14
3,914,18341,3575875191,3575875206,15
3,914,18342,3575875191,3575875206,15
3,914,18343,3575875191,3575875206,15
3,914,18344,3575875191,3575875207,16
3,914,18345,3575875191,3575875211,20
3,914,18346,3575875191,3575875216,25
3,914,18347,3575875191,3575875218,27
3,914,18348,3575875191,3575875219,28
3,914,18349,3575875191,3575875220,29
3,914,18350,3575875191,3575875220,29
3,914,18351,3575875191,3575875221,30
3,914,18352,3575875191,3575875221,30
3,914,18353,3575875191,3575875222,31
3,914,18354,3575875191,3575875224,33
3,914,18355,3575875191,3575875226,35
3,914,18356,3575875191,3575875226,35
3,914,18357,3575875191,3575875227,36
3,914,18358,3575875191,3575875229,38
3,914,18359,3575875191,3575875229,38
3,914,18360,3575875191,3575875229,38
3,914,18361,3575875191,3575875230,39
3,914,18362,3575875191,3575875231,40
3,914,18363,3575875191,3575875233,42
3,914,18364,3575875191,3575875236,45
3,914,18365,3575875191,3575875236,45
3,914,18366,3575875191,3575875237,46
3,914,18367,3575875191,3575875238,47
3,914,18368,3575875191,3575875238,47
3,914,18369,3575875191,3575875238,47
3,914,18370,3575875191,3575875238,47
3,914,18371,3575875191,3575875238,47
3,914,18372,3575875191,3575875238,47
3,914,18373,3575875191,3575875239,48
3,914,18374,3575875191,3575875240,49
3,915,18375,3575875250,3575875250,0
3,915,18376,3575875250,3575875250,0
3,915,18377,3575875250,3575875250,0
3,915,18378,3575875250,3575875250,0
3,915,18379,3575875250,3575875250,0
3,915,18380,3575875250,3575875250,0
3,915,18381,3575875250,3575875250,0
3,915,18382,3575875250,3575875250,0
3,915,18383,3575875250,3575875251,1
3,915,18384,3575875250,3575875252,2
3,915,18385,3575875250,3575875252,2
3,915,18386,3575875250,3575875254,4
3,915,18387,3575875250,3575875255,5
3,915,18388,3575875250,3575875255,5
3,915,18389,3575875250,3575875256,6
3,915,18390,3575875250,3575875259,9
3,915,18391,3575875250,3575875259,9
3,915,18392,3575875250,3575875259,9
3,915,18393,3575875250,3575875260,10
3,915,18394,3575875250,3575875263,13
3,915,18395,3575875250,3575875264,14
3,915,18396,3575875250,3575875265,15
3,915,18397,3575875250,3575875266,16
3,915,18398,3575875250,3575875266,16
3,915,18399,3575875250,3575875266,16
3,915,18400,3575875250,3575875267,17
3,915,18401,3575875250,3575875267,17
3,915,18402,3575875250,3575875269,19
3,915,18403,3575875250,3575875270,20
3,915,18404,3575875250,3575875273,23
3,915,18405,3575875250,3575875274,24
3,915,18406,3575875250,3575875280,30
3,915,18407,3575875250,3575875280,30
3,915,18408,3575875250,3575875280,30
3,915,18409,3575875250,3575875281,31
3,915,18410,3575875250,3575875281,31
3,915,18411,3575875250,3575875282,32
3,915,18412,3575875250,3575875283,33
3,915,18413,3575875250,3575875285,35
3,915,18414,3575875250,3575875286,36
3,915,18415,3575875250,3575875286,36
3,915,18416,3575875250,3575875286,36
3,915,18417,3575875250,3575875286,36
3,915,18418,3575875250,3575875287,37
3,915,18419,3575875250,3575875289,39
3,915,18420,3575875250,3575875292,42
3,915,18421,3575875250,3575875292,42
3,915,18422,3575875250,3575875293,43
3,915,18423,3575875250,3575875298,48
3,915,18424,3575875250,3575875300,50
3,915,18425,3575875250,3575875300,50
3,916,18426,3575875314,3575875314,0
3,916,18427,3575875314,3575875314,0
3,916,18428,3575875314,3575875314,0
3,916,18429,3575875314,3575875314,0
3,916,18430,3575875314,3575875314,0
3,916,18431,3575875314,3575875314,0
3,916,18432,3575875314,3575875314,0
3,916,18433,3575875314,3575875314,0
3,916,18434,3575875314,3575875314,0
3,916,18435,3575875314,3575875314,0
3,916,18436,3575875314,3575875314,0
3,916,18437,3575875314,3575875314,0
3,916,18438,3575875314,3575875314,0
3,916,18439,3575875314,3575875317,3
3,916,18440,3575875314,3575875317,3
3,916,18441,3575875314,3575875317,3
3,916,18442,3575875314,3575875320,6
3,916,18443,3575875314,3575875321,7
3,916,18444,3575875314,3575875323,9
3,916,18445,3575875314,3575875324,10
3,916,18446,3575875314,3575875327,13
3,916,18447,3575875314,3575875327,13
3,916,18448,3575875314,3575875327,13
3,916,18449,3575875314,3575875327,13
3,916,18450,3575875314,3575875331,17
3,916,18451,3575875314,3575875334,20
3,916,18452,3575875314,3575875336,22
3,916,18453,3575875314,3575875337,23
3,916,18454,3575875314,3575875338,24
3,916,18455,3575875314,3575875341,27
3,916,18456,3575875314,3575875342,28
3,916,18457,3575875314,3575875343,29
3,916,18458,3575875314,3575875344,30
3,916,18459,3575875314,3575875344,30
3,916,18460,3575875314,3575875348,34
3,916,18461,3575875314,3575875349,35
3,916,18462,3575875314,3575875352,38
3,916,18463,3575875314,3575875352,38
3,916,18464,3575875314,3575875356,42
3,916,18465,3575875314,3575875356,42
3,916,18466,3575875314,3575875357,43
3,916,18467,3575875314,3575875359,45
3,916,18468,3575875314,3575875363,49
3,916,18469,3575875314,3575875364,50
3,917,18470,3575875375,3575875375,0
3,917,18471,3575875375,3575875375,0
3,917,18472,3575875375,3575875375,0
3,917,18473,3575875375,3575875375,0
3,917,18474,3575875375,3575875375,0
3,917,18475,3575875375,3575875375,0
3,917,18476,3575875375,3575875375,0
3,917,18477,3575875375,3575875375,0
3,917,18478,3575875375,3575875375,0
3,917,18479,3575875375,3575875375,0
3,917,18480,3575875375,3575875376,1
3,917,18481,3575875375,3575875377,2
3,917,18482,3575875375,3575875377,2
3,917,18483,3575875375,3575875377,2
3,917,18484,3575875375,3575875378,3
3,917,18485,3575875375,3575875379,4
3,917,18486,3575875375,3575875379,4
3,917,18487,3575875375,3575875380,5
3,917,18488,3575875375,3575875381,6
3,917,18489,3575875375,3575875382,7
3,917,18490,3575875375,3575875384,9
3,917,18491,3575875375,3575875384,9
3,917,18492,3575875375,3575875386,11
3,917,18493,3575875375,3575875386,11
3,917,18494,3575875375,3575875386,11
3,917,18495,3575875375,3575875387,12
3,917,18496,3575875375,3575875389,14
3,917,18497,3575875375,3575875393,18
3,917,18498,3575875375,3575875394,19
3,917,18499,3575875375,3575875395,20
3,917,18500,3575875375,3575875395,20
3,917,18501,3575875375,3575875395,20
3,917,18502,3575875375,3575875395,20
3,917,18503,3575875375,3575875396,21
3,917,18504,3575875375,3575875396,21
3,917,18505,3575875375,3575875396,21
3,917,18506,3575875375,3575875397,22
3,917,18507,3575875375,3575875397,22
3,917,18508,3575875375,3575875400,25
3,917,18509,3575875375,3575875401,26
3,917,18510,3575875375,3575875401,26
3,917,18511,3575875375,3575875404,29
3,917,18512,3575875375,3575875405,30
3,917,18513,3575875375,3575875406,31
3,917,18514,3575875375,3575875406,31
3,917,18515,3575875375,3575875407,32
3,917,18516,3575875375,3575875408,33
3,917,18517,3575875375,3575875412,37
3,917,18518,3575875375,3575875415,40
3,917,18519,3575875375,3575875416,41
3,917,18520,3575875375,3575875417,42
3,917,18521,3575875375,3575875419,44
3,917,18522,3575875375,3575875419,44
3,917,18523,3575875375,3575875419,44
3,917,18524,3575875375,3575875421,46
3,917,18525,3575875375,3575875422,47
3,917,18526,3575875375,3575875423,48
3,917,18527,3575875375,3575875424,49
3,918,18528,3575875439,3575875440,1
3,918,18529,3575875439,3575875440,1
3,918,18530,3575875439,3575875440,1
3,918,18531,3575875439,3575875440,1
3,918,18532,3575875439,3575875440,1
3,918,18533,3575875439,3575875440,1
3,918,18534,3575875439,3575875440,1
3,918,18535,3575875439,3575875440,1
3,918,18536,3575875439,3575875440,1
3,918,18537,3575875439,3575875440,1
3,918,18538,3575875439,3575875440,1
3,918,18539,3575875439,3575875440,1
3,918,18540,3575875439,3575875440,1
3,918,18541,3575875439,3575875440,1
3,918,18542,3575875439,3575875440,1
3,918,18543,3575875439,3575875440,1
3,918,18544,3575875439,3575875440,1
3,918,18545,3575875439,3575875440,1
3,918,18546,3575875439,3575875440,1
3,918,18547,3575875439,3575875442,3
3,918,18548,3575875439,3575875443,4
3,918,18549,3575875439,3575875444,5
3,918,18550,3575875439,3575875445,6
3,918,18551,3575875439,3575875445,6
3,918,18552,3575875439,3575875446,7
3,918,18553,3575875439,3575875448,9
3,918,18554,3575875439,3575875451,12
3,918,18555,3575875439,3575875453,14
3,918,18556,3575875439,3575875453,14
3,918,18557,3575875439,3575875454,15
3,918,18558,3575875439,3575875455,16
3,918,18559,3575875439,3575875455,16
3,918,18560,3575875439,3575875456,17
3,918,18561,3575875439,3575875457,18
3,918,18562,3575875439,3575875459,20
3,918,18563,3575875439,3575875459,20
3,918,18564,3575875439,3575875459,20
3,918,18565,3575875439,3575875460,21
3,918,18566,3575875439,3575875463,24
3,918,18567,3575875439,3575875465,26
3,918,18568,3575875439,3575875465,26
3,918,18569,3575875439,3575875465,26
3,918,18570,3575875439,3575875467,28
3,918,18571,3575875439,3575875467,28
3,918,18572,3575875439,3575875467,28
3,918,18573,3575875439,3575875467,28
3,918,18574,3575875439,3575875468,29
3,918,18575,3575875439,3575875468,29
3,918,18576,3575875439,3575875471,32
3,918,18577,3575875439,3575875473,34
3,918,18578,3575875439,3575875475,36
3,918,18579,3575875439,3575875480,41
3,918,18580,3575875439,3575875480,41
3,918,18581,3575875439,3575875480,41
3,918,18582,3575875439,3575875481,42
3,918,18583,3575875439,3575875481,42
3,918,18584,3575875439,3575875481,42
3,918,18585,3575875439,3575875484,45
3,918,18586,3575875439,3575875485,46
3,918,18587,3575875439,3575875485,46
3,918,18588,3575875439,3575875486,47
3,918,18589,3575875439,3575875487,48
3,918,18590,3575875439,3575875487,48
3,918,18591,3575875439,3575875487,48
3,918,18592,3575875439,3575875489,50
3,919,18593,3575875499,3575875499,0
3,919,18594,3575875499,3575875499,0
3,919,18595,3575875499,3575875499,0
3,919,18596,3575875499,3575875499,0
3,919,18597,3575875499,3575875499,0
3,919,18598,3575875499,3575875499,0
3,919,18599,3575875499,3575875499,0
3,919,18600,3575875499,3575875500,1
3,919,18601,3575875499,3575875500,1
3,919,18602,3575875499,3575875501,2
3,919,18603,3575875499,3575875502,3
3,919,18604,3575875499,3575875503,4
3,919,18605,3575875499,3575875503,4
3,919,18606,3575875499,3575875504,5
3,919,18607,3575875499,3575875505,6
3,919,18608,3575875499,3575875507,8
3,919,18609,3575875499,3575875508,9
3,919,18610,3575875499,3575875511,12
3,919,18611,3575875499,3575875511,12
3,919,18612,3575875499,3575875512,13
3,919,18613,3575875499,3575875516,17
3,919,18614,3575875499,3575875516,17
3,919,18615,3575875499,3575875516,17
3,919,18616,3575875499,3575875519,20
3,919,18617,3575875499,3575875520,21
3,919,18618,3575875499,3575875521,22
3,919,18619,3575875499,3575875523,24
3,919,18620,3575875499,3575875523,24
3,919,18621,3575875499,3575875526,27
3,919,18622,3575875499,3575875526,27
3,919,18623,3575875499,3575875526,27
3,919,18624,3575875499,3575875526,27
3,919,18625,3575875499,3575875531,32
3,919,18626,3575875499,3575875533,34
3,919,18627,3575875499,3575875535,36
3,919,18628,3575875499,3575875536,37
3,919,18629,3575875499,3575875537,38
3,919,18630,3575875499,3575875540,41
3,919,18631,3575875499,3575875541,42
3,919,18632,3575875499,3575875541,42
3,919,18633,3575875499,3575875543,44
3,919,18634,3575875499,3575875543,44
3,919,18635,3575875499,3575875547,48
3,919,18636,3575875499,3575875548,49
3,920,18637,3575875559,3575875559,0
3,920,18638,3575875559,3575875559,0
3,920,18639,3575875559,3575875559,0
3,920,18640,3575875559,3575875559,0
3,920,18641,3575875559,3575875559,0
3,920,18642,3575875559,3575875559,0
3,920,18643,3575875559,3575875562,3
3,920,18644,3575875559,3575875564,5
3,920,18645,3575875559,3575875566,7
3,920,18646,3575875559,3575875567,8
3,920,18647,3575875559,3575875568,9
3,920,18648,3575875559,3575875569,10
3,920,18649,3575875559,3575875569,10
3,920,18650,3575875559,3575875571,12
3,920,18651,3575875559,3575875573,14
3,920,18652,3575875559,3575875575,16
3,920,18653,3575875559,3575875576,17
3,920,18654,3575875559,3575875576,17
3,920,18655,3575875559,3575875577,18
3,920,18656,3575875559,3575875578,19
3,920,18657,3575875559,3575875578,19
3,920,18658,3575875559,3575875580,21
3,920,18659,3575875559,3575875580,21
3,920,18660,3575875559,3575875581,22
3,920,18661,3575875559,3575875582,23
3,920,18662,3575875559,3575875583,24
3,920,18663,3575875559,3575875583,24
3,920,18664,3575875559,3575875586,27
3,920,18665,3575875559,3575875586,27
3,920,18666,3575875559,3575875586,27
3,920,18667,3575875559,3575875586,27
3,920,18668,3575875559,3575875591,32
3,920,18669,3575875559,3575875592,33
3,920,18670,3575875559,3575875594,35
3,920,18671,3575875559,3575875594,35
3,920,18672,3575875559,3575875594,35
3,920,18673,3575875559,3575875595,36
3,920,18674,3575875559,3575875595,36
3,920,18675,3575875559,3575875595,36
3,920,18676,3575875559,3575875595,36
3,920,18677,3575875559,3575875595,36
3,920,18678,3575875559,3575875596,37
3,920,18679,3575875559,3575875596,37
3,920,18680,3575875559,3575875599,40
3,920,18681,3575875559,3575875600,41
3,920,18682,3575875559,3575875600,41
3,920,18683,3575875559,3575875601,42
3,920,18684,3575875559,3575875602,43
3,920,18685,3575875559,3575875603,44
3,920,18686,3575875559,3575875603,44
3,920,18687,3575875559,3575875605,46
3,920,18688,3575875559,3575875605,46
3,920,18689,3575875559,3575875605,46
3,920,18690,3575875559,3575875608,49
3,921,18691,3575875619,3575875619,0
3,921,18692,3575875619,3575875619,0
3,921,18693,3575875619,3575875619,0
3,921,18694,3575875619,3575875619,0
3,921,18695,3575875619,3575875619,0
3,921,18696,3575875619,3575875619,0
3,921,18697,3575875619,3575875619,0
3,921,18698,3575875619,3575875620,1
3,921,18699,3575875619,3575875621,2
3,921,18700,3575875619,3575875623,4
3,921,18701,3575875619,3575875625,6
3,921,18702,3575875619,3575875625,6
3,921,18703,3575875619,3575875625,6
3,921,18704,3575875619,3575875628,9
3,921,18705,3575875619,3575875629,10
3,921,18706,3575875619,3575875629,10
3,921,18707,3575875619,3575875629,10
3,921,18708,3575875619,3575875631,12
3,921,18709,3575875619,3575875634,15
3,921,18710,3575875619,3575875635,16
3,921,18711,3575875619,3575875636,17
3,921,18712,3575875619,3575875637,18
3,921,18713,3575875619,3575875637,18
3,921,18714,3575875619,3575875637,18
3,921,18715,3575875619,3575875637,18
3,921,18716,3575875619,3575875637,18
3,921,18717,3575875619,3575875637,18
3,921,18718,3575875619,3575875638,19
3,921,18719,3575875619,3575875638,19
3,921,18720,3575875619,3575875639,20
3,921,18721,3575875619,3575875639,20
3,921,18722,3575875619,3575875641,22
3,921,18723,3575875619,3575875642,23
3,921,18724,3575875619,3575875643,24
3,921,18725,3575875619,3575875644,25
3,921,18726,3575875619,3575875645,26
3,921,18727,3575875619,3575875646,27
3,921,18728,3575875619,3575875647,28
3,921,18729,3575875619,3575875651,32
3,921,18730,3575875619,3575875652,33
3,921,18731,3575875619,3575875653,34
3,921,18732,3575875619,3575875653,34
3,921,18733,3575875619,3575875654,35
3,921,18734,3575875619,3575875655,36
3,921,18735,3575875619,3575875655,36
3,921,18736,3575875619,3575875657,38
3,921,18737,3575875619,3575875658,39
3,921,18738,3575875619,3575875658,39
3,921,18739,3575875619,3575875658,39
3,921,18740,3575875619,3575875661,42
3,921,18741,3575875619,3575875661,42
3,921,18742,3575875619,3575875663,44
3,921,18743,3575875619,3575875663,44
3,921,18744,3575875619,3575875663,44
3,921,18745,3575875619,3575875665,46
3,921,18746,3575875619,3575875666,47
3,921,18747,3575875619,3575875666,47
3,921,18748,3575875619,3575875666,47
3,921,18749,3575875619,3575875667,48
3,921,18750,3575875619,3575875667,48
3,922,18751,3575875682,3575875682,0
3,922,18752,3575875682,3575875682,0
3,922,18753,3575875682,3575875682,0
3,922,18754,3575875682,3575875682,0
3,922,18755,3575875682,3575875682,0
3,922,18756,3575875682,3575875682,0
3,922,18757,3575875682,3575875682,0
3,922,18758,3575875682,3575875684,2
3,922,18759,3575875682,3575875686,4
3,922,18760,3575875682,3575875686,4
3,922,18761,3575875682,3575875686,4
3,922,18762,3575875682,3575875687,5
3,922,18763,3575875682,3575875687,5
3,922,18764,3575875682,3575875687,5
3,922,18765,3575875682,3575875689,7
3,922,18766,3575875682,3575875693,11
3,922,18767,3575875682,3575875693,11
3,922,18768,3575875682,3575875694,12
3,922,18769,3575875682,3575875695,13
3,922,18770,3575875682,3575875696,14
3,922,18771,3575875682,3575875699,17
3,922,18772,3575875682,3575875699,17
3,922,18773,3575875682,3575875699,17
3,922,18774,3575875682,3575875700,18
3,922,18775,3575875682,3575875700,18
3,922,18776,3575875682,3575875700,18
3,922,18777,3575875682,3575875701,19
3,922,18778,3575875682,3575875703,21
3,922,18779,3575875682,3575875703,21
3,922,18780,3575875682,3575875704,22
3,922,18781,3575875682,3575875706,24
3,922,18782,3575875682,3575875707,25
3,922,18783,3575875682,3575875708,26
3,922,18784,3575875682,3575875711,29
3,922,18785,3575875682,3575875711,29
3,922,18786,3575875682,3575875712,30
3,922,18787,3575875682,3575875716,34
3,922,18788,3575875682,3575875716,34
3,922,18789,3575875682,3575875717,35
3,922,18790,3575875682,3575875719,37
3,922,18791,3575875682,3575875720,38
3,922,18792,3575875682,3575875721,39
3,922,18793,3575875682,3575875722,40
3,922,18794,3575875682,3575875723,41
3,922,18795,3575875682,3575875726,44
3,922,18796,3575875682,3575875726,44
3,922,18797,3575875682,3575875726,44
3,922,18798,3575875682,3575875726,44
3,922,18799,3575875682,3575875731,49
3,923,18800,3575875745,3575875745,0
3,923,18801,3575875745,3575875745,0
3,923,18802,3575875745,3575875745,0
3,923,18803,3575875745,3575875745,0
3,923,18804,3575875745,3575875745,0
3,923,18805,3575875745,3575875745,0
3,923,18806,3575875745,3575875745,0
3,923,18807,3575875745,3575875745,0
3,923,18808,3575875745,3575875747,2
3,923,18809,3575875745,3575875748,3
3,923,18810,3575875745,3575875751,6
3,923,18811,3575875745,3575875751,6
3,923,18812,3575875745,3575875754,9
3,923,18813,3575875745,3575875756,11
3,923,18814,3575875745,3575875756,11
3,923,18815,3575875745,3575875757,12
3,923,18816,3575875745,3575875759,14
3,923,18817,3575875745,3575875763,18
3,923,18818,3575875745,3575875764,19
3,923,18819,3575875745,3575875765,20
3,923,18820,3575875745,3575875767,22
3,923,18821,3575875745,3575875768,23
3,923,18822,3575875745,3575875769,24
3,923,18823,3575875745,3575875769,24
3,923,18824,3575875745,3575875769,24
3,923,18825,3575875745,3575875769,24
3,923,18826,3575875745,3575875770,25
3,923,18827,3575875745,3575875771,26
3,923,18828,3575875745,3575875772,27
3,923,18829,3575875745,3575875775,30
3,923,18830,3575875745,3575875776,31
3,923,18831,3575875745,3575875778,33
3,923,18832,3575875745,3575875778,33
3,923,18833,3575875745,3575875778,33
3,923,18834,3575875745,3575875779,34
3,923,18835,3575875745,3575875779,34
3,923,18836,3575875745,3575875781,36
3,923,18837,3575875745,3575875781,36
3,923,18838,3575875745,3575875781,36
3,923,18839,3575875745,3575875783,38
3,923,18840,3575875745,3575875783,38
3,923,18841,3575875745,3575875785,40
3,923,18842,3575875745,3575875786,41
3,923,18843,3575875745,3575875786,41
3,923,18844,3575875745,3575875786,41
3,923,18845,3575875745,3575875787,42
3,923,18846,3575875745,3575875791,46
3,923,18847,3575875745,3575875792,47
3,923,18848,3575875745,3575875793,48
3,923,18849,3575875745,3575875794,49
3,923,18850,3575875745,3575875794,49
3,923,18851,3575875745,3575875795,50
3,924,18852,3575875808,3575875808,0
3,924,18853,3575875808,3575875808,0
3,924,18854,3575875808,3575875808,0
3,924,18855,3575875808,3575875808,0
3,924,18856,3575875808,3575875808,0
3,924,18857,3575875808,3575875808,0
3,924,18858,3575875808,3575875808,0
3,924,18859,3575875808,3575875808,0
3,924,18860,3575875808,3575875808,0
3,924,18861,3575875808,3575875808,0
3,924,18862,3575875808,3575875808,0
3,924,18863,3575875808,3575875808,0
3,924,18864,3575875808,3575875808,0
3,924,18865,3575875808,3575875808,0
3,924,18866,3575875808,3575875808,0
3,924,18867,3575875808,3575875808,0
3,924,18868,3575875808,3575875808,0
3,924,18869,3575875808,3575875808,0
3,924,18870,3575875808,3575875810,2
3,924,18871,3575875808,3575875815,7
3,924,18872,3575875808,3575875816,8
3,924,18873,3575875808,3575875816,8
3,924,18874,3575875808,3575875818,10
3,924,18875,3575875808,3575875819,11
3,924,18876,3575875808,3575875820,12
3,924,18877,3575875808,3575875820,12
3,924,18878,3575875808,3575875821,13
3,924,18879,3575875808,3575875823,15
3,924,18880,3575875808,3575875824,16
3,924,18881,3575875808,3575875825,17
3,924,18882,3575875808,3575875826,18
3,924,18883,3575875808,3575875828,20
3,924,18884,3575875808,3575875829,21
3,924,18885,3575875808,3575875830,22
3,924,18886,3575875808,3575875830,22
3,924,18887,3575875808,3575875834,26
3,924,18888,3575875808,3575875835,27
3,924,18889,3575875808,3575875835,27
3,924,18890,3575875808,3575875837,29
3,924,18891,3575875808,3575875837,29
3,924,18892,3575875808,3575875837,29
3,924,18893,3575875808,3575875837,29
3,924,18894,3575875808,3575875838,30
3,924,18895,3575875808,3575875838,30
3,924,18896,3575875808,3575875838,30
3,924,18897,3575875808,3575875838,30
3,924,18898,3575875808,3575875838,30
3,924,18899,3575875808,3575875840,32
3,924,18900,3575875808,3575875840,32
3,924,18901,3575875808,3575875841,33
3,924,18902,3575875808,3575875842,34
3,924,18903,3575875808,3575875843,35
3,924,18904,3575875808,3575875844,36
3,924,18905,3575875808,3575875844,36
3,924,18906,3575875808,3575875845,37
3,924,18907,3575875808,3575875846,38
3,924,18908,3575875808,3575875848,40
3,924,18909,3575875808,3575875850,42
3,924,18910,3575875808,3575875852,44
3,924,18911,3575875808,3575875853,45
3,924,18912,3575875808,3575875854,46
3,924,18913,3575875808,3575875854,46
3,924,18914,3575875808,3575875855,47
3,924,18915,3575875808,3575875857,49
3,925,18916,3575875868,3575875868,0
3,925,18917,3575875868,3575875868,0
3,925,18918,3575875868,3575875868,0
3,925,18919,3575875868,3575875868,0
3,925,18920,3575875868,3575875868,0
3,925,18921,3575875868,3575875868,0
3,925,18922,3575875868,3575875868,0
3,925,18923,3575875868,3575875868,0
3,925,18924,3575875868,3575875868,0
3,925,18925,3575875868,3575875868,0
3,925,18926,3575875868,3575875868,0
3,925,18927,3575875868,3575875868,0
3,925,18928,3575875868,3575875871,3
3,925,18929,3575875868,3575875873,5
3,925,18930,3575875868,3575875875,7
3,925,18931,3575875868,3575875881,13
3,925,18932,3575875868,3575875881,13
3,925,18933,3575875868,3575875882,14
3,925,18934,3575875868,3575875882,14
3,925,18935,3575875868,3575875883,15
3,925,18936,3575875868,3575875883,15
3,925,18937,3575875868,3575875885,17
3,925,18938,3575875868,3575875886,18
3,925,18939,3575875868,3575875886,18
3,925,18940,3575875868,3575875886,18
3,925,18941,3575875868,3575875887,19
3,925,18942,3575875868,3575875887,19
3,925,18943,3575875868,3575875887,19
3,925,18944,3575875868,3575875889,21
3,925,18945,3575875868,3575875894,26
3,925,18946,3575875868,3575875894,26
3,925,18947,3575875868,3575875895,27
3,925,18948,3575875868,3575875896,28
3,925,18949,3575875868,3575875896,28
3,925,18950,3575875868,3575875899,31
3,925,18951,3575875868,3575875899,31
3,925,18952,3575875868,3575875899,31
3,925,18953,3575875868,3575875900,32
3,925,18954,3575875868,3575875900,32
3,925,18955,3575875868,3575875900,32
3,925,18956,3575875868,3575875902,34
3,925,18957,3575875868,3575875902,34
3,925,18958,3575875868,3575875903,35
3,925,18959,3575875868,3575875904,36
3,925,18960,3575875868,3575875907,39
3,925,18961,3575875868,3575875908,40
3,925,18962,3575875868,3575875911,43
3,925,18963,3575875868,3575875912,44
3,925,18964,3575875868,3575875912,44
3,925,18965,3575875868,3575875916,48
3,925,18966,3575875868,3575875917,49
3,925,18967,3575875868,3575875917,49
3,926,18968,3575875931,3575875931,0
3,926,18969,3575875931,3575875931,0
3,926,18970,3575875931,3575875931,0
3,926,18971,3575875931,3575875931,0
3,926,18972,3575875931,3575875931,0
3,926,18973,3575875931,3575875931,0
3,926,18974,3575875931,3575875931,0
3,926,18975,3575875931,3575875931,0
3,926,18976,3575875931,3575875931,0
3,926,18977,3575875931,3575875934,3
3,926,18978,3575875931,3575875937,6
3,926,18979,3575875931,3575875937,6
3,926,18980,3575875931,3575875937,6
3,926,18981,3575875931,3575875942,11
3,926,18982,3575875931,3575875942,11
3,926,18983,3575875931,3575875942,11
3,926,18984,3575875931,3575875943,12
3,926,18985,3575875931,3575875944,13
3,926,18986,3575875931,3575875946,15
3,926,18987,3575875931,3575875950,19
3,926,18988,3575875931,3575875950,19
3,926,18989,3575875931,3575875951,20
3,926,18990,3575875931,3575875955,24
3,926,18991,3575875931,3575875956,25
3,926,18992,3575875931,3575875956,25
3,926,18993,3575875931,3575875958,27
3,926,18994,3575875931,3575875960,29
3,926,18995,3575875931,3575875963,32
3,926,18996,3575875931,3575875964,33
3,926,18997,3575875931,3575875965,34
3,926,18998,3575875931,3575875967,36
3,926,18999,3575875931,3575875967,36
3,926,19000,3575875931,3575875968,37
3,926,19001,3575875931,3575875968,37
3,926,19002,3575875931,3575875969,38
3,926,19003,3575875931,3575875970,39
3,926,19004,3575875931,3575875971,40
3,926,19005,3575875931,3575875972,41
3,926,19006,3575875931,3575875975,44
3,926,19007,3575875931,3575875977,46
3,926,19008,3575875931,3575875978,47
3,926,19009,3575875931,3575875978,47
3,926,19010,3575875931,3575875978,47
3,926,19011,3575875931,3575875978,47
3,926,19012,3575875931,3575875980,49
3,927,19013,3575875994,3575875994,0
3,927,19014,3575875994,3575875994,0
3,927,19015,3575875994,3575875994,0
3,927,19016,3575875994,3575875994,0
3,927,19017,3575875994,3575875994,0
3,927,19018,3575875994,3575875994,0
3,927,19019,3575875994,3575875994,0
3,927,19020,3575875994,3575875994,0
3,927,19021,3575875994,3575875994,0
3,927,19022,3575875994,3575875994,0
3,927,19023,3575875994,3575875994,0
3,927,19024,3575875994,3575875994,0
3,927,19025,3575875994,3575875995,1
3,927,19026,3575875994,3575875995,1
3,927,19027,3575875994,3575875995,1
3,927,19028,3575875994,3575875995,1
3,927,19029,3575875994,3575875995,1
3,927,19030,3575875994,3575875995,1
3,927,19031,3575875994,3575875997,3
3,927,19032,3575875994,3575875997,3
3,927,19033,3575875994,3575876000,6
3,927,19034,3575875994,3575876000,6
3,927,19035,3575875994,3575876000,6
3,927,19036,3575875994,3575876001,7
3,927,19037,3575875994,3575876002,8
3,927,19038,3575875994,3575876004,10
3,927,19039,3575875994,3575876005,11
3,927,19040,3575875994,3575876005,11
3,927,19041,3575875994,3575876005,11
3,927,19042,3575875994,3575876006,12
3,927,19043,3575875994,3575876008,14
3,927,19044,3575875994,3575876012,18
3,927,19045,3575875994,3575876015,21
3,927,19046,3575875994,3575876015,21
3,927,19047,3575875994,3575876016,22
3,927,19048,3575875994,3575876019,25
3,927,19049,3575875994,3575876019,25
3,927,19050,3575875994,3575876020,26
3,927,19051,3575875994,3575876020,26
3,927,19052,3575875994,3575876021,27
3,927,19053,3575875994,3575876022,28
3,927,19054,3575875994,3575876023,29
3,927,19055,3575875994,3575876025,31
3,927,19056,3575875994,3575876025,31
3,927,19057,3575875994,3575876025,31
3,927,19058,3575875994,3575876029,35
3,927,19059,3575875994,3575876029,35
3,927,19060,3575875994,3575876029,35
3,927,19061,3575875994,3575876031,37
3,927,19062,3575875994,3575876031,37
3,927,19063,3575875994,3575876034,40
3,927,19064,3575875994,3575876035,41
3,927,19065,3575875994,3575876036,42
3,927,19066,3575875994,3575876037,43
3,927,19067,3575875994,3575876037,43
3,927,19068,3575875994,3575876037,43
3,927,19069,3575875994,3575876037,43
3,927,19070,3575875994,3575876038,44
3,927,19071,3575875994,3575876039,45
3,927,19072,3575875994,3575876039,45
3,927,19073,3575875994,3575876039,45
3,927,19074,3575875994,3575876040,46
3,927,19075,3575875994,3575876041,47
3,927,19076,3575875994,3575876041,47
3,927,19077,3575875994,3575876044,50
3,928,19078,3575876056,3575876056,0
3,928,19079,3575876056,3575876056,0
3,928,19080,3575876056,3575876056,0
3,928,19081,3575876056,3575876056,0
3,928,19082,3575876056,3575876056,0
3,928,19083,3575876056,3575876056,0
3,928,19084,3575876056,3575876056,0
3,928,19085,3575876056,3575876056,0
3,928,19086,3575876056,3575876056,0
3,928,19087,3575876056,3575876056,0
3,928,19088,3575876056,3575876056,0
3,928,19089,3575876056,3575876059,3
3,928,19090,3575876056,3575876059,3
3,928,19091,3575876056,3575876059,3
3,928,19092,3575876056,3575876061,5
3,928,19093,3575876056,3575876062,6
3,928,19094,3575876056,3575876063,7
3,928,19095,3575876056,3575876063,7
3,928,19096,3575876056,3575876065,9
3,928,19097,3575876056,3575876066,10
3,928,19098,3575876056,3575876066,10
3,928,19099,3575876056,3575876067,11
3,928,19100,3575876056,3575876071,15
3,928,19101,3575876056,3575876073,17
3,928,19102,3575876056,3575876076,20
3,928,19103,3575876056,3575876080,24
3,928,19104,3575876056,3575876081,25
3,928,19105,3575876056,3575876082,26
3,928,19106,3575876056,3575876082,26
3,928,19107,3575876056,3575876082,26
3,928,19108,3575876056,3575876082,26
3,928,19109,3575876056,3575876085,29
3,928,19110,3575876056,3575876085,29
3,928,19111,3575876056,3575876086,30
3,928,19112,3575876056,3575876087,31
3,928,19113,3575876056,3575876087,31
3,928,19114,3575876056,3575876087,31
3,928,19115,3575876056,3575876089,33
3,928,19116,3575876056,3575876094,38
3,928,19117,3575876056,3575876095,39
3,928,19118,3575876056,3575876095,39
3,928,19119,3575876056,3575876096,40
3,928,19120,3575876056,3575876096,40
3,928,19121,3575876056,3575876099,43
3,928,19122,3575876056,3575876099,43
3,928,19123,3575876056,3575876099,43
3,928,19124,3575876056,3575876100,44
3,928,19125,3575876056,3575876101,45
3,928,19126,3575876056,3575876101,45
3,928,19127,3575876056,3575876102,46
3,928,19128,3575876056,3575876103,47
3,928,19129,3575876056,3575876103,47
3,929,19130,3575876117,3575876118,1
3,929,19131,3575876117,3575876118,1
3,929,19132,3575876117,3575876118,1
3,929,19133,3575876117,3575876118,1
3,929,19134,3575876117,3575876118,1
3,929,19135,3575876117,3575876118,1
3,929,19136,3575876117,3575876118,1
3,929,19137,3575876117,3575876118,1
3,929,19138,3575876117,3575876121,4
3,929,19139,3575876117,3575876122,5
3,929,19140,3575876117,3575876123,6
3,929,19141,3575876117,3575876127,10
3,929,19142,3575876117,3575876127,10
3,929,19143,3575876117,3575876127,10
3,929,19144,3575876117,3575876128,11
3,929,19145,3575876117,3575876130,13
3,929,19146,3575876117,3575876132,15
3,929,19147,3575876117,3575876135,18
3,929,19148,3575876117,3575876137,20
3,929,19149,3575876117,3575876137,20
3,929,19150,3575876117,3575876137,20
3,929,19151,3575876117,3575876142,25
3,929,19152,3575876117,3575876142,25
3,929,19153,3575876117,3575876143,26
3,929,19154,3575876117,3575876143,26
3,929,19155,3575876117,3575876143,26
3,929,19156,3575876117,3575876147,30
3,929,19157,3575876117,3575876149,32
3,929,19158,3575876117,3575876152,35
3,929,19159,3575876117,3575876155,38
3,929,19160,3575876117,3575876157,40
3,929,19161,3575876117,3575876160,43
3,929,19162,3575876117,3575876161,44
3,929,19163,3575876117,3575876162,45
3,929,19164,3575876117,3575876164,47
3,929,19165,3575876117,3575876165,48
3,929,19166,3575876117,3575876167,50
3,930,19167,3575876177,3575876177,0
3,930,19168,3575876177,3575876177,0
3,930,19169,3575876177,3575876177,0
3,930,19170,3575876177,3575876177,0
3,930,19171,3575876177,3575876177,0
3,930,19172,3575876177,3575876177,0
3,930,19173,3575876177,3575876177,0
3,930,19174,3575876177,3575876177,0
3,930,19175,3575876177,3575876177,0
3,930,19176,3575876177,3575876177,0
3,930,19177,3575876177,3575876178,1
3,930,19178,3575876177,3575876178,1
3,930,19179,3575876177,3575876179,2
3,930,19180,3575876177,3575876180,3
3,930,19181,3575876177,3575876180,3
3,930,19182,3575876177,3575876181,4
3,930,19183,3575876177,3575876182,5
3,930,19184,3575876177,3575876184,7
3,930,19185,3575876177,3575876186,9
3,930,19186,3575876177,3575876186,9
3,930,19187,3575876177,3575876187,10
3,930,19188,3575876177,3575876187,10
3,930,19189,3575876177,3575876187,10
3,930,19190,3575876177,3575876191,14
3,930,19191,3575876177,3575876192,15
3,930,19192,3575876177,3575876194,17
3,930,19193,3575876177,3575876195,18
3,930,19194,3575876177,3575876195,18
3,930,19195,3575876177,3575876195,18
3,930,19196,3575876177,3575876195,18
3,930,19197,3575876177,3575876195,18
3,930,19198,3575876177,3575876195,18
3,930,19199,3575876177,3575876196,19
3,930,19200,3575876177,3575876196,19
3,930,19201,3575876177,3575876197,20
3,930,19202,3575876177,3575876197,20
3,930,19203,3575876177,3575876200,23
3,930,19204,3575876177,3575876200,23
3,930,19205,3575876177,3575876200,23
3,930,19206,3575876177,3575876201,24
3,930,19207,3575876177,3575876203,26
3,930,19208,3575876177,3575876204,27
3,930,19209,3575876177,3575876205,28
3,930,19210,3575876177,3575876205,28
3,930,19211,3575876177,3575876206,29
3,930,19212,3575876177,3575876206,29
3,930,19213,3575876177,3575876208,31
3,930,19214,3575876177,3575876211,34
3,930,19215,3575876177,3575876215,38
3,930,19216,3575876177,3575876216,39
3,930,19217,3575876177,3575876216,39
3,930,19218,3575876177,3575876218,41
3,930,19219,3575876177,3575876220,43
3,930,19220,3575876177,3575876220,43
3,930,19221,3575876177,3575876220,43
3,930,19222,3575876177,3575876221,44
3,930,19223,3575876177,3575876223,46
3,930,19224,3575876177,3575876224,47
3,930,19225,3575876177,3575876225,48
3,930,19226,3575876177,3575876226,49
3,930,19227,3575876177,3575876226,49
3,931,19228,3575876237,3575876237,0
3,931,19229,3575876237,3575876237,0
3,931,19230,3575876237,3575876237,0
3,931,19231,3575876237,3575876237,0
3,931,19232,3575876237,3575876237,0
3,931,19233,3575876237,3575876237,0
3,931,19234,3575876237,3575876237,0
3,931,19235,3575876237,3575876237,0
3,931,19236,3575876237,3575876237,0
3,931,19237,3575876237,3575876237,0
3,931,19238,3575876237,3575876237,0
3,931,19239,3575876237,3575876238,1
3,931,19240,3575876237,3575876238,1
3,931,19241,3575876237,3575876239,2
3,931,19242,3575876237,3575876240,3
3,931,19243,3575876237,3575876240,3
3,931,19244,3575876237,3575876240,3
3,931,19245,3575876237,3575876241,4
3,931,19246,3575876237,3575876241,4
3,931,19247,3575876237,3575876243,6
3,931,19248,3575876237,3575876246,9
3,931,19249,3575876237,3575876246,9
3,931,19250,3575876237,3575876246,9
3,931,19251,3575876237,3575876248,11
3,931,19252,3575876237,3575876249,12
3,931,19253,3575876237,3575876251,14
3,931,19254,3575876237,3575876253,16
3,931,19255,3575876237,3575876253,16
3,931,19256,3575876237,3575876253,16
3,931,19257,3575876237,3575876255,18
3,931,19258,3575876237,3575876256,19
3,931,19259,3575876237,3575876256,19
3,931,19260,3575876237,3575876256,19
3,931,19261,3575876237,3575876259,22
3,931,19262,3575876237,3575876259,22
3,931,19263,3575876237,3575876259,22
3,931,19264,3575876237,3575876262,25
3,931,19265,3575876237,3575876263,26
3,931,19266,3575876237,3575876264,27
3,931,19267,3575876237,3575876265,28
3,931,19268,3575876237,3575876265,28
3,931,19269,3575876237,3575876266,29
3,931,19270,3575876237,3575876266,29
3,931,19271,3575876237,3575876266,29
3,931,19272,3575876237,3575876267,30
3,931,19273,3575876237,3575876270,33
3,931,19274,3575876237,3575876276,39
3,931,19275,3575876237,3575876280,43
3,931,19276,3575876237,3575876281,44
3,931,19277,3575876237,3575876282,45
3,931,19278,3575876237,3575876282,45
3,931,19279,3575876237,3575876282,45
3,931,19280,3575876237,3575876283,46
3,931,19281,3575876237,3575876286,49
3,931,19282,3575876237,3575876286,49
3,931,19283,3575876237,3575876286,49
3,931,19284,3575876237,3575876286,49
3,931,19285,3575876237,3575876287,50
3,932,19286,3575876300,3575876300,0
3,932,19287,3575876300,3575876300,0
3,932,19288,3575876300,3575876300,0
3,932,19289,3575876300,3575876300,0
3,932,19290,3575876300,3575876300,0
3,932,19291,3575876300,3575876300,0
3,932,19292,3575876300,3575876300,0
3,932,19293,3575876300,3575876300,0
3,932,19294,3575876300,3575876300,0
3,932,19295,3575876300,3575876300,0
3,932,19296,3575876300,3575876300,0
3,932,19297,3575876300,3575876300,0
3,932,19298,3575876300,3575876300,0
3,932,19299,3575876300,3575876302,2
3,932,19300,3575876300,3575876303,3
3,932,19301,3575876300,3575876303,3
3,932,19302,3575876300,3575876305,5
3,932,19303,3575876300,3575876306,6
3,932,19304,3575876300,3575876307,7
3,932,19305,3575876300,3575876308,8
3,932,19306,3575876300,3575876311,11
3,932,19307,3575876300,3575876312,12
3,932,19308,3575876300,3575876313,13
3,932,19309,3575876300,3575876317,17
3,932,19310,3575876300,3575876317,17
3,932,19311,3575876300,3575876318,18
3,932,19312,3575876300,3575876321,21
3,932,19313,3575876300,3575876323,23
3,932,19314,3575876300,3575876323,23
3,932,19315,3575876300,3575876326,26
3,932,19316,3575876300,3575876326,26
3,932,19317,3575876300,3575876329,29
3,932,19318,3575876300,3575876330,30
3,932,19319,3575876300,3575876333,33
3,932,19320,3575876300,3575876334,34
3,932,19321,3575876300,3575876336,36
3,932,19322,3575876300,3575876337,37
3,932,19323,3575876300,3575876338,38
3,932,19324,3575876300,3575876342,42
3,932,19325,3575876300,3575876342,42
3,932,19326,3575876300,3575876343,43
3,932,19327,3575876300,3575876343,43
3,932,19328,3575876300,3575876344,44
3,932,19329,3575876300,3575876346,46
3,932,19330,3575876300,3575876349,49
3,933,19331,3575876362,3575876362,0
3,933,19332,3575876362,3575876362,0
3,933,19333,3575876362,3575876362,0
3,933,19334,3575876362,3575876362,0
3,933,19335,3575876362,3575876362,0
3,933,19336,3575876362,3575876362,0
3,933,19337,3575876362,3575876362,0
3,933,19338,3575876362,3575876363,1
3,933,19339,3575876362,3575876364,2
3,933,19340,3575876362,3575876364,2
3,933,19341,3575876362,3575876367,5
3,933,19342,3575876362,3575876367,5
3,933,19343,3575876362,3575876369,7
3,933,19344,3575876362,3575876369,7
3,933,19345,3575876362,3575876370,8
3,933,19346,3575876362,3575876370,8
3,933,19347,3575876362,3575876371,9
3,933,19348,3575876362,3575876371,9
3,933,19349,3575876362,3575876372,10
3,933,19350,3575876362,3575876376,14
3,933,19351,3575876362,3575876376,14
3,933,19352,3575876362,3575876377,15
3,933,19353,3575876362,3575876378,16
3,933,19354,3575876362,3575876379,17
3,933,19355,3575876362,3575876380,18
3,933,19356,3575876362,3575876380,18
3,933,19357,3575876362,3575876381,19
3,933,19358,3575876362,3575876381,19
3,933,19359,3575876362,3575876382,20
3,933,19360,3575876362,3575876382,20
3,933,19361,3575876362,3575876384,22
3,933,19362,3575876362,3575876385,23
3,933,19363,3575876362,3575876386,24
3,933,19364,3575876362,3575876386,24
3,933,19365,3575876362,3575876387,25
3,933,19366,3575876362,3575876388,26
3,933,19367,3575876362,3575876391,29
3,933,19368,3575876362,3575876392,30
3,933,19369,3575876362,3575876394,32
3,933,19370,3575876362,3575876394,32
3,933,19371,3575876362,3575876395,33
3,933,19372,3575876362,3575876395,33
3,933,19373,3575876362,3575876395,33
3,933,19374,3575876362,3575876395,33
3,933,19375,3575876362,3575876396,34
3,933,19376,3575876362,3575876396,34
3,933,19377,3575876362,3575876396,34
3,933,19378,3575876362,3575876397,35
3,933,19379,3575876362,3575876398,36
3,933,19380,3575876362,3575876400,38
3,933,19381,3575876362,3575876400,38
3,933,19382,3575876362,3575876401,39
3,933,19383,3575876362,3575876404,42
3,933,19384,3575876362,3575876404,42
3,933,19385,3575876362,3575876405,43
3,933,19386,3575876362,3575876405,43
3,933,19387,3575876362,3575876405,43
3,933,19388,3575876362,3575876406,44
3,933,19389,3575876362,3575876406,44
3,933,19390,3575876362,3575876408,46
3,933,19391,3575876362,3575876412,50
3,934,19392,3575876422,3575876422,0
3,934,19393,3575876422,3575876422,0
3,934,19394,3575876422,3575876422,0
3,934,19395,3575876422,3575876422,0
3,934,19396,3575876422,3575876422,0
3,934,19397,3575876422,3575876422,0
3,934,19398,3575876422,3575876422,0
3,934,19399,3575876422,3575876422,0
3,934,19400,3575876422,3575876424,2
3,934,19401,3575876422,3575876425,3
3,934,19402,3575876422,3575876425,3
3,934,19403,3575876422,3575876426,4
3,934,19404,3575876422,3575876426,4
3,934,19405,3575876422,3575876429,7
3,934,19406,3575876422,3575876430,8
3,934,19407,3575876422,3575876432,10
3,934,19408,3575876422,3575876432,10
3,934,19409,3575876422,3575876432,10
3,934,19410,3575876422,3575876435,13
3,934,19411,3575876422,3575876435,13
3,934,19412,3575876422,3575876436,14
3,934,19413,3575876422,3575876437,15
3,934,19414,3575876422,3575876437,15
3,934,19415,3575876422,3575876437,15
3,934,19416,3575876422,3575876438,16
3,934,19417,3575876422,3575876438,16
3,934,19418,3575876422,3575876440,18
3,934,19419,3575876422,3575876441,19
3,934,19420,3575876422,3575876441,19
3,934,19421,3575876422,3575876442,20
3,934,19422,3575876422,3575876443,21
3,934,19423,3575876422,3575876444,22
3,934,19424,3575876422,3575876445,23
3,934,19425,3575876422,3575876446,24
3,934,19426,3575876422,3575876447,25
3,934,19427,3575876422,3575876448,26
3,934,19428,3575876422,3575876449,27
3,934,19429,3575876422,3575876450,28
3,934,19430,3575876422,3575876453,31
3,934,19431,3575876422,3575876453,31
3,934,19432,3575876422,3575876454,32
3,934,19433,3575876422,3575876454,32
3,934,19434,3575876422,3575876455,33
3,934,19435,3575876422,3575876456,34
3,934,19436,3575876422,3575876456,34
3,934,19437,3575876422,3575876459,37
3,934,19438,3575876422,3575876459,37
3,934,19439,3575876422,3575876459,37
3,934,19440,3575876422,3575876463,41
3,934,19441,3575876422,3575876463,41
3,934,19442,3575876422,3575876464,42
3,934,19443,3575876422,3575876464,42
3,934,19444,3575876422,3575876466,44
3,934,19445,3575876422,3575876466,44
3,934,19446,3575876422,3575876466,44
3,934,19447,3575876422,3575876466,44
3,934,19448,3575876422,3575876467,45
3,934,19449,3575876422,3575876468,46
3,934,19450,3575876422,3575876469,47
3,934,19451,3575876422,3575876471,49
3,935,19452,3575876482,3575876482,0
3,935,19453,3575876482,3575876482,0
3,935,19454,3575876482,3575876482,0
3,935,19455,3575876482,3575876482,0
3,935,19456,3575876482,3575876482,0
3,935,19457,3575876482,3575876482,0
3,935,19458,3575876482,3575876482,0
3,935,19459,3575876482,3575876485,3
3,935,19460,3575876482,3575876485,3
3,935,19461,3575876482,3575876485,3
3,935,19462,3575876482,3575876485,3
3,935,19463,3575876482,3575876486,4
3,935,19464,3575876482,3575876488,6
3,935,19465,3575876482,3575876490,8
3,935,19466,3575876482,3575876494,12
3,935,19467,3575876482,3575876494,12
3,935,19468,3575876482,3575876495,13
3,935,19469,3575876482,3575876495,13
3,935,19470,3575876482,3575876495,13
3,935,19471,3575876482,3575876499,17
3,935,19472,3575876482,3575876499,17
3,935,19473,3575876482,3575876499,17
3,935,19474,3575876482,3575876499,17
3,935,19475,3575876482,3575876500,18
3,935,19476,3575876482,3575876500,18
3,935,19477,3575876482,3575876501,19
3,935,19478,3575876482,3575876502,20
3,935,19479,3575876482,3575876503,21
3,935,19480,3575876482,3575876504,22
3,935,19481,3575876482,3575876506,24
3,935,19482,3575876482,3575876506,24
3,935,19483,3575876482,3575876508,26
3,935,19484,3575876482,3575876511,29
3,935,19485,3575876482,3575876511,29
3,935,19486,3575876482,3575876512,30
3,935,19487,3575876482,3575876516,34
3,935,19488,3575876482,3575876516,34
3,935,19489,3575876482,3575876517,35
3,935,19490,3575876482,3575876520,38
3,935,19491,3575876482,3575876522,40
3,935,19492,3575876482,3575876522,40
3,935,19493,3575876482,3575876525,43
3,935,19494,3575876482,3575876526,44
3,935,19495,3575876482,3575876528,46
3,935,19496,3575876482,3575876529,47
3,936,19497,3575876546,3575876546,0
3,936,19498,3575876546,3575876546,0
3,936,19499,3575876546,3575876546,0
3,936,19500,3575876546,3575876546,0
3,936,19501,3575876546,3575876546,0
3,936,19502,3575876546,3575876546,0
3,936,19503,3575876546,3575876546,0
3,936,19504,3575876546,3575876546,0
3,936,19505,3575876546,3575876546,0
3,936,19506,3575876546,3575876546,0
3,936,19507,3575876546,3575876546,0
3,936,19508,3575876546,3575876548,2
3,936,19509,3575876546,3575876550,4
3,936,19510,3575876546,3575876550,4
3,936,19511,3575876546,3575876551,5
3,936,19512,3575876546,3575876553,7
3,936,19513,3575876546,3575876555,9
3,936,19514,3575876546,3575876556,10
3,936,19515,3575876546,3575876556,10
3,936,19516,3575876546,3575876558,12
3,936,19517,3575876546,3575876560,14
3,936,19518,3575876546,3575876563,17
3,936,19519,3575876546,3575876563,17
3,936,19520,3575876546,3575876564,18
3,936,19521,3575876546,3575876566,20
3,936,19522,3575876546,3575876567,21
3,936,19523,3575876546,3575876568,22
3,936,19524,3575876546,3575876568,22
3,936,19525,3575876546,3575876568,22
3,936,19526,3575876546,3575876569,23
3,936,19527,3575876546,3575876570,24
3,936,19528,3575876546,3575876571,25
3,936,19529,3575876546,3575876571,25
3,936,19530,3575876546,3575876573,27
3,936,19531,3575876546,3575876575,29
3,936,19532,3575876546,3575876576,30
3,936,19533,3575876546,3575876576,30
3,936,19534,3575876546,3575876577,31
3,936,19535,3575876546,3575876578,32
3,936,19536,3575876546,3575876579,33
3,936,19537,3575876546,3575876579,33
3,936,19538,3575876546,3575876579,33
3,936,19539,3575876546,3575876581,35
3,936,19540,3575876546,3575876581,35
3,936,19541,3575876546,3575876581,35
3,936,19542,3575876546,3575876584,38
3,936,19543,3575876546,3575876586,40
3,936,19544,3575876546,3575876586,40
3,936,19545,3575876546,3575876586,40
3,936,19546,3575876546,3575876587,41
3,936,19547,3575876546,3575876587,41
3,936,19548,3575876546,3575876590,44
3,936,19549,3575876546,3575876593,47
3,936,19550,3575876546,3575876594,48
3,936,19551,3575876546,3575876594,48
3,936,19552,3575876546,3575876595,49
3,936,19553,3575876546,3575876595,49
3,936,19554,3575876546,3575876595,49
3,936,19555,3575876546,3575876595,49
3,936,19556,3575876546,3575876596,50
3,937,19557,3575876611,3575876611,0
3,937,19558,3575876611,3575876611,0
3,937,19559,3575876611,3575876611,0
3,937,19560,3575876611,3575876611,0
3,937,19561,3575876611,3575876611,0
3,937,19562,3575876611,3575876611,0
3,937,19563,3575876611,3575876611,0
3,937,19564,3575876611,3575876611,0
3,937,19565,3575876611,3575876611,0
3,937,19566,3575876611,3575876611,0
3,937,19567,3575876611,3575876611,0
3,937,19568,3575876611,3575876611,0
3,937,19569,3575876611,3575876611,0
3,937,19570,3575876611,3575876614,3
3,937,19571,3575876611,3575876615,4
3,937,19572,3575876611,3575876616,5
3,937,19573,3575876611,3575876617,6
3,937,19574,3575876611,3575876619,8
3,937,19575,3575876611,3575876619,8
3,937,19576,3575876611,3575876619,8
3,937,19577,3575876611,3575876620,9
3,937,19578,3575876611,3575876623,12
3,937,19579,3575876611,3575876624,13
3,937,19580,3575876611,3575876624,13
3,937,19581,3575876611,3575876626,15
3,937,19582,3575876611,3575876628,17
3,937,19583,3575876611,3575876628,17
3,937,19584,3575876611,3575876630,19
3,937,19585,3575876611,3575876631,20
3,937,19586,3575876611,3575876631,20
3,937,19587,3575876611,3575876631,20
3,937,19588,3575876611,3575876634,23
3,937,19589,3575876611,3575876635,24
3,937,19590,3575876611,3575876635,24
3,937,19591,3575876611,3575876637,26
3,937,19592,3575876611,3575876637,26
3,937,19593,3575876611,3575876637,26
3,937,19594,3575876611,3575876637,26
3,937,19595,3575876611,3575876638,27
3,937,19596,3575876611,3575876638,27
3,937,19597,3575876611,3575876639,28
3,937,19598,3575876611,3575876639,28
3,937,19599,3575876611,3575876640,29
3,937,19600,3575876611,3575876640,29
3,937,19601,3575876611,3575876642,31
3,937,19602,3575876611,3575876642,31
3,937,19603,3575876611,3575876643,32
3,937,19604,3575876611,3575876645,34
3,937,19605,3575876611,3575876645,34
3,937,19606,3575876611,3575876645,34
3,937,19607,3575876611,3575876647,36
3,937,19608,3575876611,3575876648,37
3,937,19609,3575876611,3575876649,38
3,937,19610,3575876611,3575876652,41
3,937,19611,3575876611,3575876652,41
3,937,19612,3575876611,3575876653,42
3,937,19613,3575876611,3575876654,43
3,937,19614,3575876611,3575876655,44
3,937,19615,3575876611,3575876655,44
3,937,19616,3575876611,3575876656,45
3,937,19617,3575876611,3575876658,47
3,937,19618,3575876611,3575876658,47
3,937,19619,3575876611,3575876659,48
3,938,19620,3575876673,3575876673,0
3,938,19621,3575876673,3575876673,0
3,938,19622,3575876673,3575876673,0
3,938,19623,3575876673,3575876673,0
3,938,19624,3575876673,3575876673,0
3,938,19625,3575876673,3575876673,0
3,938,19626,3575876673,3575876673,0
3,938,19627,3575876673,3575876673,0
3,938,19628,3575876673,3575876673,0
3,938,19629,3575876673,3575876673,0
3,938,19630,3575876673,3575876673,0
3,938,19631,3575876673,3575876673,0
3,938,19632,3575876673,3575876674,1
3,938,19633,3575876673,3575876680,7
3,938,19634,3575876673,3575876680,7
3,938,19635,3575876673,3575876681,8
3,938,19636,3575876673,3575876681,8
3,938,19637,3575876673,3575876681,8
3,938,19638,3575876673,3575876681,8
3,938,19639,3575876673,3575876682,9
3,938,19640,3575876673,3575876685,12
3,938,19641,3575876673,3575876685,12
3,938,19642,3575876673,3575876685,12
3,938,19643,3575876673,3575876685,12
3,938,19644,3575876673,3575876686,13
3,938,19645,3575876673,3575876686,13
3,938,19646,3575876673,3575876688,15
3,938,19647,3575876673,3575876690,17
3,938,19648,3575876673,3575876690,17
3,938,19649,3575876673,3575876694,21
3,938,19650,3575876673,3575876695,22
3,938,19651,3575876673,3575876695,22
3,938,19652,3575876673,3575876696,23
3,938,19653,3575876673,3575876699,26
3,938,19654,3575876673,3575876699,26
3,938,19655,3575876673,3575876699,26
3,938,19656,3575876673,3575876699,26
3,938,19657,3575876673,3575876700,27
3,938,19658,3575876673,3575876701,28
3,938,19659,3575876673,3575876701,28
3,938,19660,3575876673,3575876703,30
3,938,19661,3575876673,3575876703,30
3,938,19662,3575876673,3575876704,31
3,938,19663,3575876673,3575876707,34
3,938,19664,3575876673,3575876707,34
3,938,19665,3575876673,3575876707,34
3,938,19666,3575876673,3575876711,38
3,938,19667,3575876673,3575876712,39
3,938,19668,3575876673,3575876716,43
3,938,19669,3575876673,3575876716,43
3,938,19670,3575876673,3575876717,44
3,938,19671,3575876673,3575876718,45
3,938,19672,3575876673,3575876720,47
3,938,19673,3575876673,3575876722,49
3,938,19674,3575876673,3575876722,49
3,938,19675,3575876673,3575876722,49
3,939,19676,3575876733,3575876733,0
3,939,19677,3575876733,3575876733,0
3,939,19678,3575876733,3575876733,0
3,939,19679,3575876733,3575876733,0
3,939,19680,3575876733,3575876733,0
3,939,19681,3575876733,3575876733,0
3,939,19682,3575876733,3575876734,1
3,939,19683,3575876733,3575876736,3
3,939,19684,3575876733,3575876737,4
3,939,19685,3575876733,3575876741,8
3,939,19686,3575876733,3575876742,9
3,939,19687,3575876733,3575876743,10
3,939,19688,3575876733,3575876743,10
3,939,19689,3575876733,3575876744,11
3,939,19690,3575876733,3575876746,13
3,939,19691,3575876733,3575876748,15
3,939,19692,3575876733,3575876751,18
3,939,19693,3575876733,3575876751,18
3,939,19694,3575876733,3575876751,18
3,939,19695,3575876733,3575876755,22
3,939,19696,3575876733,3575876756,23
3,939,19697,3575876733,3575876756,23
3,939,19698,3575876733,3575876758,25
3,939,19699,3575876733,3575876760,27
3,939,19700,3575876733,3575876762,29
3,939,19701,3575876733,3575876763,30
3,939,19702,3575876733,3575876764,31
3,939,19703,3575876733,3575876767,34
3,939,19704,3575876733,3575876767,34
3,939,19705,3575876733,3575876768,35
3,939,19706,3575876733,3575876769,36
3,939,19707,3575876733,3575876769,36
3,939,19708,3575876733,3575876769,36
3,939,19709,3575876733,3575876770,37
3,939,19710,3575876733,3575876771,38
3,939,19711,3575876733,3575876771,38
3,939,19712,3575876733,3575876773,40
3,939,19713,3575876733,3575876775,42
3,939,19714,3575876733,3575876775,42
3,939,19715,3575876733,3575876775,42
3,939,19716,3575876733,3575876777,44
3,939,19717,3575876733,3575876778,45
3,939,19718,3575876733,3575876779,46
3,939,19719,3575876733,3575876779,46
3,939,19720,3575876733,3575876780,47
3,939,19721,3575876733,3575876781,48
3,939,19722,3575876733,3575876781,48
3,940,19723,3575876795,3575876795,0
3,940,19724,3575876795,3575876795,0
3,940,19725,3575876795,3575876795,0
3,940,19726,3575876795,3575876795,0
3,940,19727,3575876795,3575876795,0
3,940,19728,3575876795,3575876795,0
3,940,19729,3575876795,3575876795,0
3,940,19730,3575876795,3575876795,0
3,940,19731,3575876795,3575876795,0
3,940,19732,3575876795,3575876795,0
3,940,19733,3575876795,3575876795,0
3,940,19734,3575876795,3575876795,0
3,940,19735,3575876795,3575876796,1
3,940,19736,3575876795,3575876796,1
3,940,19737,3575876795,3575876796,1
3,940,19738,3575876795,3575876799,4
3,940,19739,3575876795,3575876799,4
3,940,19740,3575876795,3575876800,5
3,940,19741,3575876795,3575876800,5
3,940,19742,3575876795,3575876803,8
3,940,19743,3575876795,3575876803,8
3,940,19744,3575876795,3575876804,9
3,940,19745,3575876795,3575876804,9
3,940,19746,3575876795,3575876805,10
3,940,19747,3575876795,3575876805,10
3,940,19748,3575876795,3575876805,10
3,940,19749,3575876795,3575876808,13
3,940,19750,3575876795,3575876810,15
3,940,19751,3575876795,3575876815,20
3,940,19752,3575876795,3575876816,21
3,940,19753,3575876795,3575876817,22
3,940,19754,3575876795,3575876817,22
3,940,19755,3575876795,3575876819,24
3,940,19756,3575876795,3575876819,24
3,940,19757,3575876795,3575876820,25
3,940,19758,3575876795,3575876824,29
3,940,19759,3575876795,3575876824,29
3,940,19760,3575876795,3575876824,29
3,940,19761,3575876795,3575876826,31
3,940,19762,3575876795,3575876829,34
3,940,19763,3575876795,3575876829,34
3,940,19764,3575876795,3575876829,34
3,940,19765,3575876795,3575876830,35
3,940,19766,3575876795,3575876831,36
3,940,19767,3575876795,3575876832,37
3,940,19768,3575876795,3575876834,39
3,940,19769,3575876795,3575876834,39
3,940,19770,3575876795,3575876835,40
3,940,19771,3575876795,3575876836,41
3,940,19772,3575876795,3575876837,42
3,940,19773,3575876795,3575876837,42
3,940,19774,3575876795,3575876838,43
3,940,19775,3575876795,3575876838,43
3,940,19776,3575876795,3575876838,43
3,940,19777,3575876795,3575876838,43
3,940,19778,3575876795,3575876839,44
3,940,19779,3575876795,3575876841,46
3,940,19780,3575876795,3575876842,47
3,940,19781,3575876795,3575876843,48
3,940,19782,3575876795,3575876843,48
3,940,19783,3575876795,3575876845,50
3,941,19784,3575876859,3575876859,0
3,941,19785,3575876859,3575876859,0
3,941,19786,3575876859,3575876859,0
3,941,19787,3575876859,3575876859,0
3,941,19788,3575876859,3575876859,0
3,941,19789,3575876859,3575876859,0
3,941,19790,3575876859,3575876859,0
3,941,19791,3575876859,3575876859,0
3,941,19792,3575876859,3575876859,0
3,941,19793,3575876859,3575876859,0
3,941,19794,3575876859,3575876859,0
3,941,19795,3575876859,3575876859,0
3,941,19796,3575876859,3575876861,2
3,941,19797,3575876859,3575876861,2
3,941,19798,3575876859,3575876862,3
3,941,19799,3575876859,3575876863,4
3,941,19800,3575876859,3575876865,6
3,941,19801,3575876859,3575876865,6
3,941,19802,3575876859,3575876865,6
3,941,19803,3575876859,3575876866,7
3,941,19804,3575876859,3575876866,7
3,941,19805,3575876859,3575876866,7
3,941,19806,3575876859,3575876867,8
3,941,19807,3575876859,3575876868,9
3,941,19808,3575876859,3575876871,12
3,941,19809,3575876859,3575876873,14
3,941,19810,3575876859,3575876875,16
3,941,19811,3575876859,3575876880,21
3,941,19812,3575876859,3575876881,22
3,941,19813,3575876859,3575876881,22
3,941,19814,3575876859,3575876881,22
3,941,19815,3575876859,3575876881,22
3,941,19816,3575876859,3575876882,23
3,941,19817,3575876859,3575876885,26
3,941,19818,3575876859,3575876885,26
3,941,19819,3575876859,3575876885,26
3,941,19820,3575876859,3575876885,26
3,941,19821,3575876859,3575876886,27
3,941,19822,3575876859,3575876887,28
3,941,19823,3575876859,3575876890,31
3,941,19824,3575876859,3575876891,32
3,941,19825,3575876859,3575876894,35
3,941,19826,3575876859,3575876895,36
3,941,19827,3575876859,3575876895,36
3,941,19828,3575876859,3575876896,37
3,941,19829,3575876859,3575876896,37
3,941,19830,3575876859,3575876899,40
3,941,19831,3575876859,3575876899,40
3,941,19832,3575876859,3575876900,41
3,941,19833,3575876859,3575876900,41
3,941,19834,3575876859,3575876900,41
3,941,19835,3575876859,3575876901,42
3,941,19836,3575876859,3575876902,43
3,941,19837,3575876859,3575876903,44
3,941,19838,3575876859,3575876903,44
3,941,19839,3575876859,3575876904,45
3,941,19840,3575876859,3575876907,48
3,941,19841,3575876859,3575876907,48
3,942,19842,3575876923,3575876923,0
3,942,19843,3575876923,3575876923,0
3,942,19844,3575876923,3575876923,0
3,942,19845,3575876923,3575876923,0
3,942,19846,3575876923,3575876923,0
3,942,19847,3575876923,3575876923,0
3,942,19848,3575876923,3575876923,0
3,942,19849,3575876923,3575876924,1
3,942,19850,3575876923,3575876924,1
3,942,19851,3575876923,3575876924,1
3,942,19852,3575876923,3575876924,1
3,942,19853,3575876923,3575876925,2
3,942,19854,3575876923,3575876926,3
3,942,19855,3575876923,3575876926,3
3,942,19856,3575876923,3575876928,5
3,942,19857,3575876923,3575876930,7
3,942,19858,3575876923,3575876933,10
3,942,19859,3575876923,3575876934,11
3,942,19860,3575876923,3575876936,13
3,942,19861,3575876923,3575876937,14
3,942,19862,3575876923,3575876941,18
3,942,19863,3575876923,3575876942,19
3,942,19864,3575876923,3575876943,20
3,942,19865,3575876923,3575876943,20
3,942,19866,3575876923,3575876943,20
3,942,19867,3575876923,3575876946,23
3,942,19868,3575876923,3575876950,27
3,942,19869,3575876923,3575876950,27
3,942,19870,3575876923,3575876951,28
3,942,19871,3575876923,3575876951,28
3,942,19872,3575876923,3575876955,32
3,942,19873,3575876923,3575876956,33
3,942,19874,3575876923,3575876957,34
3,942,19875,3575876923,3575876959,36
3,942,19876,3575876923,3575876960,37
3,942,19877,3575876923,3575876963,40
3,942,19878,3575876923,3575876964,41
3,942,19879,3575876923,3575876964,41
3,942,19880,3575876923,3575876967,44
3,942,19881,3575876923,3575876967,44
3,942,19882,3575876923,3575876969,46
3,942,19883,3575876923,3575876969,46
3,942,19884,3575876923,3575876969,46
3,942,19885,3575876923,3575876970,47
3,942,19886,3575876923,3575876971,48
3,942,19887,3575876923,3575876972,49
3,943,19888,3575876984,3575876984,0
3,943,19889,3575876984,3575876984,0
3,943,19890,3575876984,3575876984,0
3,943,19891,3575876984,3575876984,0
3,943,19892,3575876984,3575876984,0
3,943,19893,3575876984,3575876984,0
3,943,19894,3575876984,3575876984,0
3,943,19895,3575876984,3575876984,0
3,943,19896,3575876984,3575876984,0
3,943,19897,3575876984,3575876984,0
3,943,19898,3575876984,3575876987,3
3,943,19899,3575876984,3575876987,3
3,943,19900,3575876984,3575876988,4
3,943,19901,3575876984,3575876988,4
3,943,19902,3575876984,3575876988,4
3,943,19903,3575876984,3575876991,7
3,943,19904,3575876984,3575876994,10
3,943,19905,3575876984,3575876994,10
3,943,19906,3575876984,3575876994,10
3,943,19907,3575876984,3575876995,11
3,943,19908,3575876984,3575876995,11
3,943,19909,3575876984,3575876995,11
3,943,19910,3575876984,3575876996,12
3,943,19911,3575876984,3575876997,13
3,943,19912,3575876984,3575876997,13
3,943,19913,3575876984,3575876997,13
3,943,19914,3575876984,3575877000,16
3,943,19915,3575876984,3575877000,16
3,943,19916,3575876984,3575877000,16
3,943,19917,3575876984,3575877003,19
3,943,19918,3575876984,3575877004,20
3,943,19919,3575876984,3575877005,21
3,943,19920,3575876984,3575877005,21
3,943,19921,3575876984,3575877005,21
3,943,19922,3575876984,3575877006,22
3,943,19923,3575876984,3575877008,24
3,943,19924,3575876984,3575877012,28
3,943,19925,3575876984,3575877015,31
3,943,19926,3575876984,3575877015,31
3,943,19927,3575876984,3575877016,32
3,943,19928,3575876984,3575877018,34
3,943,19929,3575876984,3575877019,35
3,943,19930,3575876984,3575877019,35
3,943,19931,3575876984,3575877020,36
3,943,19932,3575876984,3575877020,36
3,943,19933,3575876984,3575877024,40
3,943,19934,3575876984,3575877024,40
3,943,19935,3575876984,3575877025,41
3,943,19936,3575876984,3575877025,41
3,943,19937,3575876984,3575877027,43
3,943,19938,3575876984,3575877029,45
3,943,19939,3575876984,3575877029,45
3,943,19940,3575876984,3575877029,45
3,943,19941,3575876984,3575877031,47
3,943,19942,3575876984,3575877032,48
3,943,19943,3575876984,3575877034,50
3,944,19944,3575877046,3575877046,0
3,944,19945,3575877046,3575877046,0
3,944,19946,3575877046,3575877046,0
3,944,19947,3575877046,3575877046,0
3,944,19948,3575877046,3575877046,0
3,944,19949,3575877046,3575877046,0
3,944,19950,3575877046,3575877046,0
3,944,19951,3575877046,3575877046,0
3,944,19952,3575877046,3575877046,0
3,944,19953,3575877046,3575877046,0
3,944,19954,3575877046,3575877046,0
3,944,19955,3575877046,3575877046,0
3,944,19956,3575877046,3575877046,0
3,944,19957,3575877046,3575877046,0
3,944,19958,3575877046,3575877046,0
3,944,19959,3575877046,3575877046,0
3,944,19960,3575877046,3575877046,0
3,944,19961,3575877046,3575877046,0
3,944,19962,3575877046,3575877050,4
3,944,19963,3575877046,3575877050,4
3,944,19964,3575877046,3575877051,5
3,944,19965,3575877046,3575877052,6
3,944,19966,3575877046,3575877052,6
3,944,19967,3575877046,3575877054,8
3,944,19968,3575877046,3575877055,9
3,944,19969,3575877046,3575877055,9
3,944,19970,3575877046,3575877056,10
3,944,19971,3575877046,3575877059,13
3,944,19972,3575877046,3575877059,13
3,944,19973,3575877046,3575877059,13
3,944,19974,3575877046,3575877060,14
3,944,19975,3575877046,3575877061,15
3,944,19976,3575877046,3575877062,16
3,944,19977,3575877046,3575877062,16
3,944,19978,3575877046,3575877065,19
3,944,19979,3575877046,3575877066,20
3,944,19980,3575877046,3575877066,20
3,944,19981,3575877046,3575877066,20
3,944,19982,3575877046,3575877066,20
3,944,19983,3575877046,3575877066,20
3,944,19984,3575877046,3575877067,21
3,944,19985,3575877046,3575877068,22
3,944,19986,3575877046,3575877071,25
3,944,19987,3575877046,3575877075,29
3,944,19988,3575877046,3575877080,34
3,944,19989,3575877046,3575877081,35
3,944,19990,3575877046,3575877081,35
3,944,19991,3575877046,3575877081,35
3,944,19992,3575877046,3575877082,36
3,944,19993,3575877046,3575877083,37
3,944,19994,3575877046,3575877085,39
3,944,19995,3575877046,3575877085,39
3,944,19996,3575877046,3575877085,39
3,944,19997,3575877046,3575877086,40
3,944,19998,3575877046,3575877086,40
3,944,19999,3575877046,3575877087,41
3,944,20000,3575877046,3575877090,44
3,944,20001,3575877046,3575877090,44
3,944,20002,3575877046,3575877094,48
3,944,20003,3575877046,3575877095,49
3,944,20004,3575877046,3575877096,50
3,945,20005,3575877104,3575877104,0
3,945,20006,3575877104,3575877104,0
3,945,20007,3575877104,3575877104,0
3,945,20008,3575877104,3575877104,0
3,945,20009,3575877104,3575877104,0
3,945,20010,3575877104,3575877104,0
3,945,20011,3575877104,3575877104,0
3,945,20012,3575877104,3575877104,0
3,945,20013,3575877104,3575877104,0
3,945,20014,3575877104,3575877104,0
3,945,20015,3575877104,3575877106,2
3,945,20016,3575877104,3575877107,3
3,945,20017,3575877104,3575877108,4
3,945,20018,3575877104,3575877112,8
3,945,20019,3575877104,3575877112,8
3,945,20020,3575877104,3575877113,9
3,945,20021,3575877104,3575877117,13
3,945,20022,3575877104,3575877117,13
3,945,20023,3575877104,3575877120,16
3,945,20024,3575877104,3575877122,18
3,945,20025,3575877104,3575877123,19
3,945,20026,3575877104,3575877126,22
3,945,20027,3575877104,3575877126,22
3,945,20028,3575877104,3575877128,24
3,945,20029,3575877104,3575877128,24
3,945,20030,3575877104,3575877130,26
3,945,20031,3575877104,3575877132,28
3,945,20032,3575877104,3575877134,30
3,945,20033,3575877104,3575877137,33
3,945,20034,3575877104,3575877137,33
3,945,20035,3575877104,3575877142,38
3,945,20036,3575877104,3575877142,38
3,945,20037,3575877104,3575877143,39
3,945,20038,3575877104,3575877143,39
3,945,20039,3575877104,3575877144,40
3,945,20040,3575877104,3575877146,42
3,945,20041,3575877104,3575877149,45
3,945,20042,3575877104,3575877151,47
3,945,20043,3575877104,3575877151,47
3,945,20044,3575877104,3575877151,47
3,946,20045,3575877168,3575877168,0
3,946,20046,3575877168,3575877168,0
3,946,20047,3575877168,3575877168,0
3,946,20048,3575877168,3575877168,0
3,946,20049,3575877168,3575877168,0
3,946,20050,3575877168,3575877168,0
3,946,20051,3575877168,3575877168,0
3,946,20052,3575877168,3575877168,0
3,946,20053,3575877168,3575877168,0
3,946,20054,3575877168,3575877169,1
3,946,20055,3575877168,3575877170,2
3,946,20056,3575877168,3575877171,3
3,946,20057,3575877168,3575877172,4
3,946,20058,3575877168,3575877175,7
3,946,20059,3575877168,3575877178,10
3,946,20060,3575877168,3575877178,10
3,946,20061,3575877168,3575877179,11
3,946,20062,3575877168,3575877180,12
3,946,20063,3575877168,3575877180,12
3,946,20064,3575877168,3575877181,13
3,946,20065,3575877168,3575877181,13
3,946,20066,3575877168,3575877181,13
3,946,20067,3575877168,3575877184,16
3,946,20068,3575877168,3575877186,18
3,946,20069,3575877168,3575877187,19
3,946,20070,3575877168,3575877188,20
3,946,20071,3575877168,3575877188,20
3,946,20072,3575877168,3575877189,21
3,946,20073,3575877168,3575877189,21
3,946,20074,3575877168,3575877190,22
3,946,20075,3575877168,3575877192,24
3,946,20076,3575877168,3575877194,26
3,946,20077,3575877168,3575877194,26
3,946,20078,3575877168,3575877194,26
3,946,20079,3575877168,3575877195,27
3,946,20080,3575877168,3575877196,28
3,946,20081,3575877168,3575877196,28
3,946,20082,3575877168,3575877197,29
3,946,20083,3575877168,3575877197,29
3,946,20084,3575877168,3575877197,29
3,946,20085,3575877168,3575877200,32
3,946,20086,3575877168,3575877200,32
3,946,20087,3575877168,3575877201,33
3,946,20088,3575877168,3575877201,33
3,946,20089,3575877168,3575877203,35
3,946,20090,3575877168,3575877204,36
3,946,20091,3575877168,3575877204,36
3,946,20092,3575877168,3575877205,37
3,946,20093,3575877168,3575877205,37
3,946,20094,3575877168,3575877206,38
3,946,20095,3575877168,3575877207,39
3,946,20096,3575877168,3575877209,41
3,946,20097,3575877168,3575877212,44
3,946,20098,3575877168,3575877216,48
3,946,20099,3575877168,3575877216,48
3,946,20100,3575877168,3575877217,49
3,947,20101,3575877232,3575877232,0
3,947,20102,3575877232,3575877232,0
3,947,20103,3575877232,3575877232,0
3,947,20104,3575877232,3575877232,0
3,947,20105,3575877232,3575877232,0
3,947,20106,3575877232,3575877232,0
3,947,20107,3575877232,3575877232,0
3,947,20108,3575877232,3575877232,0
3,947,20109,3575877232,3575877232,0
3,947,20110,3575877232,3575877232,0
3,947,20111,3575877232,3575877232,0
3,947,20112,3575877232,3575877232,0
3,947,20113,3575877232,3575877232,0
3,947,20114,3575877232,3575877232,0
3,947,20115,3575877232,3575877232,0
3,947,20116,3575877232,3575877232,0
3,947,20117,3575877232,3575877232,0
3,947,20118,3575877232,3575877235,3
3,947,20119,3575877232,3575877235,3
3,947,20120,3575877232,3575877236,4
3,947,20121,3575877232,3575877236,4
3,947,20122,3575877232,3575877237,5
3,947,20123,3575877232,3575877238,6
3,947,20124,3575877232,3575877238,6
3,947,20125,3575877232,3575877239,7
3,947,20126,3575877232,3575877239,7
3,947,20127,3575877232,3575877239,7
3,947,20128,3575877232,3575877239,7
3,947,20129,3575877232,3575877240,8
3,947,20130,3575877232,3575877242,10
3,947,20131,3575877232,3575877243,11
3,947,20132,3575877232,3575877245,13
3,947,20133,3575877232,3575877246,14
3,947,20134,3575877232,3575877246,14
3,947,20135,3575877232,3575877249,17
3,947,20136,3575877232,3575877250,18
3,947,20137,3575877232,3575877251,19
3,947,20138,3575877232,3575877251,19
3,947,20139,3575877232,3575877252,20
3,947,20140,3575877232,3575877253,21
3,947,20141,3575877232,3575877254,22
3,947,20142,3575877232,3575877254,22
3,947,20143,3575877232,3575877256,24
3,947,20144,3575877232,3575877256,24
3,947,20145,3575877232,3575877259,27
3,947,20146,3575877232,3575877259,27
3,947,20147,3575877232,3575877262,30
3,947,20148,3575877232,3575877262,30
3,947,20149,3575877232,3575877265,33
3,947,20150,3575877232,3575877266,34
3,947,20151,3575877232,3575877266,34
3,947,20152,3575877232,3575877267,35
3,947,20153,3575877232,3575877267,35
3,947,20154,3575877232,3575877267,35
3,947,20155,3575877232,3575877268,36
3,947,20156,3575877232,3575877271,39
3,947,20157,3575877232,3575877273,41
3,947,20158,3575877232,3575877276,44
3,947,20159,3575877232,3575877280,48
3,947,20160,3575877232,3575877281,49
3,947,20161,3575877232,3575877281,49
3,947,20162,3575877232,3575877281,49
3,947,20163,3575877232,3575877282,50
3,948,20164,3575877296,3575877296,0
3,948,20165,3575877296,3575877296,0
3,948,20166,3575877296,3575877296,0
3,948,20167,3575877296,3575877296,0
3,948,20168,3575877296,3575877296,0
3,948,20169,3575877296,3575877296,0
3,948,20170,3575877296,3575877296,0
3,948,20171,3575877296,3575877296,0
3,948,20172,3575877296,3575877296,0
3,948,20173,3575877296,3575877296,0
3,948,20174,3575877296,3575877296,0
3,948,20175,3575877296,3575877296,0
3,948,20176,3575877296,3575877296,0
3,948,20177,3575877296,3575877297,1
3,948,20178,3575877296,3575877300,4
3,948,20179,3575877296,3575877300,4
3,948,20180,3575877296,3575877300,4
3,948,20181,3575877296,3575877301,5
3,948,20182,3575877296,3575877301,5
3,948,20183,3575877296,3575877302,6
3,948,20184,3575877296,3575877304,8
3,948,20185,3575877296,3575877304,8
3,948,20186,3575877296,3575877304,8
3,948,20187,3575877296,3575877305,9
3,948,20188,3575877296,3575877306,10
3,948,20189,3575877296,3575877308,12
3,948,20190,3575877296,3575877312,16
3,948,20191,3575877296,3575877312,16
3,948,20192,3575877296,3575877313,17
3,948,20193,3575877296,3575877317,21
3,948,20194,3575877296,3575877317,21
3,948,20195,3575877296,3575877321,25
3,948,20196,3575877296,3575877322,26
3,948,20197,3575877296,3575877323,27
3,948,20198,3575877296,3575877326,30
3,948,20199,3575877296,3575877327,31
3,948,20200,3575877296,3575877327,31
3,948,20201,3575877296,3575877328,32
3,948,20202,3575877296,3575877330,34
3,948,20203,3575877296,3575877332,36
3,948,20204,3575877296,3575877333,37
3,948,20205,3575877296,3575877334,38
3,948,20206,3575877296,3575877336,40
3,948,20207,3575877296,3575877337,41
3,948,20208,3575877296,3575877338,42
3,948,20209,3575877296,3575877342,46
3,948,20210,3575877296,3575877342,46
3,948,20211,3575877296,3575877344,48
3,948,20212,3575877296,3575877344,48
3,949,20213,3575877356,3575877356,0
3,949,20214,3575877356,3575877356,0
3,949,20215,3575877356,3575877356,0
3,949,20216,3575877356,3575877356,0
3,949,20217,3575877356,3575877356,0
3,949,20218,3575877356,3575877356,0
3,949,20219,3575877356,3575877356,0
3,949,20220,3575877356,3575877356,0
3,949,20221,3575877356,3575877358,2
3,949,20222,3575877356,3575877359,3
3,949,20223,3575877356,3575877361,5
3,949,20224,3575877356,3575877364,8
3,949,20225,3575877356,3575877364,8
3,949,20226,3575877356,3575877365,9
3,949,20227,3575877356,3575877366,10
3,949,20228,3575877356,3575877368,12
3,949,20229,3575877356,3575877369,13
3,949,20230,3575877356,3575877369,13
3,949,20231,3575877356,3575877370,14
3,949,20232,3575877356,3575877372,16
3,949,20233,3575877356,3575877372,16
3,949,20234,3575877356,3575877375,19
3,949,20235,3575877356,3575877376,20
3,949,20236,3575877356,3575877377,21
3,949,20237,3575877356,3575877378,22
3,949,20238,3575877356,3575877379,23
3,949,20239,3575877356,3575877379,23
3,949,20240,3575877356,3575877380,24
3,949,20241,3575877356,3575877381,25
3,949,20242,3575877356,3575877381,25
3,949,20243,3575877356,3575877381,25
3,949,20244,3575877356,3575877381,25
3,949,20245,3575877356,3575877385,29
3,949,20246,3575877356,3575877388,32
3,949,20247,3575877356,3575877388,32
3,949,20248,3575877356,3575877389,33
3,949,20249,3575877356,3575877389,33
3,949,20250,3575877356,3575877391,35
3,949,20251,3575877356,3575877394,38
3,949,20252,3575877356,3575877395,39
3,949,20253,3575877356,3575877395,39
3,949,20254,3575877356,3575877395,39
3,949,20255,3575877356,3575877396,40
3,949,20256,3575877356,3575877396,40
3,949,20257,3575877356,3575877397,41
3,949,20258,3575877356,3575877397,41
3,949,20259,3575877356,3575877398,42
3,949,20260,3575877356,3575877399,43
3,949,20261,3575877356,3575877401,45
3,949,20262,3575877356,3575877401,45
3,949,20263,3575877356,3575877402,46
3,949,20264,3575877356,3575877403,47
3,949,20265,3575877356,3575877404,48
3,949,20266,3575877356,3575877404,48
3,949,20267,3575877356,3575877405,49
3,949,20268,3575877356,3575877406,50
3,950,20269,3575877420,3575877420,0
3,950,20270,3575877420,3575877420,0
3,950,20271,3575877420,3575877420,0
3,950,20272,3575877420,3575877420,0
3,950,20273,3575877420,3575877420,0
3,950,20274,3575877420,3575877420,0
3,950,20275,3575877420,3575877420,0
3,950,20276,3575877420,3575877420,0
3,950,20277,3575877420,3575877420,0
3,950,20278,3575877420,3575877420,0
3,950,20279,3575877420,3575877420,0
3,950,20280,3575877420,3575877424,4
3,950,20281,3575877420,3575877426,6
3,950,20282,3575877420,3575877427,7
3,950,20283,3575877420,3575877428,8
3,950,20284,3575877420,3575877430,10
3,950,20285,3575877420,3575877430,10
3,950,20286,3575877420,3575877432,12
3,950,20287,3575877420,3575877432,12
3,950,20288,3575877420,3575877433,13
3,950,20289,3575877420,3575877434,14
3,950,20290,3575877420,3575877436,16
3,950,20291,3575877420,3575877436,16
3,950,20292,3575877420,3575877437,17
3,950,20293,3575877420,3575877437,17
3,950,20294,3575877420,3575877438,18
3,950,20295,3575877420,3575877439,19
3,950,20296,3575877420,3575877439,19
3,950,20297,3575877420,3575877439,19
3,950,20298,3575877420,3575877439,19
3,950,20299,3575877420,3575877441,21
3,950,20300,3575877420,3575877441,21
3,950,20301,3575877420,3575877442,22
3,950,20302,3575877420,3575877443,23
3,950,20303,3575877420,3575877445,25
3,950,20304,3575877420,3575877446,26
3,950,20305,3575877420,3575877446,26
3,950,20306,3575877420,3575877446,26
3,950,20307,3575877420,3575877447,27
3,950,20308,3575877420,3575877450,30
3,950,20309,3575877420,3575877451,31
3,950,20310,3575877420,3575877452,32
3,950,20311,3575877420,3575877453,33
3,950,20312,3575877420,3575877454,34
3,950,20313,3575877420,3575877454,34
3,950,20314,3575877420,3575877455,35
3,950,20315,3575877420,3575877455,35
3,950,20316,3575877420,3575877456,36
3,950,20317,3575877420,3575877459,39
3,950,20318,3575877420,3575877459,39
3,950,20319,3575877420,3575877461,41
3,950,20320,3575877420,3575877462,42
3,950,20321,3575877420,3575877462,42
3,950,20322,3575877420,3575877463,43
3,950,20323,3575877420,3575877465,45
3,950,20324,3575877420,3575877466,46
3,950,20325,3575877420,3575877466,46
3,950,20326,3575877420,3575877466,46
3,950,20327,3575877420,3575877467,47
3,950,20328,3575877420,3575877467,47
3,950,20329,3575877420,3575877468,48
3,950,20330,3575877420,3575877469,49
3,951,20331,3575877482,3575877482,0
3,951,20332,3575877482,3575877482,0
3,951,20333,3575877482,3575877482,0
3,951,20334,3575877482,3575877482,0
3,951,20335,3575877482,3575877482,0
3,951,20336,3575877482,3575877482,0
3,951,20337,3575877482,3575877482,0
3,951,20338,3575877482,3575877482,0
3,951,20339,3575877482,3575877484,2
3,951,20340,3575877482,3575877484,2
3,951,20341,3575877482,3575877484,2
3,951,20342,3575877482,3575877484,2
3,951,20343,3575877482,3575877486,4
3,951,20344,3575877482,3575877487,5
3,951,20345,3575877482,3575877487,5
3,951,20346,3575877482,3575877488,6
3,951,20347,3575877482,3575877490,8
3,951,20348,3575877482,3575877494,12
3,951,20349,3575877482,3575877494,12
3,951,20350,3575877482,3575877495,13
3,951,20351,3575877482,3575877495,13
3,951,20352,3575877482,3575877496,14
3,951,20353,3575877482,3575877496,14
3,951,20354,3575877482,3575877499,17
3,951,20355,3575877482,3575877500,18
3,951,20356,3575877482,3575877500,18
3,951,20357,3575877482,3575877500,18
3,951,20358,3575877482,3575877501,19
3,951,20359,3575877482,3575877502,20
3,951,20360,3575877482,3575877502,20
3,951,20361,3575877482,3575877503,21
3,951,20362,3575877482,3575877504,22
3,951,20363,3575877482,3575877505,23
3,951,20364,3575877482,3575877506,24
3,951,20365,3575877482,3575877507,25
3,951,20366,3575877482,3575877507,25
3,951,20367,3575877482,3575877511,29
3,951,20368,3575877482,3575877512,30
3,951,20369,3575877482,3575877512,30
3,951,20370,3575877482,3575877516,34
3,951,20371,3575877482,3575877516,34
3,951,20372,3575877482,3575877519,37
3,951,20373,3575877482,3575877520,38
3,951,20374,3575877482,3575877521,39
3,951,20375,3575877482,3575877523,41
3,951,20376,3575877482,3575877525,43
3,951,20377,3575877482,3575877526,44
3,951,20378,3575877482,3575877528,46
3,951,20379,3575877482,3575877530,48
3,951,20380,3575877482,3575877532,50
3,952,20381,3575877543,3575877543,0
3,952,20382,3575877543,3575877543,0
3,952,20383,3575877543,3575877543,0
3,952,20384,3575877543,3575877543,0
3,952,20385,3575877543,3575877543,0
3,952,20386,3575877543,3575877543,0
3,952,20387,3575877543,3575877543,0
3,952,20388,3575877543,3575877543,0
3,952,20389,3575877543,3575877543,0
3,952,20390,3575877543,3575877544,1
3,952,20391,3575877543,3575877545,2
3,952,20392,3575877543,3575877549,6
3,952,20393,3575877543,3575877550,7
3,952,20394,3575877543,3575877550,7
3,952,20395,3575877543,3575877551,8
3,952,20396,3575877543,3575877554,11
3,952,20397,3575877543,3575877554,11
3,952,20398,3575877543,3575877557,14
3,952,20399,3575877543,3575877558,15
3,952,20400,3575877543,3575877560,17
3,952,20401,3575877543,3575877562,19
3,952,20402,3575877543,3575877563,20
3,952,20403,3575877543,3575877564,21
3,952,20404,3575877543,3575877566,23
3,952,20405,3575877543,3575877567,24
3,952,20406,3575877543,3575877569,26
3,952,20407,3575877543,3575877569,26
3,952,20408,3575877543,3575877570,27
3,952,20409,3575877543,3575877571,28
3,952,20410,3575877543,3575877571,28
3,952,20411,3575877543,3575877572,29
3,952,20412,3575877543,3575877575,32
3,952,20413,3575877543,3575877575,32
3,952,20414,3575877543,3575877576,33
3,952,20415,3575877543,3575877577,34
3,952,20416,3575877543,3575877578,35
3,952,20417,3575877543,3575877579,36
3,952,20418,3575877543,3575877580,37
3,952,20419,3575877543,3575877580,37
3,952,20420,3575877543,3575877580,37
3,952,20421,3575877543,3575877581,38
3,952,20422,3575877543,3575877581,38
3,952,20423,3575877543,3575877585,42
3,952,20424,3575877543,3575877586,43
3,952,20425,3575877543,3575877587,44
3,952,20426,3575877543,3575877587,44
3,952,20427,3575877543,3575877588,45
3,952,20428,3575877543,3575877588,45
3,952,20429,3575877543,3575877588,45
3,952,20430,3575877543,3575877591,48
3,952,20431,3575877543,3575877591,48
3,952,20432,3575877543,3575877593,50
3,953,20433,3575877606,3575877606,0
3,953,20434,3575877606,3575877606,0
3,953,20435,3575877606,3575877606,0
3,953,20436,3575877606,3575877606,0
3,953,20437,3575877606,3575877606,0
3,953,20438,3575877606,3575877606,0
3,953,20439,3575877606,3575877606,0
3,953,20440,3575877606,3575877606,0
3,953,20441,3575877606,3575877606,0
3,953,20442,3575877606,3575877606,0
3,953,20443,3575877606,3575877606,0
3,953,20444,3575877606,3575877606,0
3,953,20445,3575877606,3575877606,0
3,953,20446,3575877606,3575877606,0
3,953,20447,3575877606,3575877606,0
3,953,20448,3575877606,3575877606,0
3,953,20449,3575877606,3575877606,0
3,953,20450,3575877606,3575877606,0
3,953,20451,3575877606,3575877606,0
3,953,20452,3575877606,3575877606,0
3,953,20453,3575877606,3575877610,4
3,953,20454,3575877606,3575877615,9
3,953,20455,3575877606,3575877615,9
3,953,20456,3575877606,3575877616,10
3,953,20457,3575877606,3575877616,10
3,953,20458,3575877606,3575877618,12
3,953,20459,3575877606,3575877619,13
3,953,20460,3575877606,3575877620,14
3,953,20461,3575877606,3575877621,15
3,953,20462,3575877606,3575877623,17
3,953,20463,3575877606,3575877625,19
3,953,20464,3575877606,3575877625,19
3,953,20465,3575877606,3575877626,20
3,953,20466,3575877606,3575877627,21
3,953,20467,3575877606,3575877629,23
3,953,20468,3575877606,3575877629,23
3,953,20469,3575877606,3575877631,25
3,953,20470,3575877606,3575877631,25
3,953,20471,3575877606,3575877633,27
3,953,20472,3575877606,3575877633,27
3,953,20473,3575877606,3575877634,28
3,953,20474,3575877606,3575877635,29
3,953,20475,3575877606,3575877636,30
3,953,20476,3575877606,3575877637,31
3,953,20477,3575877606,3575877637,31
3,953,20478,3575877606,3575877637,31
3,953,20479,3575877606,3575877638,32
3,953,20480,3575877606,3575877638,32
3,953,20481,3575877606,3575877638,32
3,953,20482,3575877606,3575877640,34
3,953,20483,3575877606,3575877641,35
3,953,20484,3575877606,3575877641,35
3,953,20485,3575877606,3575877642,36
3,953,20486,3575877606,3575877644,38
3,953,20487,3575877606,3575877644,38
3,953,20488,3575877606,3575877645,39
3,953,20489,3575877606,3575877645,39
3,953,20490,3575877606,3575877646,40
3,953,20491,3575877606,3575877649,43
3,953,20492,3575877606,3575877649,43
3,953,20493,3575877606,3575877650,44
3,953,20494,3575877606,3575877650,44
3,953,20495,3575877606,3575877652,46
3,953,20496,3575877606,3575877652,46
3,953,20497,3575877606,3575877653,47
3,953,20498,3575877606,3575877653,47
3,953,20499,3575877606,3575877654,48
3,953,20500,3575877606,3575877654,48
3,953,20501,3575877606,3575877656,50
3,954,20502,3575877666,3575877667,1
3,954,20503,3575877666,3575877667,1
3,954,20504,3575877666,3575877667,1
3,954,20505,3575877666,3575877667,1
3,954,20506,3575877666,3575877667,1
3,954,20507,3575877666,3575877667,1
3,954,20508,3575877666,3575877667,1
3,954,20509,3575877666,3575877667,1
3,954,20510,3575877666,3575877667,1
3,954,20511,3575877666,3575877667,1
3,954,20512,3575877666,3575877667,1
3,954,20513,3575877666,3575877667,1
3,954,20514,3575877666,3575877668,2
3,954,20515,3575877666,3575877670,4
3,954,20516,3575877666,3575877674,8
3,954,20517,3575877666,3575877675,9
3,954,20518,3575877666,3575877680,14
3,954,20519,3575877666,3575877680,14
3,954,20520,3575877666,3575877681,15
3,954,20521,3575877666,3575877681,15
3,954,20522,3575877666,3575877681,15
3,954,20523,3575877666,3575877682,16
3,954,20524,3575877666,3575877684,18
3,954,20525,3575877666,3575877684,18
3,954,20526,3575877666,3575877684,18
3,954,20527,3575877666,3575877685,19
3,954,20528,3575877666,3575877686,20
3,954,20529,3575877666,3575877687,21
3,954,20530,3575877666,3575877688,22
3,954,20531,3575877666,3575877689,23
3,954,20532,3575877666,3575877694,28
3,954,20533,3575877666,3575877694,28
3,954,20534,3575877666,3575877695,29
3,954,20535,3575877666,3575877695,29
3,954,20536,3575877666,3575877695,29
3,954,20537,3575877666,3575877697,31
3,954,20538,3575877666,3575877698,32
3,954,20539,3575877666,3575877700,34
3,954,20540,3575877666,3575877700,34
3,954,20541,3575877666,3575877700,34
3,954,20542,3575877666,3575877701,35
3,954,20543,3575877666,3575877702,36
3,954,20544,3575877666,3575877702,36
3,954,20545,3575877666,3575877703,37
3,954,20546,3575877666,3575877705,39
3,954,20547,3575877666,3575877705,39
3,954,20548,3575877666,3575877707,41
3,954,20549,3575877666,3575877707,41
3,954,20550,3575877666,3575877711,45
3,954,20551,3575877666,3575877711,45
3,954,20552,3575877666,3575877713,47
3,955,20553,3575877727,3575877727,0
3,955,20554,3575877727,3575877727,0
3,955,20555,3575877727,3575877727,0
3,955,20556,3575877727,3575877727,0
3,955,20557,3575877727,3575877727,0
3,955,20558,3575877727,3575877727,0
3,955,20559,3575877727,3575877727,0
3,955,20560,3575877727,3575877727,0
3,955,20561,3575877727,3575877727,0
3,955,20562,3575877727,3575877727,0
3,955,20563,3575877727,3575877727,0
3,955,20564,3575877727,3575877728,1
3,955,20565,3575877727,3575877730,3
3,955,20566,3575877727,3575877732,5
3,955,20567,3575877727,3575877733,6
3,955,20568,3575877727,3575877735,8
3,955,20569,3575877727,3575877736,9
3,955,20570,3575877727,3575877736,9
3,955,20571,3575877727,3575877742,15
3,955,20572,3575877727,3575877742,15
3,955,20573,3575877727,3575877743,16
3,955,20574,3575877727,3575877744,17
3,955,20575,3575877727,3575877744,17
3,955,20576,3575877727,3575877745,18
3,955,20577,3575877727,3575877749,22
3,955,20578,3575877727,3575877750,23
3,955,20579,3575877727,3575877750,23
3,955,20580,3575877727,3575877751,24
3,955,20581,3575877727,3575877754,27
3,955,20582,3575877727,3575877754,27
3,955,20583,3575877727,3575877756,29
3,955,20584,3575877727,3575877756,29
3,955,20585,3575877727,3575877758,31
3,955,20586,3575877727,3575877760,33
3,955,20587,3575877727,3575877762,35
3,955,20588,3575877727,3575877763,36
3,955,20589,3575877727,3575877764,37
3,955,20590,3575877727,3575877769,42
3,955,20591,3575877727,3575877769,42
3,955,20592,3575877727,3575877770,43
3,955,20593,3575877727,3575877771,44
3,955,20594,3575877727,3575877771,44
3,955,20595,3575877727,3575877771,44
3,955,20596,3575877727,3575877773,46
3,955,20597,3575877727,3575877774,47
3,955,20598,3575877727,3575877775,48
3,955,20599,3575877727,3575877776,49
3,955,20600,3575877727,3575877777,50
3,956,20601,3575877789,3575877789,0
3,956,20602,3575877789,3575877789,0
3,956,20603,3575877789,3575877789,0
3,956,20604,3575877789,3575877789,0
3,956,20605,3575877789,3575877789,0
3,956,20606,3575877789,3575877789,0
3,956,20607,3575877789,3575877789,0
3,956,20608,3575877789,3575877789,0
3,956,20609,3575877789,3575877789,0
3,956,20610,3575877789,3575877789,0
3,956,20611,3575877789,3575877789,0
3,956,20612,3575877789,3575877789,0
3,956,20613,3575877789,3575877789,0
3,956,20614,3575877789,3575877789,0
3,956,20615,3575877789,3575877791,2
3,956,20616,3575877789,3575877792,3
3,956,20617,3575877789,3575877793,4
3,956,20618,3575877789,3575877794,5
3,956,20619,3575877789,3575877795,6
3,956,20620,3575877789,3575877795,6
3,956,20621,3575877789,3575877795,6
3,956,20622,3575877789,3575877795,6
3,956,20623,3575877789,3575877796,7
3,956,20624,3575877789,3575877796,7
3,956,20625,3575877789,3575877797,8
3,956,20626,3575877789,3575877797,8
3,956,20627,3575877789,3575877799,10
3,956,20628,3575877789,3575877800,11
3,956,20629,3575877789,3575877801,12
3,956,20630,3575877789,3575877802,13
3,956,20631,3575877789,3575877803,14
3,956,20632,3575877789,3575877803,14
3,956,20633,3575877789,3575877804,15
3,956,20634,3575877789,3575877805,16
3,956,20635,3575877789,3575877806,17
3,956,20636,3575877789,3575877806,17
3,956,20637,3575877789,3575877809,20
3,956,20638,3575877789,3575877810,21
3,956,20639,3575877789,3575877815,26
3,956,20640,3575877789,3575877815,26
3,956,20641,3575877789,3575877815,26
3,956,20642,3575877789,3575877817,28
3,956,20643,3575877789,3575877819,30
3,956,20644,3575877789,3575877820,31
3,956,20645,3575877789,3575877820,31
3,956,20646,3575877789,3575877821,32
3,956,20647,3575877789,3575877823,34
3,956,20648,3575877789,3575877824,35
3,956,20649,3575877789,3575877825,36
3,956,20650,3575877789,3575877825,36
3,956,20651,3575877789,3575877825,36
3,956,20652,3575877789,3575877827,38
3,956,20653,3575877789,3575877829,40
3,956,20654,3575877789,3575877829,40
3,956,20655,3575877789,3575877831,42
3,956,20656,3575877789,3575877831,42
3,956,20657,3575877789,3575877832,43
3,956,20658,3575877789,3575877833,44
3,956,20659,3575877789,3575877835,46
3,956,20660,3575877789,3575877835,46
3,956,20661,3575877789,3575877836,47
3,956,20662,3575877789,3575877837,48
3,956,20663,3575877789,3575877837,48
3,956,20664,3575877789,3575877837,48
3,956,20665,3575877789,3575877837,48
3,956,20666,3575877789,3575877838,49
3,956,20667,3575877789,3575877838,49
3,957,20668,3575877851,3575877851,0
3,957,20669,3575877851,3575877851,0
3,957,20670,3575877851,3575877851,0
3,957,20671,3575877851,3575877851,0
3,957,20672,3575877851,3575877851,0
3,957,20673,3575877851,3575877851,0
3,957,20674,3575877851,3575877851,0
3,957,20675,3575877851,3575877851,0
3,957,20676,3575877851,3575877851,0
3,957,20677,3575877851,3575877851,0
3,957,20678,3575877851,3575877851,0
3,957,20679,3575877851,3575877851,0
3,957,20680,3575877851,3575877851,0
3,957,20681,3575877851,3575877852,1
3,957,20682,3575877851,3575877853,2
3,957,20683,3575877851,3575877853,2
3,957,20684,3575877851,3575877854,3
3,957,20685,3575877851,3575877854,3
3,957,20686,3575877851,3575877857,6
3,957,20687,3575877851,3575877858,7
3,957,20688,3575877851,3575877859,8
3,957,20689,3575877851,3575877859,8
3,957,20690,3575877851,3575877860,9
3,957,20691,3575877851,3575877861,10
3,957,20692,3575877851,3575877861,10
3,957,20693,3575877851,3575877863,12
3,957,20694,3575877851,3575877865,14
3,957,20695,3575877851,3575877866,15
3,957,20696,3575877851,3575877866,15
3,957,20697,3575877851,3575877866,15
3,957,20698,3575877851,3575877867,16
3,957,20699,3575877851,3575877868,17
3,957,20700,3575877851,3575877869,18
3,957,20701,3575877851,3575877874,23
3,957,20702,3575877851,3575877875,24
3,957,20703,3575877851,3575877879,28
3,957,20704,3575877851,3575877881,30
3,957,20705,3575877851,3575877881,30
3,957,20706,3575877851,3575877881,30
3,957,20707,3575877851,3575877881,30
3,957,20708,3575877851,3575877881,30
3,957,20709,3575877851,3575877884,33
3,957,20710,3575877851,3575877884,33
3,957,20711,3575877851,3575877885,34
3,957,20712,3575877851,3575877885,34
3,957,20713,3575877851,3575877887,36
3,957,20714,3575877851,3575877888,37
3,957,20715,3575877851,3575877889,38
3,957,20716,3575877851,3575877894,43
3,957,20717,3575877851,3575877894,43
3,957,20718,3575877851,3575877895,44
3,957,20719,3575877851,3575877895,44
3,957,20720,3575877851,3575877896,45
3,957,20721,3575877851,3575877896,45
3,957,20722,3575877851,3575877899,48
3,957,20723,3575877851,3575877900,49
3,957,20724,3575877851,3575877900,49
3,957,20725,3575877851,3575877900,49
3,958,20726,3575877911,3575877911,0
3,958,20727,3575877911,3575877911,0
3,958,20728,3575877911,3575877911,0
3,958,20729,3575877911,3575877911,0
3,958,20730,3575877911,3575877911,0
3,958,20731,3575877911,3575877911,0
3,958,20732,3575877911,3575877912,1
3,958,20733,3575877911,3575877912,1
3,958,20734,3575877911,3575877912,1
3,958,20735,3575877911,3575877916,5
3,958,20736,3575877911,3575877916,5
3,958,20737,3575877911,3575877917,6
3,958,20738,3575877911,3575877919,8
3,958,20739,3575877911,3575877920,9
3,958,20740,3575877911,3575877922,11
3,958,20741,3575877911,3575877923,12
3,958,20742,3575877911,3575877926,15
3,958,20743,3575877911,3575877927,16
3,958,20744,3575877911,3575877927,16
3,958,20745,3575877911,3575877928,17
3,958,20746,3575877911,3575877930,19
3,958,20747,3575877911,3575877932,21
3,958,20748,3575877911,3575877933,22
3,958,20749,3575877911,3575877936,25
3,958,20750,3575877911,3575877937,26
3,958,20751,3575877911,3575877938,27
3,958,20752,3575877911,3575877942,31
3,958,20753,3575877911,3575877942,31
3,958,20754,3575877911,3575877943,32
3,958,20755,3575877911,3575877944,33
3,958,20756,3575877911,3575877945,34
3,958,20757,3575877911,3575877946,35
3,958,20758,3575877911,3575877949,38
3,958,20759,3575877911,3575877949,38
3,958,20760,3575877911,3575877951,40
3,958,20761,3575877911,3575877954,43
3,958,20762,3575877911,3575877954,43
3,958,20763,3575877911,3575877956,45
3,958,20764,3575877911,3575877957,46
3,958,20765,3575877911,3575877959,48
3,958,20766,3575877911,3575877960,49
3,959,20767,3575877971,3575877971,0
3,959,20768,3575877971,3575877971,0
3,959,20769,3575877971,3575877971,0
3,959,20770,3575877971,3575877971,0
3,959,20771,3575877971,3575877971,0
3,959,20772,3575877971,3575877971,0
3,959,20773,3575877971,3575877971,0
3,959,20774,3575877971,3575877971,0
3,959,20775,3575877971,3575877971,0
3,959,20776,3575877971,3575877971,0
3,959,20777,3575877971,3575877972,1
3,959,20778,3575877971,3575877975,4
3,959,20779,3575877971,3575877975,4
3,959,20780,3575877971,3575877978,7
3,959,20781,3575877971,3575877978,7
3,959,20782,3575877971,3575877979,8
3,959,20783,3575877971,3575877980,9
3,959,20784,3575877971,3575877980,9
3,959,20785,3575877971,3575877980,9
3,959,20786,3575877971,3575877981,10
3,959,20787,3575877971,3575877982,11
3,959,20788,3575877971,3575877986,15
3,959,20789,3575877971,3575877986,15
3,959,20790,3575877971,3575877987,16
3,959,20791,3575877971,3575877987,16
3,959,20792,3575877971,3575877989,18
3,959,20793,3575877971,3575877989,18
3,959,20794,3575877971,3575877991,20
3,959,20795,3575877971,3575877993,22
3,959,20796,3575877971,3575877994,23
3,959,20797,3575877971,3575877994,23
3,959,20798,3575877971,3575877995,24
3,959,20799,3575877971,3575877995,24
3,959,20800,3575877971,3575877995,24
3,959,20801,3575877971,3575877996,25
3,959,20802,3575877971,3575877997,26
3,959,20803,3575877971,3575877997,26
3,959,20804,3575877971,3575877997,26
3,959,20805,3575877971,3575877998,27
3,959,20806,3575877971,3575877998,27
3,959,20807,3575877971,3575878000,29
3,959,20808,3575877971,3575878001,30
3,959,20809,3575877971,3575878002,31
3,959,20810,3575877971,3575878003,32
3,959,20811,3575877971,3575878003,32
3,959,20812,3575877971,3575878004,33
3,959,20813,3575877971,3575878004,33
3,959,20814,3575877971,3575878006,35
3,959,20815,3575877971,3575878006,35
3,959,20816,3575877971,3575878009,38
3,959,20817,3575877971,3575878012,41
3,959,20818,3575877971,3575878015,44
3,959,20819,3575877971,3575878016,45
3,959,20820,3575877971,3575878017,46
3,959,20821,3575877971,3575878019,48
3,959,20822,3575877971,3575878019,48
3,959,20823,3575877971,3575878020,49
3,960,20824,3575878033,3575878033,0
3,960,20825,3575878033,3575878033,0
3,960,20826,3575878033,3575878033,0
3,960,20827,3575878033,3575878033,0
3,960,20828,3575878033,3575878033,0
3,960,20829,3575878033,3575878033,0
3,960,20830,3575878033,3575878033,0
3,960,20831,3575878033,3575878033,0
3,960,20832,3575878033,3575878033,0
3,960,20833,3575878033,3575878033,0
3,960,20834,3575878033,3575878033,0
3,960,20835,3575878033,3575878033,0
3,960,20836,3575878033,3575878035,2
3,960,20837,3575878033,3575878036,3
3,960,20838,3575878033,3575878036,3
3,960,20839,3575878033,3575878038,5
3,960,20840,3575878033,3575878038,5
3,960,20841,3575878033,3575878038,5
3,960,20842,3575878033,3575878038,5
3,960,20843,3575878033,3575878038,5
3,960,20844,3575878033,3575878040,7
3,960,20845,3575878033,3575878041,8
3,960,20846,3575878033,3575878041,8
3,960,20847,3575878033,3575878042,9
3,960,20848,3575878033,3575878044,11
3,960,20849,3575878033,3575878045,12
3,960,20850,3575878033,3575878045,12
3,960,20851,3575878033,3575878045,12
3,960,20852,3575878033,3575878046,13
3,960,20853,3575878033,3575878049,16
3,960,20854,3575878033,3575878050,17
3,960,20855,3575878033,3575878050,17
3,960,20856,3575878033,3575878050,17
3,960,20857,3575878033,3575878053,20
3,960,20858,3575878033,3575878053,20
3,960,20859,3575878033,3575878053,20
3,960,20860,3575878033,3575878054,21
3,960,20861,3575878033,3575878056,23
3,960,20862,3575878033,3575878058,25
3,960,20863,3575878033,3575878058,25
3,960,20864,3575878033,3575878059,26
3,960,20865,3575878033,3575878059,26
3,960,20866,3575878033,3575878060,27
3,960,20867,3575878033,3575878062,29
3,960,20868,3575878033,3575878062,29
3,960,20869,3575878033,3575878063,30
3,960,20870,3575878033,3575878065,32
3,960,20871,3575878033,3575878066,33
3,960,20872,3575878033,3575878066,33
3,960,20873,3575878033,3575878066,33
3,960,20874,3575878033,3575878066,33
3,960,20875,3575878033,3575878067,34
3,960,20876,3575878033,3575878068,35
3,960,20877,3575878033,3575878070,37
3,960,20878,3575878033,3575878074,41
3,960,20879,3575878033,3575878075,42
3,960,20880,3575878033,3575878079,46
3,960,20881,3575878033,3575878081,48
3,960,20882,3575878033,3575878081,48
3,960,20883,3575878033,3575878081,48
3,960,20884,3575878033,3575878081,48
3,960,20885,3575878033,3575878081,48
3,960,20886,3575878033,3575878083,50
3,961,20887,3575878096,3575878096,0
3,961,20888,3575878096,3575878096,0
3,961,20889,3575878096,3575878096,0
3,961,20890,3575878096,3575878096,0
3,961,20891,3575878096,3575878096,0
3,961,20892,3575878096,3575878096,0
3,961,20893,3575878096,3575878096,0
3,961,20894,3575878096,3575878096,0
3,961,20895,3575878096,3575878096,0
3,961,20896,3575878096,3575878096,0
3,961,20897,3575878096,3575878096,0
3,961,20898,3575878096,3575878096,0
3,961,20899,3575878096,3575878099,3
3,961,20900,3575878096,3575878100,4
3,961,20901,3575878096,3575878100,4
3,961,20902,3575878096,3575878100,4
3,961,20903,3575878096,3575878102,6
3,961,20904,3575878096,3575878103,7
3,961,20905,3575878096,3575878103,7
3,961,20906,3575878096,3575878105,9
3,961,20907,3575878096,3575878105,9
3,961,20908,3575878096,3575878106,10
3,961,20909,3575878096,3575878106,10
3,961,20910,3575878096,3575878107,11
3,961,20911,3575878096,3575878108,12
3,961,20912,3575878096,3575878112,16
3,961,20913,3575878096,3575878112,16
3,961,20914,3575878096,3575878113,17
3,961,20915,3575878096,3575878116,20
3,961,20916,3575878096,3575878117,21
3,961,20917,3575878096,3575878117,21
3,961,20918,3575878096,3575878119,23
3,961,20919,3575878096,3575878121,25
3,961,20920,3575878096,3575878123,27
3,961,20921,3575878096,3575878124,28
3,961,20922,3575878096,3575878125,29
3,961,20923,3575878096,3575878127,31
3,961,20924,3575878096,3575878127,31
3,961,20925,3575878096,3575878128,32
3,961,20926,3575878096,3575878130,34
3,961,20927,3575878096,3575878132,36
3,961,20928,3575878096,3575878134,38
3,961,20929,3575878096,3575878136,40
3,961,20930,3575878096,3575878137,41
3,961,20931,3575878096,3575878138,42
3,961,20932,3575878096,3575878142,46
3,961,20933,3575878096,3575878142,46
3,961,20934,3575878096,3575878143,47
3,961,20935,3575878096,3575878143,47
3,961,20936,3575878096,3575878145,49
3,962,20937,3575878161,3575878161,0
3,962,20938,3575878161,3575878161,0
3,962,20939,3575878161,3575878161,0
3,962,20940,3575878161,3575878161,0
3,962,20941,3575878161,3575878161,0
3,962,20942,3575878161,3575878161,0
3,962,20943,3575878161,3575878161,0
3,962,20944,3575878161,3575878161,0
3,962,20945,3575878161,3575878161,0
3,962,20946,3575878161,3575878163,2
3,962,20947,3575878161,3575878163,2
3,962,20948,3575878161,3575878164,3
3,962,20949,3575878161,3575878167,6
3,962,20950,3575878161,3575878169,8
3,962,20951,3575878161,3575878170,9
3,962,20952,3575878161,3575878170,9
3,962,20953,3575878161,3575878170,9
3,962,20954,3575878161,3575878171,10
3,962,20955,3575878161,3575878171,10
3,962,20956,3575878161,3575878171,10
3,962,20957,3575878161,3575878172,11
3,962,20958,3575878161,3575878175,14
3,962,20959,3575878161,3575878177,16
3,962,20960,3575878161,3575878178,17
3,962,20961,3575878161,3575878178,17
3,962,20962,3575878161,3575878179,18
3,962,20963,3575878161,3575878180,19
3,962,20964,3575878161,3575878180,19
3,962,20965,3575878161,3575878180,19
3,962,20966,3575878161,3575878181,20
3,962,20967,3575878161,3575878182,21
3,962,20968,3575878161,3575878186,25
3,962,20969,3575878161,3575878187,26
3,962,20970,3575878161,3575878187,26
3,962,20971,3575878161,3575878188,27
3,962,20972,3575878161,3575878188,27
3,962,20973,3575878161,3575878189,28
3,962,20974,3575878161,3575878193,32
3,962,20975,3575878161,3575878194,33
3,962,20976,3575878161,3575878195,34
3,962,20977,3575878161,3575878195,34
3,962,20978,3575878161,3575878195,34
3,962,20979,3575878161,3575878197,36
3,962,20980,3575878161,3575878197,36
3,962,20981,3575878161,3575878197,36
3,962,20982,3575878161,3575878197,36
3,962,20983,3575878161,3575878198,37
3,962,20984,3575878161,3575878198,37
3,962,20985,3575878161,3575878200,39
3,962,20986,3575878161,3575878201,40
3,962,20987,3575878161,3575878202,41
3,962,20988,3575878161,3575878203,42
3,962,20989,3575878161,3575878203,42
3,962,20990,3575878161,3575878204,43
3,962,20991,3575878161,3575878204,43
3,962,20992,3575878161,3575878204,43
3,962,20993,3575878161,3575878206,45
3,962,20994,3575878161,3575878206,45
3,962,20995,3575878161,3575878208,47
3,962,20996,3575878161,3575878211,50
3,963,20997,3575878226,3575878226,0
3,963,20998,3575878226,3575878226,0
3,963,20999,3575878226,3575878226,0
3,963,21000,3575878226,3575878226,0
3,963,21001,3575878226,3575878226,0
3,963,21002,3575878226,3575878226,0
3,963,21003,3575878226,3575878226,0
3,963,21004,3575878226,3575878226,0
3,963,21005,3575878226,3575878226,0
3,963,21006,3575878226,3575878226,0
3,963,21007,3575878226,3575878226,0
3,963,21008,3575878226,3575878226,0
3,963,21009,3575878226,3575878227,1
3,963,21010,3575878226,3575878227,1
3,963,21011,3575878226,3575878229,3
3,963,21012,3575878226,3575878229,3
3,963,21013,3575878226,3575878229,3
3,963,21014,3575878226,3575878231,5
3,963,21015,3575878226,3575878231,5
3,963,21016,3575878226,3575878233,7
3,963,21017,3575878226,3575878235,9
3,963,21018,3575878226,3575878235,9
3,963,21019,3575878226,3575878236,10
3,963,21020,3575878226,3575878237,11
3,963,21021,3575878226,3575878238,12
3,963,21022,3575878226,3575878238,12
3,963,21023,3575878226,3575878238,12
3,963,21024,3575878226,3575878238,12
3,963,21025,3575878226,3575878238,12
3,963,21026,3575878226,3575878238,12
3,963,21027,3575878226,3575878240,14
3,963,21028,3575878226,3575878241,15
3,963,21029,3575878226,3575878242,16
3,963,21030,3575878226,3575878242,16
3,963,21031,3575878226,3575878243,17
3,963,21032,3575878226,3575878245,19
3,963,21033,3575878226,3575878246,20
3,963,21034,3575878226,3575878246,20
3,963,21035,3575878226,3575878246,20
3,963,21036,3575878226,3575878248,22
3,963,21037,3575878226,3575878250,24
3,963,21038,3575878226,3575878250,24
3,963,21039,3575878226,3575878251,25
3,963,21040,3575878226,3575878253,27
3,963,21041,3575878226,3575878253,27
3,963,21042,3575878226,3575878254,28
3,963,21043,3575878226,3575878257,31
3,963,21044,3575878226,3575878258,32
3,963,21045,3575878226,3575878258,32
3,963,21046,3575878226,3575878259,33
3,963,21047,3575878226,3575878259,33
3,963,21048,3575878226,3575878260,34
3,963,21049,3575878226,3575878262,36
3,963,21050,3575878226,3575878262,36
3,963,21051,3575878226,3575878263,37
3,963,21052,3575878226,3575878265,39
3,963,21053,3575878226,3575878265,39
3,963,21054,3575878226,3575878267,41
3,963,21055,3575878226,3575878267,41
3,963,21056,3575878226,3575878267,41
3,963,21057,3575878226,3575878267,41
3,963,21058,3575878226,3575878267,41
3,963,21059,3575878226,3575878268,42
3,963,21060,3575878226,3575878270,44
3,963,21061,3575878226,3575878274,48
3,963,21062,3575878226,3575878276,50
3,964,21063,3575878287,3575878287,0
3,964,21064,3575878287,3575878287,0
3,964,21065,3575878287,3575878287,0
3,964,21066,3575878287,3575878287,0
3,964,21067,3575878287,3575878287,0
3,964,21068,3575878287,3575878287,0
3,964,21069,3575878287,3575878287,0
3,964,21070,3575878287,3575878287,0
3,964,21071,3575878287,3575878287,0
3,964,21072,3575878287,3575878287,0
3,964,21073,3575878287,3575878287,0
3,964,21074,3575878287,3575878288,1
3,964,21075,3575878287,3575878288,1
3,964,21076,3575878287,3575878289,2
3,964,21077,3575878287,3575878290,3
3,964,21078,3575878287,3575878295,8
3,964,21079,3575878287,3575878295,8
3,964,21080,3575878287,3575878296,9
3,964,21081,3575878287,3575878296,9
3,964,21082,3575878287,3575878296,9
3,964,21083,3575878287,3575878300,13
3,964,21084,3575878287,3575878300,13
3,964,21085,3575878287,3575878300,13
3,964,21086,3575878287,3575878301,14
3,964,21087,3575878287,3575878302,15
3,964,21088,3575878287,3575878302,15
3,964,21089,3575878287,3575878303,16
3,964,21090,3575878287,3575878305,18
3,964,21091,3575878287,3575878305,18
3,964,21092,3575878287,3575878306,19
3,964,21093,3575878287,3575878306,19
3,964,21094,3575878287,3575878307,20
3,964,21095,3575878287,3575878308,21
3,964,21096,3575878287,3575878312,25
3,964,21097,3575878287,3575878313,26
3,964,21098,3575878287,3575878313,26
3,964,21099,3575878287,3575878316,29
3,964,21100,3575878287,3575878317,30
3,964,21101,3575878287,3575878318,31
3,964,21102,3575878287,3575878319,32
3,964,21103,3575878287,3575878320,33
3,964,21104,3575878287,3575878323,36
3,964,21105,3575878287,3575878324,37
3,964,21106,3575878287,3575878327,40
3,964,21107,3575878287,3575878327,40
3,964,21108,3575878287,3575878328,41
3,964,21109,3575878287,3575878330,43
3,964,21110,3575878287,3575878333,46
3,964,21111,3575878287,3575878334,47
3,964,21112,3575878287,3575878336,49
3,964,21113,3575878287,3575878337,50
3,965,21114,3575878349,3575878350,1
3,965,21115,3575878349,3575878350,1
3,965,21116,3575878349,3575878350,1
3,965,21117,3575878349,3575878350,1
3,965,21118,3575878349,3575878350,1
3,965,21119,3575878349,3575878350,1
3,965,21120,3575878349,3575878350,1
3,965,21121,3575878349,3575878350,1
3,965,21122,3575878349,3575878350,1
3,965,21123,3575878349,3575878352,3
3,965,21124,3575878349,3575878354,5
3,965,21125,3575878349,3575878354,5
3,965,21126,3575878349,3575878357,8
3,965,21127,3575878349,3575878358,9
3,965,21128,3575878349,3575878359,10
3,965,21129,3575878349,3575878361,12
3,965,21130,3575878349,3575878364,15
3,965,21131,3575878349,3575878364,15
3,965,21132,3575878349,3575878364,15
3,965,21133,3575878349,3575878367,18
3,965,21134,3575878349,3575878369,20
3,965,21135,3575878349,3575878370,21
3,965,21136,3575878349,3575878370,21
3,965,21137,3575878349,3575878370,21
3,965,21138,3575878349,3575878371,22
3,965,21139,3575878349,3575878372,23
3,965,21140,3575878349,3575878372,23
3,965,21141,3575878349,3575878373,24
3,965,21142,3575878349,3575878376,27
3,965,21143,3575878349,3575878376,27
3,965,21144,3575878349,3575878377,28
3,965,21145,3575878349,3575878378,29
3,965,21146,3575878349,3575878379,30
3,965,21147,3575878349,3575878379,30
3,965,21148,3575878349,3575878380,31
3,965,21149,3575878349,3575878381,32
3,965,21150,3575878349,3575878381,32
3,965,21151,3575878349,3575878382,33
3,965,21152,3575878349,3575878385,36
3,965,21153,3575878349,3575878386,37
3,965,21154,3575878349,3575878386,37
3,965,21155,3575878349,3575878388,39
3,965,21156,3575878349,3575878389,40
3,965,21157,3575878349,3575878393,44
3,965,21158,3575878349,3575878395,46
3,965,21159,3575878349,3575878395,46
3,965,21160,3575878349,3575878395,46
3,965,21161,3575878349,3575878395,46
3,965,21162,3575878349,3575878397,48
3,965,21163,3575878349,3575878397,48
3,965,21164,3575878349,3575878397,48
3,965,21165,3575878349,3575878398,49
3,965,21166,3575878349,3575878398,49
3,966,21167,3575878408,3575878408,0
3,966,21168,3575878408,3575878408,0
3,966,21169,3575878408,3575878408,0
3,966,21170,3575878408,3575878408,0
3,966,21171,3575878408,3575878408,0
3,966,21172,3575878408,3575878408,0
3,966,21173,3575878408,3575878408,0
3,966,21174,3575878408,3575878408,0
3,966,21175,3575878408,3575878408,0
3,966,21176,3575878408,3575878408,0
3,966,21177,3575878408,3575878408,0
3,966,21178,3575878408,3575878409,1
3,966,21179,3575878408,3575878411,3
3,966,21180,3575878408,3575878416,8
3,966,21181,3575878408,3575878416,8
3,966,21182,3575878408,3575878416,8
3,966,21183,3575878408,3575878417,9
3,966,21184,3575878408,3575878419,11
3,966,21185,3575878408,3575878419,11
3,966,21186,3575878408,3575878420,12
3,966,21187,3575878408,3575878423,15
3,966,21188,3575878408,3575878423,15
3,966,21189,3575878408,3575878425,17
3,966,21190,3575878408,3575878426,18
3,966,21191,3575878408,3575878427,19
3,966,21192,3575878408,3575878428,20
3,966,21193,3575878408,3575878429,21
3,966,21194,3575878408,3575878429,21
3,966,21195,3575878408,3575878431,23
3,966,21196,3575878408,3575878431,23
3,966,21197,3575878408,3575878431,23
3,966,21198,3575878408,3575878432,24
3,966,21199,3575878408,3575878435,27
3,966,21200,3575878408,3575878435,27
3,966,21201,3575878408,3575878436,28
3,966,21202,3575878408,3575878436,28
3,966,21203,3575878408,3575878438,30
3,966,21204,3575878408,3575878438,30
3,966,21205,3575878408,3575878438,30
3,966,21206,3575878408,3575878438,30
3,966,21207,3575878408,3575878438,30
3,966,21208,3575878408,3575878439,31
3,966,21209,3575878408,3575878441,33
3,966,21210,3575878408,3575878442,34
3,966,21211,3575878408,3575878444,36
3,966,21212,3575878408,3575878445,37
3,966,21213,3575878408,3575878446,38
3,966,21214,3575878408,3575878446,38
3,966,21215,3575878408,3575878447,39
3,966,21216,3575878408,3575878449,41
3,966,21217,3575878408,3575878450,42
3,966,21218,3575878408,3575878451,43
3,966,21219,3575878408,3575878451,43
3,966,21220,3575878408,3575878453,45
3,966,21221,3575878408,3575878453,45
3,966,21222,3575878408,3575878454,46
3,966,21223,3575878408,3575878457,49
3,966,21224,3575878408,3575878457,49
3,967,21225,3575878469,3575878469,0
3,967,21226,3575878469,3575878469,0
3,967,21227,3575878469,3575878469,0
3,967,21228,3575878469,3575878469,0
3,967,21229,3575878469,3575878469,0
3,967,21230,3575878469,3575878469,0
3,967,21231,3575878469,3575878469,0
3,967,21232,3575878469,3575878469,0
3,967,21233,3575878469,3575878469,0
3,967,21234,3575878469,3575878469,0
3,967,21235,3575878469,3575878469,0
3,967,21236,3575878469,3575878469,0
3,967,21237,3575878469,3575878469,0
3,967,21238,3575878469,3575878469,0
3,967,21239,3575878469,3575878470,1
3,967,21240,3575878469,3575878474,5
3,967,21241,3575878469,3575878475,6
3,967,21242,3575878469,3575878479,10
3,967,21243,3575878469,3575878481,12
3,967,21244,3575878469,3575878481,12
3,967,21245,3575878469,3575878481,12
3,967,21246,3575878469,3575878481,12
3,967,21247,3575878469,3575878481,12
3,967,21248,3575878469,3575878484,15
3,967,21249,3575878469,3575878484,15
3,967,21250,3575878469,3575878485,16
3,967,21251,3575878469,3575878486,17
3,967,21252,3575878469,3575878486,17
3,967,21253,3575878469,3575878487,18
3,967,21254,3575878469,3575878488,19
3,967,21255,3575878469,3575878490,21
3,967,21256,3575878469,3575878490,21
3,967,21257,3575878469,3575878495,26
3,967,21258,3575878469,3575878495,26
3,967,21259,3575878469,3575878495,26
3,967,21260,3575878469,3575878496,27
3,967,21261,3575878469,3575878496,27
3,967,21262,3575878469,3575878500,31
3,967,21263,3575878469,3575878500,31
3,967,21264,3575878469,3575878500,31
3,967,21265,3575878469,3575878501,32
3,967,21266,3575878469,3575878502,33
3,967,21267,3575878469,3575878502,33
3,967,21268,3575878469,3575878505,36
3,967,21269,3575878469,3575878506,37
3,967,21270,3575878469,3575878506,37
3,967,21271,3575878469,3575878507,38
3,967,21272,3575878469,3575878508,39
3,967,21273,3575878469,3575878511,42
3,967,21274,3575878469,3575878513,44
3,967,21275,3575878469,3575878513,44
3,967,21276,3575878469,3575878517,48
3,967,21277,3575878469,3575878517,48
3,967,21278,3575878469,3575878518,49
3,967,21279,3575878469,3575878519,50
3,968,21280,3575878533,3575878533,0
3,968,21281,3575878533,3575878533,0
3,968,21282,3575878533,3575878533,0
3,968,21283,3575878533,3575878533,0
3,968,21284,3575878533,3575878533,0
3,968,21285,3575878533,3575878533,0
3,968,21286,3575878533,3575878533,0
3,968,21287,3575878533,3575878533,0
3,968,21288,3575878533,3575878533,0
3,968,21289,3575878533,3575878533,0
3,968,21290,3575878533,3575878533,0
3,968,21291,3575878533,3575878534,1
3,968,21292,3575878533,3575878535,2
3,968,21293,3575878533,3575878536,3
3,968,21294,3575878533,3575878541,8
3,968,21295,3575878533,3575878543,10
3,968,21296,3575878533,3575878543,10
3,968,21297,3575878533,3575878544,11
3,968,21298,3575878533,3575878547,14
3,968,21299,3575878533,3575878549,16
3,968,21300,3575878533,3575878551,18
3,968,21301,3575878533,3575878553,20
3,968,21302,3575878533,3575878554,21
3,968,21303,3575878533,3575878556,23
3,968,21304,3575878533,3575878558,25
3,968,21305,3575878533,3575878558,25
3,968,21306,3575878533,3575878560,27
3,968,21307,3575878533,3575878563,30
3,968,21308,3575878533,3575878563,30
3,968,21309,3575878533,3575878564,31
3,968,21310,3575878533,3575878566,33
3,968,21311,3575878533,3575878568,35
3,968,21312,3575878533,3575878569,36
3,968,21313,3575878533,3575878569,36
3,968,21314,3575878533,3575878569,36
3,968,21315,3575878533,3575878570,37
3,968,21316,3575878533,3575878570,37
3,968,21317,3575878533,3575878571,38
3,968,21318,3575878533,3575878572,39
3,968,21319,3575878533,3575878575,42
3,968,21320,3575878533,3575878575,42
3,968,21321,3575878533,3575878576,43
3,968,21322,3575878533,3575878577,44
3,968,21323,3575878533,3575878578,45
3,968,21324,3575878533,3575878579,46
3,968,21325,3575878533,3575878580,47
3,968,21326,3575878533,3575878581,48
3,968,21327,3575878533,3575878581,48
3,969,21328,3575878594,3575878594,0
3,969,21329,3575878594,3575878594,0
3,969,21330,3575878594,3575878594,0
3,969,21331,3575878594,3575878594,0
3,969,21332,3575878594,3575878594,0
3,969,21333,3575878594,3575878594,0
3,969,21334,3575878594,3575878594,0
3,969,21335,3575878594,3575878594,0
3,969,21336,3575878594,3575878594,0
3,969,21337,3575878594,3575878595,1
3,969,21338,3575878594,3575878596,2
3,969,21339,3575878594,3575878596,2
3,969,21340,3575878594,3575878596,2
3,969,21341,3575878594,3575878596,2
3,969,21342,3575878594,3575878597,3
3,969,21343,3575878594,3575878597,3
3,969,21344,3575878594,3575878601,7
3,969,21345,3575878594,3575878602,8
3,969,21346,3575878594,3575878602,8
3,969,21347,3575878594,3575878602,8
3,969,21348,3575878594,3575878603,9
3,969,21349,3575878594,3575878603,9
3,969,21350,3575878594,3575878604,10
3,969,21351,3575878594,3575878605,11
3,969,21352,3575878594,3575878606,12
3,969,21353,3575878594,3575878608,14
3,969,21354,3575878594,3575878610,16
3,969,21355,3575878594,3575878615,21
3,969,21356,3575878594,3575878615,21
3,969,21357,3575878594,3575878615,21
3,969,21358,3575878594,3575878618,24
3,969,21359,3575878594,3575878618,24
3,969,21360,3575878594,3575878620,26
3,969,21361,3575878594,3575878622,28
3,969,21362,3575878594,3575878622,28
3,969,21363,3575878594,3575878624,30
3,969,21364,3575878594,3575878625,31
3,969,21365,3575878594,3575878625,31
3,969,21366,3575878594,3575878627,33
3,969,21367,3575878594,3575878628,34
3,969,21368,3575878594,3575878628,34
3,969,21369,3575878594,3575878630,36
3,969,21370,3575878594,3575878630,36
3,969,21371,3575878594,3575878631,37
3,969,21372,3575878594,3575878632,38
3,969,21373,3575878594,3575878632,38
3,969,21374,3575878594,3575878634,40
3,969,21375,3575878594,3575878635,41
3,969,21376,3575878594,3575878636,42
3,969,21377,3575878594,3575878637,43
3,969,21378,3575878594,3575878637,43
3,969,21379,3575878594,3575878637,43
3,969,21380,3575878594,3575878638,44
3,969,21381,3575878594,3575878638,44
3,969,21382,3575878594,3575878638,44
3,969,21383,3575878594,3575878638,44
3,969,21384,3575878594,3575878640,46
3,969,21385,3575878594,3575878640,46
3,969,21386,3575878594,3575878641,47
3,969,21387,3575878594,3575878641,47
3,970,21388,3575878656,3575878656,0
3,970,21389,3575878656,3575878656,0
3,970,21390,3575878656,3575878656,0
3,970,21391,3575878656,3575878656,0
3,970,21392,3575878656,3575878656,0
3,970,21393,3575878656,3575878656,0
3,970,21394,3575878656,3575878656,0
3,970,21395,3575878656,3575878656,0
3,970,21396,3575878656,3575878656,0
3,970,21397,3575878656,3575878656,0
3,970,21398,3575878656,3575878656,0
3,970,21399,3575878656,3575878656,0
3,970,21400,3575878656,3575878656,0
3,970,21401,3575878656,3575878657,1
3,970,21402,3575878656,3575878658,2
3,970,21403,3575878656,3575878658,2
3,970,21404,3575878656,3575878659,3
3,970,21405,3575878656,3575878659,3
3,970,21406,3575878656,3575878661,5
3,970,21407,3575878656,3575878662,6
3,970,21408,3575878656,3575878663,7
3,970,21409,3575878656,3575878664,8
3,970,21410,3575878656,3575878664,8
3,970,21411,3575878656,3575878665,9
3,970,21412,3575878656,3575878665,9
3,970,21413,3575878656,3575878666,10
3,970,21414,3575878656,3575878666,10
3,970,21415,3575878656,3575878667,11
3,970,21416,3575878656,3575878667,11
3,970,21417,3575878656,3575878669,13
3,970,21418,3575878656,3575878673,17
3,970,21419,3575878656,3575878675,19
3,970,21420,3575878656,3575878680,24
3,970,21421,3575878656,3575878681,25
3,970,21422,3575878656,3575878681,25
3,970,21423,3575878656,3575878681,25
3,970,21424,3575878656,3575878682,26
3,970,21425,3575878656,3575878682,26
3,970,21426,3575878656,3575878684,28
3,970,21427,3575878656,3575878684,28
3,970,21428,3575878656,3575878684,28
3,970,21429,3575878656,3575878685,29
3,970,21430,3575878656,3575878686,30
3,970,21431,3575878656,3575878686,30
3,970,21432,3575878656,3575878688,32
3,970,21433,3575878656,3575878689,33
3,970,21434,3575878656,3575878690,34
3,970,21435,3575878656,3575878695,39
3,970,21436,3575878656,3575878695,39
3,970,21437,3575878656,3575878696,40
3,970,21438,3575878656,3575878696,40
3,970,21439,3575878656,3575878696,40
3,970,21440,3575878656,3575878697,41
3,970,21441,3575878656,3575878700,44
3,970,21442,3575878656,3575878700,44
3,970,21443,3575878656,3575878700,44
3,970,21444,3575878656,3575878700,44
3,970,21445,3575878656,3575878702,46
3,970,21446,3575878656,3575878702,46
3,970,21447,3575878656,3575878704,48
3,970,21448,3575878656,3575878705,49
3,970,21449,3575878656,3575878706,50
3,971,21450,3575878718,3575878718,0
3,971,21451,3575878718,3575878718,0
3,971,21452,3575878718,3575878718,0
3,971,21453,3575878718,3575878718,0
3,971,21454,3575878718,3575878718,0
3,971,21455,3575878718,3575878718,0
3,971,21456,3575878718,3575878718,0
3,971,21457,3575878718,3575878718,0
3,971,21458,3575878718,3575878718,0
3,971,21459,3575878718,3575878719,1
3,971,21460,3575878718,3575878720,2
3,971,21461,3575878718,3575878722,4
3,971,21462,3575878718,3575878723,5
3,971,21463,3575878718,3575878724,6
3,971,21464,3575878718,3575878724,6
3,971,21465,3575878718,3575878725,7
3,971,21466,3575878718,3575878727,9
3,971,21467,3575878718,3575878728,10
3,971,21468,3575878718,3575878730,12
3,971,21469,3575878718,3575878732,14
3,971,21470,3575878718,3575878733,15
3,971,21471,3575878718,3575878734,16
3,971,21472,3575878718,3575878735,17
3,971,21473,3575878718,3575878736,18
3,971,21474,3575878718,3575878741,23
3,971,21475,3575878718,3575878742,24
3,971,21476,3575878718,3575878744,26
3,971,21477,3575878718,3575878744,26
3,971,21478,3575878718,3575878746,28
3,971,21479,3575878718,3575878749,31
3,971,21480,3575878718,3575878751,33
3,971,21481,3575878718,3575878751,33
3,971,21482,3575878718,3575878753,35
3,971,21483,3575878718,3575878754,36
3,971,21484,3575878718,3575878756,38
3,971,21485,3575878718,3575878758,40
3,971,21486,3575878718,3575878758,40
3,971,21487,3575878718,3575878760,42
3,971,21488,3575878718,3575878762,44
3,971,21489,3575878718,3575878763,45
3,971,21490,3575878718,3575878764,46
3,971,21491,3575878718,3575878767,49
3,971,21492,3575878718,3575878768,50
3,972,21493,3575878778,3575878778,0
3,972,21494,3575878778,3575878778,0
3,972,21495,3575878778,3575878778,0
3,972,21496,3575878778,3575878778,0
3,972,21497,3575878778,3575878778,0
3,972,21498,3575878778,3575878778,0
3,972,21499,3575878778,3575878778,0
3,972,21500,3575878778,3575878778,0
3,972,21501,3575878778,3575878778,0
3,972,21502,3575878778,3575878778,0
3,972,21503,3575878778,3575878778,0
3,972,21504,3575878778,3575878778,0
3,972,21505,3575878778,3575878778,0
3,972,21506,3575878778,3575878779,1
3,972,21507,3575878778,3575878779,1
3,972,21508,3575878778,3575878780,2
3,972,21509,3575878778,3575878781,3
3,972,21510,3575878778,3575878785,7
3,972,21511,3575878778,3575878786,8
3,972,21512,3575878778,3575878787,9
3,972,21513,3575878778,3575878787,9
3,972,21514,3575878778,3575878788,10
3,972,21515,3575878778,3575878791,13
3,972,21516,3575878778,3575878793,15
3,972,21517,3575878778,3575878794,16
3,972,21518,3575878778,3575878794,16
3,972,21519,3575878778,3575878794,16
3,972,21520,3575878778,3575878796,18
3,972,21521,3575878778,3575878796,18
3,972,21522,3575878778,3575878796,18
3,972,21523,3575878778,3575878796,18
3,972,21524,3575878778,3575878797,19
3,972,21525,3575878778,3575878797,19
3,972,21526,3575878778,3575878801,23
3,972,21527,3575878778,3575878802,24
3,972,21528,3575878778,3575878803,25
3,972,21529,3575878778,3575878803,25
3,972,21530,3575878778,3575878803,25
3,972,21531,3575878778,3575878804,26
3,972,21532,3575878778,3575878804,26
3,972,21533,3575878778,3575878806,28
3,972,21534,3575878778,3575878806,28
3,972,21535,3575878778,3575878809,31
3,972,21536,3575878778,3575878810,32
3,972,21537,3575878778,3575878815,37
3,972,21538,3575878778,3575878816,38
3,972,21539,3575878778,3575878816,38
3,972,21540,3575878778,3575878816,38
3,972,21541,3575878778,3575878819,41
3,972,21542,3575878778,3575878820,42
3,972,21543,3575878778,3575878820,42
3,972,21544,3575878778,3575878822,44
3,972,21545,3575878778,3575878823,45
3,972,21546,3575878778,3575878823,45
3,972,21547,3575878778,3575878826,48
3,972,21548,3575878778,3575878826,48
3,972,21549,3575878778,3575878827,49
3,972,21550,3575878778,3575878827,49
3,972,21551,3575878778,3575878828,50
3,973,21552,3575878843,3575878843,0
3,973,21553,3575878843,3575878843,0
3,973,21554,3575878843,3575878843,0
3,973,21555,3575878843,3575878843,0
3,973,21556,3575878843,3575878843,0
3,973,21557,3575878843,3575878843,0
3,973,21558,3575878843,3575878843,0
3,973,21559,3575878843,3575878843,0
3,973,21560,3575878843,3575878843,0
3,973,21561,3575878843,3575878843,0
3,973,21562,3575878843,3575878843,0
3,973,21563,3575878843,3575878843,0
3,973,21564,3575878843,3575878843,0
3,973,21565,3575878843,3575878843,0
3,973,21566,3575878843,3575878843,0
3,973,21567,3575878843,3575878843,0
3,973,21568,3575878843,3575878843,0
3,973,21569,3575878843,3575878843,0
3,973,21570,3575878843,3575878843,0
3,973,21571,3575878843,3575878843,0
3,973,21572,3575878843,3575878843,0
3,973,21573,3575878843,3575878843,0
3,973,21574,3575878843,3575878844,1
3,973,21575,3575878843,3575878844,1
3,973,21576,3575878843,3575878845,2
3,973,21577,3575878843,3575878847,4
3,973,21578,3575878843,3575878849,6
3,973,21579,3575878843,3575878850,7
3,973,21580,3575878843,3575878850,7
3,973,21581,3575878843,3575878851,8
3,973,21582,3575878843,3575878852,9
3,973,21583,3575878843,3575878852,9
3,973,21584,3575878843,3575878852,9
3,973,21585,3575878843,3575878853,10
3,973,21586,3575878843,3575878855,12
3,973,21587,3575878843,3575878856,13
3,973,21588,3575878843,3575878858,15
3,973,21589,3575878843,3575878859,16
3,973,21590,3575878843,3575878859,16
3,973,21591,3575878843,3575878859,16
3,973,21592,3575878843,3575878861,18
3,973,21593,3575878843,3575878863,20
3,973,21594,3575878843,3575878863,20
3,973,21595,3575878843,3575878864,21
3,973,21596,3575878843,3575878864,21
3,973,21597,3575878843,3575878866,23
3,973,21598,3575878843,3575878866,23
3,973,21599,3575878843,3575878867,24
3,973,21600,3575878843,3575878868,25
3,973,21601,3575878843,3575878869,26
3,973,21602,3575878843,3575878874,31
3,973,21603,3575878843,3575878875,32
3,973,21604,3575878843,3575878881,38
3,973,21605,3575878843,3575878881,38
3,973,21606,3575878843,3575878881,38
3,973,21607,3575878843,3575878881,38
3,973,21608,3575878843,3575878882,39
3,973,21609,3575878843,3575878882,39
3,973,21610,3575878843,3575878883,40
3,973,21611,3575878843,3575878884,41
3,973,21612,3575878843,3575878885,42
3,973,21613,3575878843,3575878885,42
3,973,21614,3575878843,3575878885,42
3,973,21615,3575878843,3575878885,42
3,973,21616,3575878843,3575878886,43
3,973,21617,3575878843,3575878887,44
3,973,21618,3575878843,3575878888,45
3,973,21619,3575878843,3575878889,46
3,974,21620,3575878904,3575878904,0
3,974,21621,3575878904,3575878904,0
3,974,21622,3575878904,3575878904,0
3,974,21623,3575878904,3575878904,0
3,974,21624,3575878904,3575878904,0
3,974,21625,3575878904,3575878904,0
3,974,21626,3575878904,3575878904,0
3,974,21627,3575878904,3575878904,0
3,974,21628,3575878904,3575878904,0
3,974,21629,3575878904,3575878904,0
3,974,21630,3575878904,3575878904,0
3,974,21631,3575878904,3575878904,0
3,974,21632,3575878904,3575878904,0
3,974,21633,3575878904,3575878905,1
3,974,21634,3575878904,3575878905,1
3,974,21635,3575878904,3575878906,2
3,974,21636,3575878904,3575878908,4
3,974,21637,3575878904,3575878908,4
3,974,21638,3575878904,3575878912,8
3,974,21639,3575878904,3575878913,9
3,974,21640,3575878904,3575878913,9
3,974,21641,3575878904,3575878917,13
3,974,21642,3575878904,3575878917,13
3,974,21643,3575878904,3575878918,14
3,974,21644,3575878904,3575878920,16
3,974,21645,3575878904,3575878920,16
3,974,21646,3575878904,3575878922,18
3,974,21647,3575878904,3575878923,19
3,974,21648,3575878904,3575878925,21
3,974,21649,3575878904,3575878925,21
3,974,21650,3575878904,3575878926,22
3,974,21651,3575878904,3575878927,23
3,974,21652,3575878904,3575878928,24
3,974,21653,3575878904,3575878929,25
3,974,21654,3575878904,3575878932,28
3,974,21655,3575878904,3575878933,29
3,974,21656,3575878904,3575878934,30
3,974,21657,3575878904,3575878935,31
3,974,21658,3575878904,3575878937,33
3,974,21659,3575878904,3575878941,37
3,974,21660,3575878904,3575878943,39
3,974,21661,3575878904,3575878944,40
3,974,21662,3575878904,3575878946,42
3,974,21663,3575878904,3575878949,45
3,974,21664,3575878904,3575878949,45
3,974,21665,3575878904,3575878951,47
3,974,21666,3575878904,3575878951,47
3,974,21667,3575878904,3575878953,49
3,975,21668,3575878964,3575878964,0
3,975,21669,3575878964,3575878964,0
3,975,21670,3575878964,3575878964,0
3,975,21671,3575878964,3575878964,0
3,975,21672,3575878964,3575878964,0
3,975,21673,3575878964,3575878964,0
3,975,21674,3575878964,3575878964,0
3,975,21675,3575878964,3575878968,4
3,975,21676,3575878964,3575878968,4
3,975,21677,3575878964,3575878969,5
3,975,21678,3575878964,3575878969,5
3,975,21679,3575878964,3575878969,5
3,975,21680,3575878964,3575878971,7
3,975,21681,3575878964,3575878972,8
3,975,21682,3575878964,3575878972,8
3,975,21683,3575878964,3575878975,11
3,975,21684,3575878964,3575878975,11
3,975,21685,3575878964,3575878976,12
3,975,21686,3575878964,3575878978,14
3,975,21687,3575878964,3575878979,15
3,975,21688,3575878964,3575878979,15
3,975,21689,3575878964,3575878980,16
3,975,21690,3575878964,3575878981,17
3,975,21691,3575878964,3575878981,17
3,975,21692,3575878964,3575878983,19
3,975,21693,3575878964,3575878984,20
3,975,21694,3575878964,3575878986,22
3,975,21695,3575878964,3575878988,24
3,975,21696,3575878964,3575878988,24
3,975,21697,3575878964,3575878988,24
3,975,21698,3575878964,3575878993,29
3,975,21699,3575878964,3575878993,29
3,975,21700,3575878964,3575878994,30
3,975,21701,3575878964,3575878995,31
3,975,21702,3575878964,3575878996,32
3,975,21703,3575878964,3575878996,32
3,975,21704,3575878964,3575878997,33
3,975,21705,3575878964,3575878997,33
3,975,21706,3575878964,3575878997,33
3,975,21707,3575878964,3575878997,33
3,975,21708,3575878964,3575878998,34
3,975,21709,3575878964,3575879001,37
3,975,21710,3575878964,3575879002,38
3,975,21711,3575878964,3575879002,38
3,975,21712,3575878964,3575879003,39
3,975,21713,3575878964,3575879003,39
3,975,21714,3575878964,3575879003,39
3,975,21715,3575878964,3575879004,40
3,975,21716,3575878964,3575879005,41
3,975,21717,3575878964,3575879006,42
3,975,21718,3575878964,3575879009,45
3,975,21719,3575878964,3575879011,47
3,976,21720,3575879026,3575879026,0
3,976,21721,3575879026,3575879026,0
3,976,21722,3575879026,3575879026,0
3,976,21723,3575879026,3575879026,0
3,976,21724,3575879026,3575879026,0
3,976,21725,3575879026,3575879026,0
3,976,21726,3575879026,3575879026,0
3,976,21727,3575879026,3575879026,0
3,976,21728,3575879026,3575879026,0
3,976,21729,3575879026,3575879026,0
3,976,21730,3575879026,3575879026,0
3,976,21731,3575879026,3575879026,0
3,976,21732,3575879026,3575879027,1
3,976,21733,3575879026,3575879028,2
3,976,21734,3575879026,3575879028,2
3,976,21735,3575879026,3575879028,2
3,976,21736,3575879026,3575879030,4
3,976,21737,3575879026,3575879030,4
3,976,21738,3575879026,3575879030,4
3,976,21739,3575879026,3575879032,6
3,976,21740,3575879026,3575879032,6
3,976,21741,3575879026,3575879032,6
3,976,21742,3575879026,3575879034,8
3,976,21743,3575879026,3575879034,8
3,976,21744,3575879026,3575879035,9
3,976,21745,3575879026,3575879035,9
3,976,21746,3575879026,3575879036,10
3,976,21747,3575879026,3575879037,11
3,976,21748,3575879026,3575879037,11
3,976,21749,3575879026,3575879037,11
3,976,21750,3575879026,3575879038,12
3,976,21751,3575879026,3575879039,13
3,976,21752,3575879026,3575879040,14
3,976,21753,3575879026,3575879041,15
3,976,21754,3575879026,3575879041,15
3,976,21755,3575879026,3575879043,17
3,976,21756,3575879026,3575879043,17
3,976,21757,3575879026,3575879044,18
3,976,21758,3575879026,3575879044,18
3,976,21759,3575879026,3575879045,19
3,976,21760,3575879026,3575879047,21
3,976,21761,3575879026,3575879048,22
3,976,21762,3575879026,3575879049,23
3,976,21763,3575879026,3575879050,24
3,976,21764,3575879026,3575879050,24
3,976,21765,3575879026,3575879052,26
3,976,21766,3575879026,3575879052,26
3,976,21767,3575879026,3575879052,26
3,976,21768,3575879026,3575879053,27
3,976,21769,3575879026,3575879053,27
3,976,21770,3575879026,3575879055,29
3,976,21771,3575879026,3575879056,30
3,976,21772,3575879026,3575879058,32
3,976,21773,3575879026,3575879059,33
3,976,21774,3575879026,3575879059,33
3,976,21775,3575879026,3575879060,34
3,976,21776,3575879026,3575879062,36
3,976,21777,3575879026,3575879063,37
3,976,21778,3575879026,3575879063,37
3,976,21779,3575879026,3575879064,38
3,976,21780,3575879026,3575879064,38
3,976,21781,3575879026,3575879066,40
3,976,21782,3575879026,3575879066,40
3,976,21783,3575879026,3575879067,41
3,976,21784,3575879026,3575879067,41
3,976,21785,3575879026,3575879068,42
3,976,21786,3575879026,3575879069,43
3,976,21787,3575879026,3575879074,48
3,976,21788,3575879026,3575879075,49
3,977,21789,3575879090,3575879090,0
3,977,21790,3575879090,3575879090,0
3,977,21791,3575879090,3575879090,0
3,977,21792,3575879090,3575879090,0
3,977,21793,3575879090,3575879090,0
3,977,21794,3575879090,3575879090,0
3,977,21795,3575879090,3575879090,0
3,977,21796,3575879090,3575879090,0
3,977,21797,3575879090,3575879090,0
3,977,21798,3575879090,3575879090,0
3,977,21799,3575879090,3575879090,0
3,977,21800,3575879090,3575879090,0
3,977,21801,3575879090,3575879090,0
3,977,21802,3575879090,3575879090,0
3,977,21803,3575879090,3575879095,5
3,977,21804,3575879090,3575879096,6
3,977,21805,3575879090,3575879096,6
3,977,21806,3575879090,3575879097,7
3,977,21807,3575879090,3575879100,10
3,977,21808,3575879090,3575879100,10
3,977,21809,3575879090,3575879101,11
3,977,21810,3575879090,3575879101,11
3,977,21811,3575879090,3575879102,12
3,977,21812,3575879090,3575879103,13
3,977,21813,3575879090,3575879105,15
3,977,21814,3575879090,3575879105,15
3,977,21815,3575879090,3575879107,17
3,977,21816,3575879090,3575879107,17
3,977,21817,3575879090,3575879108,18
3,977,21818,3575879090,3575879110,20
3,977,21819,3575879090,3575879112,22
3,977,21820,3575879090,3575879113,23
3,977,21821,3575879090,3575879113,23
3,977,21822,3575879090,3575879117,27
3,977,21823,3575879090,3575879117,27
3,977,21824,3575879090,3575879118,28
3,977,21825,3575879090,3575879119,29
3,977,21826,3575879090,3575879120,30
3,977,21827,3575879090,3575879122,32
3,977,21828,3575879090,3575879123,33
3,977,21829,3575879090,3575879125,35
3,977,21830,3575879090,3575879126,36
3,977,21831,3575879090,3575879128,38
3,977,21832,3575879090,3575879128,38
3,977,21833,3575879090,3575879128,38
3,977,21834,3575879090,3575879130,40
3,977,21835,3575879090,3575879132,42
3,977,21836,3575879090,3575879134,44
3,977,21837,3575879090,3575879134,44
3,977,21838,3575879090,3575879135,45
3,977,21839,3575879090,3575879137,47
3,977,21840,3575879090,3575879137,47
3,978,21841,3575879154,3575879154,0
3,978,21842,3575879154,3575879154,0
3,978,21843,3575879154,3575879154,0
3,978,21844,3575879154,3575879154,0
3,978,21845,3575879154,3575879154,0
3,978,21846,3575879154,3575879154,0
3,978,21847,3575879154,3575879154,0
3,978,21848,3575879154,3575879154,0
3,978,21849,3575879154,3575879154,0
3,978,21850,3575879154,3575879154,0
3,978,21851,3575879154,3575879154,0
3,978,21852,3575879154,3575879154,0
3,978,21853,3575879154,3575879155,1
3,978,21854,3575879154,3575879158,4
3,978,21855,3575879154,3575879159,5
3,978,21856,3575879154,3575879161,7
3,978,21857,3575879154,3575879163,9
3,978,21858,3575879154,3575879164,10
3,978,21859,3575879154,3575879164,10
3,978,21860,3575879154,3575879169,15
3,978,21861,3575879154,3575879169,15
3,978,21862,3575879154,3575879169,15
3,978,21863,3575879154,3575879169,15
3,978,21864,3575879154,3575879171,17
3,978,21865,3575879154,3575879171,17
3,978,21866,3575879154,3575879171,17
3,978,21867,3575879154,3575879172,18
3,978,21868,3575879154,3575879174,20
3,978,21869,3575879154,3575879175,21
3,978,21870,3575879154,3575879175,21
3,978,21871,3575879154,3575879177,23
3,978,21872,3575879154,3575879179,25
3,978,21873,3575879154,3575879179,25
3,978,21874,3575879154,3575879179,25
3,978,21875,3575879154,3575879181,27
3,978,21876,3575879154,3575879181,27
3,978,21877,3575879154,3575879182,28
3,978,21878,3575879154,3575879184,30
3,978,21879,3575879154,3575879185,31
3,978,21880,3575879154,3575879188,34
3,978,21881,3575879154,3575879188,34
3,978,21882,3575879154,3575879189,35
3,978,21883,3575879154,3575879193,39
3,978,21884,3575879154,3575879194,40
3,978,21885,3575879154,3575879194,40
3,978,21886,3575879154,3575879195,41
3,978,21887,3575879154,3575879196,42
3,978,21888,3575879154,3575879196,42
3,978,21889,3575879154,3575879196,42
3,978,21890,3575879154,3575879196,42
3,978,21891,3575879154,3575879197,43
3,978,21892,3575879154,3575879197,43
3,978,21893,3575879154,3575879198,44
3,978,21894,3575879154,3575879201,47
3,978,21895,3575879154,3575879202,48
3,978,21896,3575879154,3575879202,48
3,978,21897,3575879154,3575879202,48
3,978,21898,3575879154,3575879203,49
3,978,21899,3575879154,3575879203,49
3,978,21900,3575879154,3575879203,49
3,978,21901,3575879154,3575879204,50
3,979,21902,3575879217,3575879217,0
3,979,21903,3575879217,3575879217,0
3,979,21904,3575879217,3575879217,0
3,979,21905,3575879217,3575879217,0
3,979,21906,3575879217,3575879218,1
3,979,21907,3575879217,3575879218,1
3,979,21908,3575879217,3575879218,1
3,979,21909,3575879217,3575879219,2
3,979,21910,3575879217,3575879219,2
3,979,21911,3575879217,3575879221,4
3,979,21912,3575879217,3575879221,4
3,979,21913,3575879217,3575879222,5
3,979,21914,3575879217,3575879222,5
3,979,21915,3575879217,3575879223,6
3,979,21916,3575879217,3575879224,7
3,979,21917,3575879217,3575879226,9
3,979,21918,3575879217,3575879227,10
3,979,21919,3575879217,3575879227,10
3,979,21920,3575879217,3575879227,10
3,979,21921,3575879217,3575879228,11
3,979,21922,3575879217,3575879230,13
3,979,21923,3575879217,3575879230,13
3,979,21924,3575879217,3575879231,14
3,979,21925,3575879217,3575879231,14
3,979,21926,3575879217,3575879232,15
3,979,21927,3575879217,3575879232,15
3,979,21928,3575879217,3575879234,17
3,979,21929,3575879217,3575879235,18
3,979,21930,3575879217,3575879235,18
3,979,21931,3575879217,3575879236,19
3,979,21932,3575879217,3575879237,20
3,979,21933,3575879217,3575879237,20
3,979,21934,3575879217,3575879237,20
3,979,21935,3575879217,3575879238,21
3,979,21936,3575879217,3575879238,21
3,979,21937,3575879217,3575879239,22
3,979,21938,3575879217,3575879240,23
3,979,21939,3575879217,3575879241,24
3,979,21940,3575879217,3575879242,25
3,979,21941,3575879217,3575879243,26
3,979,21942,3575879217,3575879244,27
3,979,21943,3575879217,3575879244,27
3,979,21944,3575879217,3575879244,27
3,979,21945,3575879217,3575879247,30
3,979,21946,3575879217,3575879247,30
3,979,21947,3575879217,3575879248,31
3,979,21948,3575879217,3575879249,32
3,979,21949,3575879217,3575879250,33
3,979,21950,3575879217,3575879250,33
3,979,21951,3575879217,3575879252,35
3,979,21952,3575879217,3575879252,35
3,979,21953,3575879217,3575879253,36
3,979,21954,3575879217,3575879253,36
3,979,21955,3575879217,3575879254,37
3,979,21956,3575879217,3575879255,38
3,979,21957,3575879217,3575879257,40
3,979,21958,3575879217,3575879259,42
3,979,21959,3575879217,3575879260,43
3,979,21960,3575879217,3575879260,43
3,979,21961,3575879217,3575879262,45
3,979,21962,3575879217,3575879263,46
3,979,21963,3575879217,3575879263,46
3,979,21964,3575879217,3575879264,47
3,979,21965,3575879217,3575879264,47
3,979,21966,3575879217,3575879266,49
3,979,21967,3575879217,3575879267,50
3,979,21968,3575879217,3575879267,50
3,980,21969,3575879277,3575879277,0
3,980,21970,3575879277,3575879277,0
3,980,21971,3575879277,3575879277,0
3,980,21972,3575879277,3575879277,0
3,980,21973,3575879277,3575879277,0
3,980,21974,3575879277,3575879277,0
3,980,21975,3575879277,3575879280,3
3,980,21976,3575879277,3575879281,4
3,980,21977,3575879277,3575879281,4
3,980,21978,3575879277,3575879281,4
3,980,21979,3575879277,3575879281,4
3,980,21980,3575879277,3575879283,6
3,980,21981,3575879277,3575879284,7
3,980,21982,3575879277,3575879285,8
3,980,21983,3575879277,3575879285,8
3,980,21984,3575879277,3575879285,8
3,980,21985,3575879277,3575879286,9
3,980,21986,3575879277,3575879286,9
3,980,21987,3575879277,3575879286,9
3,980,21988,3575879277,3575879287,10
3,980,21989,3575879277,3575879288,11
3,980,21990,3575879277,3575879291,14
3,980,21991,3575879277,3575879295,18
3,980,21992,3575879277,3575879296,19
3,980,21993,3575879277,3575879296,19
3,980,21994,3575879277,3575879296,19
3,980,21995,3575879277,3575879300,23
3,980,21996,3575879277,3575879300,23
3,980,21997,3575879277,3575879301,24
3,980,21998,3575879277,3575879302,25
3,980,21999,3575879277,3575879303,26
3,980,22000,3575879277,3575879305,28
3,980,22001,3575879277,3575879306,29
3,980,22002,3575879277,3575879307,30
3,980,22003,3575879277,3575879307,30
3,980,22004,3575879277,3575879307,30
3,980,22005,3575879277,3575879312,35
3,980,22006,3575879277,3575879313,36
3,980,22007,3575879277,3575879313,36
3,980,22008,3575879277,3575879316,39
3,980,22009,3575879277,3575879317,40
3,980,22010,3575879277,3575879319,42
3,980,22011,3575879277,3575879320,43
3,980,22012,3575879277,3575879322,45
3,980,22013,3575879277,3575879322,45
3,980,22014,3575879277,3575879324,47
3,980,22015,3575879277,3575879324,47
3,980,22016,3575879277,3575879327,50
3,981,22017,3575879341,3575879341,0
3,981,22018,3575879341,3575879341,0
3,981,22019,3575879341,3575879341,0
3,981,22020,3575879341,3575879342,1
3,981,22021,3575879341,3575879342,1
3,981,22022,3575879341,3575879342,1
3,981,22023,3575879341,3575879342,1
3,981,22024,3575879341,3575879342,1
3,981,22025,3575879341,3575879342,1
3,981,22026,3575879341,3575879342,1
3,981,22027,3575879341,3575879342,1
3,981,22028,3575879341,3575879342,1
3,981,22029,3575879341,3575879342,1
3,981,22030,3575879341,3575879343,2
3,981,22031,3575879341,3575879343,2
3,981,22032,3575879341,3575879345,4
3,981,22033,3575879341,3575879347,6
3,981,22034,3575879341,3575879349,8
3,981,22035,3575879341,3575879350,9
3,981,22036,3575879341,3575879352,11
3,981,22037,3575879341,3575879353,12
3,981,22038,3575879341,3575879354,13
3,981,22039,3575879341,3575879356,15
3,981,22040,3575879341,3575879358,17
3,981,22041,3575879341,3575879359,18
3,981,22042,3575879341,3575879361,20
3,981,22043,3575879341,3575879363,22
3,981,22044,3575879341,3575879364,23
3,981,22045,3575879341,3575879364,23
3,981,22046,3575879341,3575879368,27
3,981,22047,3575879341,3575879368,27
3,981,22048,3575879341,3575879369,28
3,981,22049,3575879341,3575879369,28
3,981,22050,3575879341,3575879371,30
3,981,22051,3575879341,3575879371,30
3,981,22052,3575879341,3575879372,31
3,981,22053,3575879341,3575879372,31
3,981,22054,3575879341,3575879374,33
3,981,22055,3575879341,3575879376,35
3,981,22056,3575879341,3575879376,35
3,981,22057,3575879341,3575879376,35
3,981,22058,3575879341,3575879377,36
3,981,22059,3575879341,3575879379,38
3,981,22060,3575879341,3575879380,39
3,981,22061,3575879341,3575879380,39
3,981,22062,3575879341,3575879381,40
3,981,22063,3575879341,3575879381,40
3,981,22064,3575879341,3575879381,40
3,981,22065,3575879341,3575879382,41
3,981,22066,3575879341,3575879384,43
3,981,22067,3575879341,3575879386,45
3,981,22068,3575879341,3575879387,46
3,981,22069,3575879341,3575879387,46
3,981,22070,3575879341,3575879388,47
3,982,22071,3575879402,3575879402,0
3,982,22072,3575879402,3575879402,0
3,982,22073,3575879402,3575879402,0
3,982,22074,3575879402,3575879402,0
3,982,22075,3575879402,3575879402,0
3,982,22076,3575879402,3575879402,0
3,982,22077,3575879402,3575879402,0
3,982,22078,3575879402,3575879402,0
3,982,22079,3575879402,3575879402,0
3,982,22080,3575879402,3575879402,0
3,982,22081,3575879402,3575879402,0
3,982,22082,3575879402,3575879402,0
3,982,22083,3575879402,3575879402,0
3,982,22084,3575879402,3575879402,0
3,982,22085,3575879402,3575879402,0
3,982,22086,3575879402,3575879402,0
3,982,22087,3575879402,3575879403,1
3,982,22088,3575879402,3575879403,1
3,982,22089,3575879402,3575879404,2
3,982,22090,3575879402,3575879404,2
3,982,22091,3575879402,3575879406,4
3,982,22092,3575879402,3575879406,4
3,982,22093,3575879402,3575879409,7
3,982,22094,3575879402,3575879411,9
3,982,22095,3575879402,3575879418,16
3,982,22096,3575879402,3575879418,16
3,982,22097,3575879402,3575879419,17
3,982,22098,3575879402,3575879419,17
3,982,22099,3575879402,3575879419,17
3,982,22100,3575879402,3575879421,19
3,982,22101,3575879402,3575879421,19
3,982,22102,3575879402,3575879422,20
3,982,22103,3575879402,3575879423,21
3,982,22104,3575879402,3575879424,22
3,982,22105,3575879402,3575879424,22
3,982,22106,3575879402,3575879425,23
3,982,22107,3575879402,3575879427,25
3,982,22108,3575879402,3575879428,26
3,982,22109,3575879402,3575879428,26
3,982,22110,3575879402,3575879429,27
3,982,22111,3575879402,3575879430,28
3,982,22112,3575879402,3575879430,28
3,982,22113,3575879402,3575879431,29
3,982,22114,3575879402,3575879431,29
3,982,22115,3575879402,3575879432,30
3,982,22116,3575879402,3575879432,30
3,982,22117,3575879402,3575879432,30
3,982,22118,3575879402,3575879435,33
3,982,22119,3575879402,3575879435,33
3,982,22120,3575879402,3575879436,34
3,982,22121,3575879402,3575879436,34
3,982,22122,3575879402,3575879437,35
3,982,22123,3575879402,3575879437,35
3,982,22124,3575879402,3575879437,35
3,982,22125,3575879402,3575879437,35
3,982,22126,3575879402,3575879438,36
3,982,22127,3575879402,3575879438,36
3,982,22128,3575879402,3575879439,37
3,982,22129,3575879402,3575879441,39
3,982,22130,3575879402,3575879441,39
3,982,22131,3575879402,3575879442,40
3,982,22132,3575879402,3575879444,42
3,982,22133,3575879402,3575879444,42
3,982,22134,3575879402,3575879445,43
3,982,22135,3575879402,3575879445,43
3,982,22136,3575879402,3575879447,45
3,982,22137,3575879402,3575879448,46
3,982,22138,3575879402,3575879448,46
3,982,22139,3575879402,3575879449,47
3,982,22140,3575879402,3575879450,48
3,982,22141,3575879402,3575879450,48
3,982,22142,3575879402,3575879452,50
3,983,22143,3575879465,3575879465,0
3,983,22144,3575879465,3575879465,0
3,983,22145,3575879465,3575879465,0
3,983,22146,3575879465,3575879466,1
3,983,22147,3575879465,3575879466,1
3,983,22148,3575879465,3575879466,1
3,983,22149,3575879465,3575879466,1
3,983,22150,3575879465,3575879466,1
3,983,22151,3575879465,3575879466,1
3,983,22152,3575879465,3575879466,1
3,983,22153,3575879465,3575879466,1
3,983,22154,3575879465,3575879466,1
3,983,22155,3575879465,3575879466,1
3,983,22156,3575879465,3575879466,1
3,983,22157,3575879465,3575879466,1
3,983,22158,3575879465,3575879467,2
3,983,22159,3575879465,3575879467,2
3,983,22160,3575879465,3575879468,3
3,983,22161,3575879465,3575879469,4
3,983,22162,3575879465,3575879470,5
3,983,22163,3575879465,3575879470,5
3,983,22164,3575879465,3575879473,8
3,983,22165,3575879465,3575879476,11
3,983,22166,3575879465,3575879480,15
3,983,22167,3575879465,3575879481,16
3,983,22168,3575879465,3575879481,16
3,983,22169,3575879465,3575879481,16
3,983,22170,3575879465,3575879482,17
3,983,22171,3575879465,3575879483,18
3,983,22172,3575879465,3575879483,18
3,983,22173,3575879465,3575879484,19
3,983,22174,3575879465,3575879485,20
3,983,22175,3575879465,3575879485,20
3,983,22176,3575879465,3575879485,20
3,983,22177,3575879465,3575879486,21
3,983,22178,3575879465,3575879486,21
3,983,22179,3575879465,3575879488,23
3,983,22180,3575879465,3575879488,23
3,983,22181,3575879465,3575879490,25
3,983,22182,3575879465,3575879490,25
3,983,22183,3575879465,3575879496,31
3,983,22184,3575879465,3575879496,31
3,983,22185,3575879465,3575879497,32
3,983,22186,3575879465,3575879500,35
3,983,22187,3575879465,3575879500,35
3,983,22188,3575879465,3575879501,36
3,983,22189,3575879465,3575879503,38
3,983,22190,3575879465,3575879503,38
3,983,22191,3575879465,3575879503,38
3,983,22192,3575879465,3575879505,40
3,983,22193,3575879465,3575879505,40
3,983,22194,3575879465,3575879506,41
3,983,22195,3575879465,3575879507,42
3,983,22196,3575879465,3575879511,46
3,983,22197,3575879465,3575879512,47
3,983,22198,3575879465,3575879513,48
3,983,22199,3575879465,3575879514,49
3,984,22200,3575879526,3575879526,0
3,984,22201,3575879526,3575879526,0
3,984,22202,3575879526,3575879526,0
3,984,22203,3575879526,3575879526,0
3,984,22204,3575879526,3575879526,0
3,984,22205,3575879526,3575879526,0
3,984,22206,3575879526,3575879526,0
3,984,22207,3575879526,3575879526,0
3,984,22208,3575879526,3575879527,1
3,984,22209,3575879526,3575879527,1
3,984,22210,3575879526,3575879527,1
3,984,22211,3575879526,3575879527,1
3,984,22212,3575879526,3575879529,3
3,984,22213,3575879526,3575879530,4
3,984,22214,3575879526,3575879532,6
3,984,22215,3575879526,3575879533,7
3,984,22216,3575879526,3575879534,8
3,984,22217,3575879526,3575879535,9
3,984,22218,3575879526,3575879535,9
3,984,22219,3575879526,3575879536,10
3,984,22220,3575879526,3575879536,10
3,984,22221,3575879526,3575879540,14
3,984,22222,3575879526,3575879540,14
3,984,22223,3575879526,3575879542,16
3,984,22224,3575879526,3575879542,16
3,984,22225,3575879526,3575879544,18
3,984,22226,3575879526,3575879546,20
3,984,22227,3575879526,3575879548,22
3,984,22228,3575879526,3575879550,24
3,984,22229,3575879526,3575879551,25
3,984,22230,3575879526,3575879552,26
3,984,22231,3575879526,3575879553,27
3,984,22232,3575879526,3575879554,28
3,984,22233,3575879526,3575879557,31
3,984,22234,3575879526,3575879558,32
3,984,22235,3575879526,3575879560,34
3,984,22236,3575879526,3575879563,37
3,984,22237,3575879526,3575879563,37
3,984,22238,3575879526,3575879564,38
3,984,22239,3575879526,3575879567,41
3,984,22240,3575879526,3575879568,42
3,984,22241,3575879526,3575879568,42
3,984,22242,3575879526,3575879569,43
3,984,22243,3575879526,3575879570,44
3,984,22244,3575879526,3575879570,44
3,984,22245,3575879526,3575879571,45
3,984,22246,3575879526,3575879571,45
3,984,22247,3575879526,3575879573,47
3,984,22248,3575879526,3575879575,49
3,984,22249,3575879526,3575879576,50
3,985,22250,3575879588,3575879588,0
3,985,22251,3575879588,3575879588,0
3,985,22252,3575879588,3575879588,0
3,985,22253,3575879588,3575879588,0
3,985,22254,3575879588,3575879588,0
3,985,22255,3575879588,3575879588,0
3,985,22256,3575879588,3575879588,0
3,985,22257,3575879588,3575879588,0
3,985,22258,3575879588,3575879588,0
3,985,22259,3575879588,3575879588,0
3,985,22260,3575879588,3575879588,0
3,985,22261,3575879588,3575879588,0
3,985,22262,3575879588,3575879591,3
3,985,22263,3575879588,3575879593,5
3,985,22264,3575879588,3575879593,5
3,985,22265,3575879588,3575879594,6
3,985,22266,3575879588,3575879595,7
3,985,22267,3575879588,3575879595,7
3,985,22268,3575879588,3575879595,7
3,985,22269,3575879588,3575879595,7
3,985,22270,3575879588,3575879595,7
3,985,22271,3575879588,3575879596,8
3,985,22272,3575879588,3575879596,8
3,985,22273,3575879588,3575879597,9
3,985,22274,3575879588,3575879597,9
3,985,22275,3575879588,3575879600,12
3,985,22276,3575879588,3575879601,13
3,985,22277,3575879588,3575879601,13
3,985,22278,3575879588,3575879602,14
3,985,22279,3575879588,3575879603,15
3,985,22280,3575879588,3575879605,17
3,985,22281,3575879588,3575879606,18
3,985,22282,3575879588,3575879608,20
3,985,22283,3575879588,3575879611,23
3,985,22284,3575879588,3575879617,29
3,985,22285,3575879588,3575879618,30
3,985,22286,3575879588,3575879618,30
3,985,22287,3575879588,3575879619,31
3,985,22288,3575879588,3575879619,31
3,985,22289,3575879588,3575879619,31
3,985,22290,3575879588,3575879620,32
3,985,22291,3575879588,3575879621,33
3,985,22292,3575879588,3575879622,34
3,985,22293,3575879588,3575879623,35
3,985,22294,3575879588,3575879623,35
3,985,22295,3575879588,3575879625,37
3,985,22296,3575879588,3575879626,38
3,985,22297,3575879588,3575879627,39
3,985,22298,3575879588,3575879627,39
3,985,22299,3575879588,3575879628,40
3,985,22300,3575879588,3575879628,40
3,985,22301,3575879588,3575879630,42
3,985,22302,3575879588,3575879630,42
3,985,22303,3575879588,3575879630,42
3,985,22304,3575879588,3575879630,42
3,985,22305,3575879588,3575879631,43
3,985,22306,3575879588,3575879634,46
3,985,22307,3575879588,3575879634,46
3,985,22308,3575879588,3575879635,47
3,985,22309,3575879588,3575879635,47
3,985,22310,3575879588,3575879636,48
3,985,22311,3575879588,3575879636,48
3,985,22312,3575879588,3575879637,49
3,985,22313,3575879588,3575879637,49
3,985,22314,3575879588,3575879637,49
3,985,22315,3575879588,3575879638,50
3,986,22316,3575879649,3575879649,0
3,986,22317,3575879649,3575879649,0
3,986,22318,3575879649,3575879649,0
3,986,22319,3575879649,3575879649,0
3,986,22320,3575879649,3575879649,0
3,986,22321,3575879649,3575879649,0
3,986,22322,3575879649,3575879649,0
3,986,22323,3575879649,3575879649,0
3,986,22324,3575879649,3575879649,0
3,986,22325,3575879649,3575879649,0
3,986,22326,3575879649,3575879649,0
3,986,22327,3575879649,3575879649,0
3,986,22328,3575879649,3575879649,0
3,986,22329,3575879649,3575879650,1
3,986,22330,3575879649,3575879652,3
3,986,22331,3575879649,3575879652,3
3,986,22332,3575879649,3575879652,3
3,986,22333,3575879649,3575879654,5
3,986,22334,3575879649,3575879655,6
3,986,22335,3575879649,3575879656,7
3,986,22336,3575879649,3575879658,9
3,986,22337,3575879649,3575879658,9
3,986,22338,3575879649,3575879659,10
3,986,22339,3575879649,3575879660,11
3,986,22340,3575879649,3575879661,12
3,986,22341,3575879649,3575879662,13
3,986,22342,3575879649,3575879662,13
3,986,22343,3575879649,3575879664,15
3,986,22344,3575879649,3575879666,17
3,986,22345,3575879649,3575879666,17
3,986,22346,3575879649,3575879666,17
3,986,22347,3575879649,3575879667,18
3,986,22348,3575879649,3575879667,18
3,986,22349,3575879649,3575879668,19
3,986,22350,3575879649,3575879669,20
3,986,22351,3575879649,3575879674,25
3,986,22352,3575879649,3575879676,27
3,986,22353,3575879649,3575879680,31
3,986,22354,3575879649,3575879681,32
3,986,22355,3575879649,3575879681,32
3,986,22356,3575879649,3575879681,32
3,986,22357,3575879649,3575879682,33
3,986,22358,3575879649,3575879683,34
3,986,22359,3575879649,3575879683,34
3,986,22360,3575879649,3575879685,36
3,986,22361,3575879649,3575879685,36
3,986,22362,3575879649,3575879685,36
3,986,22363,3575879649,3575879686,37
3,986,22364,3575879649,3575879686,37
3,986,22365,3575879649,3575879686,37
3,986,22366,3575879649,3575879687,38
3,986,22367,3575879649,3575879689,40
3,986,22368,3575879649,3575879690,41
3,986,22369,3575879649,3575879691,42
3,986,22370,3575879649,3575879695,46
3,986,22371,3575879649,3575879696,47
3,986,22372,3575879649,3575879696,47
3,986,22373,3575879649,3575879697,48
3,987,22374,3575879711,3575879711,0
3,987,22375,3575879711,3575879711,0
3,987,22376,3575879711,3575879711,0
3,987,22377,3575879711,3575879711,0
3,987,22378,3575879711,3575879711,0
3,987,22379,3575879711,3575879711,0
3,987,22380,3575879711,3575879711,0
3,987,22381,3575879711,3575879711,0
3,987,22382,3575879711,3575879711,0
3,987,22383,3575879711,3575879712,1
3,987,22384,3575879711,3575879712,1
3,987,22385,3575879711,3575879712,1
3,987,22386,3575879711,3575879713,2
3,987,22387,3575879711,3575879713,2
3,987,22388,3575879711,3575879717,6
3,987,22389,3575879711,3575879718,7
3,987,22390,3575879711,3575879718,7
3,987,22391,3575879711,3575879719,8
3,987,22392,3575879711,3575879721,10
3,987,22393,3575879711,3575879722,11
3,987,22394,3575879711,3575879723,12
3,987,22395,3575879711,3575879723,12
3,987,22396,3575879711,3575879724,13
3,987,22397,3575879711,3575879726,15
3,987,22398,3575879711,3575879727,16
3,987,22399,3575879711,3575879727,16
3,987,22400,3575879711,3575879727,16
3,987,22401,3575879711,3575879729,18
3,987,22402,3575879711,3575879731,20
3,987,22403,3575879711,3575879732,21
3,987,22404,3575879711,3575879733,22
3,987,22405,3575879711,3575879735,24
3,987,22406,3575879711,3575879735,24
3,987,22407,3575879711,3575879735,24
3,987,22408,3575879711,3575879736,25
3,987,22409,3575879711,3575879737,26
3,987,22410,3575879711,3575879740,29
3,987,22411,3575879711,3575879740,29
3,987,22412,3575879711,3575879743,32
3,987,22413,3575879711,3575879743,32
3,987,22414,3575879711,3575879743,32
3,987,22415,3575879711,3575879746,35
3,987,22416,3575879711,3575879747,36
3,987,22417,3575879711,3575879750,39
3,987,22418,3575879711,3575879752,41
3,987,22419,3575879711,3575879752,41
3,987,22420,3575879711,3575879755,44
3,987,22421,3575879711,3575879755,44
3,987,22422,3575879711,3575879759,48
3,987,22423,3575879711,3575879760,49
3,988,22424,3575879776,3575879776,0
3,988,22425,3575879776,3575879776,0
3,988,22426,3575879776,3575879776,0
3,988,22427,3575879776,3575879776,0
3,988,22428,3575879776,3575879776,0
3,988,22429,3575879776,3575879776,0
3,988,22430,3575879776,3575879776,0
3,988,22431,3575879776,3575879776,0
3,988,22432,3575879776,3575879776,0
3,988,22433,3575879776,3575879776,0
3,988,22434,3575879776,3575879776,0
3,988,22435,3575879776,3575879776,0
3,988,22436,3575879776,3575879776,0
3,988,22437,3575879776,3575879776,0
3,988,22438,3575879776,3575879777,1
3,988,22439,3575879776,3575879778,2
3,988,22440,3575879776,3575879778,2
3,988,22441,3575879776,3575879780,4
3,988,22442,3575879776,3575879780,4
3,988,22443,3575879776,3575879781,5
3,988,22444,3575879776,3575879781,5
3,988,22445,3575879776,3575879784,8
3,988,22446,3575879776,3575879786,10
3,988,22447,3575879776,3575879787,11
3,988,22448,3575879776,3575879787,11
3,988,22449,3575879776,3575879787,11
3,988,22450,3575879776,3575879791,15
3,988,22451,3575879776,3575879793,17
3,988,22452,3575879776,3575879794,18
3,988,22453,3575879776,3575879795,19
3,988,22454,3575879776,3575879795,19
3,988,22455,3575879776,3575879795,19
3,988,22456,3575879776,3575879795,19
3,988,22457,3575879776,3575879795,19
3,988,22458,3575879776,3575879796,20
3,988,22459,3575879776,3575879796,20
3,988,22460,3575879776,3575879796,20
3,988,22461,3575879776,3575879797,21
3,988,22462,3575879776,3575879798,22
3,988,22463,3575879776,3575879800,24
3,988,22464,3575879776,3575879801,25
3,988,22465,3575879776,3575879801,25
3,988,22466,3575879776,3575879802,26
3,988,22467,3575879776,3575879803,27
3,988,22468,3575879776,3575879803,27
3,988,22469,3575879776,3575879803,27
3,988,22470,3575879776,3575879803,27
3,988,22471,3575879776,3575879805,29
3,988,22472,3575879776,3575879807,31
3,988,22473,3575879776,3575879810,34
3,988,22474,3575879776,3575879817,41
3,988,22475,3575879776,3575879818,42
3,988,22476,3575879776,3575879818,42
3,988,22477,3575879776,3575879818,42
3,988,22478,3575879776,3575879819,43
3,988,22479,3575879776,3575879819,43
3,988,22480,3575879776,3575879820,44
3,988,22481,3575879776,3575879821,45
3,988,22482,3575879776,3575879822,46
3,988,22483,3575879776,3575879822,46
3,988,22484,3575879776,3575879822,46
3,988,22485,3575879776,3575879825,49
3,988,22486,3575879776,3575879825,49
3,988,22487,3575879776,3575879826,50
3,989,22488,3575879838,3575879838,0
3,989,22489,3575879838,3575879838,0
3,989,22490,3575879838,3575879838,0
3,989,22491,3575879838,3575879838,0
3,989,22492,3575879838,3575879838,0
3,989,22493,3575879838,3575879838,0
3,989,22494,3575879838,3575879838,0
3,989,22495,3575879838,3575879838,0
3,989,22496,3575879838,3575879838,0
3,989,22497,3575879838,3575879838,0
3,989,22498,3575879838,3575879838,0
3,989,22499,3575879838,3575879838,0
3,989,22500,3575879838,3575879838,0
3,989,22501,3575879838,3575879838,0
3,989,22502,3575879838,3575879838,0
3,989,22503,3575879838,3575879838,0
3,989,22504,3575879838,3575879838,0
3,989,22505,3575879838,3575879838,0
3,989,22506,3575879838,3575879840,2
3,989,22507,3575879838,3575879840,2
3,989,22508,3575879838,3575879841,3
3,989,22509,3575879838,3575879844,6
3,989,22510,3575879838,3575879844,6
3,989,22511,3575879838,3575879844,6
3,989,22512,3575879838,3575879846,8
3,989,22513,3575879838,3575879847,9
3,989,22514,3575879838,3575879847,9
3,989,22515,3575879838,3575879849,11
3,989,22516,3575879838,3575879850,12
3,989,22517,3575879838,3575879851,13
3,989,22518,3575879838,3575879852,14
3,989,22519,3575879838,3575879852,14
3,989,22520,3575879838,3575879852,14
3,989,22521,3575879838,3575879852,14
3,989,22522,3575879838,3575879855,17
3,989,22523,3575879838,3575879856,18
3,989,22524,3575879838,3575879859,21
3,989,22525,3575879838,3575879860,22
3,989,22526,3575879838,3575879860,22
3,989,22527,3575879838,3575879861,23
3,989,22528,3575879838,3575879861,23
3,989,22529,3575879838,3575879862,24
3,989,22530,3575879838,3575879862,24
3,989,22531,3575879838,3575879864,26
3,989,22532,3575879838,3575879864,26
3,989,22533,3575879838,3575879865,27
3,989,22534,3575879838,3575879866,28
3,989,22535,3575879838,3575879866,28
3,989,22536,3575879838,3575879867,29
3,989,22537,3575879838,3575879868,30
3,989,22538,3575879838,3575879869,31
3,989,22539,3575879838,3575879870,32
3,989,22540,3575879838,3575879873,35
3,989,22541,3575879838,3575879876,38
3,989,22542,3575879838,3575879880,42
3,989,22543,3575879838,3575879881,43
3,989,22544,3575879838,3575879881,43
3,989,22545,3575879838,3575879881,43
3,989,22546,3575879838,3575879882,44
3,989,22547,3575879838,3575879882,44
3,989,22548,3575879838,3575879883,45
3,989,22549,3575879838,3575879884,46
3,989,22550,3575879838,3575879885,47
3,989,22551,3575879838,3575879885,47
3,989,22552,3575879838,3575879885,47
3,989,22553,3575879838,3575879886,48
3,989,22554,3575879838,3575879886,48
3,989,22555,3575879838,3575879886,48
3,989,22556,3575879838,3575879887,49
3,990,22557,3575879900,3575879900,0
3,990,22558,3575879900,3575879900,0
3,990,22559,3575879900,3575879900,0
3,990,22560,3575879900,3575879900,0
3,990,22561,3575879900,3575879900,0
3,990,22562,3575879900,3575879900,0
3,990,22563,3575879900,3575879900,0
3,990,22564,3575879900,3575879900,0
3,990,22565,3575879900,3575879900,0
3,990,22566,3575879900,3575879901,1
3,990,22567,3575879900,3575879902,2
3,990,22568,3575879900,3575879902,2
3,990,22569,3575879900,3575879902,2
3,990,22570,3575879900,3575879903,3
3,990,22571,3575879900,3575879905,5
3,990,22572,3575879900,3575879906,6
3,990,22573,3575879900,3575879906,6
3,990,22574,3575879900,3575879907,7
3,990,22575,3575879900,3575879907,7
3,990,22576,3575879900,3575879912,12
3,990,22577,3575879900,3575879913,13
3,990,22578,3575879900,3575879913,13
3,990,22579,3575879900,3575879917,17
3,990,22580,3575879900,3575879918,18
3,990,22581,3575879900,3575879918,18
3,990,22582,3575879900,3575879919,19
3,990,22583,3575879900,3575879921,21
3,990,22584,3575879900,3575879922,22
3,990,22585,3575879900,3575879922,22
3,990,22586,3575879900,3575879923,23
3,990,22587,3575879900,3575879924,24
3,990,22588,3575879900,3575879927,27
3,990,22589,3575879900,3575879927,27
3,990,22590,3575879900,3575879927,27
3,990,22591,3575879900,3575879927,27
3,990,22592,3575879900,3575879928,28
3,990,22593,3575879900,3575879930,30
3,990,22594,3575879900,3575879931,31
3,990,22595,3575879900,3575879933,33
3,990,22596,3575879900,3575879935,35
3,990,22597,3575879900,3575879935,35
3,990,22598,3575879900,3575879935,35
3,990,22599,3575879900,3575879937,37
3,990,22600,3575879900,3575879937,37
3,990,22601,3575879900,3575879940,40
3,990,22602,3575879900,3575879941,41
3,990,22603,3575879900,3575879942,42
3,990,22604,3575879900,3575879943,43
3,990,22605,3575879900,3575879944,44
3,990,22606,3575879900,3575879946,46
3,990,22607,3575879900,3575879948,48
3,991,22608,3575879962,3575879962,0
3,991,22609,3575879962,3575879962,0
3,991,22610,3575879962,3575879962,0
3,991,22611,3575879962,3575879962,0
3,991,22612,3575879962,3575879962,0
3,991,22613,3575879962,3575879962,0
3,991,22614,3575879962,3575879962,0
3,991,22615,3575879962,3575879962,0
3,991,22616,3575879962,3575879964,2
3,991,22617,3575879962,3575879964,2
3,991,22618,3575879962,3575879968,6
3,991,22619,3575879962,3575879968,6
3,991,22620,3575879962,3575879968,6
3,991,22621,3575879962,3575879969,7
3,991,22622,3575879962,3575879970,8
3,991,22623,3575879962,3575879971,9
3,991,22624,3575879962,3575879971,9
3,991,22625,3575879962,3575879972,10
3,991,22626,3575879962,3575879973,11
3,991,22627,3575879962,3575879975,13
3,991,22628,3575879962,3575879975,13
3,991,22629,3575879962,3575879977,15
3,991,22630,3575879962,3575879978,16
3,991,22631,3575879962,3575879978,16
3,991,22632,3575879962,3575879980,18
3,991,22633,3575879962,3575879981,19
3,991,22634,3575879962,3575879981,19
3,991,22635,3575879962,3575879981,19
3,991,22636,3575879962,3575879984,22
3,991,22637,3575879962,3575879985,23
3,991,22638,3575879962,3575879986,24
3,991,22639,3575879962,3575879986,24
3,991,22640,3575879962,3575879987,25
3,991,22641,3575879962,3575879991,29
3,991,22642,3575879962,3575879993,31
3,991,22643,3575879962,3575879993,31
3,991,22644,3575879962,3575879995,33
3,991,22645,3575879962,3575879995,33
3,991,22646,3575879962,3575879995,33
3,991,22647,3575879962,3575879995,33
3,991,22648,3575879962,3575879996,34
3,991,22649,3575879962,3575879996,34
3,991,22650,3575879962,3575879996,34
3,991,22651,3575879962,3575879998,36
3,991,22652,3575879962,3575879998,36
3,991,22653,3575879962,3575880000,38
3,991,22654,3575879962,3575880000,38
3,991,22655,3575879962,3575880001,39
3,991,22656,3575879962,3575880002,40
3,991,22657,3575879962,3575880003,41
3,991,22658,3575879962,3575880003,41
3,991,22659,3575879962,3575880003,41
3,991,22660,3575879962,3575880003,41
3,991,22661,3575879962,3575880004,42
3,991,22662,3575879962,3575880006,44
3,991,22663,3575879962,3575880008,46
3,991,22664,3575879962,3575880012,50
3,992,22665,3575880028,3575880028,0
3,992,22666,3575880028,3575880028,0
3,992,22667,3575880028,3575880028,0
3,992,22668,3575880028,3575880028,0
3,992,22669,3575880028,3575880028,0
3,992,22670,3575880028,3575880028,0
3,992,22671,3575880028,3575880028,0
3,992,22672,3575880028,3575880028,0
3,992,22673,3575880028,3575880028,0
3,992,22674,3575880028,3575880029,1
3,992,22675,3575880028,3575880029,1
3,992,22676,3575880028,3575880029,1
3,992,22677,3575880028,3575880029,1
3,992,22678,3575880028,3575880029,1
3,992,22679,3575880028,3575880029,1
3,992,22680,3575880028,3575880029,1
3,992,22681,3575880028,3575880029,1
3,992,22682,3575880028,3575880030,2
3,992,22683,3575880028,3575880030,2
3,992,22684,3575880028,3575880031,3
3,992,22685,3575880028,3575880032,4
3,992,22686,3575880028,3575880034,6
3,992,22687,3575880028,3575880034,6
3,992,22688,3575880028,3575880034,6
3,992,22689,3575880028,3575880034,6
3,992,22690,3575880028,3575880037,9
3,992,22691,3575880028,3575880037,9
3,992,22692,3575880028,3575880037,9
3,992,22693,3575880028,3575880037,9
3,992,22694,3575880028,3575880037,9
3,992,22695,3575880028,3575880038,10
3,992,22696,3575880028,3575880038,10
3,992,22697,3575880028,3575880041,13
3,992,22698,3575880028,3575880041,13
3,992,22699,3575880028,3575880041,13
3,992,22700,3575880028,3575880044,16
3,992,22701,3575880028,3575880044,16
3,992,22702,3575880028,3575880045,17
3,992,22703,3575880028,3575880046,18
3,992,22704,3575880028,3575880046,18
3,992,22705,3575880028,3575880047,19
3,992,22706,3575880028,3575880049,21
3,992,22707,3575880028,3575880049,21
3,992,22708,3575880028,3575880051,23
3,992,22709,3575880028,3575880052,24
3,992,22710,3575880028,3575880052,24
3,992,22711,3575880028,3575880053,25
3,992,22712,3575880028,3575880053,25
3,992,22713,3575880028,3575880055,27
3,992,22714,3575880028,3575880055,27
3,992,22715,3575880028,3575880056,28
3,992,22716,3575880028,3575880059,31
3,992,22717,3575880028,3575880059,31
3,992,22718,3575880028,3575880060,32
3,992,22719,3575880028,3575880062,34
3,992,22720,3575880028,3575880062,34
3,992,22721,3575880028,3575880062,34
3,992,22722,3575880028,3575880063,35
3,992,22723,3575880028,3575880064,36
3,992,22724,3575880028,3575880064,36
3,992,22725,3575880028,3575880066,38
3,992,22726,3575880028,3575880066,38
3,992,22727,3575880028,3575880066,38
3,992,22728,3575880028,3575880067,39
3,992,22729,3575880028,3575880068,40
3,992,22730,3575880028,3575880069,41
3,992,22731,3575880028,3575880069,41
3,992,22732,3575880028,3575880074,46
3,992,22733,3575880028,3575880075,47
3,993,22734,3575880091,3575880092,1
3,993,22735,3575880091,3575880092,1
3,993,22736,3575880091,3575880092,1
3,993,22737,3575880091,3575880092,1
3,993,22738,3575880091,3575880092,1
3,993,22739,3575880091,3575880092,1
3,993,22740,3575880091,3575880092,1
3,993,22741,3575880091,3575880092,1
3,993,22742,3575880091,3575880092,1
3,993,22743,3575880091,3575880092,1
3,993,22744,3575880091,3575880092,1
3,993,22745,3575880091,3575880092,1
3,993,22746,3575880091,3575880092,1
3,993,22747,3575880091,3575880092,1
3,993,22748,3575880091,3575880092,1
3,993,22749,3575880091,3575880092,1
3,993,22750,3575880091,3575880092,1
3,993,22751,3575880091,3575880092,1
3,993,22752,3575880091,3575880095,4
3,993,22753,3575880091,3575880096,5
3,993,22754,3575880091,3575880096,5
3,993,22755,3575880091,3575880096,5
3,993,22756,3575880091,3575880097,6
3,993,22757,3575880091,3575880097,6
3,993,22758,3575880091,3575880100,9
3,993,22759,3575880091,3575880101,10
3,993,22760,3575880091,3575880102,11
3,993,22761,3575880091,3575880102,11
3,993,22762,3575880091,3575880103,12
3,993,22763,3575880091,3575880103,12
3,993,22764,3575880091,3575880105,14
3,993,22765,3575880091,3575880105,14
3,993,22766,3575880091,3575880107,16
3,993,22767,3575880091,3575880107,16
3,993,22768,3575880091,3575880107,16
3,993,22769,3575880091,3575880108,17
3,993,22770,3575880091,3575880111,20
3,993,22771,3575880091,3575880112,21
3,993,22772,3575880091,3575880113,22
3,993,22773,3575880091,3575880113,22
3,993,22774,3575880091,3575880117,26
3,993,22775,3575880091,3575880118,27
3,993,22776,3575880091,3575880118,27
3,993,22777,3575880091,3575880119,28
3,993,22778,3575880091,3575880121,30
3,993,22779,3575880091,3575880122,31
3,993,22780,3575880091,3575880123,32
3,993,22781,3575880091,3575880124,33
3,993,22782,3575880091,3575880125,34
3,993,22783,3575880091,3575880126,35
3,993,22784,3575880091,3575880127,36
3,993,22785,3575880091,3575880127,36
3,993,22786,3575880091,3575880127,36
3,993,22787,3575880091,3575880129,38
3,993,22788,3575880091,3575880131,40
3,993,22789,3575880091,3575880131,40
3,993,22790,3575880091,3575880134,43
3,993,22791,3575880091,3575880135,44
3,993,22792,3575880091,3575880135,44
3,993,22793,3575880091,3575880135,44
3,993,22794,3575880091,3575880137,46
3,993,22795,3575880091,3575880137,46
3,993,22796,3575880091,3575880140,49
3,994,22797,3575880155,3575880155,0
3,994,22798,3575880155,3575880155,0
3,994,22799,3575880155,3575880155,0
3,994,22800,3575880155,3575880155,0
3,994,22801,3575880155,3575880155,0
3,994,22802,3575880155,3575880155,0
3,994,22803,3575880155,3575880155,0
3,994,22804,3575880155,3575880155,0
3,994,22805,3575880155,3575880155,0
3,994,22806,3575880155,3575880155,0
3,994,22807,3575880155,3575880155,0
3,994,22808,3575880155,3575880156,1
3,994,22809,3575880155,3575880159,4
3,994,22810,3575880155,3575880161,6
3,994,22811,3575880155,3575880163,8
3,994,22812,3575880155,3575880164,9
3,994,22813,3575880155,3575880165,10
3,994,22814,3575880155,3575880168,13
3,994,22815,3575880155,3575880168,13
3,994,22816,3575880155,3575880169,14
3,994,22817,3575880155,3575880169,14
3,994,22818,3575880155,3575880171,16
3,994,22819,3575880155,3575880171,16
3,994,22820,3575880155,3575880171,16
3,994,22821,3575880155,3575880172,17
3,994,22822,3575880155,3575880173,18
3,994,22823,3575880155,3575880175,20
3,994,22824,3575880155,3575880177,22
3,994,22825,3575880155,3575880178,23
3,994,22826,3575880155,3575880178,23
3,994,22827,3575880155,3575880179,24
3,994,22828,3575880155,3575880180,25
3,994,22829,3575880155,3575880180,25
3,994,22830,3575880155,3575880181,26
3,994,22831,3575880155,3575880181,26
3,994,22832,3575880155,3575880181,26
3,994,22833,3575880155,3575880184,29
3,994,22834,3575880155,3575880186,31
3,994,22835,3575880155,3575880187,32
3,994,22836,3575880155,3575880187,32
3,994,22837,3575880155,3575880188,33
3,994,22838,3575880155,3575880190,35
3,994,22839,3575880155,3575880193,38
3,994,22840,3575880155,3575880193,38
3,994,22841,3575880155,3575880195,40
3,994,22842,3575880155,3575880195,40
3,994,22843,3575880155,3575880195,40
3,994,22844,3575880155,3575880195,40
3,994,22845,3575880155,3575880195,40
3,994,22846,3575880155,3575880196,41
3,994,22847,3575880155,3575880196,41
3,994,22848,3575880155,3575880197,42
3,994,22849,3575880155,3575880199,44
3,994,22850,3575880155,3575880200,45
3,994,22851,3575880155,3575880201,46
3,994,22852,3575880155,3575880201,46
3,994,22853,3575880155,3575880203,48
3,994,22854,3575880155,3575880203,48
3,994,22855,3575880155,3575880204,49
3,994,22856,3575880155,3575880204,49
3,994,22857,3575880155,3575880204,49
3,995,22858,3575880219,3575880219,0
3,995,22859,3575880219,3575880219,0
3,995,22860,3575880219,3575880219,0
3,995,22861,3575880219,3575880219,0
3,995,22862,3575880219,3575880219,0
3,995,22863,3575880219,3575880219,0
3,995,22864,3575880219,3575880219,0
3,995,22865,3575880219,3575880219,0
3,995,22866,3575880219,3575880219,0
3,995,22867,3575880219,3575880219,0
3,995,22868,3575880219,3575880221,2
3,995,22869,3575880219,3575880222,3
3,995,22870,3575880219,3575880222,3
3,995,22871,3575880219,3575880222,3
3,995,22872,3575880219,3575880223,4
3,995,22873,3575880219,3575880224,5
3,995,22874,3575880219,3575880225,6
3,995,22875,3575880219,3575880226,7
3,995,22876,3575880219,3575880227,8
3,995,22877,3575880219,3575880228,9
3,995,22878,3575880219,3575880228,9
3,995,22879,3575880219,3575880229,10
3,995,22880,3575880219,3575880230,11
3,995,22881,3575880219,3575880230,11
3,995,22882,3575880219,3575880230,11
3,995,22883,3575880219,3575880232,13
3,995,22884,3575880219,3575880233,14
3,995,22885,3575880219,3575880234,15
3,995,22886,3575880219,3575880235,16
3,995,22887,3575880219,3575880236,17
3,995,22888,3575880219,3575880237,18
3,995,22889,3575880219,3575880237,18
3,995,22890,3575880219,3575880237,18
3,995,22891,3575880219,3575880237,18
3,995,22892,3575880219,3575880238,19
3,995,22893,3575880219,3575880238,19
3,995,22894,3575880219,3575880238,19
3,995,22895,3575880219,3575880241,22
3,995,22896,3575880219,3575880241,22
3,995,22897,3575880219,3575880241,22
3,995,22898,3575880219,3575880244,25
3,995,22899,3575880219,3575880245,26
3,995,22900,3575880219,3575880246,27
3,995,22901,3575880219,3575880247,28
3,995,22902,3575880219,3575880247,28
3,995,22903,3575880219,3575880249,30
3,995,22904,3575880219,3575880249,30
3,995,22905,3575880219,3575880251,32
3,995,22906,3575880219,3575880252,33
3,995,22907,3575880219,3575880252,33
3,995,22908,3575880219,3575880253,34
3,995,22909,3575880219,3575880253,34
3,995,22910,3575880219,3575880255,36
3,995,22911,3575880219,3575880255,36
3,995,22912,3575880219,3575880259,40
3,995,22913,3575880219,3575880259,40
3,995,22914,3575880219,3575880260,41
3,995,22915,3575880219,3575880261,42
3,995,22916,3575880219,3575880261,42
3,995,22917,3575880219,3575880262,43
3,995,22918,3575880219,3575880262,43
3,995,22919,3575880219,3575880264,45
3,995,22920,3575880219,3575880264,45
3,995,22921,3575880219,3575880265,46
3,995,22922,3575880219,3575880266,47
3,995,22923,3575880219,3575880266,47
3,995,22924,3575880219,3575880267,48
3,995,22925,3575880219,3575880268,49
3,995,22926,3575880219,3575880269,50
3,996,22927,3575880279,3575880279,0
3,996,22928,3575880279,3575880279,0
3,996,22929,3575880279,3575880280,1
3,996,22930,3575880279,3575880281,2
3,996,22931,3575880279,3575880281,2
3,996,22932,3575880279,3575880281,2
3,996,22933,3575880279,3575880281,2
3,996,22934,3575880279,3575880282,3
3,996,22935,3575880279,3575880283,4
3,996,22936,3575880279,3575880285,6
3,996,22937,3575880279,3575880285,6
3,996,22938,3575880279,3575880286,7
3,996,22939,3575880279,3575880287,8
3,996,22940,3575880279,3575880287,8
3,996,22941,3575880279,3575880288,9
3,996,22942,3575880279,3575880288,9
3,996,22943,3575880279,3575880289,10
3,996,22944,3575880279,3575880291,12
3,996,22945,3575880279,3575880291,12
3,996,22946,3575880279,3575880295,16
3,996,22947,3575880279,3575880295,16
3,996,22948,3575880279,3575880297,18
3,996,22949,3575880279,3575880297,18
3,996,22950,3575880279,3575880299,20
3,996,22951,3575880279,3575880299,20
3,996,22952,3575880279,3575880300,21
3,996,22953,3575880279,3575880302,23
3,996,22954,3575880279,3575880302,23
3,996,22955,3575880279,3575880302,23
3,996,22956,3575880279,3575880302,23
3,996,22957,3575880279,3575880303,24
3,996,22958,3575880279,3575880305,26
3,996,22959,3575880279,3575880306,27
3,996,22960,3575880279,3575880307,28
3,996,22961,3575880279,3575880307,28
3,996,22962,3575880279,3575880308,29
3,996,22963,3575880279,3575880308,29
3,996,22964,3575880279,3575880311,32
3,996,22965,3575880279,3575880313,34
3,996,22966,3575880279,3575880313,34
3,996,22967,3575880279,3575880317,38
3,996,22968,3575880279,3575880318,39
3,996,22969,3575880279,3575880318,39
3,996,22970,3575880279,3575880320,41
3,996,22971,3575880279,3575880322,43
3,996,22972,3575880279,3575880322,43
3,996,22973,3575880279,3575880324,45
3,996,22974,3575880279,3575880324,45
3,996,22975,3575880279,3575880325,46
3,996,22976,3575880279,3575880327,48
3,996,22977,3575880279,3575880327,48
3,996,22978,3575880279,3575880327,48
3,996,22979,3575880279,3575880327,48
3,996,22980,3575880279,3575880329,50
3,997,22981,3575880348,3575880348,0
3,997,22982,3575880348,3575880348,0
3,997,22983,3575880348,3575880348,0
3,997,22984,3575880348,3575880348,0
3,997,22985,3575880348,3575880348,0
3,997,22986,3575880348,3575880348,0
3,997,22987,3575880348,3575880348,0
3,997,22988,3575880348,3575880348,0
3,997,22989,3575880348,3575880348,0
3,997,22990,3575880348,3575880348,0
3,997,22991,3575880348,3575880348,0
3,997,22992,3575880348,3575880348,0
3,997,22993,3575880348,3575880348,0
3,997,22994,3575880348,3575880348,0
3,997,22995,3575880348,3575880348,0
3,997,22996,3575880348,3575880351,3
3,997,22997,3575880348,3575880352,4
3,997,22998,3575880348,3575880352,4
3,997,22999,3575880348,3575880354,6
3,997,23000,3575880348,3575880355,7
3,997,23001,3575880348,3575880356,8
3,997,23002,3575880348,3575880359,11
3,997,23003,3575880348,3575880361,13
3,997,23004,3575880348,3575880363,15
3,997,23005,3575880348,3575880364,16
3,997,23006,3575880348,3575880364,16
3,997,23007,3575880348,3575880368,20
3,997,23008,3575880348,3575880368,20
3,997,23009,3575880348,3575880368,20
3,997,23010,3575880348,3575880370,22
3,997,23011,3575880348,3575880371,23
3,997,23012,3575880348,3575880371,23
3,997,23013,3575880348,3575880372,24
3,997,23014,3575880348,3575880373,25
3,997,23015,3575880348,3575880376,28
3,997,23016,3575880348,3575880376,28
3,997,23017,3575880348,3575880377,29
3,997,23018,3575880348,3575880379,31
3,997,23019,3575880348,3575880379,31
3,997,23020,3575880348,3575880380,32
3,997,23021,3575880348,3575880380,32
3,997,23022,3575880348,3575880381,33
3,997,23023,3575880348,3575880381,33
3,997,23024,3575880348,3575880381,33
3,997,23025,3575880348,3575880384,36
3,997,23026,3575880348,3575880386,38
3,997,23027,3575880348,3575880386,38
3,997,23028,3575880348,3575880387,39
3,997,23029,3575880348,3575880387,39
3,997,23030,3575880348,3575880391,43
3,997,23031,3575880348,3575880393,45
3,997,23032,3575880348,3575880393,45
3,997,23033,3575880348,3575880395,47
3,997,23034,3575880348,3575880395,47
3,997,23035,3575880348,3575880395,47
3,997,23036,3575880348,3575880395,47
3,997,23037,3575880348,3575880395,47
3,997,23038,3575880348,3575880396,48
3,997,23039,3575880348,3575880396,48
3,997,23040,3575880348,3575880398,50
3,998,23041,3575880415,3575880415,0
3,998,23042,3575880415,3575880415,0
3,998,23043,3575880415,3575880415,0
3,998,23044,3575880415,3575880415,0
3,998,23045,3575880415,3575880415,0
3,998,23046,3575880415,3575880415,0
3,998,23047,3575880415,3575880415,0
3,998,23048,3575880415,3575880415,0
3,998,23049,3575880415,3575880415,0
3,998,23050,3575880415,3575880415,0
3,998,23051,3575880415,3575880415,0
3,998,23052,3575880415,3575880415,0
3,998,23053,3575880415,3575880415,0
3,998,23054,3575880415,3575880415,0
3,998,23055,3575880415,3575880417,2
3,998,23056,3575880415,3575880418,3
3,998,23057,3575880415,3575880418,3
3,998,23058,3575880415,3575880419,4
3,998,23059,3575880415,3575880419,4
3,998,23060,3575880415,3575880420,5
3,998,23061,3575880415,3575880421,6
3,998,23062,3575880415,3575880422,7
3,998,23063,3575880415,3575880423,8
3,998,23064,3575880415,3575880423,8
3,998,23065,3575880415,3575880423,8
3,998,23066,3575880415,3575880424,9
3,998,23067,3575880415,3575880425,10
3,998,23068,3575880415,3575880426,11
3,998,23069,3575880415,3575880428,13
3,998,23070,3575880415,3575880428,13
3,998,23071,3575880415,3575880428,13
3,998,23072,3575880415,3575880429,14
3,998,23073,3575880415,3575880430,15
3,998,23074,3575880415,3575880431,16
3,998,23075,3575880415,3575880431,16
3,998,23076,3575880415,3575880433,18
3,998,23077,3575880415,3575880433,18
3,998,23078,3575880415,3575880434,19
3,998,23079,3575880415,3575880435,20
3,998,23080,3575880415,3575880435,20
3,998,23081,3575880415,3575880437,22
3,998,23082,3575880415,3575880437,22
3,998,23083,3575880415,3575880437,22
3,998,23084,3575880415,3575880437,22
3,998,23085,3575880415,3575880437,22
3,998,23086,3575880415,3575880437,22
3,998,23087,3575880415,3575880438,23
3,998,23088,3575880415,3575880441,26
3,998,23089,3575880415,3575880441,26
3,998,23090,3575880415,3575880441,26
3,998,23091,3575880415,3575880444,29
3,998,23092,3575880415,3575880444,29
3,998,23093,3575880415,3575880445,30
3,998,23094,3575880415,3575880446,31
3,998,23095,3575880415,3575880446,31
3,998,23096,3575880415,3575880446,31
3,998,23097,3575880415,3575880447,32
3,998,23098,3575880415,3575880449,34
3,998,23099,3575880415,3575880449,34
3,998,23100,3575880415,3575880451,36
3,998,23101,3575880415,3575880452,37
3,998,23102,3575880415,3575880453,38
3,998,23103,3575880415,3575880453,38
3,998,23104,3575880415,3575880453,38
3,998,23105,3575880415,3575880456,41
3,998,23106,3575880415,3575880459,44
3,998,23107,3575880415,3575880460,45
3,998,23108,3575880415,3575880461,46
3,998,23109,3575880415,3575880461,46
3,998,23110,3575880415,3575880461,46
3,998,23111,3575880415,3575880462,47
3,998,23112,3575880415,3575880463,48
3,998,23113,3575880415,3575880464,49
3,998,23114,3575880415,3575880464,49
3,999,23115,3575880477,3575880477,0
3,999,23116,3575880477,3575880477,0
3,999,23117,3575880477,3575880477,0
3,999,23118,3575880477,3575880477,0
3,999,23119,3575880477,3575880477,0
3,999,23120,3575880477,3575880477,0
3,999,23121,3575880477,3575880477,0
3,999,23122,3575880477,3575880477,0
3,999,23123,3575880477,3575880477,0
3,999,23124,3575880477,3575880477,0
3,999,23125,3575880477,3575880480,3
3,999,23126,3575880477,3575880481,4
3,999,23127,3575880477,3575880481,4
3,999,23128,3575880477,3575880482,5
3,999,23129,3575880477,3575880482,5
3,999,23130,3575880477,3575880483,6
3,999,23131,3575880477,3575880485,8
3,999,23132,3575880477,3575880485,8
3,999,23133,3575880477,3575880485,8
3,999,23134,3575880477,3575880486,9
3,999,23135,3575880477,3575880486,9
3,999,23136,3575880477,3575880487,10
3,999,23137,3575880477,3575880488,11
3,999,23138,3575880477,3575880488,11
3,999,23139,3575880477,3575880489,12
3,999,23140,3575880477,3575880490,13
3,999,23141,3575880477,3575880492,15
3,999,23142,3575880477,3575880495,18
3,999,23143,3575880477,3575880496,19
3,999,23144,3575880477,3575880496,19
3,999,23145,3575880477,3575880497,20
3,999,23146,3575880477,3575880497,20
3,999,23147,3575880477,3575880498,21
3,999,23148,3575880477,3575880500,23
3,999,23149,3575880477,3575880502,25
3,999,23150,3575880477,3575880502,25
3,999,23151,3575880477,3575880502,25
3,999,23152,3575880477,3575880502,25
3,999,23153,3575880477,3575880505,28
3,999,23154,3575880477,3575880506,29
3,999,23155,3575880477,3575880506,29
3,999,23156,3575880477,3575880507,30
3,999,23157,3575880477,3575880507,30
3,999,23158,3575880477,3575880508,31
3,999,23159,3575880477,3575880511,34
3,999,23160,3575880477,3575880512,35
3,999,23161,3575880477,3575880513,36
3,999,23162,3575880477,3575880513,36
3,999,23163,3575880477,3575880517,40
3,999,23164,3575880477,3575880518,41
3,999,23165,3575880477,3575880518,41
3,999,23166,3575880477,3575880520,43
3,999,23167,3575880477,3575880521,44
3,999,23168,3575880477,3575880522,45
3,999,23169,3575880477,3575880524,47
3,999,23170,3575880477,3575880524,47
3,999,23171,3575880477,3575880525,48
3,1000,23172,3575880539,3575880539,0
3,1000,23173,3575880539,3575880539,0
3,1000,23174,3575880539,3575880539,0
3,1000,23175,3575880539,3575880539,0
3,1000,23176,3575880539,3575880539,0
3,1000,23177,3575880539,3575880539,0
3,1000,23178,3575880539,3575880539,0
3,1000,23179,3575880539,3575880539,0
3,1000,23180,3575880539,3575880539,0
3,1000,23181,3575880539,3575880539,0
3,1000,23182,3575880539,3575880539,0
3,1000,23183,3575880539,3575880539,0
3,1000,23184,3575880539,3575880540,1
3,1000,23185,3575880539,3575880540,1
3,1000,23186,3575880539,3575880542,3
3,1000,23187,3575880539,3575880543,4
3,1000,23188,3575880539,3575880544,5
3,1000,23189,3575880539,3575880545,6
3,1000,23190,3575880539,3575880547,8
3,1000,23191,3575880539,3575880550,11
3,1000,23192,3575880539,3575880551,12
3,1000,23193,3575880539,3575880551,12
3,1000,23194,3575880539,3575880553,14
3,1000,23195,3575880539,3575880554,15
3,1000,23196,3575880539,3575880555,16
3,1000,23197,3575880539,3575880558,19
3,1000,23198,3575880539,3575880560,21
3,1000,23199,3575880539,3575880562,23
3,1000,23200,3575880539,3575880563,24
3,1000,23201,3575880539,3575880563,24
3,1000,23202,3575880539,3575880568,29
3,1000,23203,3575880539,3575880568,29
3,1000,23204,3575880539,3575880570,31
3,1000,23205,3575880539,3575880570,31
3,1000,23206,3575880539,3575880570,31
3,1000,23207,3575880539,3575880571,32
3,1000,23208,3575880539,3575880571,32
3,1000,23209,3575880539,3575880574,35
3,1000,23210,3575880539,3575880575,36
3,1000,23211,3575880539,3575880576,37
3,1000,23212,3575880539,3575880578,39
3,1000,23213,3575880539,3575880579,40
3,1000,23214,3575880539,3575880579,40
3,1000,23215,3575880539,3575880580,41
3,1000,23216,3575880539,3575880580,41
3,1000,23217,3575880539,3575880581,42
3,1000,23218,3575880539,3575880583,44
3,1000,23219,3575880539,3575880584,45
3,1000,23220,3575880539,3575880585,46
3,1000,23221,3575880539,3575880586,47
3,1000,23222,3575880539,3575880587,48
3,1000,23223,3575880539,3575880587,48
3,1001,23224,3575880602,3575880602,0
3,1001,23225,3575880602,3575880602,0
3,1001,23226,3575880602,3575880602,0
3,1001,23227,3575880602,3575880602,0
3,1001,23228,3575880602,3575880602,0
3,1001,23229,3575880602,3575880602,0
3,1001,23230,3575880602,3575880602,0
3,1001,23231,3575880602,3575880602,0
3,1001,23232,3575880602,3575880602,0
3,1001,23233,3575880602,3575880602,0
3,1001,23234,3575880602,3575880602,0
3,1001,23235,3575880602,3575880602,0
3,1001,23236,3575880602,3575880602,0
3,1001,23237,3575880602,3575880602,0
3,1001,23238,3575880602,3575880602,0
3,1001,23239,3575880602,3575880602,0
3,1001,23240,3575880602,3575880602,0
3,1001,23241,3575880602,3575880602,0
3,1001,23242,3575880602,3575880602,0
3,1001,23243,3575880602,3575880603,1
3,1001,23244,3575880602,3575880603,1
3,1001,23245,3575880602,3575880604,2
3,1001,23246,3575880602,3575880605,3
3,1001,23247,3575880602,3575880606,4
3,1001,23248,3575880602,3575880607,5
3,1001,23249,3575880602,3575880611,9
3,1001,23250,3575880602,3575880616,14
3,1001,23251,3575880602,3575880617,15
3,1001,23252,3575880602,3575880617,15
3,1001,23253,3575880602,3575880617,15
3,1001,23254,3575880602,3575880618,16
3,1001,23255,3575880602,3575880619,17
3,1001,23256,3575880602,3575880620,18
3,1001,23257,3575880602,3575880620,18
3,1001,23258,3575880602,3575880622,20
3,1001,23259,3575880602,3575880623,21
3,1001,23260,3575880602,3575880623,21
3,1001,23261,3575880602,3575880623,21
3,1001,23262,3575880602,3575880625,23
3,1001,23263,3575880602,3575880626,24
3,1001,23264,3575880602,3575880627,25
3,1001,23265,3575880602,3575880627,25
3,1001,23266,3575880602,3575880627,25
3,1001,23267,3575880602,3575880629,27
3,1001,23268,3575880602,3575880630,28
3,1001,23269,3575880602,3575880630,28
3,1001,23270,3575880602,3575880630,28
3,1001,23271,3575880602,3575880631,29
3,1001,23272,3575880602,3575880633,31
3,1001,23273,3575880602,3575880634,32
3,1001,23274,3575880602,3575880634,32
3,1001,23275,3575880602,3575880636,34
3,1001,23276,3575880602,3575880637,35
3,1001,23277,3575880602,3575880637,35
3,1001,23278,3575880602,3575880638,36
3,1001,23279,3575880602,3575880638,36
3,1001,23280,3575880602,3575880640,38
3,1001,23281,3575880602,3575880640,38
3,1001,23282,3575880602,3575880640,38
3,1001,23283,3575880602,3575880643,41
3,1001,23284,3575880602,3575880643,41
3,1001,23285,3575880602,3575880644,42
3,1001,23286,3575880602,3575880644,42
3,1001,23287,3575880602,3575880645,43
3,1001,23288,3575880602,3575880645,43
3,1001,23289,3575880602,3575880646,44
3,1001,23290,3575880602,3575880648,46
3,1001,23291,3575880602,3575880649,47
3,1001,23292,3575880602,3575880651,49
3,1001,23293,3575880602,3575880651,49
3,1001,23294,3575880602,3575880652,50
3,1002,23295,3575880666,3575880666,0
3,1002,23296,3575880666,3575880666,0
3,1002,23297,3575880666,3575880666,0
3,1002,23298,3575880666,3575880666,0
3,1002,23299,3575880666,3575880666,0
3,1002,23300,3575880666,3575880666,0
3,1002,23301,3575880666,3575880666,0
3,1002,23302,3575880666,3575880666,0
3,1002,23303,3575880666,3575880666,0
3,1002,23304,3575880666,3575880666,0
3,1002,23305,3575880666,3575880666,0
3,1002,23306,3575880666,3575880666,0
3,1002,23307,3575880666,3575880666,0
3,1002,23308,3575880666,3575880666,0
3,1002,23309,3575880666,3575880666,0
3,1002,23310,3575880666,3575880667,1
3,1002,23311,3575880666,3575880667,1
3,1002,23312,3575880666,3575880667,1
3,1002,23313,3575880666,3575880670,4
3,1002,23314,3575880666,3575880674,8
3,1002,23315,3575880666,3575880676,10
3,1002,23316,3575880666,3575880681,15
3,1002,23317,3575880666,3575880681,15
3,1002,23318,3575880666,3575880681,15
3,1002,23319,3575880666,3575880681,15
3,1002,23320,3575880666,3575880682,16
3,1002,23321,3575880666,3575880682,16
3,1002,23322,3575880666,3575880683,17
3,1002,23323,3575880666,3575880684,18
3,1002,23324,3575880666,3575880685,19
3,1002,23325,3575880666,3575880686,20
3,1002,23326,3575880666,3575880686,20
3,1002,23327,3575880666,3575880686,20
3,1002,23328,3575880666,3575880687,21
3,1002,23329,3575880666,3575880688,22
3,1002,23330,3575880666,3575880689,23
3,1002,23331,3575880666,3575880689,23
3,1002,23332,3575880666,3575880690,24
3,1002,23333,3575880666,3575880691,25
3,1002,23334,3575880666,3575880695,29
3,1002,23335,3575880666,3575880695,29
3,1002,23336,3575880666,3575880696,30
3,1002,23337,3575880666,3575880697,31
3,1002,23338,3575880666,3575880697,31
3,1002,23339,3575880666,3575880698,32
3,1002,23340,3575880666,3575880700,34
3,1002,23341,3575880666,3575880702,36
3,1002,23342,3575880666,3575880702,36
3,1002,23343,3575880666,3575880702,36
3,1002,23344,3575880666,3575880702,36
3,1002,23345,3575880666,3575880703,37
3,1002,23346,3575880666,3575880705,39
3,1002,23347,3575880666,3575880706,40
3,1002,23348,3575880666,3575880707,41
3,1002,23349,3575880666,3575880707,41
3,1002,23350,3575880666,3575880708,42
3,1002,23351,3575880666,3575880708,42
3,1002,23352,3575880666,3575880711,45
3,1002,23353,3575880666,3575880712,46
3,1002,23354,3575880666,3575880713,47
3,1002,23355,3575880666,3575880713,47
3,1003,23356,3575880730,3575880730,0
3,1003,23357,3575880730,3575880730,0
3,1003,23358,3575880730,3575880730,0
3,1003,23359,3575880730,3575880730,0
3,1003,23360,3575880730,3575880730,0
3,1003,23361,3575880730,3575880730,0
3,1003,23362,3575880730,3575880730,0
3,1003,23363,3575880730,3575880730,0
3,1003,23364,3575880730,3575880730,0
3,1003,23365,3575880730,3575880730,0
3,1003,23366,3575880730,3575880730,0
3,1003,23367,3575880730,3575880730,0
3,1003,23368,3575880730,3575880730,0
3,1003,23369,3575880730,3575880730,0
3,1003,23370,3575880730,3575880731,1
3,1003,23371,3575880730,3575880733,3
3,1003,23372,3575880730,3575880734,4
3,1003,23373,3575880730,3575880735,5
3,1003,23374,3575880730,3575880735,5
3,1003,23375,3575880730,3575880736,6
3,1003,23376,3575880730,3575880737,7
3,1003,23377,3575880730,3575880740,10
3,1003,23378,3575880730,3575880741,11
3,1003,23379,3575880730,3575880744,14
3,1003,23380,3575880730,3575880744,14
3,1003,23381,3575880730,3575880746,16
3,1003,23382,3575880730,3575880747,17
3,1003,23383,3575880730,3575880751,21
3,1003,23384,3575880730,3575880751,21
3,1003,23385,3575880730,3575880751,21
3,1003,23386,3575880730,3575880754,24
3,1003,23387,3575880730,3575880755,25
3,1003,23388,3575880730,3575880755,25
3,1003,23389,3575880730,3575880758,28
3,1003,23390,3575880730,3575880760,30
3,1003,23391,3575880730,3575880762,32
3,1003,23392,3575880730,3575880763,33
3,1003,23393,3575880730,3575880764,34
3,1003,23394,3575880730,3575880769,39
3,1003,23395,3575880730,3575880769,39
3,1003,23396,3575880730,3575880769,39
3,1003,23397,3575880730,3575880770,40
3,1003,23398,3575880730,3575880770,40
3,1003,23399,3575880730,3575880771,41
3,1003,23400,3575880730,3575880773,43
3,1003,23401,3575880730,3575880774,44
3,1003,23402,3575880730,3575880776,46
3,1003,23403,3575880730,3575880777,47
3,1003,23404,3575880730,3575880778,48
3,1003,23405,3575880730,3575880778,48
3,1003,23406,3575880730,3575880779,49
3,1003,23407,3575880730,3575880780,50
3,1004,23408,3575880794,3575880794,0
3,1004,23409,3575880794,3575880794,0
3,1004,23410,3575880794,3575880794,0
3,1004,23411,3575880794,3575880794,0
3,1004,23412,3575880794,3575880794,0
3,1004,23413,3575880794,3575880794,0
3,1004,23414,3575880794,3575880794,0
3,1004,23415,3575880794,3575880794,0
3,1004,23416,3575880794,3575880794,0
3,1004,23417,3575880794,3575880794,0
3,1004,23418,3575880794,3575880794,0
3,1004,23419,3575880794,3575880794,0
3,1004,23420,3575880794,3575880794,0
3,1004,23421,3575880794,3575880794,0
3,1004,23422,3575880794,3575880795,1
3,1004,23423,3575880794,3575880795,1
3,1004,23424,3575880794,3575880795,1
3,1004,23425,3575880794,3575880796,2
3,1004,23426,3575880794,3575880797,3
3,1004,23427,3575880794,3575880797,3
3,1004,23428,3575880794,3575880798,4
3,1004,23429,3575880794,3575880799,5
3,1004,23430,3575880794,3575880800,6
3,1004,23431,3575880794,3575880802,8
3,1004,23432,3575880794,3575880802,8
3,1004,23433,3575880794,3575880803,9
3,1004,23434,3575880794,3575880803,9
3,1004,23435,3575880794,3575880804,10
3,1004,23436,3575880794,3575880805,11
3,1004,23437,3575880794,3575880805,11
3,1004,23438,3575880794,3575880806,12
3,1004,23439,3575880794,3575880806,12
3,1004,23440,3575880794,3575880810,16
3,1004,23441,3575880794,3575880816,22
3,1004,23442,3575880794,3575880817,23
3,1004,23443,3575880794,3575880817,23
3,1004,23444,3575880794,3575880817,23
3,1004,23445,3575880794,3575880819,25
3,1004,23446,3575880794,3575880820,26
3,1004,23447,3575880794,3575880820,26
3,1004,23448,3575880794,3575880821,27
3,1004,23449,3575880794,3575880822,28
3,1004,23450,3575880794,3575880823,29
3,1004,23451,3575880794,3575880823,29
3,1004,23452,3575880794,3575880824,30
3,1004,23453,3575880794,3575880825,31
3,1004,23454,3575880794,3575880826,32
3,1004,23455,3575880794,3575880826,32
3,1004,23456,3575880794,3575880827,33
3,1004,23457,3575880794,3575880828,34
3,1004,23458,3575880794,3575880829,35
3,1004,23459,3575880794,3575880829,35
3,1004,23460,3575880794,3575880829,35
3,1004,23461,3575880794,3575880831,37
3,1004,23462,3575880794,3575880832,38
3,1004,23463,3575880794,3575880833,39
3,1004,23464,3575880794,3575880833,39
3,1004,23465,3575880794,3575880834,40
3,1004,23466,3575880794,3575880837,43
3,1004,23467,3575880794,3575880838,44
3,1004,23468,3575880794,3575880838,44
3,1004,23469,3575880794,3575880838,44
3,1004,23470,3575880794,3575880839,45
3,1004,23471,3575880794,3575880839,45
3,1004,23472,3575880794,3575880840,46
3,1004,23473,3575880794,3575880841,47
3,1004,23474,3575880794,3575880843,49
3,1004,23475,3575880794,3575880843,49
3,1005,23476,3575880855,3575880855,0
3,1005,23477,3575880855,3575880855,0
3,1005,23478,3575880855,3575880855,0
3,1005,23479,3575880855,3575880855,0
3,1005,23480,3575880855,3575880855,0
3,1005,23481,3575880855,3575880855,0
3,1005,23482,3575880855,3575880855,0
3,1005,23483,3575880855,3575880855,0
3,1005,23484,3575880855,3575880855,0
3,1005,23485,3575880855,3575880855,0
3,1005,23486,3575880855,3575880855,0
3,1005,23487,3575880855,3575880856,1
3,1005,23488,3575880855,3575880858,3
3,1005,23489,3575880855,3575880860,5
3,1005,23490,3575880855,3575880860,5
3,1005,23491,3575880855,3575880861,6
3,1005,23492,3575880855,3575880862,7
3,1005,23493,3575880855,3575880862,7
3,1005,23494,3575880855,3575880863,8
3,1005,23495,3575880855,3575880865,10
3,1005,23496,3575880855,3575880865,10
3,1005,23497,3575880855,3575880865,10
3,1005,23498,3575880855,3575880866,11
3,1005,23499,3575880855,3575880866,11
3,1005,23500,3575880855,3575880867,12
3,1005,23501,3575880855,3575880867,12
3,1005,23502,3575880855,3575880867,12
3,1005,23503,3575880855,3575880869,14
3,1005,23504,3575880855,3575880874,19
3,1005,23505,3575880855,3575880877,22
3,1005,23506,3575880855,3575880881,26
3,1005,23507,3575880855,3575880881,26
3,1005,23508,3575880855,3575880881,26
3,1005,23509,3575880855,3575880881,26
3,1005,23510,3575880855,3575880882,27
3,1005,23511,3575880855,3575880882,27
3,1005,23512,3575880855,3575880882,27
3,1005,23513,3575880855,3575880883,28
3,1005,23514,3575880855,3575880885,30
3,1005,23515,3575880855,3575880885,30
3,1005,23516,3575880855,3575880886,31
3,1005,23517,3575880855,3575880886,31
3,1005,23518,3575880855,3575880886,31
3,1005,23519,3575880855,3575880886,31
3,1005,23520,3575880855,3575880888,33
3,1005,23521,3575880855,3575880889,34
3,1005,23522,3575880855,3575880889,34
3,1005,23523,3575880855,3575880890,35
3,1005,23524,3575880855,3575880892,37
3,1005,23525,3575880855,3575880895,40
3,1005,23526,3575880855,3575880895,40
3,1005,23527,3575880855,3575880895,40
3,1005,23528,3575880855,3575880897,42
3,1005,23529,3575880855,3575880898,43
3,1005,23530,3575880855,3575880898,43
3,1005,23531,3575880855,3575880900,45
3,1005,23532,3575880855,3575880901,46
3,1005,23533,3575880855,3575880902,47
3,1005,23534,3575880855,3575880902,47
3,1005,23535,3575880855,3575880903,48
3,1005,23536,3575880855,3575880903,48
3,1005,23537,3575880855,3575880905,50
3,1006,23538,3575880920,3575880920,0
3,1006,23539,3575880920,3575880920,0
3,1006,23540,3575880920,3575880920,0
3,1006,23541,3575880920,3575880920,0
3,1006,23542,3575880920,3575880920,0
3,1006,23543,3575880920,3575880920,0
3,1006,23544,3575880920,3575880920,0
3,1006,23545,3575880920,3575880920,0
3,1006,23546,3575880920,3575880920,0
3,1006,23547,3575880920,3575880920,0
3,1006,23548,3575880920,3575880920,0
3,1006,23549,3575880920,3575880921,1
3,1006,23550,3575880920,3575880922,2
3,1006,23551,3575880920,3575880922,2
3,1006,23552,3575880920,3575880924,4
3,1006,23553,3575880920,3575880924,4
3,1006,23554,3575880920,3575880924,4
3,1006,23555,3575880920,3575880927,7
3,1006,23556,3575880920,3575880927,7
3,1006,23557,3575880920,3575880928,8
3,1006,23558,3575880920,3575880928,8
3,1006,23559,3575880920,3575880932,12
3,1006,23560,3575880920,3575880933,13
3,1006,23561,3575880920,3575880935,15
3,1006,23562,3575880920,3575880935,15
3,1006,23563,3575880920,3575880935,15
3,1006,23564,3575880920,3575880937,17
3,1006,23565,3575880920,3575880937,17
3,1006,23566,3575880920,3575880941,21
3,1006,23567,3575880920,3575880943,23
3,1006,23568,3575880920,3575880944,24
3,1006,23569,3575880920,3575880945,25
3,1006,23570,3575880920,3575880946,26
3,1006,23571,3575880920,3575880947,27
3,1006,23572,3575880920,3575880951,31
3,1006,23573,3575880920,3575880951,31
3,1006,23574,3575880920,3575880952,32
3,1006,23575,3575880920,3575880953,33
3,1006,23576,3575880920,3575880954,34
3,1006,23577,3575880920,3575880955,35
3,1006,23578,3575880920,3575880959,39
3,1006,23579,3575880920,3575880960,40
3,1006,23580,3575880920,3575880964,44
3,1006,23581,3575880920,3575880969,49
3,1006,23582,3575880920,3575880969,49
3,1006,23583,3575880920,3575880969,49
3,1007,23584,3575880987,3575880987,0
3,1007,23585,3575880987,3575880987,0
3,1007,23586,3575880987,3575880987,0
3,1007,23587,3575880987,3575880987,0
3,1007,23588,3575880987,3575880987,0
3,1007,23589,3575880987,3575880987,0
3,1007,23590,3575880987,3575880987,0
3,1007,23591,3575880987,3575880987,0
3,1007,23592,3575880987,3575880987,0
3,1007,23593,3575880987,3575880987,0
3,1007,23594,3575880987,3575880988,1
3,1007,23595,3575880987,3575880988,1
3,1007,23596,3575880987,3575880988,1
3,1007,23597,3575880987,3575880988,1
3,1007,23598,3575880987,3575880988,1
3,1007,23599,3575880987,3575880988,1
3,1007,23600,3575880987,3575880988,1
3,1007,23601,3575880987,3575880988,1
3,1007,23602,3575880987,3575880988,1
3,1007,23603,3575880987,3575880988,1
3,1007,23604,3575880987,3575880993,6
3,1007,23605,3575880987,3575880993,6
3,1007,23606,3575880987,3575880994,7
3,1007,23607,3575880987,3575880994,7
3,1007,23608,3575880987,3575880995,8
3,1007,23609,3575880987,3575880995,8
3,1007,23610,3575880987,3575880995,8
3,1007,23611,3575880987,3575880995,8
3,1007,23612,3575880987,3575880996,9
3,1007,23613,3575880987,3575880997,10
3,1007,23614,3575880987,3575880998,11
3,1007,23615,3575880987,3575881000,13
3,1007,23616,3575880987,3575881000,13
3,1007,23617,3575880987,3575881002,15
3,1007,23618,3575880987,3575881002,15
3,1007,23619,3575880987,3575881003,16
3,1007,23620,3575880987,3575881003,16
3,1007,23621,3575880987,3575881004,17
3,1007,23622,3575880987,3575881005,18
3,1007,23623,3575880987,3575881005,18
3,1007,23624,3575880987,3575881006,19
3,1007,23625,3575880987,3575881007,20
3,1007,23626,3575880987,3575881012,25
3,1007,23627,3575880987,3575881016,29
3,1007,23628,3575880987,3575881017,30
3,1007,23629,3575880987,3575881018,31
3,1007,23630,3575880987,3575881018,31
3,1007,23631,3575880987,3575881020,33
3,1007,23632,3575880987,3575881020,33
3,1007,23633,3575880987,3575881021,34
3,1007,23634,3575880987,3575881022,35
3,1007,23635,3575880987,3575881022,35
3,1007,23636,3575880987,3575881023,36
3,1007,23637,3575880987,3575881024,37
3,1007,23638,3575880987,3575881025,38
3,1007,23639,3575880987,3575881025,38
3,1007,23640,3575880987,3575881025,38
3,1007,23641,3575880987,3575881027,40
3,1007,23642,3575880987,3575881028,41
3,1007,23643,3575880987,3575881028,41
3,1007,23644,3575880987,3575881028,41
3,1007,23645,3575880987,3575881029,42
3,1007,23646,3575880987,3575881030,43
3,1007,23647,3575880987,3575881031,44
3,1007,23648,3575880987,3575881033,46
3,1007,23649,3575880987,3575881034,47
3,1007,23650,3575880987,3575881034,47
3,1007,23651,3575880987,3575881035,48
3,1007,23652,3575880987,3575881036,49
3,1007,23653,3575880987,3575881037,50
3,1008,23654,3575881049,3575881049,0
3,1008,23655,3575881049,3575881049,0
3,1008,23656,3575881049,3575881049,0
3,1008,23657,3575881049,3575881049,0
3,1008,23658,3575881049,3575881049,0
3,1008,23659,3575881049,3575881049,0
3,1008,23660,3575881049,3575881049,0
3,1008,23661,3575881049,3575881049,0
3,1008,23662,3575881049,3575881049,0
3,1008,23663,3575881049,3575881049,0
3,1008,23664,3575881049,3575881049,0
3,1008,23665,3575881049,3575881049,0
3,1008,23666,3575881049,3575881049,0
3,1008,23667,3575881049,3575881049,0
3,1008,23668,3575881049,3575881049,0
3,1008,23669,3575881049,3575881049,0
3,1008,23670,3575881049,3575881049,0
3,1008,23671,3575881049,3575881050,1
3,1008,23672,3575881049,3575881052,3
3,1008,23673,3575881049,3575881052,3
3,1008,23674,3575881049,3575881052,3
3,1008,23675,3575881049,3575881054,5
3,1008,23676,3575881049,3575881056,7
3,1008,23677,3575881049,3575881058,9
3,1008,23678,3575881049,3575881059,10
3,1008,23679,3575881049,3575881060,11
3,1008,23680,3575881049,3575881060,11
3,1008,23681,3575881049,3575881061,12
3,1008,23682,3575881049,3575881062,13
3,1008,23683,3575881049,3575881064,15
3,1008,23684,3575881049,3575881064,15
3,1008,23685,3575881049,3575881065,16
3,1008,23686,3575881049,3575881066,17
3,1008,23687,3575881049,3575881066,17
3,1008,23688,3575881049,3575881066,17
3,1008,23689,3575881049,3575881066,17
3,1008,23690,3575881049,3575881067,18
3,1008,23691,3575881049,3575881068,19
3,1008,23692,3575881049,3575881070,21
3,1008,23693,3575881049,3575881074,25
3,1008,23694,3575881049,3575881077,28
3,1008,23695,3575881049,3575881080,31
3,1008,23696,3575881049,3575881081,32
3,1008,23697,3575881049,3575881081,32
3,1008,23698,3575881049,3575881081,32
3,1008,23699,3575881049,3575881082,33
3,1008,23700,3575881049,3575881082,33
3,1008,23701,3575881049,3575881083,34
3,1008,23702,3575881049,3575881083,34
3,1008,23703,3575881049,3575881084,35
3,1008,23704,3575881049,3575881085,36
3,1008,23705,3575881049,3575881085,36
3,1008,23706,3575881049,3575881086,37
3,1008,23707,3575881049,3575881086,37
3,1008,23708,3575881049,3575881087,38
3,1008,23709,3575881049,3575881088,39
3,1008,23710,3575881049,3575881089,40
3,1008,23711,3575881049,3575881089,40
3,1008,23712,3575881049,3575881091,42
3,1008,23713,3575881049,3575881092,43
3,1008,23714,3575881049,3575881095,46
3,1008,23715,3575881049,3575881095,46
3,1008,23716,3575881049,3575881096,47
3,1008,23717,3575881049,3575881097,48
3,1008,23718,3575881049,3575881098,49
3,1008,23719,3575881049,3575881098,49
3,1009,23720,3575881117,3575881117,0
3,1009,23721,3575881117,3575881117,0
3,1009,23722,3575881117,3575881117,0
3,1009,23723,3575881117,3575881117,0
3,1009,23724,3575881117,3575881117,0
3,1009,23725,3575881117,3575881117,0
3,1009,23726,3575881117,3575881117,0
3,1009,23727,3575881117,3575881117,0
3,1009,23728,3575881117,3575881117,0
3,1009,23729,3575881117,3575881117,0
3,1009,23730,3575881117,3575881117,0
3,1009,23731,3575881117,3575881117,0
3,1009,23732,3575881117,3575881117,0
3,1009,23733,3575881117,3575881117,0
3,1009,23734,3575881117,3575881117,0
3,1009,23735,3575881117,3575881117,0
3,1009,23736,3575881117,3575881118,1
3,1009,23737,3575881117,3575881119,2
3,1009,23738,3575881117,3575881121,4
3,1009,23739,3575881117,3575881122,5
3,1009,23740,3575881117,3575881122,5
3,1009,23741,3575881117,3575881124,7
3,1009,23742,3575881117,3575881124,7
3,1009,23743,3575881117,3575881126,9
3,1009,23744,3575881117,3575881127,10
3,1009,23745,3575881117,3575881127,10
3,1009,23746,3575881117,3575881128,11
3,1009,23747,3575881117,3575881128,11
3,1009,23748,3575881117,3575881132,15
3,1009,23749,3575881117,3575881133,16
3,1009,23750,3575881117,3575881134,17
3,1009,23751,3575881117,3575881135,18
3,1009,23752,3575881117,3575881135,18
3,1009,23753,3575881117,3575881136,19
3,1009,23754,3575881117,3575881137,20
3,1009,23755,3575881117,3575881141,24
3,1009,23756,3575881117,3575881143,26
3,1009,23757,3575881117,3575881144,27
3,1009,23758,3575881117,3575881145,28
3,1009,23759,3575881117,3575881146,29
3,1009,23760,3575881117,3575881147,30
3,1009,23761,3575881117,3575881152,35
3,1009,23762,3575881117,3575881152,35
3,1009,23763,3575881117,3575881153,36
3,1009,23764,3575881117,3575881154,37
3,1009,23765,3575881117,3575881155,38
3,1009,23766,3575881117,3575881156,39
3,1009,23767,3575881117,3575881159,42
3,1009,23768,3575881117,3575881161,44
3,1009,23769,3575881117,3575881165,48
3,1010,23770,3575881184,3575881184,0
3,1010,23771,3575881184,3575881184,0
3,1010,23772,3575881184,3575881184,0
3,1010,23773,3575881184,3575881184,0
3,1010,23774,3575881184,3575881184,0
3,1010,23775,3575881184,3575881184,0
3,1010,23776,3575881184,3575881184,0
3,1010,23777,3575881184,3575881184,0
3,1010,23778,3575881184,3575881184,0
3,1010,23779,3575881184,3575881184,0
3,1010,23780,3575881184,3575881184,0
3,1010,23781,3575881184,3575881184,0
3,1010,23782,3575881184,3575881184,0
3,1010,23783,3575881184,3575881184,0
3,1010,23784,3575881184,3575881184,0
3,1010,23785,3575881184,3575881184,0
3,1010,23786,3575881184,3575881184,0
3,1010,23787,3575881184,3575881184,0
3,1010,23788,3575881184,3575881184,0
3,1010,23789,3575881184,3575881186,2
3,1010,23790,3575881184,3575881186,2
3,1010,23791,3575881184,3575881187,3
3,1010,23792,3575881184,3575881188,4
3,1010,23793,3575881184,3575881188,4
3,1010,23794,3575881184,3575881193,9
3,1010,23795,3575881184,3575881194,10
3,1010,23796,3575881184,3575881194,10
3,1010,23797,3575881184,3575881195,11
3,1010,23798,3575881184,3575881195,11
3,1010,23799,3575881184,3575881195,11
3,1010,23800,3575881184,3575881196,12
3,1010,23801,3575881184,3575881196,12
3,1010,23802,3575881184,3575881197,13
3,1010,23803,3575881184,3575881198,14
3,1010,23804,3575881184,3575881199,15
3,1010,23805,3575881184,3575881200,16
3,1010,23806,3575881184,3575881202,18
3,1010,23807,3575881184,3575881202,18
3,1010,23808,3575881184,3575881202,18
3,1010,23809,3575881184,3575881203,19
3,1010,23810,3575881184,3575881203,19
3,1010,23811,3575881184,3575881203,19
3,1010,23812,3575881184,3575881204,20
3,1010,23813,3575881184,3575881205,21
3,1010,23814,3575881184,3575881205,21
3,1010,23815,3575881184,3575881206,22
3,1010,23816,3575881184,3575881207,23
3,1010,23817,3575881184,3575881211,27
3,1010,23818,3575881184,3575881216,32
3,1010,23819,3575881184,3575881217,33
3,1010,23820,3575881184,3575881218,34
3,1010,23821,3575881184,3575881220,36
3,1010,23822,3575881184,3575881221,37
3,1010,23823,3575881184,3575881222,38
3,1010,23824,3575881184,3575881222,38
3,1010,23825,3575881184,3575881224,40
3,1010,23826,3575881184,3575881224,40
3,1010,23827,3575881184,3575881225,41
3,1010,23828,3575881184,3575881226,42
3,1010,23829,3575881184,3575881226,42
3,1010,23830,3575881184,3575881228,44
3,1010,23831,3575881184,3575881228,44
3,1010,23832,3575881184,3575881228,44
3,1010,23833,3575881184,3575881229,45
3,1010,23834,3575881184,3575881229,45
3,1010,23835,3575881184,3575881231,47
3,1010,23836,3575881184,3575881232,48
3,1010,23837,3575881184,3575881233,49
3,1010,23838,3575881184,3575881234,50
3,1011,23839,3575881250,3575881250,0
3,1011,23840,3575881250,3575881250,0
3,1011,23841,3575881250,3575881250,0
3,1011,23842,3575881250,3575881250,0
3,1011,23843,3575881250,3575881250,0
3,1011,23844,3575881250,3575881250,0
3,1011,23845,3575881250,3575881250,0
3,1011,23846,3575881250,3575881250,0
3,1011,23847,3575881250,3575881250,0
3,1011,23848,3575881250,3575881250,0
3,1011,23849,3575881250,3575881250,0
3,1011,23850,3575881250,3575881250,0
3,1011,23851,3575881250,3575881250,0
3,1011,23852,3575881250,3575881250,0
3,1011,23853,3575881250,3575881250,0
3,1011,23854,3575881250,3575881250,0
3,1011,23855,3575881250,3575881250,0
3,1011,23856,3575881250,3575881250,0
3,1011,23857,3575881250,3575881250,0
3,1011,23858,3575881250,3575881250,0
3,1011,23859,3575881250,3575881250,0
3,1011,23860,3575881250,3575881250,0
3,1011,23861,3575881250,3575881251,1
3,1011,23862,3575881250,3575881252,2
3,1011,23863,3575881250,3575881253,3
3,1011,23864,3575881250,3575881253,3
3,1011,23865,3575881250,3575881254,4
3,1011,23866,3575881250,3575881256,6
3,1011,23867,3575881250,3575881258,8
3,1011,23868,3575881250,3575881260,10
3,1011,23869,3575881250,3575881260,10
3,1011,23870,3575881250,3575881261,11
3,1011,23871,3575881250,3575881261,11
3,1011,23872,3575881250,3575881262,12
3,1011,23873,3575881250,3575881262,12
3,1011,23874,3575881250,3575881264,14
3,1011,23875,3575881250,3575881264,14
3,1011,23876,3575881250,3575881265,15
3,1011,23877,3575881250,3575881266,16
3,1011,23878,3575881250,3575881266,16
3,1011,23879,3575881250,3575881266,16
3,1011,23880,3575881250,3575881266,16
3,1011,23881,3575881250,3575881267,17
3,1011,23882,3575881250,3575881268,18
3,1011,23883,3575881250,3575881276,26
3,1011,23884,3575881250,3575881276,26
3,1011,23885,3575881250,3575881281,31
3,1011,23886,3575881250,3575881281,31
3,1011,23887,3575881250,3575881281,31
3,1011,23888,3575881250,3575881281,31
3,1011,23889,3575881250,3575881282,32
3,1011,23890,3575881250,3575881282,32
3,1011,23891,3575881250,3575881282,32
3,1011,23892,3575881250,3575881284,34
3,1011,23893,3575881250,3575881284,34
3,1011,23894,3575881250,3575881285,35
3,1011,23895,3575881250,3575881285,35
3,1011,23896,3575881250,3575881286,36
3,1011,23897,3575881250,3575881287,37
3,1011,23898,3575881250,3575881287,37
3,1011,23899,3575881250,3575881288,38
3,1011,23900,3575881250,3575881288,38
3,1011,23901,3575881250,3575881289,39
3,1011,23902,3575881250,3575881291,41
3,1011,23903,3575881250,3575881291,41
3,1011,23904,3575881250,3575881295,45
3,1011,23905,3575881250,3575881295,45
3,1011,23906,3575881250,3575881296,46
3,1011,23907,3575881250,3575881297,47
3,1011,23908,3575881250,3575881297,47
3,1011,23909,3575881250,3575881298,48
3,1011,23910,3575881250,3575881300,50
3,1012,23911,3575881311,3575881311,0
3,1012,23912,3575881311,3575881311,0
3,1012,23913,3575881311,3575881311,0
3,1012,23914,3575881311,3575881311,0
3,1012,23915,3575881311,3575881311,0
3,1012,23916,3575881311,3575881311,0
3,1012,23917,3575881311,3575881311,0
3,1012,23918,3575881311,3575881311,0
3,1012,23919,3575881311,3575881311,0
3,1012,23920,3575881311,3575881311,0
3,1012,23921,3575881311,3575881312,1
3,1012,23922,3575881311,3575881312,1
3,1012,23923,3575881311,3575881313,2
3,1012,23924,3575881311,3575881313,2
3,1012,23925,3575881311,3575881314,3
3,1012,23926,3575881311,3575881316,5
3,1012,23927,3575881311,3575881318,7
3,1012,23928,3575881311,3575881319,8
3,1012,23929,3575881311,3575881321,10
3,1012,23930,3575881311,3575881321,10
3,1012,23931,3575881311,3575881322,11
3,1012,23932,3575881311,3575881322,11
3,1012,23933,3575881311,3575881324,13
3,1012,23934,3575881311,3575881324,13
3,1012,23935,3575881311,3575881326,15
3,1012,23936,3575881311,3575881327,16
3,1012,23937,3575881311,3575881327,16
3,1012,23938,3575881311,3575881328,17
3,1012,23939,3575881311,3575881329,18
3,1012,23940,3575881311,3575881332,21
3,1012,23941,3575881311,3575881332,21
3,1012,23942,3575881311,3575881334,23
3,1012,23943,3575881311,3575881335,24
3,1012,23944,3575881311,3575881335,24
3,1012,23945,3575881311,3575881336,25
3,1012,23946,3575881311,3575881337,26
3,1012,23947,3575881311,3575881338,27
3,1012,23948,3575881311,3575881341,30
3,1012,23949,3575881311,3575881343,32
3,1012,23950,3575881311,3575881343,32
3,1012,23951,3575881311,3575881344,33
3,1012,23952,3575881311,3575881346,35
3,1012,23953,3575881311,3575881347,36
3,1012,23954,3575881311,3575881352,41
3,1012,23955,3575881311,3575881352,41
3,1012,23956,3575881311,3575881353,42
3,1012,23957,3575881311,3575881354,43
3,1012,23958,3575881311,3575881355,44
3,1012,23959,3575881311,3575881356,45
3,1012,23960,3575881311,3575881359,48
3,1013,23961,3575881374,3575881374,0
3,1013,23962,3575881374,3575881374,0
3,1013,23963,3575881374,3575881374,0
3,1013,23964,3575881374,3575881374,0
3,1013,23965,3575881374,3575881374,0
3,1013,23966,3575881374,3575881374,0
3,1013,23967,3575881374,3575881374,0
3,1013,23968,3575881374,3575881374,0
3,1013,23969,3575881374,3575881374,0
3,1013,23970,3575881374,3575881374,0
3,1013,23971,3575881374,3575881374,0
3,1013,23972,3575881374,3575881375,1
3,1013,23973,3575881374,3575881377,3
3,1013,23974,3575881374,3575881378,4
3,1013,23975,3575881374,3575881379,5
3,1013,23976,3575881374,3575881379,5
3,1013,23977,3575881374,3575881380,6
3,1013,23978,3575881374,3575881380,6
3,1013,23979,3575881374,3575881382,8
3,1013,23980,3575881374,3575881382,8
3,1013,23981,3575881374,3575881383,9
3,1013,23982,3575881374,3575881383,9
3,1013,23983,3575881374,3575881383,9
3,1013,23984,3575881374,3575881385,11
3,1013,23985,3575881374,3575881387,13
3,1013,23986,3575881374,3575881387,13
3,1013,23987,3575881374,3575881393,19
3,1013,23988,3575881374,3575881393,19
3,1013,23989,3575881374,3575881394,20
3,1013,23990,3575881374,3575881395,21
3,1013,23991,3575881374,3575881395,21
3,1013,23992,3575881374,3575881395,21
3,1013,23993,3575881374,3575881396,22
3,1013,23994,3575881374,3575881397,23
3,1013,23995,3575881374,3575881397,23
3,1013,23996,3575881374,3575881398,24
3,1013,23997,3575881374,3575881399,25
3,1013,23998,3575881374,3575881399,25
3,1013,23999,3575881374,3575881400,26
3,1013,24000,3575881374,3575881401,27
3,1013,24001,3575881374,3575881402,28
3,1013,24002,3575881374,3575881402,28
3,1013,24003,3575881374,3575881402,28
3,1013,24004,3575881374,3575881403,29
3,1013,24005,3575881374,3575881404,30
3,1013,24006,3575881374,3575881404,30
3,1013,24007,3575881374,3575881405,31
3,1013,24008,3575881374,3575881405,31
3,1013,24009,3575881374,3575881406,32
3,1013,24010,3575881374,3575881407,33
3,1013,24011,3575881374,3575881411,37
3,1013,24012,3575881374,3575881416,42
3,1013,24013,3575881374,3575881417,43
3,1013,24014,3575881374,3575881419,45
3,1013,24015,3575881374,3575881419,45
3,1013,24016,3575881374,3575881420,46
3,1013,24017,3575881374,3575881420,46
3,1013,24018,3575881374,3575881421,47
3,1013,24019,3575881374,3575881421,47
3,1013,24020,3575881374,3575881422,48
3,1014,24021,3575881443,3575881443,0
3,1014,24022,3575881443,3575881443,0
3,1014,24023,3575881443,3575881443,0
3,1014,24024,3575881443,3575881443,0
3,1014,24025,3575881443,3575881444,1
3,1014,24026,3575881443,3575881444,1
3,1014,24027,3575881443,3575881444,1
3,1014,24028,3575881443,3575881444,1
3,1014,24029,3575881443,3575881444,1
3,1014,24030,3575881443,3575881444,1
3,1014,24031,3575881443,3575881444,1
3,1014,24032,3575881443,3575881444,1
3,1014,24033,3575881443,3575881444,1
3,1014,24034,3575881443,3575881444,1
3,1014,24035,3575881443,3575881444,1
3,1014,24036,3575881443,3575881444,1
3,1014,24037,3575881443,3575881444,1
3,1014,24038,3575881443,3575881444,1
3,1014,24039,3575881443,3575881444,1
3,1014,24040,3575881443,3575881444,1
3,1014,24041,3575881443,3575881444,1
3,1014,24042,3575881443,3575881444,1
3,1014,24043,3575881443,3575881444,1
3,1014,24044,3575881443,3575881444,1
3,1014,24045,3575881443,3575881444,1
3,1014,24046,3575881443,3575881444,1
3,1014,24047,3575881443,3575881444,1
3,1014,24048,3575881443,3575881445,2
3,1014,24049,3575881443,3575881446,3
3,1014,24050,3575881443,3575881446,3
3,1014,24051,3575881443,3575881446,3
3,1014,24052,3575881443,3575881447,4
3,1014,24053,3575881443,3575881449,6
3,1014,24054,3575881443,3575881449,6
3,1014,24055,3575881443,3575881451,8
3,1014,24056,3575881443,3575881453,10
3,1014,24057,3575881443,3575881453,10
3,1014,24058,3575881443,3575881454,11
3,1014,24059,3575881443,3575881457,14
3,1014,24060,3575881443,3575881458,15
3,1014,24061,3575881443,3575881460,17
3,1014,24062,3575881443,3575881460,17
3,1014,24063,3575881443,3575881460,17
3,1014,24064,3575881443,3575881460,17
3,1014,24065,3575881443,3575881461,18
3,1014,24066,3575881443,3575881463,20
3,1014,24067,3575881443,3575881464,21
3,1014,24068,3575881443,3575881465,22
3,1014,24069,3575881443,3575881465,22
3,1014,24070,3575881443,3575881465,22
3,1014,24071,3575881443,3575881466,23
3,1014,24072,3575881443,3575881466,23
3,1014,24073,3575881443,3575881467,24
3,1014,24074,3575881443,3575881467,24
3,1014,24075,3575881443,3575881467,24
3,1014,24076,3575881443,3575881468,25
3,1014,24077,3575881443,3575881471,28
3,1014,24078,3575881443,3575881476,33
3,1014,24079,3575881443,3575881477,34
3,1014,24080,3575881443,3575881480,37
3,1014,24081,3575881443,3575881481,38
3,1014,24082,3575881443,3575881481,38
3,1014,24083,3575881443,3575881482,39
3,1014,24084,3575881443,3575881482,39
3,1014,24085,3575881443,3575881483,40
3,1014,24086,3575881443,3575881483,40
3,1014,24087,3575881443,3575881483,40
3,1014,24088,3575881443,3575881484,41
3,1014,24089,3575881443,3575881486,43
3,1014,24090,3575881443,3575881486,43
3,1014,24091,3575881443,3575881486,43
3,1014,24092,3575881443,3575881487,44
3,1014,24093,3575881443,3575881487,44
3,1014,24094,3575881443,3575881488,45
3,1014,24095,3575881443,3575881489,46
3,1014,24096,3575881443,3575881489,46
3,1014,24097,3575881443,3575881490,47
3,1014,24098,3575881443,3575881492,49
3,1015,24099,3575881508,3575881508,0
3,1015,24100,3575881508,3575881508,0
3,1015,24101,3575881508,3575881508,0
3,1015,24102,3575881508,3575881508,0
3,1015,24103,3575881508,3575881508,0
3,1015,24104,3575881508,3575881508,0
3,1015,24105,3575881508,3575881508,0
3,1015,24106,3575881508,3575881508,0
3,1015,24107,3575881508,3575881508,0
3,1015,24108,3575881508,3575881509,1
3,1015,24109,3575881508,3575881509,1
3,1015,24110,3575881508,3575881509,1
3,1015,24111,3575881508,3575881509,1
3,1015,24112,3575881508,3575881509,1
3,1015,24113,3575881508,3575881509,1
3,1015,24114,3575881508,3575881509,1
3,1015,24115,3575881508,3575881509,1
3,1015,24116,3575881508,3575881511,3
3,1015,24117,3575881508,3575881512,4
3,1015,24118,3575881508,3575881512,4
3,1015,24119,3575881508,3575881512,4
3,1015,24120,3575881508,3575881513,5
3,1015,24121,3575881508,3575881516,8
3,1015,24122,3575881508,3575881517,9
3,1015,24123,3575881508,3575881518,10
3,1015,24124,3575881508,3575881518,10
3,1015,24125,3575881508,3575881520,12
3,1015,24126,3575881508,3575881520,12
3,1015,24127,3575881508,3575881521,13
3,1015,24128,3575881508,3575881521,13
3,1015,24129,3575881508,3575881523,15
3,1015,24130,3575881508,3575881523,15
3,1015,24131,3575881508,3575881525,17
3,1015,24132,3575881508,3575881526,18
3,1015,24133,3575881508,3575881526,18
3,1015,24134,3575881508,3575881527,19
3,1015,24135,3575881508,3575881528,20
3,1015,24136,3575881508,3575881531,23
3,1015,24137,3575881508,3575881532,24
3,1015,24138,3575881508,3575881533,25
3,1015,24139,3575881508,3575881534,26
3,1015,24140,3575881508,3575881534,26
3,1015,24141,3575881508,3575881535,27
3,1015,24142,3575881508,3575881536,28
3,1015,24143,3575881508,3575881537,29
3,1015,24144,3575881508,3575881541,33
3,1015,24145,3575881508,3575881543,35
3,1015,24146,3575881508,3575881543,35
3,1015,24147,3575881508,3575881544,36
3,1015,24148,3575881508,3575881545,37
3,1015,24149,3575881508,3575881546,38
3,1015,24150,3575881508,3575881551,43
3,1015,24151,3575881508,3575881552,44
3,1015,24152,3575881508,3575881552,44
3,1015,24153,3575881508,3575881553,45
3,1015,24154,3575881508,3575881553,45
3,1015,24155,3575881508,3575881558,50
3,1016,24156,3575881576,3575881576,0
3,1016,24157,3575881576,3575881576,0
3,1016,24158,3575881576,3575881576,0
3,1016,24159,3575881576,3575881576,0
3,1016,24160,3575881576,3575881576,0
3,1016,24161,3575881576,3575881576,0
3,1016,24162,3575881576,3575881576,0
3,1016,24163,3575881576,3575881576,0
3,1016,24164,3575881576,3575881576,0
3,1016,24165,3575881576,3575881576,0
3,1016,24166,3575881576,3575881576,0
3,1016,24167,3575881576,3575881576,0
3,1016,24168,3575881576,3575881576,0
3,1016,24169,3575881576,3575881577,1
3,1016,24170,3575881576,3575881578,2
3,1016,24171,3575881576,3575881578,2
3,1016,24172,3575881576,3575881580,4
3,1016,24173,3575881576,3575881580,4
3,1016,24174,3575881576,3575881580,4
3,1016,24175,3575881576,3575881581,5
3,1016,24176,3575881576,3575881582,6
3,1016,24177,3575881576,3575881583,7
3,1016,24178,3575881576,3575881585,9
3,1016,24179,3575881576,3575881586,10
3,1016,24180,3575881576,3575881586,10
3,1016,24181,3575881576,3575881592,16
3,1016,24182,3575881576,3575881593,17
3,1016,24183,3575881576,3575881593,17
3,1016,24184,3575881576,3575881593,17
3,1016,24185,3575881576,3575881595,19
3,1016,24186,3575881576,3575881595,19
3,1016,24187,3575881576,3575881595,19
3,1016,24188,3575881576,3575881595,19
3,1016,24189,3575881576,3575881596,20
3,1016,24190,3575881576,3575881596,20
3,1016,24191,3575881576,3575881597,21
3,1016,24192,3575881576,3575881597,21
3,1016,24193,3575881576,3575881598,22
3,1016,24194,3575881576,3575881599,23
3,1016,24195,3575881576,3575881600,24
3,1016,24196,3575881576,3575881601,25
3,1016,24197,3575881576,3575881601,25
3,1016,24198,3575881576,3575881602,26
3,1016,24199,3575881576,3575881602,26
3,1016,24200,3575881576,3575881603,27
3,1016,24201,3575881576,3575881604,28
3,1016,24202,3575881576,3575881604,28
3,1016,24203,3575881576,3575881605,29
3,1016,24204,3575881576,3575881606,30
3,1016,24205,3575881576,3575881610,34
3,1016,24206,3575881576,3575881615,39
3,1016,24207,3575881576,3575881616,40
3,1016,24208,3575881576,3575881617,41
3,1016,24209,3575881576,3575881619,43
3,1016,24210,3575881576,3575881620,44
3,1016,24211,3575881576,3575881620,44
3,1016,24212,3575881576,3575881620,44
3,1016,24213,3575881576,3575881620,44
3,1016,24214,3575881576,3575881621,45
3,1016,24215,3575881576,3575881624,48
3,1016,24216,3575881576,3575881625,49
3,1016,24217,3575881576,3575881625,49
3,1016,24218,3575881576,3575881626,50
3,1017,24219,3575881637,3575881637,0
3,1017,24220,3575881637,3575881637,0
3,1017,24221,3575881637,3575881637,0
3,1017,24222,3575881637,3575881637,0
3,1017,24223,3575881637,3575881637,0
3,1017,24224,3575881637,3575881637,0
3,1017,24225,3575881637,3575881637,0
3,1017,24226,3575881637,3575881637,0
3,1017,24227,3575881637,3575881637,0
3,1017,24228,3575881637,3575881637,0
3,1017,24229,3575881637,3575881637,0
3,1017,24230,3575881637,3575881637,0
3,1017,24231,3575881637,3575881637,0
3,1017,24232,3575881637,3575881637,0
3,1017,24233,3575881637,3575881637,0
3,1017,24234,3575881637,3575881637,0
3,1017,24235,3575881637,3575881638,1
3,1017,24236,3575881637,3575881638,1
3,1017,24237,3575881637,3575881640,3
3,1017,24238,3575881637,3575881640,3
3,1017,24239,3575881637,3575881640,3
3,1017,24240,3575881637,3575881643,6
3,1017,24241,3575881637,3575881643,6
3,1017,24242,3575881637,3575881644,7
3,1017,24243,3575881637,3575881644,7
3,1017,24244,3575881637,3575881645,8
3,1017,24245,3575881637,3575881645,8
3,1017,24246,3575881637,3575881646,9
3,1017,24247,3575881637,3575881648,11
3,1017,24248,3575881637,3575881648,11
3,1017,24249,3575881637,3575881649,12
3,1017,24250,3575881637,3575881652,15
3,1017,24251,3575881637,3575881652,15
3,1017,24252,3575881637,3575881653,16
3,1017,24253,3575881637,3575881654,17
3,1017,24254,3575881637,3575881655,18
3,1017,24255,3575881637,3575881657,20
3,1017,24256,3575881637,3575881659,22
3,1017,24257,3575881637,3575881659,22
3,1017,24258,3575881637,3575881659,22
3,1017,24259,3575881637,3575881660,23
3,1017,24260,3575881637,3575881662,25
3,1017,24261,3575881637,3575881662,25
3,1017,24262,3575881637,3575881663,26
3,1017,24263,3575881637,3575881664,27
3,1017,24264,3575881637,3575881664,27
3,1017,24265,3575881637,3575881665,28
3,1017,24266,3575881637,3575881665,28
3,1017,24267,3575881637,3575881665,28
3,1017,24268,3575881637,3575881667,30
3,1017,24269,3575881637,3575881667,30
3,1017,24270,3575881637,3575881667,30
3,1017,24271,3575881637,3575881671,34
3,1017,24272,3575881637,3575881674,37
3,1017,24273,3575881637,3575881675,38
3,1017,24274,3575881637,3575881676,39
3,1017,24275,3575881637,3575881680,43
3,1017,24276,3575881637,3575881681,44
3,1017,24277,3575881637,3575881681,44
3,1017,24278,3575881637,3575881682,45
3,1017,24279,3575881637,3575881682,45
3,1017,24280,3575881637,3575881683,46
3,1017,24281,3575881637,3575881683,46
3,1017,24282,3575881637,3575881683,46
3,1017,24283,3575881637,3575881685,48
3,1017,24284,3575881637,3575881685,48
3,1017,24285,3575881637,3575881686,49
3,1017,24286,3575881637,3575881686,49
3,1017,24287,3575881637,3575881686,49
3,1017,24288,3575881637,3575881687,50
3,1018,24289,3575881702,3575881702,0
3,1018,24290,3575881702,3575881702,0
3,1018,24291,3575881702,3575881702,0
3,1018,24292,3575881702,3575881702,0
3,1018,24293,3575881702,3575881702,0
3,1018,24294,3575881702,3575881702,0
3,1018,24295,3575881702,3575881702,0
3,1018,24296,3575881702,3575881702,0
3,1018,24297,3575881702,3575881702,0
3,1018,24298,3575881702,3575881702,0
3,1018,24299,3575881702,3575881702,0
3,1018,24300,3575881702,3575881702,0
3,1018,24301,3575881702,3575881702,0
3,1018,24302,3575881702,3575881703,1
3,1018,24303,3575881702,3575881703,1
3,1018,24304,3575881702,3575881704,2
3,1018,24305,3575881702,3575881704,2
3,1018,24306,3575881702,3575881706,4
3,1018,24307,3575881702,3575881706,4
3,1018,24308,3575881702,3575881707,5
3,1018,24309,3575881702,3575881707,5
3,1018,24310,3575881702,3575881711,9
3,1018,24311,3575881702,3575881711,9
3,1018,24312,3575881702,3575881711,9
3,1018,24313,3575881702,3575881712,10
3,1018,24314,3575881702,3575881712,10
3,1018,24315,3575881702,3575881717,15
3,1018,24316,3575881702,3575881718,16
3,1018,24317,3575881702,3575881718,16
3,1018,24318,3575881702,3575881720,18
3,1018,24319,3575881702,3575881720,18
3,1018,24320,3575881702,3575881721,19
3,1018,24321,3575881702,3575881721,19
3,1018,24322,3575881702,3575881723,21
3,1018,24323,3575881702,3575881723,21
3,1018,24324,3575881702,3575881725,23
3,1018,24325,3575881702,3575881726,24
3,1018,24326,3575881702,3575881727,25
3,1018,24327,3575881702,3575881728,26
3,1018,24328,3575881702,3575881728,26
3,1018,24329,3575881702,3575881731,29
3,1018,24330,3575881702,3575881731,29
3,1018,24331,3575881702,3575881734,32
3,1018,24332,3575881702,3575881734,32
3,1018,24333,3575881702,3575881734,32
3,1018,24334,3575881702,3575881735,33
3,1018,24335,3575881702,3575881736,34
3,1018,24336,3575881702,3575881737,35
3,1018,24337,3575881702,3575881740,38
3,1018,24338,3575881702,3575881742,40
3,1018,24339,3575881702,3575881744,42
3,1018,24340,3575881702,3575881744,42
3,1018,24341,3575881702,3575881745,43
3,1018,24342,3575881702,3575881746,44
3,1018,24343,3575881702,3575881751,49
3,1018,24344,3575881702,3575881751,49
3,1018,24345,3575881702,3575881751,49
3,1018,24346,3575881702,3575881752,50
3,1019,24347,3575881768,3575881768,0
3,1019,24348,3575881768,3575881768,0
3,1019,24349,3575881768,3575881768,0
3,1019,24350,3575881768,3575881768,0
3,1019,24351,3575881768,3575881768,0
3,1019,24352,3575881768,3575881768,0
3,1019,24353,3575881768,3575881768,0
3,1019,24354,3575881768,3575881768,0
3,1019,24355,3575881768,3575881769,1
3,1019,24356,3575881768,3575881769,1
3,1019,24357,3575881768,3575881770,2
3,1019,24358,3575881768,3575881770,2
3,1019,24359,3575881768,3575881773,5
3,1019,24360,3575881768,3575881777,9
3,1019,24361,3575881768,3575881777,9
3,1019,24362,3575881768,3575881778,10
3,1019,24363,3575881768,3575881778,10
3,1019,24364,3575881768,3575881779,11
3,1019,24365,3575881768,3575881780,12
3,1019,24366,3575881768,3575881780,12
3,1019,24367,3575881768,3575881781,13
3,1019,24368,3575881768,3575881782,14
3,1019,24369,3575881768,3575881783,15
3,1019,24370,3575881768,3575881785,17
3,1019,24371,3575881768,3575881785,17
3,1019,24372,3575881768,3575881786,18
3,1019,24373,3575881768,3575881786,18
3,1019,24374,3575881768,3575881792,24
3,1019,24375,3575881768,3575881793,25
3,1019,24376,3575881768,3575881793,25
3,1019,24377,3575881768,3575881794,26
3,1019,24378,3575881768,3575881794,26
3,1019,24379,3575881768,3575881795,27
3,1019,24380,3575881768,3575881795,27
3,1019,24381,3575881768,3575881795,27
3,1019,24382,3575881768,3575881796,28
3,1019,24383,3575881768,3575881796,28
3,1019,24384,3575881768,3575881797,29
3,1019,24385,3575881768,3575881798,30
3,1019,24386,3575881768,3575881798,30
3,1019,24387,3575881768,3575881799,31
3,1019,24388,3575881768,3575881800,32
3,1019,24389,3575881768,3575881800,32
3,1019,24390,3575881768,3575881801,33
3,1019,24391,3575881768,3575881802,34
3,1019,24392,3575881768,3575881802,34
3,1019,24393,3575881768,3575881803,35
3,1019,24394,3575881768,3575881804,36
3,1019,24395,3575881768,3575881804,36
3,1019,24396,3575881768,3575881804,36
3,1019,24397,3575881768,3575881805,37
3,1019,24398,3575881768,3575881807,39
3,1019,24399,3575881768,3575881810,42
3,1019,24400,3575881768,3575881815,47
3,1019,24401,3575881768,3575881817,49
3,1019,24402,3575881768,3575881817,49
3,1020,24403,3575881832,3575881832,0
3,1020,24404,3575881832,3575881832,0
3,1020,24405,3575881832,3575881832,0
3,1020,24406,3575881832,3575881832,0
3,1020,24407,3575881832,3575881832,0
3,1020,24408,3575881832,3575881832,0
3,1020,24409,3575881832,3575881832,0
3,1020,24410,3575881832,3575881832,0
3,1020,24411,3575881832,3575881832,0
3,1020,24412,3575881832,3575881832,0
3,1020,24413,3575881832,3575881832,0
3,1020,24414,3575881832,3575881832,0
3,1020,24415,3575881832,3575881832,0
3,1020,24416,3575881832,3575881832,0
3,1020,24417,3575881832,3575881832,0
3,1020,24418,3575881832,3575881832,0
3,1020,24419,3575881832,3575881832,0
3,1020,24420,3575881832,3575881832,0
3,1020,24421,3575881832,3575881833,1
3,1020,24422,3575881832,3575881834,2
3,1020,24423,3575881832,3575881835,3
3,1020,24424,3575881832,3575881836,4
3,1020,24425,3575881832,3575881837,5
3,1020,24426,3575881832,3575881837,5
3,1020,24427,3575881832,3575881837,5
3,1020,24428,3575881832,3575881838,6
3,1020,24429,3575881832,3575881838,6
3,1020,24430,3575881832,3575881839,7
3,1020,24431,3575881832,3575881839,7
3,1020,24432,3575881832,3575881839,7
3,1020,24433,3575881832,3575881841,9
3,1020,24434,3575881832,3575881843,11
3,1020,24435,3575881832,3575881843,11
3,1020,24436,3575881832,3575881843,11
3,1020,24437,3575881832,3575881843,11
3,1020,24438,3575881832,3575881844,12
3,1020,24439,3575881832,3575881846,14
3,1020,24440,3575881832,3575881846,14
3,1020,24441,3575881832,3575881846,14
3,1020,24442,3575881832,3575881848,16
3,1020,24443,3575881832,3575881849,17
3,1020,24444,3575881832,3575881849,17
3,1020,24445,3575881832,3575881852,20
3,1020,24446,3575881832,3575881852,20
3,1020,24447,3575881832,3575881853,21
3,1020,24448,3575881832,3575881854,22
3,1020,24449,3575881832,3575881857,25
3,1020,24450,3575881832,3575881859,27
3,1020,24451,3575881832,3575881859,27
3,1020,24452,3575881832,3575881860,28
3,1020,24453,3575881832,3575881860,28
3,1020,24454,3575881832,3575881862,30
3,1020,24455,3575881832,3575881863,31
3,1020,24456,3575881832,3575881863,31
3,1020,24457,3575881832,3575881864,32
3,1020,24458,3575881832,3575881865,33
3,1020,24459,3575881832,3575881865,33
3,1020,24460,3575881832,3575881865,33
3,1020,24461,3575881832,3575881866,34
3,1020,24462,3575881832,3575881867,35
3,1020,24463,3575881832,3575881867,35
3,1020,24464,3575881832,3575881867,35
3,1020,24465,3575881832,3575881867,35
3,1020,24466,3575881832,3575881873,41
3,1020,24467,3575881832,3575881875,43
3,1020,24468,3575881832,3575881876,44
3,1020,24469,3575881832,3575881881,49
3,1020,24470,3575881832,3575881881,49
3,1020,24471,3575881832,3575881881,49
3,1020,24472,3575881832,3575881882,50
3,1021,24473,3575881897,3575881897,0
3,1021,24474,3575881897,3575881897,0
3,1021,24475,3575881897,3575881897,0
3,1021,24476,3575881897,3575881897,0
3,1021,24477,3575881897,3575881897,0
3,1021,24478,3575881897,3575881897,0
3,1021,24479,3575881897,3575881897,0
3,1021,24480,3575881897,3575881897,0
3,1021,24481,3575881897,3575881897,0
3,1021,24482,3575881897,3575881897,0
3,1021,24483,3575881897,3575881897,0
3,1021,24484,3575881897,3575881897,0
3,1021,24485,3575881897,3575881897,0
3,1021,24486,3575881897,3575881897,0
3,1021,24487,3575881897,3575881897,0
3,1021,24488,3575881897,3575881897,0
3,1021,24489,3575881897,3575881897,0
3,1021,24490,3575881897,3575881897,0
3,1021,24491,3575881897,3575881898,1
3,1021,24492,3575881897,3575881899,2
3,1021,24493,3575881897,3575881899,2
3,1021,24494,3575881897,3575881901,4
3,1021,24495,3575881897,3575881902,5
3,1021,24496,3575881897,3575881903,6
3,1021,24497,3575881897,3575881904,7
3,1021,24498,3575881897,3575881906,9
3,1021,24499,3575881897,3575881907,10
3,1021,24500,3575881897,3575881907,10
3,1021,24501,3575881897,3575881907,10
3,1021,24502,3575881897,3575881910,13
3,1021,24503,3575881897,3575881911,14
3,1021,24504,3575881897,3575881912,15
3,1021,24505,3575881897,3575881912,15
3,1021,24506,3575881897,3575881913,16
3,1021,24507,3575881897,3575881916,19
3,1021,24508,3575881897,3575881917,20
3,1021,24509,3575881897,3575881918,21
3,1021,24510,3575881897,3575881918,21
3,1021,24511,3575881897,3575881920,23
3,1021,24512,3575881897,3575881920,23
3,1021,24513,3575881897,3575881922,25
3,1021,24514,3575881897,3575881923,26
3,1021,24515,3575881897,3575881924,27
3,1021,24516,3575881897,3575881925,28
3,1021,24517,3575881897,3575881926,29
3,1021,24518,3575881897,3575881927,30
3,1021,24519,3575881897,3575881927,30
3,1021,24520,3575881897,3575881928,31
3,1021,24521,3575881897,3575881931,34
3,1021,24522,3575881897,3575881931,34
3,1021,24523,3575881897,3575881935,38
3,1021,24524,3575881897,3575881935,38
3,1021,24525,3575881897,3575881935,38
3,1021,24526,3575881897,3575881935,38
3,1021,24527,3575881897,3575881937,40
3,1021,24528,3575881897,3575881937,40
3,1021,24529,3575881897,3575881941,44
3,1021,24530,3575881897,3575881943,46
3,1021,24531,3575881897,3575881943,46
3,1021,24532,3575881897,3575881944,47
3,1021,24533,3575881897,3575881945,48
3,1021,24534,3575881897,3575881946,49
3,1022,24535,3575881960,3575881960,0
3,1022,24536,3575881960,3575881960,0
3,1022,24537,3575881960,3575881960,0
3,1022,24538,3575881960,3575881960,0
3,1022,24539,3575881960,3575881960,0
3,1022,24540,3575881960,3575881960,0
3,1022,24541,3575881960,3575881960,0
3,1022,24542,3575881960,3575881961,1
3,1022,24543,3575881960,3575881963,3
3,1022,24544,3575881960,3575881963,3
3,1022,24545,3575881960,3575881964,4
3,1022,24546,3575881960,3575881968,8
3,1022,24547,3575881960,3575881968,8
3,1022,24548,3575881960,3575881969,9
3,1022,24549,3575881960,3575881970,10
3,1022,24550,3575881960,3575881970,10
3,1022,24551,3575881960,3575881972,12
3,1022,24552,3575881960,3575881972,12
3,1022,24553,3575881960,3575881977,17
3,1022,24554,3575881960,3575881977,17
3,1022,24555,3575881960,3575881978,18
3,1022,24556,3575881960,3575881978,18
3,1022,24557,3575881960,3575881979,19
3,1022,24558,3575881960,3575881980,20
3,1022,24559,3575881960,3575881981,21
3,1022,24560,3575881960,3575881981,21
3,1022,24561,3575881960,3575881981,21
3,1022,24562,3575881960,3575881982,22
3,1022,24563,3575881960,3575881985,25
3,1022,24564,3575881960,3575881986,26
3,1022,24565,3575881960,3575881986,26
3,1022,24566,3575881960,3575881987,27
3,1022,24567,3575881960,3575881992,32
3,1022,24568,3575881960,3575881992,32
3,1022,24569,3575881960,3575881993,33
3,1022,24570,3575881960,3575881993,33
3,1022,24571,3575881960,3575881995,35
3,1022,24572,3575881960,3575881995,35
3,1022,24573,3575881960,3575881995,35
3,1022,24574,3575881960,3575881995,35
3,1022,24575,3575881960,3575881996,36
3,1022,24576,3575881960,3575881997,37
3,1022,24577,3575881960,3575881998,38
3,1022,24578,3575881960,3575881998,38
3,1022,24579,3575881960,3575881998,38
3,1022,24580,3575881960,3575882000,40
3,1022,24581,3575881960,3575882001,41
3,1022,24582,3575881960,3575882001,41
3,1022,24583,3575881960,3575882002,42
3,1022,24584,3575881960,3575882002,42
3,1022,24585,3575881960,3575882003,43
3,1022,24586,3575881960,3575882003,43
3,1022,24587,3575881960,3575882004,44
3,1022,24588,3575881960,3575882004,44
3,1022,24589,3575881960,3575882004,44
3,1022,24590,3575881960,3575882007,47
3,1023,24591,3575882028,3575882028,0
3,1023,24592,3575882028,3575882028,0
3,1023,24593,3575882028,3575882028,0
3,1023,24594,3575882028,3575882028,0
3,1023,24595,3575882028,3575882028,0
3,1023,24596,3575882028,3575882029,1
3,1023,24597,3575882028,3575882029,1
3,1023,24598,3575882028,3575882029,1
3,1023,24599,3575882028,3575882029,1
3,1023,24600,3575882028,3575882029,1
3,1023,24601,3575882028,3575882029,1
3,1023,24602,3575882028,3575882029,1
3,1023,24603,3575882028,3575882029,1
3,1023,24604,3575882028,3575882029,1
3,1023,24605,3575882028,3575882029,1
3,1023,24606,3575882028,3575882029,1
3,1023,24607,3575882028,3575882029,1
3,1023,24608,3575882028,3575882029,1
3,1023,24609,3575882028,3575882029,1
3,1023,24610,3575882028,3575882030,2
3,1023,24611,3575882028,3575882031,3
3,1023,24612,3575882028,3575882032,4
3,1023,24613,3575882028,3575882033,5
3,1023,24614,3575882028,3575882034,6
3,1023,24615,3575882028,3575882034,6
3,1023,24616,3575882028,3575882036,8
3,1023,24617,3575882028,3575882037,9
3,1023,24618,3575882028,3575882037,9
3,1023,24619,3575882028,3575882038,10
3,1023,24620,3575882028,3575882038,10
3,1023,24621,3575882028,3575882038,10
3,1023,24622,3575882028,3575882039,11
3,1023,24623,3575882028,3575882039,11
3,1023,24624,3575882028,3575882040,12
3,1023,24625,3575882028,3575882041,13
3,1023,24626,3575882028,3575882043,15
3,1023,24627,3575882028,3575882043,15
3,1023,24628,3575882028,3575882043,15
3,1023,24629,3575882028,3575882044,16
3,1023,24630,3575882028,3575882046,18
3,1023,24631,3575882028,3575882046,18
3,1023,24632,3575882028,3575882047,19
3,1023,24633,3575882028,3575882048,20
3,1023,24634,3575882028,3575882049,21
3,1023,24635,3575882028,3575882050,22
3,1023,24636,3575882028,3575882052,24
3,1023,24637,3575882028,3575882053,25
3,1023,24638,3575882028,3575882053,25
3,1023,24639,3575882028,3575882055,27
3,1023,24640,3575882028,3575882058,30
3,1023,24641,3575882028,3575882059,31
3,1023,24642,3575882028,3575882060,32
3,1023,24643,3575882028,3575882060,32
3,1023,24644,3575882028,3575882060,32
3,1023,24645,3575882028,3575882063,35
3,1023,24646,3575882028,3575882064,36
3,1023,24647,3575882028,3575882065,37
3,1023,24648,3575882028,3575882065,37
3,1023,24649,3575882028,3575882065,37
3,1023,24650,3575882028,3575882066,38
3,1023,24651,3575882028,3575882067,39
3,1023,24652,3575882028,3575882067,39
3,1023,24653,3575882028,3575882068,40
3,1023,24654,3575882028,3575882071,43
3,1023,24655,3575882028,3575882076,48
3,1023,24656,3575882028,3575882076,48
3,1024,24657,3575882092,3575882092,0
3,1024,24658,3575882092,3575882092,0
3,1024,24659,3575882092,3575882092,0
3,1024,24660,3575882092,3575882092,0
3,1024,24661,3575882092,3575882092,0
3,1024,24662,3575882092,3575882092,0
3,1024,24663,3575882092,3575882092,0
3,1024,24664,3575882092,3575882092,0
3,1024,24665,3575882092,3575882092,0
3,1024,24666,3575882092,3575882092,0
3,1024,24667,3575882092,3575882092,0
3,1024,24668,3575882092,3575882092,0
3,1024,24669,3575882092,3575882092,0
3,1024,24670,3575882092,3575882092,0
3,1024,24671,3575882092,3575882092,0
3,1024,24672,3575882092,3575882092,0
3,1024,24673,3575882092,3575882092,0
3,1024,24674,3575882092,3575882095,3
3,1024,24675,3575882092,3575882096,4
3,1024,24676,3575882092,3575882096,4
3,1024,24677,3575882092,3575882098,6
3,1024,24678,3575882092,3575882099,7
3,1024,24679,3575882092,3575882100,8
3,1024,24680,3575882092,3575882101,9
3,1024,24681,3575882092,3575882102,10
3,1024,24682,3575882092,3575882103,11
3,1024,24683,3575882092,3575882103,11
3,1024,24684,3575882092,3575882104,12
3,1024,24685,3575882092,3575882105,13
3,1024,24686,3575882092,3575882106,14
3,1024,24687,3575882092,3575882106,14
3,1024,24688,3575882092,3575882107,15
3,1024,24689,3575882092,3575882108,16
3,1024,24690,3575882092,3575882112,20
3,1024,24691,3575882092,3575882112,20
3,1024,24692,3575882092,3575882112,20
3,1024,24693,3575882092,3575882113,21
3,1024,24694,3575882092,3575882117,25
3,1024,24695,3575882092,3575882117,25
3,1024,24696,3575882092,3575882118,26
3,1024,24697,3575882092,3575882118,26
3,1024,24698,3575882092,3575882120,28
3,1024,24699,3575882092,3575882121,29
3,1024,24700,3575882092,3575882121,29
3,1024,24701,3575882092,3575882121,29
3,1024,24702,3575882092,3575882123,31
3,1024,24703,3575882092,3575882124,32
3,1024,24704,3575882092,3575882125,33
3,1024,24705,3575882092,3575882127,35
3,1024,24706,3575882092,3575882127,35
3,1024,24707,3575882092,3575882127,35
3,1024,24708,3575882092,3575882128,36
3,1024,24709,3575882092,3575882131,39
3,1024,24710,3575882092,3575882134,42
3,1024,24711,3575882092,3575882134,42
3,1024,24712,3575882092,3575882135,43
3,1024,24713,3575882092,3575882136,44
3,1024,24714,3575882092,3575882137,45
3,1024,24715,3575882092,3575882137,45
3,1024,24716,3575882092,3575882141,49
3,1025,24717,3575882156,3575882156,0
3,1025,24718,3575882156,3575882156,0
3,1025,24719,3575882156,3575882156,0
3,1025,24720,3575882156,3575882156,0
3,1025,24721,3575882156,3575882156,0
3,1025,24722,3575882156,3575882156,0
3,1025,24723,3575882156,3575882156,0
3,1025,24724,3575882156,3575882156,0
3,1025,24725,3575882156,3575882156,0
3,1025,24726,3575882156,3575882156,0
3,1025,24727,3575882156,3575882156,0
3,1025,24728,3575882156,3575882159,3
3,1025,24729,3575882156,3575882161,5
3,1025,24730,3575882156,3575882163,7
3,1025,24731,3575882156,3575882164,8
3,1025,24732,3575882156,3575882164,8
3,1025,24733,3575882156,3575882168,12
3,1025,24734,3575882156,3575882169,13
3,1025,24735,3575882156,3575882169,13
3,1025,24736,3575882156,3575882170,14
3,1025,24737,3575882156,3575882170,14
3,1025,24738,3575882156,3575882172,16
3,1025,24739,3575882156,3575882173,17
3,1025,24740,3575882156,3575882174,18
3,1025,24741,3575882156,3575882177,21
3,1025,24742,3575882156,3575882178,22
3,1025,24743,3575882156,3575882179,23
3,1025,24744,3575882156,3575882180,24
3,1025,24745,3575882156,3575882180,24
3,1025,24746,3575882156,3575882181,25
3,1025,24747,3575882156,3575882181,25
3,1025,24748,3575882156,3575882181,25
3,1025,24749,3575882156,3575882182,26
3,1025,24750,3575882156,3575882186,30
3,1025,24751,3575882156,3575882187,31
3,1025,24752,3575882156,3575882188,32
3,1025,24753,3575882156,3575882192,36
3,1025,24754,3575882156,3575882192,36
3,1025,24755,3575882156,3575882193,37
3,1025,24756,3575882156,3575882193,37
3,1025,24757,3575882156,3575882194,38
3,1025,24758,3575882156,3575882195,39
3,1025,24759,3575882156,3575882195,39
3,1025,24760,3575882156,3575882196,40
3,1025,24761,3575882156,3575882196,40
3,1025,24762,3575882156,3575882197,41
3,1025,24763,3575882156,3575882197,41
3,1025,24764,3575882156,3575882198,42
3,1025,24765,3575882156,3575882200,44
3,1025,24766,3575882156,3575882201,45
3,1025,24767,3575882156,3575882202,46
3,1025,24768,3575882156,3575882202,46
3,1025,24769,3575882156,3575882203,47
3,1025,24770,3575882156,3575882203,47
3,1025,24771,3575882156,3575882204,48
3,1025,24772,3575882156,3575882204,48
3,1025,24773,3575882156,3575882205,49
3,1026,24774,3575882219,3575882219,0
3,1026,24775,3575882219,3575882219,0
3,1026,24776,3575882219,3575882219,0
3,1026,24777,3575882219,3575882219,0
3,1026,24778,3575882219,3575882219,0
3,1026,24779,3575882219,3575882221,2
3,1026,24780,3575882219,3575882223,4
3,1026,24781,3575882219,3575882223,4
3,1026,24782,3575882219,3575882223,4
3,1026,24783,3575882219,3575882223,4
3,1026,24784,3575882219,3575882225,6
3,1026,24785,3575882219,3575882225,6
3,1026,24786,3575882219,3575882225,6
3,1026,24787,3575882219,3575882225,6
3,1026,24788,3575882219,3575882227,8
3,1026,24789,3575882219,3575882228,9
3,1026,24790,3575882219,3575882229,10
3,1026,24791,3575882219,3575882229,10
3,1026,24792,3575882219,3575882230,11
3,1026,24793,3575882219,3575882230,11
3,1026,24794,3575882219,3575882230,11
3,1026,24795,3575882219,3575882232,13
3,1026,24796,3575882219,3575882233,14
3,1026,24797,3575882219,3575882234,15
3,1026,24798,3575882219,3575882237,18
3,1026,24799,3575882219,3575882238,19
3,1026,24800,3575882219,3575882238,19
3,1026,24801,3575882219,3575882239,20
3,1026,24802,3575882219,3575882239,20
3,1026,24803,3575882219,3575882239,20
3,1026,24804,3575882219,3575882240,21
3,1026,24805,3575882219,3575882241,22
3,1026,24806,3575882219,3575882241,22
3,1026,24807,3575882219,3575882243,24
3,1026,24808,3575882219,3575882244,25
3,1026,24809,3575882219,3575882244,25
3,1026,24810,3575882219,3575882245,26
3,1026,24811,3575882219,3575882246,27
3,1026,24812,3575882219,3575882247,28
3,1026,24813,3575882219,3575882248,29
3,1026,24814,3575882219,3575882249,30
3,1026,24815,3575882219,3575882250,31
3,1026,24816,3575882219,3575882252,33
3,1026,24817,3575882219,3575882252,33
3,1026,24818,3575882219,3575882254,35
3,1026,24819,3575882219,3575882254,35
3,1026,24820,3575882219,3575882258,39
3,1026,24821,3575882219,3575882259,40
3,1026,24822,3575882219,3575882259,40
3,1026,24823,3575882219,3575882259,40
3,1026,24824,3575882219,3575882259,40
3,1026,24825,3575882219,3575882260,41
3,1026,24826,3575882219,3575882263,44
3,1026,24827,3575882219,3575882264,45
3,1026,24828,3575882219,3575882264,45
3,1026,24829,3575882219,3575882265,46
3,1026,24830,3575882219,3575882266,47
3,1026,24831,3575882219,3575882267,48
3,1026,24832,3575882219,3575882267,48
3,1026,24833,3575882219,3575882267,48
3,1026,24834,3575882219,3575882267,48
3,1027,24835,3575882288,3575882289,1
3,1027,24836,3575882288,3575882289,1
3,1027,24837,3575882288,3575882289,1
3,1027,24838,3575882288,3575882289,1
3,1027,24839,3575882288,3575882289,1
3,1027,24840,3575882288,3575882289,1
3,1027,24841,3575882288,3575882289,1
3,1027,24842,3575882288,3575882289,1
3,1027,24843,3575882288,3575882289,1
3,1027,24844,3575882288,3575882289,1
3,1027,24845,3575882288,3575882289,1
3,1027,24846,3575882288,3575882289,1
3,1027,24847,3575882288,3575882289,1
3,1027,24848,3575882288,3575882289,1
3,1027,24849,3575882288,3575882289,1
3,1027,24850,3575882288,3575882290,2
3,1027,24851,3575882288,3575882291,3
3,1027,24852,3575882288,3575882294,6
3,1027,24853,3575882288,3575882295,7
3,1027,24854,3575882288,3575882296,8
3,1027,24855,3575882288,3575882297,9
3,1027,24856,3575882288,3575882297,9
3,1027,24857,3575882288,3575882298,10
3,1027,24858,3575882288,3575882300,12
3,1027,24859,3575882288,3575882300,12
3,1027,24860,3575882288,3575882301,13
3,1027,24861,3575882288,3575882302,14
3,1027,24862,3575882288,3575882302,14
3,1027,24863,3575882288,3575882303,15
3,1027,24864,3575882288,3575882305,17
3,1027,24865,3575882288,3575882305,17
3,1027,24866,3575882288,3575882306,18
3,1027,24867,3575882288,3575882307,19
3,1027,24868,3575882288,3575882307,19
3,1027,24869,3575882288,3575882307,19
3,1027,24870,3575882288,3575882310,22
3,1027,24871,3575882288,3575882312,24
3,1027,24872,3575882288,3575882312,24
3,1027,24873,3575882288,3575882312,24
3,1027,24874,3575882288,3575882313,25
3,1027,24875,3575882288,3575882317,29
3,1027,24876,3575882288,3575882317,29
3,1027,24877,3575882288,3575882318,30
3,1027,24878,3575882288,3575882318,30
3,1027,24879,3575882288,3575882320,32
3,1027,24880,3575882288,3575882321,33
3,1027,24881,3575882288,3575882321,33
3,1027,24882,3575882288,3575882321,33
3,1027,24883,3575882288,3575882323,35
3,1027,24884,3575882288,3575882323,35
3,1027,24885,3575882288,3575882326,38
3,1027,24886,3575882288,3575882327,39
3,1027,24887,3575882288,3575882328,40
3,1027,24888,3575882288,3575882328,40
3,1027,24889,3575882288,3575882329,41
3,1027,24890,3575882288,3575882331,43
3,1027,24891,3575882288,3575882331,43
3,1027,24892,3575882288,3575882334,46
3,1027,24893,3575882288,3575882335,47
3,1027,24894,3575882288,3575882335,47
3,1027,24895,3575882288,3575882337,49
3,1028,24896,3575882351,3575882351,0
3,1028,24897,3575882351,3575882351,0
3,1028,24898,3575882351,3575882351,0
3,1028,24899,3575882351,3575882351,0
3,1028,24900,3575882351,3575882351,0
3,1028,24901,3575882351,3575882351,0
3,1028,24902,3575882351,3575882351,0
3,1028,24903,3575882351,3575882351,0
3,1028,24904,3575882351,3575882352,1
3,1028,24905,3575882351,3575882353,2
3,1028,24906,3575882351,3575882354,3
3,1028,24907,3575882351,3575882355,4
3,1028,24908,3575882351,3575882357,6
3,1028,24909,3575882351,3575882360,9
3,1028,24910,3575882351,3575882361,10
3,1028,24911,3575882351,3575882363,12
3,1028,24912,3575882351,3575882365,14
3,1028,24913,3575882351,3575882365,14
3,1028,24914,3575882351,3575882368,17
3,1028,24915,3575882351,3575882369,18
3,1028,24916,3575882351,3575882369,18
3,1028,24917,3575882351,3575882371,20
3,1028,24918,3575882351,3575882371,20
3,1028,24919,3575882351,3575882372,21
3,1028,24920,3575882351,3575882373,22
3,1028,24921,3575882351,3575882376,25
3,1028,24922,3575882351,3575882377,26
3,1028,24923,3575882351,3575882377,26
3,1028,24924,3575882351,3575882379,28
3,1028,24925,3575882351,3575882380,29
3,1028,24926,3575882351,3575882380,29
3,1028,24927,3575882351,3575882381,30
3,1028,24928,3575882351,3575882381,30
3,1028,24929,3575882351,3575882381,30
3,1028,24930,3575882351,3575882381,30
3,1028,24931,3575882351,3575882384,33
3,1028,24932,3575882351,3575882386,35
3,1028,24933,3575882351,3575882386,35
3,1028,24934,3575882351,3575882387,36
3,1028,24935,3575882351,3575882387,36
3,1028,24936,3575882351,3575882392,41
3,1028,24937,3575882351,3575882393,42
3,1028,24938,3575882351,3575882393,42
3,1028,24939,3575882351,3575882394,43
3,1028,24940,3575882351,3575882395,44
3,1028,24941,3575882351,3575882395,44
3,1028,24942,3575882351,3575882395,44
3,1028,24943,3575882351,3575882396,45
3,1028,24944,3575882351,3575882397,46
3,1028,24945,3575882351,3575882397,46
3,1028,24946,3575882351,3575882398,47
3,1028,24947,3575882351,3575882400,49
3,1028,24948,3575882351,3575882400,49
3,1028,24949,3575882351,3575882401,50
3,1029,24950,3575882413,3575882413,0
3,1029,24951,3575882413,3575882413,0
3,1029,24952,3575882413,3575882413,0
3,1029,24953,3575882413,3575882413,0
3,1029,24954,3575882413,3575882413,0
3,1029,24955,3575882413,3575882413,0
3,1029,24956,3575882413,3575882413,0
3,1029,24957,3575882413,3575882413,0
3,1029,24958,3575882413,3575882415,2
3,1029,24959,3575882413,3575882417,4
3,1029,24960,3575882413,3575882418,5
3,1029,24961,3575882413,3575882419,6
3,1029,24962,3575882413,3575882421,8
3,1029,24963,3575882413,3575882422,9
3,1029,24964,3575882413,3575882422,9
3,1029,24965,3575882413,3575882423,10
3,1029,24966,3575882413,3575882425,12
3,1029,24967,3575882413,3575882425,12
3,1029,24968,3575882413,3575882426,13
3,1029,24969,3575882413,3575882426,13
3,1029,24970,3575882413,3575882426,13
3,1029,24971,3575882413,3575882428,15
3,1029,24972,3575882413,3575882428,15
3,1029,24973,3575882413,3575882429,16
3,1029,24974,3575882413,3575882430,17
3,1029,24975,3575882413,3575882430,17
3,1029,24976,3575882413,3575882431,18
3,1029,24977,3575882413,3575882432,19
3,1029,24978,3575882413,3575882433,20
3,1029,24979,3575882413,3575882433,20
3,1029,24980,3575882413,3575882435,22
3,1029,24981,3575882413,3575882435,22
3,1029,24982,3575882413,3575882436,23
3,1029,24983,3575882413,3575882437,24
3,1029,24984,3575882413,3575882438,25
3,1029,24985,3575882413,3575882438,25
3,1029,24986,3575882413,3575882439,26
3,1029,24987,3575882413,3575882440,27
3,1029,24988,3575882413,3575882441,28
3,1029,24989,3575882413,3575882441,28
3,1029,24990,3575882413,3575882443,30
3,1029,24991,3575882413,3575882444,31
3,1029,24992,3575882413,3575882444,31
3,1029,24993,3575882413,3575882445,32
3,1029,24994,3575882413,3575882446,33
3,1029,24995,3575882413,3575882448,35
3,1029,24996,3575882413,3575882448,35
3,1029,24997,3575882413,3575882449,36
3,1029,24998,3575882413,3575882450,37
3,1029,24999,3575882413,3575882452,39
3,1029,25000,3575882413,3575882453,40
3,1029,25001,3575882413,3575882454,41
3,1029,25002,3575882413,3575882455,42
3,1029,25003,3575882413,3575882455,42
3,1029,25004,3575882413,3575882458,45
3,1029,25005,3575882413,3575882459,46
3,1029,25006,3575882413,3575882459,46
3,1029,25007,3575882413,3575882459,46
3,1029,25008,3575882413,3575882459,46
3,1029,25009,3575882413,3575882459,46
3,1029,25010,3575882413,3575882463,50
3,1030,25011,3575882478,3575882478,0
3,1030,25012,3575882478,3575882478,0
3,1030,25013,3575882478,3575882478,0
3,1030,25014,3575882478,3575882478,0
3,1030,25015,3575882478,3575882478,0
3,1030,25016,3575882478,3575882478,0
3,1030,25017,3575882478,3575882478,0
3,1030,25018,3575882478,3575882478,0
3,1030,25019,3575882478,3575882478,0
3,1030,25020,3575882478,3575882478,0
3,1030,25021,3575882478,3575882478,0
3,1030,25022,3575882478,3575882478,0
3,1030,25023,3575882478,3575882481,3
3,1030,25024,3575882478,3575882482,4
3,1030,25025,3575882478,3575882483,5
3,1030,25026,3575882478,3575882484,6
3,1030,25027,3575882478,3575882485,7
3,1030,25028,3575882478,3575882486,8
3,1030,25029,3575882478,3575882487,9
3,1030,25030,3575882478,3575882488,10
3,1030,25031,3575882478,3575882488,10
3,1030,25032,3575882478,3575882489,11
3,1030,25033,3575882478,3575882490,12
3,1030,25034,3575882478,3575882490,12
3,1030,25035,3575882478,3575882490,12
3,1030,25036,3575882478,3575882494,16
3,1030,25037,3575882478,3575882496,18
3,1030,25038,3575882478,3575882496,18
3,1030,25039,3575882478,3575882497,19
3,1030,25040,3575882478,3575882497,19
3,1030,25041,3575882478,3575882498,20
3,1030,25042,3575882478,3575882500,22
3,1030,25043,3575882478,3575882500,22
3,1030,25044,3575882478,3575882501,23
3,1030,25045,3575882478,3575882502,24
3,1030,25046,3575882478,3575882503,25
3,1030,25047,3575882478,3575882503,25
3,1030,25048,3575882478,3575882505,27
3,1030,25049,3575882478,3575882505,27
3,1030,25050,3575882478,3575882506,28
3,1030,25051,3575882478,3575882506,28
3,1030,25052,3575882478,3575882507,29
3,1030,25053,3575882478,3575882508,30
3,1030,25054,3575882478,3575882511,33
3,1030,25055,3575882478,3575882512,34
3,1030,25056,3575882478,3575882512,34
3,1030,25057,3575882478,3575882513,35
3,1030,25058,3575882478,3575882516,38
3,1030,25059,3575882478,3575882517,39
3,1030,25060,3575882478,3575882517,39
3,1030,25061,3575882478,3575882518,40
3,1030,25062,3575882478,3575882519,41
3,1030,25063,3575882478,3575882520,42
3,1030,25064,3575882478,3575882520,42
3,1030,25065,3575882478,3575882521,43
3,1030,25066,3575882478,3575882521,43
3,1030,25067,3575882478,3575882523,45
3,1030,25068,3575882478,3575882523,45
3,1030,25069,3575882478,3575882526,48
3,1030,25070,3575882478,3575882527,49
3,1030,25071,3575882478,3575882528,50
3,1031,25072,3575882544,3575882544,0
3,1031,25073,3575882544,3575882544,0
3,1031,25074,3575882544,3575882544,0
3,1031,25075,3575882544,3575882544,0
3,1031,25076,3575882544,3575882544,0
3,1031,25077,3575882544,3575882544,0
3,1031,25078,3575882544,3575882544,0
3,1031,25079,3575882544,3575882544,0
3,1031,25080,3575882544,3575882544,0
3,1031,25081,3575882544,3575882544,0
3,1031,25082,3575882544,3575882544,0
3,1031,25083,3575882544,3575882544,0
3,1031,25084,3575882544,3575882544,0
3,1031,25085,3575882544,3575882544,0
3,1031,25086,3575882544,3575882545,1
3,1031,25087,3575882544,3575882550,6
3,1031,25088,3575882544,3575882551,7
3,1031,25089,3575882544,3575882554,10
3,1031,25090,3575882544,3575882554,10
3,1031,25091,3575882544,3575882556,12
3,1031,25092,3575882544,3575882558,14
3,1031,25093,3575882544,3575882560,16
3,1031,25094,3575882544,3575882562,18
3,1031,25095,3575882544,3575882564,20
3,1031,25096,3575882544,3575882565,21
3,1031,25097,3575882544,3575882565,21
3,1031,25098,3575882544,3575882567,23
3,1031,25099,3575882544,3575882568,24
3,1031,25100,3575882544,3575882569,25
3,1031,25101,3575882544,3575882570,26
3,1031,25102,3575882544,3575882570,26
3,1031,25103,3575882544,3575882570,26
3,1031,25104,3575882544,3575882575,31
3,1031,25105,3575882544,3575882576,32
3,1031,25106,3575882544,3575882577,33
3,1031,25107,3575882544,3575882578,34
3,1031,25108,3575882544,3575882578,34
3,1031,25109,3575882544,3575882579,35
3,1031,25110,3575882544,3575882579,35
3,1031,25111,3575882544,3575882580,36
3,1031,25112,3575882544,3575882581,37
3,1031,25113,3575882544,3575882581,37
3,1031,25114,3575882544,3575882582,38
3,1031,25115,3575882544,3575882585,41
3,1031,25116,3575882544,3575882585,41
3,1031,25117,3575882544,3575882586,42
3,1031,25118,3575882544,3575882587,43
3,1031,25119,3575882544,3575882591,47
3,1031,25120,3575882544,3575882592,48
3,1031,25121,3575882544,3575882593,49
3,1031,25122,3575882544,3575882594,50
3,1032,25123,3575882615,3575882615,0
3,1032,25124,3575882615,3575882615,0
3,1032,25125,3575882615,3575882615,0
3,1032,25126,3575882615,3575882615,0
3,1032,25127,3575882615,3575882615,0
3,1032,25128,3575882615,3575882615,0
3,1032,25129,3575882615,3575882615,0
3,1032,25130,3575882615,3575882615,0
3,1032,25131,3575882615,3575882615,0
3,1032,25132,3575882615,3575882615,0
3,1032,25133,3575882615,3575882615,0
3,1032,25134,3575882615,3575882615,0
3,1032,25135,3575882615,3575882615,0
3,1032,25136,3575882615,3575882615,0
3,1032,25137,3575882615,3575882615,0
3,1032,25138,3575882615,3575882615,0
3,1032,25139,3575882615,3575882615,0
3,1032,25140,3575882615,3575882615,0
3,1032,25141,3575882615,3575882615,0
3,1032,25142,3575882615,3575882615,0
3,1032,25143,3575882615,3575882615,0
3,1032,25144,3575882615,3575882615,0
3,1032,25145,3575882615,3575882615,0
3,1032,25146,3575882615,3575882616,1
3,1032,25147,3575882615,3575882618,3
3,1032,25148,3575882615,3575882618,3
3,1032,25149,3575882615,3575882619,4
3,1032,25150,3575882615,3575882621,6
3,1032,25151,3575882615,3575882621,6
3,1032,25152,3575882615,3575882622,7
3,1032,25153,3575882615,3575882623,8
3,1032,25154,3575882615,3575882624,9
3,1032,25155,3575882615,3575882624,9
3,1032,25156,3575882615,3575882625,10
3,1032,25157,3575882615,3575882625,10
3,1032,25158,3575882615,3575882626,11
3,1032,25159,3575882615,3575882626,11
3,1032,25160,3575882615,3575882627,12
3,1032,25161,3575882615,3575882628,13
3,1032,25162,3575882615,3575882629,14
3,1032,25163,3575882615,3575882629,14
3,1032,25164,3575882615,3575882630,15
3,1032,25165,3575882615,3575882631,16
3,1032,25166,3575882615,3575882632,17
3,1032,25167,3575882615,3575882632,17
3,1032,25168,3575882615,3575882634,19
3,1032,25169,3575882615,3575882635,20
3,1032,25170,3575882615,3575882635,20
3,1032,25171,3575882615,3575882637,22
3,1032,25172,3575882615,3575882637,22
3,1032,25173,3575882615,3575882637,22
3,1032,25174,3575882615,3575882637,22
3,1032,25175,3575882615,3575882638,23
3,1032,25176,3575882615,3575882639,24
3,1032,25177,3575882615,3575882640,25
3,1032,25178,3575882615,3575882640,25
3,1032,25179,3575882615,3575882642,27
3,1032,25180,3575882615,3575882643,28
3,1032,25181,3575882615,3575882643,28
3,1032,25182,3575882615,3575882644,29
3,1032,25183,3575882615,3575882644,29
3,1032,25184,3575882615,3575882644,29
3,1032,25185,3575882615,3575882645,30
3,1032,25186,3575882615,3575882647,32
3,1032,25187,3575882615,3575882647,32
3,1032,25188,3575882615,3575882648,33
3,1032,25189,3575882615,3575882650,35
3,1032,25190,3575882615,3575882652,37
3,1032,25191,3575882615,3575882652,37
3,1032,25192,3575882615,3575882653,38
3,1032,25193,3575882615,3575882654,39
3,1032,25194,3575882615,3575882654,39
3,1032,25195,3575882615,3575882658,43
3,1032,25196,3575882615,3575882658,43
3,1032,25197,3575882615,3575882658,43
3,1032,25198,3575882615,3575882658,43
3,1032,25199,3575882615,3575882659,44
3,1032,25200,3575882615,3575882661,46
3,1032,25201,3575882615,3575882662,47
3,1032,25202,3575882615,3575882663,48
3,1032,25203,3575882615,3575882664,49
3,1032,25204,3575882615,3575882665,50
3,1033,25205,3575882680,3575882680,0
3,1033,25206,3575882680,3575882680,0
3,1033,25207,3575882680,3575882680,0
3,1033,25208,3575882680,3575882680,0
3,1033,25209,3575882680,3575882680,0
3,1033,25210,3575882680,3575882680,0
3,1033,25211,3575882680,3575882680,0
3,1033,25212,3575882680,3575882680,0
3,1033,25213,3575882680,3575882680,0
3,1033,25214,3575882680,3575882681,1
3,1033,25215,3575882680,3575882682,2
3,1033,25216,3575882680,3575882683,3
3,1033,25217,3575882680,3575882686,6
3,1033,25218,3575882680,3575882687,7
3,1033,25219,3575882680,3575882687,7
3,1033,25220,3575882680,3575882687,7
3,1033,25221,3575882680,3575882688,8
3,1033,25222,3575882680,3575882689,9
3,1033,25223,3575882680,3575882689,9
3,1033,25224,3575882680,3575882690,10
3,1033,25225,3575882680,3575882690,10
3,1033,25226,3575882680,3575882694,14
3,1033,25227,3575882680,3575882696,16
3,1033,25228,3575882680,3575882696,16
3,1033,25229,3575882680,3575882697,17
3,1033,25230,3575882680,3575882697,17
3,1033,25231,3575882680,3575882698,18
3,1033,25232,3575882680,3575882701,21
3,1033,25233,3575882680,3575882701,21
3,1033,25234,3575882680,3575882702,22
3,1033,25235,3575882680,3575882703,23
3,1033,25236,3575882680,3575882703,23
3,1033,25237,3575882680,3575882705,25
3,1033,25238,3575882680,3575882705,25
3,1033,25239,3575882680,3575882706,26
3,1033,25240,3575882680,3575882707,27
3,1033,25241,3575882680,3575882708,28
3,1033,25242,3575882680,3575882711,31
3,1033,25243,3575882680,3575882712,32
3,1033,25244,3575882680,3575882712,32
3,1033,25245,3575882680,3575882713,33
3,1033,25246,3575882680,3575882713,33
3,1033,25247,3575882680,3575882715,35
3,1033,25248,3575882680,3575882717,37
3,1033,25249,3575882680,3575882717,37
3,1033,25250,3575882680,3575882718,38
3,1033,25251,3575882680,3575882719,39
3,1033,25252,3575882680,3575882720,40
3,1033,25253,3575882680,3575882721,41
3,1033,25254,3575882680,3575882721,41
3,1033,25255,3575882680,3575882723,43
3,1033,25256,3575882680,3575882723,43
3,1033,25257,3575882680,3575882726,46
3,1033,25258,3575882680,3575882727,47
3,1033,25259,3575882680,3575882727,47
3,1033,25260,3575882680,3575882729,49
3,1033,25261,3575882680,3575882729,49
3,1034,25262,3575882747,3575882747,0
3,1034,25263,3575882747,3575882747,0
3,1034,25264,3575882747,3575882747,0
3,1034,25265,3575882747,3575882747,0
3,1034,25266,3575882747,3575882747,0
3,1034,25267,3575882747,3575882747,0
3,1034,25268,3575882747,3575882747,0
3,1034,25269,3575882747,3575882747,0
3,1034,25270,3575882747,3575882747,0
3,1034,25271,3575882747,3575882747,0
3,1034,25272,3575882747,3575882747,0
3,1034,25273,3575882747,3575882747,0
3,1034,25274,3575882747,3575882747,0
3,1034,25275,3575882747,3575882747,0
3,1034,25276,3575882747,3575882750,3
3,1034,25277,3575882747,3575882751,4
3,1034,25278,3575882747,3575882753,6
3,1034,25279,3575882747,3575882754,7
3,1034,25280,3575882747,3575882755,8
3,1034,25281,3575882747,3575882756,9
3,1034,25282,3575882747,3575882758,11
3,1034,25283,3575882747,3575882760,13
3,1034,25284,3575882747,3575882765,18
3,1034,25285,3575882747,3575882765,18
3,1034,25286,3575882747,3575882766,19
3,1034,25287,3575882747,3575882767,20
3,1034,25288,3575882747,3575882769,22
3,1034,25289,3575882747,3575882769,22
3,1034,25290,3575882747,3575882770,23
3,1034,25291,3575882747,3575882770,23
3,1034,25292,3575882747,3575882771,24
3,1034,25293,3575882747,3575882773,26
3,1034,25294,3575882747,3575882774,27
3,1034,25295,3575882747,3575882777,30
3,1034,25296,3575882747,3575882777,30
3,1034,25297,3575882747,3575882778,31
3,1034,25298,3575882747,3575882779,32
3,1034,25299,3575882747,3575882779,32
3,1034,25300,3575882747,3575882780,33
3,1034,25301,3575882747,3575882781,34
3,1034,25302,3575882747,3575882782,35
3,1034,25303,3575882747,3575882782,35
3,1034,25304,3575882747,3575882785,38
3,1034,25305,3575882747,3575882785,38
3,1034,25306,3575882747,3575882785,38
3,1034,25307,3575882747,3575882786,39
3,1034,25308,3575882747,3575882791,44
3,1034,25309,3575882747,3575882792,45
3,1034,25310,3575882747,3575882794,47
3,1034,25311,3575882747,3575882794,47
3,1034,25312,3575882747,3575882795,48
3,1034,25313,3575882747,3575882795,48
3,1034,25314,3575882747,3575882795,48
3,1034,25315,3575882747,3575882795,48
3,1034,25316,3575882747,3575882796,49
3,1034,25317,3575882747,3575882796,49
3,1035,25318,3575882816,3575882816,0
3,1035,25319,3575882816,3575882816,0
3,1035,25320,3575882816,3575882816,0
3,1035,25321,3575882816,3575882816,0
3,1035,25322,3575882816,3575882816,0
3,1035,25323,3575882816,3575882816,0
3,1035,25324,3575882816,3575882816,0
3,1035,25325,3575882816,3575882816,0
3,1035,25326,3575882816,3575882816,0
3,1035,25327,3575882816,3575882816,0
3,1035,25328,3575882816,3575882816,0
3,1035,25329,3575882816,3575882816,0
3,1035,25330,3575882816,3575882816,0
3,1035,25331,3575882816,3575882816,0
3,1035,25332,3575882816,3575882816,0
3,1035,25333,3575882816,3575882816,0
3,1035,25334,3575882816,3575882818,2
3,1035,25335,3575882816,3575882819,3
3,1035,25336,3575882816,3575882820,4
3,1035,25337,3575882816,3575882821,5
3,1035,25338,3575882816,3575882822,6
3,1035,25339,3575882816,3575882823,7
3,1035,25340,3575882816,3575882823,7
3,1035,25341,3575882816,3575882824,8
3,1035,25342,3575882816,3575882824,8
3,1035,25343,3575882816,3575882825,9
3,1035,25344,3575882816,3575882825,9
3,1035,25345,3575882816,3575882826,10
3,1035,25346,3575882816,3575882827,11
3,1035,25347,3575882816,3575882827,11
3,1035,25348,3575882816,3575882828,12
3,1035,25349,3575882816,3575882829,13
3,1035,25350,3575882816,3575882829,13
3,1035,25351,3575882816,3575882830,14
3,1035,25352,3575882816,3575882832,16
3,1035,25353,3575882816,3575882832,16
3,1035,25354,3575882816,3575882832,16
3,1035,25355,3575882816,3575882833,17
3,1035,25356,3575882816,3575882833,17
3,1035,25357,3575882816,3575882837,21
3,1035,25358,3575882816,3575882837,21
3,1035,25359,3575882816,3575882837,21
3,1035,25360,3575882816,3575882838,22
3,1035,25361,3575882816,3575882838,22
3,1035,25362,3575882816,3575882839,23
3,1035,25363,3575882816,3575882839,23
3,1035,25364,3575882816,3575882841,25
3,1035,25365,3575882816,3575882843,27
3,1035,25366,3575882816,3575882843,27
3,1035,25367,3575882816,3575882844,28
3,1035,25368,3575882816,3575882844,28
3,1035,25369,3575882816,3575882845,29
3,1035,25370,3575882816,3575882846,30
3,1035,25371,3575882816,3575882847,31
3,1035,25372,3575882816,3575882847,31
3,1035,25373,3575882816,3575882849,33
3,1035,25374,3575882816,3575882850,34
3,1035,25375,3575882816,3575882852,36
3,1035,25376,3575882816,3575882853,37
3,1035,25377,3575882816,3575882853,37
3,1035,25378,3575882816,3575882854,38
3,1035,25379,3575882816,3575882854,38
3,1035,25380,3575882816,3575882858,42
3,1035,25381,3575882816,3575882859,43
3,1035,25382,3575882816,3575882859,43
3,1035,25383,3575882816,3575882859,43
3,1035,25384,3575882816,3575882860,44
3,1035,25385,3575882816,3575882862,46
3,1035,25386,3575882816,3575882862,46
3,1035,25387,3575882816,3575882864,48
3,1035,25388,3575882816,3575882865,49
3,1035,25389,3575882816,3575882865,49
3,1036,25390,3575882879,3575882879,0
3,1036,25391,3575882879,3575882879,0
3,1036,25392,3575882879,3575882879,0
3,1036,25393,3575882879,3575882879,0
3,1036,25394,3575882879,3575882879,0
3,1036,25395,3575882879,3575882879,0
3,1036,25396,3575882879,3575882879,0
3,1036,25397,3575882879,3575882879,0
3,1036,25398,3575882879,3575882879,0
3,1036,25399,3575882879,3575882881,2
3,1036,25400,3575882879,3575882882,3
3,1036,25401,3575882879,3575882883,4
3,1036,25402,3575882879,3575882886,7
3,1036,25403,3575882879,3575882886,7
3,1036,25404,3575882879,3575882887,8
3,1036,25405,3575882879,3575882887,8
3,1036,25406,3575882879,3575882887,8
3,1036,25407,3575882879,3575882888,9
3,1036,25408,3575882879,3575882889,10
3,1036,25409,3575882879,3575882889,10
3,1036,25410,3575882879,3575882890,11
3,1036,25411,3575882879,3575882891,12
3,1036,25412,3575882879,3575882894,15
3,1036,25413,3575882879,3575882896,17
3,1036,25414,3575882879,3575882896,17
3,1036,25415,3575882879,3575882897,18
3,1036,25416,3575882879,3575882897,18
3,1036,25417,3575882879,3575882899,20
3,1036,25418,3575882879,3575882900,21
3,1036,25419,3575882879,3575882901,22
3,1036,25420,3575882879,3575882901,22
3,1036,25421,3575882879,3575882902,23
3,1036,25422,3575882879,3575882903,24
3,1036,25423,3575882879,3575882903,24
3,1036,25424,3575882879,3575882905,26
3,1036,25425,3575882879,3575882905,26
3,1036,25426,3575882879,3575882906,27
3,1036,25427,3575882879,3575882906,27
3,1036,25428,3575882879,3575882908,29
3,1036,25429,3575882879,3575882909,30
3,1036,25430,3575882879,3575882910,31
3,1036,25431,3575882879,3575882912,33
3,1036,25432,3575882879,3575882912,33
3,1036,25433,3575882879,3575882912,33
3,1036,25434,3575882879,3575882913,34
3,1036,25435,3575882879,3575882915,36
3,1036,25436,3575882879,3575882916,37
3,1036,25437,3575882879,3575882917,38
3,1036,25438,3575882879,3575882919,40
3,1036,25439,3575882879,3575882920,41
3,1036,25440,3575882879,3575882921,42
3,1036,25441,3575882879,3575882923,44
3,1036,25442,3575882879,3575882923,44
3,1036,25443,3575882879,3575882926,47
3,1036,25444,3575882879,3575882927,48
3,1036,25445,3575882879,3575882927,48
3,1037,25446,3575882944,3575882944,0
3,1037,25447,3575882944,3575882944,0
3,1037,25448,3575882944,3575882944,0
3,1037,25449,3575882944,3575882944,0
3,1037,25450,3575882944,3575882944,0
3,1037,25451,3575882944,3575882944,0
3,1037,25452,3575882944,3575882944,0
3,1037,25453,3575882944,3575882944,0
3,1037,25454,3575882944,3575882944,0
3,1037,25455,3575882944,3575882944,0
3,1037,25456,3575882944,3575882944,0
3,1037,25457,3575882944,3575882944,0
3,1037,25458,3575882944,3575882944,0
3,1037,25459,3575882944,3575882944,0
3,1037,25460,3575882944,3575882945,1
3,1037,25461,3575882944,3575882950,6
3,1037,25462,3575882944,3575882950,6
3,1037,25463,3575882944,3575882952,8
3,1037,25464,3575882944,3575882954,10
3,1037,25465,3575882944,3575882955,11
3,1037,25466,3575882944,3575882956,12
3,1037,25467,3575882944,3575882960,16
3,1037,25468,3575882944,3575882962,18
3,1037,25469,3575882944,3575882964,20
3,1037,25470,3575882944,3575882966,22
3,1037,25471,3575882944,3575882967,23
3,1037,25472,3575882944,3575882968,24
3,1037,25473,3575882944,3575882968,24
3,1037,25474,3575882944,3575882968,24
3,1037,25475,3575882944,3575882970,26
3,1037,25476,3575882944,3575882970,26
3,1037,25477,3575882944,3575882971,27
3,1037,25478,3575882944,3575882973,29
3,1037,25479,3575882944,3575882975,31
3,1037,25480,3575882944,3575882977,33
3,1037,25481,3575882944,3575882978,34
3,1037,25482,3575882944,3575882978,34
3,1037,25483,3575882944,3575882979,35
3,1037,25484,3575882944,3575882980,36
3,1037,25485,3575882944,3575882981,37
3,1037,25486,3575882944,3575882981,37
3,1037,25487,3575882944,3575882983,39
3,1037,25488,3575882944,3575882986,42
3,1037,25489,3575882944,3575882986,42
3,1037,25490,3575882944,3575882988,44
3,1037,25491,3575882944,3575882994,50
3,1038,25492,3575883007,3575883007,0
3,1038,25493,3575883007,3575883007,0
3,1038,25494,3575883007,3575883007,0
3,1038,25495,3575883007,3575883007,0
3,1038,25496,3575883007,3575883007,0
3,1038,25497,3575883007,3575883007,0
3,1038,25498,3575883007,3575883007,0
3,1038,25499,3575883007,3575883007,0
3,1038,25500,3575883007,3575883007,0
3,1038,25501,3575883007,3575883007,0
3,1038,25502,3575883007,3575883007,0
3,1038,25503,3575883007,3575883007,0
3,1038,25504,3575883007,3575883007,0
3,1038,25505,3575883007,3575883007,0
3,1038,25506,3575883007,3575883007,0
3,1038,25507,3575883007,3575883007,0
3,1038,25508,3575883007,3575883007,0
3,1038,25509,3575883007,3575883007,0
3,1038,25510,3575883007,3575883007,0
3,1038,25511,3575883007,3575883011,4
3,1038,25512,3575883007,3575883015,8
3,1038,25513,3575883007,3575883018,11
3,1038,25514,3575883007,3575883019,12
3,1038,25515,3575883007,3575883021,14
3,1038,25516,3575883007,3575883022,15
3,1038,25517,3575883007,3575883023,16
3,1038,25518,3575883007,3575883024,17
3,1038,25519,3575883007,3575883025,18
3,1038,25520,3575883007,3575883025,18
3,1038,25521,3575883007,3575883026,19
3,1038,25522,3575883007,3575883027,20
3,1038,25523,3575883007,3575883028,21
3,1038,25524,3575883007,3575883028,21
3,1038,25525,3575883007,3575883028,21
3,1038,25526,3575883007,3575883030,23
3,1038,25527,3575883007,3575883030,23
3,1038,25528,3575883007,3575883031,24
3,1038,25529,3575883007,3575883032,25
3,1038,25530,3575883007,3575883034,27
3,1038,25531,3575883007,3575883035,28
3,1038,25532,3575883007,3575883037,30
3,1038,25533,3575883007,3575883038,31
3,1038,25534,3575883007,3575883038,31
3,1038,25535,3575883007,3575883038,31
3,1038,25536,3575883007,3575883038,31
3,1038,25537,3575883007,3575883039,32
3,1038,25538,3575883007,3575883040,33
3,1038,25539,3575883007,3575883041,34
3,1038,25540,3575883007,3575883043,36
3,1038,25541,3575883007,3575883043,36
3,1038,25542,3575883007,3575883043,36
3,1038,25543,3575883007,3575883044,37
3,1038,25544,3575883007,3575883044,37
3,1038,25545,3575883007,3575883044,37
3,1038,25546,3575883007,3575883046,39
3,1038,25547,3575883007,3575883047,40
3,1038,25548,3575883007,3575883047,40
3,1038,25549,3575883007,3575883049,42
3,1038,25550,3575883007,3575883050,43
3,1038,25551,3575883007,3575883052,45
3,1038,25552,3575883007,3575883053,46
3,1038,25553,3575883007,3575883053,46
3,1038,25554,3575883007,3575883054,47
3,1038,25555,3575883007,3575883055,48
3,1039,25556,3575883071,3575883071,0
3,1039,25557,3575883071,3575883071,0
3,1039,25558,3575883071,3575883071,0
3,1039,25559,3575883071,3575883071,0
3,1039,25560,3575883071,3575883071,0
3,1039,25561,3575883071,3575883071,0
3,1039,25562,3575883071,3575883071,0
3,1039,25563,3575883071,3575883071,0
3,1039,25564,3575883071,3575883071,0
3,1039,25565,3575883071,3575883071,0
3,1039,25566,3575883071,3575883071,0
3,1039,25567,3575883071,3575883071,0
3,1039,25568,3575883071,3575883071,0
3,1039,25569,3575883071,3575883071,0
3,1039,25570,3575883071,3575883071,0
3,1039,25571,3575883071,3575883071,0
3,1039,25572,3575883071,3575883071,0
3,1039,25573,3575883071,3575883074,3
3,1039,25574,3575883071,3575883076,5
3,1039,25575,3575883071,3575883077,6
3,1039,25576,3575883071,3575883081,10
3,1039,25577,3575883071,3575883081,10
3,1039,25578,3575883071,3575883085,14
3,1039,25579,3575883071,3575883086,15
3,1039,25580,3575883071,3575883087,16
3,1039,25581,3575883071,3575883088,17
3,1039,25582,3575883071,3575883088,17
3,1039,25583,3575883071,3575883088,17
3,1039,25584,3575883071,3575883089,18
3,1039,25585,3575883071,3575883090,19
3,1039,25586,3575883071,3575883090,19
3,1039,25587,3575883071,3575883093,22
3,1039,25588,3575883071,3575883097,26
3,1039,25589,3575883071,3575883097,26
3,1039,25590,3575883071,3575883098,27
3,1039,25591,3575883071,3575883099,28
3,1039,25592,3575883071,3575883100,29
3,1039,25593,3575883071,3575883100,29
3,1039,25594,3575883071,3575883101,30
3,1039,25595,3575883071,3575883102,31
3,1039,25596,3575883071,3575883103,32
3,1039,25597,3575883071,3575883105,34
3,1039,25598,3575883071,3575883105,34
3,1039,25599,3575883071,3575883106,35
3,1039,25600,3575883071,3575883107,36
3,1039,25601,3575883071,3575883107,36
3,1039,25602,3575883071,3575883109,38
3,1039,25603,3575883071,3575883111,40
3,1039,25604,3575883071,3575883112,41
3,1039,25605,3575883071,3575883112,41
3,1039,25606,3575883071,3575883112,41
3,1039,25607,3575883071,3575883113,42
3,1039,25608,3575883071,3575883115,44
3,1039,25609,3575883071,3575883117,46
3,1039,25610,3575883071,3575883117,46
3,1039,25611,3575883071,3575883119,48
3,1039,25612,3575883071,3575883120,49
3,1039,25613,3575883071,3575883121,50
3,1040,25614,3575883134,3575883134,0
3,1040,25615,3575883134,3575883134,0
3,1040,25616,3575883134,3575883134,0
3,1040,25617,3575883134,3575883134,0
3,1040,25618,3575883134,3575883134,0
3,1040,25619,3575883134,3575883134,0
3,1040,25620,3575883134,3575883134,0
3,1040,25621,3575883134,3575883134,0
3,1040,25622,3575883134,3575883134,0
3,1040,25623,3575883134,3575883134,0
3,1040,25624,3575883134,3575883134,0
3,1040,25625,3575883134,3575883134,0
3,1040,25626,3575883134,3575883137,3
3,1040,25627,3575883134,3575883137,3
3,1040,25628,3575883134,3575883141,7
3,1040,25629,3575883134,3575883143,9
3,1040,25630,3575883134,3575883144,10
3,1040,25631,3575883134,3575883144,10
3,1040,25632,3575883134,3575883144,10
3,1040,25633,3575883134,3575883146,12
3,1040,25634,3575883134,3575883150,16
3,1040,25635,3575883134,3575883151,17
3,1040,25636,3575883134,3575883153,19
3,1040,25637,3575883134,3575883154,20
3,1040,25638,3575883134,3575883155,21
3,1040,25639,3575883134,3575883156,22
3,1040,25640,3575883134,3575883160,26
3,1040,25641,3575883134,3575883161,27
3,1040,25642,3575883134,3575883162,28
3,1040,25643,3575883134,3575883164,30
3,1040,25644,3575883134,3575883165,31
3,1040,25645,3575883134,3575883167,33
3,1040,25646,3575883134,3575883168,34
3,1040,25647,3575883134,3575883169,35
3,1040,25648,3575883134,3575883169,35
3,1040,25649,3575883134,3575883170,36
3,1040,25650,3575883134,3575883171,37
3,1040,25651,3575883134,3575883171,37
3,1040,25652,3575883134,3575883174,40
3,1040,25653,3575883134,3575883178,44
3,1040,25654,3575883134,3575883178,44
3,1040,25655,3575883134,3575883180,46
3,1040,25656,3575883134,3575883180,46
3,1040,25657,3575883134,3575883181,47
3,1040,25658,3575883134,3575883181,47
3,1040,25659,3575883134,3575883181,47
3,1040,25660,3575883134,3575883182,48
3,1041,25661,3575883198,3575883198,0
3,1041,25662,3575883198,3575883198,0
3,1041,25663,3575883198,3575883198,0
3,1041,25664,3575883198,3575883198,0
3,1041,25665,3575883198,3575883198,0
3,1041,25666,3575883198,3575883198,0
3,1041,25667,3575883198,3575883198,0
3,1041,25668,3575883198,3575883198,0
3,1041,25669,3575883198,3575883198,0
3,1041,25670,3575883198,3575883198,0
3,1041,25671,3575883198,3575883198,0
3,1041,25672,3575883198,3575883198,0
3,1041,25673,3575883198,3575883198,0
3,1041,25674,3575883198,3575883198,0
3,1041,25675,3575883198,3575883198,0
3,1041,25676,3575883198,3575883199,1
3,1041,25677,3575883198,3575883200,2
3,1041,25678,3575883198,3575883201,3
3,1041,25679,3575883198,3575883201,3
3,1041,25680,3575883198,3575883202,4
3,1041,25681,3575883198,3575883203,5
3,1041,25682,3575883198,3575883203,5
3,1041,25683,3575883198,3575883204,6
3,1041,25684,3575883198,3575883204,6
3,1041,25685,3575883198,3575883206,8
3,1041,25686,3575883198,3575883212,14
3,1041,25687,3575883198,3575883215,17
3,1041,25688,3575883198,3575883218,20
3,1041,25689,3575883198,3575883220,22
3,1041,25690,3575883198,3575883220,22
3,1041,25691,3575883198,3575883222,24
3,1041,25692,3575883198,3575883222,24
3,1041,25693,3575883198,3575883222,24
3,1041,25694,3575883198,3575883223,25
3,1041,25695,3575883198,3575883225,27
3,1041,25696,3575883198,3575883226,28
3,1041,25697,3575883198,3575883227,29
3,1041,25698,3575883198,3575883228,30
3,1041,25699,3575883198,3575883228,30
3,1041,25700,3575883198,3575883229,31
3,1041,25701,3575883198,3575883229,31
3,1041,25702,3575883198,3575883230,32
3,1041,25703,3575883198,3575883230,32
3,1041,25704,3575883198,3575883232,34
3,1041,25705,3575883198,3575883232,34
3,1041,25706,3575883198,3575883233,35
3,1041,25707,3575883198,3575883234,36
3,1041,25708,3575883198,3575883236,38
3,1041,25709,3575883198,3575883237,39
3,1041,25710,3575883198,3575883237,39
3,1041,25711,3575883198,3575883238,40
3,1041,25712,3575883198,3575883238,40
3,1041,25713,3575883198,3575883239,41
3,1041,25714,3575883198,3575883241,43
3,1041,25715,3575883198,3575883241,43
3,1041,25716,3575883198,3575883243,45
3,1041,25717,3575883198,3575883243,45
3,1041,25718,3575883198,3575883243,45
3,1041,25719,3575883198,3575883243,45
3,1041,25720,3575883198,3575883244,46
3,1041,25721,3575883198,3575883245,47
3,1041,25722,3575883198,3575883246,48
3,1041,25723,3575883198,3575883246,48
3,1041,25724,3575883198,3575883248,50
3,1042,25725,3575883262,3575883262,0
3,1042,25726,3575883262,3575883262,0
3,1042,25727,3575883262,3575883262,0
3,1042,25728,3575883262,3575883262,0
3,1042,25729,3575883262,3575883262,0
3,1042,25730,3575883262,3575883262,0
3,1042,25731,3575883262,3575883262,0
3,1042,25732,3575883262,3575883262,0
3,1042,25733,3575883262,3575883262,0
3,1042,25734,3575883262,3575883262,0
3,1042,25735,3575883262,3575883262,0
3,1042,25736,3575883262,3575883262,0
3,1042,25737,3575883262,3575883263,1
3,1042,25738,3575883262,3575883264,2
3,1042,25739,3575883262,3575883265,3
3,1042,25740,3575883262,3575883265,3
3,1042,25741,3575883262,3575883266,4
3,1042,25742,3575883262,3575883266,4
3,1042,25743,3575883262,3575883268,6
3,1042,25744,3575883262,3575883269,7
3,1042,25745,3575883262,3575883269,7
3,1042,25746,3575883262,3575883270,8
3,1042,25747,3575883262,3575883274,12
3,1042,25748,3575883262,3575883276,14
3,1042,25749,3575883262,3575883278,16
3,1042,25750,3575883262,3575883282,20
3,1042,25751,3575883262,3575883282,20
3,1042,25752,3575883262,3575883284,22
3,1042,25753,3575883262,3575883284,22
3,1042,25754,3575883262,3575883286,24
3,1042,25755,3575883262,3575883286,24
3,1042,25756,3575883262,3575883287,25
3,1042,25757,3575883262,3575883288,26
3,1042,25758,3575883262,3575883288,26
3,1042,25759,3575883262,3575883288,26
3,1042,25760,3575883262,3575883289,27
3,1042,25761,3575883262,3575883290,28
3,1042,25762,3575883262,3575883290,28
3,1042,25763,3575883262,3575883294,32
3,1042,25764,3575883262,3575883297,35
3,1042,25765,3575883262,3575883297,35
3,1042,25766,3575883262,3575883298,36
3,1042,25767,3575883262,3575883299,37
3,1042,25768,3575883262,3575883300,38
3,1042,25769,3575883262,3575883301,39
3,1042,25770,3575883262,3575883302,40
3,1042,25771,3575883262,3575883302,40
3,1042,25772,3575883262,3575883304,42
3,1042,25773,3575883262,3575883305,43
3,1042,25774,3575883262,3575883306,44
3,1042,25775,3575883262,3575883306,44
3,1042,25776,3575883262,3575883306,44
3,1042,25777,3575883262,3575883307,45
3,1042,25778,3575883262,3575883308,46
3,1042,25779,3575883262,3575883311,49
3,1042,25780,3575883262,3575883311,49
3,1043,25781,3575883325,3575883325,0
3,1043,25782,3575883325,3575883325,0
3,1043,25783,3575883325,3575883325,0
3,1043,25784,3575883325,3575883325,0
3,1043,25785,3575883325,3575883325,0
3,1043,25786,3575883325,3575883325,0
3,1043,25787,3575883325,3575883325,0
3,1043,25788,3575883325,3575883325,0
3,1043,25789,3575883325,3575883325,0
3,1043,25790,3575883325,3575883325,0
3,1043,25791,3575883325,3575883325,0
3,1043,25792,3575883325,3575883326,1
3,1043,25793,3575883325,3575883327,2
3,1043,25794,3575883325,3575883327,2
3,1043,25795,3575883325,3575883329,4
3,1043,25796,3575883325,3575883330,5
3,1043,25797,3575883325,3575883331,6
3,1043,25798,3575883325,3575883332,7
3,1043,25799,3575883325,3575883333,8
3,1043,25800,3575883325,3575883334,9
3,1043,25801,3575883325,3575883334,9
3,1043,25802,3575883325,3575883337,12
3,1043,25803,3575883325,3575883338,13
3,1043,25804,3575883325,3575883341,16
3,1043,25805,3575883325,3575883342,17
3,1043,25806,3575883325,3575883344,19
3,1043,25807,3575883325,3575883344,19
3,1043,25808,3575883325,3575883345,20
3,1043,25809,3575883325,3575883346,21
3,1043,25810,3575883325,3575883350,25
3,1043,25811,3575883325,3575883352,27
3,1043,25812,3575883325,3575883353,28
3,1043,25813,3575883325,3575883354,29
3,1043,25814,3575883325,3575883355,30
3,1043,25815,3575883325,3575883356,31
3,1043,25816,3575883325,3575883361,36
3,1043,25817,3575883325,3575883361,36
3,1043,25818,3575883325,3575883362,37
3,1043,25819,3575883325,3575883365,40
3,1043,25820,3575883325,3575883365,40
3,1043,25821,3575883325,3575883368,43
3,1043,25822,3575883325,3575883368,43
3,1043,25823,3575883325,3575883369,44
3,1043,25824,3575883325,3575883369,44
3,1043,25825,3575883325,3575883371,46
3,1043,25826,3575883325,3575883371,46
3,1043,25827,3575883325,3575883371,46
3,1043,25828,3575883325,3575883373,48
3,1043,25829,3575883325,3575883375,50
3,1044,25830,3575883392,3575883392,0
3,1044,25831,3575883392,3575883392,0
3,1044,25832,3575883392,3575883392,0
3,1044,25833,3575883392,3575883392,0
3,1044,25834,3575883392,3575883392,0
3,1044,25835,3575883392,3575883392,0
3,1044,25836,3575883392,3575883392,0
3,1044,25837,3575883392,3575883392,0
3,1044,25838,3575883392,3575883392,0
3,1044,25839,3575883392,3575883392,0
3,1044,25840,3575883392,3575883392,0
3,1044,25841,3575883392,3575883392,0
3,1044,25842,3575883392,3575883392,0
3,1044,25843,3575883392,3575883393,1
3,1044,25844,3575883392,3575883393,1
3,1044,25845,3575883392,3575883394,2
3,1044,25846,3575883392,3575883395,3
3,1044,25847,3575883392,3575883395,3
3,1044,25848,3575883392,3575883396,4
3,1044,25849,3575883392,3575883396,4
3,1044,25850,3575883392,3575883396,4
3,1044,25851,3575883392,3575883397,5
3,1044,25852,3575883392,3575883397,5
3,1044,25853,3575883392,3575883397,5
3,1044,25854,3575883392,3575883398,6
3,1044,25855,3575883392,3575883400,8
3,1044,25856,3575883392,3575883400,8
3,1044,25857,3575883392,3575883401,9
3,1044,25858,3575883392,3575883401,9
3,1044,25859,3575883392,3575883401,9
3,1044,25860,3575883392,3575883403,11
3,1044,25861,3575883392,3575883404,12
3,1044,25862,3575883392,3575883404,12
3,1044,25863,3575883392,3575883404,12
3,1044,25864,3575883392,3575883406,14
3,1044,25865,3575883392,3575883411,19
3,1044,25866,3575883392,3575883417,25
3,1044,25867,3575883392,3575883418,26
3,1044,25868,3575883392,3575883420,28
3,1044,25869,3575883392,3575883421,29
3,1044,25870,3575883392,3575883422,30
3,1044,25871,3575883392,3575883422,30
3,1044,25872,3575883392,3575883422,30
3,1044,25873,3575883392,3575883424,32
3,1044,25874,3575883392,3575883424,32
3,1044,25875,3575883392,3575883426,34
3,1044,25876,3575883392,3575883427,35
3,1044,25877,3575883392,3575883427,35
3,1044,25878,3575883392,3575883428,36
3,1044,25879,3575883392,3575883429,37
3,1044,25880,3575883392,3575883429,37
3,1044,25881,3575883392,3575883429,37
3,1044,25882,3575883392,3575883430,38
3,1044,25883,3575883392,3575883430,38
3,1044,25884,3575883392,3575883431,39
3,1044,25885,3575883392,3575883432,40
3,1044,25886,3575883392,3575883433,41
3,1044,25887,3575883392,3575883434,42
3,1044,25888,3575883392,3575883437,45
3,1044,25889,3575883392,3575883437,45
3,1044,25890,3575883392,3575883437,45
3,1044,25891,3575883392,3575883437,45
3,1044,25892,3575883392,3575883438,46
3,1044,25893,3575883392,3575883439,47
3,1044,25894,3575883392,3575883441,49
3,1044,25895,3575883392,3575883441,49
3,1045,25896,3575883456,3575883456,0
3,1045,25897,3575883456,3575883456,0
3,1045,25898,3575883456,3575883456,0
3,1045,25899,3575883456,3575883456,0
3,1045,25900,3575883456,3575883456,0
3,1045,25901,3575883456,3575883456,0
3,1045,25902,3575883456,3575883456,0
3,1045,25903,3575883456,3575883456,0
3,1045,25904,3575883456,3575883456,0
3,1045,25905,3575883456,3575883456,0
3,1045,25906,3575883456,3575883456,0
3,1045,25907,3575883456,3575883456,0
3,1045,25908,3575883456,3575883456,0
3,1045,25909,3575883456,3575883458,2
3,1045,25910,3575883456,3575883459,3
3,1045,25911,3575883456,3575883459,3
3,1045,25912,3575883456,3575883460,4
3,1045,25913,3575883456,3575883461,5
3,1045,25914,3575883456,3575883462,6
3,1045,25915,3575883456,3575883463,7
3,1045,25916,3575883456,3575883464,8
3,1045,25917,3575883456,3575883464,8
3,1045,25918,3575883456,3575883465,9
3,1045,25919,3575883456,3575883465,9
3,1045,25920,3575883456,3575883466,10
3,1045,25921,3575883456,3575883466,10
3,1045,25922,3575883456,3575883468,12
3,1045,25923,3575883456,3575883469,13
3,1045,25924,3575883456,3575883474,18
3,1045,25925,3575883456,3575883477,21
3,1045,25926,3575883456,3575883477,21
3,1045,25927,3575883456,3575883482,26
3,1045,25928,3575883456,3575883482,26
3,1045,25929,3575883456,3575883484,28
3,1045,25930,3575883456,3575883485,29
3,1045,25931,3575883456,3575883485,29
3,1045,25932,3575883456,3575883486,30
3,1045,25933,3575883456,3575883487,31
3,1045,25934,3575883456,3575883487,31
3,1045,25935,3575883456,3575883488,32
3,1045,25936,3575883456,3575883488,32
3,1045,25937,3575883456,3575883489,33
3,1045,25938,3575883456,3575883490,34
3,1045,25939,3575883456,3575883491,35
3,1045,25940,3575883456,3575883494,38
3,1045,25941,3575883456,3575883497,41
3,1045,25942,3575883456,3575883497,41
3,1045,25943,3575883456,3575883499,43
3,1045,25944,3575883456,3575883499,43
3,1045,25945,3575883456,3575883500,44
3,1045,25946,3575883456,3575883501,45
3,1045,25947,3575883456,3575883501,45
3,1045,25948,3575883456,3575883502,46
3,1045,25949,3575883456,3575883503,47
3,1045,25950,3575883456,3575883503,47
3,1045,25951,3575883456,3575883505,49
3,1046,25952,3575883519,3575883519,0
3,1046,25953,3575883519,3575883519,0
3,1046,25954,3575883519,3575883519,0
3,1046,25955,3575883519,3575883519,0
3,1046,25956,3575883519,3575883519,0
3,1046,25957,3575883519,3575883519,0
3,1046,25958,3575883519,3575883519,0
3,1046,25959,3575883519,3575883519,0
3,1046,25960,3575883519,3575883519,0
3,1046,25961,3575883519,3575883519,0
3,1046,25962,3575883519,3575883519,0
3,1046,25963,3575883519,3575883519,0
3,1046,25964,3575883519,3575883519,0
3,1046,25965,3575883519,3575883519,0
3,1046,25966,3575883519,3575883520,1
3,1046,25967,3575883519,3575883522,3
3,1046,25968,3575883519,3575883523,4
3,1046,25969,3575883519,3575883523,4
3,1046,25970,3575883519,3575883524,5
3,1046,25971,3575883519,3575883526,7
3,1046,25972,3575883519,3575883529,10
3,1046,25973,3575883519,3575883530,11
3,1046,25974,3575883519,3575883530,11
3,1046,25975,3575883519,3575883531,12
3,1046,25976,3575883519,3575883532,13
3,1046,25977,3575883519,3575883533,14
3,1046,25978,3575883519,3575883533,14
3,1046,25979,3575883519,3575883536,17
3,1046,25980,3575883519,3575883537,18
3,1046,25981,3575883519,3575883540,21
3,1046,25982,3575883519,3575883542,23
3,1046,25983,3575883519,3575883543,24
3,1046,25984,3575883519,3575883544,25
3,1046,25985,3575883519,3575883544,25
3,1046,25986,3575883519,3575883548,29
3,1046,25987,3575883519,3575883551,32
3,1046,25988,3575883519,3575883552,33
3,1046,25989,3575883519,3575883553,34
3,1046,25990,3575883519,3575883554,35
3,1046,25991,3575883519,3575883554,35
3,1046,25992,3575883519,3575883560,41
3,1046,25993,3575883519,3575883560,41
3,1046,25994,3575883519,3575883561,42
3,1046,25995,3575883519,3575883563,44
3,1046,25996,3575883519,3575883564,45
3,1046,25997,3575883519,3575883567,48
3,1046,25998,3575883519,3575883567,48
3,1046,25999,3575883519,3575883568,49
3,1046,26000,3575883519,3575883569,50
3,1047,26001,3575883583,3575883583,0
3,1047,26002,3575883583,3575883583,0
3,1047,26003,3575883583,3575883584,1
3,1047,26004,3575883583,3575883584,1
3,1047,26005,3575883583,3575883584,1
3,1047,26006,3575883583,3575883584,1
3,1047,26007,3575883583,3575883584,1
3,1047,26008,3575883583,3575883584,1
3,1047,26009,3575883583,3575883584,1
3,1047,26010,3575883583,3575883584,1
3,1047,26011,3575883583,3575883584,1
3,1047,26012,3575883583,3575883584,1
3,1047,26013,3575883583,3575883584,1
3,1047,26014,3575883583,3575883584,1
3,1047,26015,3575883583,3575883586,3
3,1047,26016,3575883583,3575883586,3
3,1047,26017,3575883583,3575883586,3
3,1047,26018,3575883583,3575883587,4
3,1047,26019,3575883583,3575883590,7
3,1047,26020,3575883583,3575883592,9
3,1047,26021,3575883583,3575883593,10
3,1047,26022,3575883583,3575883593,10
3,1047,26023,3575883583,3575883594,11
3,1047,26024,3575883583,3575883595,12
3,1047,26025,3575883583,3575883595,12
3,1047,26026,3575883583,3575883595,12
3,1047,26027,3575883583,3575883596,13
3,1047,26028,3575883583,3575883596,13
3,1047,26029,3575883583,3575883596,13
3,1047,26030,3575883583,3575883597,14
3,1047,26031,3575883583,3575883598,15
3,1047,26032,3575883583,3575883599,16
3,1047,26033,3575883583,3575883599,16
3,1047,26034,3575883583,3575883600,17
3,1047,26035,3575883583,3575883600,17
3,1047,26036,3575883583,3575883601,18
3,1047,26037,3575883583,3575883602,19
3,1047,26038,3575883583,3575883602,19
3,1047,26039,3575883583,3575883602,19
3,1047,26040,3575883583,3575883603,20
3,1047,26041,3575883583,3575883606,23
3,1047,26042,3575883583,3575883611,28
3,1047,26043,3575883583,3575883614,31
3,1047,26044,3575883583,3575883617,34
3,1047,26045,3575883583,3575883617,34
3,1047,26046,3575883583,3575883619,36
3,1047,26047,3575883583,3575883620,37
3,1047,26048,3575883583,3575883620,37
3,1047,26049,3575883583,3575883621,38
3,1047,26050,3575883583,3575883622,39
3,1047,26051,3575883583,3575883623,40
3,1047,26052,3575883583,3575883623,40
3,1047,26053,3575883583,3575883623,40
3,1047,26054,3575883583,3575883625,42
3,1047,26055,3575883583,3575883626,43
3,1047,26056,3575883583,3575883626,43
3,1047,26057,3575883583,3575883627,44
3,1047,26058,3575883583,3575883627,44
3,1047,26059,3575883583,3575883627,44
3,1047,26060,3575883583,3575883628,45
3,1047,26061,3575883583,3575883629,46
3,1047,26062,3575883583,3575883629,46
3,1047,26063,3575883583,3575883630,47
3,1047,26064,3575883583,3575883631,48
3,1047,26065,3575883583,3575883632,49
3,1048,26066,3575883647,3575883647,0
3,1048,26067,3575883647,3575883647,0
3,1048,26068,3575883647,3575883647,0
3,1048,26069,3575883647,3575883647,0
3,1048,26070,3575883647,3575883647,0
3,1048,26071,3575883647,3575883647,0
3,1048,26072,3575883647,3575883647,0
3,1048,26073,3575883647,3575883647,0
3,1048,26074,3575883647,3575883647,0
3,1048,26075,3575883647,3575883647,0
3,1048,26076,3575883647,3575883647,0
3,1048,26077,3575883647,3575883647,0
3,1048,26078,3575883647,3575883647,0
3,1048,26079,3575883647,3575883647,0
3,1048,26080,3575883647,3575883647,0
3,1048,26081,3575883647,3575883647,0
3,1048,26082,3575883647,3575883649,2
3,1048,26083,3575883647,3575883651,4
3,1048,26084,3575883647,3575883652,5
3,1048,26085,3575883647,3575883652,5
3,1048,26086,3575883647,3575883653,6
3,1048,26087,3575883647,3575883655,8
3,1048,26088,3575883647,3575883657,10
3,1048,26089,3575883647,3575883657,10
3,1048,26090,3575883647,3575883659,12
3,1048,26091,3575883647,3575883660,13
3,1048,26092,3575883647,3575883660,13
3,1048,26093,3575883647,3575883661,14
3,1048,26094,3575883647,3575883662,15
3,1048,26095,3575883647,3575883663,16
3,1048,26096,3575883647,3575883663,16
3,1048,26097,3575883647,3575883664,17
3,1048,26098,3575883647,3575883664,17
3,1048,26099,3575883647,3575883665,18
3,1048,26100,3575883647,3575883666,19
3,1048,26101,3575883647,3575883667,20
3,1048,26102,3575883647,3575883668,21
3,1048,26103,3575883647,3575883668,21
3,1048,26104,3575883647,3575883669,22
3,1048,26105,3575883647,3575883674,27
3,1048,26106,3575883647,3575883677,30
3,1048,26107,3575883647,3575883677,30
3,1048,26108,3575883647,3575883681,34
3,1048,26109,3575883647,3575883682,35
3,1048,26110,3575883647,3575883683,36
3,1048,26111,3575883647,3575883684,37
3,1048,26112,3575883647,3575883684,37
3,1048,26113,3575883647,3575883686,39
3,1048,26114,3575883647,3575883686,39
3,1048,26115,3575883647,3575883687,40
3,1048,26116,3575883647,3575883688,41
3,1048,26117,3575883647,3575883688,41
3,1048,26118,3575883647,3575883689,42
3,1048,26119,3575883647,3575883689,42
3,1048,26120,3575883647,3575883691,44
3,1048,26121,3575883647,3575883691,44
3,1048,26122,3575883647,3575883694,47
3,1048,26123,3575883647,3575883695,48
3,1048,26124,3575883647,3575883696,49
3,1048,26125,3575883647,3575883697,50
3,1049,26126,3575883711,3575883711,0
3,1049,26127,3575883711,3575883711,0
3,1049,26128,3575883711,3575883711,0
3,1049,26129,3575883711,3575883711,0
3,1049,26130,3575883711,3575883711,0
3,1049,26131,3575883711,3575883711,0
3,1049,26132,3575883711,3575883711,0
3,1049,26133,3575883711,3575883711,0
3,1049,26134,3575883711,3575883711,0
3,1049,26135,3575883711,3575883711,0
3,1049,26136,3575883711,3575883711,0
3,1049,26137,3575883711,3575883711,0
3,1049,26138,3575883711,3575883711,0
3,1049,26139,3575883711,3575883711,0
3,1049,26140,3575883711,3575883711,0
3,1049,26141,3575883711,3575883711,0
3,1049,26142,3575883711,3575883712,1
3,1049,26143,3575883711,3575883712,1
3,1049,26144,3575883711,3575883715,4
3,1049,26145,3575883711,3575883716,5
3,1049,26146,3575883711,3575883717,6
3,1049,26147,3575883711,3575883718,7
3,1049,26148,3575883711,3575883719,8
3,1049,26149,3575883711,3575883720,9
3,1049,26150,3575883711,3575883721,10
3,1049,26151,3575883711,3575883723,12
3,1049,26152,3575883711,3575883723,12
3,1049,26153,3575883711,3575883724,13
3,1049,26154,3575883711,3575883726,15
3,1049,26155,3575883711,3575883729,18
3,1049,26156,3575883711,3575883730,19
3,1049,26157,3575883711,3575883730,19
3,1049,26158,3575883711,3575883731,20
3,1049,26159,3575883711,3575883733,22
3,1049,26160,3575883711,3575883734,23
3,1049,26161,3575883711,3575883736,25
3,1049,26162,3575883711,3575883737,26
3,1049,26163,3575883711,3575883741,30
3,1049,26164,3575883711,3575883742,31
3,1049,26165,3575883711,3575883743,32
3,1049,26166,3575883711,3575883743,32
3,1049,26167,3575883711,3575883744,33
3,1049,26168,3575883711,3575883749,38
3,1049,26169,3575883711,3575883751,40
3,1049,26170,3575883711,3575883752,41
3,1049,26171,3575883711,3575883753,42
3,1049,26172,3575883711,3575883754,43
3,1049,26173,3575883711,3575883755,44
3,1049,26174,3575883711,3575883760,49
3,1049,26175,3575883711,3575883760,49
3,1049,26176,3575883711,3575883761,50
3,1050,26177,3575883773,3575883773,0
3,1050,26178,3575883773,3575883773,0
3,1050,26179,3575883773,3575883773,0
3,1050,26180,3575883773,3575883773,0
3,1050,26181,3575883773,3575883773,0
3,1050,26182,3575883773,3575883773,0
3,1050,26183,3575883773,3575883773,0
3,1050,26184,3575883773,3575883773,0
3,1050,26185,3575883773,3575883774,1
3,1050,26186,3575883773,3575883775,2
3,1050,26187,3575883773,3575883777,4
3,1050,26188,3575883773,3575883778,5
3,1050,26189,3575883773,3575883779,6
3,1050,26190,3575883773,3575883780,7
3,1050,26191,3575883773,3575883780,7
3,1050,26192,3575883773,3575883781,8
3,1050,26193,3575883773,3575883781,8
3,1050,26194,3575883773,3575883783,10
3,1050,26195,3575883773,3575883786,13
3,1050,26196,3575883773,3575883787,14
3,1050,26197,3575883773,3575883787,14
3,1050,26198,3575883773,3575883787,14
3,1050,26199,3575883773,3575883791,18
3,1050,26200,3575883773,3575883792,19
3,1050,26201,3575883773,3575883792,19
3,1050,26202,3575883773,3575883793,20
3,1050,26203,3575883773,3575883793,20
3,1050,26204,3575883773,3575883794,21
3,1050,26205,3575883773,3575883795,22
3,1050,26206,3575883773,3575883795,22
3,1050,26207,3575883773,3575883796,23
3,1050,26208,3575883773,3575883796,23
3,1050,26209,3575883773,3575883796,23
3,1050,26210,3575883773,3575883796,23
3,1050,26211,3575883773,3575883796,23
3,1050,26212,3575883773,3575883798,25
3,1050,26213,3575883773,3575883799,26
3,1050,26214,3575883773,3575883800,27
3,1050,26215,3575883773,3575883800,27
3,1050,26216,3575883773,3575883801,28
3,1050,26217,3575883773,3575883801,28
3,1050,26218,3575883773,3575883802,29
3,1050,26219,3575883773,3575883802,29
3,1050,26220,3575883773,3575883803,30
3,1050,26221,3575883773,3575883804,31
3,1050,26222,3575883773,3575883804,31
3,1050,26223,3575883773,3575883805,32
3,1050,26224,3575883773,3575883811,38
3,1050,26225,3575883773,3575883815,42
3,1050,26226,3575883773,3575883816,43
3,1050,26227,3575883773,3575883817,44
3,1050,26228,3575883773,3575883819,46
3,1050,26229,3575883773,3575883819,46
3,1050,26230,3575883773,3575883820,47
3,1050,26231,3575883773,3575883821,48
3,1050,26232,3575883773,3575883822,49
3,1050,26233,3575883773,3575883823,50
3,1051,26234,3575883840,3575883840,0
3,1051,26235,3575883840,3575883840,0
3,1051,26236,3575883840,3575883840,0
3,1051,26237,3575883840,3575883840,0
3,1051,26238,3575883840,3575883840,0
3,1051,26239,3575883840,3575883840,0
3,1051,26240,3575883840,3575883840,0
3,1051,26241,3575883840,3575883840,0
3,1051,26242,3575883840,3575883840,0
3,1051,26243,3575883840,3575883840,0
3,1051,26244,3575883840,3575883840,0
3,1051,26245,3575883840,3575883840,0
3,1051,26246,3575883840,3575883840,0
3,1051,26247,3575883840,3575883840,0
3,1051,26248,3575883840,3575883840,0
3,1051,26249,3575883840,3575883840,0
3,1051,26250,3575883840,3575883840,0
3,1051,26251,3575883840,3575883840,0
3,1051,26252,3575883840,3575883840,0
3,1051,26253,3575883840,3575883840,0
3,1051,26254,3575883840,3575883841,1
3,1051,26255,3575883840,3575883842,2
3,1051,26256,3575883840,3575883843,3
3,1051,26257,3575883840,3575883843,3
3,1051,26258,3575883840,3575883843,3
3,1051,26259,3575883840,3575883844,4
3,1051,26260,3575883840,3575883844,4
3,1051,26261,3575883840,3575883845,5
3,1051,26262,3575883840,3575883849,9
3,1051,26263,3575883840,3575883850,10
3,1051,26264,3575883840,3575883851,11
3,1051,26265,3575883840,3575883852,12
3,1051,26266,3575883840,3575883853,13
3,1051,26267,3575883840,3575883855,15
3,1051,26268,3575883840,3575883857,17
3,1051,26269,3575883840,3575883857,17
3,1051,26270,3575883840,3575883858,18
3,1051,26271,3575883840,3575883859,19
3,1051,26272,3575883840,3575883859,19
3,1051,26273,3575883840,3575883860,20
3,1051,26274,3575883840,3575883860,20
3,1051,26275,3575883840,3575883862,22
3,1051,26276,3575883840,3575883862,22
3,1051,26277,3575883840,3575883863,23
3,1051,26278,3575883840,3575883864,24
3,1051,26279,3575883840,3575883865,25
3,1051,26280,3575883840,3575883866,26
3,1051,26281,3575883840,3575883866,26
3,1051,26282,3575883840,3575883868,28
3,1051,26283,3575883840,3575883868,28
3,1051,26284,3575883840,3575883869,29
3,1051,26285,3575883840,3575883874,34
3,1051,26286,3575883840,3575883877,37
3,1051,26287,3575883840,3575883877,37
3,1051,26288,3575883840,3575883881,41
3,1051,26289,3575883840,3575883881,41
3,1051,26290,3575883840,3575883883,43
3,1051,26291,3575883840,3575883884,44
3,1051,26292,3575883840,3575883885,45
3,1051,26293,3575883840,3575883885,45
3,1051,26294,3575883840,3575883886,46
3,1051,26295,3575883840,3575883888,48
3,1051,26296,3575883840,3575883888,48
3,1051,26297,3575883840,3575883888,48
3,1051,26298,3575883840,3575883888,48
3,1051,26299,3575883840,3575883889,49
3,1051,26300,3575883840,3575883890,50
3,1052,26301,3575883902,3575883902,0
3,1052,26302,3575883902,3575883902,0
3,1052,26303,3575883902,3575883902,0
3,1052,26304,3575883902,3575883902,0
3,1052,26305,3575883902,3575883902,0
3,1052,26306,3575883902,3575883902,0
3,1052,26307,3575883902,3575883902,0
3,1052,26308,3575883902,3575883902,0
3,1052,26309,3575883902,3575883902,0
3,1052,26310,3575883902,3575883902,0
3,1052,26311,3575883902,3575883902,0
3,1052,26312,3575883902,3575883902,0
3,1052,26313,3575883902,3575883903,1
3,1052,26314,3575883902,3575883904,2
3,1052,26315,3575883902,3575883906,4
3,1052,26316,3575883902,3575883906,4
3,1052,26317,3575883902,3575883907,5
3,1052,26318,3575883902,3575883907,5
3,1052,26319,3575883902,3575883908,6
3,1052,26320,3575883902,3575883908,6
3,1052,26321,3575883902,3575883911,9
3,1052,26322,3575883902,3575883912,10
3,1052,26323,3575883902,3575883912,10
3,1052,26324,3575883902,3575883913,11
3,1052,26325,3575883902,3575883913,11
3,1052,26326,3575883902,3575883915,13
3,1052,26327,3575883902,3575883915,13
3,1052,26328,3575883902,3575883917,15
3,1052,26329,3575883902,3575883919,17
3,1052,26330,3575883902,3575883919,17
3,1052,26331,3575883902,3575883920,18
3,1052,26332,3575883902,3575883921,19
3,1052,26333,3575883902,3575883923,21
3,1052,26334,3575883902,3575883923,21
3,1052,26335,3575883902,3575883925,23
3,1052,26336,3575883902,3575883926,24
3,1052,26337,3575883902,3575883929,27
3,1052,26338,3575883902,3575883930,28
3,1052,26339,3575883902,3575883931,29
3,1052,26340,3575883902,3575883931,29
3,1052,26341,3575883902,3575883932,30
3,1052,26342,3575883902,3575883934,32
3,1052,26343,3575883902,3575883937,35
3,1052,26344,3575883902,3575883937,35
3,1052,26345,3575883902,3575883941,39
3,1052,26346,3575883902,3575883942,40
3,1052,26347,3575883902,3575883943,41
3,1052,26348,3575883902,3575883944,42
3,1052,26349,3575883902,3575883944,42
3,1052,26350,3575883902,3575883949,47
3,1052,26351,3575883902,3575883951,49
3,1052,26352,3575883902,3575883952,50
3,1053,26353,3575883968,3575883968,0
3,1053,26354,3575883968,3575883968,0
3,1053,26355,3575883968,3575883968,0
3,1053,26356,3575883968,3575883968,0
3,1053,26357,3575883968,3575883968,0
3,1053,26358,3575883968,3575883968,0
3,1053,26359,3575883968,3575883968,0
3,1053,26360,3575883968,3575883968,0
3,1053,26361,3575883968,3575883968,0
3,1053,26362,3575883968,3575883968,0
3,1053,26363,3575883968,3575883970,2
3,1053,26364,3575883968,3575883971,3
3,1053,26365,3575883968,3575883973,5
3,1053,26366,3575883968,3575883975,7
3,1053,26367,3575883968,3575883976,8
3,1053,26368,3575883968,3575883977,9
3,1053,26369,3575883968,3575883978,10
3,1053,26370,3575883968,3575883979,11
3,1053,26371,3575883968,3575883980,12
3,1053,26372,3575883968,3575883981,13
3,1053,26373,3575883968,3575883981,13
3,1053,26374,3575883968,3575883981,13
3,1053,26375,3575883968,3575883983,15
3,1053,26376,3575883968,3575883986,18
3,1053,26377,3575883968,3575883986,18
3,1053,26378,3575883968,3575883987,19
3,1053,26379,3575883968,3575883987,19
3,1053,26380,3575883968,3575883991,23
3,1053,26381,3575883968,3575883991,23
3,1053,26382,3575883968,3575883993,25
3,1053,26383,3575883968,3575883994,26
3,1053,26384,3575883968,3575883995,27
3,1053,26385,3575883968,3575883995,27
3,1053,26386,3575883968,3575883995,27
3,1053,26387,3575883968,3575883995,27
3,1053,26388,3575883968,3575883996,28
3,1053,26389,3575883968,3575883996,28
3,1053,26390,3575883968,3575883996,28
3,1053,26391,3575883968,3575883997,29
3,1053,26392,3575883968,3575883999,31
3,1053,26393,3575883968,3575884000,32
3,1053,26394,3575883968,3575884000,32
3,1053,26395,3575883968,3575884000,32
3,1053,26396,3575883968,3575884001,33
3,1053,26397,3575883968,3575884001,33
3,1053,26398,3575883968,3575884002,34
3,1053,26399,3575883968,3575884002,34
3,1053,26400,3575883968,3575884003,35
3,1053,26401,3575883968,3575884004,36
3,1053,26402,3575883968,3575884004,36
3,1053,26403,3575883968,3575884006,38
3,1053,26404,3575883968,3575884011,43
3,1053,26405,3575883968,3575884016,48
3,1053,26406,3575883968,3575884017,49
3,1054,26407,3575884033,3575884033,0
3,1054,26408,3575884033,3575884033,0
3,1054,26409,3575884033,3575884033,0
3,1054,26410,3575884033,3575884033,0
3,1054,26411,3575884033,3575884033,0
3,1054,26412,3575884033,3575884033,0
3,1054,26413,3575884033,3575884033,0
3,1054,26414,3575884033,3575884033,0
3,1054,26415,3575884033,3575884033,0
3,1054,26416,3575884033,3575884033,0
3,1054,26417,3575884033,3575884033,0
3,1054,26418,3575884033,3575884033,0
3,1054,26419,3575884033,3575884033,0
3,1054,26420,3575884033,3575884033,0
3,1054,26421,3575884033,3575884033,0
3,1054,26422,3575884033,3575884033,0
3,1054,26423,3575884033,3575884033,0
3,1054,26424,3575884033,3575884034,1
3,1054,26425,3575884033,3575884036,3
3,1054,26426,3575884033,3575884037,4
3,1054,26427,3575884033,3575884037,4
3,1054,26428,3575884033,3575884038,5
3,1054,26429,3575884033,3575884038,5
3,1054,26430,3575884033,3575884038,5
3,1054,26431,3575884033,3575884040,7
3,1054,26432,3575884033,3575884042,9
3,1054,26433,3575884033,3575884043,10
3,1054,26434,3575884033,3575884043,10
3,1054,26435,3575884033,3575884043,10
3,1054,26436,3575884033,3575884044,11
3,1054,26437,3575884033,3575884044,11
3,1054,26438,3575884033,3575884046,13
3,1054,26439,3575884033,3575884046,13
3,1054,26440,3575884033,3575884047,14
3,1054,26441,3575884033,3575884051,18
3,1054,26442,3575884033,3575884051,18
3,1054,26443,3575884033,3575884052,19
3,1054,26444,3575884033,3575884054,21
3,1054,26445,3575884033,3575884054,21
3,1054,26446,3575884033,3575884057,24
3,1054,26447,3575884033,3575884058,25
3,1054,26448,3575884033,3575884058,25
3,1054,26449,3575884033,3575884059,26
3,1054,26450,3575884033,3575884059,26
3,1054,26451,3575884033,3575884060,27
3,1054,26452,3575884033,3575884061,28
3,1054,26453,3575884033,3575884061,28
3,1054,26454,3575884033,3575884063,30
3,1054,26455,3575884033,3575884063,30
3,1054,26456,3575884033,3575884064,31
3,1054,26457,3575884033,3575884064,31
3,1054,26458,3575884033,3575884066,33
3,1054,26459,3575884033,3575884066,33
3,1054,26460,3575884033,3575884067,34
3,1054,26461,3575884033,3575884068,35
3,1054,26462,3575884033,3575884068,35
3,1054,26463,3575884033,3575884069,36
3,1054,26464,3575884033,3575884074,41
3,1054,26465,3575884033,3575884077,44
3,1054,26466,3575884033,3575884077,44
3,1054,26467,3575884033,3575884081,48
3,1054,26468,3575884033,3575884082,49
3,1054,26469,3575884033,3575884083,50
3,1055,26470,3575884096,3575884096,0
3,1055,26471,3575884096,3575884096,0
3,1055,26472,3575884096,3575884096,0
3,1055,26473,3575884096,3575884096,0
3,1055,26474,3575884096,3575884096,0
3,1055,26475,3575884096,3575884096,0
3,1055,26476,3575884096,3575884096,0
3,1055,26477,3575884096,3575884096,0
3,1055,26478,3575884096,3575884096,0
3,1055,26479,3575884096,3575884096,0
3,1055,26480,3575884096,3575884096,0
3,1055,26481,3575884096,3575884096,0
3,1055,26482,3575884096,3575884096,0
3,1055,26483,3575884096,3575884096,0
3,1055,26484,3575884096,3575884096,0
3,1055,26485,3575884096,3575884097,1
3,1055,26486,3575884096,3575884097,1
3,1055,26487,3575884096,3575884099,3
3,1055,26488,3575884096,3575884100,4
3,1055,26489,3575884096,3575884100,4
3,1055,26490,3575884096,3575884101,5
3,1055,26491,3575884096,3575884102,6
3,1055,26492,3575884096,3575884102,6
3,1055,26493,3575884096,3575884105,9
3,1055,26494,3575884096,3575884106,10
3,1055,26495,3575884096,3575884106,10
3,1055,26496,3575884096,3575884107,11
3,1055,26497,3575884096,3575884108,12
3,1055,26498,3575884096,3575884109,13
3,1055,26499,3575884096,3575884111,15
3,1055,26500,3575884096,3575884112,16
3,1055,26501,3575884096,3575884113,17
3,1055,26502,3575884096,3575884113,17
3,1055,26503,3575884096,3575884113,17
3,1055,26504,3575884096,3575884114,18
3,1055,26505,3575884096,3575884116,20
3,1055,26506,3575884096,3575884117,21
3,1055,26507,3575884096,3575884119,23
3,1055,26508,3575884096,3575884119,23
3,1055,26509,3575884096,3575884121,25
3,1055,26510,3575884096,3575884122,26
3,1055,26511,3575884096,3575884123,27
3,1055,26512,3575884096,3575884124,28
3,1055,26513,3575884096,3575884125,29
3,1055,26514,3575884096,3575884126,30
3,1055,26515,3575884096,3575884128,32
3,1055,26516,3575884096,3575884130,34
3,1055,26517,3575884096,3575884131,35
3,1055,26518,3575884096,3575884131,35
3,1055,26519,3575884096,3575884132,36
3,1055,26520,3575884096,3575884133,37
3,1055,26521,3575884096,3575884134,38
3,1055,26522,3575884096,3575884137,41
3,1055,26523,3575884096,3575884137,41
3,1055,26524,3575884096,3575884141,45
3,1055,26525,3575884096,3575884143,47
3,1055,26526,3575884096,3575884143,47
3,1055,26527,3575884096,3575884143,47
3,1055,26528,3575884096,3575884144,48
3,1056,26529,3575884163,3575884163,0
3,1056,26530,3575884163,3575884163,0
3,1056,26531,3575884163,3575884163,0
3,1056,26532,3575884163,3575884163,0
3,1056,26533,3575884163,3575884163,0
3,1056,26534,3575884163,3575884163,0
3,1056,26535,3575884163,3575884163,0
3,1056,26536,3575884163,3575884163,0
3,1056,26537,3575884163,3575884167,4
3,1056,26538,3575884163,3575884168,5
3,1056,26539,3575884163,3575884169,6
3,1056,26540,3575884163,3575884169,6
3,1056,26541,3575884163,3575884171,8
3,1056,26542,3575884163,3575884171,8
3,1056,26543,3575884163,3575884173,10
3,1056,26544,3575884163,3575884174,11
3,1056,26545,3575884163,3575884177,14
3,1056,26546,3575884163,3575884178,15
3,1056,26547,3575884163,3575884178,15
3,1056,26548,3575884163,3575884180,17
3,1056,26549,3575884163,3575884181,18
3,1056,26550,3575884163,3575884181,18
3,1056,26551,3575884163,3575884181,18
3,1056,26552,3575884163,3575884181,18
3,1056,26553,3575884163,3575884184,21
3,1056,26554,3575884163,3575884185,22
3,1056,26555,3575884163,3575884187,24
3,1056,26556,3575884163,3575884187,24
3,1056,26557,3575884163,3575884191,28
3,1056,26558,3575884163,3575884191,28
3,1056,26559,3575884163,3575884194,31
3,1056,26560,3575884163,3575884195,32
3,1056,26561,3575884163,3575884195,32
3,1056,26562,3575884163,3575884195,32
3,1056,26563,3575884163,3575884196,33
3,1056,26564,3575884163,3575884196,33
3,1056,26565,3575884163,3575884196,33
3,1056,26566,3575884163,3575884197,34
3,1056,26567,3575884163,3575884198,35
3,1056,26568,3575884163,3575884199,36
3,1056,26569,3575884163,3575884200,37
3,1056,26570,3575884163,3575884200,37
3,1056,26571,3575884163,3575884200,37
3,1056,26572,3575884163,3575884201,38
3,1056,26573,3575884163,3575884202,39
3,1056,26574,3575884163,3575884202,39
3,1056,26575,3575884163,3575884203,40
3,1056,26576,3575884163,3575884204,41
3,1056,26577,3575884163,3575884204,41
3,1056,26578,3575884163,3575884204,41
3,1056,26579,3575884163,3575884212,49
3,1057,26580,3575884227,3575884227,0
3,1057,26581,3575884227,3575884227,0
3,1057,26582,3575884227,3575884227,0
3,1057,26583,3575884227,3575884227,0
3,1057,26584,3575884227,3575884227,0
3,1057,26585,3575884227,3575884227,0
3,1057,26586,3575884227,3575884227,0
3,1057,26587,3575884227,3575884227,0
3,1057,26588,3575884227,3575884227,0
3,1057,26589,3575884227,3575884227,0
3,1057,26590,3575884227,3575884228,1
3,1057,26591,3575884227,3575884228,1
3,1057,26592,3575884227,3575884228,1
3,1057,26593,3575884227,3575884229,2
3,1057,26594,3575884227,3575884229,2
3,1057,26595,3575884227,3575884229,2
3,1057,26596,3575884227,3575884230,3
3,1057,26597,3575884227,3575884231,4
3,1057,26598,3575884227,3575884232,5
3,1057,26599,3575884227,3575884233,6
3,1057,26600,3575884227,3575884235,8
3,1057,26601,3575884227,3575884237,10
3,1057,26602,3575884227,3575884237,10
3,1057,26603,3575884227,3575884237,10
3,1057,26604,3575884227,3575884238,11
3,1057,26605,3575884227,3575884239,12
3,1057,26606,3575884227,3575884239,12
3,1057,26607,3575884227,3575884241,14
3,1057,26608,3575884227,3575884242,15
3,1057,26609,3575884227,3575884242,15
3,1057,26610,3575884227,3575884243,16
3,1057,26611,3575884227,3575884243,16
3,1057,26612,3575884227,3575884244,17
3,1057,26613,3575884227,3575884244,17
3,1057,26614,3575884227,3575884246,19
3,1057,26615,3575884227,3575884247,20
3,1057,26616,3575884227,3575884248,21
3,1057,26617,3575884227,3575884249,22
3,1057,26618,3575884227,3575884250,23
3,1057,26619,3575884227,3575884252,25
3,1057,26620,3575884227,3575884254,27
3,1057,26621,3575884227,3575884254,27
3,1057,26622,3575884227,3575884257,30
3,1057,26623,3575884227,3575884257,30
3,1057,26624,3575884227,3575884258,31
3,1057,26625,3575884227,3575884259,32
3,1057,26626,3575884227,3575884259,32
3,1057,26627,3575884227,3575884260,33
3,1057,26628,3575884227,3575884261,34
3,1057,26629,3575884227,3575884262,35
3,1057,26630,3575884227,3575884262,35
3,1057,26631,3575884227,3575884264,37
3,1057,26632,3575884227,3575884264,37
3,1057,26633,3575884227,3575884264,37
3,1057,26634,3575884227,3575884265,38
3,1057,26635,3575884227,3575884266,39
3,1057,26636,3575884227,3575884266,39
3,1057,26637,3575884227,3575884267,40
3,1057,26638,3575884227,3575884268,41
3,1057,26639,3575884227,3575884268,41
3,1057,26640,3575884227,3575884270,43
3,1057,26641,3575884227,3575884274,47
3,1057,26642,3575884227,3575884276,49
3,1057,26643,3575884227,3575884277,50
3,1058,26644,3575884292,3575884292,0
3,1058,26645,3575884292,3575884292,0
3,1058,26646,3575884292,3575884292,0
3,1058,26647,3575884292,3575884292,0
3,1058,26648,3575884292,3575884292,0
3,1058,26649,3575884292,3575884292,0
3,1058,26650,3575884292,3575884293,1
3,1058,26651,3575884292,3575884293,1
3,1058,26652,3575884292,3575884293,1
3,1058,26653,3575884292,3575884293,1
3,1058,26654,3575884292,3575884293,1
3,1058,26655,3575884292,3575884293,1
3,1058,26656,3575884292,3575884293,1
3,1058,26657,3575884292,3575884293,1
3,1058,26658,3575884292,3575884293,1
3,1058,26659,3575884292,3575884293,1
3,1058,26660,3575884292,3575884295,3
3,1058,26661,3575884292,3575884297,5
3,1058,26662,3575884292,3575884297,5
3,1058,26663,3575884292,3575884299,7
3,1058,26664,3575884292,3575884300,8
3,1058,26665,3575884292,3575884301,9
3,1058,26666,3575884292,3575884302,10
3,1058,26667,3575884292,3575884302,10
3,1058,26668,3575884292,3575884303,11
3,1058,26669,3575884292,3575884305,13
3,1058,26670,3575884292,3575884306,14
3,1058,26671,3575884292,3575884306,14
3,1058,26672,3575884292,3575884307,15
3,1058,26673,3575884292,3575884307,15
3,1058,26674,3575884292,3575884308,16
3,1058,26675,3575884292,3575884308,16
3,1058,26676,3575884292,3575884311,19
3,1058,26677,3575884292,3575884312,20
3,1058,26678,3575884292,3575884313,21
3,1058,26679,3575884292,3575884313,21
3,1058,26680,3575884292,3575884313,21
3,1058,26681,3575884292,3575884315,23
3,1058,26682,3575884292,3575884316,24
3,1058,26683,3575884292,3575884319,27
3,1058,26684,3575884292,3575884319,27
3,1058,26685,3575884292,3575884322,30
3,1058,26686,3575884292,3575884323,31
3,1058,26687,3575884292,3575884323,31
3,1058,26688,3575884292,3575884324,32
3,1058,26689,3575884292,3575884327,35
3,1058,26690,3575884292,3575884329,37
3,1058,26691,3575884292,3575884333,41
3,1058,26692,3575884292,3575884333,41
3,1058,26693,3575884292,3575884334,42
3,1058,26694,3575884292,3575884337,45
3,1058,26695,3575884292,3575884338,46
3,1058,26696,3575884292,3575884341,49
3,1059,26697,3575884356,3575884356,0
3,1059,26698,3575884356,3575884356,0
3,1059,26699,3575884356,3575884356,0
3,1059,26700,3575884356,3575884356,0
3,1059,26701,3575884356,3575884356,0
3,1059,26702,3575884356,3575884356,0
3,1059,26703,3575884356,3575884356,0
3,1059,26704,3575884356,3575884356,0
3,1059,26705,3575884356,3575884360,4
3,1059,26706,3575884356,3575884361,5
3,1059,26707,3575884356,3575884362,6
3,1059,26708,3575884356,3575884364,8
3,1059,26709,3575884356,3575884365,9
3,1059,26710,3575884356,3575884367,11
3,1059,26711,3575884356,3575884368,12
3,1059,26712,3575884356,3575884369,13
3,1059,26713,3575884356,3575884369,13
3,1059,26714,3575884356,3575884371,15
3,1059,26715,3575884356,3575884371,15
3,1059,26716,3575884356,3575884373,17
3,1059,26717,3575884356,3575884376,20
3,1059,26718,3575884356,3575884378,22
3,1059,26719,3575884356,3575884379,23
3,1059,26720,3575884356,3575884380,24
3,1059,26721,3575884356,3575884380,24
3,1059,26722,3575884356,3575884381,25
3,1059,26723,3575884356,3575884381,25
3,1059,26724,3575884356,3575884382,26
3,1059,26725,3575884356,3575884384,28
3,1059,26726,3575884356,3575884385,29
3,1059,26727,3575884356,3575884387,31
3,1059,26728,3575884356,3575884388,32
3,1059,26729,3575884356,3575884391,35
3,1059,26730,3575884356,3575884392,36
3,1059,26731,3575884356,3575884393,37
3,1059,26732,3575884356,3575884395,39
3,1059,26733,3575884356,3575884395,39
3,1059,26734,3575884356,3575884396,40
3,1059,26735,3575884356,3575884396,40
3,1059,26736,3575884356,3575884397,41
3,1059,26737,3575884356,3575884397,41
3,1059,26738,3575884356,3575884398,42
3,1059,26739,3575884356,3575884399,43
3,1059,26740,3575884356,3575884400,44
3,1059,26741,3575884356,3575884400,44
3,1059,26742,3575884356,3575884400,44
3,1059,26743,3575884356,3575884401,45
3,1059,26744,3575884356,3575884401,45
3,1059,26745,3575884356,3575884402,46
3,1059,26746,3575884356,3575884403,47
3,1059,26747,3575884356,3575884404,48
3,1059,26748,3575884356,3575884404,48
3,1059,26749,3575884356,3575884404,48
3,1059,26750,3575884356,3575884406,50
3,1060,26751,3575884424,3575884424,0
3,1060,26752,3575884424,3575884424,0
3,1060,26753,3575884424,3575884424,0
3,1060,26754,3575884424,3575884424,0
3,1060,26755,3575884424,3575884424,0
3,1060,26756,3575884424,3575884424,0
3,1060,26757,3575884424,3575884424,0
3,1060,26758,3575884424,3575884424,0
3,1060,26759,3575884424,3575884424,0
3,1060,26760,3575884424,3575884424,0
3,1060,26761,3575884424,3575884424,0
3,1060,26762,3575884424,3575884427,3
3,1060,26763,3575884424,3575884427,3
3,1060,26764,3575884424,3575884428,4
3,1060,26765,3575884424,3575884428,4
3,1060,26766,3575884424,3575884428,4
3,1060,26767,3575884424,3575884429,5
3,1060,26768,3575884424,3575884431,7
3,1060,26769,3575884424,3575884431,7
3,1060,26770,3575884424,3575884432,8
3,1060,26771,3575884424,3575884432,8
3,1060,26772,3575884424,3575884433,9
3,1060,26773,3575884424,3575884435,11
3,1060,26774,3575884424,3575884436,12
3,1060,26775,3575884424,3575884437,13
3,1060,26776,3575884424,3575884437,13
3,1060,26777,3575884424,3575884438,14
3,1060,26778,3575884424,3575884439,15
3,1060,26779,3575884424,3575884439,15
3,1060,26780,3575884424,3575884441,17
3,1060,26781,3575884424,3575884442,18
3,1060,26782,3575884424,3575884442,18
3,1060,26783,3575884424,3575884443,19
3,1060,26784,3575884424,3575884443,19
3,1060,26785,3575884424,3575884444,20
3,1060,26786,3575884424,3575884444,20
3,1060,26787,3575884424,3575884446,22
3,1060,26788,3575884424,3575884447,23
3,1060,26789,3575884424,3575884448,24
3,1060,26790,3575884424,3575884449,25
3,1060,26791,3575884424,3575884450,26
3,1060,26792,3575884424,3575884453,29
3,1060,26793,3575884424,3575884453,29
3,1060,26794,3575884424,3575884454,30
3,1060,26795,3575884424,3575884455,31
3,1060,26796,3575884424,3575884457,33
3,1060,26797,3575884424,3575884458,34
3,1060,26798,3575884424,3575884459,35
3,1060,26799,3575884424,3575884459,35
3,1060,26800,3575884424,3575884461,37
3,1060,26801,3575884424,3575884462,38
3,1060,26802,3575884424,3575884462,38
3,1060,26803,3575884424,3575884463,39
3,1060,26804,3575884424,3575884464,40
3,1060,26805,3575884424,3575884464,40
3,1060,26806,3575884424,3575884465,41
3,1060,26807,3575884424,3575884466,42
3,1060,26808,3575884424,3575884466,42
3,1060,26809,3575884424,3575884468,44
3,1060,26810,3575884424,3575884468,44
3,1060,26811,3575884424,3575884470,46
3,1061,26812,3575884486,3575884486,0
3,1061,26813,3575884486,3575884486,0
3,1061,26814,3575884486,3575884486,0
3,1061,26815,3575884486,3575884486,0
3,1061,26816,3575884486,3575884486,0
3,1061,26817,3575884486,3575884486,0
3,1061,26818,3575884486,3575884486,0
3,1061,26819,3575884486,3575884486,0
3,1061,26820,3575884486,3575884486,0
3,1061,26821,3575884486,3575884487,1
3,1061,26822,3575884486,3575884487,1
3,1061,26823,3575884486,3575884488,2
3,1061,26824,3575884486,3575884488,2
3,1061,26825,3575884486,3575884488,2
3,1061,26826,3575884486,3575884489,3
3,1061,26827,3575884486,3575884490,4
3,1061,26828,3575884486,3575884494,8
3,1061,26829,3575884486,3575884496,10
3,1061,26830,3575884486,3575884499,13
3,1061,26831,3575884486,3575884499,13
3,1061,26832,3575884486,3575884500,14
3,1061,26833,3575884486,3575884501,15
3,1061,26834,3575884486,3575884501,15
3,1061,26835,3575884486,3575884502,16
3,1061,26836,3575884486,3575884504,18
3,1061,26837,3575884486,3575884505,19
3,1061,26838,3575884486,3575884505,19
3,1061,26839,3575884486,3575884505,19
3,1061,26840,3575884486,3575884506,20
3,1061,26841,3575884486,3575884507,21
3,1061,26842,3575884486,3575884508,22
3,1061,26843,3575884486,3575884509,23
3,1061,26844,3575884486,3575884511,25
3,1061,26845,3575884486,3575884512,26
3,1061,26846,3575884486,3575884512,26
3,1061,26847,3575884486,3575884513,27
3,1061,26848,3575884486,3575884513,27
3,1061,26849,3575884486,3575884515,29
3,1061,26850,3575884486,3575884516,30
3,1061,26851,3575884486,3575884518,32
3,1061,26852,3575884486,3575884519,33
3,1061,26853,3575884486,3575884521,35
3,1061,26854,3575884486,3575884522,36
3,1061,26855,3575884486,3575884522,36
3,1061,26856,3575884486,3575884523,37
3,1061,26857,3575884486,3575884526,40
3,1061,26858,3575884486,3575884528,42
3,1061,26859,3575884486,3575884530,44
3,1061,26860,3575884486,3575884531,45
3,1061,26861,3575884486,3575884532,46
3,1061,26862,3575884486,3575884532,46
3,1061,26863,3575884486,3575884533,47
3,1061,26864,3575884486,3575884536,50
3,1062,26865,3575884552,3575884552,0
3,1062,26866,3575884552,3575884552,0
3,1062,26867,3575884552,3575884552,0
3,1062,26868,3575884552,3575884552,0
3,1062,26869,3575884552,3575884552,0
3,1062,26870,3575884552,3575884552,0
3,1062,26871,3575884552,3575884552,0
3,1062,26872,3575884552,3575884552,0
3,1062,26873,3575884552,3575884553,1
3,1062,26874,3575884552,3575884560,8
3,1062,26875,3575884552,3575884560,8
3,1062,26876,3575884552,3575884563,11
3,1062,26877,3575884552,3575884564,12
3,1062,26878,3575884552,3575884566,14
3,1062,26879,3575884552,3575884568,16
3,1062,26880,3575884552,3575884569,17
3,1062,26881,3575884552,3575884570,18
3,1062,26882,3575884552,3575884570,18
3,1062,26883,3575884552,3575884570,18
3,1062,26884,3575884552,3575884573,21
3,1062,26885,3575884552,3575884578,26
3,1062,26886,3575884552,3575884578,26
3,1062,26887,3575884552,3575884579,27
3,1062,26888,3575884552,3575884579,27
3,1062,26889,3575884552,3575884579,27
3,1062,26890,3575884552,3575884580,28
3,1062,26891,3575884552,3575884581,29
3,1062,26892,3575884552,3575884582,30
3,1062,26893,3575884552,3575884585,33
3,1062,26894,3575884552,3575884586,34
3,1062,26895,3575884552,3575884587,35
3,1062,26896,3575884552,3575884590,38
3,1062,26897,3575884552,3575884590,38
3,1062,26898,3575884552,3575884592,40
3,1062,26899,3575884552,3575884592,40
3,1062,26900,3575884552,3575884593,41
3,1062,26901,3575884552,3575884595,43
3,1062,26902,3575884552,3575884595,43
3,1062,26903,3575884552,3575884595,43
3,1062,26904,3575884552,3575884595,43
3,1062,26905,3575884552,3575884596,44
3,1062,26906,3575884552,3575884596,44
3,1062,26907,3575884552,3575884597,45
3,1062,26908,3575884552,3575884599,47
3,1062,26909,3575884552,3575884599,47
3,1062,26910,3575884552,3575884599,47
3,1062,26911,3575884552,3575884600,48
3,1062,26912,3575884552,3575884600,48
3,1062,26913,3575884552,3575884601,49
3,1062,26914,3575884552,3575884602,50
3,1063,26915,3575884613,3575884613,0
3,1063,26916,3575884613,3575884613,0
3,1063,26917,3575884613,3575884613,0
3,1063,26918,3575884613,3575884613,0
3,1063,26919,3575884613,3575884613,0
3,1063,26920,3575884613,3575884613,0
3,1063,26921,3575884613,3575884615,2
3,1063,26922,3575884613,3575884616,3
3,1063,26923,3575884613,3575884617,4
3,1063,26924,3575884613,3575884619,6
3,1063,26925,3575884613,3575884619,6
3,1063,26926,3575884613,3575884621,8
3,1063,26927,3575884613,3575884622,9
3,1063,26928,3575884613,3575884622,9
3,1063,26929,3575884613,3575884623,10
3,1063,26930,3575884613,3575884624,11
3,1063,26931,3575884613,3575884625,12
3,1063,26932,3575884613,3575884625,12
3,1063,26933,3575884613,3575884626,13
3,1063,26934,3575884613,3575884628,15
3,1063,26935,3575884613,3575884628,15
3,1063,26936,3575884613,3575884628,15
3,1063,26937,3575884613,3575884628,15
3,1063,26938,3575884613,3575884628,15
3,1063,26939,3575884613,3575884629,16
3,1063,26940,3575884613,3575884630,17
3,1063,26941,3575884613,3575884630,17
3,1063,26942,3575884613,3575884630,17
3,1063,26943,3575884613,3575884631,18
3,1063,26944,3575884613,3575884632,19
3,1063,26945,3575884613,3575884635,22
3,1063,26946,3575884613,3575884635,22
3,1063,26947,3575884613,3575884636,23
3,1063,26948,3575884613,3575884637,24
3,1063,26949,3575884613,3575884637,24
3,1063,26950,3575884613,3575884638,25
3,1063,26951,3575884613,3575884638,25
3,1063,26952,3575884613,3575884640,27
3,1063,26953,3575884613,3575884641,28
3,1063,26954,3575884613,3575884641,28
3,1063,26955,3575884613,3575884642,29
3,1063,26956,3575884613,3575884642,29
3,1063,26957,3575884613,3575884643,30
3,1063,26958,3575884613,3575884645,32
3,1063,26959,3575884613,3575884646,33
3,1063,26960,3575884613,3575884646,33
3,1063,26961,3575884613,3575884647,34
3,1063,26962,3575884613,3575884648,35
3,1063,26963,3575884613,3575884651,38
3,1063,26964,3575884613,3575884652,39
3,1063,26965,3575884613,3575884653,40
3,1063,26966,3575884613,3575884653,40
3,1063,26967,3575884613,3575884656,43
3,1063,26968,3575884613,3575884657,44
3,1063,26969,3575884613,3575884658,45
3,1063,26970,3575884613,3575884658,45
3,1063,26971,3575884613,3575884661,48
3,1063,26972,3575884613,3575884661,48
3,1063,26973,3575884613,3575884662,49
3,1063,26974,3575884613,3575884663,50
3,1064,26975,3575884676,3575884676,0
3,1064,26976,3575884676,3575884676,0
3,1064,26977,3575884676,3575884676,0
3,1064,26978,3575884676,3575884676,0
3,1064,26979,3575884676,3575884676,0
3,1064,26980,3575884676,3575884676,0
3,1064,26981,3575884676,3575884676,0
3,1064,26982,3575884676,3575884677,1
3,1064,26983,3575884676,3575884678,2
3,1064,26984,3575884676,3575884681,5
3,1064,26985,3575884676,3575884681,5
3,1064,26986,3575884676,3575884682,6
3,1064,26987,3575884676,3575884684,8
3,1064,26988,3575884676,3575884685,9
3,1064,26989,3575884676,3575884685,9
3,1064,26990,3575884676,3575884686,10
3,1064,26991,3575884676,3575884687,11
3,1064,26992,3575884676,3575884687,11
3,1064,26993,3575884676,3575884688,12
3,1064,26994,3575884676,3575884688,12
3,1064,26995,3575884676,3575884688,12
3,1064,26996,3575884676,3575884689,13
3,1064,26997,3575884676,3575884689,13
3,1064,26998,3575884676,3575884690,14
3,1064,26999,3575884676,3575884694,18
3,1064,27000,3575884676,3575884696,20
3,1064,27001,3575884676,3575884699,23
3,1064,27002,3575884676,3575884699,23
3,1064,27003,3575884676,3575884701,25
3,1064,27004,3575884676,3575884701,25
3,1064,27005,3575884676,3575884701,25
3,1064,27006,3575884676,3575884703,27
3,1064,27007,3575884676,3575884705,29
3,1064,27008,3575884676,3575884706,30
3,1064,27009,3575884676,3575884706,30
3,1064,27010,3575884676,3575884707,31
3,1064,27011,3575884676,3575884708,32
3,1064,27012,3575884676,3575884710,34
3,1064,27013,3575884676,3575884710,34
3,1064,27014,3575884676,3575884712,36
3,1064,27015,3575884676,3575884712,36
3,1064,27016,3575884676,3575884713,37
3,1064,27017,3575884676,3575884714,38
3,1064,27018,3575884676,3575884716,40
3,1064,27019,3575884676,3575884716,40
3,1064,27020,3575884676,3575884718,42
3,1064,27021,3575884676,3575884718,42
3,1064,27022,3575884676,3575884721,45
3,1064,27023,3575884676,3575884721,45
3,1064,27024,3575884676,3575884722,46
3,1064,27025,3575884676,3575884722,46
3,1064,27026,3575884676,3575884723,47
3,1064,27027,3575884676,3575884726,50
3,1065,27028,3575884741,3575884741,0
3,1065,27029,3575884741,3575884741,0
3,1065,27030,3575884741,3575884741,0
3,1065,27031,3575884741,3575884741,0
3,1065,27032,3575884741,3575884741,0
3,1065,27033,3575884741,3575884741,0
3,1065,27034,3575884741,3575884741,0
3,1065,27035,3575884741,3575884741,0
3,1065,27036,3575884741,3575884741,0
3,1065,27037,3575884741,3575884741,0
3,1065,27038,3575884741,3575884743,2
3,1065,27039,3575884741,3575884743,2
3,1065,27040,3575884741,3575884743,2
3,1065,27041,3575884741,3575884752,11
3,1065,27042,3575884741,3575884754,13
3,1065,27043,3575884741,3575884754,13
3,1065,27044,3575884741,3575884760,19
3,1065,27045,3575884741,3575884760,19
3,1065,27046,3575884741,3575884764,23
3,1065,27047,3575884741,3575884767,26
3,1065,27048,3575884741,3575884767,26
3,1065,27049,3575884741,3575884768,27
3,1065,27050,3575884741,3575884769,28
3,1065,27051,3575884741,3575884770,29
3,1065,27052,3575884741,3575884770,29
3,1065,27053,3575884741,3575884770,29
3,1065,27054,3575884741,3575884774,33
3,1065,27055,3575884741,3575884779,38
3,1065,27056,3575884741,3575884779,38
3,1065,27057,3575884741,3575884780,39
3,1065,27058,3575884741,3575884780,39
3,1065,27059,3575884741,3575884780,39
3,1065,27060,3575884741,3575884780,39
3,1065,27061,3575884741,3575884781,40
3,1065,27062,3575884741,3575884782,41
3,1065,27063,3575884741,3575884785,44
3,1065,27064,3575884741,3575884786,45
3,1065,27065,3575884741,3575884787,46
3,1065,27066,3575884741,3575884787,46
3,1065,27067,3575884741,3575884790,49
3,1065,27068,3575884741,3575884790,49
3,1066,27069,3575884806,3575884806,0
3,1066,27070,3575884806,3575884806,0
3,1066,27071,3575884806,3575884806,0
3,1066,27072,3575884806,3575884806,0
3,1066,27073,3575884806,3575884806,0
3,1066,27074,3575884806,3575884806,0
3,1066,27075,3575884806,3575884806,0
3,1066,27076,3575884806,3575884806,0
3,1066,27077,3575884806,3575884806,0
3,1066,27078,3575884806,3575884806,0
3,1066,27079,3575884806,3575884806,0
3,1066,27080,3575884806,3575884806,0
3,1066,27081,3575884806,3575884806,0
3,1066,27082,3575884806,3575884806,0
3,1066,27083,3575884806,3575884806,0
3,1066,27084,3575884806,3575884806,0
3,1066,27085,3575884806,3575884806,0
3,1066,27086,3575884806,3575884806,0
3,1066,27087,3575884806,3575884806,0
3,1066,27088,3575884806,3575884806,0
3,1066,27089,3575884806,3575884810,4
3,1066,27090,3575884806,3575884815,9
3,1066,27091,3575884806,3575884817,11
3,1066,27092,3575884806,3575884817,11
3,1066,27093,3575884806,3575884819,13
3,1066,27094,3575884806,3575884820,14
3,1066,27095,3575884806,3575884821,15
3,1066,27096,3575884806,3575884822,16
3,1066,27097,3575884806,3575884823,17
3,1066,27098,3575884806,3575884823,17
3,1066,27099,3575884806,3575884824,18
3,1066,27100,3575884806,3575884825,19
3,1066,27101,3575884806,3575884826,20
3,1066,27102,3575884806,3575884828,22
3,1066,27103,3575884806,3575884828,22
3,1066,27104,3575884806,3575884828,22
3,1066,27105,3575884806,3575884829,23
3,1066,27106,3575884806,3575884829,23
3,1066,27107,3575884806,3575884829,23
3,1066,27108,3575884806,3575884829,23
3,1066,27109,3575884806,3575884830,24
3,1066,27110,3575884806,3575884831,25
3,1066,27111,3575884806,3575884831,25
3,1066,27112,3575884806,3575884831,25
3,1066,27113,3575884806,3575884834,28
3,1066,27114,3575884806,3575884835,29
3,1066,27115,3575884806,3575884836,30
3,1066,27116,3575884806,3575884837,31
3,1066,27117,3575884806,3575884837,31
3,1066,27118,3575884806,3575884838,32
3,1066,27119,3575884806,3575884838,32
3,1066,27120,3575884806,3575884841,35
3,1066,27121,3575884806,3575884841,35
3,1066,27122,3575884806,3575884841,35
3,1066,27123,3575884806,3575884842,36
3,1066,27124,3575884806,3575884842,36
3,1066,27125,3575884806,3575884843,37
3,1066,27126,3575884806,3575884844,38
3,1066,27127,3575884806,3575884844,38
3,1066,27128,3575884806,3575884846,40
3,1066,27129,3575884806,3575884846,40
3,1066,27130,3575884806,3575884847,41
3,1066,27131,3575884806,3575884849,43
3,1066,27132,3575884806,3575884849,43
3,1066,27133,3575884806,3575884851,45
3,1066,27134,3575884806,3575884852,46
3,1066,27135,3575884806,3575884853,47
3,1066,27136,3575884806,3575884854,48
3,1066,27137,3575884806,3575884857,51
3,1067,27138,3575884875,3575884875,0
3,1067,27139,3575884875,3575884875,0
3,1067,27140,3575884875,3575884875,0
3,1067,27141,3575884875,3575884875,0
3,1067,27142,3575884875,3575884875,0
3,1067,27143,3575884875,3575884875,0
3,1067,27144,3575884875,3575884875,0
3,1067,27145,3575884875,3575884875,0
3,1067,27146,3575884875,3575884875,0
3,1067,27147,3575884875,3575884876,1
3,1067,27148,3575884875,3575884876,1
3,1067,27149,3575884875,3575884876,1
3,1067,27150,3575884875,3575884876,1
3,1067,27151,3575884875,3575884876,1
3,1067,27152,3575884875,3575884876,1
3,1067,27153,3575884875,3575884877,2
3,1067,27154,3575884875,3575884877,2
3,1067,27155,3575884875,3575884881,6
3,1067,27156,3575884875,3575884882,7
3,1067,27157,3575884875,3575884882,7
3,1067,27158,3575884875,3575884884,9
3,1067,27159,3575884875,3575884884,9
3,1067,27160,3575884875,3575884885,10
3,1067,27161,3575884875,3575884886,11
3,1067,27162,3575884875,3575884886,11
3,1067,27163,3575884875,3575884888,13
3,1067,27164,3575884875,3575884888,13
3,1067,27165,3575884875,3575884888,13
3,1067,27166,3575884875,3575884888,13
3,1067,27167,3575884875,3575884889,14
3,1067,27168,3575884875,3575884889,14
3,1067,27169,3575884875,3575884893,18
3,1067,27170,3575884875,3575884896,21
3,1067,27171,3575884875,3575884896,21
3,1067,27172,3575884875,3575884899,24
3,1067,27173,3575884875,3575884900,25
3,1067,27174,3575884875,3575884900,25
3,1067,27175,3575884875,3575884901,26
3,1067,27176,3575884875,3575884901,26
3,1067,27177,3575884875,3575884901,26
3,1067,27178,3575884875,3575884903,28
3,1067,27179,3575884875,3575884905,30
3,1067,27180,3575884875,3575884905,30
3,1067,27181,3575884875,3575884905,30
3,1067,27182,3575884875,3575884907,32
3,1067,27183,3575884875,3575884909,34
3,1067,27184,3575884875,3575884910,35
3,1067,27185,3575884875,3575884910,35
3,1067,27186,3575884875,3575884912,37
3,1067,27187,3575884875,3575884913,38
3,1067,27188,3575884875,3575884913,38
3,1067,27189,3575884875,3575884913,38
3,1067,27190,3575884875,3575884913,38
3,1067,27191,3575884875,3575884916,41
3,1067,27192,3575884875,3575884917,42
3,1067,27193,3575884875,3575884918,43
3,1067,27194,3575884875,3575884918,43
3,1067,27195,3575884875,3575884920,45
3,1067,27196,3575884875,3575884922,47
3,1067,27197,3575884875,3575884922,47
3,1067,27198,3575884875,3575884923,48
3,1067,27199,3575884875,3575884924,49
3,1068,27200,3575884939,3575884939,0
3,1068,27201,3575884939,3575884939,0
3,1068,27202,3575884939,3575884939,0
3,1068,27203,3575884939,3575884939,0
3,1068,27204,3575884939,3575884939,0
3,1068,27205,3575884939,3575884939,0
3,1068,27206,3575884939,3575884939,0
3,1068,27207,3575884939,3575884939,0
3,1068,27208,3575884939,3575884939,0
3,1068,27209,3575884939,3575884939,0
3,1068,27210,3575884939,3575884941,2
3,1068,27211,3575884939,3575884943,4
3,1068,27212,3575884939,3575884943,4
3,1068,27213,3575884939,3575884943,4
3,1068,27214,3575884939,3575884949,10
3,1068,27215,3575884939,3575884951,12
3,1068,27216,3575884939,3575884952,13
3,1068,27217,3575884939,3575884954,15
3,1068,27218,3575884939,3575884954,15
3,1068,27219,3575884939,3575884959,20
3,1068,27220,3575884939,3575884960,21
3,1068,27221,3575884939,3575884964,25
3,1068,27222,3575884939,3575884967,28
3,1068,27223,3575884939,3575884967,28
3,1068,27224,3575884939,3575884968,29
3,1068,27225,3575884939,3575884969,30
3,1068,27226,3575884939,3575884970,31
3,1068,27227,3575884939,3575884970,31
3,1068,27228,3575884939,3575884972,33
3,1068,27229,3575884939,3575884975,36
3,1068,27230,3575884939,3575884978,39
3,1068,27231,3575884939,3575884979,40
3,1068,27232,3575884939,3575884980,41
3,1068,27233,3575884939,3575884980,41
3,1068,27234,3575884939,3575884980,41
3,1068,27235,3575884939,3575884981,42
3,1068,27236,3575884939,3575884981,42
3,1068,27237,3575884939,3575884985,46
3,1068,27238,3575884939,3575884986,47
3,1068,27239,3575884939,3575884987,48
3,1068,27240,3575884939,3575884987,48
3,1069,27241,3575885003,3575885003,0
3,1069,27242,3575885003,3575885003,0
3,1069,27243,3575885003,3575885003,0
3,1069,27244,3575885003,3575885003,0
3,1069,27245,3575885003,3575885003,0
3,1069,27246,3575885003,3575885003,0
3,1069,27247,3575885003,3575885003,0
3,1069,27248,3575885003,3575885003,0
3,1069,27249,3575885003,3575885003,0
3,1069,27250,3575885003,3575885003,0
3,1069,27251,3575885003,3575885003,0
3,1069,27252,3575885003,3575885003,0
3,1069,27253,3575885003,3575885003,0
3,1069,27254,3575885003,3575885003,0
3,1069,27255,3575885003,3575885003,0
3,1069,27256,3575885003,3575885003,0
3,1069,27257,3575885003,3575885003,0
3,1069,27258,3575885003,3575885003,0
3,1069,27259,3575885003,3575885003,0
3,1069,27260,3575885003,3575885003,0
3,1069,27261,3575885003,3575885003,0
3,1069,27262,3575885003,3575885003,0
3,1069,27263,3575885003,3575885006,3
3,1069,27264,3575885003,3575885012,9
3,1069,27265,3575885003,3575885017,14
3,1069,27266,3575885003,3575885017,14
3,1069,27267,3575885003,3575885019,16
3,1069,27268,3575885003,3575885020,17
3,1069,27269,3575885003,3575885021,18
3,1069,27270,3575885003,3575885022,19
3,1069,27271,3575885003,3575885022,19
3,1069,27272,3575885003,3575885023,20
3,1069,27273,3575885003,3575885024,21
3,1069,27274,3575885003,3575885025,22
3,1069,27275,3575885003,3575885026,23
3,1069,27276,3575885003,3575885028,25
3,1069,27277,3575885003,3575885028,25
3,1069,27278,3575885003,3575885028,25
3,1069,27279,3575885003,3575885029,26
3,1069,27280,3575885003,3575885029,26
3,1069,27281,3575885003,3575885029,26
3,1069,27282,3575885003,3575885030,27
3,1069,27283,3575885003,3575885030,27
3,1069,27284,3575885003,3575885031,28
3,1069,27285,3575885003,3575885032,29
3,1069,27286,3575885003,3575885032,29
3,1069,27287,3575885003,3575885035,32
3,1069,27288,3575885003,3575885036,33
3,1069,27289,3575885003,3575885037,34
3,1069,27290,3575885003,3575885038,35
3,1069,27291,3575885003,3575885038,35
3,1069,27292,3575885003,3575885039,36
3,1069,27293,3575885003,3575885041,38
3,1069,27294,3575885003,3575885041,38
3,1069,27295,3575885003,3575885041,38
3,1069,27296,3575885003,3575885042,39
3,1069,27297,3575885003,3575885042,39
3,1069,27298,3575885003,3575885043,40
3,1069,27299,3575885003,3575885044,41
3,1069,27300,3575885003,3575885044,41
3,1069,27301,3575885003,3575885045,42
3,1069,27302,3575885003,3575885046,43
3,1069,27303,3575885003,3575885047,44
3,1069,27304,3575885003,3575885049,46
3,1069,27305,3575885003,3575885051,48
3,1069,27306,3575885003,3575885052,49
3,1069,27307,3575885003,3575885052,49
3,1069,27308,3575885003,3575885053,50
3,1070,27309,3575885072,3575885072,0
3,1070,27310,3575885072,3575885072,0
3,1070,27311,3575885072,3575885072,0
3,1070,27312,3575885072,3575885072,0
3,1070,27313,3575885072,3575885072,0
3,1070,27314,3575885072,3575885072,0
3,1070,27315,3575885072,3575885072,0
3,1070,27316,3575885072,3575885072,0
3,1070,27317,3575885072,3575885072,0
3,1070,27318,3575885072,3575885072,0
3,1070,27319,3575885072,3575885072,0
3,1070,27320,3575885072,3575885072,0
3,1070,27321,3575885072,3575885072,0
3,1070,27322,3575885072,3575885072,0
3,1070,27323,3575885072,3575885072,0
3,1070,27324,3575885072,3575885072,0
3,1070,27325,3575885072,3575885072,0
3,1070,27326,3575885072,3575885072,0
3,1070,27327,3575885072,3575885072,0
3,1070,27328,3575885072,3575885074,2
3,1070,27329,3575885072,3575885077,5
3,1070,27330,3575885072,3575885078,6
3,1070,27331,3575885072,3575885082,10
3,1070,27332,3575885072,3575885082,10
3,1070,27333,3575885072,3575885084,12
3,1070,27334,3575885072,3575885085,13
3,1070,27335,3575885072,3575885085,13
3,1070,27336,3575885072,3575885086,14
3,1070,27337,3575885072,3575885087,15
3,1070,27338,3575885072,3575885088,16
3,1070,27339,3575885072,3575885088,16
3,1070,27340,3575885072,3575885088,16
3,1070,27341,3575885072,3575885089,17
3,1070,27342,3575885072,3575885089,17
3,1070,27343,3575885072,3575885089,17
3,1070,27344,3575885072,3575885094,22
3,1070,27345,3575885072,3575885096,24
3,1070,27346,3575885072,3575885096,24
3,1070,27347,3575885072,3575885099,27
3,1070,27348,3575885072,3575885100,28
3,1070,27349,3575885072,3575885100,28
3,1070,27350,3575885072,3575885101,29
3,1070,27351,3575885072,3575885101,29
3,1070,27352,3575885072,3575885102,30
3,1070,27353,3575885072,3575885104,32
3,1070,27354,3575885072,3575885105,33
3,1070,27355,3575885072,3575885106,34
3,1070,27356,3575885072,3575885106,34
3,1070,27357,3575885072,3575885108,36
3,1070,27358,3575885072,3575885109,37
3,1070,27359,3575885072,3575885110,38
3,1070,27360,3575885072,3575885110,38
3,1070,27361,3575885072,3575885112,40
3,1070,27362,3575885072,3575885112,40
3,1070,27363,3575885072,3575885112,40
3,1070,27364,3575885072,3575885113,41
3,1070,27365,3575885072,3575885113,41
3,1070,27366,3575885072,3575885116,44
3,1070,27367,3575885072,3575885117,45
3,1070,27368,3575885072,3575885118,46
3,1070,27369,3575885072,3575885119,47
3,1070,27370,3575885072,3575885121,49
3,1070,27371,3575885072,3575885121,49
3,1071,27372,3575885136,3575885136,0
3,1071,27373,3575885136,3575885136,0
3,1071,27374,3575885136,3575885136,0
3,1071,27375,3575885136,3575885136,0
3,1071,27376,3575885136,3575885136,0
3,1071,27377,3575885136,3575885136,0
3,1071,27378,3575885136,3575885136,0
3,1071,27379,3575885136,3575885136,0
3,1071,27380,3575885136,3575885136,0
3,1071,27381,3575885136,3575885136,0
3,1071,27382,3575885136,3575885136,0
3,1071,27383,3575885136,3575885137,1
3,1071,27384,3575885136,3575885137,1
3,1071,27385,3575885136,3575885141,5
3,1071,27386,3575885136,3575885143,7
3,1071,27387,3575885136,3575885143,7
3,1071,27388,3575885136,3575885143,7
3,1071,27389,3575885136,3575885144,8
3,1071,27390,3575885136,3575885149,13
3,1071,27391,3575885136,3575885150,14
3,1071,27392,3575885136,3575885151,15
3,1071,27393,3575885136,3575885152,16
3,1071,27394,3575885136,3575885154,18
3,1071,27395,3575885136,3575885154,18
3,1071,27396,3575885136,3575885159,23
3,1071,27397,3575885136,3575885161,25
3,1071,27398,3575885136,3575885162,26
3,1071,27399,3575885136,3575885163,27
3,1071,27400,3575885136,3575885164,28
3,1071,27401,3575885136,3575885168,32
3,1071,27402,3575885136,3575885168,32
3,1071,27403,3575885136,3575885169,33
3,1071,27404,3575885136,3575885169,33
3,1071,27405,3575885136,3575885170,34
3,1071,27406,3575885136,3575885170,34
3,1071,27407,3575885136,3575885171,35
3,1071,27408,3575885136,3575885173,37
3,1071,27409,3575885136,3575885174,38
3,1071,27410,3575885136,3575885179,43
3,1071,27411,3575885136,3575885180,44
3,1071,27412,3575885136,3575885180,44
3,1071,27413,3575885136,3575885181,45
3,1071,27414,3575885136,3575885182,46
3,1071,27415,3575885136,3575885183,47
3,1071,27416,3575885136,3575885186,50
3,1072,27417,3575885201,3575885201,0
3,1072,27418,3575885201,3575885201,0
3,1072,27419,3575885201,3575885201,0
3,1072,27420,3575885201,3575885201,0
3,1072,27421,3575885201,3575885201,0
3,1072,27422,3575885201,3575885201,0
3,1072,27423,3575885201,3575885201,0
3,1072,27424,3575885201,3575885201,0
3,1072,27425,3575885201,3575885201,0
3,1072,27426,3575885201,3575885201,0
3,1072,27427,3575885201,3575885201,0
3,1072,27428,3575885201,3575885201,0
3,1072,27429,3575885201,3575885201,0
3,1072,27430,3575885201,3575885201,0
3,1072,27431,3575885201,3575885201,0
3,1072,27432,3575885201,3575885201,0
3,1072,27433,3575885201,3575885201,0
3,1072,27434,3575885201,3575885201,0
3,1072,27435,3575885201,3575885201,0
3,1072,27436,3575885201,3575885202,1
3,1072,27437,3575885201,3575885203,2
3,1072,27438,3575885201,3575885204,3
3,1072,27439,3575885201,3575885204,3
3,1072,27440,3575885201,3575885206,5
3,1072,27441,3575885201,3575885211,10
3,1072,27442,3575885201,3575885215,14
3,1072,27443,3575885201,3575885216,15
3,1072,27444,3575885201,3575885217,16
3,1072,27445,3575885201,3575885218,17
3,1072,27446,3575885201,3575885220,19
3,1072,27447,3575885201,3575885222,21
3,1072,27448,3575885201,3575885222,21
3,1072,27449,3575885201,3575885223,22
3,1072,27450,3575885201,3575885223,22
3,1072,27451,3575885201,3575885223,22
3,1072,27452,3575885201,3575885225,24
3,1072,27453,3575885201,3575885226,25
3,1072,27454,3575885201,3575885228,27
3,1072,27455,3575885201,3575885228,27
3,1072,27456,3575885201,3575885228,27
3,1072,27457,3575885201,3575885228,27
3,1072,27458,3575885201,3575885229,28
3,1072,27459,3575885201,3575885229,28
3,1072,27460,3575885201,3575885230,29
3,1072,27461,3575885201,3575885230,29
3,1072,27462,3575885201,3575885231,30
3,1072,27463,3575885201,3575885231,30
3,1072,27464,3575885201,3575885232,31
3,1072,27465,3575885201,3575885235,34
3,1072,27466,3575885201,3575885236,35
3,1072,27467,3575885201,3575885237,36
3,1072,27468,3575885201,3575885238,37
3,1072,27469,3575885201,3575885238,37
3,1072,27470,3575885201,3575885239,38
3,1072,27471,3575885201,3575885241,40
3,1072,27472,3575885201,3575885241,40
3,1072,27473,3575885201,3575885241,40
3,1072,27474,3575885201,3575885242,41
3,1072,27475,3575885201,3575885243,42
3,1072,27476,3575885201,3575885243,42
3,1072,27477,3575885201,3575885245,44
3,1072,27478,3575885201,3575885246,45
3,1072,27479,3575885201,3575885246,45
3,1072,27480,3575885201,3575885248,47
3,1072,27481,3575885201,3575885249,48
3,1072,27482,3575885201,3575885251,50
3,1073,27483,3575885265,3575885265,0
3,1073,27484,3575885265,3575885265,0
3,1073,27485,3575885265,3575885265,0
3,1073,27486,3575885265,3575885265,0
3,1073,27487,3575885265,3575885265,0
3,1073,27488,3575885265,3575885265,0
3,1073,27489,3575885265,3575885265,0
3,1073,27490,3575885265,3575885265,0
3,1073,27491,3575885265,3575885265,0
3,1073,27492,3575885265,3575885265,0
3,1073,27493,3575885265,3575885265,0
3,1073,27494,3575885265,3575885265,0
3,1073,27495,3575885265,3575885265,0
3,1073,27496,3575885265,3575885265,0
3,1073,27497,3575885265,3575885265,0
3,1073,27498,3575885265,3575885265,0
3,1073,27499,3575885265,3575885265,0
3,1073,27500,3575885265,3575885266,1
3,1073,27501,3575885265,3575885266,1
3,1073,27502,3575885265,3575885267,2
3,1073,27503,3575885265,3575885267,2
3,1073,27504,3575885265,3575885268,3
3,1073,27505,3575885265,3575885269,4
3,1073,27506,3575885265,3575885274,9
3,1073,27507,3575885265,3575885277,12
3,1073,27508,3575885265,3575885281,16
3,1073,27509,3575885265,3575885281,16
3,1073,27510,3575885265,3575885282,17
3,1073,27511,3575885265,3575885284,19
3,1073,27512,3575885265,3575885284,19
3,1073,27513,3575885265,3575885286,21
3,1073,27514,3575885265,3575885287,22
3,1073,27515,3575885265,3575885287,22
3,1073,27516,3575885265,3575885288,23
3,1073,27517,3575885265,3575885288,23
3,1073,27518,3575885265,3575885288,23
3,1073,27519,3575885265,3575885289,24
3,1073,27520,3575885265,3575885290,25
3,1073,27521,3575885265,3575885290,25
3,1073,27522,3575885265,3575885290,25
3,1073,27523,3575885265,3575885293,28
3,1073,27524,3575885265,3575885296,31
3,1073,27525,3575885265,3575885297,32
3,1073,27526,3575885265,3575885297,32
3,1073,27527,3575885265,3575885299,34
3,1073,27528,3575885265,3575885300,35
3,1073,27529,3575885265,3575885300,35
3,1073,27530,3575885265,3575885301,36
3,1073,27531,3575885265,3575885301,36
3,1073,27532,3575885265,3575885302,37
3,1073,27533,3575885265,3575885303,38
3,1073,27534,3575885265,3575885305,40
3,1073,27535,3575885265,3575885306,41
3,1073,27536,3575885265,3575885306,41
3,1073,27537,3575885265,3575885307,42
3,1073,27538,3575885265,3575885308,43
3,1073,27539,3575885265,3575885309,44
3,1073,27540,3575885265,3575885311,46
3,1073,27541,3575885265,3575885312,47
3,1073,27542,3575885265,3575885312,47
3,1073,27543,3575885265,3575885314,49
3,1073,27544,3575885265,3575885315,50
3,1074,27545,3575885330,3575885330,0
3,1074,27546,3575885330,3575885330,0
3,1074,27547,3575885330,3575885330,0
3,1074,27548,3575885330,3575885330,0
3,1074,27549,3575885330,3575885330,0
3,1074,27550,3575885330,3575885330,0
3,1074,27551,3575885330,3575885330,0
3,1074,27552,3575885330,3575885330,0
3,1074,27553,3575885330,3575885330,0
3,1074,27554,3575885330,3575885331,1
3,1074,27555,3575885330,3575885332,2
3,1074,27556,3575885330,3575885332,2
3,1074,27557,3575885330,3575885334,4
3,1074,27558,3575885330,3575885337,7
3,1074,27559,3575885330,3575885341,11
3,1074,27560,3575885330,3575885342,12
3,1074,27561,3575885330,3575885343,13
3,1074,27562,3575885330,3575885344,14
3,1074,27563,3575885330,3575885349,19
3,1074,27564,3575885330,3575885350,20
3,1074,27565,3575885330,3575885351,21
3,1074,27566,3575885330,3575885351,21
3,1074,27567,3575885330,3575885354,24
3,1074,27568,3575885330,3575885354,24
3,1074,27569,3575885330,3575885359,29
3,1074,27570,3575885330,3575885361,31
3,1074,27571,3575885330,3575885362,32
3,1074,27572,3575885330,3575885364,34
3,1074,27573,3575885330,3575885364,34
3,1074,27574,3575885330,3575885368,38
3,1074,27575,3575885330,3575885368,38
3,1074,27576,3575885330,3575885369,39
3,1074,27577,3575885330,3575885371,41
3,1074,27578,3575885330,3575885371,41
3,1074,27579,3575885330,3575885372,42
3,1074,27580,3575885330,3575885373,43
3,1074,27581,3575885330,3575885375,45
3,1074,27582,3575885330,3575885380,50
3,1075,27583,3575885393,3575885393,0
3,1075,27584,3575885393,3575885393,0
3,1075,27585,3575885393,3575885393,0
3,1075,27586,3575885393,3575885393,0
3,1075,27587,3575885393,3575885393,0
3,1075,27588,3575885393,3575885393,0
3,1075,27589,3575885393,3575885393,0
3,1075,27590,3575885393,3575885393,0
3,1075,27591,3575885393,3575885393,0
3,1075,27592,3575885393,3575885393,0
3,1075,27593,3575885393,3575885393,0
3,1075,27594,3575885393,3575885393,0
3,1075,27595,3575885393,3575885395,2
3,1075,27596,3575885393,3575885395,2
3,1075,27597,3575885393,3575885395,2
3,1075,27598,3575885393,3575885395,2
3,1075,27599,3575885393,3575885396,3
3,1075,27600,3575885393,3575885396,3
3,1075,27601,3575885393,3575885397,4
3,1075,27602,3575885393,3575885397,4
3,1075,27603,3575885393,3575885399,6
3,1075,27604,3575885393,3575885399,6
3,1075,27605,3575885393,3575885400,7
3,1075,27606,3575885393,3575885401,8
3,1075,27607,3575885393,3575885401,8
3,1075,27608,3575885393,3575885402,9
3,1075,27609,3575885393,3575885402,9
3,1075,27610,3575885393,3575885403,10
3,1075,27611,3575885393,3575885403,10
3,1075,27612,3575885393,3575885406,13
3,1075,27613,3575885393,3575885412,19
3,1075,27614,3575885393,3575885415,22
3,1075,27615,3575885393,3575885416,23
3,1075,27616,3575885393,3575885417,24
3,1075,27617,3575885393,3575885418,25
3,1075,27618,3575885393,3575885420,27
3,1075,27619,3575885393,3575885421,28
3,1075,27620,3575885393,3575885422,29
3,1075,27621,3575885393,3575885422,29
3,1075,27622,3575885393,3575885422,29
3,1075,27623,3575885393,3575885426,33
3,1075,27624,3575885393,3575885427,34
3,1075,27625,3575885393,3575885427,34
3,1075,27626,3575885393,3575885428,35
3,1075,27627,3575885393,3575885428,35
3,1075,27628,3575885393,3575885429,36
3,1075,27629,3575885393,3575885429,36
3,1075,27630,3575885393,3575885429,36
3,1075,27631,3575885393,3575885430,37
3,1075,27632,3575885393,3575885430,37
3,1075,27633,3575885393,3575885431,38
3,1075,27634,3575885393,3575885431,38
3,1075,27635,3575885393,3575885431,38
3,1075,27636,3575885393,3575885434,41
3,1075,27637,3575885393,3575885435,42
3,1075,27638,3575885393,3575885436,43
3,1075,27639,3575885393,3575885437,44
3,1075,27640,3575885393,3575885438,45
3,1075,27641,3575885393,3575885439,46
3,1075,27642,3575885393,3575885441,48
3,1075,27643,3575885393,3575885441,48
3,1075,27644,3575885393,3575885441,48
3,1075,27645,3575885393,3575885442,49
3,1075,27646,3575885393,3575885442,49
3,1075,27647,3575885393,3575885443,50
3,1076,27648,3575885457,3575885457,0
3,1076,27649,3575885457,3575885457,0
3,1076,27650,3575885457,3575885458,1
3,1076,27651,3575885457,3575885458,1
3,1076,27652,3575885457,3575885458,1
3,1076,27653,3575885457,3575885458,1
3,1076,27654,3575885457,3575885458,1
3,1076,27655,3575885457,3575885458,1
3,1076,27656,3575885457,3575885458,1
3,1076,27657,3575885457,3575885458,1
3,1076,27658,3575885457,3575885458,1
3,1076,27659,3575885457,3575885458,1
3,1076,27660,3575885457,3575885458,1
3,1076,27661,3575885457,3575885458,1
3,1076,27662,3575885457,3575885459,2
3,1076,27663,3575885457,3575885460,3
3,1076,27664,3575885457,3575885461,4
3,1076,27665,3575885457,3575885462,5
3,1076,27666,3575885457,3575885462,5
3,1076,27667,3575885457,3575885463,6
3,1076,27668,3575885457,3575885464,7
3,1076,27669,3575885457,3575885464,7
3,1076,27670,3575885457,3575885465,8
3,1076,27671,3575885457,3575885466,9
3,1076,27672,3575885457,3575885466,9
3,1076,27673,3575885457,3575885467,10
3,1076,27674,3575885457,3575885468,11
3,1076,27675,3575885457,3575885469,12
3,1076,27676,3575885457,3575885470,13
3,1076,27677,3575885457,3575885474,17
3,1076,27678,3575885457,3575885477,20
3,1076,27679,3575885457,3575885478,21
3,1076,27680,3575885457,3575885481,24
3,1076,27681,3575885457,3575885481,24
3,1076,27682,3575885457,3575885482,25
3,1076,27683,3575885457,3575885484,27
3,1076,27684,3575885457,3575885484,27
3,1076,27685,3575885457,3575885485,28
3,1076,27686,3575885457,3575885486,29
3,1076,27687,3575885457,3575885488,31
3,1076,27688,3575885457,3575885488,31
3,1076,27689,3575885457,3575885488,31
3,1076,27690,3575885457,3575885489,32
3,1076,27691,3575885457,3575885489,32
3,1076,27692,3575885457,3575885490,33
3,1076,27693,3575885457,3575885490,33
3,1076,27694,3575885457,3575885490,33
3,1076,27695,3575885457,3575885490,33
3,1076,27696,3575885457,3575885494,37
3,1076,27697,3575885457,3575885495,38
3,1076,27698,3575885457,3575885496,39
3,1076,27699,3575885457,3575885496,39
3,1076,27700,3575885457,3575885499,42
3,1076,27701,3575885457,3575885500,43
3,1076,27702,3575885457,3575885500,43
3,1076,27703,3575885457,3575885501,44
3,1076,27704,3575885457,3575885501,44
3,1076,27705,3575885457,3575885504,47
3,1076,27706,3575885457,3575885505,48
3,1076,27707,3575885457,3575885506,49
3,1076,27708,3575885457,3575885506,49
3,1076,27709,3575885457,3575885507,50
3,1077,27710,3575885519,3575885519,0
3,1077,27711,3575885519,3575885519,0
3,1077,27712,3575885519,3575885519,0
3,1077,27713,3575885519,3575885519,0
3,1077,27714,3575885519,3575885519,0
3,1077,27715,3575885519,3575885519,0
3,1077,27716,3575885519,3575885519,0
3,1077,27717,3575885519,3575885519,0
3,1077,27718,3575885519,3575885519,0
3,1077,27719,3575885519,3575885519,0
3,1077,27720,3575885519,3575885519,0
3,1077,27721,3575885519,3575885520,1
3,1077,27722,3575885519,3575885520,1
3,1077,27723,3575885519,3575885522,3
3,1077,27724,3575885519,3575885524,5
3,1077,27725,3575885519,3575885528,9
3,1077,27726,3575885519,3575885530,11
3,1077,27727,3575885519,3575885531,12
3,1077,27728,3575885519,3575885531,12
3,1077,27729,3575885519,3575885531,12
3,1077,27730,3575885519,3575885533,14
3,1077,27731,3575885519,3575885534,15
3,1077,27732,3575885519,3575885536,17
3,1077,27733,3575885519,3575885540,21
3,1077,27734,3575885519,3575885543,24
3,1077,27735,3575885519,3575885543,24
3,1077,27736,3575885519,3575885543,24
3,1077,27737,3575885519,3575885548,29
3,1077,27738,3575885519,3575885551,32
3,1077,27739,3575885519,3575885552,33
3,1077,27740,3575885519,3575885553,34
3,1077,27741,3575885519,3575885553,34
3,1077,27742,3575885519,3575885558,39
3,1077,27743,3575885519,3575885560,41
3,1077,27744,3575885519,3575885562,43
3,1077,27745,3575885519,3575885562,43
3,1077,27746,3575885519,3575885568,49
3,1077,27747,3575885519,3575885568,49
3,1077,27748,3575885519,3575885569,50
3,1078,27749,3575885582,3575885582,0
3,1078,27750,3575885582,3575885582,0
3,1078,27751,3575885582,3575885582,0
3,1078,27752,3575885582,3575885582,0
3,1078,27753,3575885582,3575885582,0
3,1078,27754,3575885582,3575885582,0
3,1078,27755,3575885582,3575885582,0
3,1078,27756,3575885582,3575885582,0
3,1078,27757,3575885582,3575885582,0
3,1078,27758,3575885582,3575885582,0
3,1078,27759,3575885582,3575885582,0
3,1078,27760,3575885582,3575885582,0
3,1078,27761,3575885582,3575885583,1
3,1078,27762,3575885582,3575885585,3
3,1078,27763,3575885582,3575885586,4
3,1078,27764,3575885582,3575885587,5
3,1078,27765,3575885582,3575885587,5
3,1078,27766,3575885582,3575885589,7
3,1078,27767,3575885582,3575885591,9
3,1078,27768,3575885582,3575885592,10
3,1078,27769,3575885582,3575885594,12
3,1078,27770,3575885582,3575885594,12
3,1078,27771,3575885582,3575885594,12
3,1078,27772,3575885582,3575885594,12
3,1078,27773,3575885582,3575885595,13
3,1078,27774,3575885582,3575885595,13
3,1078,27775,3575885582,3575885595,13
3,1078,27776,3575885582,3575885596,14
3,1078,27777,3575885582,3575885598,16
3,1078,27778,3575885582,3575885599,17
3,1078,27779,3575885582,3575885599,17
3,1078,27780,3575885582,3575885600,18
3,1078,27781,3575885582,3575885600,18
3,1078,27782,3575885582,3575885600,18
3,1078,27783,3575885582,3575885601,19
3,1078,27784,3575885582,3575885602,20
3,1078,27785,3575885582,3575885602,20
3,1078,27786,3575885582,3575885602,20
3,1078,27787,3575885582,3575885605,23
3,1078,27788,3575885582,3575885610,28
3,1078,27789,3575885582,3575885614,32
3,1078,27790,3575885582,3575885615,33
3,1078,27791,3575885582,3575885616,34
3,1078,27792,3575885582,3575885618,36
3,1078,27793,3575885582,3575885620,38
3,1078,27794,3575885582,3575885622,40
3,1078,27795,3575885582,3575885622,40
3,1078,27796,3575885582,3575885622,40
3,1078,27797,3575885582,3575885624,42
3,1078,27798,3575885582,3575885626,44
3,1078,27799,3575885582,3575885627,45
3,1078,27800,3575885582,3575885627,45
3,1078,27801,3575885582,3575885627,45
3,1078,27802,3575885582,3575885628,46
3,1078,27803,3575885582,3575885628,46
3,1078,27804,3575885582,3575885629,47
3,1078,27805,3575885582,3575885630,48
3,1078,27806,3575885582,3575885630,48
3,1078,27807,3575885582,3575885631,49
3,1078,27808,3575885582,3575885631,49
3,1079,27809,3575885646,3575885646,0
3,1079,27810,3575885646,3575885646,0
3,1079,27811,3575885646,3575885646,0
3,1079,27812,3575885646,3575885646,0
3,1079,27813,3575885646,3575885646,0
3,1079,27814,3575885646,3575885646,0
3,1079,27815,3575885646,3575885646,0
3,1079,27816,3575885646,3575885646,0
3,1079,27817,3575885646,3575885646,0
3,1079,27818,3575885646,3575885646,0
3,1079,27819,3575885646,3575885646,0
3,1079,27820,3575885646,3575885646,0
3,1079,27821,3575885646,3575885646,0
3,1079,27822,3575885646,3575885646,0
3,1079,27823,3575885646,3575885646,0
3,1079,27824,3575885646,3575885647,1
3,1079,27825,3575885646,3575885647,1
3,1079,27826,3575885646,3575885648,2
3,1079,27827,3575885646,3575885649,3
3,1079,27828,3575885646,3575885651,5
3,1079,27829,3575885646,3575885652,6
3,1079,27830,3575885646,3575885653,7
3,1079,27831,3575885646,3575885656,10
3,1079,27832,3575885646,3575885656,10
3,1079,27833,3575885646,3575885657,11
3,1079,27834,3575885646,3575885658,12
3,1079,27835,3575885646,3575885661,15
3,1079,27836,3575885646,3575885661,15
3,1079,27837,3575885646,3575885661,15
3,1079,27838,3575885646,3575885662,16
3,1079,27839,3575885646,3575885662,16
3,1079,27840,3575885646,3575885662,16
3,1079,27841,3575885646,3575885663,17
3,1079,27842,3575885646,3575885664,18
3,1079,27843,3575885646,3575885665,19
3,1079,27844,3575885646,3575885665,19
3,1079,27845,3575885646,3575885666,20
3,1079,27846,3575885646,3575885667,21
3,1079,27847,3575885646,3575885667,21
3,1079,27848,3575885646,3575885669,23
3,1079,27849,3575885646,3575885674,28
3,1079,27850,3575885646,3575885677,31
3,1079,27851,3575885646,3575885678,32
3,1079,27852,3575885646,3575885681,35
3,1079,27853,3575885646,3575885682,36
3,1079,27854,3575885646,3575885682,36
3,1079,27855,3575885646,3575885684,38
3,1079,27856,3575885646,3575885684,38
3,1079,27857,3575885646,3575885686,40
3,1079,27858,3575885646,3575885687,41
3,1079,27859,3575885646,3575885688,42
3,1079,27860,3575885646,3575885688,42
3,1079,27861,3575885646,3575885689,43
3,1079,27862,3575885646,3575885689,43
3,1079,27863,3575885646,3575885689,43
3,1079,27864,3575885646,3575885690,44
3,1079,27865,3575885646,3575885690,44
3,1079,27866,3575885646,3575885694,48
3,1079,27867,3575885646,3575885695,49
3,1079,27868,3575885646,3575885696,50
3,1080,27869,3575885709,3575885709,0
3,1080,27870,3575885709,3575885709,0
3,1080,27871,3575885709,3575885709,0
3,1080,27872,3575885709,3575885709,0
3,1080,27873,3575885709,3575885709,0
3,1080,27874,3575885709,3575885709,0
3,1080,27875,3575885709,3575885709,0
3,1080,27876,3575885709,3575885709,0
3,1080,27877,3575885709,3575885709,0
3,1080,27878,3575885709,3575885709,0
3,1080,27879,3575885709,3575885710,1
3,1080,27880,3575885709,3575885710,1
3,1080,27881,3575885709,3575885711,2
3,1080,27882,3575885709,3575885711,2
3,1080,27883,3575885709,3575885712,3
3,1080,27884,3575885709,3575885713,4
3,1080,27885,3575885709,3575885714,5
3,1080,27886,3575885709,3575885716,7
3,1080,27887,3575885709,3575885716,7
3,1080,27888,3575885709,3575885717,8
3,1080,27889,3575885709,3575885719,10
3,1080,27890,3575885709,3575885720,11
3,1080,27891,3575885709,3575885720,11
3,1080,27892,3575885709,3575885722,13
3,1080,27893,3575885709,3575885723,14
3,1080,27894,3575885709,3575885726,17
3,1080,27895,3575885709,3575885728,19
3,1080,27896,3575885709,3575885729,20
3,1080,27897,3575885709,3575885730,21
3,1080,27898,3575885709,3575885731,22
3,1080,27899,3575885709,3575885731,22
3,1080,27900,3575885709,3575885732,23
3,1080,27901,3575885709,3575885734,25
3,1080,27902,3575885709,3575885734,25
3,1080,27903,3575885709,3575885736,27
3,1080,27904,3575885709,3575885737,28
3,1080,27905,3575885709,3575885740,31
3,1080,27906,3575885709,3575885743,34
3,1080,27907,3575885709,3575885748,39
3,1080,27908,3575885709,3575885751,42
3,1080,27909,3575885709,3575885752,43
3,1080,27910,3575885709,3575885753,44
3,1080,27911,3575885709,3575885755,46
3,1080,27912,3575885709,3575885758,49
3,1081,27913,3575885780,3575885780,0
3,1081,27914,3575885780,3575885780,0
3,1081,27915,3575885780,3575885780,0
3,1081,27916,3575885780,3575885780,0
3,1081,27917,3575885780,3575885780,0
3,1081,27918,3575885780,3575885780,0
3,1081,27919,3575885780,3575885780,0
3,1081,27920,3575885780,3575885780,0
3,1081,27921,3575885780,3575885780,0
3,1081,27922,3575885780,3575885780,0
3,1081,27923,3575885780,3575885780,0
3,1081,27924,3575885780,3575885780,0
3,1081,27925,3575885780,3575885780,0
3,1081,27926,3575885780,3575885780,0
3,1081,27927,3575885780,3575885781,1
3,1081,27928,3575885780,3575885781,1
3,1081,27929,3575885780,3575885781,1
3,1081,27930,3575885780,3575885786,6
3,1081,27931,3575885780,3575885786,6
3,1081,27932,3575885780,3575885786,6
3,1081,27933,3575885780,3575885786,6
3,1081,27934,3575885780,3575885789,9
3,1081,27935,3575885780,3575885791,11
3,1081,27936,3575885780,3575885792,12
3,1081,27937,3575885780,3575885794,14
3,1081,27938,3575885780,3575885794,14
3,1081,27939,3575885780,3575885794,14
3,1081,27940,3575885780,3575885795,15
3,1081,27941,3575885780,3575885795,15
3,1081,27942,3575885780,3575885795,15
3,1081,27943,3575885780,3575885796,16
3,1081,27944,3575885780,3575885796,16
3,1081,27945,3575885780,3575885798,18
3,1081,27946,3575885780,3575885798,18
3,1081,27947,3575885780,3575885799,19
3,1081,27948,3575885780,3575885799,19
3,1081,27949,3575885780,3575885800,20
3,1081,27950,3575885780,3575885800,20
3,1081,27951,3575885780,3575885801,21
3,1081,27952,3575885780,3575885802,22
3,1081,27953,3575885780,3575885803,23
3,1081,27954,3575885780,3575885803,23
3,1081,27955,3575885780,3575885805,25
3,1081,27956,3575885780,3575885810,30
3,1081,27957,3575885780,3575885815,35
3,1081,27958,3575885780,3575885815,35
3,1081,27959,3575885780,3575885817,37
3,1081,27960,3575885780,3575885818,38
3,1081,27961,3575885780,3575885820,40
3,1081,27962,3575885780,3575885822,42
3,1081,27963,3575885780,3575885822,42
3,1081,27964,3575885780,3575885823,43
3,1081,27965,3575885780,3575885824,44
3,1081,27966,3575885780,3575885827,47
3,1081,27967,3575885780,3575885827,47
3,1081,27968,3575885780,3575885827,47
3,1081,27969,3575885780,3575885828,48
3,1081,27970,3575885780,3575885828,48
3,1081,27971,3575885780,3575885829,49
3,1081,27972,3575885780,3575885829,49
3,1081,27973,3575885780,3575885829,49
3,1081,27974,3575885780,3575885830,50
3,1082,27975,3575885843,3575885843,0
3,1082,27976,3575885843,3575885843,0
3,1082,27977,3575885843,3575885843,0
3,1082,27978,3575885843,3575885843,0
3,1082,27979,3575885843,3575885843,0
3,1082,27980,3575885843,3575885843,0
3,1082,27981,3575885843,3575885843,0
3,1082,27982,3575885843,3575885843,0
3,1082,27983,3575885843,3575885843,0
3,1082,27984,3575885843,3575885843,0
3,1082,27985,3575885843,3575885843,0
3,1082,27986,3575885843,3575885843,0
3,1082,27987,3575885843,3575885843,0
3,1082,27988,3575885843,3575885843,0
3,1082,27989,3575885843,3575885844,1
3,1082,27990,3575885843,3575885845,2
3,1082,27991,3575885843,3575885847,4
3,1082,27992,3575885843,3575885849,6
3,1082,27993,3575885843,3575885849,6
3,1082,27994,3575885843,3575885852,9
3,1082,27995,3575885843,3575885852,9
3,1082,27996,3575885843,3575885852,9
3,1082,27997,3575885843,3575885855,12
3,1082,27998,3575885843,3575885857,14
3,1082,27999,3575885843,3575885858,15
3,1082,28000,3575885843,3575885859,16
3,1082,28001,3575885843,3575885861,18
3,1082,28002,3575885843,3575885861,18
3,1082,28003,3575885843,3575885862,19
3,1082,28004,3575885843,3575885862,19
3,1082,28005,3575885843,3575885862,19
3,1082,28006,3575885843,3575885862,19
3,1082,28007,3575885843,3575885863,20
3,1082,28008,3575885843,3575885865,22
3,1082,28009,3575885843,3575885865,22
3,1082,28010,3575885843,3575885866,23
3,1082,28011,3575885843,3575885866,23
3,1082,28012,3575885843,3575885867,24
3,1082,28013,3575885843,3575885867,24
3,1082,28014,3575885843,3575885868,25
3,1082,28015,3575885843,3575885874,31
3,1082,28016,3575885843,3575885877,34
3,1082,28017,3575885843,3575885877,34
3,1082,28018,3575885843,3575885881,38
3,1082,28019,3575885843,3575885882,39
3,1082,28020,3575885843,3575885883,40
3,1082,28021,3575885843,3575885884,41
3,1082,28022,3575885843,3575885884,41
3,1082,28023,3575885843,3575885885,42
3,1082,28024,3575885843,3575885886,43
3,1082,28025,3575885843,3575885887,44
3,1082,28026,3575885843,3575885888,45
3,1082,28027,3575885843,3575885888,45
3,1082,28028,3575885843,3575885888,45
3,1082,28029,3575885843,3575885889,46
3,1082,28030,3575885843,3575885889,46
3,1082,28031,3575885843,3575885890,47
3,1082,28032,3575885843,3575885890,47
3,1083,28033,3575885906,3575885906,0
3,1083,28034,3575885906,3575885906,0
3,1083,28035,3575885906,3575885906,0
3,1083,28036,3575885906,3575885906,0
3,1083,28037,3575885906,3575885906,0
3,1083,28038,3575885906,3575885906,0
3,1083,28039,3575885906,3575885906,0
3,1083,28040,3575885906,3575885906,0
3,1083,28041,3575885906,3575885906,0
3,1083,28042,3575885906,3575885906,0
3,1083,28043,3575885906,3575885906,0
3,1083,28044,3575885906,3575885906,0
3,1083,28045,3575885906,3575885906,0
3,1083,28046,3575885906,3575885909,3
3,1083,28047,3575885906,3575885910,4
3,1083,28048,3575885906,3575885911,5
3,1083,28049,3575885906,3575885911,5
3,1083,28050,3575885906,3575885911,5
3,1083,28051,3575885906,3575885912,6
3,1083,28052,3575885906,3575885913,7
3,1083,28053,3575885906,3575885914,8
3,1083,28054,3575885906,3575885917,11
3,1083,28055,3575885906,3575885917,11
3,1083,28056,3575885906,3575885917,11
3,1083,28057,3575885906,3575885919,13
3,1083,28058,3575885906,3575885920,14
3,1083,28059,3575885906,3575885921,15
3,1083,28060,3575885906,3575885922,16
3,1083,28061,3575885906,3575885922,16
3,1083,28062,3575885906,3575885923,17
3,1083,28063,3575885906,3575885926,20
3,1083,28064,3575885906,3575885928,22
3,1083,28065,3575885906,3575885929,23
3,1083,28066,3575885906,3575885931,25
3,1083,28067,3575885906,3575885931,25
3,1083,28068,3575885906,3575885932,26
3,1083,28069,3575885906,3575885933,27
3,1083,28070,3575885906,3575885934,28
3,1083,28071,3575885906,3575885934,28
3,1083,28072,3575885906,3575885937,31
3,1083,28073,3575885906,3575885937,31
3,1083,28074,3575885906,3575885941,35
3,1083,28075,3575885906,3575885943,37
3,1083,28076,3575885906,3575885943,37
3,1083,28077,3575885906,3575885945,39
3,1083,28078,3575885906,3575885948,42
3,1083,28079,3575885906,3575885948,42
3,1083,28080,3575885906,3575885951,45
3,1083,28081,3575885906,3575885952,46
3,1083,28082,3575885906,3575885954,48
3,1083,28083,3575885906,3575885954,48
3,1084,28084,3575885970,3575885970,0
3,1084,28085,3575885970,3575885970,0
3,1084,28086,3575885970,3575885970,0
3,1084,28087,3575885970,3575885970,0
3,1084,28088,3575885970,3575885970,0
3,1084,28089,3575885970,3575885970,0
3,1084,28090,3575885970,3575885970,0
3,1084,28091,3575885970,3575885970,0
3,1084,28092,3575885970,3575885970,0
3,1084,28093,3575885970,3575885970,0
3,1084,28094,3575885970,3575885971,1
3,1084,28095,3575885970,3575885971,1
3,1084,28096,3575885970,3575885973,3
3,1084,28097,3575885970,3575885977,7
3,1084,28098,3575885970,3575885979,9
3,1084,28099,3575885970,3575885979,9
3,1084,28100,3575885970,3575885979,9
3,1084,28101,3575885970,3575885981,11
3,1084,28102,3575885970,3575885981,11
3,1084,28103,3575885970,3575885981,11
3,1084,28104,3575885970,3575885983,13
3,1084,28105,3575885970,3575885985,15
3,1084,28106,3575885970,3575885986,16
3,1084,28107,3575885970,3575885986,16
3,1084,28108,3575885970,3575885987,17
3,1084,28109,3575885970,3575885989,19
3,1084,28110,3575885970,3575885992,22
3,1084,28111,3575885970,3575885992,22
3,1084,28112,3575885970,3575885994,24
3,1084,28113,3575885970,3575885994,24
3,1084,28114,3575885970,3575885994,24
3,1084,28115,3575885970,3575885995,25
3,1084,28116,3575885970,3575885996,26
3,1084,28117,3575885970,3575885996,26
3,1084,28118,3575885970,3575885997,27
3,1084,28119,3575885970,3575885998,28
3,1084,28120,3575885970,3575885999,29
3,1084,28121,3575885970,3575886000,30
3,1084,28122,3575885970,3575886000,30
3,1084,28123,3575885970,3575886002,32
3,1084,28124,3575885970,3575886002,32
3,1084,28125,3575885970,3575886003,33
3,1084,28126,3575885970,3575886003,33
3,1084,28127,3575885970,3575886006,36
3,1084,28128,3575885970,3575886012,42
3,1084,28129,3575885970,3575886015,45
3,1084,28130,3575885970,3575886018,48
3,1084,28131,3575885970,3575886018,48
3,1084,28132,3575885970,3575886020,50
3,1085,28133,3575886037,3575886037,0
3,1085,28134,3575886037,3575886037,0
3,1085,28135,3575886037,3575886037,0
3,1085,28136,3575886037,3575886037,0
3,1085,28137,3575886037,3575886037,0
3,1085,28138,3575886037,3575886037,0
3,1085,28139,3575886037,3575886037,0
3,1085,28140,3575886037,3575886037,0
3,1085,28141,3575886037,3575886037,0
3,1085,28142,3575886037,3575886037,0
3,1085,28143,3575886037,3575886037,0
3,1085,28144,3575886037,3575886037,0
3,1085,28145,3575886037,3575886037,0
3,1085,28146,3575886037,3575886037,0
3,1085,28147,3575886037,3575886037,0
3,1085,28148,3575886037,3575886037,0
3,1085,28149,3575886037,3575886037,0
3,1085,28150,3575886037,3575886037,0
3,1085,28151,3575886037,3575886038,1
3,1085,28152,3575886037,3575886038,1
3,1085,28153,3575886037,3575886039,2
3,1085,28154,3575886037,3575886040,3
3,1085,28155,3575886037,3575886040,3
3,1085,28156,3575886037,3575886040,3
3,1085,28157,3575886037,3575886041,4
3,1085,28158,3575886037,3575886041,4
3,1085,28159,3575886037,3575886043,6
3,1085,28160,3575886037,3575886044,7
3,1085,28161,3575886037,3575886045,8
3,1085,28162,3575886037,3575886047,10
3,1085,28163,3575886037,3575886049,12
3,1085,28164,3575886037,3575886052,15
3,1085,28165,3575886037,3575886052,15
3,1085,28166,3575886037,3575886053,16
3,1085,28167,3575886037,3575886055,18
3,1085,28168,3575886037,3575886057,20
3,1085,28169,3575886037,3575886058,21
3,1085,28170,3575886037,3575886059,22
3,1085,28171,3575886037,3575886061,24
3,1085,28172,3575886037,3575886061,24
3,1085,28173,3575886037,3575886062,25
3,1085,28174,3575886037,3575886062,25
3,1085,28175,3575886037,3575886063,26
3,1085,28176,3575886037,3575886063,26
3,1085,28177,3575886037,3575886064,27
3,1085,28178,3575886037,3575886065,28
3,1085,28179,3575886037,3575886066,29
3,1085,28180,3575886037,3575886066,29
3,1085,28181,3575886037,3575886066,29
3,1085,28182,3575886037,3575886067,30
3,1085,28183,3575886037,3575886068,31
3,1085,28184,3575886037,3575886070,33
3,1085,28185,3575886037,3575886074,37
3,1085,28186,3575886037,3575886077,40
3,1085,28187,3575886037,3575886078,41
3,1085,28188,3575886037,3575886081,44
3,1085,28189,3575886037,3575886083,46
3,1085,28190,3575886037,3575886083,46
3,1085,28191,3575886037,3575886084,47
3,1085,28192,3575886037,3575886084,47
3,1085,28193,3575886037,3575886086,49
3,1086,28194,3575886103,3575886103,0
3,1086,28195,3575886103,3575886103,0
3,1086,28196,3575886103,3575886103,0
3,1086,28197,3575886103,3575886103,0
3,1086,28198,3575886103,3575886103,0
3,1086,28199,3575886103,3575886103,0
3,1086,28200,3575886103,3575886103,0
3,1086,28201,3575886103,3575886103,0
3,1086,28202,3575886103,3575886103,0
3,1086,28203,3575886103,3575886103,0
3,1086,28204,3575886103,3575886103,0
3,1086,28205,3575886103,3575886103,0
3,1086,28206,3575886103,3575886103,0
3,1086,28207,3575886103,3575886103,0
3,1086,28208,3575886103,3575886103,0
3,1086,28209,3575886103,3575886103,0
3,1086,28210,3575886103,3575886103,0
3,1086,28211,3575886103,3575886105,2
3,1086,28212,3575886103,3575886106,3
3,1086,28213,3575886103,3575886106,3
3,1086,28214,3575886103,3575886109,6
3,1086,28215,3575886103,3575886110,7
3,1086,28216,3575886103,3575886110,7
3,1086,28217,3575886103,3575886111,8
3,1086,28218,3575886103,3575886112,9
3,1086,28219,3575886103,3575886112,9
3,1086,28220,3575886103,3575886113,10
3,1086,28221,3575886103,3575886115,12
3,1086,28222,3575886103,3575886117,14
3,1086,28223,3575886103,3575886117,14
3,1086,28224,3575886103,3575886117,14
3,1086,28225,3575886103,3575886120,17
3,1086,28226,3575886103,3575886121,18
3,1086,28227,3575886103,3575886121,18
3,1086,28228,3575886103,3575886121,18
3,1086,28229,3575886103,3575886123,20
3,1086,28230,3575886103,3575886127,24
3,1086,28231,3575886103,3575886128,25
3,1086,28232,3575886103,3575886129,26
3,1086,28233,3575886103,3575886130,27
3,1086,28234,3575886103,3575886131,28
3,1086,28235,3575886103,3575886133,30
3,1086,28236,3575886103,3575886133,30
3,1086,28237,3575886103,3575886133,30
3,1086,28238,3575886103,3575886134,31
3,1086,28239,3575886103,3575886137,34
3,1086,28240,3575886103,3575886137,34
3,1086,28241,3575886103,3575886141,38
3,1086,28242,3575886103,3575886142,39
3,1086,28243,3575886103,3575886142,39
3,1086,28244,3575886103,3575886143,40
3,1086,28245,3575886103,3575886145,42
3,1086,28246,3575886103,3575886148,45
3,1086,28247,3575886103,3575886149,46
3,1086,28248,3575886103,3575886151,48
3,1086,28249,3575886103,3575886152,49
3,1087,28250,3575886165,3575886165,0
3,1087,28251,3575886165,3575886165,0
3,1087,28252,3575886165,3575886165,0
3,1087,28253,3575886165,3575886165,0
3,1087,28254,3575886165,3575886165,0
3,1087,28255,3575886165,3575886165,0
3,1087,28256,3575886165,3575886165,0
3,1087,28257,3575886165,3575886168,3
3,1087,28258,3575886165,3575886169,4
3,1087,28259,3575886165,3575886169,4
3,1087,28260,3575886165,3575886170,5
3,1087,28261,3575886165,3575886171,6
3,1087,28262,3575886165,3575886172,7
3,1087,28263,3575886165,3575886173,8
3,1087,28264,3575886165,3575886177,12
3,1087,28265,3575886165,3575886179,14
3,1087,28266,3575886165,3575886180,15
3,1087,28267,3575886165,3575886180,15
3,1087,28268,3575886165,3575886181,16
3,1087,28269,3575886165,3575886181,16
3,1087,28270,3575886165,3575886181,16
3,1087,28271,3575886165,3575886182,17
3,1087,28272,3575886165,3575886186,21
3,1087,28273,3575886165,3575886186,21
3,1087,28274,3575886165,3575886187,22
3,1087,28275,3575886165,3575886187,22
3,1087,28276,3575886165,3575886189,24
3,1087,28277,3575886165,3575886191,26
3,1087,28278,3575886165,3575886192,27
3,1087,28279,3575886165,3575886194,29
3,1087,28280,3575886165,3575886194,29
3,1087,28281,3575886165,3575886194,29
3,1087,28282,3575886165,3575886195,30
3,1087,28283,3575886165,3575886195,30
3,1087,28284,3575886165,3575886195,30
3,1087,28285,3575886165,3575886196,31
3,1087,28286,3575886165,3575886196,31
3,1087,28287,3575886165,3575886197,32
3,1087,28288,3575886165,3575886198,33
3,1087,28289,3575886165,3575886199,34
3,1087,28290,3575886165,3575886200,35
3,1087,28291,3575886165,3575886200,35
3,1087,28292,3575886165,3575886202,37
3,1087,28293,3575886165,3575886202,37
3,1087,28294,3575886165,3575886203,38
3,1087,28295,3575886165,3575886204,39
3,1087,28296,3575886165,3575886206,41
3,1087,28297,3575886165,3575886212,47
3,1088,28298,3575886230,3575886231,1
3,1088,28299,3575886230,3575886231,1
3,1088,28300,3575886230,3575886231,1
3,1088,28301,3575886230,3575886231,1
3,1088,28302,3575886230,3575886231,1
3,1088,28303,3575886230,3575886231,1
3,1088,28304,3575886230,3575886231,1
3,1088,28305,3575886230,3575886231,1
3,1088,28306,3575886230,3575886231,1
3,1088,28307,3575886230,3575886231,1
3,1088,28308,3575886230,3575886231,1
3,1088,28309,3575886230,3575886231,1
3,1088,28310,3575886230,3575886231,1
3,1088,28311,3575886230,3575886231,1
3,1088,28312,3575886230,3575886231,1
3,1088,28313,3575886230,3575886231,1
3,1088,28314,3575886230,3575886231,1
3,1088,28315,3575886230,3575886231,1
3,1088,28316,3575886230,3575886231,1
3,1088,28317,3575886230,3575886231,1
3,1088,28318,3575886230,3575886231,1
3,1088,28319,3575886230,3575886232,2
3,1088,28320,3575886230,3575886234,4
3,1088,28321,3575886230,3575886234,4
3,1088,28322,3575886230,3575886236,6
3,1088,28323,3575886230,3575886238,8
3,1088,28324,3575886230,3575886239,9
3,1088,28325,3575886230,3575886239,9
3,1088,28326,3575886230,3575886239,9
3,1088,28327,3575886230,3575886240,10
3,1088,28328,3575886230,3575886241,11
3,1088,28329,3575886230,3575886241,11
3,1088,28330,3575886230,3575886241,11
3,1088,28331,3575886230,3575886241,11
3,1088,28332,3575886230,3575886243,13
3,1088,28333,3575886230,3575886244,14
3,1088,28334,3575886230,3575886245,15
3,1088,28335,3575886230,3575886246,16
3,1088,28336,3575886230,3575886248,18
3,1088,28337,3575886230,3575886249,19
3,1088,28338,3575886230,3575886252,22
3,1088,28339,3575886230,3575886252,22
3,1088,28340,3575886230,3575886253,23
3,1088,28341,3575886230,3575886258,28
3,1088,28342,3575886230,3575886259,29
3,1088,28343,3575886230,3575886260,30
3,1088,28344,3575886230,3575886261,31
3,1088,28345,3575886230,3575886262,32
3,1088,28346,3575886230,3575886262,32
3,1088,28347,3575886230,3575886263,33
3,1088,28348,3575886230,3575886264,34
3,1088,28349,3575886230,3575886264,34
3,1088,28350,3575886230,3575886264,34
3,1088,28351,3575886230,3575886265,35
3,1088,28352,3575886230,3575886266,36
3,1088,28353,3575886230,3575886266,36
3,1088,28354,3575886230,3575886267,37
3,1088,28355,3575886230,3575886268,38
3,1088,28356,3575886230,3575886270,40
3,1088,28357,3575886230,3575886275,45
3,1088,28358,3575886230,3575886278,48
3,1088,28359,3575886230,3575886278,48
3,1089,28360,3575886293,3575886293,0
3,1089,28361,3575886293,3575886293,0
3,1089,28362,3575886293,3575886293,0
3,1089,28363,3575886293,3575886293,0
3,1089,28364,3575886293,3575886293,0
3,1089,28365,3575886293,3575886293,0
3,1089,28366,3575886293,3575886293,0
3,1089,28367,3575886293,3575886293,0
3,1089,28368,3575886293,3575886293,0
3,1089,28369,3575886293,3575886293,0
3,1089,28370,3575886293,3575886293,0
3,1089,28371,3575886293,3575886293,0
3,1089,28372,3575886293,3575886293,0
3,1089,28373,3575886293,3575886293,0
3,1089,28374,3575886293,3575886293,0
3,1089,28375,3575886293,3575886295,2
3,1089,28376,3575886293,3575886296,3
3,1089,28377,3575886293,3575886296,3
3,1089,28378,3575886293,3575886297,4
3,1089,28379,3575886293,3575886299,6
3,1089,28380,3575886293,3575886301,8
3,1089,28381,3575886293,3575886302,9
3,1089,28382,3575886293,3575886302,9
3,1089,28383,3575886293,3575886302,9
3,1089,28384,3575886293,3575886302,9
3,1089,28385,3575886293,3575886303,10
3,1089,28386,3575886293,3575886305,12
3,1089,28387,3575886293,3575886306,13
3,1089,28388,3575886293,3575886306,13
3,1089,28389,3575886293,3575886307,14
3,1089,28390,3575886293,3575886309,16
3,1089,28391,3575886293,3575886310,17
3,1089,28392,3575886293,3575886310,17
3,1089,28393,3575886293,3575886311,18
3,1089,28394,3575886293,3575886312,19
3,1089,28395,3575886293,3575886313,20
3,1089,28396,3575886293,3575886313,20
3,1089,28397,3575886293,3575886314,21
3,1089,28398,3575886293,3575886316,23
3,1089,28399,3575886293,3575886317,24
3,1089,28400,3575886293,3575886318,25
3,1089,28401,3575886293,3575886319,26
3,1089,28402,3575886293,3575886320,27
3,1089,28403,3575886293,3575886322,29
3,1089,28404,3575886293,3575886322,29
3,1089,28405,3575886293,3575886323,30
3,1089,28406,3575886293,3575886323,30
3,1089,28407,3575886293,3575886326,33
3,1089,28408,3575886293,3575886328,35
3,1089,28409,3575886293,3575886331,38
3,1089,28410,3575886293,3575886331,38
3,1089,28411,3575886293,3575886331,38
3,1089,28412,3575886293,3575886332,39
3,1089,28413,3575886293,3575886333,40
3,1089,28414,3575886293,3575886333,40
3,1089,28415,3575886293,3575886335,42
3,1089,28416,3575886293,3575886338,45
3,1089,28417,3575886293,3575886341,48
3,1089,28418,3575886293,3575886343,50
3,1090,28419,3575886357,3575886357,0
3,1090,28420,3575886357,3575886357,0
3,1090,28421,3575886357,3575886357,0
3,1090,28422,3575886357,3575886357,0
3,1090,28423,3575886357,3575886357,0
3,1090,28424,3575886357,3575886357,0
3,1090,28425,3575886357,3575886357,0
3,1090,28426,3575886357,3575886357,0
3,1090,28427,3575886357,3575886357,0
3,1090,28428,3575886357,3575886359,2
3,1090,28429,3575886357,3575886361,4
3,1090,28430,3575886357,3575886361,4
3,1090,28431,3575886357,3575886364,7
3,1090,28432,3575886357,3575886364,7
3,1090,28433,3575886357,3575886368,11
3,1090,28434,3575886357,3575886369,12
3,1090,28435,3575886357,3575886370,13
3,1090,28436,3575886357,3575886371,14
3,1090,28437,3575886357,3575886371,14
3,1090,28438,3575886357,3575886372,15
3,1090,28439,3575886357,3575886374,17
3,1090,28440,3575886357,3575886380,23
3,1090,28441,3575886357,3575886381,24
3,1090,28442,3575886357,3575886381,24
3,1090,28443,3575886357,3575886381,24
3,1090,28444,3575886357,3575886382,25
3,1090,28445,3575886357,3575886384,27
3,1090,28446,3575886357,3575886386,29
3,1090,28447,3575886357,3575886387,30
3,1090,28448,3575886357,3575886387,30
3,1090,28449,3575886357,3575886387,30
3,1090,28450,3575886357,3575886389,32
3,1090,28451,3575886357,3575886392,35
3,1090,28452,3575886357,3575886392,35
3,1090,28453,3575886357,3575886394,37
3,1090,28454,3575886357,3575886394,37
3,1090,28455,3575886357,3575886394,37
3,1090,28456,3575886357,3575886395,38
3,1090,28457,3575886357,3575886395,38
3,1090,28458,3575886357,3575886395,38
3,1090,28459,3575886357,3575886396,39
3,1090,28460,3575886357,3575886396,39
3,1090,28461,3575886357,3575886397,40
3,1090,28462,3575886357,3575886398,41
3,1090,28463,3575886357,3575886399,42
3,1090,28464,3575886357,3575886400,43
3,1090,28465,3575886357,3575886400,43
3,1090,28466,3575886357,3575886402,45
3,1090,28467,3575886357,3575886403,46
3,1090,28468,3575886357,3575886404,47
3,1090,28469,3575886357,3575886406,49
3,1091,28470,3575886420,3575886420,0
3,1091,28471,3575886420,3575886420,0
3,1091,28472,3575886420,3575886420,0
3,1091,28473,3575886420,3575886421,1
3,1091,28474,3575886420,3575886421,1
3,1091,28475,3575886420,3575886422,2
3,1091,28476,3575886420,3575886422,2
3,1091,28477,3575886420,3575886423,3
3,1091,28478,3575886420,3575886424,4
3,1091,28479,3575886420,3575886426,6
3,1091,28480,3575886420,3575886426,6
3,1091,28481,3575886420,3575886427,7
3,1091,28482,3575886420,3575886428,8
3,1091,28483,3575886420,3575886428,8
3,1091,28484,3575886420,3575886428,8
3,1091,28485,3575886420,3575886429,9
3,1091,28486,3575886420,3575886429,9
3,1091,28487,3575886420,3575886429,9
3,1091,28488,3575886420,3575886431,11
3,1091,28489,3575886420,3575886431,11
3,1091,28490,3575886420,3575886432,12
3,1091,28491,3575886420,3575886434,14
3,1091,28492,3575886420,3575886435,15
3,1091,28493,3575886420,3575886436,16
3,1091,28494,3575886420,3575886438,18
3,1091,28495,3575886420,3575886439,19
3,1091,28496,3575886420,3575886440,20
3,1091,28497,3575886420,3575886440,20
3,1091,28498,3575886420,3575886440,20
3,1091,28499,3575886420,3575886441,21
3,1091,28500,3575886420,3575886441,21
3,1091,28501,3575886420,3575886441,21
3,1091,28502,3575886420,3575886441,21
3,1091,28503,3575886420,3575886444,24
3,1091,28504,3575886420,3575886444,24
3,1091,28505,3575886420,3575886445,25
3,1091,28506,3575886420,3575886446,26
3,1091,28507,3575886420,3575886447,27
3,1091,28508,3575886420,3575886448,28
3,1091,28509,3575886420,3575886449,29
3,1091,28510,3575886420,3575886452,32
3,1091,28511,3575886420,3575886452,32
3,1091,28512,3575886420,3575886452,32
3,1091,28513,3575886420,3575886453,33
3,1091,28514,3575886420,3575886456,36
3,1091,28515,3575886420,3575886458,38
3,1091,28516,3575886420,3575886459,39
3,1091,28517,3575886420,3575886460,40
3,1091,28518,3575886420,3575886461,41
3,1091,28519,3575886420,3575886462,42
3,1091,28520,3575886420,3575886462,42
3,1091,28521,3575886420,3575886463,43
3,1091,28522,3575886420,3575886464,44
3,1091,28523,3575886420,3575886464,44
3,1091,28524,3575886420,3575886465,45
3,1091,28525,3575886420,3575886465,45
3,1091,28526,3575886420,3575886466,46
3,1091,28527,3575886420,3575886466,46
3,1091,28528,3575886420,3575886467,47
3,1091,28529,3575886420,3575886470,50
3,1092,28530,3575886483,3575886483,0
3,1092,28531,3575886483,3575886483,0
3,1092,28532,3575886483,3575886483,0
3,1092,28533,3575886483,3575886483,0
3,1092,28534,3575886483,3575886483,0
3,1092,28535,3575886483,3575886483,0
3,1092,28536,3575886483,3575886483,0
3,1092,28537,3575886483,3575886484,1
3,1092,28538,3575886483,3575886484,1
3,1092,28539,3575886483,3575886487,4
3,1092,28540,3575886483,3575886488,5
3,1092,28541,3575886483,3575886488,5
3,1092,28542,3575886483,3575886489,6
3,1092,28543,3575886483,3575886489,6
3,1092,28544,3575886483,3575886490,7
3,1092,28545,3575886483,3575886490,7
3,1092,28546,3575886483,3575886490,7
3,1092,28547,3575886483,3575886490,7
3,1092,28548,3575886483,3575886495,12
3,1092,28549,3575886483,3575886495,12
3,1092,28550,3575886483,3575886496,13
3,1092,28551,3575886483,3575886497,14
3,1092,28552,3575886483,3575886499,16
3,1092,28553,3575886483,3575886501,18
3,1092,28554,3575886483,3575886501,18
3,1092,28555,3575886483,3575886501,18
3,1092,28556,3575886483,3575886502,19
3,1092,28557,3575886483,3575886502,19
3,1092,28558,3575886483,3575886505,22
3,1092,28559,3575886483,3575886505,22
3,1092,28560,3575886483,3575886505,22
3,1092,28561,3575886483,3575886506,23
3,1092,28562,3575886483,3575886508,25
3,1092,28563,3575886483,3575886509,26
3,1092,28564,3575886483,3575886511,28
3,1092,28565,3575886483,3575886511,28
3,1092,28566,3575886483,3575886512,29
3,1092,28567,3575886483,3575886512,29
3,1092,28568,3575886483,3575886512,29
3,1092,28569,3575886483,3575886513,30
3,1092,28570,3575886483,3575886516,33
3,1092,28571,3575886483,3575886516,33
3,1092,28572,3575886483,3575886517,34
3,1092,28573,3575886483,3575886518,35
3,1092,28574,3575886483,3575886519,36
3,1092,28575,3575886483,3575886520,37
3,1092,28576,3575886483,3575886520,37
3,1092,28577,3575886483,3575886522,39
3,1092,28578,3575886483,3575886522,39
3,1092,28579,3575886483,3575886526,43
3,1092,28580,3575886483,3575886527,44
3,1092,28581,3575886483,3575886529,46
3,1092,28582,3575886483,3575886529,46
3,1092,28583,3575886483,3575886530,47
3,1093,28584,3575886546,3575886546,0
3,1093,28585,3575886546,3575886546,0
3,1093,28586,3575886546,3575886546,0
3,1093,28587,3575886546,3575886546,0
3,1093,28588,3575886546,3575886546,0
3,1093,28589,3575886546,3575886546,0
3,1093,28590,3575886546,3575886546,0
3,1093,28591,3575886546,3575886546,0
3,1093,28592,3575886546,3575886546,0
3,1093,28593,3575886546,3575886546,0
3,1093,28594,3575886546,3575886546,0
3,1093,28595,3575886546,3575886548,2
3,1093,28596,3575886546,3575886551,5
3,1093,28597,3575886546,3575886551,5
3,1093,28598,3575886546,3575886553,7
3,1093,28599,3575886546,3575886553,7
3,1093,28600,3575886546,3575886558,12
3,1093,28601,3575886546,3575886560,14
3,1093,28602,3575886546,3575886563,17
3,1093,28603,3575886546,3575886563,17
3,1093,28604,3575886546,3575886567,21
3,1093,28605,3575886546,3575886569,23
3,1093,28606,3575886546,3575886570,24
3,1093,28607,3575886546,3575886571,25
3,1093,28608,3575886546,3575886571,25
3,1093,28609,3575886546,3575886573,27
3,1093,28610,3575886546,3575886576,30
3,1093,28611,3575886546,3575886579,33
3,1093,28612,3575886546,3575886579,33
3,1093,28613,3575886546,3575886580,34
3,1093,28614,3575886546,3575886580,34
3,1093,28615,3575886546,3575886581,35
3,1093,28616,3575886546,3575886581,35
3,1093,28617,3575886546,3575886582,36
3,1093,28618,3575886546,3575886586,40
3,1093,28619,3575886546,3575886586,40
3,1093,28620,3575886546,3575886586,40
3,1093,28621,3575886546,3575886587,41
3,1093,28622,3575886546,3575886588,42
3,1093,28623,3575886546,3575886590,44
3,1093,28624,3575886546,3575886591,45
3,1093,28625,3575886546,3575886593,47
3,1093,28626,3575886546,3575886593,47
3,1093,28627,3575886546,3575886593,47
3,1093,28628,3575886546,3575886594,48
3,1093,28629,3575886546,3575886594,48
3,1093,28630,3575886546,3575886595,49
3,1093,28631,3575886546,3575886596,50
3,1094,28632,3575886608,3575886608,0
3,1094,28633,3575886608,3575886608,0
3,1094,28634,3575886608,3575886608,0
3,1094,28635,3575886608,3575886608,0
3,1094,28636,3575886608,3575886608,0
3,1094,28637,3575886608,3575886608,0
3,1094,28638,3575886608,3575886608,0
3,1094,28639,3575886608,3575886608,0
3,1094,28640,3575886608,3575886608,0
3,1094,28641,3575886608,3575886608,0
3,1094,28642,3575886608,3575886608,0
3,1094,28643,3575886608,3575886608,0
3,1094,28644,3575886608,3575886608,0
3,1094,28645,3575886608,3575886611,3
3,1094,28646,3575886608,3575886614,6
3,1094,28647,3575886608,3575886617,9
3,1094,28648,3575886608,3575886617,9
3,1094,28649,3575886608,3575886618,10
3,1094,28650,3575886608,3575886620,12
3,1094,28651,3575886608,3575886620,12
3,1094,28652,3575886608,3575886621,13
3,1094,28653,3575886608,3575886623,15
3,1094,28654,3575886608,3575886623,15
3,1094,28655,3575886608,3575886626,18
3,1094,28656,3575886608,3575886626,18
3,1094,28657,3575886608,3575886626,18
3,1094,28658,3575886608,3575886626,18
3,1094,28659,3575886608,3575886627,19
3,1094,28660,3575886608,3575886627,19
3,1094,28661,3575886608,3575886628,20
3,1094,28662,3575886608,3575886628,20
3,1094,28663,3575886608,3575886629,21
3,1094,28664,3575886608,3575886630,22
3,1094,28665,3575886608,3575886630,22
3,1094,28666,3575886608,3575886633,25
3,1094,28667,3575886608,3575886634,26
3,1094,28668,3575886608,3575886635,27
3,1094,28669,3575886608,3575886638,30
3,1094,28670,3575886608,3575886639,31
3,1094,28671,3575886608,3575886639,31
3,1094,28672,3575886608,3575886639,31
3,1094,28673,3575886608,3575886640,32
3,1094,28674,3575886608,3575886640,32
3,1094,28675,3575886608,3575886640,32
3,1094,28676,3575886608,3575886640,32
3,1094,28677,3575886608,3575886643,35
3,1094,28678,3575886608,3575886644,36
3,1094,28679,3575886608,3575886644,36
3,1094,28680,3575886608,3575886645,37
3,1094,28681,3575886608,3575886646,38
3,1094,28682,3575886608,3575886647,39
3,1094,28683,3575886608,3575886648,40
3,1094,28684,3575886608,3575886651,43
3,1094,28685,3575886608,3575886651,43
3,1094,28686,3575886608,3575886652,44
3,1094,28687,3575886608,3575886652,44
3,1094,28688,3575886608,3575886654,46
3,1094,28689,3575886608,3575886657,49
3,1094,28690,3575886608,3575886658,50
3,1095,28691,3575886672,3575886672,0
3,1095,28692,3575886672,3575886672,0
3,1095,28693,3575886672,3575886672,0
3,1095,28694,3575886672,3575886672,0
3,1095,28695,3575886672,3575886672,0
3,1095,28696,3575886672,3575886672,0
3,1095,28697,3575886672,3575886672,0
3,1095,28698,3575886672,3575886672,0
3,1095,28699,3575886672,3575886672,0
3,1095,28700,3575886672,3575886672,0
3,1095,28701,3575886672,3575886672,0
3,1095,28702,3575886672,3575886672,0
3,1095,28703,3575886672,3575886672,0
3,1095,28704,3575886672,3575886672,0
3,1095,28705,3575886672,3575886673,1
3,1095,28706,3575886672,3575886679,7
3,1095,28707,3575886672,3575886680,8
3,1095,28708,3575886672,3575886681,9
3,1095,28709,3575886672,3575886683,11
3,1095,28710,3575886672,3575886683,11
3,1095,28711,3575886672,3575886685,13
3,1095,28712,3575886672,3575886685,13
3,1095,28713,3575886672,3575886687,15
3,1095,28714,3575886672,3575886687,15
3,1095,28715,3575886672,3575886688,16
3,1095,28716,3575886672,3575886688,16
3,1095,28717,3575886672,3575886689,17
3,1095,28718,3575886672,3575886689,17
3,1095,28719,3575886672,3575886690,18
3,1095,28720,3575886672,3575886690,18
3,1095,28721,3575886672,3575886691,19
3,1095,28722,3575886672,3575886694,22
3,1095,28723,3575886672,3575886695,23
3,1095,28724,3575886672,3575886697,25
3,1095,28725,3575886672,3575886698,26
3,1095,28726,3575886672,3575886700,28
3,1095,28727,3575886672,3575886701,29
3,1095,28728,3575886672,3575886701,29
3,1095,28729,3575886672,3575886702,30
3,1095,28730,3575886672,3575886702,30
3,1095,28731,3575886672,3575886705,33
3,1095,28732,3575886672,3575886705,33
3,1095,28733,3575886672,3575886710,38
3,1095,28734,3575886672,3575886710,38
3,1095,28735,3575886672,3575886711,39
3,1095,28736,3575886672,3575886713,41
3,1095,28737,3575886672,3575886713,41
3,1095,28738,3575886672,3575886713,41
3,1095,28739,3575886672,3575886713,41
3,1095,28740,3575886672,3575886716,44
3,1095,28741,3575886672,3575886718,46
3,1095,28742,3575886672,3575886720,48
3,1095,28743,3575886672,3575886721,49
3,1095,28744,3575886672,3575886722,50
3,1096,28745,3575886735,3575886735,0
3,1096,28746,3575886735,3575886735,0
3,1096,28747,3575886735,3575886735,0
3,1096,28748,3575886735,3575886735,0
3,1096,28749,3575886735,3575886735,0
3,1096,28750,3575886735,3575886735,0
3,1096,28751,3575886735,3575886735,0
3,1096,28752,3575886735,3575886735,0
3,1096,28753,3575886735,3575886735,0
3,1096,28754,3575886735,3575886737,2
3,1096,28755,3575886735,3575886737,2
3,1096,28756,3575886735,3575886740,5
3,1096,28757,3575886735,3575886742,7
3,1096,28758,3575886735,3575886743,8
3,1096,28759,3575886735,3575886743,8
3,1096,28760,3575886735,3575886744,9
3,1096,28761,3575886735,3575886747,12
3,1096,28762,3575886735,3575886748,13
3,1096,28763,3575886735,3575886751,16
3,1096,28764,3575886735,3575886751,16
3,1096,28765,3575886735,3575886753,18
3,1096,28766,3575886735,3575886754,19
3,1096,28767,3575886735,3575886758,23
3,1096,28768,3575886735,3575886760,25
3,1096,28769,3575886735,3575886761,26
3,1096,28770,3575886735,3575886762,27
3,1096,28771,3575886735,3575886763,28
3,1096,28772,3575886735,3575886768,33
3,1096,28773,3575886735,3575886769,34
3,1096,28774,3575886735,3575886769,34
3,1096,28775,3575886735,3575886771,36
3,1096,28776,3575886735,3575886771,36
3,1096,28777,3575886735,3575886773,38
3,1096,28778,3575886735,3575886776,41
3,1096,28779,3575886735,3575886779,44
3,1096,28780,3575886735,3575886779,44
3,1096,28781,3575886735,3575886779,44
3,1096,28782,3575886735,3575886780,45
3,1096,28783,3575886735,3575886781,46
3,1096,28784,3575886735,3575886781,46
3,1096,28785,3575886735,3575886783,48
3,1097,28786,3575886800,3575886800,0
3,1097,28787,3575886800,3575886800,0
3,1097,28788,3575886800,3575886800,0
3,1097,28789,3575886800,3575886800,0
3,1097,28790,3575886800,3575886800,0
3,1097,28791,3575886800,3575886800,0
3,1097,28792,3575886800,3575886800,0
3,1097,28793,3575886800,3575886800,0
3,1097,28794,3575886800,3575886800,0
3,1097,28795,3575886800,3575886800,0
3,1097,28796,3575886800,3575886800,0
3,1097,28797,3575886800,3575886800,0
3,1097,28798,3575886800,3575886800,0
3,1097,28799,3575886800,3575886800,0
3,1097,28800,3575886800,3575886800,0
3,1097,28801,3575886800,3575886800,0
3,1097,28802,3575886800,3575886800,0
3,1097,28803,3575886800,3575886800,0
3,1097,28804,3575886800,3575886800,0
3,1097,28805,3575886800,3575886800,0
3,1097,28806,3575886800,3575886800,0
3,1097,28807,3575886800,3575886800,0
3,1097,28808,3575886800,3575886802,2
3,1097,28809,3575886800,3575886803,3
3,1097,28810,3575886800,3575886803,3
3,1097,28811,3575886800,3575886805,5
3,1097,28812,3575886800,3575886810,10
3,1097,28813,3575886800,3575886815,15
3,1097,28814,3575886800,3575886817,17
3,1097,28815,3575886800,3575886817,17
3,1097,28816,3575886800,3575886818,18
3,1097,28817,3575886800,3575886819,19
3,1097,28818,3575886800,3575886820,20
3,1097,28819,3575886800,3575886821,21
3,1097,28820,3575886800,3575886821,21
3,1097,28821,3575886800,3575886823,23
3,1097,28822,3575886800,3575886824,24
3,1097,28823,3575886800,3575886825,25
3,1097,28824,3575886800,3575886825,25
3,1097,28825,3575886800,3575886826,26
3,1097,28826,3575886800,3575886827,27
3,1097,28827,3575886800,3575886827,27
3,1097,28828,3575886800,3575886828,28
3,1097,28829,3575886800,3575886828,28
3,1097,28830,3575886800,3575886829,29
3,1097,28831,3575886800,3575886829,29
3,1097,28832,3575886800,3575886830,30
3,1097,28833,3575886800,3575886831,31
3,1097,28834,3575886800,3575886832,32
3,1097,28835,3575886800,3575886833,33
3,1097,28836,3575886800,3575886833,33
3,1097,28837,3575886800,3575886835,35
3,1097,28838,3575886800,3575886838,38
3,1097,28839,3575886800,3575886838,38
3,1097,28840,3575886800,3575886839,39
3,1097,28841,3575886800,3575886839,39
3,1097,28842,3575886800,3575886839,39
3,1097,28843,3575886800,3575886840,40
3,1097,28844,3575886800,3575886840,40
3,1097,28845,3575886800,3575886840,40
3,1097,28846,3575886800,3575886841,41
3,1097,28847,3575886800,3575886844,44
3,1097,28848,3575886800,3575886845,45
3,1097,28849,3575886800,3575886846,46
3,1097,28850,3575886800,3575886847,47
3,1097,28851,3575886800,3575886849,49
3,1098,28852,3575886863,3575886863,0
3,1098,28853,3575886863,3575886863,0
3,1098,28854,3575886863,3575886863,0
3,1098,28855,3575886863,3575886863,0
3,1098,28856,3575886863,3575886863,0
3,1098,28857,3575886863,3575886863,0
3,1098,28858,3575886863,3575886863,0
3,1098,28859,3575886863,3575886863,0
3,1098,28860,3575886863,3575886863,0
3,1098,28861,3575886863,3575886863,0
3,1098,28862,3575886863,3575886863,0
3,1098,28863,3575886863,3575886863,0
3,1098,28864,3575886863,3575886863,0
3,1098,28865,3575886863,3575886864,1
3,1098,28866,3575886863,3575886865,2
3,1098,28867,3575886863,3575886865,2
3,1098,28868,3575886863,3575886865,2
3,1098,28869,3575886863,3575886866,3
3,1098,28870,3575886863,3575886867,4
3,1098,28871,3575886863,3575886868,5
3,1098,28872,3575886863,3575886873,10
3,1098,28873,3575886863,3575886877,14
3,1098,28874,3575886863,3575886878,15
3,1098,28875,3575886863,3575886881,18
3,1098,28876,3575886863,3575886883,20
3,1098,28877,3575886863,3575886883,20
3,1098,28878,3575886863,3575886885,22
3,1098,28879,3575886863,3575886887,24
3,1098,28880,3575886863,3575886887,24
3,1098,28881,3575886863,3575886888,25
3,1098,28882,3575886863,3575886888,25
3,1098,28883,3575886863,3575886888,25
3,1098,28884,3575886863,3575886890,27
3,1098,28885,3575886863,3575886890,27
3,1098,28886,3575886863,3575886890,27
3,1098,28887,3575886863,3575886891,28
3,1098,28888,3575886863,3575886894,31
3,1098,28889,3575886863,3575886895,32
3,1098,28890,3575886863,3575886901,38
3,1098,28891,3575886863,3575886901,38
3,1098,28892,3575886863,3575886902,39
3,1098,28893,3575886863,3575886902,39
3,1098,28894,3575886863,3575886902,39
3,1098,28895,3575886863,3575886905,42
3,1098,28896,3575886863,3575886905,42
3,1098,28897,3575886863,3575886906,43
3,1098,28898,3575886863,3575886911,48
3,1098,28899,3575886863,3575886912,49
3,1098,28900,3575886863,3575886912,49
3,1098,28901,3575886863,3575886913,50
3,1098,28902,3575886863,3575886913,50
3,1099,28903,3575886929,3575886929,0
3,1099,28904,3575886929,3575886929,0
3,1099,28905,3575886929,3575886929,0
3,1099,28906,3575886929,3575886929,0
3,1099,28907,3575886929,3575886929,0
3,1099,28908,3575886929,3575886929,0
3,1099,28909,3575886929,3575886929,0
3,1099,28910,3575886929,3575886929,0
3,1099,28911,3575886929,3575886929,0
3,1099,28912,3575886929,3575886929,0
3,1099,28913,3575886929,3575886930,1
3,1099,28914,3575886929,3575886930,1
3,1099,28915,3575886929,3575886931,2
3,1099,28916,3575886929,3575886933,4
3,1099,28917,3575886929,3575886933,4
3,1099,28918,3575886929,3575886933,4
3,1099,28919,3575886929,3575886934,5
3,1099,28920,3575886929,3575886937,8
3,1099,28921,3575886929,3575886937,8
3,1099,28922,3575886929,3575886941,12
3,1099,28923,3575886929,3575886942,13
3,1099,28924,3575886929,3575886943,14
3,1099,28925,3575886929,3575886944,15
3,1099,28926,3575886929,3575886944,15
3,1099,28927,3575886929,3575886947,18
3,1099,28928,3575886929,3575886948,19
3,1099,28929,3575886929,3575886951,22
3,1099,28930,3575886929,3575886952,23
3,1099,28931,3575886929,3575886954,25
3,1099,28932,3575886929,3575886954,25
3,1099,28933,3575886929,3575886958,29
3,1099,28934,3575886929,3575886960,31
3,1099,28935,3575886929,3575886961,32
3,1099,28936,3575886929,3575886962,33
3,1099,28937,3575886929,3575886964,35
3,1099,28938,3575886929,3575886968,39
3,1099,28939,3575886929,3575886969,40
3,1099,28940,3575886929,3575886970,41
3,1099,28941,3575886929,3575886971,42
3,1099,28942,3575886929,3575886971,42
3,1099,28943,3575886929,3575886971,42
3,1099,28944,3575886929,3575886975,46
3,1099,28945,3575886929,3575886976,47
3,1099,28946,3575886929,3575886979,50
3,1100,28947,3575886991,3575886991,0
3,1100,28948,3575886991,3575886991,0
3,1100,28949,3575886991,3575886991,0
3,1100,28950,3575886991,3575886991,0
3,1100,28951,3575886991,3575886991,0
3,1100,28952,3575886991,3575886991,0
3,1100,28953,3575886991,3575886991,0
3,1100,28954,3575886991,3575886991,0
3,1100,28955,3575886991,3575886991,0
3,1100,28956,3575886991,3575886991,0
3,1100,28957,3575886991,3575886991,0
3,1100,28958,3575886991,3575886991,0
3,1100,28959,3575886991,3575886991,0
3,1100,28960,3575886991,3575886993,2
3,1100,28961,3575886991,3575886993,2
3,1100,28962,3575886991,3575886993,2
3,1100,28963,3575886991,3575886995,4
3,1100,28964,3575886991,3575886995,4
3,1100,28965,3575886991,3575886996,5
3,1100,28966,3575886991,3575886996,5
3,1100,28967,3575886991,3575886997,6
3,1100,28968,3575886991,3575886997,6
3,1100,28969,3575886991,3575886998,7
3,1100,28970,3575886991,3575886999,8
3,1100,28971,3575886991,3575886999,8
3,1100,28972,3575886991,3575887000,9
3,1100,28973,3575886991,3575887000,9
3,1100,28974,3575886991,3575887002,11
3,1100,28975,3575886991,3575887002,11
3,1100,28976,3575886991,3575887003,12
3,1100,28977,3575886991,3575887004,13
3,1100,28978,3575886991,3575887006,15
3,1100,28979,3575886991,3575887012,21
3,1100,28980,3575886991,3575887016,25
3,1100,28981,3575886991,3575887017,26
3,1100,28982,3575886991,3575887018,27
3,1100,28983,3575886991,3575887018,27
3,1100,28984,3575886991,3575887020,29
3,1100,28985,3575886991,3575887020,29
3,1100,28986,3575886991,3575887021,30
3,1100,28987,3575886991,3575887022,31
3,1100,28988,3575886991,3575887022,31
3,1100,28989,3575886991,3575887023,32
3,1100,28990,3575886991,3575887025,34
3,1100,28991,3575886991,3575887026,35
3,1100,28992,3575886991,3575887026,35
3,1100,28993,3575886991,3575887027,36
3,1100,28994,3575886991,3575887027,36
3,1100,28995,3575886991,3575887028,37
3,1100,28996,3575886991,3575887028,37
3,1100,28997,3575886991,3575887029,38
3,1100,28998,3575886991,3575887029,38
3,1100,28999,3575886991,3575887029,38
3,1100,29000,3575886991,3575887031,40
3,1100,29001,3575886991,3575887031,40
3,1100,29002,3575886991,3575887033,42
3,1100,29003,3575886991,3575887034,43
3,1100,29004,3575886991,3575887035,44
3,1100,29005,3575886991,3575887038,47
3,1100,29006,3575886991,3575887039,48
3,1100,29007,3575886991,3575887039,48
3,1100,29008,3575886991,3575887039,48
3,1100,29009,3575886991,3575887039,48
3,1100,29010,3575886991,3575887039,48
3,1100,29011,3575886991,3575887040,49
3,1100,29012,3575886991,3575887040,49
3,1100,29013,3575886991,3575887041,50
3,1101,29014,3575887056,3575887056,0
3,1101,29015,3575887056,3575887056,0
3,1101,29016,3575887056,3575887056,0
3,1101,29017,3575887056,3575887056,0
3,1101,29018,3575887056,3575887056,0
3,1101,29019,3575887056,3575887056,0
3,1101,29020,3575887056,3575887056,0
3,1101,29021,3575887056,3575887056,0
3,1101,29022,3575887056,3575887056,0
3,1101,29023,3575887056,3575887056,0
3,1101,29024,3575887056,3575887056,0
3,1101,29025,3575887056,3575887058,2
3,1101,29026,3575887056,3575887059,3
3,1101,29027,3575887056,3575887059,3
3,1101,29028,3575887056,3575887061,5
3,1101,29029,3575887056,3575887061,5
3,1101,29030,3575887056,3575887061,5
3,1101,29031,3575887056,3575887063,7
3,1101,29032,3575887056,3575887063,7
3,1101,29033,3575887056,3575887063,7
3,1101,29034,3575887056,3575887064,8
3,1101,29035,3575887056,3575887065,9
3,1101,29036,3575887056,3575887065,9
3,1101,29037,3575887056,3575887066,10
3,1101,29038,3575887056,3575887067,11
3,1101,29039,3575887056,3575887067,11
3,1101,29040,3575887056,3575887070,14
3,1101,29041,3575887056,3575887073,17
3,1101,29042,3575887056,3575887077,21
3,1101,29043,3575887056,3575887079,23
3,1101,29044,3575887056,3575887080,24
3,1101,29045,3575887056,3575887082,26
3,1101,29046,3575887056,3575887084,28
3,1101,29047,3575887056,3575887084,28
3,1101,29048,3575887056,3575887084,28
3,1101,29049,3575887056,3575887086,30
3,1101,29050,3575887056,3575887087,31
3,1101,29051,3575887056,3575887087,31
3,1101,29052,3575887056,3575887087,31
3,1101,29053,3575887056,3575887088,32
3,1101,29054,3575887056,3575887089,33
3,1101,29055,3575887056,3575887090,34
3,1101,29056,3575887056,3575887090,34
3,1101,29057,3575887056,3575887090,34
3,1101,29058,3575887056,3575887090,34
3,1101,29059,3575887056,3575887094,38
3,1101,29060,3575887056,3575887095,39
3,1101,29061,3575887056,3575887098,42
3,1101,29062,3575887056,3575887101,45
3,1101,29063,3575887056,3575887101,45
3,1101,29064,3575887056,3575887102,46
3,1101,29065,3575887056,3575887102,46
3,1101,29066,3575887056,3575887102,46
3,1101,29067,3575887056,3575887105,49
3,1101,29068,3575887056,3575887105,49
3,1101,29069,3575887056,3575887105,49
3,1102,29070,3575887120,3575887120,0
3,1102,29071,3575887120,3575887120,0
3,1102,29072,3575887120,3575887120,0
3,1102,29073,3575887120,3575887120,0
3,1102,29074,3575887120,3575887120,0
3,1102,29075,3575887120,3575887120,0
3,1102,29076,3575887120,3575887120,0
3,1102,29077,3575887120,3575887120,0
3,1102,29078,3575887120,3575887120,0
3,1102,29079,3575887120,3575887120,0
3,1102,29080,3575887120,3575887120,0
3,1102,29081,3575887120,3575887120,0
3,1102,29082,3575887120,3575887121,1
3,1102,29083,3575887120,3575887122,2
3,1102,29084,3575887120,3575887125,5
3,1102,29085,3575887120,3575887127,7
3,1102,29086,3575887120,3575887127,7
3,1102,29087,3575887120,3575887130,10
3,1102,29088,3575887120,3575887131,11
3,1102,29089,3575887120,3575887131,11
3,1102,29090,3575887120,3575887133,13
3,1102,29091,3575887120,3575887133,13
3,1102,29092,3575887120,3575887134,14
3,1102,29093,3575887120,3575887134,14
3,1102,29094,3575887120,3575887137,17
3,1102,29095,3575887120,3575887137,17
3,1102,29096,3575887120,3575887141,21
3,1102,29097,3575887120,3575887143,23
3,1102,29098,3575887120,3575887143,23
3,1102,29099,3575887120,3575887144,24
3,1102,29100,3575887120,3575887144,24
3,1102,29101,3575887120,3575887147,27
3,1102,29102,3575887120,3575887148,28
3,1102,29103,3575887120,3575887151,31
3,1102,29104,3575887120,3575887152,32
3,1102,29105,3575887120,3575887154,34
3,1102,29106,3575887120,3575887154,34
3,1102,29107,3575887120,3575887159,39
3,1102,29108,3575887120,3575887161,41
3,1102,29109,3575887120,3575887161,41
3,1102,29110,3575887120,3575887162,42
3,1102,29111,3575887120,3575887164,44
3,1102,29112,3575887120,3575887168,48
3,1102,29113,3575887120,3575887169,49
3,1102,29114,3575887120,3575887169,49
3,1103,29115,3575887184,3575887184,0
3,1103,29116,3575887184,3575887184,0
3,1103,29117,3575887184,3575887184,0
3,1103,29118,3575887184,3575887184,0
3,1103,29119,3575887184,3575887184,0
3,1103,29120,3575887184,3575887184,0
3,1103,29121,3575887184,3575887184,0
3,1103,29122,3575887184,3575887184,0
3,1103,29123,3575887184,3575887184,0
3,1103,29124,3575887184,3575887184,0
3,1103,29125,3575887184,3575887184,0
3,1103,29126,3575887184,3575887184,0
3,1103,29127,3575887184,3575887186,2
3,1103,29128,3575887184,3575887186,2
3,1103,29129,3575887184,3575887187,3
3,1103,29130,3575887184,3575887188,4
3,1103,29131,3575887184,3575887189,5
3,1103,29132,3575887184,3575887191,7
3,1103,29133,3575887184,3575887193,9
3,1103,29134,3575887184,3575887193,9
3,1103,29135,3575887184,3575887194,10
3,1103,29136,3575887184,3575887195,11
3,1103,29137,3575887184,3575887195,11
3,1103,29138,3575887184,3575887197,13
3,1103,29139,3575887184,3575887197,13
3,1103,29140,3575887184,3575887197,13
3,1103,29141,3575887184,3575887198,14
3,1103,29142,3575887184,3575887199,15
3,1103,29143,3575887184,3575887199,15
3,1103,29144,3575887184,3575887200,16
3,1103,29145,3575887184,3575887200,16
3,1103,29146,3575887184,3575887201,17
3,1103,29147,3575887184,3575887203,19
3,1103,29148,3575887184,3575887203,19
3,1103,29149,3575887184,3575887204,20
3,1103,29150,3575887184,3575887206,22
3,1103,29151,3575887184,3575887211,27
3,1103,29152,3575887184,3575887216,32
3,1103,29153,3575887184,3575887216,32
3,1103,29154,3575887184,3575887218,34
3,1103,29155,3575887184,3575887218,34
3,1103,29156,3575887184,3575887220,36
3,1103,29157,3575887184,3575887220,36
3,1103,29158,3575887184,3575887221,37
3,1103,29159,3575887184,3575887222,38
3,1103,29160,3575887184,3575887223,39
3,1103,29161,3575887184,3575887224,40
3,1103,29162,3575887184,3575887225,41
3,1103,29163,3575887184,3575887226,42
3,1103,29164,3575887184,3575887226,42
3,1103,29165,3575887184,3575887228,44
3,1103,29166,3575887184,3575887228,44
3,1103,29167,3575887184,3575887228,44
3,1103,29168,3575887184,3575887228,44
3,1103,29169,3575887184,3575887229,45
3,1103,29170,3575887184,3575887229,45
3,1103,29171,3575887184,3575887229,45
3,1103,29172,3575887184,3575887231,47
3,1103,29173,3575887184,3575887232,48
3,1103,29174,3575887184,3575887233,49
3,1104,29175,3575887248,3575887248,0
3,1104,29176,3575887248,3575887248,0
3,1104,29177,3575887248,3575887248,0
3,1104,29178,3575887248,3575887248,0
3,1104,29179,3575887248,3575887248,0
3,1104,29180,3575887248,3575887248,0
3,1104,29181,3575887248,3575887248,0
3,1104,29182,3575887248,3575887248,0
3,1104,29183,3575887248,3575887249,1
3,1104,29184,3575887248,3575887249,1
3,1104,29185,3575887248,3575887249,1
3,1104,29186,3575887248,3575887249,1
3,1104,29187,3575887248,3575887249,1
3,1104,29188,3575887248,3575887249,1
3,1104,29189,3575887248,3575887250,2
3,1104,29190,3575887248,3575887251,3
3,1104,29191,3575887248,3575887252,4
3,1104,29192,3575887248,3575887252,4
3,1104,29193,3575887248,3575887252,4
3,1104,29194,3575887248,3575887255,7
3,1104,29195,3575887248,3575887255,7
3,1104,29196,3575887248,3575887258,10
3,1104,29197,3575887248,3575887259,11
3,1104,29198,3575887248,3575887259,11
3,1104,29199,3575887248,3575887261,13
3,1104,29200,3575887248,3575887262,14
3,1104,29201,3575887248,3575887262,14
3,1104,29202,3575887248,3575887263,15
3,1104,29203,3575887248,3575887264,16
3,1104,29204,3575887248,3575887264,16
3,1104,29205,3575887248,3575887264,16
3,1104,29206,3575887248,3575887266,18
3,1104,29207,3575887248,3575887266,18
3,1104,29208,3575887248,3575887266,18
3,1104,29209,3575887248,3575887267,19
3,1104,29210,3575887248,3575887267,19
3,1104,29211,3575887248,3575887269,21
3,1104,29212,3575887248,3575887273,25
3,1104,29213,3575887248,3575887277,29
3,1104,29214,3575887248,3575887279,31
3,1104,29215,3575887248,3575887280,32
3,1104,29216,3575887248,3575887282,34
3,1104,29217,3575887248,3575887283,35
3,1104,29218,3575887248,3575887284,36
3,1104,29219,3575887248,3575887285,37
3,1104,29220,3575887248,3575887285,37
3,1104,29221,3575887248,3575887285,37
3,1104,29222,3575887248,3575887287,39
3,1104,29223,3575887248,3575887287,39
3,1104,29224,3575887248,3575887288,40
3,1104,29225,3575887248,3575887288,40
3,1104,29226,3575887248,3575887288,40
3,1104,29227,3575887248,3575887289,41
3,1104,29228,3575887248,3575887290,42
3,1104,29229,3575887248,3575887290,42
3,1104,29230,3575887248,3575887291,43
3,1104,29231,3575887248,3575887294,46
3,1104,29232,3575887248,3575887296,48
3,1105,29233,3575887310,3575887310,0
3,1105,29234,3575887310,3575887310,0
3,1105,29235,3575887310,3575887310,0
3,1105,29236,3575887310,3575887310,0
3,1105,29237,3575887310,3575887310,0
3,1105,29238,3575887310,3575887310,0
3,1105,29239,3575887310,3575887310,0
3,1105,29240,3575887310,3575887310,0
3,1105,29241,3575887310,3575887310,0
3,1105,29242,3575887310,3575887310,0
3,1105,29243,3575887310,3575887310,0
3,1105,29244,3575887310,3575887312,2
3,1105,29245,3575887310,3575887313,3
3,1105,29246,3575887310,3575887313,3
3,1105,29247,3575887310,3575887315,5
3,1105,29248,3575887310,3575887317,7
3,1105,29249,3575887310,3575887318,8
3,1105,29250,3575887310,3575887318,8
3,1105,29251,3575887310,3575887318,8
3,1105,29252,3575887310,3575887320,10
3,1105,29253,3575887310,3575887322,12
3,1105,29254,3575887310,3575887322,12
3,1105,29255,3575887310,3575887323,13
3,1105,29256,3575887310,3575887327,17
3,1105,29257,3575887310,3575887328,18
3,1105,29258,3575887310,3575887330,20
3,1105,29259,3575887310,3575887331,21
3,1105,29260,3575887310,3575887331,21
3,1105,29261,3575887310,3575887332,22
3,1105,29262,3575887310,3575887333,23
3,1105,29263,3575887310,3575887334,24
3,1105,29264,3575887310,3575887337,27
3,1105,29265,3575887310,3575887338,28
3,1105,29266,3575887310,3575887341,31
3,1105,29267,3575887310,3575887344,34
3,1105,29268,3575887310,3575887344,34
3,1105,29269,3575887310,3575887344,34
3,1105,29270,3575887310,3575887344,34
3,1105,29271,3575887310,3575887346,36
3,1105,29272,3575887310,3575887349,39
3,1105,29273,3575887310,3575887351,41
3,1105,29274,3575887310,3575887352,42
3,1105,29275,3575887310,3575887354,44
3,1105,29276,3575887310,3575887355,45
3,1105,29277,3575887310,3575887359,49
3,1106,29278,3575887374,3575887374,0
3,1106,29279,3575887374,3575887374,0
3,1106,29280,3575887374,3575887374,0
3,1106,29281,3575887374,3575887374,0
3,1106,29282,3575887374,3575887374,0
3,1106,29283,3575887374,3575887374,0
3,1106,29284,3575887374,3575887374,0
3,1106,29285,3575887374,3575887374,0
3,1106,29286,3575887374,3575887374,0
3,1106,29287,3575887374,3575887374,0
3,1106,29288,3575887374,3575887374,0
3,1106,29289,3575887374,3575887376,2
3,1106,29290,3575887374,3575887379,5
3,1106,29291,3575887374,3575887381,7
3,1106,29292,3575887374,3575887381,7
3,1106,29293,3575887374,3575887381,7
3,1106,29294,3575887374,3575887381,7
3,1106,29295,3575887374,3575887382,8
3,1106,29296,3575887374,3575887384,10
3,1106,29297,3575887374,3575887385,11
3,1106,29298,3575887374,3575887387,13
3,1106,29299,3575887374,3575887387,13
3,1106,29300,3575887374,3575887388,14
3,1106,29301,3575887374,3575887389,15
3,1106,29302,3575887374,3575887390,16
3,1106,29303,3575887374,3575887391,17
3,1106,29304,3575887374,3575887393,19
3,1106,29305,3575887374,3575887393,19
3,1106,29306,3575887374,3575887393,19
3,1106,29307,3575887374,3575887395,21
3,1106,29308,3575887374,3575887396,22
3,1106,29309,3575887374,3575887396,22
3,1106,29310,3575887374,3575887397,23
3,1106,29311,3575887374,3575887397,23
3,1106,29312,3575887374,3575887399,25
3,1106,29313,3575887374,3575887399,25
3,1106,29314,3575887374,3575887400,26
3,1106,29315,3575887374,3575887400,26
3,1106,29316,3575887374,3575887400,26
3,1106,29317,3575887374,3575887401,27
3,1106,29318,3575887374,3575887403,29
3,1106,29319,3575887374,3575887403,29
3,1106,29320,3575887374,3575887403,29
3,1106,29321,3575887374,3575887406,32
3,1106,29322,3575887374,3575887411,37
3,1106,29323,3575887374,3575887416,42
3,1106,29324,3575887374,3575887417,43
3,1106,29325,3575887374,3575887419,45
3,1106,29326,3575887374,3575887420,46
3,1106,29327,3575887374,3575887420,46
3,1106,29328,3575887374,3575887421,47
3,1106,29329,3575887374,3575887422,48
3,1106,29330,3575887374,3575887423,49
3,1107,29331,3575887437,3575887437,0
3,1107,29332,3575887437,3575887437,0
3,1107,29333,3575887437,3575887437,0
3,1107,29334,3575887437,3575887437,0
3,1107,29335,3575887437,3575887437,0
3,1107,29336,3575887437,3575887437,0
3,1107,29337,3575887437,3575887437,0
3,1107,29338,3575887437,3575887437,0
3,1107,29339,3575887437,3575887437,0
3,1107,29340,3575887437,3575887437,0
3,1107,29341,3575887437,3575887437,0
3,1107,29342,3575887437,3575887437,0
3,1107,29343,3575887437,3575887437,0
3,1107,29344,3575887437,3575887437,0
3,1107,29345,3575887437,3575887437,0
3,1107,29346,3575887437,3575887437,0
3,1107,29347,3575887437,3575887437,0
3,1107,29348,3575887437,3575887438,1
3,1107,29349,3575887437,3575887439,2
3,1107,29350,3575887437,3575887439,2
3,1107,29351,3575887437,3575887439,2
3,1107,29352,3575887437,3575887439,2
3,1107,29353,3575887437,3575887440,3
3,1107,29354,3575887437,3575887441,4
3,1107,29355,3575887437,3575887441,4
3,1107,29356,3575887437,3575887441,4
3,1107,29357,3575887437,3575887444,7
3,1107,29358,3575887437,3575887445,8
3,1107,29359,3575887437,3575887445,8
3,1107,29360,3575887437,3575887447,10
3,1107,29361,3575887437,3575887448,11
3,1107,29362,3575887437,3575887450,13
3,1107,29363,3575887437,3575887451,14
3,1107,29364,3575887437,3575887452,15
3,1107,29365,3575887437,3575887452,15
3,1107,29366,3575887437,3575887455,18
3,1107,29367,3575887437,3575887455,18
3,1107,29368,3575887437,3575887458,21
3,1107,29369,3575887437,3575887458,21
3,1107,29370,3575887437,3575887461,24
3,1107,29371,3575887437,3575887461,24
3,1107,29372,3575887437,3575887463,26
3,1107,29373,3575887437,3575887463,26
3,1107,29374,3575887437,3575887463,26
3,1107,29375,3575887437,3575887465,28
3,1107,29376,3575887437,3575887465,28
3,1107,29377,3575887437,3575887466,29
3,1107,29378,3575887437,3575887466,29
3,1107,29379,3575887437,3575887467,30
3,1107,29380,3575887437,3575887467,30
3,1107,29381,3575887437,3575887468,31
3,1107,29382,3575887437,3575887469,32
3,1107,29383,3575887437,3575887473,36
3,1107,29384,3575887437,3575887477,40
3,1107,29385,3575887437,3575887480,43
3,1107,29386,3575887437,3575887482,45
3,1107,29387,3575887437,3575887484,47
3,1107,29388,3575887437,3575887485,48
3,1107,29389,3575887437,3575887485,48
3,1107,29390,3575887437,3575887485,48
3,1107,29391,3575887437,3575887487,50
3,1108,29392,3575887503,3575887503,0
3,1108,29393,3575887503,3575887503,0
3,1108,29394,3575887503,3575887503,0
3,1108,29395,3575887503,3575887503,0
3,1108,29396,3575887503,3575887503,0
3,1108,29397,3575887503,3575887503,0
3,1108,29398,3575887503,3575887503,0
3,1108,29399,3575887503,3575887503,0
3,1108,29400,3575887503,3575887503,0
3,1108,29401,3575887503,3575887503,0
3,1108,29402,3575887503,3575887503,0
3,1108,29403,3575887503,3575887503,0
3,1108,29404,3575887503,3575887503,0
3,1108,29405,3575887503,3575887503,0
3,1108,29406,3575887503,3575887503,0
3,1108,29407,3575887503,3575887503,0
3,1108,29408,3575887503,3575887503,0
3,1108,29409,3575887503,3575887503,0
3,1108,29410,3575887503,3575887504,1
3,1108,29411,3575887503,3575887504,1
3,1108,29412,3575887503,3575887505,2
3,1108,29413,3575887503,3575887506,3
3,1108,29414,3575887503,3575887509,6
3,1108,29415,3575887503,3575887511,8
3,1108,29416,3575887503,3575887511,8
3,1108,29417,3575887503,3575887512,9
3,1108,29418,3575887503,3575887512,9
3,1108,29419,3575887503,3575887513,10
3,1108,29420,3575887503,3575887513,10
3,1108,29421,3575887503,3575887516,13
3,1108,29422,3575887503,3575887517,14
3,1108,29423,3575887503,3575887517,14
3,1108,29424,3575887503,3575887517,14
3,1108,29425,3575887503,3575887519,16
3,1108,29426,3575887503,3575887521,18
3,1108,29427,3575887503,3575887521,18
3,1108,29428,3575887503,3575887521,18
3,1108,29429,3575887503,3575887524,21
3,1108,29430,3575887503,3575887526,23
3,1108,29431,3575887503,3575887526,23
3,1108,29432,3575887503,3575887529,26
3,1108,29433,3575887503,3575887530,27
3,1108,29434,3575887503,3575887530,27
3,1108,29435,3575887503,3575887532,29
3,1108,29436,3575887503,3575887533,30
3,1108,29437,3575887503,3575887533,30
3,1108,29438,3575887503,3575887533,30
3,1108,29439,3575887503,3575887536,33
3,1108,29440,3575887503,3575887537,34
3,1108,29441,3575887503,3575887541,38
3,1108,29442,3575887503,3575887542,39
3,1108,29443,3575887503,3575887543,40
3,1108,29444,3575887503,3575887543,40
3,1108,29445,3575887503,3575887543,40
3,1108,29446,3575887503,3575887546,43
3,1108,29447,3575887503,3575887550,47
3,1108,29448,3575887503,3575887551,48
3,1108,29449,3575887503,3575887553,50
3,1109,29450,3575887566,3575887566,0
3,1109,29451,3575887566,3575887566,0
3,1109,29452,3575887566,3575887566,0
3,1109,29453,3575887566,3575887566,0
3,1109,29454,3575887566,3575887566,0
3,1109,29455,3575887566,3575887566,0
3,1109,29456,3575887566,3575887567,1
3,1109,29457,3575887566,3575887568,2
3,1109,29458,3575887566,3575887570,4
3,1109,29459,3575887566,3575887570,4
3,1109,29460,3575887566,3575887570,4
3,1109,29461,3575887566,3575887571,5
3,1109,29462,3575887566,3575887573,7
3,1109,29463,3575887566,3575887576,10
3,1109,29464,3575887566,3575887578,12
3,1109,29465,3575887566,3575887579,13
3,1109,29466,3575887566,3575887580,14
3,1109,29467,3575887566,3575887580,14
3,1109,29468,3575887566,3575887580,14
3,1109,29469,3575887566,3575887581,15
3,1109,29470,3575887566,3575887581,15
3,1109,29471,3575887566,3575887583,17
3,1109,29472,3575887566,3575887585,19
3,1109,29473,3575887566,3575887586,20
3,1109,29474,3575887566,3575887586,20
3,1109,29475,3575887566,3575887587,21
3,1109,29476,3575887566,3575887588,22
3,1109,29477,3575887566,3575887589,23
3,1109,29478,3575887566,3575887590,24
3,1109,29479,3575887566,3575887590,24
3,1109,29480,3575887566,3575887592,26
3,1109,29481,3575887566,3575887592,26
3,1109,29482,3575887566,3575887593,27
3,1109,29483,3575887566,3575887595,29
3,1109,29484,3575887566,3575887595,29
3,1109,29485,3575887566,3575887595,29
3,1109,29486,3575887566,3575887596,30
3,1109,29487,3575887566,3575887596,30
3,1109,29488,3575887566,3575887599,33
3,1109,29489,3575887566,3575887599,33
3,1109,29490,3575887566,3575887599,33
3,1109,29491,3575887566,3575887599,33
3,1109,29492,3575887566,3575887600,34
3,1109,29493,3575887566,3575887601,35
3,1109,29494,3575887566,3575887601,35
3,1109,29495,3575887566,3575887602,36
3,1109,29496,3575887566,3575887602,36
3,1109,29497,3575887566,3575887605,39
3,1109,29498,3575887566,3575887611,45
3,1109,29499,3575887566,3575887615,49
3,1110,29500,3575887631,3575887631,0
3,1110,29501,3575887631,3575887631,0
3,1110,29502,3575887631,3575887631,0
3,1110,29503,3575887631,3575887631,0
3,1110,29504,3575887631,3575887631,0
3,1110,29505,3575887631,3575887631,0
3,1110,29506,3575887631,3575887631,0
3,1110,29507,3575887631,3575887631,0
3,1110,29508,3575887631,3575887631,0
3,1110,29509,3575887631,3575887631,0
3,1110,29510,3575887631,3575887631,0
3,1110,29511,3575887631,3575887631,0
3,1110,29512,3575887631,3575887631,0
3,1110,29513,3575887631,3575887631,0
3,1110,29514,3575887631,3575887631,0
3,1110,29515,3575887631,3575887631,0
3,1110,29516,3575887631,3575887631,0
3,1110,29517,3575887631,3575887631,0
3,1110,29518,3575887631,3575887631,0
3,1110,29519,3575887631,3575887632,1
3,1110,29520,3575887631,3575887633,2
3,1110,29521,3575887631,3575887637,6
3,1110,29522,3575887631,3575887638,7
3,1110,29523,3575887631,3575887638,7
3,1110,29524,3575887631,3575887639,8
3,1110,29525,3575887631,3575887639,8
3,1110,29526,3575887631,3575887639,8
3,1110,29527,3575887631,3575887639,8
3,1110,29528,3575887631,3575887640,9
3,1110,29529,3575887631,3575887640,9
3,1110,29530,3575887631,3575887644,13
3,1110,29531,3575887631,3575887644,13
3,1110,29532,3575887631,3575887645,14
3,1110,29533,3575887631,3575887646,15
3,1110,29534,3575887631,3575887646,15
3,1110,29535,3575887631,3575887647,16
3,1110,29536,3575887631,3575887649,18
3,1110,29537,3575887631,3575887651,20
3,1110,29538,3575887631,3575887651,20
3,1110,29539,3575887631,3575887651,20
3,1110,29540,3575887631,3575887652,21
3,1110,29541,3575887631,3575887653,22
3,1110,29542,3575887631,3575887654,23
3,1110,29543,3575887631,3575887657,26
3,1110,29544,3575887631,3575887657,26
3,1110,29545,3575887631,3575887660,29
3,1110,29546,3575887631,3575887662,31
3,1110,29547,3575887631,3575887662,31
3,1110,29548,3575887631,3575887662,31
3,1110,29549,3575887631,3575887663,32
3,1110,29550,3575887631,3575887663,32
3,1110,29551,3575887631,3575887664,33
3,1110,29552,3575887631,3575887664,33
3,1110,29553,3575887631,3575887665,34
3,1110,29554,3575887631,3575887666,35
3,1110,29555,3575887631,3575887667,36
3,1110,29556,3575887631,3575887669,38
3,1110,29557,3575887631,3575887673,42
3,1110,29558,3575887631,3575887676,45
3,1110,29559,3575887631,3575887679,48
3,1110,29560,3575887631,3575887680,49
3,1111,29561,3575887696,3575887696,0
3,1111,29562,3575887696,3575887696,0
3,1111,29563,3575887696,3575887696,0
3,1111,29564,3575887696,3575887696,0
3,1111,29565,3575887696,3575887696,0
3,1111,29566,3575887696,3575887696,0
3,1111,29567,3575887696,3575887696,0
3,1111,29568,3575887696,3575887696,0
3,1111,29569,3575887696,3575887696,0
3,1111,29570,3575887696,3575887696,0
3,1111,29571,3575887696,3575887696,0
3,1111,29572,3575887696,3575887696,0
3,1111,29573,3575887696,3575887696,0
3,1111,29574,3575887696,3575887696,0
3,1111,29575,3575887696,3575887696,0
3,1111,29576,3575887696,3575887697,1
3,1111,29577,3575887696,3575887700,4
3,1111,29578,3575887696,3575887700,4
3,1111,29579,3575887696,3575887700,4
3,1111,29580,3575887696,3575887701,5
3,1111,29581,3575887696,3575887701,5
3,1111,29582,3575887696,3575887701,5
3,1111,29583,3575887696,3575887701,5
3,1111,29584,3575887696,3575887704,8
3,1111,29585,3575887696,3575887704,8
3,1111,29586,3575887696,3575887706,10
3,1111,29587,3575887696,3575887706,10
3,1111,29588,3575887696,3575887709,13
3,1111,29589,3575887696,3575887710,14
3,1111,29590,3575887696,3575887711,15
3,1111,29591,3575887696,3575887711,15
3,1111,29592,3575887696,3575887712,16
3,1111,29593,3575887696,3575887713,17
3,1111,29594,3575887696,3575887714,18
3,1111,29595,3575887696,3575887716,20
3,1111,29596,3575887696,3575887716,20
3,1111,29597,3575887696,3575887717,21
3,1111,29598,3575887696,3575887717,21
3,1111,29599,3575887696,3575887721,25
3,1111,29600,3575887696,3575887721,25
3,1111,29601,3575887696,3575887722,26
3,1111,29602,3575887696,3575887726,30
3,1111,29603,3575887696,3575887727,31
3,1111,29604,3575887696,3575887728,32
3,1111,29605,3575887696,3575887730,34
3,1111,29606,3575887696,3575887732,36
3,1111,29607,3575887696,3575887733,37
3,1111,29608,3575887696,3575887733,37
3,1111,29609,3575887696,3575887734,38
3,1111,29610,3575887696,3575887736,40
3,1111,29611,3575887696,3575887737,41
3,1111,29612,3575887696,3575887740,44
3,1111,29613,3575887696,3575887743,47
3,1111,29614,3575887696,3575887743,47
3,1112,29615,3575887760,3575887760,0
3,1112,29616,3575887760,3575887760,0
3,1112,29617,3575887760,3575887761,1
3,1112,29618,3575887760,3575887761,1
3,1112,29619,3575887760,3575887761,1
3,1112,29620,3575887760,3575887761,1
3,1112,29621,3575887760,3575887761,1
3,1112,29622,3575887760,3575887761,1
3,1112,29623,3575887760,3575887761,1
3,1112,29624,3575887760,3575887763,3
3,1112,29625,3575887760,3575887764,4
3,1112,29626,3575887760,3575887767,7
3,1112,29627,3575887760,3575887769,9
3,1112,29628,3575887760,3575887770,10
3,1112,29629,3575887760,3575887770,10
3,1112,29630,3575887760,3575887771,11
3,1112,29631,3575887760,3575887771,11
3,1112,29632,3575887760,3575887778,18
3,1112,29633,3575887760,3575887779,19
3,1112,29634,3575887760,3575887779,19
3,1112,29635,3575887760,3575887780,20
3,1112,29636,3575887760,3575887780,20
3,1112,29637,3575887760,3575887781,21
3,1112,29638,3575887760,3575887781,21
3,1112,29639,3575887760,3575887786,26
3,1112,29640,3575887760,3575887786,26
3,1112,29641,3575887760,3575887786,26
3,1112,29642,3575887760,3575887787,27
3,1112,29643,3575887760,3575887788,28
3,1112,29644,3575887760,3575887788,28
3,1112,29645,3575887760,3575887791,31
3,1112,29646,3575887760,3575887791,31
3,1112,29647,3575887760,3575887792,32
3,1112,29648,3575887760,3575887792,32
3,1112,29649,3575887760,3575887793,33
3,1112,29650,3575887760,3575887795,35
3,1112,29651,3575887760,3575887795,35
3,1112,29652,3575887760,3575887796,36
3,1112,29653,3575887760,3575887796,36
3,1112,29654,3575887760,3575887796,36
3,1112,29655,3575887760,3575887799,39
3,1112,29656,3575887760,3575887799,39
3,1112,29657,3575887760,3575887799,39
3,1112,29658,3575887760,3575887799,39
3,1112,29659,3575887760,3575887800,40
3,1112,29660,3575887760,3575887801,41
3,1112,29661,3575887760,3575887803,43
3,1112,29662,3575887760,3575887803,43
3,1112,29663,3575887760,3575887803,43
3,1112,29664,3575887760,3575887805,45
3,1112,29665,3575887760,3575887810,50
3,1113,29666,3575887825,3575887825,0
3,1113,29667,3575887825,3575887825,0
3,1113,29668,3575887825,3575887825,0
3,1113,29669,3575887825,3575887825,0
3,1113,29670,3575887825,3575887825,0
3,1113,29671,3575887825,3575887825,0
3,1113,29672,3575887825,3575887825,0
3,1113,29673,3575887825,3575887825,0
3,1113,29674,3575887825,3575887825,0
3,1113,29675,3575887825,3575887825,0
3,1113,29676,3575887825,3575887826,1
3,1113,29677,3575887825,3575887826,1
3,1113,29678,3575887825,3575887827,2
3,1113,29679,3575887825,3575887827,2
3,1113,29680,3575887825,3575887828,3
3,1113,29681,3575887825,3575887828,3
3,1113,29682,3575887825,3575887829,4
3,1113,29683,3575887825,3575887830,5
3,1113,29684,3575887825,3575887830,5
3,1113,29685,3575887825,3575887831,6
3,1113,29686,3575887825,3575887832,7
3,1113,29687,3575887825,3575887834,9
3,1113,29688,3575887825,3575887837,12
3,1113,29689,3575887825,3575887838,13
3,1113,29690,3575887825,3575887838,13
3,1113,29691,3575887825,3575887838,13
3,1113,29692,3575887825,3575887839,14
3,1113,29693,3575887825,3575887840,15
3,1113,29694,3575887825,3575887840,15
3,1113,29695,3575887825,3575887841,16
3,1113,29696,3575887825,3575887843,18
3,1113,29697,3575887825,3575887844,19
3,1113,29698,3575887825,3575887844,19
3,1113,29699,3575887825,3575887846,21
3,1113,29700,3575887825,3575887846,21
3,1113,29701,3575887825,3575887847,22
3,1113,29702,3575887825,3575887847,22
3,1113,29703,3575887825,3575887849,24
3,1113,29704,3575887825,3575887851,26
3,1113,29705,3575887825,3575887851,26
3,1113,29706,3575887825,3575887852,27
3,1113,29707,3575887825,3575887852,27
3,1113,29708,3575887825,3575887857,32
3,1113,29709,3575887825,3575887858,33
3,1113,29710,3575887825,3575887860,35
3,1113,29711,3575887825,3575887861,36
3,1113,29712,3575887825,3575887861,36
3,1113,29713,3575887825,3575887861,36
3,1113,29714,3575887825,3575887862,37
3,1113,29715,3575887825,3575887862,37
3,1113,29716,3575887825,3575887864,39
3,1113,29717,3575887825,3575887864,39
3,1113,29718,3575887825,3575887866,41
3,1113,29719,3575887825,3575887867,42
3,1113,29720,3575887825,3575887869,44
3,1113,29721,3575887825,3575887873,48
3,1114,29722,3575887888,3575887888,0
3,1114,29723,3575887888,3575887888,0
3,1114,29724,3575887888,3575887888,0
3,1114,29725,3575887888,3575887888,0
3,1114,29726,3575887888,3575887888,0
3,1114,29727,3575887888,3575887888,0
3,1114,29728,3575887888,3575887888,0
3,1114,29729,3575887888,3575887888,0
3,1114,29730,3575887888,3575887888,0
3,1114,29731,3575887888,3575887888,0
3,1114,29732,3575887888,3575887888,0
3,1114,29733,3575887888,3575887890,2
3,1114,29734,3575887888,3575887891,3
3,1114,29735,3575887888,3575887891,3
3,1114,29736,3575887888,3575887894,6
3,1114,29737,3575887888,3575887895,7
3,1114,29738,3575887888,3575887896,8
3,1114,29739,3575887888,3575887897,9
3,1114,29740,3575887888,3575887900,12
3,1114,29741,3575887888,3575887900,12
3,1114,29742,3575887888,3575887901,13
3,1114,29743,3575887888,3575887901,13
3,1114,29744,3575887888,3575887901,13
3,1114,29745,3575887888,3575887901,13
3,1114,29746,3575887888,3575887901,13
3,1114,29747,3575887888,3575887904,16
3,1114,29748,3575887888,3575887905,17
3,1114,29749,3575887888,3575887906,18
3,1114,29750,3575887888,3575887907,19
3,1114,29751,3575887888,3575887908,20
3,1114,29752,3575887888,3575887911,23
3,1114,29753,3575887888,3575887911,23
3,1114,29754,3575887888,3575887912,24
3,1114,29755,3575887888,3575887912,24
3,1114,29756,3575887888,3575887913,25
3,1114,29757,3575887888,3575887913,25
3,1114,29758,3575887888,3575887916,28
3,1114,29759,3575887888,3575887916,28
3,1114,29760,3575887888,3575887917,29
3,1114,29761,3575887888,3575887918,30
3,1114,29762,3575887888,3575887920,32
3,1114,29763,3575887888,3575887921,33
3,1114,29764,3575887888,3575887922,34
3,1114,29765,3575887888,3575887922,34
3,1114,29766,3575887888,3575887926,38
3,1114,29767,3575887888,3575887927,39
3,1114,29768,3575887888,3575887929,41
3,1114,29769,3575887888,3575887930,42
3,1114,29770,3575887888,3575887930,42
3,1114,29771,3575887888,3575887933,45
3,1114,29772,3575887888,3575887933,45
3,1114,29773,3575887888,3575887933,45
3,1114,29774,3575887888,3575887933,45
3,1114,29775,3575887888,3575887937,49
3,1115,29776,3575887952,3575887952,0
3,1115,29777,3575887952,3575887952,0
3,1115,29778,3575887952,3575887952,0
3,1115,29779,3575887952,3575887952,0
3,1115,29780,3575887952,3575887952,0
3,1115,29781,3575887952,3575887952,0
3,1115,29782,3575887952,3575887952,0
3,1115,29783,3575887952,3575887952,0
3,1115,29784,3575887952,3575887954,2
3,1115,29785,3575887952,3575887954,2
3,1115,29786,3575887952,3575887959,7
3,1115,29787,3575887952,3575887960,8
3,1115,29788,3575887952,3575887961,9
3,1115,29789,3575887952,3575887964,12
3,1115,29790,3575887952,3575887965,13
3,1115,29791,3575887952,3575887968,16
3,1115,29792,3575887952,3575887970,18
3,1115,29793,3575887952,3575887970,18
3,1115,29794,3575887952,3575887970,18
3,1115,29795,3575887952,3575887971,19
3,1115,29796,3575887952,3575887972,20
3,1115,29797,3575887952,3575887973,21
3,1115,29798,3575887952,3575887976,24
3,1115,29799,3575887952,3575887978,26
3,1115,29800,3575887952,3575887979,27
3,1115,29801,3575887952,3575887979,27
3,1115,29802,3575887952,3575887980,28
3,1115,29803,3575887952,3575887981,29
3,1115,29804,3575887952,3575887981,29
3,1115,29805,3575887952,3575887982,30
3,1115,29806,3575887952,3575887984,32
3,1115,29807,3575887952,3575887986,34
3,1115,29808,3575887952,3575887986,34
3,1115,29809,3575887952,3575887986,34
3,1115,29810,3575887952,3575887988,36
3,1115,29811,3575887952,3575887988,36
3,1115,29812,3575887952,3575887991,39
3,1115,29813,3575887952,3575887992,40
3,1115,29814,3575887952,3575887992,40
3,1115,29815,3575887952,3575887993,41
3,1115,29816,3575887952,3575887995,43
3,1115,29817,3575887952,3575887995,43
3,1115,29818,3575887952,3575887996,44
3,1115,29819,3575887952,3575887996,44
3,1115,29820,3575887952,3575887996,44
3,1115,29821,3575887952,3575887997,45
3,1115,29822,3575887952,3575887999,47
3,1115,29823,3575887952,3575887999,47
3,1115,29824,3575887952,3575887999,47
3,1115,29825,3575887952,3575887999,47
3,1115,29826,3575887952,3575888000,48
3,1115,29827,3575887952,3575888001,49
3,1116,29828,3575888015,3575888015,0
3,1116,29829,3575888015,3575888015,0
3,1116,29830,3575888015,3575888015,0
3,1116,29831,3575888015,3575888015,0
3,1116,29832,3575888015,3575888015,0
3,1116,29833,3575888015,3575888015,0
3,1116,29834,3575888015,3575888016,1
3,1116,29835,3575888015,3575888017,2
3,1116,29836,3575888015,3575888018,3
3,1116,29837,3575888015,3575888019,4
3,1116,29838,3575888015,3575888021,6
3,1116,29839,3575888015,3575888021,6
3,1116,29840,3575888015,3575888021,6
3,1116,29841,3575888015,3575888022,7
3,1116,29842,3575888015,3575888025,10
3,1116,29843,3575888015,3575888026,11
3,1116,29844,3575888015,3575888026,11
3,1116,29845,3575888015,3575888027,12
3,1116,29846,3575888015,3575888027,12
3,1116,29847,3575888015,3575888028,13
3,1116,29848,3575888015,3575888028,13
3,1116,29849,3575888015,3575888029,14
3,1116,29850,3575888015,3575888030,15
3,1116,29851,3575888015,3575888030,15
3,1116,29852,3575888015,3575888032,17
3,1116,29853,3575888015,3575888032,17
3,1116,29854,3575888015,3575888032,17
3,1116,29855,3575888015,3575888034,19
3,1116,29856,3575888015,3575888037,22
3,1116,29857,3575888015,3575888038,23
3,1116,29858,3575888015,3575888038,23
3,1116,29859,3575888015,3575888038,23
3,1116,29860,3575888015,3575888039,24
3,1116,29861,3575888015,3575888039,24
3,1116,29862,3575888015,3575888040,25
3,1116,29863,3575888015,3575888040,25
3,1116,29864,3575888015,3575888041,26
3,1116,29865,3575888015,3575888043,28
3,1116,29866,3575888015,3575888044,29
3,1116,29867,3575888015,3575888044,29
3,1116,29868,3575888015,3575888046,31
3,1116,29869,3575888015,3575888046,31
3,1116,29870,3575888015,3575888049,34
3,1116,29871,3575888015,3575888051,36
3,1116,29872,3575888015,3575888052,37
3,1116,29873,3575888015,3575888052,37
3,1116,29874,3575888015,3575888053,38
3,1116,29875,3575888015,3575888054,39
3,1116,29876,3575888015,3575888057,42
3,1116,29877,3575888015,3575888057,42
3,1116,29878,3575888015,3575888061,46
3,1116,29879,3575888015,3575888062,47
3,1116,29880,3575888015,3575888062,47
3,1116,29881,3575888015,3575888063,48
3,1117,29882,3575888081,3575888081,0
3,1117,29883,3575888081,3575888081,0
3,1117,29884,3575888081,3575888081,0
3,1117,29885,3575888081,3575888081,0
3,1117,29886,3575888081,3575888081,0
3,1117,29887,3575888081,3575888081,0
3,1117,29888,3575888081,3575888081,0
3,1117,29889,3575888081,3575888081,0
3,1117,29890,3575888081,3575888082,1
3,1117,29891,3575888081,3575888083,2
3,1117,29892,3575888081,3575888084,3
3,1117,29893,3575888081,3575888085,4
3,1117,29894,3575888081,3575888085,4
3,1117,29895,3575888081,3575888086,5
3,1117,29896,3575888081,3575888087,6
3,1117,29897,3575888081,3575888087,6
3,1117,29898,3575888081,3575888088,7
3,1117,29899,3575888081,3575888089,8
3,1117,29900,3575888081,3575888090,9
3,1117,29901,3575888081,3575888090,9
3,1117,29902,3575888081,3575888090,9
3,1117,29903,3575888081,3575888091,10
3,1117,29904,3575888081,3575888091,10
3,1117,29905,3575888081,3575888095,14
3,1117,29906,3575888081,3575888096,15
3,1117,29907,3575888081,3575888096,15
3,1117,29908,3575888081,3575888097,16
3,1117,29909,3575888081,3575888100,19
3,1117,29910,3575888081,3575888101,20
3,1117,29911,3575888081,3575888101,20
3,1117,29912,3575888081,3575888101,20
3,1117,29913,3575888081,3575888102,21
3,1117,29914,3575888081,3575888102,21
3,1117,29915,3575888081,3575888104,23
3,1117,29916,3575888081,3575888105,24
3,1117,29917,3575888081,3575888105,24
3,1117,29918,3575888081,3575888107,26
3,1117,29919,3575888081,3575888109,28
3,1117,29920,3575888081,3575888111,30
3,1117,29921,3575888081,3575888112,31
3,1117,29922,3575888081,3575888112,31
3,1117,29923,3575888081,3575888113,32
3,1117,29924,3575888081,3575888113,32
3,1117,29925,3575888081,3575888113,32
3,1117,29926,3575888081,3575888116,35
3,1117,29927,3575888081,3575888117,36
3,1117,29928,3575888081,3575888118,37
3,1117,29929,3575888081,3575888118,37
3,1117,29930,3575888081,3575888120,39
3,1117,29931,3575888081,3575888121,40
3,1117,29932,3575888081,3575888122,41
3,1117,29933,3575888081,3575888127,46
3,1117,29934,3575888081,3575888127,46
3,1117,29935,3575888081,3575888129,48
3,1117,29936,3575888081,3575888130,49
3,1118,29937,3575888143,3575888143,0
3,1118,29938,3575888143,3575888143,0
3,1118,29939,3575888143,3575888143,0
3,1118,29940,3575888143,3575888143,0
3,1118,29941,3575888143,3575888143,0
3,1118,29942,3575888143,3575888143,0
3,1118,29943,3575888143,3575888143,0
3,1118,29944,3575888143,3575888143,0
3,1118,29945,3575888143,3575888143,0
3,1118,29946,3575888143,3575888143,0
3,1118,29947,3575888143,3575888146,3
3,1118,29948,3575888143,3575888149,6
3,1118,29949,3575888143,3575888151,8
3,1118,29950,3575888143,3575888151,8
3,1118,29951,3575888143,3575888154,11
3,1118,29952,3575888143,3575888154,11
3,1118,29953,3575888143,3575888160,17
3,1118,29954,3575888143,3575888161,18
3,1118,29955,3575888143,3575888161,18
3,1118,29956,3575888143,3575888163,20
3,1118,29957,3575888143,3575888164,21
3,1118,29958,3575888143,3575888168,25
3,1118,29959,3575888143,3575888170,27
3,1118,29960,3575888143,3575888170,27
3,1118,29961,3575888143,3575888170,27
3,1118,29962,3575888143,3575888171,28
3,1118,29963,3575888143,3575888172,29
3,1118,29964,3575888143,3575888176,33
3,1118,29965,3575888143,3575888178,35
3,1118,29966,3575888143,3575888180,37
3,1118,29967,3575888143,3575888181,38
3,1118,29968,3575888143,3575888181,38
3,1118,29969,3575888143,3575888182,39
3,1118,29970,3575888143,3575888182,39
3,1118,29971,3575888143,3575888184,41
3,1118,29972,3575888143,3575888185,42
3,1118,29973,3575888143,3575888187,44
3,1118,29974,3575888143,3575888187,44
3,1118,29975,3575888143,3575888189,46
3,1118,29976,3575888143,3575888191,48
3,1118,29977,3575888143,3575888191,48
3,1118,29978,3575888143,3575888192,49
3,1119,29979,3575888207,3575888207,0
3,1119,29980,3575888207,3575888207,0
3,1119,29981,3575888207,3575888207,0
3,1119,29982,3575888207,3575888207,0
3,1119,29983,3575888207,3575888207,0
3,1119,29984,3575888207,3575888207,0
3,1119,29985,3575888207,3575888207,0
3,1119,29986,3575888207,3575888207,0
3,1119,29987,3575888207,3575888207,0
3,1119,29988,3575888207,3575888207,0
3,1119,29989,3575888207,3575888207,0
3,1119,29990,3575888207,3575888207,0
3,1119,29991,3575888207,3575888207,0
3,1119,29992,3575888207,3575888207,0
3,1119,29993,3575888207,3575888207,0
3,1119,29994,3575888207,3575888207,0
3,1119,29995,3575888207,3575888211,4
3,1119,29996,3575888207,3575888215,8
3,1119,29997,3575888207,3575888216,9
3,1119,29998,3575888207,3575888217,10
3,1119,29999,3575888207,3575888218,11
3,1119,30000,3575888207,3575888220,13
3,1119,30001,3575888207,3575888222,15
3,1119,30002,3575888207,3575888222,15
3,1119,30003,3575888207,3575888223,16
3,1119,30004,3575888207,3575888224,17
3,1119,30005,3575888207,3575888225,18
3,1119,30006,3575888207,3575888226,19
3,1119,30007,3575888207,3575888227,20
3,1119,30008,3575888207,3575888227,20
3,1119,30009,3575888207,3575888227,20
3,1119,30010,3575888207,3575888228,21
3,1119,30011,3575888207,3575888228,21
3,1119,30012,3575888207,3575888229,22
3,1119,30013,3575888207,3575888229,22
3,1119,30014,3575888207,3575888230,23
3,1119,30015,3575888207,3575888231,24
3,1119,30016,3575888207,3575888232,25
3,1119,30017,3575888207,3575888232,25
3,1119,30018,3575888207,3575888234,27
3,1119,30019,3575888207,3575888237,30
3,1119,30020,3575888207,3575888238,31
3,1119,30021,3575888207,3575888238,31
3,1119,30022,3575888207,3575888238,31
3,1119,30023,3575888207,3575888239,32
3,1119,30024,3575888207,3575888239,32
3,1119,30025,3575888207,3575888240,33
3,1119,30026,3575888207,3575888240,33
3,1119,30027,3575888207,3575888241,34
3,1119,30028,3575888207,3575888241,34
3,1119,30029,3575888207,3575888243,36
3,1119,30030,3575888207,3575888244,37
3,1119,30031,3575888207,3575888244,37
3,1119,30032,3575888207,3575888246,39
3,1119,30033,3575888207,3575888246,39
3,1119,30034,3575888207,3575888249,42
3,1119,30035,3575888207,3575888250,43
3,1119,30036,3575888207,3575888252,45
3,1119,30037,3575888207,3575888252,45
3,1119,30038,3575888207,3575888254,47
3,1120,30039,3575888270,3575888270,0
3,1120,30040,3575888270,3575888270,0
3,1120,30041,3575888270,3575888270,0
3,1120,30042,3575888270,3575888270,0
3,1120,30043,3575888270,3575888270,0
3,1120,30044,3575888270,3575888270,0
3,1120,30045,3575888270,3575888270,0
3,1120,30046,3575888270,3575888270,0
3,1120,30047,3575888270,3575888270,0
3,1120,30048,3575888270,3575888270,0
3,1120,30049,3575888270,3575888270,0
3,1120,30050,3575888270,3575888270,0
3,1120,30051,3575888270,3575888270,0
3,1120,30052,3575888270,3575888275,5
3,1120,30053,3575888270,3575888276,6
3,1120,30054,3575888270,3575888280,10
3,1120,30055,3575888270,3575888280,10
3,1120,30056,3575888270,3575888282,12
3,1120,30057,3575888270,3575888284,14
3,1120,30058,3575888270,3575888285,15
3,1120,30059,3575888270,3575888286,16
3,1120,30060,3575888270,3575888286,16
3,1120,30061,3575888270,3575888287,17
3,1120,30062,3575888270,3575888288,18
3,1120,30063,3575888270,3575888288,18
3,1120,30064,3575888270,3575888289,19
3,1120,30065,3575888270,3575888289,19
3,1120,30066,3575888270,3575888290,20
3,1120,30067,3575888270,3575888290,20
3,1120,30068,3575888270,3575888291,21
3,1120,30069,3575888270,3575888291,21
3,1120,30070,3575888270,3575888295,25
3,1120,30071,3575888270,3575888295,25
3,1120,30072,3575888270,3575888297,27
3,1120,30073,3575888270,3575888297,27
3,1120,30074,3575888270,3575888300,30
3,1120,30075,3575888270,3575888301,31
3,1120,30076,3575888270,3575888301,31
3,1120,30077,3575888270,3575888301,31
3,1120,30078,3575888270,3575888302,32
3,1120,30079,3575888270,3575888302,32
3,1120,30080,3575888270,3575888302,32
3,1120,30081,3575888270,3575888305,35
3,1120,30082,3575888270,3575888305,35
3,1120,30083,3575888270,3575888306,36
3,1120,30084,3575888270,3575888311,41
3,1120,30085,3575888270,3575888312,42
3,1120,30086,3575888270,3575888312,42
3,1120,30087,3575888270,3575888313,43
3,1120,30088,3575888270,3575888313,43
3,1120,30089,3575888270,3575888314,44
3,1120,30090,3575888270,3575888317,47
3,1120,30091,3575888270,3575888318,48
3,1120,30092,3575888270,3575888319,49
3,1121,30093,3575888333,3575888333,0
3,1121,30094,3575888333,3575888333,0
3,1121,30095,3575888333,3575888333,0
3,1121,30096,3575888333,3575888333,0
3,1121,30097,3575888333,3575888333,0
3,1121,30098,3575888333,3575888333,0
3,1121,30099,3575888333,3575888333,0
3,1121,30100,3575888333,3575888333,0
3,1121,30101,3575888333,3575888333,0
3,1121,30102,3575888333,3575888333,0
3,1121,30103,3575888333,3575888334,1
3,1121,30104,3575888333,3575888334,1
3,1121,30105,3575888333,3575888338,5
3,1121,30106,3575888333,3575888338,5
3,1121,30107,3575888333,3575888342,9
3,1121,30108,3575888333,3575888343,10
3,1121,30109,3575888333,3575888343,10
3,1121,30110,3575888333,3575888343,10
3,1121,30111,3575888333,3575888343,10
3,1121,30112,3575888333,3575888346,13
3,1121,30113,3575888333,3575888348,15
3,1121,30114,3575888333,3575888351,18
3,1121,30115,3575888333,3575888352,19
3,1121,30116,3575888333,3575888354,21
3,1121,30117,3575888333,3575888359,26
3,1121,30118,3575888333,3575888361,28
3,1121,30119,3575888333,3575888363,30
3,1121,30120,3575888333,3575888365,32
3,1121,30121,3575888333,3575888368,35
3,1121,30122,3575888333,3575888370,37
3,1121,30123,3575888333,3575888371,38
3,1121,30124,3575888333,3575888371,38
3,1121,30125,3575888333,3575888372,39
3,1121,30126,3575888333,3575888376,43
3,1121,30127,3575888333,3575888379,46
3,1121,30128,3575888333,3575888381,48
3,1121,30129,3575888333,3575888381,48
3,1121,30130,3575888333,3575888382,49
3,1121,30131,3575888333,3575888382,49
3,1122,30132,3575888396,3575888396,0
3,1122,30133,3575888396,3575888396,0
3,1122,30134,3575888396,3575888396,0
3,1122,30135,3575888396,3575888396,0
3,1122,30136,3575888396,3575888396,0
3,1122,30137,3575888396,3575888397,1
3,1122,30138,3575888396,3575888397,1
3,1122,30139,3575888396,3575888397,1
3,1122,30140,3575888396,3575888397,1
3,1122,30141,3575888396,3575888397,1
3,1122,30142,3575888396,3575888397,1
3,1122,30143,3575888396,3575888397,1
3,1122,30144,3575888396,3575888397,1
3,1122,30145,3575888396,3575888397,1
3,1122,30146,3575888396,3575888397,1
3,1122,30147,3575888396,3575888398,2
3,1122,30148,3575888396,3575888399,3
3,1122,30149,3575888396,3575888399,3
3,1122,30150,3575888396,3575888400,4
3,1122,30151,3575888396,3575888400,4
3,1122,30152,3575888396,3575888403,7
3,1122,30153,3575888396,3575888404,8
3,1122,30154,3575888396,3575888404,8
3,1122,30155,3575888396,3575888406,10
3,1122,30156,3575888396,3575888415,19
3,1122,30157,3575888396,3575888416,20
3,1122,30158,3575888396,3575888417,21
3,1122,30159,3575888396,3575888418,22
3,1122,30160,3575888396,3575888419,23
3,1122,30161,3575888396,3575888421,25
3,1122,30162,3575888396,3575888421,25
3,1122,30163,3575888396,3575888422,26
3,1122,30164,3575888396,3575888423,27
3,1122,30165,3575888396,3575888425,29
3,1122,30166,3575888396,3575888426,30
3,1122,30167,3575888396,3575888426,30
3,1122,30168,3575888396,3575888427,31
3,1122,30169,3575888396,3575888427,31
3,1122,30170,3575888396,3575888428,32
3,1122,30171,3575888396,3575888429,33
3,1122,30172,3575888396,3575888429,33
3,1122,30173,3575888396,3575888429,33
3,1122,30174,3575888396,3575888429,33
3,1122,30175,3575888396,3575888430,34
3,1122,30176,3575888396,3575888432,36
3,1122,30177,3575888396,3575888432,36
3,1122,30178,3575888396,3575888434,38
3,1122,30179,3575888396,3575888434,38
3,1122,30180,3575888396,3575888437,41
3,1122,30181,3575888396,3575888438,42
3,1122,30182,3575888396,3575888438,42
3,1122,30183,3575888396,3575888438,42
3,1122,30184,3575888396,3575888439,43
3,1122,30185,3575888396,3575888440,44
3,1122,30186,3575888396,3575888440,44
3,1122,30187,3575888396,3575888441,45
3,1122,30188,3575888396,3575888441,45
3,1122,30189,3575888396,3575888441,45
3,1122,30190,3575888396,3575888443,47
3,1122,30191,3575888396,3575888444,48
3,1122,30192,3575888396,3575888445,49
3,1123,30193,3575888458,3575888458,0
3,1123,30194,3575888458,3575888458,0
3,1123,30195,3575888458,3575888458,0
3,1123,30196,3575888458,3575888458,0
3,1123,30197,3575888458,3575888458,0
3,1123,30198,3575888458,3575888458,0
3,1123,30199,3575888458,3575888458,0
3,1123,30200,3575888458,3575888458,0
3,1123,30201,3575888458,3575888458,0
3,1123,30202,3575888458,3575888460,2
3,1123,30203,3575888458,3575888462,4
3,1123,30204,3575888458,3575888463,5
3,1123,30205,3575888458,3575888464,6
3,1123,30206,3575888458,3575888464,6
3,1123,30207,3575888458,3575888465,7
3,1123,30208,3575888458,3575888465,7
3,1123,30209,3575888458,3575888466,8
3,1123,30210,3575888458,3575888466,8
3,1123,30211,3575888458,3575888467,9
3,1123,30212,3575888458,3575888468,10
3,1123,30213,3575888458,3575888468,10
3,1123,30214,3575888458,3575888469,11
3,1123,30215,3575888458,3575888476,18
3,1123,30216,3575888458,3575888477,19
3,1123,30217,3575888458,3575888480,22
3,1123,30218,3575888458,3575888481,23
3,1123,30219,3575888458,3575888481,23
3,1123,30220,3575888458,3575888484,26
3,1123,30221,3575888458,3575888484,26
3,1123,30222,3575888458,3575888485,27
3,1123,30223,3575888458,3575888486,28
3,1123,30224,3575888458,3575888486,28
3,1123,30225,3575888458,3575888487,29
3,1123,30226,3575888458,3575888488,30
3,1123,30227,3575888458,3575888488,30
3,1123,30228,3575888458,3575888488,30
3,1123,30229,3575888458,3575888488,30
3,1123,30230,3575888458,3575888489,31
3,1123,30231,3575888458,3575888490,32
3,1123,30232,3575888458,3575888490,32
3,1123,30233,3575888458,3575888491,33
3,1123,30234,3575888458,3575888491,33
3,1123,30235,3575888458,3575888495,37
3,1123,30236,3575888458,3575888495,37
3,1123,30237,3575888458,3575888497,39
3,1123,30238,3575888458,3575888501,43
3,1123,30239,3575888458,3575888501,43
3,1123,30240,3575888458,3575888501,43
3,1123,30241,3575888458,3575888502,44
3,1123,30242,3575888458,3575888502,44
3,1123,30243,3575888458,3575888503,45
3,1123,30244,3575888458,3575888505,47
3,1123,30245,3575888458,3575888505,47
3,1123,30246,3575888458,3575888506,48
3,1124,30247,3575888524,3575888524,0
3,1124,30248,3575888524,3575888524,0
3,1124,30249,3575888524,3575888524,0
3,1124,30250,3575888524,3575888524,0
3,1124,30251,3575888524,3575888524,0
3,1124,30252,3575888524,3575888524,0
3,1124,30253,3575888524,3575888524,0
3,1124,30254,3575888524,3575888524,0
3,1124,30255,3575888524,3575888524,0
3,1124,30256,3575888524,3575888524,0
3,1124,30257,3575888524,3575888524,0
3,1124,30258,3575888524,3575888524,0
3,1124,30259,3575888524,3575888524,0
3,1124,30260,3575888524,3575888526,2
3,1124,30261,3575888524,3575888527,3
3,1124,30262,3575888524,3575888528,4
3,1124,30263,3575888524,3575888530,6
3,1124,30264,3575888524,3575888531,7
3,1124,30265,3575888524,3575888532,8
3,1124,30266,3575888524,3575888532,8
3,1124,30267,3575888524,3575888532,8
3,1124,30268,3575888524,3575888533,9
3,1124,30269,3575888524,3575888537,13
3,1124,30270,3575888524,3575888537,13
3,1124,30271,3575888524,3575888541,17
3,1124,30272,3575888524,3575888541,17
3,1124,30273,3575888524,3575888542,18
3,1124,30274,3575888524,3575888542,18
3,1124,30275,3575888524,3575888543,19
3,1124,30276,3575888524,3575888545,21
3,1124,30277,3575888524,3575888549,25
3,1124,30278,3575888524,3575888551,27
3,1124,30279,3575888524,3575888553,29
3,1124,30280,3575888524,3575888553,29
3,1124,30281,3575888524,3575888558,34
3,1124,30282,3575888524,3575888560,36
3,1124,30283,3575888524,3575888561,37
3,1124,30284,3575888524,3575888563,39
3,1124,30285,3575888524,3575888564,40
3,1124,30286,3575888524,3575888568,44
3,1124,30287,3575888524,3575888569,45
3,1124,30288,3575888524,3575888570,46
3,1124,30289,3575888524,3575888570,46
3,1124,30290,3575888524,3575888570,46
3,1124,30291,3575888524,3575888570,46
3,1125,30292,3575888588,3575888588,0
3,1125,30293,3575888588,3575888588,0
3,1125,30294,3575888588,3575888588,0
3,1125,30295,3575888588,3575888588,0
3,1125,30296,3575888588,3575888588,0
3,1125,30297,3575888588,3575888588,0
3,1125,30298,3575888588,3575888588,0
3,1125,30299,3575888588,3575888588,0
3,1125,30300,3575888588,3575888588,0
3,1125,30301,3575888588,3575888588,0
3,1125,30302,3575888588,3575888588,0
3,1125,30303,3575888588,3575888588,0
3,1125,30304,3575888588,3575888590,2
3,1125,30305,3575888588,3575888591,3
3,1125,30306,3575888588,3575888592,4
3,1125,30307,3575888588,3575888592,4
3,1125,30308,3575888588,3575888593,5
3,1125,30309,3575888588,3575888595,7
3,1125,30310,3575888588,3575888595,7
3,1125,30311,3575888588,3575888596,8
3,1125,30312,3575888588,3575888596,8
3,1125,30313,3575888588,3575888596,8
3,1125,30314,3575888588,3575888597,9
3,1125,30315,3575888588,3575888598,10
3,1125,30316,3575888588,3575888599,11
3,1125,30317,3575888588,3575888599,11
3,1125,30318,3575888588,3575888599,11
3,1125,30319,3575888588,3575888599,11
3,1125,30320,3575888588,3575888602,14
3,1125,30321,3575888588,3575888602,14
3,1125,30322,3575888588,3575888603,15
3,1125,30323,3575888588,3575888605,17
3,1125,30324,3575888588,3575888610,22
3,1125,30325,3575888588,3575888614,26
3,1125,30326,3575888588,3575888616,28
3,1125,30327,3575888588,3575888617,29
3,1125,30328,3575888588,3575888618,30
3,1125,30329,3575888588,3575888619,31
3,1125,30330,3575888588,3575888619,31
3,1125,30331,3575888588,3575888620,32
3,1125,30332,3575888588,3575888621,33
3,1125,30333,3575888588,3575888623,35
3,1125,30334,3575888588,3575888623,35
3,1125,30335,3575888588,3575888624,36
3,1125,30336,3575888588,3575888625,37
3,1125,30337,3575888588,3575888626,38
3,1125,30338,3575888588,3575888627,39
3,1125,30339,3575888588,3575888627,39
3,1125,30340,3575888588,3575888628,40
3,1125,30341,3575888588,3575888629,41
3,1125,30342,3575888588,3575888629,41
3,1125,30343,3575888588,3575888630,42
3,1125,30344,3575888588,3575888632,44
3,1125,30345,3575888588,3575888633,45
3,1125,30346,3575888588,3575888636,48
3,1125,30347,3575888588,3575888637,49
3,1125,30348,3575888588,3575888637,49
3,1125,30349,3575888588,3575888638,50
3,1126,30350,3575888653,3575888653,0
3,1126,30351,3575888653,3575888653,0
3,1126,30352,3575888653,3575888653,0
3,1126,30353,3575888653,3575888653,0
3,1126,30354,3575888653,3575888653,0
3,1126,30355,3575888653,3575888653,0
3,1126,30356,3575888653,3575888653,0
3,1126,30357,3575888653,3575888653,0
3,1126,30358,3575888653,3575888653,0
3,1126,30359,3575888653,3575888653,0
3,1126,30360,3575888653,3575888653,0
3,1126,30361,3575888653,3575888653,0
3,1126,30362,3575888653,3575888653,0
3,1126,30363,3575888653,3575888653,0
3,1126,30364,3575888653,3575888653,0
3,1126,30365,3575888653,3575888653,0
3,1126,30366,3575888653,3575888654,1
3,1126,30367,3575888653,3575888656,3
3,1126,30368,3575888653,3575888656,3
3,1126,30369,3575888653,3575888659,6
3,1126,30370,3575888653,3575888660,7
3,1126,30371,3575888653,3575888661,8
3,1126,30372,3575888653,3575888662,9
3,1126,30373,3575888653,3575888663,10
3,1126,30374,3575888653,3575888663,10
3,1126,30375,3575888653,3575888664,11
3,1126,30376,3575888653,3575888665,12
3,1126,30377,3575888653,3575888665,12
3,1126,30378,3575888653,3575888665,12
3,1126,30379,3575888653,3575888666,13
3,1126,30380,3575888653,3575888667,14
3,1126,30381,3575888653,3575888668,15
3,1126,30382,3575888653,3575888669,16
3,1126,30383,3575888653,3575888676,23
3,1126,30384,3575888653,3575888677,24
3,1126,30385,3575888653,3575888680,27
3,1126,30386,3575888653,3575888681,28
3,1126,30387,3575888653,3575888682,29
3,1126,30388,3575888653,3575888684,31
3,1126,30389,3575888653,3575888685,32
3,1126,30390,3575888653,3575888686,33
3,1126,30391,3575888653,3575888687,34
3,1126,30392,3575888653,3575888688,35
3,1126,30393,3575888653,3575888689,36
3,1126,30394,3575888653,3575888689,36
3,1126,30395,3575888653,3575888689,36
3,1126,30396,3575888653,3575888690,37
3,1126,30397,3575888653,3575888690,37
3,1126,30398,3575888653,3575888695,42
3,1126,30399,3575888653,3575888696,43
3,1126,30400,3575888653,3575888701,48
3,1126,30401,3575888653,3575888701,48
3,1126,30402,3575888653,3575888701,48
3,1126,30403,3575888653,3575888701,48
3,1126,30404,3575888653,3575888702,49
3,1126,30405,3575888653,3575888702,49
3,1127,30406,3575888716,3575888716,0
3,1127,30407,3575888716,3575888716,0
3,1127,30408,3575888716,3575888716,0
3,1127,30409,3575888716,3575888716,0
3,1127,30410,3575888716,3575888716,0
3,1127,30411,3575888716,3575888716,0
3,1127,30412,3575888716,3575888716,0
3,1127,30413,3575888716,3575888716,0
3,1127,30414,3575888716,3575888717,1
3,1127,30415,3575888716,3575888718,2
3,1127,30416,3575888716,3575888720,4
3,1127,30417,3575888716,3575888721,5
3,1127,30418,3575888716,3575888722,6
3,1127,30419,3575888716,3575888727,11
3,1127,30420,3575888716,3575888727,11
3,1127,30421,3575888716,3575888727,11
3,1127,30422,3575888716,3575888730,14
3,1127,30423,3575888716,3575888732,16
3,1127,30424,3575888716,3575888732,16
3,1127,30425,3575888716,3575888732,16
3,1127,30426,3575888716,3575888733,17
3,1127,30427,3575888716,3575888734,18
3,1127,30428,3575888716,3575888737,21
3,1127,30429,3575888716,3575888737,21
3,1127,30430,3575888716,3575888741,25
3,1127,30431,3575888716,3575888742,26
3,1127,30432,3575888716,3575888743,27
3,1127,30433,3575888716,3575888744,28
3,1127,30434,3575888716,3575888745,29
3,1127,30435,3575888716,3575888748,32
3,1127,30436,3575888716,3575888749,33
3,1127,30437,3575888716,3575888751,35
3,1127,30438,3575888716,3575888754,38
3,1127,30439,3575888716,3575888758,42
3,1127,30440,3575888716,3575888760,44
3,1127,30441,3575888716,3575888761,45
3,1127,30442,3575888716,3575888762,46
3,1128,30443,3575888782,3575888782,0
3,1128,30444,3575888782,3575888782,0
3,1128,30445,3575888782,3575888782,0
3,1128,30446,3575888782,3575888782,0
3,1128,30447,3575888782,3575888782,0
3,1128,30448,3575888782,3575888782,0
3,1128,30449,3575888782,3575888782,0
3,1128,30450,3575888782,3575888782,0
3,1128,30451,3575888782,3575888782,0
3,1128,30452,3575888782,3575888782,0
3,1128,30453,3575888782,3575888782,0
3,1128,30454,3575888782,3575888782,0
3,1128,30455,3575888782,3575888782,0
3,1128,30456,3575888782,3575888782,0
3,1128,30457,3575888782,3575888783,1
3,1128,30458,3575888782,3575888785,3
3,1128,30459,3575888782,3575888785,3
3,1128,30460,3575888782,3575888786,4
3,1128,30461,3575888782,3575888786,4
3,1128,30462,3575888782,3575888791,9
3,1128,30463,3575888782,3575888792,10
3,1128,30464,3575888782,3575888792,10
3,1128,30465,3575888782,3575888793,11
3,1128,30466,3575888782,3575888795,13
3,1128,30467,3575888782,3575888795,13
3,1128,30468,3575888782,3575888795,13
3,1128,30469,3575888782,3575888796,14
3,1128,30470,3575888782,3575888796,14
3,1128,30471,3575888782,3575888797,15
3,1128,30472,3575888782,3575888798,16
3,1128,30473,3575888782,3575888798,16
3,1128,30474,3575888782,3575888798,16
3,1128,30475,3575888782,3575888799,17
3,1128,30476,3575888782,3575888799,17
3,1128,30477,3575888782,3575888802,20
3,1128,30478,3575888782,3575888803,21
3,1128,30479,3575888782,3575888803,21
3,1128,30480,3575888782,3575888803,21
3,1128,30481,3575888782,3575888805,23
3,1128,30482,3575888782,3575888811,29
3,1128,30483,3575888782,3575888815,33
3,1128,30484,3575888782,3575888816,34
3,1128,30485,3575888782,3575888816,34
3,1128,30486,3575888782,3575888818,36
3,1128,30487,3575888782,3575888819,37
3,1128,30488,3575888782,3575888820,38
3,1128,30489,3575888782,3575888821,39
3,1128,30490,3575888782,3575888821,39
3,1128,30491,3575888782,3575888823,41
3,1128,30492,3575888782,3575888824,42
3,1128,30493,3575888782,3575888825,43
3,1128,30494,3575888782,3575888826,44
3,1128,30495,3575888782,3575888826,44
3,1128,30496,3575888782,3575888826,44
3,1128,30497,3575888782,3575888827,45
3,1128,30498,3575888782,3575888828,46
3,1128,30499,3575888782,3575888829,47
3,1128,30500,3575888782,3575888830,48
3,1128,30501,3575888782,3575888830,48
3,1129,30502,3575888844,3575888844,0
3,1129,30503,3575888844,3575888844,0
3,1129,30504,3575888844,3575888844,0
3,1129,30505,3575888844,3575888844,0
3,1129,30506,3575888844,3575888844,0
3,1129,30507,3575888844,3575888844,0
3,1129,30508,3575888844,3575888844,0
3,1129,30509,3575888844,3575888844,0
3,1129,30510,3575888844,3575888844,0
3,1129,30511,3575888844,3575888844,0
3,1129,30512,3575888844,3575888844,0
3,1129,30513,3575888844,3575888844,0
3,1129,30514,3575888844,3575888844,0
3,1129,30515,3575888844,3575888844,0
3,1129,30516,3575888844,3575888844,0
3,1129,30517,3575888844,3575888844,0
3,1129,30518,3575888844,3575888845,1
3,1129,30519,3575888844,3575888849,5
3,1129,30520,3575888844,3575888850,6
3,1129,30521,3575888844,3575888851,7
3,1129,30522,3575888844,3575888851,7
3,1129,30523,3575888844,3575888852,8
3,1129,30524,3575888844,3575888854,10
3,1129,30525,3575888844,3575888856,12
3,1129,30526,3575888844,3575888857,13
3,1129,30527,3575888844,3575888859,15
3,1129,30528,3575888844,3575888860,16
3,1129,30529,3575888844,3575888861,17
3,1129,30530,3575888844,3575888862,18
3,1129,30531,3575888844,3575888863,19
3,1129,30532,3575888844,3575888865,21
3,1129,30533,3575888844,3575888865,21
3,1129,30534,3575888844,3575888865,21
3,1129,30535,3575888844,3575888865,21
3,1129,30536,3575888844,3575888866,22
3,1129,30537,3575888844,3575888867,23
3,1129,30538,3575888844,3575888868,24
3,1129,30539,3575888844,3575888869,25
3,1129,30540,3575888844,3575888876,32
3,1129,30541,3575888844,3575888877,33
3,1129,30542,3575888844,3575888880,36
3,1129,30543,3575888844,3575888882,38
3,1129,30544,3575888844,3575888884,40
3,1129,30545,3575888844,3575888885,41
3,1129,30546,3575888844,3575888885,41
3,1129,30547,3575888844,3575888885,41
3,1129,30548,3575888844,3575888887,43
3,1129,30549,3575888844,3575888888,44
3,1129,30550,3575888844,3575888888,44
3,1129,30551,3575888844,3575888889,45
3,1129,30552,3575888844,3575888889,45
3,1129,30553,3575888844,3575888890,46
3,1129,30554,3575888844,3575888890,46
3,1129,30555,3575888844,3575888890,46
3,1130,30556,3575888908,3575888908,0
3,1130,30557,3575888908,3575888908,0
3,1130,30558,3575888908,3575888908,0
3,1130,30559,3575888908,3575888908,0
3,1130,30560,3575888908,3575888908,0
3,1130,30561,3575888908,3575888908,0
3,1130,30562,3575888908,3575888908,0
3,1130,30563,3575888908,3575888908,0
3,1130,30564,3575888908,3575888908,0
3,1130,30565,3575888908,3575888908,0
3,1130,30566,3575888908,3575888908,0
3,1130,30567,3575888908,3575888908,0
3,1130,30568,3575888908,3575888911,3
3,1130,30569,3575888908,3575888911,3
3,1130,30570,3575888908,3575888912,4
3,1130,30571,3575888908,3575888912,4
3,1130,30572,3575888908,3575888913,5
3,1130,30573,3575888908,3575888914,6
3,1130,30574,3575888908,3575888916,8
3,1130,30575,3575888908,3575888917,9
3,1130,30576,3575888908,3575888920,12
3,1130,30577,3575888908,3575888921,13
3,1130,30578,3575888908,3575888921,13
3,1130,30579,3575888908,3575888922,14
3,1130,30580,3575888908,3575888927,19
3,1130,30581,3575888908,3575888928,20
3,1130,30582,3575888908,3575888928,20
3,1130,30583,3575888908,3575888929,21
3,1130,30584,3575888908,3575888932,24
3,1130,30585,3575888908,3575888932,24
3,1130,30586,3575888908,3575888933,25
3,1130,30587,3575888908,3575888933,25
3,1130,30588,3575888908,3575888933,25
3,1130,30589,3575888908,3575888937,29
3,1130,30590,3575888908,3575888937,29
3,1130,30591,3575888908,3575888941,33
3,1130,30592,3575888908,3575888942,34
3,1130,30593,3575888908,3575888943,35
3,1130,30594,3575888908,3575888944,36
3,1130,30595,3575888908,3575888945,37
3,1130,30596,3575888908,3575888948,40
3,1130,30597,3575888908,3575888951,43
3,1130,30598,3575888908,3575888951,43
3,1130,30599,3575888908,3575888954,46
3,1130,30600,3575888908,3575888958,50
3,1131,30601,3575888972,3575888972,0
3,1131,30602,3575888972,3575888972,0
3,1131,30603,3575888972,3575888972,0
3,1131,30604,3575888972,3575888972,0
3,1131,30605,3575888972,3575888972,0
3,1131,30606,3575888972,3575888972,0
3,1131,30607,3575888972,3575888972,0
3,1131,30608,3575888972,3575888972,0
3,1131,30609,3575888972,3575888972,0
3,1131,30610,3575888972,3575888973,1
3,1131,30611,3575888972,3575888976,4
3,1131,30612,3575888972,3575888979,7
3,1131,30613,3575888972,3575888980,8
3,1131,30614,3575888972,3575888981,9
3,1131,30615,3575888972,3575888981,9
3,1131,30616,3575888972,3575888981,9
3,1131,30617,3575888972,3575888982,10
3,1131,30618,3575888972,3575888983,11
3,1131,30619,3575888972,3575888985,13
3,1131,30620,3575888972,3575888985,13
3,1131,30621,3575888972,3575888986,14
3,1131,30622,3575888972,3575888987,15
3,1131,30623,3575888972,3575888990,18
3,1131,30624,3575888972,3575888991,19
3,1131,30625,3575888972,3575888991,19
3,1131,30626,3575888972,3575888992,20
3,1131,30627,3575888972,3575888993,21
3,1131,30628,3575888972,3575888995,23
3,1131,30629,3575888972,3575888995,23
3,1131,30630,3575888972,3575888996,24
3,1131,30631,3575888972,3575888996,24
3,1131,30632,3575888972,3575888996,24
3,1131,30633,3575888972,3575888997,25
3,1131,30634,3575888972,3575888998,26
3,1131,30635,3575888972,3575888998,26
3,1131,30636,3575888972,3575888999,27
3,1131,30637,3575888972,3575889003,31
3,1131,30638,3575888972,3575889003,31
3,1131,30639,3575888972,3575889003,31
3,1131,30640,3575888972,3575889003,31
3,1131,30641,3575888972,3575889006,34
3,1131,30642,3575888972,3575889011,39
3,1131,30643,3575888972,3575889015,43
3,1131,30644,3575888972,3575889016,44
3,1131,30645,3575888972,3575889017,45
3,1131,30646,3575888972,3575889018,46
3,1131,30647,3575888972,3575889020,48
3,1131,30648,3575888972,3575889020,48
3,1131,30649,3575888972,3575889022,50
3,1132,30650,3575889034,3575889034,0
3,1132,30651,3575889034,3575889034,0
3,1132,30652,3575889034,3575889034,0
3,1132,30653,3575889034,3575889034,0
3,1132,30654,3575889034,3575889034,0
3,1132,30655,3575889034,3575889034,0
3,1132,30656,3575889034,3575889034,0
3,1132,30657,3575889034,3575889034,0
3,1132,30658,3575889034,3575889034,0
3,1132,30659,3575889034,3575889034,0
3,1132,30660,3575889034,3575889034,0
3,1132,30661,3575889034,3575889034,0
3,1132,30662,3575889034,3575889034,0
3,1132,30663,3575889034,3575889034,0
3,1132,30664,3575889034,3575889034,0
3,1132,30665,3575889034,3575889034,0
3,1132,30666,3575889034,3575889037,3
3,1132,30667,3575889034,3575889037,3
3,1132,30668,3575889034,3575889038,4
3,1132,30669,3575889034,3575889038,4
3,1132,30670,3575889034,3575889039,5
3,1132,30671,3575889034,3575889039,5
3,1132,30672,3575889034,3575889039,5
3,1132,30673,3575889034,3575889041,7
3,1132,30674,3575889034,3575889041,7
3,1132,30675,3575889034,3575889043,9
3,1132,30676,3575889034,3575889044,10
3,1132,30677,3575889034,3575889045,11
3,1132,30678,3575889034,3575889049,15
3,1132,30679,3575889034,3575889050,16
3,1132,30680,3575889034,3575889052,18
3,1132,30681,3575889034,3575889052,18
3,1132,30682,3575889034,3575889052,18
3,1132,30683,3575889034,3575889053,19
3,1132,30684,3575889034,3575889058,24
3,1132,30685,3575889034,3575889058,24
3,1132,30686,3575889034,3575889059,25
3,1132,30687,3575889034,3575889060,26
3,1132,30688,3575889034,3575889061,27
3,1132,30689,3575889034,3575889063,29
3,1132,30690,3575889034,3575889064,30
3,1132,30691,3575889034,3575889065,31
3,1132,30692,3575889034,3575889065,31
3,1132,30693,3575889034,3575889066,32
3,1132,30694,3575889034,3575889066,32
3,1132,30695,3575889034,3575889067,33
3,1132,30696,3575889034,3575889070,36
3,1132,30697,3575889034,3575889070,36
3,1132,30698,3575889034,3575889076,42
3,1132,30699,3575889034,3575889077,43
3,1132,30700,3575889034,3575889080,46
3,1132,30701,3575889034,3575889081,47
3,1132,30702,3575889034,3575889082,48
3,1132,30703,3575889034,3575889084,50
3,1133,30704,3575889098,3575889098,0
3,1133,30705,3575889098,3575889098,0
3,1133,30706,3575889098,3575889098,0
3,1133,30707,3575889098,3575889098,0
3,1133,30708,3575889098,3575889098,0
3,1133,30709,3575889098,3575889098,0
3,1133,30710,3575889098,3575889098,0
3,1133,30711,3575889098,3575889098,0
3,1133,30712,3575889098,3575889098,0
3,1133,30713,3575889098,3575889098,0
3,1133,30714,3575889098,3575889098,0
3,1133,30715,3575889098,3575889098,0
3,1133,30716,3575889098,3575889098,0
3,1133,30717,3575889098,3575889098,0
3,1133,30718,3575889098,3575889101,3
3,1133,30719,3575889098,3575889102,4
3,1133,30720,3575889098,3575889102,4
3,1133,30721,3575889098,3575889102,4
3,1133,30722,3575889098,3575889103,5
3,1133,30723,3575889098,3575889107,9
3,1133,30724,3575889098,3575889108,10
3,1133,30725,3575889098,3575889111,13
3,1133,30726,3575889098,3575889112,14
3,1133,30727,3575889098,3575889112,14
3,1133,30728,3575889098,3575889113,15
3,1133,30729,3575889098,3575889113,15
3,1133,30730,3575889098,3575889114,16
3,1133,30731,3575889098,3575889117,19
3,1133,30732,3575889098,3575889121,23
3,1133,30733,3575889098,3575889121,23
3,1133,30734,3575889098,3575889121,23
3,1133,30735,3575889098,3575889122,24
3,1133,30736,3575889098,3575889127,29
3,1133,30737,3575889098,3575889128,30
3,1133,30738,3575889098,3575889128,30
3,1133,30739,3575889098,3575889130,32
3,1133,30740,3575889098,3575889132,34
3,1133,30741,3575889098,3575889132,34
3,1133,30742,3575889098,3575889133,35
3,1133,30743,3575889098,3575889134,36
3,1133,30744,3575889098,3575889134,36
3,1133,30745,3575889098,3575889137,39
3,1133,30746,3575889098,3575889137,39
3,1133,30747,3575889098,3575889141,43
3,1133,30748,3575889098,3575889143,45
3,1133,30749,3575889098,3575889143,45
3,1133,30750,3575889098,3575889143,45
3,1133,30751,3575889098,3575889144,46
3,1133,30752,3575889098,3575889144,46
3,1134,30753,3575889162,3575889162,0
3,1134,30754,3575889162,3575889162,0
3,1134,30755,3575889162,3575889162,0
3,1134,30756,3575889162,3575889162,0
3,1134,30757,3575889162,3575889162,0
3,1134,30758,3575889162,3575889162,0
3,1134,30759,3575889162,3575889163,1
3,1134,30760,3575889162,3575889165,3
3,1134,30761,3575889162,3575889168,6
3,1134,30762,3575889162,3575889170,8
3,1134,30763,3575889162,3575889170,8
3,1134,30764,3575889162,3575889171,9
3,1134,30765,3575889162,3575889171,9
3,1134,30766,3575889162,3575889172,10
3,1134,30767,3575889162,3575889173,11
3,1134,30768,3575889162,3575889176,14
3,1134,30769,3575889162,3575889179,17
3,1134,30770,3575889162,3575889180,18
3,1134,30771,3575889162,3575889181,19
3,1134,30772,3575889162,3575889181,19
3,1134,30773,3575889162,3575889182,20
3,1134,30774,3575889162,3575889182,20
3,1134,30775,3575889162,3575889183,21
3,1134,30776,3575889162,3575889185,23
3,1134,30777,3575889162,3575889186,24
3,1134,30778,3575889162,3575889188,26
3,1134,30779,3575889162,3575889191,29
3,1134,30780,3575889162,3575889191,29
3,1134,30781,3575889162,3575889192,30
3,1134,30782,3575889162,3575889192,30
3,1134,30783,3575889162,3575889193,31
3,1134,30784,3575889162,3575889195,33
3,1134,30785,3575889162,3575889195,33
3,1134,30786,3575889162,3575889196,34
3,1134,30787,3575889162,3575889196,34
3,1134,30788,3575889162,3575889197,35
3,1134,30789,3575889162,3575889197,35
3,1134,30790,3575889162,3575889198,36
3,1134,30791,3575889162,3575889199,37
3,1134,30792,3575889162,3575889199,37
3,1134,30793,3575889162,3575889202,40
3,1134,30794,3575889162,3575889203,41
3,1134,30795,3575889162,3575889203,41
3,1134,30796,3575889162,3575889204,42
3,1134,30797,3575889162,3575889206,44
3,1134,30798,3575889162,3575889212,50
3,1135,30799,3575889226,3575889227,1
3,1135,30800,3575889226,3575889227,1
3,1135,30801,3575889226,3575889227,1
3,1135,30802,3575889226,3575889227,1
3,1135,30803,3575889226,3575889227,1
3,1135,30804,3575889226,3575889227,1
3,1135,30805,3575889226,3575889227,1
3,1135,30806,3575889226,3575889227,1
3,1135,30807,3575889226,3575889227,1
3,1135,30808,3575889226,3575889227,1
3,1135,30809,3575889226,3575889227,1
3,1135,30810,3575889226,3575889228,2
3,1135,30811,3575889226,3575889228,2
3,1135,30812,3575889226,3575889228,2
3,1135,30813,3575889226,3575889229,3
3,1135,30814,3575889226,3575889229,3
3,1135,30815,3575889226,3575889231,5
3,1135,30816,3575889226,3575889232,6
3,1135,30817,3575889226,3575889232,6
3,1135,30818,3575889226,3575889237,11
3,1135,30819,3575889226,3575889237,11
3,1135,30820,3575889226,3575889237,11
3,1135,30821,3575889226,3575889238,12
3,1135,30822,3575889226,3575889238,12
3,1135,30823,3575889226,3575889239,13
3,1135,30824,3575889226,3575889239,13
3,1135,30825,3575889226,3575889239,13
3,1135,30826,3575889226,3575889241,15
3,1135,30827,3575889226,3575889241,15
3,1135,30828,3575889226,3575889243,17
3,1135,30829,3575889226,3575889245,19
3,1135,30830,3575889226,3575889246,20
3,1135,30831,3575889226,3575889249,23
3,1135,30832,3575889226,3575889251,25
3,1135,30833,3575889226,3575889252,26
3,1135,30834,3575889226,3575889252,26
3,1135,30835,3575889226,3575889252,26
3,1135,30836,3575889226,3575889258,32
3,1135,30837,3575889226,3575889258,32
3,1135,30838,3575889226,3575889259,33
3,1135,30839,3575889226,3575889262,36
3,1135,30840,3575889226,3575889262,36
3,1135,30841,3575889226,3575889263,37
3,1135,30842,3575889226,3575889264,38
3,1135,30843,3575889226,3575889265,39
3,1135,30844,3575889226,3575889266,40
3,1135,30845,3575889226,3575889266,40
3,1135,30846,3575889226,3575889267,41
3,1135,30847,3575889226,3575889270,44
3,1135,30848,3575889226,3575889270,44
3,1136,30849,3575889289,3575889289,0
3,1136,30850,3575889289,3575889289,0
3,1136,30851,3575889289,3575889289,0
3,1136,30852,3575889289,3575889289,0
3,1136,30853,3575889289,3575889289,0
3,1136,30854,3575889289,3575889289,0
3,1136,30855,3575889289,3575889289,0
3,1136,30856,3575889289,3575889289,0
3,1136,30857,3575889289,3575889289,0
3,1136,30858,3575889289,3575889289,0
3,1136,30859,3575889289,3575889289,0
3,1136,30860,3575889289,3575889291,2
3,1136,30861,3575889289,3575889291,2
3,1136,30862,3575889289,3575889291,2
3,1136,30863,3575889289,3575889296,7
3,1136,30864,3575889289,3575889297,8
3,1136,30865,3575889289,3575889297,8
3,1136,30866,3575889289,3575889297,8
3,1136,30867,3575889289,3575889300,11
3,1136,30868,3575889289,3575889301,12
3,1136,30869,3575889289,3575889302,13
3,1136,30870,3575889289,3575889302,13
3,1136,30871,3575889289,3575889302,13
3,1136,30872,3575889289,3575889303,14
3,1136,30873,3575889289,3575889306,17
3,1136,30874,3575889289,3575889306,17
3,1136,30875,3575889289,3575889311,22
3,1136,30876,3575889289,3575889312,23
3,1136,30877,3575889289,3575889313,24
3,1136,30878,3575889289,3575889314,25
3,1136,30879,3575889289,3575889315,26
3,1136,30880,3575889289,3575889318,29
3,1136,30881,3575889289,3575889318,29
3,1136,30882,3575889289,3575889321,32
3,1136,30883,3575889289,3575889322,33
3,1136,30884,3575889289,3575889323,34
3,1136,30885,3575889289,3575889327,38
3,1136,30886,3575889289,3575889328,39
3,1136,30887,3575889289,3575889328,39
3,1136,30888,3575889289,3575889329,40
3,1136,30889,3575889289,3575889333,44
3,1136,30890,3575889289,3575889333,44
3,1136,30891,3575889289,3575889334,45
3,1136,30892,3575889289,3575889334,45
3,1136,30893,3575889289,3575889337,48
3,1136,30894,3575889289,3575889338,49
3,1137,30895,3575889352,3575889352,0
3,1137,30896,3575889352,3575889352,0
3,1137,30897,3575889352,3575889352,0
3,1137,30898,3575889352,3575889352,0
3,1137,30899,3575889352,3575889352,0
3,1137,30900,3575889352,3575889352,0
3,1137,30901,3575889352,3575889352,0
3,1137,30902,3575889352,3575889352,0
3,1137,30903,3575889352,3575889352,0
3,1137,30904,3575889352,3575889354,2
3,1137,30905,3575889352,3575889360,8
3,1137,30906,3575889352,3575889361,9
3,1137,30907,3575889352,3575889363,11
3,1137,30908,3575889352,3575889365,13
3,1137,30909,3575889352,3575889368,16
3,1137,30910,3575889352,3575889371,19
3,1137,30911,3575889352,3575889371,19
3,1137,30912,3575889352,3575889371,19
3,1137,30913,3575889352,3575889372,20
3,1137,30914,3575889352,3575889372,20
3,1137,30915,3575889352,3575889373,21
3,1137,30916,3575889352,3575889376,24
3,1137,30917,3575889352,3575889379,27
3,1137,30918,3575889352,3575889381,29
3,1137,30919,3575889352,3575889381,29
3,1137,30920,3575889352,3575889381,29
3,1137,30921,3575889352,3575889382,30
3,1137,30922,3575889352,3575889382,30
3,1137,30923,3575889352,3575889384,32
3,1137,30924,3575889352,3575889385,33
3,1137,30925,3575889352,3575889387,35
3,1137,30926,3575889352,3575889387,35
3,1137,30927,3575889352,3575889391,39
3,1137,30928,3575889352,3575889391,39
3,1137,30929,3575889352,3575889391,39
3,1137,30930,3575889352,3575889393,41
3,1137,30931,3575889352,3575889393,41
3,1137,30932,3575889352,3575889395,43
3,1137,30933,3575889352,3575889395,43
3,1137,30934,3575889352,3575889396,44
3,1137,30935,3575889352,3575889397,45
3,1137,30936,3575889352,3575889397,45
3,1137,30937,3575889352,3575889398,46
3,1137,30938,3575889352,3575889399,47
3,1137,30939,3575889352,3575889399,47
3,1137,30940,3575889352,3575889400,48
3,1137,30941,3575889352,3575889403,51
3,1138,30942,3575889415,3575889415,0
3,1138,30943,3575889415,3575889415,0
3,1138,30944,3575889415,3575889415,0
3,1138,30945,3575889415,3575889415,0
3,1138,30946,3575889415,3575889415,0
3,1138,30947,3575889415,3575889415,0
3,1138,30948,3575889415,3575889416,1
3,1138,30949,3575889415,3575889417,2
3,1138,30950,3575889415,3575889419,4
3,1138,30951,3575889415,3575889420,5
3,1138,30952,3575889415,3575889422,7
3,1138,30953,3575889415,3575889424,9
3,1138,30954,3575889415,3575889424,9
3,1138,30955,3575889415,3575889426,11
3,1138,30956,3575889415,3575889427,12
3,1138,30957,3575889415,3575889427,12
3,1138,30958,3575889415,3575889428,13
3,1138,30959,3575889415,3575889428,13
3,1138,30960,3575889415,3575889429,14
3,1138,30961,3575889415,3575889430,15
3,1138,30962,3575889415,3575889430,15
3,1138,30963,3575889415,3575889431,16
3,1138,30964,3575889415,3575889432,17
3,1138,30965,3575889415,3575889433,18
3,1138,30966,3575889415,3575889435,20
3,1138,30967,3575889415,3575889437,22
3,1138,30968,3575889415,3575889437,22
3,1138,30969,3575889415,3575889438,23
3,1138,30970,3575889415,3575889438,23
3,1138,30971,3575889415,3575889438,23
3,1138,30972,3575889415,3575889439,24
3,1138,30973,3575889415,3575889439,24
3,1138,30974,3575889415,3575889441,26
3,1138,30975,3575889415,3575889441,26
3,1138,30976,3575889415,3575889445,30
3,1138,30977,3575889415,3575889446,31
3,1138,30978,3575889415,3575889448,33
3,1138,30979,3575889415,3575889449,34
3,1138,30980,3575889415,3575889451,36
3,1138,30981,3575889415,3575889452,37
3,1138,30982,3575889415,3575889452,37
3,1138,30983,3575889415,3575889453,38
3,1138,30984,3575889415,3575889458,43
3,1138,30985,3575889415,3575889458,43
3,1138,30986,3575889415,3575889459,44
3,1138,30987,3575889415,3575889462,47
3,1138,30988,3575889415,3575889462,47
3,1138,30989,3575889415,3575889463,48
3,1138,30990,3575889415,3575889465,50
3,1139,30991,3575889478,3575889478,0
3,1139,30992,3575889478,3575889478,0
3,1139,30993,3575889478,3575889478,0
3,1139,30994,3575889478,3575889478,0
3,1139,30995,3575889478,3575889478,0
3,1139,30996,3575889478,3575889478,0
3,1139,30997,3575889478,3575889478,0
3,1139,30998,3575889478,3575889478,0
3,1139,30999,3575889478,3575889480,2
3,1139,31000,3575889478,3575889481,3
3,1139,31001,3575889478,3575889483,5
3,1139,31002,3575889478,3575889483,5
3,1139,31003,3575889478,3575889484,6
3,1139,31004,3575889478,3575889485,7
3,1139,31005,3575889478,3575889486,8
3,1139,31006,3575889478,3575889487,9
3,1139,31007,3575889478,3575889487,9
3,1139,31008,3575889478,3575889489,11
3,1139,31009,3575889478,3575889490,12
3,1139,31010,3575889478,3575889490,12
3,1139,31011,3575889478,3575889491,13
3,1139,31012,3575889478,3575889492,14
3,1139,31013,3575889478,3575889495,17
3,1139,31014,3575889478,3575889496,18
3,1139,31015,3575889478,3575889497,19
3,1139,31016,3575889478,3575889497,19
3,1139,31017,3575889478,3575889501,23
3,1139,31018,3575889478,3575889502,24
3,1139,31019,3575889478,3575889502,24
3,1139,31020,3575889478,3575889502,24
3,1139,31021,3575889478,3575889502,24
3,1139,31022,3575889478,3575889506,28
3,1139,31023,3575889478,3575889506,28
3,1139,31024,3575889478,3575889507,29
3,1139,31025,3575889478,3575889510,32
3,1139,31026,3575889478,3575889511,33
3,1139,31027,3575889478,3575889513,35
3,1139,31028,3575889478,3575889513,35
3,1139,31029,3575889478,3575889514,36
3,1139,31030,3575889478,3575889515,37
3,1139,31031,3575889478,3575889518,40
3,1139,31032,3575889478,3575889519,41
3,1139,31033,3575889478,3575889521,43
3,1139,31034,3575889478,3575889521,43
3,1139,31035,3575889478,3575889522,44
3,1139,31036,3575889478,3575889527,49
3,1139,31037,3575889478,3575889528,50
3,1140,31038,3575889640,3575889640,0
3,1140,31039,3575889640,3575889640,0
3,1140,31040,3575889640,3575889640,0
3,1140,31041,3575889640,3575889640,0
3,1140,31042,3575889640,3575889640,0
3,1140,31043,3575889640,3575889640,0
3,1140,31044,3575889640,3575889640,0
3,1140,31045,3575889640,3575889640,0
3,1140,31046,3575889640,3575889640,0
3,1140,31047,3575889640,3575889640,0
3,1140,31048,3575889640,3575889640,0
3,1140,31049,3575889640,3575889640,0
3,1140,31050,3575889640,3575889640,0
3,1140,31051,3575889640,3575889640,0
3,1140,31052,3575889640,3575889640,0
3,1140,31053,3575889640,3575889640,0
3,1140,31054,3575889640,3575889640,0
3,1140,31055,3575889640,3575889640,0
3,1140,31056,3575889640,3575889640,0
3,1140,31057,3575889640,3575889640,0
3,1140,31058,3575889640,3575889640,0
3,1140,31059,3575889640,3575889640,0
3,1140,31060,3575889640,3575889640,0
3,1140,31061,3575889640,3575889640,0
3,1140,31062,3575889640,3575889640,0
3,1140,31063,3575889640,3575889640,0
3,1140,31064,3575889640,3575889640,0
3,1140,31065,3575889640,3575889640,0
3,1140,31066,3575889640,3575889640,0
3,1140,31067,3575889640,3575889640,0
3,1140,31068,3575889640,3575889640,0
3,1140,31069,3575889640,3575889640,0
3,1140,31070,3575889640,3575889640,0
3,1140,31071,3575889640,3575889640,0
3,1140,31072,3575889640,3575889640,0
3,1140,31073,3575889640,3575889640,0
3,1140,31074,3575889640,3575889640,0
3,1140,31075,3575889640,3575889640,0
3,1140,31076,3575889640,3575889640,0
3,1140,31077,3575889640,3575889640,0
3,1140,31078,3575889640,3575889640,0
3,1140,31079,3575889640,3575889640,0
3,1140,31080,3575889640,3575889640,0
3,1140,31081,3575889640,3575889640,0
3,1140,31082,3575889640,3575889640,0
3,1140,31083,3575889640,3575889640,0
3,1140,31084,3575889640,3575889641,1
3,1140,31085,3575889640,3575889641,1
3,1140,31086,3575889640,3575889641,1
3,1140,31087,3575889640,3575889641,1
3,1140,31088,3575889640,3575889641,1
3,1140,31089,3575889640,3575889641,1
3,1140,31090,3575889640,3575889641,1
3,1140,31091,3575889640,3575889641,1
3,1140,31092,3575889640,3575889641,1
3,1140,31093,3575889640,3575889641,1
3,1140,31094,3575889640,3575889641,1
3,1140,31095,3575889640,3575889641,1
3,1140,31096,3575889640,3575889641,1
3,1140,31097,3575889640,3575889641,1
3,1140,31098,3575889640,3575889641,1
3,1140,31099,3575889640,3575889641,1
3,1140,31100,3575889640,3575889641,1
3,1140,31101,3575889640,3575889641,1
3,1140,31102,3575889640,3575889641,1
3,1140,31103,3575889640,3575889641,1
3,1140,31104,3575889640,3575889641,1
3,1140,31105,3575889640,3575889641,1
3,1140,31106,3575889640,3575889641,1
3,1140,31107,3575889640,3575889641,1
3,1140,31108,3575889640,3575889641,1
3,1140,31109,3575889640,3575889641,1
3,1140,31110,3575889640,3575889641,1
3,1140,31111,3575889640,3575889641,1
3,1140,31112,3575889640,3575889641,1
3,1140,31113,3575889640,3575889641,1
3,1140,31114,3575889640,3575889641,1
3,1140,31115,3575889640,3575889641,1
3,1140,31116,3575889640,3575889641,1
3,1140,31117,3575889640,3575889641,1
3,1140,31118,3575889640,3575889641,1
3,1140,31119,3575889640,3575889641,1
3,1140,31120,3575889640,3575889641,1
3,1140,31121,3575889640,3575889641,1
3,1140,31122,3575889640,3575889641,1
3,1140,31123,3575889640,3575889641,1
3,1140,31124,3575889640,3575889641,1
3,1140,31125,3575889640,3575889641,1
3,1140,31126,3575889640,3575889642,2
3,1140,31127,3575889640,3575889643,3
3,1140,31128,3575889640,3575889643,3
3,1140,31129,3575889640,3575889645,5
3,1140,31130,3575889640,3575889648,8
3,1140,31131,3575889640,3575889649,9
3,1140,31132,3575889640,3575889651,11
3,1140,31133,3575889640,3575889651,11
3,1140,31134,3575889640,3575889652,12
3,1140,31135,3575889640,3575889656,16
3,1140,31136,3575889640,3575889658,18
3,1140,31137,3575889640,3575889658,18
3,1140,31138,3575889640,3575889660,20
3,1140,31139,3575889640,3575889662,22
3,1140,31140,3575889640,3575889663,23
3,1140,31141,3575889640,3575889663,23
3,1140,31142,3575889640,3575889663,23
3,1140,31143,3575889640,3575889664,24
3,1140,31144,3575889640,3575889665,25
3,1140,31145,3575889640,3575889665,25
3,1140,31146,3575889640,3575889667,27
3,1140,31147,3575889640,3575889669,29
3,1140,31148,3575889640,3575889671,31
3,1140,31149,3575889640,3575889676,36
3,1140,31150,3575889640,3575889677,37
3,1140,31151,3575889640,3575889681,41
3,1140,31152,3575889640,3575889683,43
3,1140,31153,3575889640,3575889683,43
3,1140,31154,3575889640,3575889685,45
3,1140,31155,3575889640,3575889685,45
3,1140,31156,3575889640,3575889686,46
3,1140,31157,3575889640,3575889687,47
3,1140,31158,3575889640,3575889687,47
3,1140,31159,3575889640,3575889690,50
3,1141,31160,3575889702,3575889702,0
3,1141,31161,3575889702,3575889702,0
3,1141,31162,3575889702,3575889702,0
3,1141,31163,3575889702,3575889702,0
3,1141,31164,3575889702,3575889702,0
3,1141,31165,3575889702,3575889702,0
3,1141,31166,3575889702,3575889702,0
3,1141,31167,3575889702,3575889702,0
3,1141,31168,3575889702,3575889702,0
3,1141,31169,3575889702,3575889702,0
3,1141,31170,3575889702,3575889703,1
3,1141,31171,3575889702,3575889705,3
3,1141,31172,3575889702,3575889706,4
3,1141,31173,3575889702,3575889706,4
3,1141,31174,3575889702,3575889706,4
3,1141,31175,3575889702,3575889710,8
3,1141,31176,3575889702,3575889711,9
3,1141,31177,3575889702,3575889712,10
3,1141,31178,3575889702,3575889713,11
3,1141,31179,3575889702,3575889713,11
3,1141,31180,3575889702,3575889714,12
3,1141,31181,3575889702,3575889715,13
3,1141,31182,3575889702,3575889718,16
3,1141,31183,3575889702,3575889719,17
3,1141,31184,3575889702,3575889721,19
3,1141,31185,3575889702,3575889721,19
3,1141,31186,3575889702,3575889722,20
3,1141,31187,3575889702,3575889724,22
3,1141,31188,3575889702,3575889727,25
3,1141,31189,3575889702,3575889727,25
3,1141,31190,3575889702,3575889728,26
3,1141,31191,3575889702,3575889730,28
3,1141,31192,3575889702,3575889731,29
3,1141,31193,3575889702,3575889732,30
3,1141,31194,3575889702,3575889733,31
3,1141,31195,3575889702,3575889733,31
3,1141,31196,3575889702,3575889736,34
3,1141,31197,3575889702,3575889737,35
3,1141,31198,3575889702,3575889740,38
3,1141,31199,3575889702,3575889742,40
3,1141,31200,3575889702,3575889742,40
3,1141,31201,3575889702,3575889743,41
3,1141,31202,3575889702,3575889743,41
3,1141,31203,3575889702,3575889744,42
3,1142,31204,3575889769,3575889769,0
3,1142,31205,3575889769,3575889769,0
3,1142,31206,3575889769,3575889769,0
3,1142,31207,3575889769,3575889769,0
3,1142,31208,3575889769,3575889769,0
3,1142,31209,3575889769,3575889769,0
3,1142,31210,3575889769,3575889769,0
3,1142,31211,3575889769,3575889769,0
3,1142,31212,3575889769,3575889770,1
3,1142,31213,3575889769,3575889770,1
3,1142,31214,3575889769,3575889770,1
3,1142,31215,3575889769,3575889771,2
3,1142,31216,3575889769,3575889773,4
3,1142,31217,3575889769,3575889776,7
3,1142,31218,3575889769,3575889778,9
3,1142,31219,3575889769,3575889779,10
3,1142,31220,3575889769,3575889780,11
3,1142,31221,3575889769,3575889780,11
3,1142,31222,3575889769,3575889781,12
3,1142,31223,3575889769,3575889781,12
3,1142,31224,3575889769,3575889783,14
3,1142,31225,3575889769,3575889785,16
3,1142,31226,3575889769,3575889785,16
3,1142,31227,3575889769,3575889786,17
3,1142,31228,3575889769,3575889787,18
3,1142,31229,3575889769,3575889790,21
3,1142,31230,3575889769,3575889791,22
3,1142,31231,3575889769,3575889791,22
3,1142,31232,3575889769,3575889792,23
3,1142,31233,3575889769,3575889793,24
3,1142,31234,3575889769,3575889795,26
3,1142,31235,3575889769,3575889795,26
3,1142,31236,3575889769,3575889795,26
3,1142,31237,3575889769,3575889796,27
3,1142,31238,3575889769,3575889796,27
3,1142,31239,3575889769,3575889796,27
3,1142,31240,3575889769,3575889798,29
3,1142,31241,3575889769,3575889798,29
3,1142,31242,3575889769,3575889799,30
3,1142,31243,3575889769,3575889799,30
3,1142,31244,3575889769,3575889801,32
3,1142,31245,3575889769,3575889802,33
3,1142,31246,3575889769,3575889803,34
3,1142,31247,3575889769,3575889805,36
3,1142,31248,3575889769,3575889812,43
3,1142,31249,3575889769,3575889815,46
3,1142,31250,3575889769,3575889815,46
3,1142,31251,3575889769,3575889816,47
3,1142,31252,3575889769,3575889819,50
3,1143,31253,3575889831,3575889831,0
3,1143,31254,3575889831,3575889831,0
3,1143,31255,3575889831,3575889831,0
3,1143,31256,3575889831,3575889831,0
3,1143,31257,3575889831,3575889831,0
3,1143,31258,3575889831,3575889831,0
3,1143,31259,3575889831,3575889831,0
3,1143,31260,3575889831,3575889831,0
3,1143,31261,3575889831,3575889831,0
3,1143,31262,3575889831,3575889831,0
3,1143,31263,3575889831,3575889831,0
3,1143,31264,3575889831,3575889831,0
3,1143,31265,3575889831,3575889832,1
3,1143,31266,3575889831,3575889833,2
3,1143,31267,3575889831,3575889833,2
3,1143,31268,3575889831,3575889836,5
3,1143,31269,3575889831,3575889837,6
3,1143,31270,3575889831,3575889837,6
3,1143,31271,3575889831,3575889838,7
3,1143,31272,3575889831,3575889839,8
3,1143,31273,3575889831,3575889839,8
3,1143,31274,3575889831,3575889840,9
3,1143,31275,3575889831,3575889840,9
3,1143,31276,3575889831,3575889841,10
3,1143,31277,3575889831,3575889843,12
3,1143,31278,3575889831,3575889843,12
3,1143,31279,3575889831,3575889845,14
3,1143,31280,3575889831,3575889849,18
3,1143,31281,3575889831,3575889850,19
3,1143,31282,3575889831,3575889851,20
3,1143,31283,3575889831,3575889852,21
3,1143,31284,3575889831,3575889852,21
3,1143,31285,3575889831,3575889856,25
3,1143,31286,3575889831,3575889857,26
3,1143,31287,3575889831,3575889861,30
3,1143,31288,3575889831,3575889861,30
3,1143,31289,3575889831,3575889863,32
3,1143,31290,3575889831,3575889863,32
3,1143,31291,3575889831,3575889864,33
3,1143,31292,3575889831,3575889865,34
3,1143,31293,3575889831,3575889865,34
3,1143,31294,3575889831,3575889865,34
3,1143,31295,3575889831,3575889866,35
3,1143,31296,3575889831,3575889867,36
3,1143,31297,3575889831,3575889872,41
3,1143,31298,3575889831,3575889876,45
3,1143,31299,3575889831,3575889877,46
3,1144,31300,3575889898,3575889898,0
3,1144,31301,3575889898,3575889898,0
3,1144,31302,3575889898,3575889898,0
3,1144,31303,3575889898,3575889898,0
3,1144,31304,3575889898,3575889898,0
3,1144,31305,3575889898,3575889898,0
3,1144,31306,3575889898,3575889898,0
3,1144,31307,3575889898,3575889898,0
3,1144,31308,3575889898,3575889898,0
3,1144,31309,3575889898,3575889898,0
3,1144,31310,3575889898,3575889898,0
3,1144,31311,3575889898,3575889898,0
3,1144,31312,3575889898,3575889898,0
3,1144,31313,3575889898,3575889898,0
3,1144,31314,3575889898,3575889898,0
3,1144,31315,3575889898,3575889898,0
3,1144,31316,3575889898,3575889901,3
3,1144,31317,3575889898,3575889902,4
3,1144,31318,3575889898,3575889902,4
3,1144,31319,3575889898,3575889902,4
3,1144,31320,3575889898,3575889903,5
3,1144,31321,3575889898,3575889903,5
3,1144,31322,3575889898,3575889905,7
3,1144,31323,3575889898,3575889906,8
3,1144,31324,3575889898,3575889906,8
3,1144,31325,3575889898,3575889907,9
3,1144,31326,3575889898,3575889910,12
3,1144,31327,3575889898,3575889912,14
3,1144,31328,3575889898,3575889912,14
3,1144,31329,3575889898,3575889913,15
3,1144,31330,3575889898,3575889913,15
3,1144,31331,3575889898,3575889914,16
3,1144,31332,3575889898,3575889916,18
3,1144,31333,3575889898,3575889919,21
3,1144,31334,3575889898,3575889921,23
3,1144,31335,3575889898,3575889921,23
3,1144,31336,3575889898,3575889922,24
3,1144,31337,3575889898,3575889923,25
3,1144,31338,3575889898,3575889928,30
3,1144,31339,3575889898,3575889928,30
3,1144,31340,3575889898,3575889930,32
3,1144,31341,3575889898,3575889932,34
3,1144,31342,3575889898,3575889933,35
3,1144,31343,3575889898,3575889933,35
3,1144,31344,3575889898,3575889934,36
3,1144,31345,3575889898,3575889937,39
3,1144,31346,3575889898,3575889937,39
3,1144,31347,3575889898,3575889941,43
3,1144,31348,3575889898,3575889942,44
3,1144,31349,3575889898,3575889943,45
3,1144,31350,3575889898,3575889943,45
3,1144,31351,3575889898,3575889944,46
3,1144,31352,3575889898,3575889944,46
3,1144,31353,3575889898,3575889948,50
3,1145,31354,3575889961,3575889961,0
3,1145,31355,3575889961,3575889961,0
3,1145,31356,3575889961,3575889961,0
3,1145,31357,3575889961,3575889961,0
3,1145,31358,3575889961,3575889961,0
3,1145,31359,3575889961,3575889962,1
3,1145,31360,3575889961,3575889964,3
3,1145,31361,3575889961,3575889968,7
3,1145,31362,3575889961,3575889970,9
3,1145,31363,3575889961,3575889970,9
3,1145,31364,3575889961,3575889970,9
3,1145,31365,3575889961,3575889971,10
3,1145,31366,3575889961,3575889973,12
3,1145,31367,3575889961,3575889975,14
3,1145,31368,3575889961,3575889978,17
3,1145,31369,3575889961,3575889979,18
3,1145,31370,3575889961,3575889980,19
3,1145,31371,3575889961,3575889981,20
3,1145,31372,3575889961,3575889981,20
3,1145,31373,3575889961,3575889981,20
3,1145,31374,3575889961,3575889982,21
3,1145,31375,3575889961,3575889985,24
3,1145,31376,3575889961,3575889986,25
3,1145,31377,3575889961,3575889988,27
3,1145,31378,3575889961,3575889990,29
3,1145,31379,3575889961,3575889990,29
3,1145,31380,3575889961,3575889991,30
3,1145,31381,3575889961,3575889992,31
3,1145,31382,3575889961,3575889993,32
3,1145,31383,3575889961,3575889995,34
3,1145,31384,3575889961,3575889995,34
3,1145,31385,3575889961,3575889995,34
3,1145,31386,3575889961,3575889996,35
3,1145,31387,3575889961,3575889996,35
3,1145,31388,3575889961,3575889997,36
3,1145,31389,3575889961,3575889998,37
3,1145,31390,3575889961,3575889999,38
3,1145,31391,3575889961,3575890001,40
3,1145,31392,3575889961,3575890003,42
3,1145,31393,3575889961,3575890003,42
3,1145,31394,3575889961,3575890003,42
3,1145,31395,3575889961,3575890006,45
3,1145,31396,3575889961,3575890011,50
3,1146,31397,3575890025,3575890025,0
3,1146,31398,3575890025,3575890025,0
3,1146,31399,3575890025,3575890025,0
3,1146,31400,3575890025,3575890025,0
3,1146,31401,3575890025,3575890025,0
3,1146,31402,3575890025,3575890025,0
3,1146,31403,3575890025,3575890025,0
3,1146,31404,3575890025,3575890025,0
3,1146,31405,3575890025,3575890025,0
3,1146,31406,3575890025,3575890026,1
3,1146,31407,3575890025,3575890027,2
3,1146,31408,3575890025,3575890028,3
3,1146,31409,3575890025,3575890028,3
3,1146,31410,3575890025,3575890028,3
3,1146,31411,3575890025,3575890028,3
3,1146,31412,3575890025,3575890030,5
3,1146,31413,3575890025,3575890032,7
3,1146,31414,3575890025,3575890032,7
3,1146,31415,3575890025,3575890033,8
3,1146,31416,3575890025,3575890034,9
3,1146,31417,3575890025,3575890037,12
3,1146,31418,3575890025,3575890037,12
3,1146,31419,3575890025,3575890038,13
3,1146,31420,3575890025,3575890038,13
3,1146,31421,3575890025,3575890039,14
3,1146,31422,3575890025,3575890039,14
3,1146,31423,3575890025,3575890040,15
3,1146,31424,3575890025,3575890041,16
3,1146,31425,3575890025,3575890043,18
3,1146,31426,3575890025,3575890044,19
3,1146,31427,3575890025,3575890045,20
3,1146,31428,3575890025,3575890049,24
3,1146,31429,3575890025,3575890049,24
3,1146,31430,3575890025,3575890051,26
3,1146,31431,3575890025,3575890052,27
3,1146,31432,3575890025,3575890053,28
3,1146,31433,3575890025,3575890053,28
3,1146,31434,3575890025,3575890057,32
3,1146,31435,3575890025,3575890057,32
3,1146,31436,3575890025,3575890061,36
3,1146,31437,3575890025,3575890061,36
3,1146,31438,3575890025,3575890063,38
3,1146,31439,3575890025,3575890063,38
3,1146,31440,3575890025,3575890063,38
3,1146,31441,3575890025,3575890065,40
3,1146,31442,3575890025,3575890065,40
3,1146,31443,3575890025,3575890066,41
3,1146,31444,3575890025,3575890067,42
3,1146,31445,3575890025,3575890067,42
3,1146,31446,3575890025,3575890072,47
3,1147,31447,3575890089,3575890089,0
3,1147,31448,3575890089,3575890089,0
3,1147,31449,3575890089,3575890089,0
3,1147,31450,3575890089,3575890090,1
3,1147,31451,3575890089,3575890090,1
3,1147,31452,3575890089,3575890090,1
3,1147,31453,3575890089,3575890090,1
3,1147,31454,3575890089,3575890090,1
3,1147,31455,3575890089,3575890090,1
3,1147,31456,3575890089,3575890090,1
3,1147,31457,3575890089,3575890090,1
3,1147,31458,3575890089,3575890090,1
3,1147,31459,3575890089,3575890091,2
3,1147,31460,3575890089,3575890091,2
3,1147,31461,3575890089,3575890092,3
3,1147,31462,3575890089,3575890097,8
3,1147,31463,3575890089,3575890101,12
3,1147,31464,3575890089,3575890102,13
3,1147,31465,3575890089,3575890102,13
3,1147,31466,3575890089,3575890102,13
3,1147,31467,3575890089,3575890103,14
3,1147,31468,3575890089,3575890103,14
3,1147,31469,3575890089,3575890105,16
3,1147,31470,3575890089,3575890106,17
3,1147,31471,3575890089,3575890106,17
3,1147,31472,3575890089,3575890110,21
3,1147,31473,3575890089,3575890112,23
3,1147,31474,3575890089,3575890112,23
3,1147,31475,3575890089,3575890113,24
3,1147,31476,3575890089,3575890114,25
3,1147,31477,3575890089,3575890114,25
3,1147,31478,3575890089,3575890116,27
3,1147,31479,3575890089,3575890119,30
3,1147,31480,3575890089,3575890121,32
3,1147,31481,3575890089,3575890121,32
3,1147,31482,3575890089,3575890123,34
3,1147,31483,3575890089,3575890123,34
3,1147,31484,3575890089,3575890128,39
3,1147,31485,3575890089,3575890128,39
3,1147,31486,3575890089,3575890130,41
3,1147,31487,3575890089,3575890132,43
3,1147,31488,3575890089,3575890133,44
3,1147,31489,3575890089,3575890133,44
3,1147,31490,3575890089,3575890135,46
3,1147,31491,3575890089,3575890137,48
3,1147,31492,3575890089,3575890137,48
3,1148,31493,3575890151,3575890151,0
3,1148,31494,3575890151,3575890151,0
3,1148,31495,3575890151,3575890151,0
3,1148,31496,3575890151,3575890151,0
3,1148,31497,3575890151,3575890151,0
3,1148,31498,3575890151,3575890151,0
3,1148,31499,3575890151,3575890154,3
3,1148,31500,3575890151,3575890159,8
3,1148,31501,3575890151,3575890161,10
3,1148,31502,3575890151,3575890161,10
3,1148,31503,3575890151,3575890163,12
3,1148,31504,3575890151,3575890165,14
3,1148,31505,3575890151,3575890168,17
3,1148,31506,3575890151,3575890170,19
3,1148,31507,3575890151,3575890170,19
3,1148,31508,3575890151,3575890170,19
3,1148,31509,3575890151,3575890171,20
3,1148,31510,3575890151,3575890173,22
3,1148,31511,3575890151,3575890174,23
3,1148,31512,3575890151,3575890177,26
3,1148,31513,3575890151,3575890178,27
3,1148,31514,3575890151,3575890180,29
3,1148,31515,3575890151,3575890181,30
3,1148,31516,3575890151,3575890181,30
3,1148,31517,3575890151,3575890182,31
3,1148,31518,3575890151,3575890182,31
3,1148,31519,3575890151,3575890186,35
3,1148,31520,3575890151,3575890186,35
3,1148,31521,3575890151,3575890188,37
3,1148,31522,3575890151,3575890190,39
3,1148,31523,3575890151,3575890190,39
3,1148,31524,3575890151,3575890191,40
3,1148,31525,3575890151,3575890192,41
3,1148,31526,3575890151,3575890193,42
3,1148,31527,3575890151,3575890195,44
3,1148,31528,3575890151,3575890195,44
3,1148,31529,3575890151,3575890196,45
3,1148,31530,3575890151,3575890197,46
3,1148,31531,3575890151,3575890197,46
3,1148,31532,3575890151,3575890198,47
3,1148,31533,3575890151,3575890199,48
3,1148,31534,3575890151,3575890199,48
3,1148,31535,3575890151,3575890199,48
3,1148,31536,3575890151,3575890200,49
3,1148,31537,3575890151,3575890201,50
3,1149,31538,3575890215,3575890215,0
3,1149,31539,3575890215,3575890215,0
3,1149,31540,3575890215,3575890215,0
3,1149,31541,3575890215,3575890215,0
3,1149,31542,3575890215,3575890215,0
3,1149,31543,3575890215,3575890215,0
3,1149,31544,3575890215,3575890216,1
3,1149,31545,3575890215,3575890216,1
3,1149,31546,3575890215,3575890217,2
3,1149,31547,3575890215,3575890220,5
3,1149,31548,3575890215,3575890220,5
3,1149,31549,3575890215,3575890222,7
3,1149,31550,3575890215,3575890222,7
3,1149,31551,3575890215,3575890225,10
3,1149,31552,3575890215,3575890227,12
3,1149,31553,3575890215,3575890227,12
3,1149,31554,3575890215,3575890228,13
3,1149,31555,3575890215,3575890228,13
3,1149,31556,3575890215,3575890229,14
3,1149,31557,3575890215,3575890229,14
3,1149,31558,3575890215,3575890230,15
3,1149,31559,3575890215,3575890232,17
3,1149,31560,3575890215,3575890232,17
3,1149,31561,3575890215,3575890233,18
3,1149,31562,3575890215,3575890234,19
3,1149,31563,3575890215,3575890237,22
3,1149,31564,3575890215,3575890238,23
3,1149,31565,3575890215,3575890238,23
3,1149,31566,3575890215,3575890238,23
3,1149,31567,3575890215,3575890239,24
3,1149,31568,3575890215,3575890240,25
3,1149,31569,3575890215,3575890240,25
3,1149,31570,3575890215,3575890241,26
3,1149,31571,3575890215,3575890241,26
3,1149,31572,3575890215,3575890243,28
3,1149,31573,3575890215,3575890244,29
3,1149,31574,3575890215,3575890245,30
3,1149,31575,3575890215,3575890246,31
3,1149,31576,3575890215,3575890248,33
3,1149,31577,3575890215,3575890249,34
3,1149,31578,3575890215,3575890250,35
3,1149,31579,3575890215,3575890252,37
3,1149,31580,3575890215,3575890253,38
3,1149,31581,3575890215,3575890254,39
3,1149,31582,3575890215,3575890257,42
3,1149,31583,3575890215,3575890258,43
3,1149,31584,3575890215,3575890260,45
3,1149,31585,3575890215,3575890261,46
3,1149,31586,3575890215,3575890263,48
3,1149,31587,3575890215,3575890264,49
3,1149,31588,3575890215,3575890264,49
3,1149,31589,3575890215,3575890265,50
3,1150,31590,3575890277,3575890277,0
3,1150,31591,3575890277,3575890277,0
3,1150,31592,3575890277,3575890277,0
3,1150,31593,3575890277,3575890277,0
3,1150,31594,3575890277,3575890277,0
3,1150,31595,3575890277,3575890277,0
3,1150,31596,3575890277,3575890277,0
3,1150,31597,3575890277,3575890278,1
3,1150,31598,3575890277,3575890281,4
3,1150,31599,3575890277,3575890281,4
3,1150,31600,3575890277,3575890283,6
3,1150,31601,3575890277,3575890284,7
3,1150,31602,3575890277,3575890285,8
3,1150,31603,3575890277,3575890285,8
3,1150,31604,3575890277,3575890286,9
3,1150,31605,3575890277,3575890287,10
3,1150,31606,3575890277,3575890288,11
3,1150,31607,3575890277,3575890288,11
3,1150,31608,3575890277,3575890291,14
3,1150,31609,3575890277,3575890292,15
3,1150,31610,3575890277,3575890292,15
3,1150,31611,3575890277,3575890292,15
3,1150,31612,3575890277,3575890296,19
3,1150,31613,3575890277,3575890297,20
3,1150,31614,3575890277,3575890297,20
3,1150,31615,3575890277,3575890301,24
3,1150,31616,3575890277,3575890302,25
3,1150,31617,3575890277,3575890302,25
3,1150,31618,3575890277,3575890303,26
3,1150,31619,3575890277,3575890303,26
3,1150,31620,3575890277,3575890303,26
3,1150,31621,3575890277,3575890306,29
3,1150,31622,3575890277,3575890306,29
3,1150,31623,3575890277,3575890307,30
3,1150,31624,3575890277,3575890311,34
3,1150,31625,3575890277,3575890311,34
3,1150,31626,3575890277,3575890312,35
3,1150,31627,3575890277,3575890314,37
3,1150,31628,3575890277,3575890314,37
3,1150,31629,3575890277,3575890315,38
3,1150,31630,3575890277,3575890319,42
3,1150,31631,3575890277,3575890319,42
3,1150,31632,3575890277,3575890320,43
3,1150,31633,3575890277,3575890321,44
3,1150,31634,3575890277,3575890322,45
3,1150,31635,3575890277,3575890323,46
3,1151,31636,3575890342,3575890342,0
3,1151,31637,3575890342,3575890342,0
3,1151,31638,3575890342,3575890342,0
3,1151,31639,3575890342,3575890342,0
3,1151,31640,3575890342,3575890342,0
3,1151,31641,3575890342,3575890342,0
3,1151,31642,3575890342,3575890342,0
3,1151,31643,3575890342,3575890342,0
3,1151,31644,3575890342,3575890342,0
3,1151,31645,3575890342,3575890342,0
3,1151,31646,3575890342,3575890343,1
3,1151,31647,3575890342,3575890343,1
3,1151,31648,3575890342,3575890343,1
3,1151,31649,3575890342,3575890344,2
3,1151,31650,3575890342,3575890344,2
3,1151,31651,3575890342,3575890348,6
3,1151,31652,3575890342,3575890352,10
3,1151,31653,3575890342,3575890354,12
3,1151,31654,3575890342,3575890361,19
3,1151,31655,3575890342,3575890361,19
3,1151,31656,3575890342,3575890363,21
3,1151,31657,3575890342,3575890364,22
3,1151,31658,3575890342,3575890368,26
3,1151,31659,3575890342,3575890370,28
3,1151,31660,3575890342,3575890371,29
3,1151,31661,3575890342,3575890371,29
3,1151,31662,3575890342,3575890374,32
3,1151,31663,3575890342,3575890377,35
3,1151,31664,3575890342,3575890380,38
3,1151,31665,3575890342,3575890380,38
3,1151,31666,3575890342,3575890381,39
3,1151,31667,3575890342,3575890382,40
3,1151,31668,3575890342,3575890382,40
3,1151,31669,3575890342,3575890383,41
3,1151,31670,3575890342,3575890385,43
3,1151,31671,3575890342,3575890386,44
3,1151,31672,3575890342,3575890389,47
3,1151,31673,3575890342,3575890390,48
3,1151,31674,3575890342,3575890391,49
3,1151,31675,3575890342,3575890391,49
3,1152,31676,3575890405,3575890405,0
3,1152,31677,3575890405,3575890405,0
3,1152,31678,3575890405,3575890405,0
3,1152,31679,3575890405,3575890405,0
3,1152,31680,3575890405,3575890405,0
3,1152,31681,3575890405,3575890405,0
3,1152,31682,3575890405,3575890405,0
3,1152,31683,3575890405,3575890405,0
3,1152,31684,3575890405,3575890405,0
3,1152,31685,3575890405,3575890405,0
3,1152,31686,3575890405,3575890405,0
3,1152,31687,3575890405,3575890405,0
3,1152,31688,3575890405,3575890405,0
3,1152,31689,3575890405,3575890405,0
3,1152,31690,3575890405,3575890405,0
3,1152,31691,3575890405,3575890405,0
3,1152,31692,3575890405,3575890407,2
3,1152,31693,3575890405,3575890411,6
3,1152,31694,3575890405,3575890415,10
3,1152,31695,3575890405,3575890417,12
3,1152,31696,3575890405,3575890417,12
3,1152,31697,3575890405,3575890418,13
3,1152,31698,3575890405,3575890420,15
3,1152,31699,3575890405,3575890420,15
3,1152,31700,3575890405,3575890423,18
3,1152,31701,3575890405,3575890425,20
3,1152,31702,3575890405,3575890427,22
3,1152,31703,3575890405,3575890428,23
3,1152,31704,3575890405,3575890428,23
3,1152,31705,3575890405,3575890428,23
3,1152,31706,3575890405,3575890428,23
3,1152,31707,3575890405,3575890429,24
3,1152,31708,3575890405,3575890431,26
3,1152,31709,3575890405,3575890432,27
3,1152,31710,3575890405,3575890433,28
3,1152,31711,3575890405,3575890435,30
3,1152,31712,3575890405,3575890437,32
3,1152,31713,3575890405,3575890438,33
3,1152,31714,3575890405,3575890438,33
3,1152,31715,3575890405,3575890438,33
3,1152,31716,3575890405,3575890438,33
3,1152,31717,3575890405,3575890439,34
3,1152,31718,3575890405,3575890440,35
3,1152,31719,3575890405,3575890440,35
3,1152,31720,3575890405,3575890441,36
3,1152,31721,3575890405,3575890441,36
3,1152,31722,3575890405,3575890444,39
3,1152,31723,3575890405,3575890444,39
3,1152,31724,3575890405,3575890444,39
3,1152,31725,3575890405,3575890446,41
3,1152,31726,3575890405,3575890449,44
3,1152,31727,3575890405,3575890449,44
3,1152,31728,3575890405,3575890450,45
3,1152,31729,3575890405,3575890453,48
3,1152,31730,3575890405,3575890453,48
3,1152,31731,3575890405,3575890453,48
3,1153,31732,3575890473,3575890473,0
3,1153,31733,3575890473,3575890473,0
3,1153,31734,3575890473,3575890473,0
3,1153,31735,3575890473,3575890473,0
3,1153,31736,3575890473,3575890473,0
3,1153,31737,3575890473,3575890473,0
3,1153,31738,3575890473,3575890473,0
3,1153,31739,3575890473,3575890473,0
3,1153,31740,3575890473,3575890473,0
3,1153,31741,3575890473,3575890473,0
3,1153,31742,3575890473,3575890473,0
3,1153,31743,3575890473,3575890473,0
3,1153,31744,3575890473,3575890473,0
3,1153,31745,3575890473,3575890473,0
3,1153,31746,3575890473,3575890476,3
3,1153,31747,3575890473,3575890477,4
3,1153,31748,3575890473,3575890481,8
3,1153,31749,3575890473,3575890481,8
3,1153,31750,3575890473,3575890483,10
3,1153,31751,3575890473,3575890485,12
3,1153,31752,3575890473,3575890485,12
3,1153,31753,3575890473,3575890485,12
3,1153,31754,3575890473,3575890486,13
3,1153,31755,3575890473,3575890486,13
3,1153,31756,3575890473,3575890488,15
3,1153,31757,3575890473,3575890488,15
3,1153,31758,3575890473,3575890491,18
3,1153,31759,3575890473,3575890491,18
3,1153,31760,3575890473,3575890491,18
3,1153,31761,3575890473,3575890492,19
3,1153,31762,3575890473,3575890497,24
3,1153,31763,3575890473,3575890497,24
3,1153,31764,3575890473,3575890501,28
3,1153,31765,3575890473,3575890502,29
3,1153,31766,3575890473,3575890502,29
3,1153,31767,3575890473,3575890502,29
3,1153,31768,3575890473,3575890503,30
3,1153,31769,3575890473,3575890505,32
3,1153,31770,3575890473,3575890506,33
3,1153,31771,3575890473,3575890506,33
3,1153,31772,3575890473,3575890511,38
3,1153,31773,3575890473,3575890511,38
3,1153,31774,3575890473,3575890513,40
3,1153,31775,3575890473,3575890514,41
3,1153,31776,3575890473,3575890514,41
3,1153,31777,3575890473,3575890516,43
3,1153,31778,3575890473,3575890519,46
3,1153,31779,3575890473,3575890519,46
3,1153,31780,3575890473,3575890520,47
3,1153,31781,3575890473,3575890522,49
3,1153,31782,3575890473,3575890523,50
3,1154,31783,3575890535,3575890535,0
3,1154,31784,3575890535,3575890535,0
3,1154,31785,3575890535,3575890535,0
3,1154,31786,3575890535,3575890535,0
3,1154,31787,3575890535,3575890535,0
3,1154,31788,3575890535,3575890535,0
3,1154,31789,3575890535,3575890535,0
3,1154,31790,3575890535,3575890536,1
3,1154,31791,3575890535,3575890537,2
3,1154,31792,3575890535,3575890540,5
3,1154,31793,3575890535,3575890542,7
3,1154,31794,3575890535,3575890542,7
3,1154,31795,3575890535,3575890543,8
3,1154,31796,3575890535,3575890543,8
3,1154,31797,3575890535,3575890543,8
3,1154,31798,3575890535,3575890548,13
3,1154,31799,3575890535,3575890551,16
3,1154,31800,3575890535,3575890559,24
3,1154,31801,3575890535,3575890560,25
3,1154,31802,3575890535,3575890561,26
3,1154,31803,3575890535,3575890563,28
3,1154,31804,3575890535,3575890563,28
3,1154,31805,3575890535,3575890568,33
3,1154,31806,3575890535,3575890568,33
3,1154,31807,3575890535,3575890570,35
3,1154,31808,3575890535,3575890570,35
3,1154,31809,3575890535,3575890570,35
3,1154,31810,3575890535,3575890574,39
3,1154,31811,3575890535,3575890576,41
3,1154,31812,3575890535,3575890579,44
3,1154,31813,3575890535,3575890579,44
3,1154,31814,3575890535,3575890580,45
3,1154,31815,3575890535,3575890580,45
3,1154,31816,3575890535,3575890581,46
3,1154,31817,3575890535,3575890581,46
3,1155,31818,3575890597,3575890597,0
3,1155,31819,3575890597,3575890597,0
3,1155,31820,3575890597,3575890597,0
3,1155,31821,3575890597,3575890597,0
3,1155,31822,3575890597,3575890597,0
3,1155,31823,3575890597,3575890597,0
3,1155,31824,3575890597,3575890597,0
3,1155,31825,3575890597,3575890597,0
3,1155,31826,3575890597,3575890597,0
3,1155,31827,3575890597,3575890597,0
3,1155,31828,3575890597,3575890597,0
3,1155,31829,3575890597,3575890597,0
3,1155,31830,3575890597,3575890597,0
3,1155,31831,3575890597,3575890597,0
3,1155,31832,3575890597,3575890598,1
3,1155,31833,3575890597,3575890599,2
3,1155,31834,3575890597,3575890600,3
3,1155,31835,3575890597,3575890602,5
3,1155,31836,3575890597,3575890603,6
3,1155,31837,3575890597,3575890606,9
3,1155,31838,3575890597,3575890610,13
3,1155,31839,3575890597,3575890614,17
3,1155,31840,3575890597,3575890616,19
3,1155,31841,3575890597,3575890617,20
3,1155,31842,3575890597,3575890618,21
3,1155,31843,3575890597,3575890619,22
3,1155,31844,3575890597,3575890620,23
3,1155,31845,3575890597,3575890620,23
3,1155,31846,3575890597,3575890621,24
3,1155,31847,3575890597,3575890623,26
3,1155,31848,3575890597,3575890625,28
3,1155,31849,3575890597,3575890625,28
3,1155,31850,3575890597,3575890627,30
3,1155,31851,3575890597,3575890627,30
3,1155,31852,3575890597,3575890627,30
3,1155,31853,3575890597,3575890628,31
3,1155,31854,3575890597,3575890628,31
3,1155,31855,3575890597,3575890629,32
3,1155,31856,3575890597,3575890630,33
3,1155,31857,3575890597,3575890631,34
3,1155,31858,3575890597,3575890632,35
3,1155,31859,3575890597,3575890633,36
3,1155,31860,3575890597,3575890637,40
3,1155,31861,3575890597,3575890637,40
3,1155,31862,3575890597,3575890637,40
3,1155,31863,3575890597,3575890637,40
3,1155,31864,3575890597,3575890637,40
3,1155,31865,3575890597,3575890639,42
3,1155,31866,3575890597,3575890639,42
3,1155,31867,3575890597,3575890640,43
3,1155,31868,3575890597,3575890640,43
3,1155,31869,3575890597,3575890643,46
3,1155,31870,3575890597,3575890643,46
3,1156,31871,3575890661,3575890661,0
3,1156,31872,3575890661,3575890661,0
3,1156,31873,3575890661,3575890661,0
3,1156,31874,3575890661,3575890661,0
3,1156,31875,3575890661,3575890661,0
3,1156,31876,3575890661,3575890661,0
3,1156,31877,3575890661,3575890661,0
3,1156,31878,3575890661,3575890661,0
3,1156,31879,3575890661,3575890661,0
3,1156,31880,3575890661,3575890661,0
3,1156,31881,3575890661,3575890662,1
3,1156,31882,3575890661,3575890663,2
3,1156,31883,3575890661,3575890663,2
3,1156,31884,3575890661,3575890663,2
3,1156,31885,3575890661,3575890664,3
3,1156,31886,3575890661,3575890666,5
3,1156,31887,3575890661,3575890666,5
3,1156,31888,3575890661,3575890667,6
3,1156,31889,3575890661,3575890669,8
3,1156,31890,3575890661,3575890672,11
3,1156,31891,3575890661,3575890676,15
3,1156,31892,3575890661,3575890677,16
3,1156,31893,3575890661,3575890681,20
3,1156,31894,3575890661,3575890681,20
3,1156,31895,3575890661,3575890683,22
3,1156,31896,3575890661,3575890685,24
3,1156,31897,3575890661,3575890685,24
3,1156,31898,3575890661,3575890686,25
3,1156,31899,3575890661,3575890686,25
3,1156,31900,3575890661,3575890687,26
3,1156,31901,3575890661,3575890688,27
3,1156,31902,3575890661,3575890688,27
3,1156,31903,3575890661,3575890691,30
3,1156,31904,3575890661,3575890691,30
3,1156,31905,3575890661,3575890691,30
3,1156,31906,3575890661,3575890692,31
3,1156,31907,3575890661,3575890692,31
3,1156,31908,3575890661,3575890697,36
3,1156,31909,3575890661,3575890698,37
3,1156,31910,3575890661,3575890698,37
3,1156,31911,3575890661,3575890702,41
3,1156,31912,3575890661,3575890702,41
3,1156,31913,3575890661,3575890703,42
3,1156,31914,3575890661,3575890704,43
3,1156,31915,3575890661,3575890705,44
3,1156,31916,3575890661,3575890706,45
3,1156,31917,3575890661,3575890706,45
3,1156,31918,3575890661,3575890707,46
3,1157,31919,3575890724,3575890724,0
3,1157,31920,3575890724,3575890724,0
3,1157,31921,3575890724,3575890724,0
3,1157,31922,3575890724,3575890724,0
3,1157,31923,3575890724,3575890724,0
3,1157,31924,3575890724,3575890724,0
3,1157,31925,3575890724,3575890724,0
3,1157,31926,3575890724,3575890724,0
3,1157,31927,3575890724,3575890724,0
3,1157,31928,3575890724,3575890724,0
3,1157,31929,3575890724,3575890724,0
3,1157,31930,3575890724,3575890728,4
3,1157,31931,3575890724,3575890729,5
3,1157,31932,3575890724,3575890732,8
3,1157,31933,3575890724,3575890733,9
3,1157,31934,3575890724,3575890734,10
3,1157,31935,3575890724,3575890736,12
3,1157,31936,3575890724,3575890737,13
3,1157,31937,3575890724,3575890740,16
3,1157,31938,3575890724,3575890742,18
3,1157,31939,3575890724,3575890743,19
3,1157,31940,3575890724,3575890743,19
3,1157,31941,3575890724,3575890743,19
3,1157,31942,3575890724,3575890744,20
3,1157,31943,3575890724,3575890751,27
3,1157,31944,3575890724,3575890754,30
3,1157,31945,3575890724,3575890759,35
3,1157,31946,3575890724,3575890760,36
3,1157,31947,3575890724,3575890760,36
3,1157,31948,3575890724,3575890762,38
3,1157,31949,3575890724,3575890763,39
3,1157,31950,3575890724,3575890768,44
3,1157,31951,3575890724,3575890769,45
3,1157,31952,3575890724,3575890770,46
3,1157,31953,3575890724,3575890770,46
3,1158,31954,3575890786,3575890786,0
3,1158,31955,3575890786,3575890786,0
3,1158,31956,3575890786,3575890786,0
3,1158,31957,3575890786,3575890786,0
3,1158,31958,3575890786,3575890786,0
3,1158,31959,3575890786,3575890786,0
3,1158,31960,3575890786,3575890786,0
3,1158,31961,3575890786,3575890786,0
3,1158,31962,3575890786,3575890786,0
3,1158,31963,3575890786,3575890786,0
3,1158,31964,3575890786,3575890786,0
3,1158,31965,3575890786,3575890788,2
3,1158,31966,3575890786,3575890789,3
3,1158,31967,3575890786,3575890790,4
3,1158,31968,3575890786,3575890791,5
3,1158,31969,3575890786,3575890792,6
3,1158,31970,3575890786,3575890793,7
3,1158,31971,3575890786,3575890795,9
3,1158,31972,3575890786,3575890795,9
3,1158,31973,3575890786,3575890796,10
3,1158,31974,3575890786,3575890796,10
3,1158,31975,3575890786,3575890796,10
3,1158,31976,3575890786,3575890798,12
3,1158,31977,3575890786,3575890798,12
3,1158,31978,3575890786,3575890799,13
3,1158,31979,3575890786,3575890799,13
3,1158,31980,3575890786,3575890799,13
3,1158,31981,3575890786,3575890800,14
3,1158,31982,3575890786,3575890802,16
3,1158,31983,3575890786,3575890803,17
3,1158,31984,3575890786,3575890803,17
3,1158,31985,3575890786,3575890806,20
3,1158,31986,3575890786,3575890814,28
3,1158,31987,3575890786,3575890816,30
3,1158,31988,3575890786,3575890818,32
3,1158,31989,3575890786,3575890819,33
3,1158,31990,3575890786,3575890819,33
3,1158,31991,3575890786,3575890820,34
3,1158,31992,3575890786,3575890823,37
3,1158,31993,3575890786,3575890825,39
3,1158,31994,3575890786,3575890826,40
3,1158,31995,3575890786,3575890827,41
3,1158,31996,3575890786,3575890827,41
3,1158,31997,3575890786,3575890828,42
3,1158,31998,3575890786,3575890828,42
3,1158,31999,3575890786,3575890828,42
3,1158,32000,3575890786,3575890829,43
3,1158,32001,3575890786,3575890831,45
3,1158,32002,3575890786,3575890831,45
3,1158,32003,3575890786,3575890832,46
3,1158,32004,3575890786,3575890834,48
3,1159,32005,3575890850,3575890850,0
3,1159,32006,3575890850,3575890850,0
3,1159,32007,3575890850,3575890850,0
3,1159,32008,3575890850,3575890850,0
3,1159,32009,3575890850,3575890850,0
3,1159,32010,3575890850,3575890850,0
3,1159,32011,3575890850,3575890850,0
3,1159,32012,3575890850,3575890850,0
3,1159,32013,3575890850,3575890850,0
3,1159,32014,3575890850,3575890850,0
3,1159,32015,3575890850,3575890850,0
3,1159,32016,3575890850,3575890850,0
3,1159,32017,3575890850,3575890850,0
3,1159,32018,3575890850,3575890851,1
3,1159,32019,3575890850,3575890851,1
3,1159,32020,3575890850,3575890853,3
3,1159,32021,3575890850,3575890856,6
3,1159,32022,3575890850,3575890856,6
3,1159,32023,3575890850,3575890860,10
3,1159,32024,3575890850,3575890861,11
3,1159,32025,3575890850,3575890862,12
3,1159,32026,3575890850,3575890862,12
3,1159,32027,3575890850,3575890862,12
3,1159,32028,3575890850,3575890863,13
3,1159,32029,3575890850,3575890864,14
3,1159,32030,3575890850,3575890864,14
3,1159,32031,3575890850,3575890866,16
3,1159,32032,3575890850,3575890867,17
3,1159,32033,3575890850,3575890867,17
3,1159,32034,3575890850,3575890868,18
3,1159,32035,3575890850,3575890873,23
3,1159,32036,3575890850,3575890876,26
3,1159,32037,3575890850,3575890877,27
3,1159,32038,3575890850,3575890881,31
3,1159,32039,3575890850,3575890882,32
3,1159,32040,3575890850,3575890883,33
3,1159,32041,3575890850,3575890885,35
3,1159,32042,3575890850,3575890885,35
3,1159,32043,3575890850,3575890886,36
3,1159,32044,3575890850,3575890888,38
3,1159,32045,3575890850,3575890888,38
3,1159,32046,3575890850,3575890890,40
3,1159,32047,3575890850,3575890891,41
3,1159,32048,3575890850,3575890891,41
3,1159,32049,3575890850,3575890891,41
3,1159,32050,3575890850,3575890892,42
3,1159,32051,3575890850,3575890897,47
3,1159,32052,3575890850,3575890898,48
3,1159,32053,3575890850,3575890898,48
3,1160,32054,3575890914,3575890914,0
3,1160,32055,3575890914,3575890914,0
3,1160,32056,3575890914,3575890914,0
3,1160,32057,3575890914,3575890914,0
3,1160,32058,3575890914,3575890914,0
3,1160,32059,3575890914,3575890914,0
3,1160,32060,3575890914,3575890914,0
3,1160,32061,3575890914,3575890915,1
3,1160,32062,3575890914,3575890915,1
3,1160,32063,3575890914,3575890915,1
3,1160,32064,3575890914,3575890915,1
3,1160,32065,3575890914,3575890915,1
3,1160,32066,3575890914,3575890915,1
3,1160,32067,3575890914,3575890915,1
3,1160,32068,3575890914,3575890915,1
3,1160,32069,3575890914,3575890915,1
3,1160,32070,3575890914,3575890919,5
3,1160,32071,3575890914,3575890919,5
3,1160,32072,3575890914,3575890920,6
3,1160,32073,3575890914,3575890921,7
3,1160,32074,3575890914,3575890922,8
3,1160,32075,3575890914,3575890923,9
3,1160,32076,3575890914,3575890928,14
3,1160,32077,3575890914,3575890928,14
3,1160,32078,3575890914,3575890928,14
3,1160,32079,3575890914,3575890932,18
3,1160,32080,3575890914,3575890932,18
3,1160,32081,3575890914,3575890934,20
3,1160,32082,3575890914,3575890934,20
3,1160,32083,3575890914,3575890937,23
3,1160,32084,3575890914,3575890937,23
3,1160,32085,3575890914,3575890941,27
3,1160,32086,3575890914,3575890942,28
3,1160,32087,3575890914,3575890943,29
3,1160,32088,3575890914,3575890943,29
3,1160,32089,3575890914,3575890943,29
3,1160,32090,3575890914,3575890944,30
3,1160,32091,3575890914,3575890952,38
3,1160,32092,3575890914,3575890954,40
3,1160,32093,3575890914,3575890959,45
3,1160,32094,3575890914,3575890960,46
3,1160,32095,3575890914,3575890961,47
3,1160,32096,3575890914,3575890962,48
3,1160,32097,3575890914,3575890964,50
3,1161,32098,3575890977,3575890977,0
3,1161,32099,3575890977,3575890977,0
3,1161,32100,3575890977,3575890977,0
3,1161,32101,3575890977,3575890977,0
3,1161,32102,3575890977,3575890977,0
3,1161,32103,3575890977,3575890977,0
3,1161,32104,3575890977,3575890977,0
3,1161,32105,3575890977,3575890979,2
3,1161,32106,3575890977,3575890980,3
3,1161,32107,3575890977,3575890980,3
3,1161,32108,3575890977,3575890981,4
3,1161,32109,3575890977,3575890981,4
3,1161,32110,3575890977,3575890982,5
3,1161,32111,3575890977,3575890986,9
3,1161,32112,3575890977,3575890986,9
3,1161,32113,3575890977,3575890987,10
3,1161,32114,3575890977,3575890991,14
3,1161,32115,3575890977,3575890991,14
3,1161,32116,3575890977,3575890991,14
3,1161,32117,3575890977,3575890992,15
3,1161,32118,3575890977,3575890993,16
3,1161,32119,3575890977,3575890995,18
3,1161,32120,3575890977,3575890995,18
3,1161,32121,3575890977,3575890996,19
3,1161,32122,3575890977,3575890996,19
3,1161,32123,3575890977,3575890996,19
3,1161,32124,3575890977,3575890998,21
3,1161,32125,3575890977,3575890999,22
3,1161,32126,3575890977,3575890999,22
3,1161,32127,3575890977,3575891000,23
3,1161,32128,3575890977,3575891000,23
3,1161,32129,3575890977,3575891002,25
3,1161,32130,3575890977,3575891002,25
3,1161,32131,3575890977,3575891002,25
3,1161,32132,3575890977,3575891003,26
3,1161,32133,3575890977,3575891006,29
3,1161,32134,3575890977,3575891011,34
3,1161,32135,3575890977,3575891015,38
3,1161,32136,3575890977,3575891016,39
3,1161,32137,3575890977,3575891017,40
3,1161,32138,3575890977,3575891018,41
3,1161,32139,3575890977,3575891019,42
3,1161,32140,3575890977,3575891020,43
3,1161,32141,3575890977,3575891025,48
3,1161,32142,3575890977,3575891025,48
3,1161,32143,3575890977,3575891027,50
3,1162,32144,3575891041,3575891041,0
3,1162,32145,3575891041,3575891041,0
3,1162,32146,3575891041,3575891041,0
3,1162,32147,3575891041,3575891041,0
3,1162,32148,3575891041,3575891041,0
3,1162,32149,3575891041,3575891041,0
3,1162,32150,3575891041,3575891041,0
3,1162,32151,3575891041,3575891041,0
3,1162,32152,3575891041,3575891041,0
3,1162,32153,3575891041,3575891041,0
3,1162,32154,3575891041,3575891041,0
3,1162,32155,3575891041,3575891041,0
3,1162,32156,3575891041,3575891041,0
3,1162,32157,3575891041,3575891041,0
3,1162,32158,3575891041,3575891041,0
3,1162,32159,3575891041,3575891041,0
3,1162,32160,3575891041,3575891043,2
3,1162,32161,3575891041,3575891044,3
3,1162,32162,3575891041,3575891044,3
3,1162,32163,3575891041,3575891045,4
3,1162,32164,3575891041,3575891049,8
3,1162,32165,3575891041,3575891049,8
3,1162,32166,3575891041,3575891050,9
3,1162,32167,3575891041,3575891052,11
3,1162,32168,3575891041,3575891052,11
3,1162,32169,3575891041,3575891053,12
3,1162,32170,3575891041,3575891057,16
3,1162,32171,3575891041,3575891058,17
3,1162,32172,3575891041,3575891059,18
3,1162,32173,3575891041,3575891062,21
3,1162,32174,3575891041,3575891062,21
3,1162,32175,3575891041,3575891062,21
3,1162,32176,3575891041,3575891063,22
3,1162,32177,3575891041,3575891063,22
3,1162,32178,3575891041,3575891064,23
3,1162,32179,3575891041,3575891065,24
3,1162,32180,3575891041,3575891066,25
3,1162,32181,3575891041,3575891067,26
3,1162,32182,3575891041,3575891067,26
3,1162,32183,3575891041,3575891069,28
3,1162,32184,3575891041,3575891073,32
3,1162,32185,3575891041,3575891076,35
3,1162,32186,3575891041,3575891077,36
3,1162,32187,3575891041,3575891081,40
3,1162,32188,3575891041,3575891082,41
3,1162,32189,3575891041,3575891083,42
3,1162,32190,3575891041,3575891085,44
3,1162,32191,3575891041,3575891085,44
3,1162,32192,3575891041,3575891085,44
3,1162,32193,3575891041,3575891088,47
3,1162,32194,3575891041,3575891090,49
3,1162,32195,3575891041,3575891091,50
3,1163,32196,3575891103,3575891103,0
3,1163,32197,3575891103,3575891103,0
3,1163,32198,3575891103,3575891103,0
3,1163,32199,3575891103,3575891103,0
3,1163,32200,3575891103,3575891103,0
3,1163,32201,3575891103,3575891103,0
3,1163,32202,3575891103,3575891103,0
3,1163,32203,3575891103,3575891103,0
3,1163,32204,3575891103,3575891103,0
3,1163,32205,3575891103,3575891103,0
3,1163,32206,3575891103,3575891103,0
3,1163,32207,3575891103,3575891106,3
3,1163,32208,3575891103,3575891106,3
3,1163,32209,3575891103,3575891106,3
3,1163,32210,3575891103,3575891108,5
3,1163,32211,3575891103,3575891111,8
3,1163,32212,3575891103,3575891112,9
3,1163,32213,3575891103,3575891112,9
3,1163,32214,3575891103,3575891113,10
3,1163,32215,3575891103,3575891114,11
3,1163,32216,3575891103,3575891115,12
3,1163,32217,3575891103,3575891116,13
3,1163,32218,3575891103,3575891119,16
3,1163,32219,3575891103,3575891119,16
3,1163,32220,3575891103,3575891121,18
3,1163,32221,3575891103,3575891121,18
3,1163,32222,3575891103,3575891124,21
3,1163,32223,3575891103,3575891128,25
3,1163,32224,3575891103,3575891128,25
3,1163,32225,3575891103,3575891128,25
3,1163,32226,3575891103,3575891131,28
3,1163,32227,3575891103,3575891133,30
3,1163,32228,3575891103,3575891133,30
3,1163,32229,3575891103,3575891135,32
3,1163,32230,3575891103,3575891137,34
3,1163,32231,3575891103,3575891138,35
3,1163,32232,3575891103,3575891141,38
3,1163,32233,3575891103,3575891142,39
3,1163,32234,3575891103,3575891142,39
3,1163,32235,3575891103,3575891143,40
3,1163,32236,3575891103,3575891144,41
3,1163,32237,3575891103,3575891144,41
3,1163,32238,3575891103,3575891152,49
3,1164,32239,3575891169,3575891169,0
3,1164,32240,3575891169,3575891169,0
3,1164,32241,3575891169,3575891169,0
3,1164,32242,3575891169,3575891169,0
3,1164,32243,3575891169,3575891169,0
3,1164,32244,3575891169,3575891169,0
3,1164,32245,3575891169,3575891169,0
3,1164,32246,3575891169,3575891169,0
3,1164,32247,3575891169,3575891170,1
3,1164,32248,3575891169,3575891170,1
3,1164,32249,3575891169,3575891172,3
3,1164,32250,3575891169,3575891175,6
3,1164,32251,3575891169,3575891176,7
3,1164,32252,3575891169,3575891180,11
3,1164,32253,3575891169,3575891180,11
3,1164,32254,3575891169,3575891181,12
3,1164,32255,3575891169,3575891182,13
3,1164,32256,3575891169,3575891182,13
3,1164,32257,3575891169,3575891185,16
3,1164,32258,3575891169,3575891187,18
3,1164,32259,3575891169,3575891187,18
3,1164,32260,3575891169,3575891190,21
3,1164,32261,3575891169,3575891191,22
3,1164,32262,3575891169,3575891191,22
3,1164,32263,3575891169,3575891192,23
3,1164,32264,3575891169,3575891193,24
3,1164,32265,3575891169,3575891195,26
3,1164,32266,3575891169,3575891195,26
3,1164,32267,3575891169,3575891196,27
3,1164,32268,3575891169,3575891196,27
3,1164,32269,3575891169,3575891198,29
3,1164,32270,3575891169,3575891198,29
3,1164,32271,3575891169,3575891199,30
3,1164,32272,3575891169,3575891199,30
3,1164,32273,3575891169,3575891200,31
3,1164,32274,3575891169,3575891202,33
3,1164,32275,3575891169,3575891203,34
3,1164,32276,3575891169,3575891204,35
3,1164,32277,3575891169,3575891206,37
3,1164,32278,3575891169,3575891212,43
3,1164,32279,3575891169,3575891216,47
3,1164,32280,3575891169,3575891216,47
3,1164,32281,3575891169,3575891217,48
3,1164,32282,3575891169,3575891218,49
3,1165,32283,3575891233,3575891234,1
3,1165,32284,3575891233,3575891234,1
3,1165,32285,3575891233,3575891234,1
3,1165,32286,3575891233,3575891234,1
3,1165,32287,3575891233,3575891234,1
3,1165,32288,3575891233,3575891234,1
3,1165,32289,3575891233,3575891234,1
3,1165,32290,3575891233,3575891234,1
3,1165,32291,3575891233,3575891234,1
3,1165,32292,3575891233,3575891234,1
3,1165,32293,3575891233,3575891234,1
3,1165,32294,3575891233,3575891234,1
3,1165,32295,3575891233,3575891234,1
3,1165,32296,3575891233,3575891234,1
3,1165,32297,3575891233,3575891234,1
3,1165,32298,3575891233,3575891237,4
3,1165,32299,3575891233,3575891237,4
3,1165,32300,3575891233,3575891238,5
3,1165,32301,3575891233,3575891239,6
3,1165,32302,3575891233,3575891239,6
3,1165,32303,3575891233,3575891239,6
3,1165,32304,3575891233,3575891240,7
3,1165,32305,3575891233,3575891241,8
3,1165,32306,3575891233,3575891243,10
3,1165,32307,3575891233,3575891243,10
3,1165,32308,3575891233,3575891246,13
3,1165,32309,3575891233,3575891249,16
3,1165,32310,3575891233,3575891249,16
3,1165,32311,3575891233,3575891251,18
3,1165,32312,3575891233,3575891252,19
3,1165,32313,3575891233,3575891252,19
3,1165,32314,3575891233,3575891253,20
3,1165,32315,3575891233,3575891258,25
3,1165,32316,3575891233,3575891258,25
3,1165,32317,3575891233,3575891259,26
3,1165,32318,3575891233,3575891262,29
3,1165,32319,3575891233,3575891263,30
3,1165,32320,3575891233,3575891263,30
3,1165,32321,3575891233,3575891264,31
3,1165,32322,3575891233,3575891264,31
3,1165,32323,3575891233,3575891264,31
3,1165,32324,3575891233,3575891264,31
3,1165,32325,3575891233,3575891266,33
3,1165,32326,3575891233,3575891267,34
3,1165,32327,3575891233,3575891268,35
3,1165,32328,3575891233,3575891270,37
3,1165,32329,3575891233,3575891273,40
3,1165,32330,3575891233,3575891277,44
3,1165,32331,3575891233,3575891277,44
3,1165,32332,3575891233,3575891281,48
3,1165,32333,3575891233,3575891282,49
3,1165,32334,3575891233,3575891283,50
3,1166,32335,3575891295,3575891296,1
3,1166,32336,3575891295,3575891296,1
3,1166,32337,3575891295,3575891296,1
3,1166,32338,3575891295,3575891296,1
3,1166,32339,3575891295,3575891296,1
3,1166,32340,3575891295,3575891296,1
3,1166,32341,3575891295,3575891296,1
3,1166,32342,3575891295,3575891296,1
3,1166,32343,3575891295,3575891296,1
3,1166,32344,3575891295,3575891296,1
3,1166,32345,3575891295,3575891296,1
3,1166,32346,3575891295,3575891297,2
3,1166,32347,3575891295,3575891300,5
3,1166,32348,3575891295,3575891301,6
3,1166,32349,3575891295,3575891302,7
3,1166,32350,3575891295,3575891303,8
3,1166,32351,3575891295,3575891303,8
3,1166,32352,3575891295,3575891303,8
3,1166,32353,3575891295,3575891306,11
3,1166,32354,3575891295,3575891306,11
3,1166,32355,3575891295,3575891306,11
3,1166,32356,3575891295,3575891307,12
3,1166,32357,3575891295,3575891312,17
3,1166,32358,3575891295,3575891313,18
3,1166,32359,3575891295,3575891313,18
3,1166,32360,3575891295,3575891314,19
3,1166,32361,3575891295,3575891315,20
3,1166,32362,3575891295,3575891315,20
3,1166,32363,3575891295,3575891319,24
3,1166,32364,3575891295,3575891319,24
3,1166,32365,3575891295,3575891321,26
3,1166,32366,3575891295,3575891321,26
3,1166,32367,3575891295,3575891322,27
3,1166,32368,3575891295,3575891324,29
3,1166,32369,3575891295,3575891328,33
3,1166,32370,3575891295,3575891328,33
3,1166,32371,3575891295,3575891328,33
3,1166,32372,3575891295,3575891332,37
3,1166,32373,3575891295,3575891332,37
3,1166,32374,3575891295,3575891333,38
3,1166,32375,3575891295,3575891335,40
3,1166,32376,3575891295,3575891337,42
3,1166,32377,3575891295,3575891338,43
3,1166,32378,3575891295,3575891341,46
3,1166,32379,3575891295,3575891343,48
3,1166,32380,3575891295,3575891343,48
3,1166,32381,3575891295,3575891344,49
3,1166,32382,3575891295,3575891344,49
3,1166,32383,3575891295,3575891344,49
3,1167,32384,3575891357,3575891357,0
3,1167,32385,3575891357,3575891357,0
3,1167,32386,3575891357,3575891357,0
3,1167,32387,3575891357,3575891359,2
3,1167,32388,3575891357,3575891361,4
3,1167,32389,3575891357,3575891361,4
3,1167,32390,3575891357,3575891364,7
3,1167,32391,3575891357,3575891365,8
3,1167,32392,3575891357,3575891368,11
3,1167,32393,3575891357,3575891369,12
3,1167,32394,3575891357,3575891370,13
3,1167,32395,3575891357,3575891371,14
3,1167,32396,3575891357,3575891372,15
3,1167,32397,3575891357,3575891376,19
3,1167,32398,3575891357,3575891377,20
3,1167,32399,3575891357,3575891379,22
3,1167,32400,3575891357,3575891380,23
3,1167,32401,3575891357,3575891381,24
3,1167,32402,3575891357,3575891381,24
3,1167,32403,3575891357,3575891381,24
3,1167,32404,3575891357,3575891381,24
3,1167,32405,3575891357,3575891383,26
3,1167,32406,3575891357,3575891387,30
3,1167,32407,3575891357,3575891387,30
3,1167,32408,3575891357,3575891387,30
3,1167,32409,3575891357,3575891390,33
3,1167,32410,3575891357,3575891391,34
3,1167,32411,3575891357,3575891391,34
3,1167,32412,3575891357,3575891393,36
3,1167,32413,3575891357,3575891393,36
3,1167,32414,3575891357,3575891395,38
3,1167,32415,3575891357,3575891396,39
3,1167,32416,3575891357,3575891396,39
3,1167,32417,3575891357,3575891397,40
3,1167,32418,3575891357,3575891398,41
3,1167,32419,3575891357,3575891399,42
3,1167,32420,3575891357,3575891399,42
3,1167,32421,3575891357,3575891399,42
3,1167,32422,3575891357,3575891400,43
3,1167,32423,3575891357,3575891401,44
3,1167,32424,3575891357,3575891403,46
3,1167,32425,3575891357,3575891403,46
3,1167,32426,3575891357,3575891407,50
3,1168,32427,3575891421,3575891421,0
3,1168,32428,3575891421,3575891421,0
3,1168,32429,3575891421,3575891421,0
3,1168,32430,3575891421,3575891421,0
3,1168,32431,3575891421,3575891421,0
3,1168,32432,3575891421,3575891421,0
3,1168,32433,3575891421,3575891421,0
3,1168,32434,3575891421,3575891421,0
3,1168,32435,3575891421,3575891422,1
3,1168,32436,3575891421,3575891423,2
3,1168,32437,3575891421,3575891425,4
3,1168,32438,3575891421,3575891426,5
3,1168,32439,3575891421,3575891427,6
3,1168,32440,3575891421,3575891428,7
3,1168,32441,3575891421,3575891428,7
3,1168,32442,3575891421,3575891429,8
3,1168,32443,3575891421,3575891431,10
3,1168,32444,3575891421,3575891431,10
3,1168,32445,3575891421,3575891433,12
3,1168,32446,3575891421,3575891435,14
3,1168,32447,3575891421,3575891437,16
3,1168,32448,3575891421,3575891437,16
3,1168,32449,3575891421,3575891438,17
3,1168,32450,3575891421,3575891439,18
3,1168,32451,3575891421,3575891439,18
3,1168,32452,3575891421,3575891439,18
3,1168,32453,3575891421,3575891440,19
3,1168,32454,3575891421,3575891441,20
3,1168,32455,3575891421,3575891443,22
3,1168,32456,3575891421,3575891444,23
3,1168,32457,3575891421,3575891446,25
3,1168,32458,3575891421,3575891449,28
3,1168,32459,3575891421,3575891449,28
3,1168,32460,3575891421,3575891451,30
3,1168,32461,3575891421,3575891452,31
3,1168,32462,3575891421,3575891452,31
3,1168,32463,3575891421,3575891453,32
3,1168,32464,3575891421,3575891457,36
3,1168,32465,3575891421,3575891458,37
3,1168,32466,3575891421,3575891460,39
3,1168,32467,3575891421,3575891461,40
3,1168,32468,3575891421,3575891463,42
3,1168,32469,3575891421,3575891463,42
3,1168,32470,3575891421,3575891463,42
3,1168,32471,3575891421,3575891464,43
3,1168,32472,3575891421,3575891464,43
3,1168,32473,3575891421,3575891465,44
3,1168,32474,3575891421,3575891466,45
3,1168,32475,3575891421,3575891467,46
3,1168,32476,3575891421,3575891468,47
3,1168,32477,3575891421,3575891470,49
3,1169,32478,3575891484,3575891484,0
3,1169,32479,3575891484,3575891484,0
3,1169,32480,3575891484,3575891484,0
3,1169,32481,3575891484,3575891484,0
3,1169,32482,3575891484,3575891484,0
3,1169,32483,3575891484,3575891484,0
3,1169,32484,3575891484,3575891484,0
3,1169,32485,3575891484,3575891484,0
3,1169,32486,3575891484,3575891484,0
3,1169,32487,3575891484,3575891485,1
3,1169,32488,3575891484,3575891487,3
3,1169,32489,3575891484,3575891487,3
3,1169,32490,3575891484,3575891490,6
3,1169,32491,3575891484,3575891490,6
3,1169,32492,3575891484,3575891491,7
3,1169,32493,3575891484,3575891491,7
3,1169,32494,3575891484,3575891492,8
3,1169,32495,3575891484,3575891496,12
3,1169,32496,3575891484,3575891500,16
3,1169,32497,3575891484,3575891501,17
3,1169,32498,3575891484,3575891502,18
3,1169,32499,3575891484,3575891502,18
3,1169,32500,3575891484,3575891505,21
3,1169,32501,3575891484,3575891505,21
3,1169,32502,3575891484,3575891505,21
3,1169,32503,3575891484,3575891506,22
3,1169,32504,3575891484,3575891510,26
3,1169,32505,3575891484,3575891510,26
3,1169,32506,3575891484,3575891512,28
3,1169,32507,3575891484,3575891512,28
3,1169,32508,3575891484,3575891514,30
3,1169,32509,3575891484,3575891514,30
3,1169,32510,3575891484,3575891515,31
3,1169,32511,3575891484,3575891518,34
3,1169,32512,3575891484,3575891518,34
3,1169,32513,3575891484,3575891519,35
3,1169,32514,3575891484,3575891521,37
3,1169,32515,3575891484,3575891521,37
3,1169,32516,3575891484,3575891523,39
3,1169,32517,3575891484,3575891527,43
3,1169,32518,3575891484,3575891527,43
3,1169,32519,3575891484,3575891528,44
3,1169,32520,3575891484,3575891531,47
3,1169,32521,3575891484,3575891532,48
3,1169,32522,3575891484,3575891532,48
3,1169,32523,3575891484,3575891534,50
3,1170,32524,3575891547,3575891547,0
3,1170,32525,3575891547,3575891547,0
3,1170,32526,3575891547,3575891547,0
3,1170,32527,3575891547,3575891547,0
3,1170,32528,3575891547,3575891547,0
3,1170,32529,3575891547,3575891547,0
3,1170,32530,3575891547,3575891547,0
3,1170,32531,3575891547,3575891548,1
3,1170,32532,3575891547,3575891552,5
3,1170,32533,3575891547,3575891554,7
3,1170,32534,3575891547,3575891559,12
3,1170,32535,3575891547,3575891560,13
3,1170,32536,3575891547,3575891562,15
3,1170,32537,3575891547,3575891567,20
3,1170,32538,3575891547,3575891569,22
3,1170,32539,3575891547,3575891570,23
3,1170,32540,3575891547,3575891570,23
3,1170,32541,3575891547,3575891572,25
3,1170,32542,3575891547,3575891574,27
3,1170,32543,3575891547,3575891575,28
3,1170,32544,3575891547,3575891578,31
3,1170,32545,3575891547,3575891580,33
3,1170,32546,3575891547,3575891580,33
3,1170,32547,3575891547,3575891580,33
3,1170,32548,3575891547,3575891581,34
3,1170,32549,3575891547,3575891583,36
3,1170,32550,3575891547,3575891586,39
3,1170,32551,3575891547,3575891586,39
3,1170,32552,3575891547,3575891586,39
3,1170,32553,3575891547,3575891590,43
3,1170,32554,3575891547,3575891590,43
3,1170,32555,3575891547,3575891590,43
3,1170,32556,3575891547,3575891593,46
3,1170,32557,3575891547,3575891593,46
3,1170,32558,3575891547,3575891594,47
3,1170,32559,3575891547,3575891595,48
3,1170,32560,3575891547,3575891595,48
3,1170,32561,3575891547,3575891597,50
3,1171,32562,3575891612,3575891612,0
3,1171,32563,3575891612,3575891612,0
3,1171,32564,3575891612,3575891612,0
3,1171,32565,3575891612,3575891612,0
3,1171,32566,3575891612,3575891612,0
3,1171,32567,3575891612,3575891612,0
3,1171,32568,3575891612,3575891612,0
3,1171,32569,3575891612,3575891612,0
3,1171,32570,3575891612,3575891612,0
3,1171,32571,3575891612,3575891612,0
3,1171,32572,3575891612,3575891615,3
3,1171,32573,3575891612,3575891616,4
3,1171,32574,3575891612,3575891617,5
3,1171,32575,3575891612,3575891618,6
3,1171,32576,3575891612,3575891618,6
3,1171,32577,3575891612,3575891619,7
3,1171,32578,3575891612,3575891620,8
3,1171,32579,3575891612,3575891621,9
3,1171,32580,3575891612,3575891623,11
3,1171,32581,3575891612,3575891624,12
3,1171,32582,3575891612,3575891626,14
3,1171,32583,3575891612,3575891626,14
3,1171,32584,3575891612,3575891627,15
3,1171,32585,3575891612,3575891628,16
3,1171,32586,3575891612,3575891629,17
3,1171,32587,3575891612,3575891630,18
3,1171,32588,3575891612,3575891632,20
3,1171,32589,3575891612,3575891637,25
3,1171,32590,3575891612,3575891637,25
3,1171,32591,3575891612,3575891637,25
3,1171,32592,3575891612,3575891638,26
3,1171,32593,3575891612,3575891639,27
3,1171,32594,3575891612,3575891639,27
3,1171,32595,3575891612,3575891640,28
3,1171,32596,3575891612,3575891641,29
3,1171,32597,3575891612,3575891642,30
3,1171,32598,3575891612,3575891643,31
3,1171,32599,3575891612,3575891645,33
3,1171,32600,3575891612,3575891648,36
3,1171,32601,3575891612,3575891649,37
3,1171,32602,3575891612,3575891649,37
3,1171,32603,3575891612,3575891651,39
3,1171,32604,3575891612,3575891652,40
3,1171,32605,3575891612,3575891652,40
3,1171,32606,3575891612,3575891657,45
3,1171,32607,3575891612,3575891658,46
3,1171,32608,3575891612,3575891658,46
3,1171,32609,3575891612,3575891661,49
3,1171,32610,3575891612,3575891662,50
3,1172,32611,3575891674,3575891674,0
3,1172,32612,3575891674,3575891674,0
3,1172,32613,3575891674,3575891674,0
3,1172,32614,3575891674,3575891674,0
3,1172,32615,3575891674,3575891674,0
3,1172,32616,3575891674,3575891674,0
3,1172,32617,3575891674,3575891674,0
3,1172,32618,3575891674,3575891674,0
3,1172,32619,3575891674,3575891674,0
3,1172,32620,3575891674,3575891674,0
3,1172,32621,3575891674,3575891676,2
3,1172,32622,3575891674,3575891676,2
3,1172,32623,3575891674,3575891680,6
3,1172,32624,3575891674,3575891682,8
3,1172,32625,3575891674,3575891682,8
3,1172,32626,3575891674,3575891684,10
3,1172,32627,3575891674,3575891684,10
3,1172,32628,3575891674,3575891685,11
3,1172,32629,3575891674,3575891686,12
3,1172,32630,3575891674,3575891687,13
3,1172,32631,3575891674,3575891687,13
3,1172,32632,3575891674,3575891689,15
3,1172,32633,3575891674,3575891690,16
3,1172,32634,3575891674,3575891691,17
3,1172,32635,3575891674,3575891691,17
3,1172,32636,3575891674,3575891691,17
3,1172,32637,3575891674,3575891697,23
3,1172,32638,3575891674,3575891700,26
3,1172,32639,3575891674,3575891701,27
3,1172,32640,3575891674,3575891701,27
3,1172,32641,3575891674,3575891701,27
3,1172,32642,3575891674,3575891702,28
3,1172,32643,3575891674,3575891703,29
3,1172,32644,3575891674,3575891705,31
3,1172,32645,3575891674,3575891705,31
3,1172,32646,3575891674,3575891705,31
3,1172,32647,3575891674,3575891706,32
3,1172,32648,3575891674,3575891709,35
3,1172,32649,3575891674,3575891710,36
3,1172,32650,3575891674,3575891712,38
3,1172,32651,3575891674,3575891712,38
3,1172,32652,3575891674,3575891714,40
3,1172,32653,3575891674,3575891714,40
3,1172,32654,3575891674,3575891714,40
3,1172,32655,3575891674,3575891718,44
3,1172,32656,3575891674,3575891718,44
3,1172,32657,3575891674,3575891720,46
3,1172,32658,3575891674,3575891720,46
3,1172,32659,3575891674,3575891721,47
3,1172,32660,3575891674,3575891723,49
3,1173,32661,3575891751,3575891751,0
3,1173,32662,3575891751,3575891751,0
3,1173,32663,3575891751,3575891751,0
3,1173,32664,3575891751,3575891751,0
3,1173,32665,3575891751,3575891751,0
3,1173,32666,3575891751,3575891751,0
3,1173,32667,3575891751,3575891751,0
3,1173,32668,3575891751,3575891751,0
3,1173,32669,3575891751,3575891751,0
3,1173,32670,3575891751,3575891751,0
3,1173,32671,3575891751,3575891751,0
3,1173,32672,3575891751,3575891751,0
3,1173,32673,3575891751,3575891751,0
3,1173,32674,3575891751,3575891751,0
3,1173,32675,3575891751,3575891752,1
3,1173,32676,3575891751,3575891753,2
3,1173,32677,3575891751,3575891754,3
3,1173,32678,3575891751,3575891758,7
3,1173,32679,3575891751,3575891760,9
3,1173,32680,3575891751,3575891763,12
3,1173,32681,3575891751,3575891765,14
3,1173,32682,3575891751,3575891768,17
3,1173,32683,3575891751,3575891768,17
3,1173,32684,3575891751,3575891770,19
3,1173,32685,3575891751,3575891770,19
3,1173,32686,3575891751,3575891772,21
3,1173,32687,3575891751,3575891775,24
3,1173,32688,3575891751,3575891778,27
3,1173,32689,3575891751,3575891779,28
3,1173,32690,3575891751,3575891780,29
3,1173,32691,3575891751,3575891781,30
3,1173,32692,3575891751,3575891781,30
3,1173,32693,3575891751,3575891783,32
3,1173,32694,3575891751,3575891785,34
3,1173,32695,3575891751,3575891786,35
3,1173,32696,3575891751,3575891787,36
3,1173,32697,3575891751,3575891790,39
3,1173,32698,3575891751,3575891791,40
3,1173,32699,3575891751,3575891791,40
3,1173,32700,3575891751,3575891793,42
3,1173,32701,3575891751,3575891793,42
3,1173,32702,3575891751,3575891796,45
3,1173,32703,3575891751,3575891796,45
3,1173,32704,3575891751,3575891796,45
3,1173,32705,3575891751,3575891798,47
3,1173,32706,3575891751,3575891798,47
3,1173,32707,3575891751,3575891799,48
3,1173,32708,3575891751,3575891799,48
3,1173,32709,3575891751,3575891801,50
3,1174,32710,3575891815,3575891815,0
3,1174,32711,3575891815,3575891815,0
3,1174,32712,3575891815,3575891815,0
3,1174,32713,3575891815,3575891815,0
3,1174,32714,3575891815,3575891815,0
3,1174,32715,3575891815,3575891815,0
3,1174,32716,3575891815,3575891815,0
3,1174,32717,3575891815,3575891817,2
3,1174,32718,3575891815,3575891818,3
3,1174,32719,3575891815,3575891818,3
3,1174,32720,3575891815,3575891820,5
3,1174,32721,3575891815,3575891821,6
3,1174,32722,3575891815,3575891823,8
3,1174,32723,3575891815,3575891825,10
3,1174,32724,3575891815,3575891826,11
3,1174,32725,3575891815,3575891826,11
3,1174,32726,3575891815,3575891826,11
3,1174,32727,3575891815,3575891827,12
3,1174,32728,3575891815,3575891828,13
3,1174,32729,3575891815,3575891830,15
3,1174,32730,3575891815,3575891832,17
3,1174,32731,3575891815,3575891832,17
3,1174,32732,3575891815,3575891833,18
3,1174,32733,3575891815,3575891837,22
3,1174,32734,3575891815,3575891837,22
3,1174,32735,3575891815,3575891838,23
3,1174,32736,3575891815,3575891838,23
3,1174,32737,3575891815,3575891839,24
3,1174,32738,3575891815,3575891839,24
3,1174,32739,3575891815,3575891841,26
3,1174,32740,3575891815,3575891841,26
3,1174,32741,3575891815,3575891843,28
3,1174,32742,3575891815,3575891843,28
3,1174,32743,3575891815,3575891844,29
3,1174,32744,3575891815,3575891845,30
3,1174,32745,3575891815,3575891847,32
3,1174,32746,3575891815,3575891849,34
3,1174,32747,3575891815,3575891849,34
3,1174,32748,3575891815,3575891851,36
3,1174,32749,3575891815,3575891852,37
3,1174,32750,3575891815,3575891852,37
3,1174,32751,3575891815,3575891856,41
3,1174,32752,3575891815,3575891857,42
3,1174,32753,3575891815,3575891860,45
3,1174,32754,3575891815,3575891861,46
3,1174,32755,3575891815,3575891861,46
3,1174,32756,3575891815,3575891862,47
3,1174,32757,3575891815,3575891863,48
3,1174,32758,3575891815,3575891863,48
3,1174,32759,3575891815,3575891864,49
3,1174,32760,3575891815,3575891865,50
3,1175,32761,3575891878,3575891878,0
3,1175,32762,3575891878,3575891878,0
3,1175,32763,3575891878,3575891878,0
3,1175,32764,3575891878,3575891878,0
3,1175,32765,3575891878,3575891878,0
3,1175,32766,3575891878,3575891878,0
3,1175,32767,3575891878,3575891878,0
3,1175,32768,3575891878,3575891880,2
3,1175,32769,3575891878,3575891882,4
3,1175,32770,3575891878,3575891884,6
3,1175,32771,3575891878,3575891884,6
3,1175,32772,3575891878,3575891885,7
3,1175,32773,3575891878,3575891887,9
3,1175,32774,3575891878,3575891890,12
3,1175,32775,3575891878,3575891890,12
3,1175,32776,3575891878,3575891891,13
3,1175,32777,3575891878,3575891892,14
3,1175,32778,3575891878,3575891892,14
3,1175,32779,3575891878,3575891897,19
3,1175,32780,3575891878,3575891897,19
3,1175,32781,3575891878,3575891900,22
3,1175,32782,3575891878,3575891901,23
3,1175,32783,3575891878,3575891901,23
3,1175,32784,3575891878,3575891902,24
3,1175,32785,3575891878,3575891903,25
3,1175,32786,3575891878,3575891905,27
3,1175,32787,3575891878,3575891905,27
3,1175,32788,3575891878,3575891905,27
3,1175,32789,3575891878,3575891907,29
3,1175,32790,3575891878,3575891909,31
3,1175,32791,3575891878,3575891911,33
3,1175,32792,3575891878,3575891912,34
3,1175,32793,3575891878,3575891912,34
3,1175,32794,3575891878,3575891914,36
3,1175,32795,3575891878,3575891914,36
3,1175,32796,3575891878,3575891915,37
3,1175,32797,3575891878,3575891918,40
3,1175,32798,3575891878,3575891918,40
3,1175,32799,3575891878,3575891920,42
3,1175,32800,3575891878,3575891921,43
3,1175,32801,3575891878,3575891922,44
3,1175,32802,3575891878,3575891923,45
3,1175,32803,3575891878,3575891927,49
3,1175,32804,3575891878,3575891928,50
3,1176,32805,3575891944,3575891944,0
3,1176,32806,3575891944,3575891944,0
3,1176,32807,3575891944,3575891944,0
3,1176,32808,3575891944,3575891944,0
3,1176,32809,3575891944,3575891944,0
3,1176,32810,3575891944,3575891944,0
3,1176,32811,3575891944,3575891944,0
3,1176,32812,3575891944,3575891944,0
3,1176,32813,3575891944,3575891944,0
3,1176,32814,3575891944,3575891944,0
3,1176,32815,3575891944,3575891944,0
3,1176,32816,3575891944,3575891944,0
3,1176,32817,3575891944,3575891949,5
3,1176,32818,3575891944,3575891952,8
3,1176,32819,3575891944,3575891954,10
3,1176,32820,3575891944,3575891960,16
3,1176,32821,3575891944,3575891963,19
3,1176,32822,3575891944,3575891966,22
3,1176,32823,3575891944,3575891968,24
3,1176,32824,3575891944,3575891969,25
3,1176,32825,3575891944,3575891970,26
3,1176,32826,3575891944,3575891970,26
3,1176,32827,3575891944,3575891972,28
3,1176,32828,3575891944,3575891975,31
3,1176,32829,3575891944,3575891976,32
3,1176,32830,3575891944,3575891978,34
3,1176,32831,3575891944,3575891980,36
3,1176,32832,3575891944,3575891980,36
3,1176,32833,3575891944,3575891981,37
3,1176,32834,3575891944,3575891981,37
3,1176,32835,3575891944,3575891983,39
3,1176,32836,3575891944,3575891986,42
3,1176,32837,3575891944,3575891986,42
3,1176,32838,3575891944,3575891987,43
3,1176,32839,3575891944,3575891989,45
3,1176,32840,3575891944,3575891990,46
3,1176,32841,3575891944,3575891991,47
3,1176,32842,3575891944,3575891993,49
3,1177,32843,3575892008,3575892008,0
3,1177,32844,3575892008,3575892008,0
3,1177,32845,3575892008,3575892008,0
3,1177,32846,3575892008,3575892008,0
3,1177,32847,3575892008,3575892008,0
3,1177,32848,3575892008,3575892008,0
3,1177,32849,3575892008,3575892008,0
3,1177,32850,3575892008,3575892008,0
3,1177,32851,3575892008,3575892008,0
3,1177,32852,3575892008,3575892008,0
3,1177,32853,3575892008,3575892008,0
3,1177,32854,3575892008,3575892008,0
3,1177,32855,3575892008,3575892011,3
3,1177,32856,3575892008,3575892015,7
3,1177,32857,3575892008,3575892016,8
3,1177,32858,3575892008,3575892018,10
3,1177,32859,3575892008,3575892020,12
3,1177,32860,3575892008,3575892020,12
3,1177,32861,3575892008,3575892020,12
3,1177,32862,3575892008,3575892022,14
3,1177,32863,3575892008,3575892023,15
3,1177,32864,3575892008,3575892025,17
3,1177,32865,3575892008,3575892025,17
3,1177,32866,3575892008,3575892026,18
3,1177,32867,3575892008,3575892027,19
3,1177,32868,3575892008,3575892028,20
3,1177,32869,3575892008,3575892028,20
3,1177,32870,3575892008,3575892029,21
3,1177,32871,3575892008,3575892031,23
3,1177,32872,3575892008,3575892032,24
3,1177,32873,3575892008,3575892034,26
3,1177,32874,3575892008,3575892037,29
3,1177,32875,3575892008,3575892037,29
3,1177,32876,3575892008,3575892037,29
3,1177,32877,3575892008,3575892038,30
3,1177,32878,3575892008,3575892039,31
3,1177,32879,3575892008,3575892039,31
3,1177,32880,3575892008,3575892041,33
3,1177,32881,3575892008,3575892041,33
3,1177,32882,3575892008,3575892043,35
3,1177,32883,3575892008,3575892043,35
3,1177,32884,3575892008,3575892044,36
3,1177,32885,3575892008,3575892045,37
3,1177,32886,3575892008,3575892048,40
3,1177,32887,3575892008,3575892049,41
3,1177,32888,3575892008,3575892050,42
3,1177,32889,3575892008,3575892052,44
3,1177,32890,3575892008,3575892052,44
3,1177,32891,3575892008,3575892053,45
3,1177,32892,3575892008,3575892057,49
3,1177,32893,3575892008,3575892058,50
3,1178,32894,3575892080,3575892080,0
3,1178,32895,3575892080,3575892080,0
3,1178,32896,3575892080,3575892080,0
3,1178,32897,3575892080,3575892080,0
3,1178,32898,3575892080,3575892080,0
3,1178,32899,3575892080,3575892080,0
3,1178,32900,3575892080,3575892080,0
3,1178,32901,3575892080,3575892080,0
3,1178,32902,3575892080,3575892080,0
3,1178,32903,3575892080,3575892080,0
3,1178,32904,3575892080,3575892080,0
3,1178,32905,3575892080,3575892080,0
3,1178,32906,3575892080,3575892080,0
3,1178,32907,3575892080,3575892080,0
3,1178,32908,3575892080,3575892080,0
3,1178,32909,3575892080,3575892081,1
3,1178,32910,3575892080,3575892082,2
3,1178,32911,3575892080,3575892084,4
3,1178,32912,3575892080,3575892084,4
3,1178,32913,3575892080,3575892085,5
3,1178,32914,3575892080,3575892086,6
3,1178,32915,3575892080,3575892087,7
3,1178,32916,3575892080,3575892087,7
3,1178,32917,3575892080,3575892089,9
3,1178,32918,3575892080,3575892090,10
3,1178,32919,3575892080,3575892091,11
3,1178,32920,3575892080,3575892091,11
3,1178,32921,3575892080,3575892092,12
3,1178,32922,3575892080,3575892096,16
3,1178,32923,3575892080,3575892097,17
3,1178,32924,3575892080,3575892100,20
3,1178,32925,3575892080,3575892101,21
3,1178,32926,3575892080,3575892101,21
3,1178,32927,3575892080,3575892101,21
3,1178,32928,3575892080,3575892103,23
3,1178,32929,3575892080,3575892105,25
3,1178,32930,3575892080,3575892105,25
3,1178,32931,3575892080,3575892105,25
3,1178,32932,3575892080,3575892106,26
3,1178,32933,3575892080,3575892109,29
3,1178,32934,3575892080,3575892112,32
3,1178,32935,3575892080,3575892112,32
3,1178,32936,3575892080,3575892112,32
3,1178,32937,3575892080,3575892114,34
3,1178,32938,3575892080,3575892115,35
3,1178,32939,3575892080,3575892115,35
3,1178,32940,3575892080,3575892118,38
3,1178,32941,3575892080,3575892118,38
3,1178,32942,3575892080,3575892122,42
3,1178,32943,3575892080,3575892122,42
3,1178,32944,3575892080,3575892122,42
3,1178,32945,3575892080,3575892124,44
3,1178,32946,3575892080,3575892127,47
3,1178,32947,3575892080,3575892128,48
3,1178,32948,3575892080,3575892129,49
3,1179,32949,3575892145,3575892145,0
3,1179,32950,3575892145,3575892145,0
3,1179,32951,3575892145,3575892145,0
3,1179,32952,3575892145,3575892145,0
3,1179,32953,3575892145,3575892145,0
3,1179,32954,3575892145,3575892145,0
3,1179,32955,3575892145,3575892145,0
3,1179,32956,3575892145,3575892145,0
3,1179,32957,3575892145,3575892145,0
3,1179,32958,3575892145,3575892145,0
3,1179,32959,3575892145,3575892145,0
3,1179,32960,3575892145,3575892152,7
3,1179,32961,3575892145,3575892154,9
3,1179,32962,3575892145,3575892154,9
3,1179,32963,3575892145,3575892161,16
3,1179,32964,3575892145,3575892165,20
3,1179,32965,3575892145,3575892168,23
3,1179,32966,3575892145,3575892169,24
3,1179,32967,3575892145,3575892170,25
3,1179,32968,3575892145,3575892171,26
3,1179,32969,3575892145,3575892171,26
3,1179,32970,3575892145,3575892176,31
3,1179,32971,3575892145,3575892177,32
3,1179,32972,3575892145,3575892178,33
3,1179,32973,3575892145,3575892179,34
3,1179,32974,3575892145,3575892180,35
3,1179,32975,3575892145,3575892180,35
3,1179,32976,3575892145,3575892181,36
3,1179,32977,3575892145,3575892184,39
3,1179,32978,3575892145,3575892187,42
3,1179,32979,3575892145,3575892188,43
3,1179,32980,3575892145,3575892190,45
3,1179,32981,3575892145,3575892190,45
3,1179,32982,3575892145,3575892191,46
3,1179,32983,3575892145,3575892193,48
3,1179,32984,3575892145,3575892193,48
3,1179,32985,3575892145,3575892195,50
3,1180,32986,3575892209,3575892209,0
3,1180,32987,3575892209,3575892209,0
3,1180,32988,3575892209,3575892209,0
3,1180,32989,3575892209,3575892209,0
3,1180,32990,3575892209,3575892209,0
3,1180,32991,3575892209,3575892209,0
3,1180,32992,3575892209,3575892209,0
3,1180,32993,3575892209,3575892209,0
3,1180,32994,3575892209,3575892209,0
3,1180,32995,3575892209,3575892209,0
3,1180,32996,3575892209,3575892211,2
3,1180,32997,3575892209,3575892215,6
3,1180,32998,3575892209,3575892216,7
3,1180,32999,3575892209,3575892220,11
3,1180,33000,3575892209,3575892220,11
3,1180,33001,3575892209,3575892221,12
3,1180,33002,3575892209,3575892222,13
3,1180,33003,3575892209,3575892223,14
3,1180,33004,3575892209,3575892225,16
3,1180,33005,3575892209,3575892225,16
3,1180,33006,3575892209,3575892227,18
3,1180,33007,3575892209,3575892227,18
3,1180,33008,3575892209,3575892227,18
3,1180,33009,3575892209,3575892228,19
3,1180,33010,3575892209,3575892229,20
3,1180,33011,3575892209,3575892230,21
3,1180,33012,3575892209,3575892232,23
3,1180,33013,3575892209,3575892234,25
3,1180,33014,3575892209,3575892236,27
3,1180,33015,3575892209,3575892237,28
3,1180,33016,3575892209,3575892238,29
3,1180,33017,3575892209,3575892238,29
3,1180,33018,3575892209,3575892239,30
3,1180,33019,3575892209,3575892239,30
3,1180,33020,3575892209,3575892239,30
3,1180,33021,3575892209,3575892241,32
3,1180,33022,3575892209,3575892241,32
3,1180,33023,3575892209,3575892243,34
3,1180,33024,3575892209,3575892243,34
3,1180,33025,3575892209,3575892244,35
3,1180,33026,3575892209,3575892246,37
3,1180,33027,3575892209,3575892248,39
3,1180,33028,3575892209,3575892249,40
3,1180,33029,3575892209,3575892250,41
3,1180,33030,3575892209,3575892251,42
3,1180,33031,3575892209,3575892252,43
3,1180,33032,3575892209,3575892252,43
3,1180,33033,3575892209,3575892257,48
3,1180,33034,3575892209,3575892257,48
3,1181,33035,3575892273,3575892273,0
3,1181,33036,3575892273,3575892273,0
3,1181,33037,3575892273,3575892273,0
3,1181,33038,3575892273,3575892273,0
3,1181,33039,3575892273,3575892273,0
3,1181,33040,3575892273,3575892273,0
3,1181,33041,3575892273,3575892273,0
3,1181,33042,3575892273,3575892273,0
3,1181,33043,3575892273,3575892273,0
3,1181,33044,3575892273,3575892273,0
3,1181,33045,3575892273,3575892274,1
3,1181,33046,3575892273,3575892276,3
3,1181,33047,3575892273,3575892277,4
3,1181,33048,3575892273,3575892281,8
3,1181,33049,3575892273,3575892282,9
3,1181,33050,3575892273,3575892282,9
3,1181,33051,3575892273,3575892284,11
3,1181,33052,3575892273,3575892284,11
3,1181,33053,3575892273,3575892285,12
3,1181,33054,3575892273,3575892285,12
3,1181,33055,3575892273,3575892287,14
3,1181,33056,3575892273,3575892287,14
3,1181,33057,3575892273,3575892290,17
3,1181,33058,3575892273,3575892291,18
3,1181,33059,3575892273,3575892291,18
3,1181,33060,3575892273,3575892291,18
3,1181,33061,3575892273,3575892292,19
3,1181,33062,3575892273,3575892297,24
3,1181,33063,3575892273,3575892297,24
3,1181,33064,3575892273,3575892300,27
3,1181,33065,3575892273,3575892301,28
3,1181,33066,3575892273,3575892301,28
3,1181,33067,3575892273,3575892301,28
3,1181,33068,3575892273,3575892304,31
3,1181,33069,3575892273,3575892305,32
3,1181,33070,3575892273,3575892305,32
3,1181,33071,3575892273,3575892306,33
3,1181,33072,3575892273,3575892306,33
3,1181,33073,3575892273,3575892310,37
3,1181,33074,3575892273,3575892311,38
3,1181,33075,3575892273,3575892312,39
3,1181,33076,3575892273,3575892312,39
3,1181,33077,3575892273,3575892314,41
3,1181,33078,3575892273,3575892315,42
3,1181,33079,3575892273,3575892315,42
3,1181,33080,3575892273,3575892318,45
3,1181,33081,3575892273,3575892318,45
3,1181,33082,3575892273,3575892321,48
3,1181,33083,3575892273,3575892322,49
3,1181,33084,3575892273,3575892322,49
3,1182,33085,3575892337,3575892337,0
3,1182,33086,3575892337,3575892337,0
3,1182,33087,3575892337,3575892337,0
3,1182,33088,3575892337,3575892337,0
3,1182,33089,3575892337,3575892337,0
3,1182,33090,3575892337,3575892337,0
3,1182,33091,3575892337,3575892337,0
3,1182,33092,3575892337,3575892338,1
3,1182,33093,3575892337,3575892338,1
3,1182,33094,3575892337,3575892342,5
3,1182,33095,3575892337,3575892343,6
3,1182,33096,3575892337,3575892344,7
3,1182,33097,3575892337,3575892344,7
3,1182,33098,3575892337,3575892345,8
3,1182,33099,3575892337,3575892349,12
3,1182,33100,3575892337,3575892354,17
3,1182,33101,3575892337,3575892354,17
3,1182,33102,3575892337,3575892362,25
3,1182,33103,3575892337,3575892363,26
3,1182,33104,3575892337,3575892365,28
3,1182,33105,3575892337,3575892369,32
3,1182,33106,3575892337,3575892369,32
3,1182,33107,3575892337,3575892371,34
3,1182,33108,3575892337,3575892371,34
3,1182,33109,3575892337,3575892376,39
3,1182,33110,3575892337,3575892381,44
3,1182,33111,3575892337,3575892381,44
3,1182,33112,3575892337,3575892381,44
3,1182,33113,3575892337,3575892381,44
3,1182,33114,3575892337,3575892383,46
3,1182,33115,3575892337,3575892385,48
3,1182,33116,3575892337,3575892387,50
3,1183,33117,3575892405,3575892405,0
3,1183,33118,3575892405,3575892405,0
3,1183,33119,3575892405,3575892405,0
3,1183,33120,3575892405,3575892405,0
3,1183,33121,3575892405,3575892405,0
3,1183,33122,3575892405,3575892405,0
3,1183,33123,3575892405,3575892405,0
3,1183,33124,3575892405,3575892405,0
3,1183,33125,3575892405,3575892405,0
3,1183,33126,3575892405,3575892405,0
3,1183,33127,3575892405,3575892405,0
3,1183,33128,3575892405,3575892405,0
3,1183,33129,3575892405,3575892405,0
3,1183,33130,3575892405,3575892405,0
3,1183,33131,3575892405,3575892405,0
3,1183,33132,3575892405,3575892405,0
3,1183,33133,3575892405,3575892405,0
3,1183,33134,3575892405,3575892405,0
3,1183,33135,3575892405,3575892408,3
3,1183,33136,3575892405,3575892411,6
3,1183,33137,3575892405,3575892415,10
3,1183,33138,3575892405,3575892417,12
3,1183,33139,3575892405,3575892417,12
3,1183,33140,3575892405,3575892420,15
3,1183,33141,3575892405,3575892420,15
3,1183,33142,3575892405,3575892420,15
3,1183,33143,3575892405,3575892421,16
3,1183,33144,3575892405,3575892422,17
3,1183,33145,3575892405,3575892424,19
3,1183,33146,3575892405,3575892425,20
3,1183,33147,3575892405,3575892426,21
3,1183,33148,3575892405,3575892427,22
3,1183,33149,3575892405,3575892428,23
3,1183,33150,3575892405,3575892428,23
3,1183,33151,3575892405,3575892429,24
3,1183,33152,3575892405,3575892431,26
3,1183,33153,3575892405,3575892432,27
3,1183,33154,3575892405,3575892434,29
3,1183,33155,3575892405,3575892438,33
3,1183,33156,3575892405,3575892438,33
3,1183,33157,3575892405,3575892438,33
3,1183,33158,3575892405,3575892439,34
3,1183,33159,3575892405,3575892439,34
3,1183,33160,3575892405,3575892439,34
3,1183,33161,3575892405,3575892441,36
3,1183,33162,3575892405,3575892441,36
3,1183,33163,3575892405,3575892443,38
3,1183,33164,3575892405,3575892443,38
3,1183,33165,3575892405,3575892445,40
3,1183,33166,3575892405,3575892446,41
3,1183,33167,3575892405,3575892449,44
3,1183,33168,3575892405,3575892449,44
3,1183,33169,3575892405,3575892450,45
3,1183,33170,3575892405,3575892452,47
3,1183,33171,3575892405,3575892453,48
3,1183,33172,3575892405,3575892453,48
3,1184,33173,3575892469,3575892469,0
3,1184,33174,3575892469,3575892469,0
3,1184,33175,3575892469,3575892469,0
3,1184,33176,3575892469,3575892469,0
3,1184,33177,3575892469,3575892469,0
3,1184,33178,3575892469,3575892469,0
3,1184,33179,3575892469,3575892469,0
3,1184,33180,3575892469,3575892469,0
3,1184,33181,3575892469,3575892469,0
3,1184,33182,3575892469,3575892469,0
3,1184,33183,3575892469,3575892469,0
3,1184,33184,3575892469,3575892474,5
3,1184,33185,3575892469,3575892476,7
3,1184,33186,3575892469,3575892477,8
3,1184,33187,3575892469,3575892481,12
3,1184,33188,3575892469,3575892481,12
3,1184,33189,3575892469,3575892482,13
3,1184,33190,3575892469,3575892484,15
3,1184,33191,3575892469,3575892484,15
3,1184,33192,3575892469,3575892484,15
3,1184,33193,3575892469,3575892486,17
3,1184,33194,3575892469,3575892487,18
3,1184,33195,3575892469,3575892487,18
3,1184,33196,3575892469,3575892488,19
3,1184,33197,3575892469,3575892490,21
3,1184,33198,3575892469,3575892492,23
3,1184,33199,3575892469,3575892492,23
3,1184,33200,3575892469,3575892493,24
3,1184,33201,3575892469,3575892497,28
3,1184,33202,3575892469,3575892500,31
3,1184,33203,3575892469,3575892501,32
3,1184,33204,3575892469,3575892501,32
3,1184,33205,3575892469,3575892504,35
3,1184,33206,3575892469,3575892505,36
3,1184,33207,3575892469,3575892505,36
3,1184,33208,3575892469,3575892506,37
3,1184,33209,3575892469,3575892506,37
3,1184,33210,3575892469,3575892509,40
3,1184,33211,3575892469,3575892512,43
3,1184,33212,3575892469,3575892512,43
3,1184,33213,3575892469,3575892513,44
3,1184,33214,3575892469,3575892514,45
3,1184,33215,3575892469,3575892515,46
3,1184,33216,3575892469,3575892516,47
3,1184,33217,3575892469,3575892518,49
3,1184,33218,3575892469,3575892519,50
3,1185,33219,3575892531,3575892531,0
3,1185,33220,3575892531,3575892531,0
3,1185,33221,3575892531,3575892531,0
3,1185,33222,3575892531,3575892531,0
3,1185,33223,3575892531,3575892531,0
3,1185,33224,3575892531,3575892531,0
3,1185,33225,3575892531,3575892531,0
3,1185,33226,3575892531,3575892532,1
3,1185,33227,3575892531,3575892532,1
3,1185,33228,3575892531,3575892534,3
3,1185,33229,3575892531,3575892537,6
3,1185,33230,3575892531,3575892541,10
3,1185,33231,3575892531,3575892542,11
3,1185,33232,3575892531,3575892543,12
3,1185,33233,3575892531,3575892543,12
3,1185,33234,3575892531,3575892543,12
3,1185,33235,3575892531,3575892544,13
3,1185,33236,3575892531,3575892548,17
3,1185,33237,3575892531,3575892554,23
3,1185,33238,3575892531,3575892556,25
3,1185,33239,3575892531,3575892559,28
3,1185,33240,3575892531,3575892560,29
3,1185,33241,3575892531,3575892562,31
3,1185,33242,3575892531,3575892564,33
3,1185,33243,3575892531,3575892568,37
3,1185,33244,3575892531,3575892569,38
3,1185,33245,3575892531,3575892570,39
3,1185,33246,3575892531,3575892570,39
3,1185,33247,3575892531,3575892570,39
3,1185,33248,3575892531,3575892574,43
3,1185,33249,3575892531,3575892575,44
3,1185,33250,3575892531,3575892580,49
3,1185,33251,3575892531,3575892580,49
3,1185,33252,3575892531,3575892581,50
3,1185,33253,3575892531,3575892581,50
3,1186,33254,3575892595,3575892595,0
3,1186,33255,3575892595,3575892595,0
3,1186,33256,3575892595,3575892595,0
3,1186,33257,3575892595,3575892595,0
3,1186,33258,3575892595,3575892595,0
3,1186,33259,3575892595,3575892595,0
3,1186,33260,3575892595,3575892595,0
3,1186,33261,3575892595,3575892595,0
3,1186,33262,3575892595,3575892595,0
3,1186,33263,3575892595,3575892595,0
3,1186,33264,3575892595,3575892595,0
3,1186,33265,3575892595,3575892595,0
3,1186,33266,3575892595,3575892595,0
3,1186,33267,3575892595,3575892596,1
3,1186,33268,3575892595,3575892596,1
3,1186,33269,3575892595,3575892598,3
3,1186,33270,3575892595,3575892599,4
3,1186,33271,3575892595,3575892601,6
3,1186,33272,3575892595,3575892602,7
3,1186,33273,3575892595,3575892603,8
3,1186,33274,3575892595,3575892603,8
3,1186,33275,3575892595,3575892609,14
3,1186,33276,3575892595,3575892611,16
3,1186,33277,3575892595,3575892614,19
3,1186,33278,3575892595,3575892615,20
3,1186,33279,3575892595,3575892617,22
3,1186,33280,3575892595,3575892618,23
3,1186,33281,3575892595,3575892618,23
3,1186,33282,3575892595,3575892619,24
3,1186,33283,3575892595,3575892620,25
3,1186,33284,3575892595,3575892621,26
3,1186,33285,3575892595,3575892623,28
3,1186,33286,3575892595,3575892625,30
3,1186,33287,3575892595,3575892625,30
3,1186,33288,3575892595,3575892626,31
3,1186,33289,3575892595,3575892626,31
3,1186,33290,3575892595,3575892627,32
3,1186,33291,3575892595,3575892627,32
3,1186,33292,3575892595,3575892630,35
3,1186,33293,3575892595,3575892634,39
3,1186,33294,3575892595,3575892636,41
3,1186,33295,3575892595,3575892637,42
3,1186,33296,3575892595,3575892638,43
3,1186,33297,3575892595,3575892638,43
3,1186,33298,3575892595,3575892638,43
3,1186,33299,3575892595,3575892638,43
3,1186,33300,3575892595,3575892639,44
3,1186,33301,3575892595,3575892639,44
3,1186,33302,3575892595,3575892640,45
3,1186,33303,3575892595,3575892642,47
3,1186,33304,3575892595,3575892642,47
3,1186,33305,3575892595,3575892644,49
3,1187,33306,3575892658,3575892658,0
3,1187,33307,3575892658,3575892658,0
3,1187,33308,3575892658,3575892658,0
3,1187,33309,3575892658,3575892658,0
3,1187,33310,3575892658,3575892658,0
3,1187,33311,3575892658,3575892658,0
3,1187,33312,3575892658,3575892658,0
3,1187,33313,3575892658,3575892658,0
3,1187,33314,3575892658,3575892658,0
3,1187,33315,3575892658,3575892659,1
3,1187,33316,3575892658,3575892662,4
3,1187,33317,3575892658,3575892662,4
3,1187,33318,3575892658,3575892663,5
3,1187,33319,3575892658,3575892663,5
3,1187,33320,3575892658,3575892663,5
3,1187,33321,3575892658,3575892664,6
3,1187,33322,3575892658,3575892665,7
3,1187,33323,3575892658,3575892666,8
3,1187,33324,3575892658,3575892667,9
3,1187,33325,3575892658,3575892669,11
3,1187,33326,3575892658,3575892675,17
3,1187,33327,3575892658,3575892676,18
3,1187,33328,3575892658,3575892677,19
3,1187,33329,3575892658,3575892681,23
3,1187,33330,3575892658,3575892682,24
3,1187,33331,3575892658,3575892682,24
3,1187,33332,3575892658,3575892684,26
3,1187,33333,3575892658,3575892684,26
3,1187,33334,3575892658,3575892684,26
3,1187,33335,3575892658,3575892685,27
3,1187,33336,3575892658,3575892687,29
3,1187,33337,3575892658,3575892687,29
3,1187,33338,3575892658,3575892688,30
3,1187,33339,3575892658,3575892690,32
3,1187,33340,3575892658,3575892691,33
3,1187,33341,3575892658,3575892691,33
3,1187,33342,3575892658,3575892692,34
3,1187,33343,3575892658,3575892697,39
3,1187,33344,3575892658,3575892700,42
3,1187,33345,3575892658,3575892701,43
3,1187,33346,3575892658,3575892705,47
3,1187,33347,3575892658,3575892705,47
3,1187,33348,3575892658,3575892705,47
3,1187,33349,3575892658,3575892706,48
3,1187,33350,3575892658,3575892706,48
3,1188,33351,3575892726,3575892726,0
3,1188,33352,3575892726,3575892726,0
3,1188,33353,3575892726,3575892726,0
3,1188,33354,3575892726,3575892726,0
3,1188,33355,3575892726,3575892726,0
3,1188,33356,3575892726,3575892726,0
3,1188,33357,3575892726,3575892726,0
3,1188,33358,3575892726,3575892726,0
3,1188,33359,3575892726,3575892726,0
3,1188,33360,3575892726,3575892726,0
3,1188,33361,3575892726,3575892726,0
3,1188,33362,3575892726,3575892726,0
3,1188,33363,3575892726,3575892728,2
3,1188,33364,3575892726,3575892728,2
3,1188,33365,3575892726,3575892731,5
3,1188,33366,3575892726,3575892733,7
3,1188,33367,3575892726,3575892734,8
3,1188,33368,3575892726,3575892737,11
3,1188,33369,3575892726,3575892738,12
3,1188,33370,3575892726,3575892741,15
3,1188,33371,3575892726,3575892743,17
3,1188,33372,3575892726,3575892743,17
3,1188,33373,3575892726,3575892743,17
3,1188,33374,3575892726,3575892744,18
3,1188,33375,3575892726,3575892748,22
3,1188,33376,3575892726,3575892753,27
3,1188,33377,3575892726,3575892754,28
3,1188,33378,3575892726,3575892756,30
3,1188,33379,3575892726,3575892759,33
3,1188,33380,3575892726,3575892760,34
3,1188,33381,3575892726,3575892763,37
3,1188,33382,3575892726,3575892764,38
3,1188,33383,3575892726,3575892768,42
3,1188,33384,3575892726,3575892769,43
3,1188,33385,3575892726,3575892770,44
3,1188,33386,3575892726,3575892770,44
3,1188,33387,3575892726,3575892771,45
3,1188,33388,3575892726,3575892776,50
3,1189,33389,3575892790,3575892791,1
3,1189,33390,3575892790,3575892791,1
3,1189,33391,3575892790,3575892791,1
3,1189,33392,3575892790,3575892791,1
3,1189,33393,3575892790,3575892791,1
3,1189,33394,3575892790,3575892791,1
3,1189,33395,3575892790,3575892791,1
3,1189,33396,3575892790,3575892791,1
3,1189,33397,3575892790,3575892791,1
3,1189,33398,3575892790,3575892791,1
3,1189,33399,3575892790,3575892791,1
3,1189,33400,3575892790,3575892791,1
3,1189,33401,3575892790,3575892791,1
3,1189,33402,3575892790,3575892792,2
3,1189,33403,3575892790,3575892793,3
3,1189,33404,3575892790,3575892795,5
3,1189,33405,3575892790,3575892795,5
3,1189,33406,3575892790,3575892795,5
3,1189,33407,3575892790,3575892796,6
3,1189,33408,3575892790,3575892796,6
3,1189,33409,3575892790,3575892798,8
3,1189,33410,3575892790,3575892802,12
3,1189,33411,3575892790,3575892802,12
3,1189,33412,3575892790,3575892803,13
3,1189,33413,3575892790,3575892810,20
3,1189,33414,3575892790,3575892812,22
3,1189,33415,3575892790,3575892815,25
3,1189,33416,3575892790,3575892816,26
3,1189,33417,3575892790,3575892816,26
3,1189,33418,3575892790,3575892819,29
3,1189,33419,3575892790,3575892819,29
3,1189,33420,3575892790,3575892821,31
3,1189,33421,3575892790,3575892821,31
3,1189,33422,3575892790,3575892823,33
3,1189,33423,3575892790,3575892825,35
3,1189,33424,3575892790,3575892826,36
3,1189,33425,3575892790,3575892826,36
3,1189,33426,3575892790,3575892827,37
3,1189,33427,3575892790,3575892829,39
3,1189,33428,3575892790,3575892830,40
3,1189,33429,3575892790,3575892831,41
3,1189,33430,3575892790,3575892833,43
3,1189,33431,3575892790,3575892837,47
3,1189,33432,3575892790,3575892837,47
3,1189,33433,3575892790,3575892838,48
3,1189,33434,3575892790,3575892839,49
3,1189,33435,3575892790,3575892839,49
3,1190,33436,3575892860,3575892860,0
3,1190,33437,3575892860,3575892860,0
3,1190,33438,3575892860,3575892860,0
3,1190,33439,3575892860,3575892860,0
3,1190,33440,3575892860,3575892860,0
3,1190,33441,3575892860,3575892860,0
3,1190,33442,3575892860,3575892860,0
3,1190,33443,3575892860,3575892860,0
3,1190,33444,3575892860,3575892860,0
3,1190,33445,3575892860,3575892860,0
3,1190,33446,3575892860,3575892860,0
3,1190,33447,3575892860,3575892860,0
3,1190,33448,3575892860,3575892860,0
3,1190,33449,3575892860,3575892860,0
3,1190,33450,3575892860,3575892860,0
3,1190,33451,3575892860,3575892862,2
3,1190,33452,3575892860,3575892862,2
3,1190,33453,3575892860,3575892863,3
3,1190,33454,3575892860,3575892863,3
3,1190,33455,3575892860,3575892864,4
3,1190,33456,3575892860,3575892865,5
3,1190,33457,3575892860,3575892866,6
3,1190,33458,3575892860,3575892867,7
3,1190,33459,3575892860,3575892875,15
3,1190,33460,3575892860,3575892877,17
3,1190,33461,3575892860,3575892882,22
3,1190,33462,3575892860,3575892882,22
3,1190,33463,3575892860,3575892884,24
3,1190,33464,3575892860,3575892885,25
3,1190,33465,3575892860,3575892887,27
3,1190,33466,3575892860,3575892887,27
3,1190,33467,3575892860,3575892888,28
3,1190,33468,3575892860,3575892891,31
3,1190,33469,3575892860,3575892891,31
3,1190,33470,3575892860,3575892891,31
3,1190,33471,3575892860,3575892891,31
3,1190,33472,3575892860,3575892893,33
3,1190,33473,3575892860,3575892896,36
3,1190,33474,3575892860,3575892897,37
3,1190,33475,3575892860,3575892900,40
3,1190,33476,3575892860,3575892901,41
3,1190,33477,3575892860,3575892904,44
3,1190,33478,3575892860,3575892905,45
3,1190,33479,3575892860,3575892906,46
3,1190,33480,3575892860,3575892907,47
3,1190,33481,3575892860,3575892907,47
3,1190,33482,3575892860,3575892910,50
3,1191,33483,3575892926,3575892926,0
3,1191,33484,3575892926,3575892926,0
3,1191,33485,3575892926,3575892926,0
3,1191,33486,3575892926,3575892926,0
3,1191,33487,3575892926,3575892926,0
3,1191,33488,3575892926,3575892926,0
3,1191,33489,3575892926,3575892926,0
3,1191,33490,3575892926,3575892926,0
3,1191,33491,3575892926,3575892926,0
3,1191,33492,3575892926,3575892926,0
3,1191,33493,3575892926,3575892926,0
3,1191,33494,3575892926,3575892926,0
3,1191,33495,3575892926,3575892926,0
3,1191,33496,3575892926,3575892928,2
3,1191,33497,3575892926,3575892930,4
3,1191,33498,3575892926,3575892930,4
3,1191,33499,3575892926,3575892931,5
3,1191,33500,3575892926,3575892934,8
3,1191,33501,3575892926,3575892934,8
3,1191,33502,3575892926,3575892937,11
3,1191,33503,3575892926,3575892938,12
3,1191,33504,3575892926,3575892942,16
3,1191,33505,3575892926,3575892943,17
3,1191,33506,3575892926,3575892943,17
3,1191,33507,3575892926,3575892943,17
3,1191,33508,3575892926,3575892944,18
3,1191,33509,3575892926,3575892944,18
3,1191,33510,3575892926,3575892948,22
3,1191,33511,3575892926,3575892954,28
3,1191,33512,3575892926,3575892954,28
3,1191,33513,3575892926,3575892956,30
3,1191,33514,3575892926,3575892959,33
3,1191,33515,3575892926,3575892960,34
3,1191,33516,3575892926,3575892962,36
3,1191,33517,3575892926,3575892964,38
3,1191,33518,3575892926,3575892968,42
3,1191,33519,3575892926,3575892969,43
3,1191,33520,3575892926,3575892970,44
3,1191,33521,3575892926,3575892971,45
3,1191,33522,3575892926,3575892973,47
3,1191,33523,3575892926,3575892974,48
3,1191,33524,3575892926,3575892976,50
3,1192,33525,3575892997,3575892997,0
3,1192,33526,3575892997,3575892997,0
3,1192,33527,3575892997,3575892997,0
3,1192,33528,3575892997,3575892997,0
3,1192,33529,3575892997,3575892997,0
3,1192,33530,3575892997,3575892997,0
3,1192,33531,3575892997,3575892997,0
3,1192,33532,3575892997,3575892997,0
3,1192,33533,3575892997,3575892997,0
3,1192,33534,3575892997,3575892997,0
3,1192,33535,3575892997,3575892997,0
3,1192,33536,3575892997,3575892997,0
3,1192,33537,3575892997,3575892997,0
3,1192,33538,3575892997,3575892997,0
3,1192,33539,3575892997,3575892997,0
3,1192,33540,3575892997,3575892997,0
3,1192,33541,3575892997,3575892997,0
3,1192,33542,3575892997,3575892997,0
3,1192,33543,3575892997,3575892997,0
3,1192,33544,3575892997,3575892998,1
3,1192,33545,3575892997,3575893000,3
3,1192,33546,3575892997,3575893002,5
3,1192,33547,3575892997,3575893003,6
3,1192,33548,3575892997,3575893003,6
3,1192,33549,3575892997,3575893010,13
3,1192,33550,3575892997,3575893012,15
3,1192,33551,3575892997,3575893015,18
3,1192,33552,3575892997,3575893015,18
3,1192,33553,3575892997,3575893017,20
3,1192,33554,3575892997,3575893018,21
3,1192,33555,3575892997,3575893019,22
3,1192,33556,3575892997,3575893020,23
3,1192,33557,3575892997,3575893021,24
3,1192,33558,3575892997,3575893021,24
3,1192,33559,3575892997,3575893023,26
3,1192,33560,3575892997,3575893025,28
3,1192,33561,3575892997,3575893027,30
3,1192,33562,3575892997,3575893027,30
3,1192,33563,3575892997,3575893027,30
3,1192,33564,3575892997,3575893028,31
3,1192,33565,3575892997,3575893028,31
3,1192,33566,3575892997,3575893030,33
3,1192,33567,3575892997,3575893032,35
3,1192,33568,3575892997,3575893036,39
3,1192,33569,3575892997,3575893037,40
3,1192,33570,3575892997,3575893038,41
3,1192,33571,3575892997,3575893039,42
3,1192,33572,3575892997,3575893039,42
3,1192,33573,3575892997,3575893040,43
3,1192,33574,3575892997,3575893041,44
3,1192,33575,3575892997,3575893044,47
3,1192,33576,3575892997,3575893044,47
3,1192,33577,3575892997,3575893045,48
3,1192,33578,3575892997,3575893046,49
3,1193,33579,3575893065,3575893065,0
3,1193,33580,3575893065,3575893065,0
3,1193,33581,3575893065,3575893065,0
3,1193,33582,3575893065,3575893065,0
3,1193,33583,3575893065,3575893065,0
3,1193,33584,3575893065,3575893065,0
3,1193,33585,3575893065,3575893065,0
3,1193,33586,3575893065,3575893065,0
3,1193,33587,3575893065,3575893065,0
3,1193,33588,3575893065,3575893065,0
3,1193,33589,3575893065,3575893065,0
3,1193,33590,3575893065,3575893065,0
3,1193,33591,3575893065,3575893065,0
3,1193,33592,3575893065,3575893065,0
3,1193,33593,3575893065,3575893066,1
3,1193,33594,3575893065,3575893066,1
3,1193,33595,3575893065,3575893067,2
3,1193,33596,3575893065,3575893070,5
3,1193,33597,3575893065,3575893075,10
3,1193,33598,3575893065,3575893077,12
3,1193,33599,3575893065,3575893081,16
3,1193,33600,3575893065,3575893082,17
3,1193,33601,3575893065,3575893082,17
3,1193,33602,3575893065,3575893084,19
3,1193,33603,3575893065,3575893085,20
3,1193,33604,3575893065,3575893086,21
3,1193,33605,3575893065,3575893088,23
3,1193,33606,3575893065,3575893088,23
3,1193,33607,3575893065,3575893091,26
3,1193,33608,3575893065,3575893092,27
3,1193,33609,3575893065,3575893093,28
3,1193,33610,3575893065,3575893097,32
3,1193,33611,3575893065,3575893100,35
3,1193,33612,3575893065,3575893101,36
3,1193,33613,3575893065,3575893103,38
3,1193,33614,3575893065,3575893104,39
3,1193,33615,3575893065,3575893105,40
3,1193,33616,3575893065,3575893106,41
3,1193,33617,3575893065,3575893108,43
3,1193,33618,3575893065,3575893110,45
3,1193,33619,3575893065,3575893111,46
3,1193,33620,3575893065,3575893114,49
3,1194,33621,3575893129,3575893129,0
3,1194,33622,3575893129,3575893129,0
3,1194,33623,3575893129,3575893129,0
3,1194,33624,3575893129,3575893129,0
3,1194,33625,3575893129,3575893129,0
3,1194,33626,3575893129,3575893129,0
3,1194,33627,3575893129,3575893129,0
3,1194,33628,3575893129,3575893129,0
3,1194,33629,3575893129,3575893129,0
3,1194,33630,3575893129,3575893129,0
3,1194,33631,3575893129,3575893130,1
3,1194,33632,3575893129,3575893131,2
3,1194,33633,3575893129,3575893131,2
3,1194,33634,3575893129,3575893134,5
3,1194,33635,3575893129,3575893134,5
3,1194,33636,3575893129,3575893137,8
3,1194,33637,3575893129,3575893138,9
3,1194,33638,3575893129,3575893142,13
3,1194,33639,3575893129,3575893142,13
3,1194,33640,3575893129,3575893143,14
3,1194,33641,3575893129,3575893144,15
3,1194,33642,3575893129,3575893144,15
3,1194,33643,3575893129,3575893148,19
3,1194,33644,3575893129,3575893154,25
3,1194,33645,3575893129,3575893156,27
3,1194,33646,3575893129,3575893160,31
3,1194,33647,3575893129,3575893162,33
3,1194,33648,3575893129,3575893163,34
3,1194,33649,3575893129,3575893165,36
3,1194,33650,3575893129,3575893168,39
3,1194,33651,3575893129,3575893170,41
3,1194,33652,3575893129,3575893171,42
3,1194,33653,3575893129,3575893174,45
3,1195,33654,3575893192,3575893192,0
3,1195,33655,3575893192,3575893192,0
3,1195,33656,3575893192,3575893192,0
3,1195,33657,3575893192,3575893192,0
3,1195,33658,3575893192,3575893192,0
3,1195,33659,3575893192,3575893192,0
3,1195,33660,3575893192,3575893192,0
3,1195,33661,3575893192,3575893192,0
3,1195,33662,3575893192,3575893192,0
3,1195,33663,3575893192,3575893192,0
3,1195,33664,3575893192,3575893192,0
3,1195,33665,3575893192,3575893192,0
3,1195,33666,3575893192,3575893192,0
3,1195,33667,3575893192,3575893193,1
3,1195,33668,3575893192,3575893193,1
3,1195,33669,3575893192,3575893193,1
3,1195,33670,3575893192,3575893195,3
3,1195,33671,3575893192,3575893196,4
3,1195,33672,3575893192,3575893196,4
3,1195,33673,3575893192,3575893196,4
3,1195,33674,3575893192,3575893197,5
3,1195,33675,3575893192,3575893198,6
3,1195,33676,3575893192,3575893199,7
3,1195,33677,3575893192,3575893201,9
3,1195,33678,3575893192,3575893202,10
3,1195,33679,3575893192,3575893203,11
3,1195,33680,3575893192,3575893203,11
3,1195,33681,3575893192,3575893210,18
3,1195,33682,3575893192,3575893212,20
3,1195,33683,3575893192,3575893215,23
3,1195,33684,3575893192,3575893216,24
3,1195,33685,3575893192,3575893217,25
3,1195,33686,3575893192,3575893218,26
3,1195,33687,3575893192,3575893218,26
3,1195,33688,3575893192,3575893220,28
3,1195,33689,3575893192,3575893220,28
3,1195,33690,3575893192,3575893221,29
3,1195,33691,3575893192,3575893223,31
3,1195,33692,3575893192,3575893224,32
3,1195,33693,3575893192,3575893226,34
3,1195,33694,3575893192,3575893227,35
3,1195,33695,3575893192,3575893227,35
3,1195,33696,3575893192,3575893227,35
3,1195,33697,3575893192,3575893228,36
3,1195,33698,3575893192,3575893228,36
3,1195,33699,3575893192,3575893230,38
3,1195,33700,3575893192,3575893233,41
3,1195,33701,3575893192,3575893235,43
3,1195,33702,3575893192,3575893237,45
3,1195,33703,3575893192,3575893238,46
3,1195,33704,3575893192,3575893239,47
3,1195,33705,3575893192,3575893240,48
3,1195,33706,3575893192,3575893240,48
3,1195,33707,3575893192,3575893241,49
3,1196,33708,3575893258,3575893258,0
3,1196,33709,3575893258,3575893258,0
3,1196,33710,3575893258,3575893258,0
3,1196,33711,3575893258,3575893258,0
3,1196,33712,3575893258,3575893258,0
3,1196,33713,3575893258,3575893258,0
3,1196,33714,3575893258,3575893258,0
3,1196,33715,3575893258,3575893258,0
3,1196,33716,3575893258,3575893258,0
3,1196,33717,3575893258,3575893258,0
3,1196,33718,3575893258,3575893260,2
3,1196,33719,3575893258,3575893262,4
3,1196,33720,3575893258,3575893264,6
3,1196,33721,3575893258,3575893264,6
3,1196,33722,3575893258,3575893264,6
3,1196,33723,3575893258,3575893266,8
3,1196,33724,3575893258,3575893266,8
3,1196,33725,3575893258,3575893266,8
3,1196,33726,3575893258,3575893267,9
3,1196,33727,3575893258,3575893270,12
3,1196,33728,3575893258,3575893275,17
3,1196,33729,3575893258,3575893277,19
3,1196,33730,3575893258,3575893277,19
3,1196,33731,3575893258,3575893281,23
3,1196,33732,3575893258,3575893282,24
3,1196,33733,3575893258,3575893282,24
3,1196,33734,3575893258,3575893284,26
3,1196,33735,3575893258,3575893285,27
3,1196,33736,3575893258,3575893287,29
3,1196,33737,3575893258,3575893288,30
3,1196,33738,3575893258,3575893290,32
3,1196,33739,3575893258,3575893291,33
3,1196,33740,3575893258,3575893291,33
3,1196,33741,3575893258,3575893292,34
3,1196,33742,3575893258,3575893297,39
3,1196,33743,3575893258,3575893300,42
3,1196,33744,3575893258,3575893300,42
3,1196,33745,3575893258,3575893301,43
3,1196,33746,3575893258,3575893303,45
3,1196,33747,3575893258,3575893305,47
3,1196,33748,3575893258,3575893305,47
3,1196,33749,3575893258,3575893306,48
3,1196,33750,3575893258,3575893308,50
3,1197,33751,3575893321,3575893321,0
3,1197,33752,3575893321,3575893321,0
3,1197,33753,3575893321,3575893321,0
3,1197,33754,3575893321,3575893321,0
3,1197,33755,3575893321,3575893321,0
3,1197,33756,3575893321,3575893321,0
3,1197,33757,3575893321,3575893321,0
3,1197,33758,3575893321,3575893321,0
3,1197,33759,3575893321,3575893321,0
3,1197,33760,3575893321,3575893321,0
3,1197,33761,3575893321,3575893321,0
3,1197,33762,3575893321,3575893324,3
3,1197,33763,3575893321,3575893327,6
3,1197,33764,3575893321,3575893329,8
3,1197,33765,3575893321,3575893331,10
3,1197,33766,3575893321,3575893331,10
3,1197,33767,3575893321,3575893332,11
3,1197,33768,3575893321,3575893334,13
3,1197,33769,3575893321,3575893334,13
3,1197,33770,3575893321,3575893338,17
3,1197,33771,3575893321,3575893342,21
3,1197,33772,3575893321,3575893342,21
3,1197,33773,3575893321,3575893343,22
3,1197,33774,3575893321,3575893344,23
3,1197,33775,3575893321,3575893344,23
3,1197,33776,3575893321,3575893344,23
3,1197,33777,3575893321,3575893349,28
3,1197,33778,3575893321,3575893354,33
3,1197,33779,3575893321,3575893354,33
3,1197,33780,3575893321,3575893357,36
3,1197,33781,3575893321,3575893359,38
3,1197,33782,3575893321,3575893361,40
3,1197,33783,3575893321,3575893363,42
3,1197,33784,3575893321,3575893364,43
3,1197,33785,3575893321,3575893368,47
3,1198,33786,3575893388,3575893388,0
3,1198,33787,3575893388,3575893388,0
3,1198,33788,3575893388,3575893388,0
3,1198,33789,3575893388,3575893388,0
3,1198,33790,3575893388,3575893388,0
3,1198,33791,3575893388,3575893388,0
3,1198,33792,3575893388,3575893388,0
3,1198,33793,3575893388,3575893388,0
3,1198,33794,3575893388,3575893388,0
3,1198,33795,3575893388,3575893388,0
3,1198,33796,3575893388,3575893388,0
3,1198,33797,3575893388,3575893388,0
3,1198,33798,3575893388,3575893388,0
3,1198,33799,3575893388,3575893391,3
3,1198,33800,3575893388,3575893392,4
3,1198,33801,3575893388,3575893392,4
3,1198,33802,3575893388,3575893392,4
3,1198,33803,3575893388,3575893393,5
3,1198,33804,3575893388,3575893393,5
3,1198,33805,3575893388,3575893393,5
3,1198,33806,3575893388,3575893395,7
3,1198,33807,3575893388,3575893396,8
3,1198,33808,3575893388,3575893397,9
3,1198,33809,3575893388,3575893397,9
3,1198,33810,3575893388,3575893400,12
3,1198,33811,3575893388,3575893401,13
3,1198,33812,3575893388,3575893402,14
3,1198,33813,3575893388,3575893403,15
3,1198,33814,3575893388,3575893403,15
3,1198,33815,3575893388,3575893404,16
3,1198,33816,3575893388,3575893410,22
3,1198,33817,3575893388,3575893413,25
3,1198,33818,3575893388,3575893415,27
3,1198,33819,3575893388,3575893417,29
3,1198,33820,3575893388,3575893418,30
3,1198,33821,3575893388,3575893419,31
3,1198,33822,3575893388,3575893420,32
3,1198,33823,3575893388,3575893420,32
3,1198,33824,3575893388,3575893422,34
3,1198,33825,3575893388,3575893423,35
3,1198,33826,3575893388,3575893424,36
3,1198,33827,3575893388,3575893427,39
3,1198,33828,3575893388,3575893427,39
3,1198,33829,3575893388,3575893427,39
3,1198,33830,3575893388,3575893428,40
3,1198,33831,3575893388,3575893429,41
3,1198,33832,3575893388,3575893430,42
3,1198,33833,3575893388,3575893433,45
3,1198,33834,3575893388,3575893433,45
3,1198,33835,3575893388,3575893436,48
3,1198,33836,3575893388,3575893437,49
3,1199,33837,3575893451,3575893451,0
3,1199,33838,3575893451,3575893451,0
3,1199,33839,3575893451,3575893451,0
3,1199,33840,3575893451,3575893452,1
3,1199,33841,3575893451,3575893452,1
3,1199,33842,3575893451,3575893452,1
3,1199,33843,3575893451,3575893452,1
3,1199,33844,3575893451,3575893452,1
3,1199,33845,3575893451,3575893452,1
3,1199,33846,3575893451,3575893452,1
3,1199,33847,3575893451,3575893452,1
3,1199,33848,3575893451,3575893452,1
3,1199,33849,3575893451,3575893453,2
3,1199,33850,3575893451,3575893454,3
3,1199,33851,3575893451,3575893455,4
3,1199,33852,3575893451,3575893457,6
3,1199,33853,3575893451,3575893460,9
3,1199,33854,3575893451,3575893463,12
3,1199,33855,3575893451,3575893464,13
3,1199,33856,3575893451,3575893464,13
3,1199,33857,3575893451,3575893465,14
3,1199,33858,3575893451,3575893466,15
3,1199,33859,3575893451,3575893466,15
3,1199,33860,3575893451,3575893466,15
3,1199,33861,3575893451,3575893468,17
3,1199,33862,3575893451,3575893475,24
3,1199,33863,3575893451,3575893477,26
3,1199,33864,3575893451,3575893477,26
3,1199,33865,3575893451,3575893481,30
3,1199,33866,3575893451,3575893482,31
3,1199,33867,3575893451,3575893482,31
3,1199,33868,3575893451,3575893485,34
3,1199,33869,3575893451,3575893485,34
3,1199,33870,3575893451,3575893486,35
3,1199,33871,3575893451,3575893486,35
3,1199,33872,3575893451,3575893487,36
3,1199,33873,3575893451,3575893487,36
3,1199,33874,3575893451,3575893488,37
3,1199,33875,3575893451,3575893491,40
3,1199,33876,3575893451,3575893492,41
3,1199,33877,3575893451,3575893493,42
3,1199,33878,3575893451,3575893497,46
3,1199,33879,3575893451,3575893498,47
3,1199,33880,3575893451,3575893500,49
3,1200,33881,3575893518,3575893518,0
3,1200,33882,3575893518,3575893518,0
3,1200,33883,3575893518,3575893518,0
3,1200,33884,3575893518,3575893518,0
3,1200,33885,3575893518,3575893518,0
3,1200,33886,3575893518,3575893518,0
3,1200,33887,3575893518,3575893518,0
3,1200,33888,3575893518,3575893518,0
3,1200,33889,3575893518,3575893518,0
3,1200,33890,3575893518,3575893518,0
3,1200,33891,3575893518,3575893518,0
3,1200,33892,3575893518,3575893518,0
3,1200,33893,3575893518,3575893518,0
3,1200,33894,3575893518,3575893518,0
3,1200,33895,3575893518,3575893520,2
3,1200,33896,3575893518,3575893521,3
3,1200,33897,3575893518,3575893523,5
3,1200,33898,3575893518,3575893526,8
3,1200,33899,3575893518,3575893528,10
3,1200,33900,3575893518,3575893530,12
3,1200,33901,3575893518,3575893530,12
3,1200,33902,3575893518,3575893532,14
3,1200,33903,3575893518,3575893533,15
3,1200,33904,3575893518,3575893533,15
3,1200,33905,3575893518,3575893537,19
3,1200,33906,3575893518,3575893537,19
3,1200,33907,3575893518,3575893541,23
3,1200,33908,3575893518,3575893542,24
3,1200,33909,3575893518,3575893543,25
3,1200,33910,3575893518,3575893543,25
3,1200,33911,3575893518,3575893543,25
3,1200,33912,3575893518,3575893553,35
3,1200,33913,3575893518,3575893554,36
3,1200,33914,3575893518,3575893556,38
3,1200,33915,3575893518,3575893558,40
3,1200,33916,3575893518,3575893561,43
3,1200,33917,3575893518,3575893563,45
3,1200,33918,3575893518,3575893563,45
3,1200,33919,3575893518,3575893567,49
3,1201,33920,3575893581,3575893581,0
3,1201,33921,3575893581,3575893581,0
3,1201,33922,3575893581,3575893581,0
3,1201,33923,3575893581,3575893581,0
3,1201,33924,3575893581,3575893581,0
3,1201,33925,3575893581,3575893581,0
3,1201,33926,3575893581,3575893581,0
3,1201,33927,3575893581,3575893581,0
3,1201,33928,3575893581,3575893582,1
3,1201,33929,3575893581,3575893583,2
3,1201,33930,3575893581,3575893586,5
3,1201,33931,3575893581,3575893586,5
3,1201,33932,3575893581,3575893590,9
3,1201,33933,3575893581,3575893591,10
3,1201,33934,3575893581,3575893591,10
3,1201,33935,3575893581,3575893591,10
3,1201,33936,3575893581,3575893592,11
3,1201,33937,3575893581,3575893593,12
3,1201,33938,3575893581,3575893593,12
3,1201,33939,3575893581,3575893594,13
3,1201,33940,3575893581,3575893595,14
3,1201,33941,3575893581,3575893595,14
3,1201,33942,3575893581,3575893596,15
3,1201,33943,3575893581,3575893596,15
3,1201,33944,3575893581,3575893597,16
3,1201,33945,3575893581,3575893599,18
3,1201,33946,3575893581,3575893599,18
3,1201,33947,3575893581,3575893600,19
3,1201,33948,3575893581,3575893601,20
3,1201,33949,3575893581,3575893602,21
3,1201,33950,3575893581,3575893603,22
3,1201,33951,3575893581,3575893609,28
3,1201,33952,3575893581,3575893613,32
3,1201,33953,3575893581,3575893614,33
3,1201,33954,3575893581,3575893616,35
3,1201,33955,3575893581,3575893617,36
3,1201,33956,3575893581,3575893617,36
3,1201,33957,3575893581,3575893620,39
3,1201,33958,3575893581,3575893620,39
3,1201,33959,3575893581,3575893625,44
3,1201,33960,3575893581,3575893626,45
3,1201,33961,3575893581,3575893627,46
3,1201,33962,3575893581,3575893627,46
3,1201,33963,3575893581,3575893630,49
3,1202,33964,3575893646,3575893646,0
3,1202,33965,3575893646,3575893646,0
3,1202,33966,3575893646,3575893646,0
3,1202,33967,3575893646,3575893646,0
3,1202,33968,3575893646,3575893646,0
3,1202,33969,3575893646,3575893646,0
3,1202,33970,3575893646,3575893646,0
3,1202,33971,3575893646,3575893646,0
3,1202,33972,3575893646,3575893646,0
3,1202,33973,3575893646,3575893646,0
3,1202,33974,3575893646,3575893646,0
3,1202,33975,3575893646,3575893646,0
3,1202,33976,3575893646,3575893647,1
3,1202,33977,3575893646,3575893651,5
3,1202,33978,3575893646,3575893652,6
3,1202,33979,3575893646,3575893653,7
3,1202,33980,3575893646,3575893654,8
3,1202,33981,3575893646,3575893656,10
3,1202,33982,3575893646,3575893656,10
3,1202,33983,3575893646,3575893659,13
3,1202,33984,3575893646,3575893662,16
3,1202,33985,3575893646,3575893663,17
3,1202,33986,3575893646,3575893664,18
3,1202,33987,3575893646,3575893664,18
3,1202,33988,3575893646,3575893665,19
3,1202,33989,3575893646,3575893665,19
3,1202,33990,3575893646,3575893667,21
3,1202,33991,3575893646,3575893669,23
3,1202,33992,3575893646,3575893675,29
3,1202,33993,3575893646,3575893677,31
3,1202,33994,3575893646,3575893681,35
3,1202,33995,3575893646,3575893682,36
3,1202,33996,3575893646,3575893682,36
3,1202,33997,3575893646,3575893684,38
3,1202,33998,3575893646,3575893686,40
3,1202,33999,3575893646,3575893687,41
3,1202,34000,3575893646,3575893688,42
3,1202,34001,3575893646,3575893691,45
3,1202,34002,3575893646,3575893692,46
3,1202,34003,3575893646,3575893692,46
3,1202,34004,3575893646,3575893693,47
3,1202,34005,3575893646,3575893694,48
3,1203,34006,3575893711,3575893711,0
3,1203,34007,3575893711,3575893711,0
3,1203,34008,3575893711,3575893711,0
3,1203,34009,3575893711,3575893711,0
3,1203,34010,3575893711,3575893711,0
3,1203,34011,3575893711,3575893711,0
3,1203,34012,3575893711,3575893711,0
3,1203,34013,3575893711,3575893711,0
3,1203,34014,3575893711,3575893711,0
3,1203,34015,3575893711,3575893711,0
3,1203,34016,3575893711,3575893711,0
3,1203,34017,3575893711,3575893711,0
3,1203,34018,3575893711,3575893712,1
3,1203,34019,3575893711,3575893712,1
3,1203,34020,3575893711,3575893713,2
3,1203,34021,3575893711,3575893716,5
3,1203,34022,3575893711,3575893717,6
3,1203,34023,3575893711,3575893717,6
3,1203,34024,3575893711,3575893717,6
3,1203,34025,3575893711,3575893718,7
3,1203,34026,3575893711,3575893718,7
3,1203,34027,3575893711,3575893720,9
3,1203,34028,3575893711,3575893723,12
3,1203,34029,3575893711,3575893724,13
3,1203,34030,3575893711,3575893726,15
3,1203,34031,3575893711,3575893729,18
3,1203,34032,3575893711,3575893729,18
3,1203,34033,3575893711,3575893731,20
3,1203,34034,3575893711,3575893733,22
3,1203,34035,3575893711,3575893734,23
3,1203,34036,3575893711,3575893737,26
3,1203,34037,3575893711,3575893741,30
3,1203,34038,3575893711,3575893742,31
3,1203,34039,3575893711,3575893742,31
3,1203,34040,3575893711,3575893743,32
3,1203,34041,3575893711,3575893743,32
3,1203,34042,3575893711,3575893743,32
3,1203,34043,3575893711,3575893749,38
3,1203,34044,3575893711,3575893754,43
3,1203,34045,3575893711,3575893754,43
3,1203,34046,3575893711,3575893759,48
3,1203,34047,3575893711,3575893761,50
3,1204,34048,3575893775,3575893775,0
3,1204,34049,3575893775,3575893775,0
3,1204,34050,3575893775,3575893775,0
3,1204,34051,3575893775,3575893775,0
3,1204,34052,3575893775,3575893775,0
3,1204,34053,3575893775,3575893775,0
3,1204,34054,3575893775,3575893775,0
3,1204,34055,3575893775,3575893775,0
3,1204,34056,3575893775,3575893779,4
3,1204,34057,3575893775,3575893780,5
3,1204,34058,3575893775,3575893780,5
3,1204,34059,3575893775,3575893780,5
3,1204,34060,3575893775,3575893781,6
3,1204,34061,3575893775,3575893782,7
3,1204,34062,3575893775,3575893783,8
3,1204,34063,3575893775,3575893785,10
3,1204,34064,3575893775,3575893786,11
3,1204,34065,3575893775,3575893787,12
3,1204,34066,3575893775,3575893790,15
3,1204,34067,3575893775,3575893790,15
3,1204,34068,3575893775,3575893791,16
3,1204,34069,3575893775,3575893791,16
3,1204,34070,3575893775,3575893793,18
3,1204,34071,3575893775,3575893794,19
3,1204,34072,3575893775,3575893794,19
3,1204,34073,3575893775,3575893795,20
3,1204,34074,3575893775,3575893795,20
3,1204,34075,3575893775,3575893797,22
3,1204,34076,3575893775,3575893797,22
3,1204,34077,3575893775,3575893797,22
3,1204,34078,3575893775,3575893797,22
3,1204,34079,3575893775,3575893799,24
3,1204,34080,3575893775,3575893802,27
3,1204,34081,3575893775,3575893803,28
3,1204,34082,3575893775,3575893803,28
3,1204,34083,3575893775,3575893809,34
3,1204,34084,3575893775,3575893814,39
3,1204,34085,3575893775,3575893817,42
3,1204,34086,3575893775,3575893817,42
3,1204,34087,3575893775,3575893817,42
3,1204,34088,3575893775,3575893818,43
3,1204,34089,3575893775,3575893820,45
3,1204,34090,3575893775,3575893821,46
3,1204,34091,3575893775,3575893823,48
3,1205,34092,3575893842,3575893842,0
3,1205,34093,3575893842,3575893842,0
3,1205,34094,3575893842,3575893842,0
3,1205,34095,3575893842,3575893842,0
3,1205,34096,3575893842,3575893842,0
3,1205,34097,3575893842,3575893842,0
3,1205,34098,3575893842,3575893842,0
3,1205,34099,3575893842,3575893842,0
3,1205,34100,3575893842,3575893842,0
3,1205,34101,3575893842,3575893842,0
3,1205,34102,3575893842,3575893842,0
3,1205,34103,3575893842,3575893842,0
3,1205,34104,3575893842,3575893842,0
3,1205,34105,3575893842,3575893842,0
3,1205,34106,3575893842,3575893842,0
3,1205,34107,3575893842,3575893842,0
3,1205,34108,3575893842,3575893842,0
3,1205,34109,3575893842,3575893843,1
3,1205,34110,3575893842,3575893844,2
3,1205,34111,3575893842,3575893845,3
3,1205,34112,3575893842,3575893847,5
3,1205,34113,3575893842,3575893849,7
3,1205,34114,3575893842,3575893851,9
3,1205,34115,3575893842,3575893853,11
3,1205,34116,3575893842,3575893854,12
3,1205,34117,3575893842,3575893856,14
3,1205,34118,3575893842,3575893856,14
3,1205,34119,3575893842,3575893859,17
3,1205,34120,3575893842,3575893863,21
3,1205,34121,3575893842,3575893864,22
3,1205,34122,3575893842,3575893864,22
3,1205,34123,3575893842,3575893865,23
3,1205,34124,3575893842,3575893867,25
3,1205,34125,3575893842,3575893875,33
3,1205,34126,3575893842,3575893877,35
3,1205,34127,3575893842,3575893877,35
3,1205,34128,3575893842,3575893882,40
3,1205,34129,3575893842,3575893883,41
3,1205,34130,3575893842,3575893885,43
3,1205,34131,3575893842,3575893885,43
3,1205,34132,3575893842,3575893885,43
3,1205,34133,3575893842,3575893887,45
3,1205,34134,3575893842,3575893888,46
3,1205,34135,3575893842,3575893888,46
3,1205,34136,3575893842,3575893891,49
3,1205,34137,3575893842,3575893892,50
3,1206,34138,3575893905,3575893905,0
3,1206,34139,3575893905,3575893905,0
3,1206,34140,3575893905,3575893905,0
3,1206,34141,3575893905,3575893905,0
3,1206,34142,3575893905,3575893905,0
3,1206,34143,3575893905,3575893905,0
3,1206,34144,3575893905,3575893907,2
3,1206,34145,3575893905,3575893908,3
3,1206,34146,3575893905,3575893909,4
3,1206,34147,3575893905,3575893909,4
3,1206,34148,3575893905,3575893911,6
3,1206,34149,3575893905,3575893916,11
3,1206,34150,3575893905,3575893917,12
3,1206,34151,3575893905,3575893917,12
3,1206,34152,3575893905,3575893917,12
3,1206,34153,3575893905,3575893918,13
3,1206,34154,3575893905,3575893919,14
3,1206,34155,3575893905,3575893920,15
3,1206,34156,3575893905,3575893920,15
3,1206,34157,3575893905,3575893922,17
3,1206,34158,3575893905,3575893924,19
3,1206,34159,3575893905,3575893926,21
3,1206,34160,3575893905,3575893929,24
3,1206,34161,3575893905,3575893929,24
3,1206,34162,3575893905,3575893931,26
3,1206,34163,3575893905,3575893933,28
3,1206,34164,3575893905,3575893934,29
3,1206,34165,3575893905,3575893937,32
3,1206,34166,3575893905,3575893938,33
3,1206,34167,3575893905,3575893942,37
3,1206,34168,3575893905,3575893943,38
3,1206,34169,3575893905,3575893943,38
3,1206,34170,3575893905,3575893944,39
3,1206,34171,3575893905,3575893944,39
3,1206,34172,3575893905,3575893949,44
3,1206,34173,3575893905,3575893954,49
3,1206,34174,3575893905,3575893955,50
3,1207,34175,3575893970,3575893970,0
3,1207,34176,3575893970,3575893970,0
3,1207,34177,3575893970,3575893970,0
3,1207,34178,3575893970,3575893970,0
3,1207,34179,3575893970,3575893970,0
3,1207,34180,3575893970,3575893970,0
3,1207,34181,3575893970,3575893970,0
3,1207,34182,3575893970,3575893971,1
3,1207,34183,3575893970,3575893972,2
3,1207,34184,3575893970,3575893974,4
3,1207,34185,3575893970,3575893978,8
3,1207,34186,3575893970,3575893979,9
3,1207,34187,3575893970,3575893979,9
3,1207,34188,3575893970,3575893979,9
3,1207,34189,3575893970,3575893980,10
3,1207,34190,3575893970,3575893981,11
3,1207,34191,3575893970,3575893982,12
3,1207,34192,3575893970,3575893983,13
3,1207,34193,3575893970,3575893986,16
3,1207,34194,3575893970,3575893986,16
3,1207,34195,3575893970,3575893987,17
3,1207,34196,3575893970,3575893990,20
3,1207,34197,3575893970,3575893991,21
3,1207,34198,3575893970,3575893991,21
3,1207,34199,3575893970,3575893992,22
3,1207,34200,3575893970,3575893993,23
3,1207,34201,3575893970,3575893994,24
3,1207,34202,3575893970,3575893995,25
3,1207,34203,3575893970,3575893995,25
3,1207,34204,3575893970,3575893995,25
3,1207,34205,3575893970,3575893996,26
3,1207,34206,3575893970,3575893996,26
3,1207,34207,3575893970,3575893997,27
3,1207,34208,3575893970,3575893997,27
3,1207,34209,3575893970,3575893999,29
3,1207,34210,3575893970,3575894000,30
3,1207,34211,3575893970,3575894002,32
3,1207,34212,3575893970,3575894002,32
3,1207,34213,3575893970,3575894003,33
3,1207,34214,3575893970,3575894009,39
3,1207,34215,3575893970,3575894015,45
3,1207,34216,3575893970,3575894015,45
3,1207,34217,3575893970,3575894016,46
3,1207,34218,3575893970,3575894017,47
3,1207,34219,3575893970,3575894017,47
3,1207,34220,3575893970,3575894017,47
3,1207,34221,3575893970,3575894020,50
3,1208,34222,3575894033,3575894033,0
3,1208,34223,3575894033,3575894033,0
3,1208,34224,3575894033,3575894033,0
3,1208,34225,3575894033,3575894033,0
3,1208,34226,3575894033,3575894033,0
3,1208,34227,3575894033,3575894033,0
3,1208,34228,3575894033,3575894033,0
3,1208,34229,3575894033,3575894033,0
3,1208,34230,3575894033,3575894033,0
3,1208,34231,3575894033,3575894033,0
3,1208,34232,3575894033,3575894033,0
3,1208,34233,3575894033,3575894033,0
3,1208,34234,3575894033,3575894033,0
3,1208,34235,3575894033,3575894035,2
3,1208,34236,3575894033,3575894035,2
3,1208,34237,3575894033,3575894037,4
3,1208,34238,3575894033,3575894038,5
3,1208,34239,3575894033,3575894040,7
3,1208,34240,3575894033,3575894040,7
3,1208,34241,3575894033,3575894040,7
3,1208,34242,3575894033,3575894041,8
3,1208,34243,3575894033,3575894041,8
3,1208,34244,3575894033,3575894044,11
3,1208,34245,3575894033,3575894044,11
3,1208,34246,3575894033,3575894045,12
3,1208,34247,3575894033,3575894045,12
3,1208,34248,3575894033,3575894047,14
3,1208,34249,3575894033,3575894050,17
3,1208,34250,3575894033,3575894052,19
3,1208,34251,3575894033,3575894052,19
3,1208,34252,3575894033,3575894055,22
3,1208,34253,3575894033,3575894057,24
3,1208,34254,3575894033,3575894058,25
3,1208,34255,3575894033,3575894059,26
3,1208,34256,3575894033,3575894063,30
3,1208,34257,3575894033,3575894064,31
3,1208,34258,3575894033,3575894064,31
3,1208,34259,3575894033,3575894065,32
3,1208,34260,3575894033,3575894065,32
3,1208,34261,3575894033,3575894066,33
3,1208,34262,3575894033,3575894067,34
3,1208,34263,3575894033,3575894069,36
3,1208,34264,3575894033,3575894075,42
3,1208,34265,3575894033,3575894077,44
3,1208,34266,3575894033,3575894077,44
3,1208,34267,3575894033,3575894082,49
3,1209,34268,3575894097,3575894097,0
3,1209,34269,3575894097,3575894097,0
3,1209,34270,3575894097,3575894097,0
3,1209,34271,3575894097,3575894097,0
3,1209,34272,3575894097,3575894097,0
3,1209,34273,3575894097,3575894097,0
3,1209,34274,3575894097,3575894097,0
3,1209,34275,3575894097,3575894097,0
3,1209,34276,3575894097,3575894098,1
3,1209,34277,3575894097,3575894100,3
3,1209,34278,3575894097,3575894101,4
3,1209,34279,3575894097,3575894102,5
3,1209,34280,3575894097,3575894104,7
3,1209,34281,3575894097,3575894104,7
3,1209,34282,3575894097,3575894104,7
3,1209,34283,3575894097,3575894107,10
3,1209,34284,3575894097,3575894108,11
3,1209,34285,3575894097,3575894110,13
3,1209,34286,3575894097,3575894110,13
3,1209,34287,3575894097,3575894112,15
3,1209,34288,3575894097,3575894112,15
3,1209,34289,3575894097,3575894113,16
3,1209,34290,3575894097,3575894117,20
3,1209,34291,3575894097,3575894117,20
3,1209,34292,3575894097,3575894117,20
3,1209,34293,3575894097,3575894117,20
3,1209,34294,3575894097,3575894118,21
3,1209,34295,3575894097,3575894119,22
3,1209,34296,3575894097,3575894121,24
3,1209,34297,3575894097,3575894123,26
3,1209,34298,3575894097,3575894124,27
3,1209,34299,3575894097,3575894128,31
3,1209,34300,3575894097,3575894130,33
3,1209,34301,3575894097,3575894131,34
3,1209,34302,3575894097,3575894133,36
3,1209,34303,3575894097,3575894135,38
3,1209,34304,3575894097,3575894137,40
3,1209,34305,3575894097,3575894139,42
3,1209,34306,3575894097,3575894141,44
3,1209,34307,3575894097,3575894142,45
3,1209,34308,3575894097,3575894143,46
3,1209,34309,3575894097,3575894143,46
3,1209,34310,3575894097,3575894143,46
3,1209,34311,3575894097,3575894144,47
3,1210,34312,3575894160,3575894160,0
3,1210,34313,3575894160,3575894160,0
3,1210,34314,3575894160,3575894160,0
3,1210,34315,3575894160,3575894160,0
3,1210,34316,3575894160,3575894160,0
3,1210,34317,3575894160,3575894161,1
3,1210,34318,3575894160,3575894163,3
3,1210,34319,3575894160,3575894164,4
3,1210,34320,3575894160,3575894168,8
3,1210,34321,3575894160,3575894171,11
3,1210,34322,3575894160,3575894171,11
3,1210,34323,3575894160,3575894172,12
3,1210,34324,3575894160,3575894172,12
3,1210,34325,3575894160,3575894175,15
3,1210,34326,3575894160,3575894179,19
3,1210,34327,3575894160,3575894179,19
3,1210,34328,3575894160,3575894180,20
3,1210,34329,3575894160,3575894181,21
3,1210,34330,3575894160,3575894182,22
3,1210,34331,3575894160,3575894183,23
3,1210,34332,3575894160,3575894186,26
3,1210,34333,3575894160,3575894188,28
3,1210,34334,3575894160,3575894191,31
3,1210,34335,3575894160,3575894191,31
3,1210,34336,3575894160,3575894192,32
3,1210,34337,3575894160,3575894192,32
3,1210,34338,3575894160,3575894193,33
3,1210,34339,3575894160,3575894194,34
3,1210,34340,3575894160,3575894195,35
3,1210,34341,3575894160,3575894195,35
3,1210,34342,3575894160,3575894195,35
3,1210,34343,3575894160,3575894196,36
3,1210,34344,3575894160,3575894196,36
3,1210,34345,3575894160,3575894197,37
3,1210,34346,3575894160,3575894198,38
3,1210,34347,3575894160,3575894199,39
3,1210,34348,3575894160,3575894200,40
3,1210,34349,3575894160,3575894203,43
3,1210,34350,3575894160,3575894203,43
3,1210,34351,3575894160,3575894209,49
3,1211,34352,3575894224,3575894224,0
3,1211,34353,3575894224,3575894224,0
3,1211,34354,3575894224,3575894224,0
3,1211,34355,3575894224,3575894224,0
3,1211,34356,3575894224,3575894224,0
3,1211,34357,3575894224,3575894224,0
3,1211,34358,3575894224,3575894224,0
3,1211,34359,3575894224,3575894224,0
3,1211,34360,3575894224,3575894224,0
3,1211,34361,3575894224,3575894225,1
3,1211,34362,3575894224,3575894226,2
3,1211,34363,3575894224,3575894226,2
3,1211,34364,3575894224,3575894228,4
3,1211,34365,3575894224,3575894229,5
3,1211,34366,3575894224,3575894229,5
3,1211,34367,3575894224,3575894230,6
3,1211,34368,3575894224,3575894232,8
3,1211,34369,3575894224,3575894236,12
3,1211,34370,3575894224,3575894237,13
3,1211,34371,3575894224,3575894238,14
3,1211,34372,3575894224,3575894240,16
3,1211,34373,3575894224,3575894240,16
3,1211,34374,3575894224,3575894241,17
3,1211,34375,3575894224,3575894244,20
3,1211,34376,3575894224,3575894244,20
3,1211,34377,3575894224,3575894245,21
3,1211,34378,3575894224,3575894246,22
3,1211,34379,3575894224,3575894252,28
3,1211,34380,3575894224,3575894252,28
3,1211,34381,3575894224,3575894253,29
3,1211,34382,3575894224,3575894255,31
3,1211,34383,3575894224,3575894256,32
3,1211,34384,3575894224,3575894258,34
3,1211,34385,3575894224,3575894264,40
3,1211,34386,3575894224,3575894264,40
3,1211,34387,3575894224,3575894265,41
3,1211,34388,3575894224,3575894265,41
3,1211,34389,3575894224,3575894266,42
3,1211,34390,3575894224,3575894266,42
3,1211,34391,3575894224,3575894267,43
3,1211,34392,3575894224,3575894274,50
3,1212,34393,3575894290,3575894290,0
3,1212,34394,3575894290,3575894290,0
3,1212,34395,3575894290,3575894290,0
3,1212,34396,3575894290,3575894290,0
3,1212,34397,3575894290,3575894290,0
3,1212,34398,3575894290,3575894290,0
3,1212,34399,3575894290,3575894290,0
3,1212,34400,3575894290,3575894290,0
3,1212,34401,3575894290,3575894290,0
3,1212,34402,3575894290,3575894290,0
3,1212,34403,3575894290,3575894293,3
3,1212,34404,3575894290,3575894294,4
3,1212,34405,3575894290,3575894297,7
3,1212,34406,3575894290,3575894299,9
3,1212,34407,3575894290,3575894299,9
3,1212,34408,3575894290,3575894300,10
3,1212,34409,3575894290,3575894301,11
3,1212,34410,3575894290,3575894304,14
3,1212,34411,3575894290,3575894304,14
3,1212,34412,3575894290,3575894307,17
3,1212,34413,3575894290,3575894308,18
3,1212,34414,3575894290,3575894310,20
3,1212,34415,3575894290,3575894310,20
3,1212,34416,3575894290,3575894312,22
3,1212,34417,3575894290,3575894313,23
3,1212,34418,3575894290,3575894317,27
3,1212,34419,3575894290,3575894317,27
3,1212,34420,3575894290,3575894318,28
3,1212,34421,3575894290,3575894318,28
3,1212,34422,3575894290,3575894318,28
3,1212,34423,3575894290,3575894319,29
3,1212,34424,3575894290,3575894321,31
3,1212,34425,3575894290,3575894321,31
3,1212,34426,3575894290,3575894322,32
3,1212,34427,3575894290,3575894324,34
3,1212,34428,3575894290,3575894328,38
3,1212,34429,3575894290,3575894331,41
3,1212,34430,3575894290,3575894332,42
3,1212,34431,3575894290,3575894334,44
3,1212,34432,3575894290,3575894335,45
3,1212,34433,3575894290,3575894339,49
3,1213,34434,3575894353,3575894353,0
3,1213,34435,3575894353,3575894353,0
3,1213,34436,3575894353,3575894353,0
3,1213,34437,3575894353,3575894353,0
3,1213,34438,3575894353,3575894353,0
3,1213,34439,3575894353,3575894353,0
3,1213,34440,3575894353,3575894353,0
3,1213,34441,3575894353,3575894356,3
3,1213,34442,3575894353,3575894357,4
3,1213,34443,3575894353,3575894361,8
3,1213,34444,3575894353,3575894362,9
3,1213,34445,3575894353,3575894364,11
3,1213,34446,3575894353,3575894364,11
3,1213,34447,3575894353,3575894368,15
3,1213,34448,3575894353,3575894371,18
3,1213,34449,3575894353,3575894372,19
3,1213,34450,3575894353,3575894372,19
3,1213,34451,3575894353,3575894372,19
3,1213,34452,3575894353,3575894374,21
3,1213,34453,3575894353,3575894379,26
3,1213,34454,3575894353,3575894379,26
3,1213,34455,3575894353,3575894381,28
3,1213,34456,3575894353,3575894381,28
3,1213,34457,3575894353,3575894381,28
3,1213,34458,3575894353,3575894382,29
3,1213,34459,3575894353,3575894383,30
3,1213,34460,3575894353,3575894387,34
3,1213,34461,3575894353,3575894388,35
3,1213,34462,3575894353,3575894392,39
3,1213,34463,3575894353,3575894393,40
3,1213,34464,3575894353,3575894393,40
3,1213,34465,3575894353,3575894394,41
3,1213,34466,3575894353,3575894395,42
3,1213,34467,3575894353,3575894396,43
3,1213,34468,3575894353,3575894396,43
3,1213,34469,3575894353,3575894397,44
3,1213,34470,3575894353,3575894397,44
3,1213,34471,3575894353,3575894399,46
3,1213,34472,3575894353,3575894400,47
3,1213,34473,3575894353,3575894400,47
3,1213,34474,3575894353,3575894403,50
3,1214,34475,3575894418,3575894418,0
3,1214,34476,3575894418,3575894418,0
3,1214,34477,3575894418,3575894418,0
3,1214,34478,3575894418,3575894418,0
3,1214,34479,3575894418,3575894418,0
3,1214,34480,3575894418,3575894418,0
3,1214,34481,3575894418,3575894418,0
3,1214,34482,3575894418,3575894420,2
3,1214,34483,3575894418,3575894423,5
3,1214,34484,3575894418,3575894425,7
3,1214,34485,3575894418,3575894426,8
3,1214,34486,3575894418,3575894427,9
3,1214,34487,3575894418,3575894428,10
3,1214,34488,3575894418,3575894428,10
3,1214,34489,3575894418,3575894428,10
3,1214,34490,3575894418,3575894430,12
3,1214,34491,3575894418,3575894431,13
3,1214,34492,3575894418,3575894432,14
3,1214,34493,3575894418,3575894435,17
3,1214,34494,3575894418,3575894436,18
3,1214,34495,3575894418,3575894438,20
3,1214,34496,3575894418,3575894438,20
3,1214,34497,3575894418,3575894440,22
3,1214,34498,3575894418,3575894441,23
3,1214,34499,3575894418,3575894441,23
3,1214,34500,3575894418,3575894442,24
3,1214,34501,3575894418,3575894444,26
3,1214,34502,3575894418,3575894445,27
3,1214,34503,3575894418,3575894446,28
3,1214,34504,3575894418,3575894447,29
3,1214,34505,3575894418,3575894449,31
3,1214,34506,3575894418,3575894452,34
3,1214,34507,3575894418,3575894452,34
3,1214,34508,3575894418,3575894454,36
3,1214,34509,3575894418,3575894456,38
3,1214,34510,3575894418,3575894457,39
3,1214,34511,3575894418,3575894457,39
3,1214,34512,3575894418,3575894458,40
3,1214,34513,3575894418,3575894460,42
3,1214,34514,3575894418,3575894464,46
3,1214,34515,3575894418,3575894465,47
3,1214,34516,3575894418,3575894465,47
3,1214,34517,3575894418,3575894465,47
3,1214,34518,3575894418,3575894466,48
3,1214,34519,3575894418,3575894466,48
3,1214,34520,3575894418,3575894467,49
3,1214,34521,3575894418,3575894468,50
3,1215,34522,3575894480,3575894481,1
3,1215,34523,3575894480,3575894481,1
3,1215,34524,3575894480,3575894481,1
3,1215,34525,3575894480,3575894481,1
3,1215,34526,3575894480,3575894481,1
3,1215,34527,3575894480,3575894484,4
3,1215,34528,3575894480,3575894485,5
3,1215,34529,3575894480,3575894486,6
3,1215,34530,3575894480,3575894489,9
3,1215,34531,3575894480,3575894489,9
3,1215,34532,3575894480,3575894491,11
3,1215,34533,3575894480,3575894492,12
3,1215,34534,3575894480,3575894492,12
3,1215,34535,3575894480,3575894493,13
3,1215,34536,3575894480,3575894495,15
3,1215,34537,3575894480,3575894497,17
3,1215,34538,3575894480,3575894498,18
3,1215,34539,3575894480,3575894499,19
3,1215,34540,3575894480,3575894500,20
3,1215,34541,3575894480,3575894501,21
3,1215,34542,3575894480,3575894501,21
3,1215,34543,3575894480,3575894503,23
3,1215,34544,3575894480,3575894504,24
3,1215,34545,3575894480,3575894504,24
3,1215,34546,3575894480,3575894506,26
3,1215,34547,3575894480,3575894507,27
3,1215,34548,3575894480,3575894509,29
3,1215,34549,3575894480,3575894511,31
3,1215,34550,3575894480,3575894512,32
3,1215,34551,3575894480,3575894513,33
3,1215,34552,3575894480,3575894516,36
3,1215,34553,3575894480,3575894517,37
3,1215,34554,3575894480,3575894517,37
3,1215,34555,3575894480,3575894518,38
3,1215,34556,3575894480,3575894519,39
3,1215,34557,3575894480,3575894520,40
3,1215,34558,3575894480,3575894521,41
3,1215,34559,3575894480,3575894523,43
3,1215,34560,3575894480,3575894527,47
3,1215,34561,3575894480,3575894530,50
3,1216,34562,3575894550,3575894550,0
3,1216,34563,3575894550,3575894550,0
3,1216,34564,3575894550,3575894550,0
3,1216,34565,3575894550,3575894550,0
3,1216,34566,3575894550,3575894550,0
3,1216,34567,3575894550,3575894550,0
3,1216,34568,3575894550,3575894550,0
3,1216,34569,3575894550,3575894550,0
3,1216,34570,3575894550,3575894552,2
3,1216,34571,3575894550,3575894553,3
3,1216,34572,3575894550,3575894554,4
3,1216,34573,3575894550,3575894556,6
3,1216,34574,3575894550,3575894560,10
3,1216,34575,3575894550,3575894563,13
3,1216,34576,3575894550,3575894564,14
3,1216,34577,3575894550,3575894567,17
3,1216,34578,3575894550,3575894569,19
3,1216,34579,3575894550,3575894571,21
3,1216,34580,3575894550,3575894571,21
3,1216,34581,3575894550,3575894571,21
3,1216,34582,3575894550,3575894572,22
3,1216,34583,3575894550,3575894578,28
3,1216,34584,3575894550,3575894579,29
3,1216,34585,3575894550,3575894579,29
3,1216,34586,3575894550,3575894579,29
3,1216,34587,3575894550,3575894580,30
3,1216,34588,3575894550,3575894581,31
3,1216,34589,3575894550,3575894582,32
3,1216,34590,3575894550,3575894582,32
3,1216,34591,3575894550,3575894585,35
3,1216,34592,3575894550,3575894585,35
3,1216,34593,3575894550,3575894587,37
3,1216,34594,3575894550,3575894590,40
3,1216,34595,3575894550,3575894590,40
3,1216,34596,3575894550,3575894591,41
3,1216,34597,3575894550,3575894592,42
3,1216,34598,3575894550,3575894593,43
3,1216,34599,3575894550,3575894594,44
3,1216,34600,3575894550,3575894594,44
3,1216,34601,3575894550,3575894595,45
3,1216,34602,3575894550,3575894595,45
3,1216,34603,3575894550,3575894595,45
3,1216,34604,3575894550,3575894596,46
3,1216,34605,3575894550,3575894596,46
3,1216,34606,3575894550,3575894599,49
3,1216,34607,3575894550,3575894599,49
3,1216,34608,3575894550,3575894600,50
3,1217,34609,3575894613,3575894613,0
3,1217,34610,3575894613,3575894613,0
3,1217,34611,3575894613,3575894613,0
3,1217,34612,3575894613,3575894613,0
3,1217,34613,3575894613,3575894614,1
3,1217,34614,3575894613,3575894615,2
3,1217,34615,3575894613,3575894616,3
3,1217,34616,3575894613,3575894616,3
3,1217,34617,3575894613,3575894616,3
3,1217,34618,3575894613,3575894618,5
3,1217,34619,3575894613,3575894619,6
3,1217,34620,3575894613,3575894619,6
3,1217,34621,3575894613,3575894621,8
3,1217,34622,3575894613,3575894626,13
3,1217,34623,3575894613,3575894626,13
3,1217,34624,3575894613,3575894626,13
3,1217,34625,3575894613,3575894627,14
3,1217,34626,3575894613,3575894627,14
3,1217,34627,3575894613,3575894628,15
3,1217,34628,3575894613,3575894629,16
3,1217,34629,3575894613,3575894630,17
3,1217,34630,3575894613,3575894631,18
3,1217,34631,3575894613,3575894634,21
3,1217,34632,3575894613,3575894636,23
3,1217,34633,3575894613,3575894637,24
3,1217,34634,3575894613,3575894637,24
3,1217,34635,3575894613,3575894638,25
3,1217,34636,3575894613,3575894639,26
3,1217,34637,3575894613,3575894640,27
3,1217,34638,3575894613,3575894641,28
3,1217,34639,3575894613,3575894642,29
3,1217,34640,3575894613,3575894642,29
3,1217,34641,3575894613,3575894643,30
3,1217,34642,3575894613,3575894643,30
3,1217,34643,3575894613,3575894646,33
3,1217,34644,3575894613,3575894648,35
3,1217,34645,3575894613,3575894650,37
3,1217,34646,3575894613,3575894651,38
3,1217,34647,3575894613,3575894655,42
3,1217,34648,3575894613,3575894656,43
3,1217,34649,3575894613,3575894656,43
3,1217,34650,3575894613,3575894657,44
3,1217,34651,3575894613,3575894658,45
3,1218,34652,3575894678,3575894678,0
3,1218,34653,3575894678,3575894678,0
3,1218,34654,3575894678,3575894678,0
3,1218,34655,3575894678,3575894678,0
3,1218,34656,3575894678,3575894678,0
3,1218,34657,3575894678,3575894678,0
3,1218,34658,3575894678,3575894678,0
3,1218,34659,3575894678,3575894678,0
3,1218,34660,3575894678,3575894678,0
3,1218,34661,3575894678,3575894678,0
3,1218,34662,3575894678,3575894678,0
3,1218,34663,3575894678,3575894681,3
3,1218,34664,3575894678,3575894681,3
3,1218,34665,3575894678,3575894684,6
3,1218,34666,3575894678,3575894684,6
3,1218,34667,3575894678,3575894685,7
3,1218,34668,3575894678,3575894685,7
3,1218,34669,3575894678,3575894686,8
3,1218,34670,3575894678,3575894686,8
3,1218,34671,3575894678,3575894689,11
3,1218,34672,3575894678,3575894689,11
3,1218,34673,3575894678,3575894690,12
3,1218,34674,3575894678,3575894693,15
3,1218,34675,3575894678,3575894693,15
3,1218,34676,3575894678,3575894696,18
3,1218,34677,3575894678,3575894697,19
3,1218,34678,3575894678,3575894699,21
3,1218,34679,3575894678,3575894701,23
3,1218,34680,3575894678,3575894702,24
3,1218,34681,3575894678,3575894703,25
3,1218,34682,3575894678,3575894704,26
3,1218,34683,3575894678,3575894706,28
3,1218,34684,3575894678,3575894707,29
3,1218,34685,3575894678,3575894709,31
3,1218,34686,3575894678,3575894710,32
3,1218,34687,3575894678,3575894712,34
3,1218,34688,3575894678,3575894716,38
3,1218,34689,3575894678,3575894717,39
3,1218,34690,3575894678,3575894717,39
3,1218,34691,3575894678,3575894717,39
3,1218,34692,3575894678,3575894718,40
3,1218,34693,3575894678,3575894719,41
3,1218,34694,3575894678,3575894720,42
3,1218,34695,3575894678,3575894720,42
3,1218,34696,3575894678,3575894721,43
3,1218,34697,3575894678,3575894723,45
3,1218,34698,3575894678,3575894727,49
3,1219,34699,3575894745,3575894745,0
3,1219,34700,3575894745,3575894745,0
3,1219,34701,3575894745,3575894745,0
3,1219,34702,3575894745,3575894745,0
3,1219,34703,3575894745,3575894745,0
3,1219,34704,3575894745,3575894745,0
3,1219,34705,3575894745,3575894745,0
3,1219,34706,3575894745,3575894745,0
3,1219,34707,3575894745,3575894745,0
3,1219,34708,3575894745,3575894745,0
3,1219,34709,3575894745,3575894745,0
3,1219,34710,3575894745,3575894748,3
3,1219,34711,3575894745,3575894751,6
3,1219,34712,3575894745,3575894753,8
3,1219,34713,3575894745,3575894754,9
3,1219,34714,3575894745,3575894756,11
3,1219,34715,3575894745,3575894758,13
3,1219,34716,3575894745,3575894760,15
3,1219,34717,3575894745,3575894763,18
3,1219,34718,3575894745,3575894763,18
3,1219,34719,3575894745,3575894767,22
3,1219,34720,3575894745,3575894771,26
3,1219,34721,3575894745,3575894771,26
3,1219,34722,3575894745,3575894771,26
3,1219,34723,3575894745,3575894772,27
3,1219,34724,3575894745,3575894773,28
3,1219,34725,3575894745,3575894778,33
3,1219,34726,3575894745,3575894779,34
3,1219,34727,3575894745,3575894779,34
3,1219,34728,3575894745,3575894780,35
3,1219,34729,3575894745,3575894782,37
3,1219,34730,3575894745,3575894782,37
3,1219,34731,3575894745,3575894783,38
3,1219,34732,3575894745,3575894786,41
3,1219,34733,3575894745,3575894786,41
3,1219,34734,3575894745,3575894787,42
3,1219,34735,3575894745,3575894791,46
3,1219,34736,3575894745,3575894791,46
3,1219,34737,3575894745,3575894792,47
3,1219,34738,3575894745,3575894792,47
3,1219,34739,3575894745,3575894793,48
3,1219,34740,3575894745,3575894794,49
3,1219,34741,3575894745,3575894795,50
3,1220,34742,3575894809,3575894809,0
3,1220,34743,3575894809,3575894809,0
3,1220,34744,3575894809,3575894809,0
3,1220,34745,3575894809,3575894809,0
3,1220,34746,3575894809,3575894809,0
3,1220,34747,3575894809,3575894809,0
3,1220,34748,3575894809,3575894809,0
3,1220,34749,3575894809,3575894809,0
3,1220,34750,3575894809,3575894809,0
3,1220,34751,3575894809,3575894809,0
3,1220,34752,3575894809,3575894809,0
3,1220,34753,3575894809,3575894815,6
3,1220,34754,3575894809,3575894815,6
3,1220,34755,3575894809,3575894815,6
3,1220,34756,3575894809,3575894817,8
3,1220,34757,3575894809,3575894818,9
3,1220,34758,3575894809,3575894819,10
3,1220,34759,3575894809,3575894821,12
3,1220,34760,3575894809,3575894823,14
3,1220,34761,3575894809,3575894826,17
3,1220,34762,3575894809,3575894826,17
3,1220,34763,3575894809,3575894826,17
3,1220,34764,3575894809,3575894827,18
3,1220,34765,3575894809,3575894827,18
3,1220,34766,3575894809,3575894829,20
3,1220,34767,3575894809,3575894829,20
3,1220,34768,3575894809,3575894831,22
3,1220,34769,3575894809,3575894831,22
3,1220,34770,3575894809,3575894834,25
3,1220,34771,3575894809,3575894836,27
3,1220,34772,3575894809,3575894837,28
3,1220,34773,3575894809,3575894838,29
3,1220,34774,3575894809,3575894838,29
3,1220,34775,3575894809,3575894839,30
3,1220,34776,3575894809,3575894840,31
3,1220,34777,3575894809,3575894840,31
3,1220,34778,3575894809,3575894841,32
3,1220,34779,3575894809,3575894842,33
3,1220,34780,3575894809,3575894842,33
3,1220,34781,3575894809,3575894843,34
3,1220,34782,3575894809,3575894844,35
3,1220,34783,3575894809,3575894845,36
3,1220,34784,3575894809,3575894847,38
3,1220,34785,3575894809,3575894849,40
3,1220,34786,3575894809,3575894850,41
3,1220,34787,3575894809,3575894851,42
3,1220,34788,3575894809,3575894854,45
3,1220,34789,3575894809,3575894855,46
3,1220,34790,3575894809,3575894856,47
3,1220,34791,3575894809,3575894856,47
3,1220,34792,3575894809,3575894857,48
3,1221,34793,3575894874,3575894874,0
3,1221,34794,3575894874,3575894874,0
3,1221,34795,3575894874,3575894874,0
3,1221,34796,3575894874,3575894874,0
3,1221,34797,3575894874,3575894874,0
3,1221,34798,3575894874,3575894874,0
3,1221,34799,3575894874,3575894874,0
3,1221,34800,3575894874,3575894874,0
3,1221,34801,3575894874,3575894874,0
3,1221,34802,3575894874,3575894874,0
3,1221,34803,3575894874,3575894876,2
3,1221,34804,3575894874,3575894877,3
3,1221,34805,3575894874,3575894878,4
3,1221,34806,3575894874,3575894881,7
3,1221,34807,3575894874,3575894884,10
3,1221,34808,3575894874,3575894884,10
3,1221,34809,3575894874,3575894885,11
3,1221,34810,3575894874,3575894885,11
3,1221,34811,3575894874,3575894889,15
3,1221,34812,3575894874,3575894890,16
3,1221,34813,3575894874,3575894892,18
3,1221,34814,3575894874,3575894892,18
3,1221,34815,3575894874,3575894893,19
3,1221,34816,3575894874,3575894896,22
3,1221,34817,3575894874,3575894898,24
3,1221,34818,3575894874,3575894898,24
3,1221,34819,3575894874,3575894899,25
3,1221,34820,3575894874,3575894901,27
3,1221,34821,3575894874,3575894902,28
3,1221,34822,3575894874,3575894903,29
3,1221,34823,3575894874,3575894903,29
3,1221,34824,3575894874,3575894904,30
3,1221,34825,3575894874,3575894906,32
3,1221,34826,3575894874,3575894907,33
3,1221,34827,3575894874,3575894909,35
3,1221,34828,3575894874,3575894912,38
3,1221,34829,3575894874,3575894913,39
3,1221,34830,3575894874,3575894918,44
3,1221,34831,3575894874,3575894918,44
3,1221,34832,3575894874,3575894919,45
3,1221,34833,3575894874,3575894920,46
3,1221,34834,3575894874,3575894920,46
3,1221,34835,3575894874,3575894921,47
3,1221,34836,3575894874,3575894923,49
3,1222,34837,3575894937,3575894937,0
3,1222,34838,3575894937,3575894937,0
3,1222,34839,3575894937,3575894937,0
3,1222,34840,3575894937,3575894937,0
3,1222,34841,3575894937,3575894937,0
3,1222,34842,3575894937,3575894937,0
3,1222,34843,3575894937,3575894937,0
3,1222,34844,3575894937,3575894939,2
3,1222,34845,3575894937,3575894941,4
3,1222,34846,3575894937,3575894942,5
3,1222,34847,3575894937,3575894943,6
3,1222,34848,3575894937,3575894944,7
3,1222,34849,3575894937,3575894946,9
3,1222,34850,3575894937,3575894948,11
3,1222,34851,3575894937,3575894954,17
3,1222,34852,3575894937,3575894954,17
3,1222,34853,3575894937,3575894956,19
3,1222,34854,3575894937,3575894963,26
3,1222,34855,3575894937,3575894965,28
3,1222,34856,3575894937,3575894967,30
3,1222,34857,3575894937,3575894971,34
3,1222,34858,3575894937,3575894972,35
3,1222,34859,3575894937,3575894973,36
3,1222,34860,3575894937,3575894974,37
3,1222,34861,3575894937,3575894978,41
3,1222,34862,3575894937,3575894979,42
3,1222,34863,3575894937,3575894980,43
3,1222,34864,3575894937,3575894980,43
3,1222,34865,3575894937,3575894982,45
3,1222,34866,3575894937,3575894983,46
3,1222,34867,3575894937,3575894984,47
3,1222,34868,3575894937,3575894985,48
3,1222,34869,3575894937,3575894986,49
3,1222,34870,3575894937,3575894987,50
3,1223,34871,3575895001,3575895001,0
3,1223,34872,3575895001,3575895001,0
3,1223,34873,3575895001,3575895001,0
3,1223,34874,3575895001,3575895001,0
3,1223,34875,3575895001,3575895001,0
3,1223,34876,3575895001,3575895001,0
3,1223,34877,3575895001,3575895001,0
3,1223,34878,3575895001,3575895001,0
3,1223,34879,3575895001,3575895001,0
3,1223,34880,3575895001,3575895001,0
3,1223,34881,3575895001,3575895001,0
3,1223,34882,3575895001,3575895001,0
3,1223,34883,3575895001,3575895001,0
3,1223,34884,3575895001,3575895001,0
3,1223,34885,3575895001,3575895001,0
3,1223,34886,3575895001,3575895001,0
3,1223,34887,3575895001,3575895001,0
3,1223,34888,3575895001,3575895002,1
3,1223,34889,3575895001,3575895003,2
3,1223,34890,3575895001,3575895003,2
3,1223,34891,3575895001,3575895010,9
3,1223,34892,3575895001,3575895015,14
3,1223,34893,3575895001,3575895015,14
3,1223,34894,3575895001,3575895016,15
3,1223,34895,3575895001,3575895016,15
3,1223,34896,3575895001,3575895018,17
3,1223,34897,3575895001,3575895019,18
3,1223,34898,3575895001,3575895020,19
3,1223,34899,3575895001,3575895022,21
3,1223,34900,3575895001,3575895023,22
3,1223,34901,3575895001,3575895026,25
3,1223,34902,3575895001,3575895026,25
3,1223,34903,3575895001,3575895027,26
3,1223,34904,3575895001,3575895027,26
3,1223,34905,3575895001,3575895029,28
3,1223,34906,3575895001,3575895030,29
3,1223,34907,3575895001,3575895031,30
3,1223,34908,3575895001,3575895031,30
3,1223,34909,3575895001,3575895034,33
3,1223,34910,3575895001,3575895037,36
3,1223,34911,3575895001,3575895038,37
3,1223,34912,3575895001,3575895038,37
3,1223,34913,3575895001,3575895039,38
3,1223,34914,3575895001,3575895040,39
3,1223,34915,3575895001,3575895042,41
3,1223,34916,3575895001,3575895042,41
3,1223,34917,3575895001,3575895043,42
3,1223,34918,3575895001,3575895045,44
3,1223,34919,3575895001,3575895045,44
3,1223,34920,3575895001,3575895047,46
3,1223,34921,3575895001,3575895051,50
3,1224,34922,3575895066,3575895066,0
3,1224,34923,3575895066,3575895066,0
3,1224,34924,3575895066,3575895066,0
3,1224,34925,3575895066,3575895066,0
3,1224,34926,3575895066,3575895066,0
3,1224,34927,3575895066,3575895066,0
3,1224,34928,3575895066,3575895066,0
3,1224,34929,3575895066,3575895066,0
3,1224,34930,3575895066,3575895066,0
3,1224,34931,3575895066,3575895067,1
3,1224,34932,3575895066,3575895068,2
3,1224,34933,3575895066,3575895068,2
3,1224,34934,3575895066,3575895070,4
3,1224,34935,3575895066,3575895076,10
3,1224,34936,3575895066,3575895077,11
3,1224,34937,3575895066,3575895078,12
3,1224,34938,3575895066,3575895081,15
3,1224,34939,3575895066,3575895081,15
3,1224,34940,3575895066,3575895083,17
3,1224,34941,3575895066,3575895085,19
3,1224,34942,3575895066,3575895086,20
3,1224,34943,3575895066,3575895086,20
3,1224,34944,3575895066,3575895086,20
3,1224,34945,3575895066,3575895090,24
3,1224,34946,3575895066,3575895090,24
3,1224,34947,3575895066,3575895092,26
3,1224,34948,3575895066,3575895093,27
3,1224,34949,3575895066,3575895096,30
3,1224,34950,3575895066,3575895097,31
3,1224,34951,3575895066,3575895097,31
3,1224,34952,3575895066,3575895099,33
3,1224,34953,3575895066,3575895102,36
3,1224,34954,3575895066,3575895104,38
3,1224,34955,3575895066,3575895108,42
3,1224,34956,3575895066,3575895109,43
3,1224,34957,3575895066,3575895109,43
3,1224,34958,3575895066,3575895110,44
3,1224,34959,3575895066,3575895112,46
3,1225,34960,3575895132,3575895132,0
3,1225,34961,3575895132,3575895132,0
3,1225,34962,3575895132,3575895132,0
3,1225,34963,3575895132,3575895132,0
3,1225,34964,3575895132,3575895132,0
3,1225,34965,3575895132,3575895132,0
3,1225,34966,3575895132,3575895132,0
3,1225,34967,3575895132,3575895132,0
3,1225,34968,3575895132,3575895132,0
3,1225,34969,3575895132,3575895132,0
3,1225,34970,3575895132,3575895132,0
3,1225,34971,3575895132,3575895133,1
3,1225,34972,3575895132,3575895135,3
3,1225,34973,3575895132,3575895139,7
3,1225,34974,3575895132,3575895141,9
3,1225,34975,3575895132,3575895143,11
3,1225,34976,3575895132,3575895143,11
3,1225,34977,3575895132,3575895144,12
3,1225,34978,3575895132,3575895146,14
3,1225,34979,3575895132,3575895149,17
3,1225,34980,3575895132,3575895154,22
3,1225,34981,3575895132,3575895155,23
3,1225,34982,3575895132,3575895157,25
3,1225,34983,3575895132,3575895159,27
3,1225,34984,3575895132,3575895161,29
3,1225,34985,3575895132,3575895163,31
3,1225,34986,3575895132,3575895164,32
3,1225,34987,3575895132,3575895168,36
3,1225,34988,3575895132,3575895171,39
3,1225,34989,3575895132,3575895173,41
3,1225,34990,3575895132,3575895173,41
3,1225,34991,3575895132,3575895174,42
3,1225,34992,3575895132,3575895179,47
3,1225,34993,3575895132,3575895179,47
3,1225,34994,3575895132,3575895180,48
3,1225,34995,3575895132,3575895181,49
3,1225,34996,3575895132,3575895182,50
3,1226,34997,3575895195,3575895195,0
3,1226,34998,3575895195,3575895195,0
3,1226,34999,3575895195,3575895195,0
3,1226,35000,3575895195,3575895195,0
3,1226,35001,3575895195,3575895195,0
3,1226,35002,3575895195,3575895195,0
3,1226,35003,3575895195,3575895195,0
3,1226,35004,3575895195,3575895195,0
3,1226,35005,3575895195,3575895195,0
3,1226,35006,3575895195,3575895195,0
3,1226,35007,3575895195,3575895196,1
3,1226,35008,3575895195,3575895196,1
3,1226,35009,3575895195,3575895197,2
3,1226,35010,3575895195,3575895197,2
3,1226,35011,3575895195,3575895199,4
3,1226,35012,3575895195,3575895200,5
3,1226,35013,3575895195,3575895201,6
3,1226,35014,3575895195,3575895202,7
3,1226,35015,3575895195,3575895203,8
3,1226,35016,3575895195,3575895204,9
3,1226,35017,3575895195,3575895210,15
3,1226,35018,3575895195,3575895215,20
3,1226,35019,3575895195,3575895216,21
3,1226,35020,3575895195,3575895216,21
3,1226,35021,3575895195,3575895216,21
3,1226,35022,3575895195,3575895217,22
3,1226,35023,3575895195,3575895219,24
3,1226,35024,3575895195,3575895220,25
3,1226,35025,3575895195,3575895221,26
3,1226,35026,3575895195,3575895225,30
3,1226,35027,3575895195,3575895228,33
3,1226,35028,3575895195,3575895229,34
3,1226,35029,3575895195,3575895229,34
3,1226,35030,3575895195,3575895232,37
3,1226,35031,3575895195,3575895232,37
3,1226,35032,3575895195,3575895234,39
3,1226,35033,3575895195,3575895237,42
3,1226,35034,3575895195,3575895237,42
3,1226,35035,3575895195,3575895238,43
3,1226,35036,3575895195,3575895240,45
3,1226,35037,3575895195,3575895240,45
3,1226,35038,3575895195,3575895241,46
3,1226,35039,3575895195,3575895241,46
3,1226,35040,3575895195,3575895242,47
3,1226,35041,3575895195,3575895243,48
3,1226,35042,3575895195,3575895244,49
3,1227,35043,3575895258,3575895258,0
3,1227,35044,3575895258,3575895258,0
3,1227,35045,3575895258,3575895258,0
3,1227,35046,3575895258,3575895258,0
3,1227,35047,3575895258,3575895258,0
3,1227,35048,3575895258,3575895258,0
3,1227,35049,3575895258,3575895258,0
3,1227,35050,3575895258,3575895258,0
3,1227,35051,3575895258,3575895259,1
3,1227,35052,3575895258,3575895264,6
3,1227,35053,3575895258,3575895264,6
3,1227,35054,3575895258,3575895264,6
3,1227,35055,3575895258,3575895265,7
3,1227,35056,3575895258,3575895268,10
3,1227,35057,3575895258,3575895270,12
3,1227,35058,3575895258,3575895276,18
3,1227,35059,3575895258,3575895278,20
3,1227,35060,3575895258,3575895278,20
3,1227,35061,3575895258,3575895281,23
3,1227,35062,3575895258,3575895284,26
3,1227,35063,3575895258,3575895284,26
3,1227,35064,3575895258,3575895286,28
3,1227,35065,3575895258,3575895286,28
3,1227,35066,3575895258,3575895287,29
3,1227,35067,3575895258,3575895290,32
3,1227,35068,3575895258,3575895291,33
3,1227,35069,3575895258,3575895291,33
3,1227,35070,3575895258,3575895292,34
3,1227,35071,3575895258,3575895293,35
3,1227,35072,3575895258,3575895293,35
3,1227,35073,3575895258,3575895295,37
3,1227,35074,3575895258,3575895298,40
3,1227,35075,3575895258,3575895298,40
3,1227,35076,3575895258,3575895300,42
3,1227,35077,3575895258,3575895301,43
3,1227,35078,3575895258,3575895302,44
3,1227,35079,3575895258,3575895302,44
3,1227,35080,3575895258,3575895303,45
3,1227,35081,3575895258,3575895304,46
3,1227,35082,3575895258,3575895304,46
3,1228,35083,3575895327,3575895327,0
3,1228,35084,3575895327,3575895327,0
3,1228,35085,3575895327,3575895327,0
3,1228,35086,3575895327,3575895327,0
3,1228,35087,3575895327,3575895327,0
3,1228,35088,3575895327,3575895327,0
3,1228,35089,3575895327,3575895327,0
3,1228,35090,3575895327,3575895327,0
3,1228,35091,3575895327,3575895327,0
3,1228,35092,3575895327,3575895327,0
3,1228,35093,3575895327,3575895327,0
3,1228,35094,3575895327,3575895327,0
3,1228,35095,3575895327,3575895329,2
3,1228,35096,3575895327,3575895331,4
3,1228,35097,3575895327,3575895331,4
3,1228,35098,3575895327,3575895332,5
3,1228,35099,3575895327,3575895332,5
3,1228,35100,3575895327,3575895336,9
3,1228,35101,3575895327,3575895338,11
3,1228,35102,3575895327,3575895339,12
3,1228,35103,3575895327,3575895341,14
3,1228,35104,3575895327,3575895343,16
3,1228,35105,3575895327,3575895344,17
3,1228,35106,3575895327,3575895344,17
3,1228,35107,3575895327,3575895346,19
3,1228,35108,3575895327,3575895349,22
3,1228,35109,3575895327,3575895354,27
3,1228,35110,3575895327,3575895356,29
3,1228,35111,3575895327,3575895357,30
3,1228,35112,3575895327,3575895360,33
3,1228,35113,3575895327,3575895361,34
3,1228,35114,3575895327,3575895363,36
3,1228,35115,3575895327,3575895364,37
3,1228,35116,3575895327,3575895368,41
3,1228,35117,3575895327,3575895368,41
3,1228,35118,3575895327,3575895372,45
3,1228,35119,3575895327,3575895372,45
3,1228,35120,3575895327,3575895373,46
3,1228,35121,3575895327,3575895373,46
3,1229,35122,3575895390,3575895390,0
3,1229,35123,3575895390,3575895390,0
3,1229,35124,3575895390,3575895390,0
3,1229,35125,3575895390,3575895390,0
3,1229,35126,3575895390,3575895390,0
3,1229,35127,3575895390,3575895390,0
3,1229,35128,3575895390,3575895390,0
3,1229,35129,3575895390,3575895390,0
3,1229,35130,3575895390,3575895390,0
3,1229,35131,3575895390,3575895391,1
3,1229,35132,3575895390,3575895393,3
3,1229,35133,3575895390,3575895393,3
3,1229,35134,3575895390,3575895394,4
3,1229,35135,3575895390,3575895395,5
3,1229,35136,3575895390,3575895395,5
3,1229,35137,3575895390,3575895396,6
3,1229,35138,3575895390,3575895396,6
3,1229,35139,3575895390,3575895396,6
3,1229,35140,3575895390,3575895397,7
3,1229,35141,3575895390,3575895397,7
3,1229,35142,3575895390,3575895398,8
3,1229,35143,3575895390,3575895398,8
3,1229,35144,3575895390,3575895400,10
3,1229,35145,3575895390,3575895401,11
3,1229,35146,3575895390,3575895402,12
3,1229,35147,3575895390,3575895402,12
3,1229,35148,3575895390,3575895403,13
3,1229,35149,3575895390,3575895404,14
3,1229,35150,3575895390,3575895410,20
3,1229,35151,3575895390,3575895415,25
3,1229,35152,3575895390,3575895417,27
3,1229,35153,3575895390,3575895417,27
3,1229,35154,3575895390,3575895418,28
3,1229,35155,3575895390,3575895420,30
3,1229,35156,3575895390,3575895422,32
3,1229,35157,3575895390,3575895422,32
3,1229,35158,3575895390,3575895427,37
3,1229,35159,3575895390,3575895428,38
3,1229,35160,3575895390,3575895429,39
3,1229,35161,3575895390,3575895429,39
3,1229,35162,3575895390,3575895430,40
3,1229,35163,3575895390,3575895431,41
3,1229,35164,3575895390,3575895432,42
3,1229,35165,3575895390,3575895434,44
3,1229,35166,3575895390,3575895437,47
3,1229,35167,3575895390,3575895437,47
3,1229,35168,3575895390,3575895438,48
3,1229,35169,3575895390,3575895440,50
3,1230,35170,3575895457,3575895457,0
3,1230,35171,3575895457,3575895457,0
3,1230,35172,3575895457,3575895457,0
3,1230,35173,3575895457,3575895457,0
3,1230,35174,3575895457,3575895457,0
3,1230,35175,3575895457,3575895457,0
3,1230,35176,3575895457,3575895457,0
3,1230,35177,3575895457,3575895457,0
3,1230,35178,3575895457,3575895457,0
3,1230,35179,3575895457,3575895457,0
3,1230,35180,3575895457,3575895457,0
3,1230,35181,3575895457,3575895457,0
3,1230,35182,3575895457,3575895457,0
3,1230,35183,3575895457,3575895464,7
3,1230,35184,3575895457,3575895464,7
3,1230,35185,3575895457,3575895465,8
3,1230,35186,3575895457,3575895465,8
3,1230,35187,3575895457,3575895465,8
3,1230,35188,3575895457,3575895467,10
3,1230,35189,3575895457,3575895468,11
3,1230,35190,3575895457,3575895469,12
3,1230,35191,3575895457,3575895470,13
3,1230,35192,3575895457,3575895476,19
3,1230,35193,3575895457,3575895477,20
3,1230,35194,3575895457,3575895478,21
3,1230,35195,3575895457,3575895481,24
3,1230,35196,3575895457,3575895481,24
3,1230,35197,3575895457,3575895484,27
3,1230,35198,3575895457,3575895486,29
3,1230,35199,3575895457,3575895486,29
3,1230,35200,3575895457,3575895486,29
3,1230,35201,3575895457,3575895487,30
3,1230,35202,3575895457,3575895490,33
3,1230,35203,3575895457,3575895491,34
3,1230,35204,3575895457,3575895491,34
3,1230,35205,3575895457,3575895493,36
3,1230,35206,3575895457,3575895494,37
3,1230,35207,3575895457,3575895496,39
3,1230,35208,3575895457,3575895498,41
3,1230,35209,3575895457,3575895498,41
3,1230,35210,3575895457,3575895500,43
3,1230,35211,3575895457,3575895501,44
3,1230,35212,3575895457,3575895502,45
3,1230,35213,3575895457,3575895504,47
3,1230,35214,3575895457,3575895504,47
3,1230,35215,3575895457,3575895504,47
3,1231,35216,3575895520,3575895520,0
3,1231,35217,3575895520,3575895520,0
3,1231,35218,3575895520,3575895520,0
3,1231,35219,3575895520,3575895520,0
3,1231,35220,3575895520,3575895520,0
3,1231,35221,3575895520,3575895520,0
3,1231,35222,3575895520,3575895520,0
3,1231,35223,3575895520,3575895520,0
3,1231,35224,3575895520,3575895520,0
3,1231,35225,3575895520,3575895520,0
3,1231,35226,3575895520,3575895520,0
3,1231,35227,3575895520,3575895520,0
3,1231,35228,3575895520,3575895529,9
3,1231,35229,3575895520,3575895530,10
3,1231,35230,3575895520,3575895530,10
3,1231,35231,3575895520,3575895531,11
3,1231,35232,3575895520,3575895532,12
3,1231,35233,3575895520,3575895535,15
3,1231,35234,3575895520,3575895537,17
3,1231,35235,3575895520,3575895539,19
3,1231,35236,3575895520,3575895540,20
3,1231,35237,3575895520,3575895543,23
3,1231,35238,3575895520,3575895544,24
3,1231,35239,3575895520,3575895545,25
3,1231,35240,3575895520,3575895548,28
3,1231,35241,3575895520,3575895551,31
3,1231,35242,3575895520,3575895553,33
3,1231,35243,3575895520,3575895555,35
3,1231,35244,3575895520,3575895561,41
3,1231,35245,3575895520,3575895564,44
3,1231,35246,3575895520,3575895564,44
3,1231,35247,3575895520,3575895568,48
3,1231,35248,3575895520,3575895568,48
3,1232,35249,3575895584,3575895584,0
3,1232,35250,3575895584,3575895584,0
3,1232,35251,3575895584,3575895584,0
3,1232,35252,3575895584,3575895584,0
3,1232,35253,3575895584,3575895584,0
3,1232,35254,3575895584,3575895584,0
3,1232,35255,3575895584,3575895584,0
3,1232,35256,3575895584,3575895584,0
3,1232,35257,3575895584,3575895584,0
3,1232,35258,3575895584,3575895586,2
3,1232,35259,3575895584,3575895591,7
3,1232,35260,3575895584,3575895592,8
3,1232,35261,3575895584,3575895592,8
3,1232,35262,3575895584,3575895594,10
3,1232,35263,3575895584,3575895594,10
3,1232,35264,3575895584,3575895595,11
3,1232,35265,3575895584,3575895595,11
3,1232,35266,3575895584,3575895595,11
3,1232,35267,3575895584,3575895595,11
3,1232,35268,3575895584,3575895596,12
3,1232,35269,3575895584,3575895596,12
3,1232,35270,3575895584,3575895598,14
3,1232,35271,3575895584,3575895598,14
3,1232,35272,3575895584,3575895599,15
3,1232,35273,3575895584,3575895600,16
3,1232,35274,3575895584,3575895602,18
3,1232,35275,3575895584,3575895602,18
3,1232,35276,3575895584,3575895609,25
3,1232,35277,3575895584,3575895614,30
3,1232,35278,3575895584,3575895615,31
3,1232,35279,3575895584,3575895616,32
3,1232,35280,3575895584,3575895617,33
3,1232,35281,3575895584,3575895618,34
3,1232,35282,3575895584,3575895619,35
3,1232,35283,3575895584,3575895619,35
3,1232,35284,3575895584,3575895621,37
3,1232,35285,3575895584,3575895622,38
3,1232,35286,3575895584,3575895625,41
3,1232,35287,3575895584,3575895627,43
3,1232,35288,3575895584,3575895627,43
3,1232,35289,3575895584,3575895628,44
3,1232,35290,3575895584,3575895628,44
3,1232,35291,3575895584,3575895630,46
3,1232,35292,3575895584,3575895632,48
3,1232,35293,3575895584,3575895634,50
3,1233,35294,3575895650,3575895650,0
3,1233,35295,3575895650,3575895650,0
3,1233,35296,3575895650,3575895650,0
3,1233,35297,3575895650,3575895650,0
3,1233,35298,3575895650,3575895650,0
3,1233,35299,3575895650,3575895650,0
3,1233,35300,3575895650,3575895650,0
3,1233,35301,3575895650,3575895650,0
3,1233,35302,3575895650,3575895650,0
3,1233,35303,3575895650,3575895650,0
3,1233,35304,3575895650,3575895650,0
3,1233,35305,3575895650,3575895650,0
3,1233,35306,3575895650,3575895652,2
3,1233,35307,3575895650,3575895654,4
3,1233,35308,3575895650,3575895655,5
3,1233,35309,3575895650,3575895655,5
3,1233,35310,3575895650,3575895657,7
3,1233,35311,3575895650,3575895658,8
3,1233,35312,3575895650,3575895663,13
3,1233,35313,3575895650,3575895663,13
3,1233,35314,3575895650,3575895663,13
3,1233,35315,3575895650,3575895664,14
3,1233,35316,3575895650,3575895665,15
3,1233,35317,3575895650,3575895666,16
3,1233,35318,3575895650,3575895666,16
3,1233,35319,3575895650,3575895667,17
3,1233,35320,3575895650,3575895669,19
3,1233,35321,3575895650,3575895669,19
3,1233,35322,3575895650,3575895677,27
3,1233,35323,3575895650,3575895678,28
3,1233,35324,3575895650,3575895682,32
3,1233,35325,3575895650,3575895684,34
3,1233,35326,3575895650,3575895684,34
3,1233,35327,3575895650,3575895686,36
3,1233,35328,3575895650,3575895686,36
3,1233,35329,3575895650,3575895686,36
3,1233,35330,3575895650,3575895687,37
3,1233,35331,3575895650,3575895690,40
3,1233,35332,3575895650,3575895692,42
3,1233,35333,3575895650,3575895692,42
3,1233,35334,3575895650,3575895692,42
3,1233,35335,3575895650,3575895694,44
3,1233,35336,3575895650,3575895696,46
3,1233,35337,3575895650,3575895698,48
3,1234,35338,3575895713,3575895713,0
3,1234,35339,3575895713,3575895713,0
3,1234,35340,3575895713,3575895713,0
3,1234,35341,3575895713,3575895713,0
3,1234,35342,3575895713,3575895713,0
3,1234,35343,3575895713,3575895713,0
3,1234,35344,3575895713,3575895713,0
3,1234,35345,3575895713,3575895713,0
3,1234,35346,3575895713,3575895713,0
3,1234,35347,3575895713,3575895713,0
3,1234,35348,3575895713,3575895717,4
3,1234,35349,3575895713,3575895718,5
3,1234,35350,3575895713,3575895719,6
3,1234,35351,3575895713,3575895719,6
3,1234,35352,3575895713,3575895720,7
3,1234,35353,3575895713,3575895721,8
3,1234,35354,3575895713,3575895722,9
3,1234,35355,3575895713,3575895730,17
3,1234,35356,3575895713,3575895730,17
3,1234,35357,3575895713,3575895730,17
3,1234,35358,3575895713,3575895732,19
3,1234,35359,3575895713,3575895733,20
3,1234,35360,3575895713,3575895736,23
3,1234,35361,3575895713,3575895739,26
3,1234,35362,3575895713,3575895741,28
3,1234,35363,3575895713,3575895743,30
3,1234,35364,3575895713,3575895743,30
3,1234,35365,3575895713,3575895746,33
3,1234,35366,3575895713,3575895749,36
3,1234,35367,3575895713,3575895752,39
3,1234,35368,3575895713,3575895753,40
3,1234,35369,3575895713,3575895755,42
3,1234,35370,3575895713,3575895756,43
3,1234,35371,3575895713,3575895759,46
3,1234,35372,3575895713,3575895763,50
3,1235,35373,3575895780,3575895780,0
3,1235,35374,3575895780,3575895780,0
3,1235,35375,3575895780,3575895780,0
3,1235,35376,3575895780,3575895780,0
3,1235,35377,3575895780,3575895780,0
3,1235,35378,3575895780,3575895780,0
3,1235,35379,3575895780,3575895780,0
3,1235,35380,3575895780,3575895780,0
3,1235,35381,3575895780,3575895780,0
3,1235,35382,3575895780,3575895781,1
3,1235,35383,3575895780,3575895783,3
3,1235,35384,3575895780,3575895783,3
3,1235,35385,3575895780,3575895783,3
3,1235,35386,3575895780,3575895787,7
3,1235,35387,3575895780,3575895787,7
3,1235,35388,3575895780,3575895791,11
3,1235,35389,3575895780,3575895792,12
3,1235,35390,3575895780,3575895793,13
3,1235,35391,3575895780,3575895793,13
3,1235,35392,3575895780,3575895794,14
3,1235,35393,3575895780,3575895794,14
3,1235,35394,3575895780,3575895795,15
3,1235,35395,3575895780,3575895795,15
3,1235,35396,3575895780,3575895796,16
3,1235,35397,3575895780,3575895796,16
3,1235,35398,3575895780,3575895796,16
3,1235,35399,3575895780,3575895798,18
3,1235,35400,3575895780,3575895800,20
3,1235,35401,3575895780,3575895800,20
3,1235,35402,3575895780,3575895802,22
3,1235,35403,3575895780,3575895803,23
3,1235,35404,3575895780,3575895804,24
3,1235,35405,3575895780,3575895810,30
3,1235,35406,3575895780,3575895815,35
3,1235,35407,3575895780,3575895815,35
3,1235,35408,3575895780,3575895816,36
3,1235,35409,3575895780,3575895816,36
3,1235,35410,3575895780,3575895817,37
3,1235,35411,3575895780,3575895820,40
3,1235,35412,3575895780,3575895826,46
3,1235,35413,3575895780,3575895826,46
3,1235,35414,3575895780,3575895827,47
3,1235,35415,3575895780,3575895827,47
3,1235,35416,3575895780,3575895828,48
3,1235,35417,3575895780,3575895829,49
3,1235,35418,3575895780,3575895829,49
3,1236,35419,3575895843,3575895843,0
3,1236,35420,3575895843,3575895843,0
3,1236,35421,3575895843,3575895843,0
3,1236,35422,3575895843,3575895843,0
3,1236,35423,3575895843,3575895843,0
3,1236,35424,3575895843,3575895843,0
3,1236,35425,3575895843,3575895843,0
3,1236,35426,3575895843,3575895843,0
3,1236,35427,3575895843,3575895843,0
3,1236,35428,3575895843,3575895843,0
3,1236,35429,3575895843,3575895843,0
3,1236,35430,3575895843,3575895845,2
3,1236,35431,3575895843,3575895849,6
3,1236,35432,3575895843,3575895849,6
3,1236,35433,3575895843,3575895850,7
3,1236,35434,3575895843,3575895851,8
3,1236,35435,3575895843,3575895854,11
3,1236,35436,3575895843,3575895855,12
3,1236,35437,3575895843,3575895856,13
3,1236,35438,3575895843,3575895856,13
3,1236,35439,3575895843,3575895859,16
3,1236,35440,3575895843,3575895863,20
3,1236,35441,3575895843,3575895864,21
3,1236,35442,3575895843,3575895864,21
3,1236,35443,3575895843,3575895864,21
3,1236,35444,3575895843,3575895865,22
3,1236,35445,3575895843,3575895866,23
3,1236,35446,3575895843,3575895866,23
3,1236,35447,3575895843,3575895867,24
3,1236,35448,3575895843,3575895869,26
3,1236,35449,3575895843,3575895877,34
3,1236,35450,3575895843,3575895878,35
3,1236,35451,3575895843,3575895878,35
3,1236,35452,3575895843,3575895881,38
3,1236,35453,3575895843,3575895881,38
3,1236,35454,3575895843,3575895885,42
3,1236,35455,3575895843,3575895886,43
3,1236,35456,3575895843,3575895886,43
3,1236,35457,3575895843,3575895886,43
3,1236,35458,3575895843,3575895888,45
3,1236,35459,3575895843,3575895890,47
3,1236,35460,3575895843,3575895892,49
3,1236,35461,3575895843,3575895892,49
3,1237,35462,3575895909,3575895909,0
3,1237,35463,3575895909,3575895909,0
3,1237,35464,3575895909,3575895909,0
3,1237,35465,3575895909,3575895909,0
3,1237,35466,3575895909,3575895909,0
3,1237,35467,3575895909,3575895909,0
3,1237,35468,3575895909,3575895909,0
3,1237,35469,3575895909,3575895909,0
3,1237,35470,3575895909,3575895909,0
3,1237,35471,3575895909,3575895909,0
3,1237,35472,3575895909,3575895909,0
3,1237,35473,3575895909,3575895910,1
3,1237,35474,3575895909,3575895911,2
3,1237,35475,3575895909,3575895913,4
3,1237,35476,3575895909,3575895917,8
3,1237,35477,3575895909,3575895918,9
3,1237,35478,3575895909,3575895919,10
3,1237,35479,3575895909,3575895920,11
3,1237,35480,3575895909,3575895920,11
3,1237,35481,3575895909,3575895920,11
3,1237,35482,3575895909,3575895921,12
3,1237,35483,3575895909,3575895922,13
3,1237,35484,3575895909,3575895930,21
3,1237,35485,3575895909,3575895930,21
3,1237,35486,3575895909,3575895931,22
3,1237,35487,3575895909,3575895934,25
3,1237,35488,3575895909,3575895936,27
3,1237,35489,3575895909,3575895937,28
3,1237,35490,3575895909,3575895940,31
3,1237,35491,3575895909,3575895941,32
3,1237,35492,3575895909,3575895944,35
3,1237,35493,3575895909,3575895944,35
3,1237,35494,3575895909,3575895946,37
3,1237,35495,3575895909,3575895950,41
3,1237,35496,3575895909,3575895952,43
3,1237,35497,3575895909,3575895956,47
3,1237,35498,3575895909,3575895957,48
3,1238,35499,3575895974,3575895974,0
3,1238,35500,3575895974,3575895974,0
3,1238,35501,3575895974,3575895974,0
3,1238,35502,3575895974,3575895974,0
3,1238,35503,3575895974,3575895974,0
3,1238,35504,3575895974,3575895974,0
3,1238,35505,3575895974,3575895974,0
3,1238,35506,3575895974,3575895974,0
3,1238,35507,3575895974,3575895974,0
3,1238,35508,3575895974,3575895974,0
3,1238,35509,3575895974,3575895978,4
3,1238,35510,3575895974,3575895980,6
3,1238,35511,3575895974,3575895982,8
3,1238,35512,3575895974,3575895982,8
3,1238,35513,3575895974,3575895983,9
3,1238,35514,3575895974,3575895984,10
3,1238,35515,3575895974,3575895987,13
3,1238,35516,3575895974,3575895987,13
3,1238,35517,3575895974,3575895990,16
3,1238,35518,3575895974,3575895992,18
3,1238,35519,3575895974,3575895992,18
3,1238,35520,3575895974,3575895994,20
3,1238,35521,3575895974,3575895994,20
3,1238,35522,3575895974,3575895994,20
3,1238,35523,3575895974,3575895995,21
3,1238,35524,3575895974,3575895995,21
3,1238,35525,3575895974,3575895995,21
3,1238,35526,3575895974,3575895996,22
3,1238,35527,3575895974,3575895997,23
3,1238,35528,3575895974,3575895998,24
3,1238,35529,3575895974,3575895998,24
3,1238,35530,3575895974,3575896001,27
3,1238,35531,3575895974,3575896002,28
3,1238,35532,3575895974,3575896002,28
3,1238,35533,3575895974,3575896004,30
3,1238,35534,3575895974,3575896004,30
3,1238,35535,3575895974,3575896010,36
3,1238,35536,3575895974,3575896015,41
3,1238,35537,3575895974,3575896016,42
3,1238,35538,3575895974,3575896016,42
3,1238,35539,3575895974,3575896016,42
3,1238,35540,3575895974,3575896017,43
3,1238,35541,3575895974,3575896019,45
3,1238,35542,3575895974,3575896020,46
3,1238,35543,3575895974,3575896020,46
3,1238,35544,3575895974,3575896022,48
3,1238,35545,3575895974,3575896023,49
3,1239,35546,3575896040,3575896040,0
3,1239,35547,3575896040,3575896040,0
3,1239,35548,3575896040,3575896040,0
3,1239,35549,3575896040,3575896040,0
3,1239,35550,3575896040,3575896040,0
3,1239,35551,3575896040,3575896040,0
3,1239,35552,3575896040,3575896040,0
3,1239,35553,3575896040,3575896040,0
3,1239,35554,3575896040,3575896040,0
3,1239,35555,3575896040,3575896040,0
3,1239,35556,3575896040,3575896040,0
3,1239,35557,3575896040,3575896040,0
3,1239,35558,3575896040,3575896040,0
3,1239,35559,3575896040,3575896040,0
3,1239,35560,3575896040,3575896040,0
3,1239,35561,3575896040,3575896041,1
3,1239,35562,3575896040,3575896041,1
3,1239,35563,3575896040,3575896041,1
3,1239,35564,3575896040,3575896043,3
3,1239,35565,3575896040,3575896043,3
3,1239,35566,3575896040,3575896045,5
3,1239,35567,3575896040,3575896048,8
3,1239,35568,3575896040,3575896049,9
3,1239,35569,3575896040,3575896049,9
3,1239,35570,3575896040,3575896051,11
3,1239,35571,3575896040,3575896053,13
3,1239,35572,3575896040,3575896054,14
3,1239,35573,3575896040,3575896055,15
3,1239,35574,3575896040,3575896056,16
3,1239,35575,3575896040,3575896058,18
3,1239,35576,3575896040,3575896058,18
3,1239,35577,3575896040,3575896059,19
3,1239,35578,3575896040,3575896063,23
3,1239,35579,3575896040,3575896064,24
3,1239,35580,3575896040,3575896064,24
3,1239,35581,3575896040,3575896065,25
3,1239,35582,3575896040,3575896066,26
3,1239,35583,3575896040,3575896067,27
3,1239,35584,3575896040,3575896067,27
3,1239,35585,3575896040,3575896070,30
3,1239,35586,3575896040,3575896077,37
3,1239,35587,3575896040,3575896078,38
3,1239,35588,3575896040,3575896078,38
3,1239,35589,3575896040,3575896081,41
3,1239,35590,3575896040,3575896081,41
3,1239,35591,3575896040,3575896084,44
3,1239,35592,3575896040,3575896085,45
3,1239,35593,3575896040,3575896086,46
3,1239,35594,3575896040,3575896086,46
3,1239,35595,3575896040,3575896088,48
3,1240,35596,3575896106,3575896106,0
3,1240,35597,3575896106,3575896106,0
3,1240,35598,3575896106,3575896106,0
3,1240,35599,3575896106,3575896106,0
3,1240,35600,3575896106,3575896106,0
3,1240,35601,3575896106,3575896106,0
3,1240,35602,3575896106,3575896106,0
3,1240,35603,3575896106,3575896106,0
3,1240,35604,3575896106,3575896106,0
3,1240,35605,3575896106,3575896106,0
3,1240,35606,3575896106,3575896106,0
3,1240,35607,3575896106,3575896106,0
3,1240,35608,3575896106,3575896106,0
3,1240,35609,3575896106,3575896109,3
3,1240,35610,3575896106,3575896109,3
3,1240,35611,3575896106,3575896110,4
3,1240,35612,3575896106,3575896111,5
3,1240,35613,3575896106,3575896113,7
3,1240,35614,3575896106,3575896113,7
3,1240,35615,3575896106,3575896117,11
3,1240,35616,3575896106,3575896118,12
3,1240,35617,3575896106,3575896119,13
3,1240,35618,3575896106,3575896120,14
3,1240,35619,3575896106,3575896121,15
3,1240,35620,3575896106,3575896121,15
3,1240,35621,3575896106,3575896122,16
3,1240,35622,3575896106,3575896123,17
3,1240,35623,3575896106,3575896130,24
3,1240,35624,3575896106,3575896130,24
3,1240,35625,3575896106,3575896133,27
3,1240,35626,3575896106,3575896136,30
3,1240,35627,3575896106,3575896137,31
3,1240,35628,3575896106,3575896140,34
3,1240,35629,3575896106,3575896141,35
3,1240,35630,3575896106,3575896143,37
3,1240,35631,3575896106,3575896145,39
3,1240,35632,3575896106,3575896145,39
3,1240,35633,3575896106,3575896146,40
3,1240,35634,3575896106,3575896150,44
3,1240,35635,3575896106,3575896151,45
3,1240,35636,3575896106,3575896155,49
3,1241,35637,3575896173,3575896173,0
3,1241,35638,3575896173,3575896173,0
3,1241,35639,3575896173,3575896173,0
3,1241,35640,3575896173,3575896173,0
3,1241,35641,3575896173,3575896173,0
3,1241,35642,3575896173,3575896173,0
3,1241,35643,3575896173,3575896173,0
3,1241,35644,3575896173,3575896173,0
3,1241,35645,3575896173,3575896173,0
3,1241,35646,3575896173,3575896173,0
3,1241,35647,3575896173,3575896173,0
3,1241,35648,3575896173,3575896173,0
3,1241,35649,3575896173,3575896178,5
3,1241,35650,3575896173,3575896179,6
3,1241,35651,3575896173,3575896180,7
3,1241,35652,3575896173,3575896180,7
3,1241,35653,3575896173,3575896182,9
3,1241,35654,3575896173,3575896183,10
3,1241,35655,3575896173,3575896184,11
3,1241,35656,3575896173,3575896185,12
3,1241,35657,3575896173,3575896185,12
3,1241,35658,3575896173,3575896187,14
3,1241,35659,3575896173,3575896187,14
3,1241,35660,3575896173,3575896191,18
3,1241,35661,3575896173,3575896192,19
3,1241,35662,3575896173,3575896193,20
3,1241,35663,3575896173,3575896194,21
3,1241,35664,3575896173,3575896194,21
3,1241,35665,3575896173,3575896195,22
3,1241,35666,3575896173,3575896195,22
3,1241,35667,3575896173,3575896196,23
3,1241,35668,3575896173,3575896197,24
3,1241,35669,3575896173,3575896198,25
3,1241,35670,3575896173,3575896198,25
3,1241,35671,3575896173,3575896198,25
3,1241,35672,3575896173,3575896199,26
3,1241,35673,3575896173,3575896200,27
3,1241,35674,3575896173,3575896202,29
3,1241,35675,3575896173,3575896204,31
3,1241,35676,3575896173,3575896204,31
3,1241,35677,3575896173,3575896210,37
3,1241,35678,3575896173,3575896215,42
3,1241,35679,3575896173,3575896216,43
3,1241,35680,3575896173,3575896216,43
3,1241,35681,3575896173,3575896217,44
3,1241,35682,3575896173,3575896219,46
3,1241,35683,3575896173,3575896219,46
3,1241,35684,3575896173,3575896222,49
3,1242,35685,3575896239,3575896239,0
3,1242,35686,3575896239,3575896239,0
3,1242,35687,3575896239,3575896239,0
3,1242,35688,3575896239,3575896239,0
3,1242,35689,3575896239,3575896239,0
3,1242,35690,3575896239,3575896239,0
3,1242,35691,3575896239,3575896239,0
3,1242,35692,3575896239,3575896239,0
3,1242,35693,3575896239,3575896239,0
3,1242,35694,3575896239,3575896239,0
3,1242,35695,3575896239,3575896239,0
3,1242,35696,3575896239,3575896239,0
3,1242,35697,3575896239,3575896239,0
3,1242,35698,3575896239,3575896240,1
3,1242,35699,3575896239,3575896241,2
3,1242,35700,3575896239,3575896241,2
3,1242,35701,3575896239,3575896242,3
3,1242,35702,3575896239,3575896244,5
3,1242,35703,3575896239,3575896244,5
3,1242,35704,3575896239,3575896245,6
3,1242,35705,3575896239,3575896248,9
3,1242,35706,3575896239,3575896249,10
3,1242,35707,3575896239,3575896250,11
3,1242,35708,3575896239,3575896250,11
3,1242,35709,3575896239,3575896253,14
3,1242,35710,3575896239,3575896254,15
3,1242,35711,3575896239,3575896256,17
3,1242,35712,3575896239,3575896257,18
3,1242,35713,3575896239,3575896257,18
3,1242,35714,3575896239,3575896260,21
3,1242,35715,3575896239,3575896263,24
3,1242,35716,3575896239,3575896264,25
3,1242,35717,3575896239,3575896264,25
3,1242,35718,3575896239,3575896264,25
3,1242,35719,3575896239,3575896265,26
3,1242,35720,3575896239,3575896266,27
3,1242,35721,3575896239,3575896267,28
3,1242,35722,3575896239,3575896267,28
3,1242,35723,3575896239,3575896269,30
3,1242,35724,3575896239,3575896270,31
3,1242,35725,3575896239,3575896278,39
3,1242,35726,3575896239,3575896278,39
3,1242,35727,3575896239,3575896279,40
3,1242,35728,3575896239,3575896281,42
3,1242,35729,3575896239,3575896284,45
3,1242,35730,3575896239,3575896285,46
3,1242,35731,3575896239,3575896286,47
3,1242,35732,3575896239,3575896286,47
3,1242,35733,3575896239,3575896287,48
3,1242,35734,3575896239,3575896288,49
3,1243,35735,3575896302,3575896302,0
3,1243,35736,3575896302,3575896302,0
3,1243,35737,3575896302,3575896302,0
3,1243,35738,3575896302,3575896302,0
3,1243,35739,3575896302,3575896302,0
3,1243,35740,3575896302,3575896302,0
3,1243,35741,3575896302,3575896302,0
3,1243,35742,3575896302,3575896302,0
3,1243,35743,3575896302,3575896302,0
3,1243,35744,3575896302,3575896304,2
3,1243,35745,3575896302,3575896309,7
3,1243,35746,3575896302,3575896309,7
3,1243,35747,3575896302,3575896310,8
3,1243,35748,3575896302,3575896310,8
3,1243,35749,3575896302,3575896311,9
3,1243,35750,3575896302,3575896313,11
3,1243,35751,3575896302,3575896318,16
3,1243,35752,3575896302,3575896318,16
3,1243,35753,3575896302,3575896320,18
3,1243,35754,3575896302,3575896320,18
3,1243,35755,3575896302,3575896321,19
3,1243,35756,3575896302,3575896321,19
3,1243,35757,3575896302,3575896323,21
3,1243,35758,3575896302,3575896330,28
3,1243,35759,3575896302,3575896330,28
3,1243,35760,3575896302,3575896330,28
3,1243,35761,3575896302,3575896332,30
3,1243,35762,3575896302,3575896334,32
3,1243,35763,3575896302,3575896337,35
3,1243,35764,3575896302,3575896338,36
3,1243,35765,3575896302,3575896341,39
3,1243,35766,3575896302,3575896341,39
3,1243,35767,3575896302,3575896344,42
3,1243,35768,3575896302,3575896345,43
3,1243,35769,3575896302,3575896346,44
3,1243,35770,3575896302,3575896351,49
3,1244,35771,3575896366,3575896366,0
3,1244,35772,3575896366,3575896366,0
3,1244,35773,3575896366,3575896366,0
3,1244,35774,3575896366,3575896366,0
3,1244,35775,3575896366,3575896368,2
3,1244,35776,3575896366,3575896370,4
3,1244,35777,3575896366,3575896371,5
3,1244,35778,3575896366,3575896372,6
3,1244,35779,3575896366,3575896373,7
3,1244,35780,3575896366,3575896373,7
3,1244,35781,3575896366,3575896379,13
3,1244,35782,3575896366,3575896379,13
3,1244,35783,3575896366,3575896380,14
3,1244,35784,3575896366,3575896381,15
3,1244,35785,3575896366,3575896383,17
3,1244,35786,3575896366,3575896384,18
3,1244,35787,3575896366,3575896384,18
3,1244,35788,3575896366,3575896385,19
3,1244,35789,3575896366,3575896386,20
3,1244,35790,3575896366,3575896387,21
3,1244,35791,3575896366,3575896388,22
3,1244,35792,3575896366,3575896391,25
3,1244,35793,3575896366,3575896392,26
3,1244,35794,3575896366,3575896394,28
3,1244,35795,3575896366,3575896394,28
3,1244,35796,3575896366,3575896395,29
3,1244,35797,3575896366,3575896395,29
3,1244,35798,3575896366,3575896395,29
3,1244,35799,3575896366,3575896396,30
3,1244,35800,3575896366,3575896398,32
3,1244,35801,3575896366,3575896398,32
3,1244,35802,3575896366,3575896398,32
3,1244,35803,3575896366,3575896398,32
3,1244,35804,3575896366,3575896400,34
3,1244,35805,3575896366,3575896403,37
3,1244,35806,3575896366,3575896403,37
3,1244,35807,3575896366,3575896404,38
3,1244,35808,3575896366,3575896405,39
3,1244,35809,3575896366,3575896411,45
3,1244,35810,3575896366,3575896415,49
3,1245,35811,3575896431,3575896431,0
3,1245,35812,3575896431,3575896431,0
3,1245,35813,3575896431,3575896431,0
3,1245,35814,3575896431,3575896431,0
3,1245,35815,3575896431,3575896431,0
3,1245,35816,3575896431,3575896431,0
3,1245,35817,3575896431,3575896431,0
3,1245,35818,3575896431,3575896431,0
3,1245,35819,3575896431,3575896431,0
3,1245,35820,3575896431,3575896431,0
3,1245,35821,3575896431,3575896431,0
3,1245,35822,3575896431,3575896431,0
3,1245,35823,3575896431,3575896431,0
3,1245,35824,3575896431,3575896431,0
3,1245,35825,3575896431,3575896431,0
3,1245,35826,3575896431,3575896432,1
3,1245,35827,3575896431,3575896433,2
3,1245,35828,3575896431,3575896435,4
3,1245,35829,3575896431,3575896436,5
3,1245,35830,3575896431,3575896437,6
3,1245,35831,3575896431,3575896439,8
3,1245,35832,3575896431,3575896440,9
3,1245,35833,3575896431,3575896441,10
3,1245,35834,3575896431,3575896441,10
3,1245,35835,3575896431,3575896442,11
3,1245,35836,3575896431,3575896442,11
3,1245,35837,3575896431,3575896443,12
3,1245,35838,3575896431,3575896444,13
3,1245,35839,3575896431,3575896445,14
3,1245,35840,3575896431,3575896448,17
3,1245,35841,3575896431,3575896450,19
3,1245,35842,3575896431,3575896450,19
3,1245,35843,3575896431,3575896451,20
3,1245,35844,3575896431,3575896452,21
3,1245,35845,3575896431,3575896453,22
3,1245,35846,3575896431,3575896455,24
3,1245,35847,3575896431,3575896456,25
3,1245,35848,3575896431,3575896457,26
3,1245,35849,3575896431,3575896459,28
3,1245,35850,3575896431,3575896464,33
3,1245,35851,3575896431,3575896464,33
3,1245,35852,3575896431,3575896464,33
3,1245,35853,3575896431,3575896465,34
3,1245,35854,3575896431,3575896467,36
3,1245,35855,3575896431,3575896468,37
3,1245,35856,3575896431,3575896469,38
3,1245,35857,3575896431,3575896470,39
3,1245,35858,3575896431,3575896477,46
3,1245,35859,3575896431,3575896478,47
3,1245,35860,3575896431,3575896479,48
3,1245,35861,3575896431,3575896481,50
3,1246,35862,3575896494,3575896494,0
3,1246,35863,3575896494,3575896494,0
3,1246,35864,3575896494,3575896494,0
3,1246,35865,3575896494,3575896494,0
3,1246,35866,3575896494,3575896494,0
3,1246,35867,3575896494,3575896494,0
3,1246,35868,3575896494,3575896494,0
3,1246,35869,3575896494,3575896494,0
3,1246,35870,3575896494,3575896495,1
3,1246,35871,3575896494,3575896497,3
3,1246,35872,3575896494,3575896498,4
3,1246,35873,3575896494,3575896498,4
3,1246,35874,3575896494,3575896499,5
3,1246,35875,3575896494,3575896500,6
3,1246,35876,3575896494,3575896502,8
3,1246,35877,3575896494,3575896502,8
3,1246,35878,3575896494,3575896503,9
3,1246,35879,3575896494,3575896508,14
3,1246,35880,3575896494,3575896509,15
3,1246,35881,3575896494,3575896509,15
3,1246,35882,3575896494,3575896511,17
3,1246,35883,3575896494,3575896512,18
3,1246,35884,3575896494,3575896512,18
3,1246,35885,3575896494,3575896517,23
3,1246,35886,3575896494,3575896517,23
3,1246,35887,3575896494,3575896520,26
3,1246,35888,3575896494,3575896520,26
3,1246,35889,3575896494,3575896522,28
3,1246,35890,3575896494,3575896522,28
3,1246,35891,3575896494,3575896529,35
3,1246,35892,3575896494,3575896529,35
3,1246,35893,3575896494,3575896530,36
3,1246,35894,3575896494,3575896532,38
3,1246,35895,3575896494,3575896533,39
3,1246,35896,3575896494,3575896537,43
3,1246,35897,3575896494,3575896538,44
3,1246,35898,3575896494,3575896540,46
3,1246,35899,3575896494,3575896540,46
3,1246,35900,3575896494,3575896544,50
3,1247,35901,3575896562,3575896562,0
3,1247,35902,3575896562,3575896562,0
3,1247,35903,3575896562,3575896562,0
3,1247,35904,3575896562,3575896562,0
3,1247,35905,3575896562,3575896562,0
3,1247,35906,3575896562,3575896562,0
3,1247,35907,3575896562,3575896562,0
3,1247,35908,3575896562,3575896562,0
3,1247,35909,3575896562,3575896563,1
3,1247,35910,3575896562,3575896567,5
3,1247,35911,3575896562,3575896569,7
3,1247,35912,3575896562,3575896570,8
3,1247,35913,3575896562,3575896571,9
3,1247,35914,3575896562,3575896572,10
3,1247,35915,3575896562,3575896572,10
3,1247,35916,3575896562,3575896578,16
3,1247,35917,3575896562,3575896578,16
3,1247,35918,3575896562,3575896579,17
3,1247,35919,3575896562,3575896579,17
3,1247,35920,3575896562,3575896582,20
3,1247,35921,3575896562,3575896583,21
3,1247,35922,3575896562,3575896584,22
3,1247,35923,3575896562,3575896585,23
3,1247,35924,3575896562,3575896588,26
3,1247,35925,3575896562,3575896590,28
3,1247,35926,3575896562,3575896591,29
3,1247,35927,3575896562,3575896592,30
3,1247,35928,3575896562,3575896593,31
3,1247,35929,3575896562,3575896593,31
3,1247,35930,3575896562,3575896594,32
3,1247,35931,3575896562,3575896594,32
3,1247,35932,3575896562,3575896595,33
3,1247,35933,3575896562,3575896595,33
3,1247,35934,3575896562,3575896596,34
3,1247,35935,3575896562,3575896597,35
3,1247,35936,3575896562,3575896597,35
3,1247,35937,3575896562,3575896598,36
3,1247,35938,3575896562,3575896599,37
3,1247,35939,3575896562,3575896601,39
3,1247,35940,3575896562,3575896602,40
3,1247,35941,3575896562,3575896602,40
3,1247,35942,3575896562,3575896603,41
3,1247,35943,3575896562,3575896604,42
3,1247,35944,3575896562,3575896610,48
3,1248,35945,3575896626,3575896626,0
3,1248,35946,3575896626,3575896626,0
3,1248,35947,3575896626,3575896626,0
3,1248,35948,3575896626,3575896626,0
3,1248,35949,3575896626,3575896626,0
3,1248,35950,3575896626,3575896626,0
3,1248,35951,3575896626,3575896626,0
3,1248,35952,3575896626,3575896626,0
3,1248,35953,3575896626,3575896626,0
3,1248,35954,3575896626,3575896627,1
3,1248,35955,3575896626,3575896628,2
3,1248,35956,3575896626,3575896628,2
3,1248,35957,3575896626,3575896629,3
3,1248,35958,3575896626,3575896630,4
3,1248,35959,3575896626,3575896630,4
3,1248,35960,3575896626,3575896633,7
3,1248,35961,3575896626,3575896633,7
3,1248,35962,3575896626,3575896635,9
3,1248,35963,3575896626,3575896639,13
3,1248,35964,3575896626,3575896640,14
3,1248,35965,3575896626,3575896641,15
3,1248,35966,3575896626,3575896642,16
3,1248,35967,3575896626,3575896642,16
3,1248,35968,3575896626,3575896643,17
3,1248,35969,3575896626,3575896645,19
3,1248,35970,3575896626,3575896647,21
3,1248,35971,3575896626,3575896648,22
3,1248,35972,3575896626,3575896649,23
3,1248,35973,3575896626,3575896650,24
3,1248,35974,3575896626,3575896651,25
3,1248,35975,3575896626,3575896652,26
3,1248,35976,3575896626,3575896655,29
3,1248,35977,3575896626,3575896656,30
3,1248,35978,3575896626,3575896657,31
3,1248,35979,3575896626,3575896658,32
3,1248,35980,3575896626,3575896663,37
3,1248,35981,3575896626,3575896663,37
3,1248,35982,3575896626,3575896663,37
3,1248,35983,3575896626,3575896664,38
3,1248,35984,3575896626,3575896664,38
3,1248,35985,3575896626,3575896666,40
3,1248,35986,3575896626,3575896667,41
3,1248,35987,3575896626,3575896669,43
3,1248,35988,3575896626,3575896670,44
3,1249,35989,3575896690,3575896690,0
3,1249,35990,3575896690,3575896690,0
3,1249,35991,3575896690,3575896690,0
3,1249,35992,3575896690,3575896690,0
3,1249,35993,3575896690,3575896690,0
3,1249,35994,3575896690,3575896690,0
3,1249,35995,3575896690,3575896690,0
3,1249,35996,3575896690,3575896690,0
3,1249,35997,3575896690,3575896690,0
3,1249,35998,3575896690,3575896690,0
3,1249,35999,3575896690,3575896691,1
3,1249,36000,3575896690,3575896692,2
3,1249,36001,3575896690,3575896696,6
3,1249,36002,3575896690,3575896697,7
3,1249,36003,3575896690,3575896698,8
3,1249,36004,3575896690,3575896699,9
3,1249,36005,3575896690,3575896699,9
3,1249,36006,3575896690,3575896699,9
3,1249,36007,3575896690,3575896701,11
3,1249,36008,3575896690,3575896702,12
3,1249,36009,3575896690,3575896702,12
3,1249,36010,3575896690,3575896703,13
3,1249,36011,3575896690,3575896708,18
3,1249,36012,3575896690,3575896709,19
3,1249,36013,3575896690,3575896710,20
3,1249,36014,3575896690,3575896710,20
3,1249,36015,3575896690,3575896712,22
3,1249,36016,3575896690,3575896712,22
3,1249,36017,3575896690,3575896717,27
3,1249,36018,3575896690,3575896718,28
3,1249,36019,3575896690,3575896720,30
3,1249,36020,3575896690,3575896720,30
3,1249,36021,3575896690,3575896721,31
3,1249,36022,3575896690,3575896721,31
3,1249,36023,3575896690,3575896729,39
3,1249,36024,3575896690,3575896729,39
3,1249,36025,3575896690,3575896729,39
3,1249,36026,3575896690,3575896732,42
3,1249,36027,3575896690,3575896734,44
3,1249,36028,3575896690,3575896737,47
3,1249,36029,3575896690,3575896738,48
3,1249,36030,3575896690,3575896740,50
3,1250,36031,3575896755,3575896755,0
3,1250,36032,3575896755,3575896755,0
3,1250,36033,3575896755,3575896755,0
3,1250,36034,3575896755,3575896755,0
3,1250,36035,3575896755,3575896756,1
3,1250,36036,3575896755,3575896756,1
3,1250,36037,3575896755,3575896762,7
3,1250,36038,3575896755,3575896763,8
3,1250,36039,3575896755,3575896767,12
3,1250,36040,3575896755,3575896769,14
3,1250,36041,3575896755,3575896770,15
3,1250,36042,3575896755,3575896772,17
3,1250,36043,3575896755,3575896772,17
3,1250,36044,3575896755,3575896772,17
3,1250,36045,3575896755,3575896778,23
3,1250,36046,3575896755,3575896778,23
3,1250,36047,3575896755,3575896779,24
3,1250,36048,3575896755,3575896779,24
3,1250,36049,3575896755,3575896782,27
3,1250,36050,3575896755,3575896783,28
3,1250,36051,3575896755,3575896786,31
3,1250,36052,3575896755,3575896786,31
3,1250,36053,3575896755,3575896786,31
3,1250,36054,3575896755,3575896787,32
3,1250,36055,3575896755,3575896789,34
3,1250,36056,3575896755,3575896791,36
3,1250,36057,3575896755,3575896791,36
3,1250,36058,3575896755,3575896792,37
3,1250,36059,3575896755,3575896793,38
3,1250,36060,3575896755,3575896793,38
3,1250,36061,3575896755,3575896794,39
3,1250,36062,3575896755,3575896794,39
3,1250,36063,3575896755,3575896795,40
3,1250,36064,3575896755,3575896795,40
3,1250,36065,3575896755,3575896796,41
3,1250,36066,3575896755,3575896797,42
3,1250,36067,3575896755,3575896798,43
3,1250,36068,3575896755,3575896798,43
3,1250,36069,3575896755,3575896799,44
3,1250,36070,3575896755,3575896800,45
3,1250,36071,3575896755,3575896802,47
3,1250,36072,3575896755,3575896802,47
3,1250,36073,3575896755,3575896803,48
3,1250,36074,3575896755,3575896804,49
3,1251,36075,3575896818,3575896818,0
3,1251,36076,3575896818,3575896818,0
3,1251,36077,3575896818,3575896818,0
3,1251,36078,3575896818,3575896818,0
3,1251,36079,3575896818,3575896818,0
3,1251,36080,3575896818,3575896818,0
3,1251,36081,3575896818,3575896819,1
3,1251,36082,3575896818,3575896819,1
3,1251,36083,3575896818,3575896820,2
3,1251,36084,3575896818,3575896821,3
3,1251,36085,3575896818,3575896827,9
3,1251,36086,3575896818,3575896828,10
3,1251,36087,3575896818,3575896828,10
3,1251,36088,3575896818,3575896829,11
3,1251,36089,3575896818,3575896831,13
3,1251,36090,3575896818,3575896831,13
3,1251,36091,3575896818,3575896833,15
3,1251,36092,3575896818,3575896834,16
3,1251,36093,3575896818,3575896835,17
3,1251,36094,3575896818,3575896838,20
3,1251,36095,3575896818,3575896839,21
3,1251,36096,3575896818,3575896839,21
3,1251,36097,3575896818,3575896839,21
3,1251,36098,3575896818,3575896841,23
3,1251,36099,3575896818,3575896842,24
3,1251,36100,3575896818,3575896842,24
3,1251,36101,3575896818,3575896842,24
3,1251,36102,3575896818,3575896844,26
3,1251,36103,3575896818,3575896845,27
3,1251,36104,3575896818,3575896848,30
3,1251,36105,3575896818,3575896849,31
3,1251,36106,3575896818,3575896851,33
3,1251,36107,3575896818,3575896852,34
3,1251,36108,3575896818,3575896853,35
3,1251,36109,3575896818,3575896854,36
3,1251,36110,3575896818,3575896855,37
3,1251,36111,3575896818,3575896856,38
3,1251,36112,3575896818,3575896856,38
3,1251,36113,3575896818,3575896859,41
3,1251,36114,3575896818,3575896863,45
3,1251,36115,3575896818,3575896864,46
3,1251,36116,3575896818,3575896864,46
3,1251,36117,3575896818,3575896865,47
3,1251,36118,3575896818,3575896865,47
3,1251,36119,3575896818,3575896866,48
3,1251,36120,3575896818,3575896867,49
3,1251,36121,3575896818,3575896867,49
3,1252,36122,3575896884,3575896884,0
3,1252,36123,3575896884,3575896884,0
3,1252,36124,3575896884,3575896884,0
3,1252,36125,3575896884,3575896884,0
3,1252,36126,3575896884,3575896884,0
3,1252,36127,3575896884,3575896884,0
3,1252,36128,3575896884,3575896885,1
3,1252,36129,3575896884,3575896885,1
3,1252,36130,3575896884,3575896886,2
3,1252,36131,3575896884,3575896887,3
3,1252,36132,3575896884,3575896890,6
3,1252,36133,3575896884,3575896891,7
3,1252,36134,3575896884,3575896891,7
3,1252,36135,3575896884,3575896892,8
3,1252,36136,3575896884,3575896896,12
3,1252,36137,3575896884,3575896897,13
3,1252,36138,3575896884,3575896898,14
3,1252,36139,3575896884,3575896899,15
3,1252,36140,3575896884,3575896899,15
3,1252,36141,3575896884,3575896900,16
3,1252,36142,3575896884,3575896901,17
3,1252,36143,3575896884,3575896901,17
3,1252,36144,3575896884,3575896903,19
3,1252,36145,3575896884,3575896904,20
3,1252,36146,3575896884,3575896910,26
3,1252,36147,3575896884,3575896911,27
3,1252,36148,3575896884,3575896912,28
3,1252,36149,3575896884,3575896912,28
3,1252,36150,3575896884,3575896912,28
3,1252,36151,3575896884,3575896917,33
3,1252,36152,3575896884,3575896918,34
3,1252,36153,3575896884,3575896920,36
3,1252,36154,3575896884,3575896921,37
3,1252,36155,3575896884,3575896922,38
3,1252,36156,3575896884,3575896922,38
3,1252,36157,3575896884,3575896927,43
3,1252,36158,3575896884,3575896929,45
3,1252,36159,3575896884,3575896929,45
3,1252,36160,3575896884,3575896930,46
3,1252,36161,3575896884,3575896932,48
3,1253,36162,3575896946,3575896946,0
3,1253,36163,3575896946,3575896946,0
3,1253,36164,3575896946,3575896946,0
3,1253,36165,3575896946,3575896946,0
3,1253,36166,3575896946,3575896946,0
3,1253,36167,3575896946,3575896946,0
3,1253,36168,3575896946,3575896949,3
3,1253,36169,3575896946,3575896955,9
3,1253,36170,3575896946,3575896956,10
3,1253,36171,3575896946,3575896959,13
3,1253,36172,3575896946,3575896960,14
3,1253,36173,3575896946,3575896962,16
3,1253,36174,3575896946,3575896964,18
3,1253,36175,3575896946,3575896967,21
3,1253,36176,3575896946,3575896972,26
3,1253,36177,3575896946,3575896972,26
3,1253,36178,3575896946,3575896973,27
3,1253,36179,3575896946,3575896978,32
3,1253,36180,3575896946,3575896979,33
3,1253,36181,3575896946,3575896980,34
3,1253,36182,3575896946,3575896983,37
3,1253,36183,3575896946,3575896983,37
3,1253,36184,3575896946,3575896986,40
3,1253,36185,3575896946,3575896986,40
3,1253,36186,3575896946,3575896986,40
3,1253,36187,3575896946,3575896986,40
3,1253,36188,3575896946,3575896990,44
3,1253,36189,3575896946,3575896991,45
3,1253,36190,3575896946,3575896991,45
3,1253,36191,3575896946,3575896993,47
3,1253,36192,3575896946,3575896994,48
3,1253,36193,3575896946,3575896994,48
3,1253,36194,3575896946,3575896995,49
3,1253,36195,3575896946,3575896995,49
3,1254,36196,3575897014,3575897014,0
3,1254,36197,3575897014,3575897014,0
3,1254,36198,3575897014,3575897014,0
3,1254,36199,3575897014,3575897014,0
3,1254,36200,3575897014,3575897014,0
3,1254,36201,3575897014,3575897014,0
3,1254,36202,3575897014,3575897014,0
3,1254,36203,3575897014,3575897014,0
3,1254,36204,3575897014,3575897014,0
3,1254,36205,3575897014,3575897015,1
3,1254,36206,3575897014,3575897016,2
3,1254,36207,3575897014,3575897017,3
3,1254,36208,3575897014,3575897020,6
3,1254,36209,3575897014,3575897020,6
3,1254,36210,3575897014,3575897022,8
3,1254,36211,3575897014,3575897026,12
3,1254,36212,3575897014,3575897028,14
3,1254,36213,3575897014,3575897028,14
3,1254,36214,3575897014,3575897028,14
3,1254,36215,3575897014,3575897028,14
3,1254,36216,3575897014,3575897029,15
3,1254,36217,3575897014,3575897031,17
3,1254,36218,3575897014,3575897032,18
3,1254,36219,3575897014,3575897034,20
3,1254,36220,3575897014,3575897034,20
3,1254,36221,3575897014,3575897035,21
3,1254,36222,3575897014,3575897039,25
3,1254,36223,3575897014,3575897040,26
3,1254,36224,3575897014,3575897040,26
3,1254,36225,3575897014,3575897040,26
3,1254,36226,3575897014,3575897042,28
3,1254,36227,3575897014,3575897042,28
3,1254,36228,3575897014,3575897043,29
3,1254,36229,3575897014,3575897044,30
3,1254,36230,3575897014,3575897045,31
3,1254,36231,3575897014,3575897048,34
3,1254,36232,3575897014,3575897049,35
3,1254,36233,3575897014,3575897049,35
3,1254,36234,3575897014,3575897051,37
3,1254,36235,3575897014,3575897053,39
3,1254,36236,3575897014,3575897053,39
3,1254,36237,3575897014,3575897055,41
3,1254,36238,3575897014,3575897057,43
3,1254,36239,3575897014,3575897057,43
3,1254,36240,3575897014,3575897060,46
3,1254,36241,3575897014,3575897063,49
3,1254,36242,3575897014,3575897064,50
3,1255,36243,3575897078,3575897078,0
3,1255,36244,3575897078,3575897078,0
3,1255,36245,3575897078,3575897078,0
3,1255,36246,3575897078,3575897078,0
3,1255,36247,3575897078,3575897078,0
3,1255,36248,3575897078,3575897078,0
3,1255,36249,3575897078,3575897078,0
3,1255,36250,3575897078,3575897078,0
3,1255,36251,3575897078,3575897079,1
3,1255,36252,3575897078,3575897081,3
3,1255,36253,3575897078,3575897081,3
3,1255,36254,3575897078,3575897082,4
3,1255,36255,3575897078,3575897085,7
3,1255,36256,3575897078,3575897086,8
3,1255,36257,3575897078,3575897086,8
3,1255,36258,3575897078,3575897091,13
3,1255,36259,3575897078,3575897092,14
3,1255,36260,3575897078,3575897096,18
3,1255,36261,3575897078,3575897097,19
3,1255,36262,3575897078,3575897098,20
3,1255,36263,3575897078,3575897099,21
3,1255,36264,3575897078,3575897099,21
3,1255,36265,3575897078,3575897100,22
3,1255,36266,3575897078,3575897102,24
3,1255,36267,3575897078,3575897102,24
3,1255,36268,3575897078,3575897104,26
3,1255,36269,3575897078,3575897108,30
3,1255,36270,3575897078,3575897110,32
3,1255,36271,3575897078,3575897110,32
3,1255,36272,3575897078,3575897112,34
3,1255,36273,3575897078,3575897112,34
3,1255,36274,3575897078,3575897117,39
3,1255,36275,3575897078,3575897118,40
3,1255,36276,3575897078,3575897120,42
3,1255,36277,3575897078,3575897121,43
3,1255,36278,3575897078,3575897121,43
3,1255,36279,3575897078,3575897122,44
3,1255,36280,3575897078,3575897122,44
3,1255,36281,3575897078,3575897127,49
3,1256,36282,3575897142,3575897142,0
3,1256,36283,3575897142,3575897142,0
3,1256,36284,3575897142,3575897142,0
3,1256,36285,3575897142,3575897142,0
3,1256,36286,3575897142,3575897142,0
3,1256,36287,3575897142,3575897142,0
3,1256,36288,3575897142,3575897142,0
3,1256,36289,3575897142,3575897142,0
3,1256,36290,3575897142,3575897144,2
3,1256,36291,3575897142,3575897146,4
3,1256,36292,3575897142,3575897146,4
3,1256,36293,3575897142,3575897150,8
3,1256,36294,3575897142,3575897156,14
3,1256,36295,3575897142,3575897156,14
3,1256,36296,3575897142,3575897159,17
3,1256,36297,3575897142,3575897163,21
3,1256,36298,3575897142,3575897165,23
3,1256,36299,3575897142,3575897168,26
3,1256,36300,3575897142,3575897169,27
3,1256,36301,3575897142,3575897172,30
3,1256,36302,3575897142,3575897173,31
3,1256,36303,3575897142,3575897174,32
3,1256,36304,3575897142,3575897174,32
3,1256,36305,3575897142,3575897178,36
3,1256,36306,3575897142,3575897179,37
3,1256,36307,3575897142,3575897180,38
3,1256,36308,3575897142,3575897180,38
3,1256,36309,3575897142,3575897184,42
3,1256,36310,3575897142,3575897184,42
3,1256,36311,3575897142,3575897186,44
3,1256,36312,3575897142,3575897187,45
3,1256,36313,3575897142,3575897187,45
3,1256,36314,3575897142,3575897187,45
3,1256,36315,3575897142,3575897190,48
3,1256,36316,3575897142,3575897191,49
3,1256,36317,3575897142,3575897191,49
3,1257,36318,3575897209,3575897209,0
3,1257,36319,3575897209,3575897209,0
3,1257,36320,3575897209,3575897209,0
3,1257,36321,3575897209,3575897209,0
3,1257,36322,3575897209,3575897209,0
3,1257,36323,3575897209,3575897209,0
3,1257,36324,3575897209,3575897209,0
3,1257,36325,3575897209,3575897209,0
3,1257,36326,3575897209,3575897209,0
3,1257,36327,3575897209,3575897209,0
3,1257,36328,3575897209,3575897209,0
3,1257,36329,3575897209,3575897209,0
3,1257,36330,3575897209,3575897209,0
3,1257,36331,3575897209,3575897209,0
3,1257,36332,3575897209,3575897211,2
3,1257,36333,3575897209,3575897215,6
3,1257,36334,3575897209,3575897215,6
3,1257,36335,3575897209,3575897217,8
3,1257,36336,3575897209,3575897218,9
3,1257,36337,3575897209,3575897220,11
3,1257,36338,3575897209,3575897220,11
3,1257,36339,3575897209,3575897220,11
3,1257,36340,3575897209,3575897223,14
3,1257,36341,3575897209,3575897224,15
3,1257,36342,3575897209,3575897227,18
3,1257,36343,3575897209,3575897228,19
3,1257,36344,3575897209,3575897229,20
3,1257,36345,3575897209,3575897229,20
3,1257,36346,3575897209,3575897230,21
3,1257,36347,3575897209,3575897232,23
3,1257,36348,3575897209,3575897232,23
3,1257,36349,3575897209,3575897235,26
3,1257,36350,3575897209,3575897235,26
3,1257,36351,3575897209,3575897236,27
3,1257,36352,3575897209,3575897238,29
3,1257,36353,3575897209,3575897239,30
3,1257,36354,3575897209,3575897240,31
3,1257,36355,3575897209,3575897240,31
3,1257,36356,3575897209,3575897240,31
3,1257,36357,3575897209,3575897242,33
3,1257,36358,3575897209,3575897242,33
3,1257,36359,3575897209,3575897243,34
3,1257,36360,3575897209,3575897244,35
3,1257,36361,3575897209,3575897244,35
3,1257,36362,3575897209,3575897248,39
3,1257,36363,3575897209,3575897249,40
3,1257,36364,3575897209,3575897249,40
3,1257,36365,3575897209,3575897253,44
3,1257,36366,3575897209,3575897253,44
3,1257,36367,3575897209,3575897254,45
3,1257,36368,3575897209,3575897255,46
3,1257,36369,3575897209,3575897257,48
3,1257,36370,3575897209,3575897257,48
3,1258,36371,3575897271,3575897271,0
3,1258,36372,3575897271,3575897271,0
3,1258,36373,3575897271,3575897272,1
3,1258,36374,3575897271,3575897272,1
3,1258,36375,3575897271,3575897272,1
3,1258,36376,3575897271,3575897272,1
3,1258,36377,3575897271,3575897272,1
3,1258,36378,3575897271,3575897272,1
3,1258,36379,3575897271,3575897272,1
3,1258,36380,3575897271,3575897272,1
3,1258,36381,3575897271,3575897278,7
3,1258,36382,3575897271,3575897278,7
3,1258,36383,3575897271,3575897281,10
3,1258,36384,3575897271,3575897281,10
3,1258,36385,3575897271,3575897282,11
3,1258,36386,3575897271,3575897285,14
3,1258,36387,3575897271,3575897285,14
3,1258,36388,3575897271,3575897285,14
3,1258,36389,3575897271,3575897286,15
3,1258,36390,3575897271,3575897286,15
3,1258,36391,3575897271,3575897286,15
3,1258,36392,3575897271,3575897289,18
3,1258,36393,3575897271,3575897291,20
3,1258,36394,3575897271,3575897291,20
3,1258,36395,3575897271,3575897292,21
3,1258,36396,3575897271,3575897296,25
3,1258,36397,3575897271,3575897298,27
3,1258,36398,3575897271,3575897298,27
3,1258,36399,3575897271,3575897299,28
3,1258,36400,3575897271,3575897300,29
3,1258,36401,3575897271,3575897301,30
3,1258,36402,3575897271,3575897301,30
3,1258,36403,3575897271,3575897304,33
3,1258,36404,3575897271,3575897309,38
3,1258,36405,3575897271,3575897309,38
3,1258,36406,3575897271,3575897310,39
3,1258,36407,3575897271,3575897311,40
3,1258,36408,3575897271,3575897312,41
3,1258,36409,3575897271,3575897313,42
3,1258,36410,3575897271,3575897318,47
3,1258,36411,3575897271,3575897321,50
3,1259,36412,3575897337,3575897337,0
3,1259,36413,3575897337,3575897337,0
3,1259,36414,3575897337,3575897337,0
3,1259,36415,3575897337,3575897337,0
3,1259,36416,3575897337,3575897337,0
3,1259,36417,3575897337,3575897337,0
3,1259,36418,3575897337,3575897337,0
3,1259,36419,3575897337,3575897338,1
3,1259,36420,3575897337,3575897340,3
3,1259,36421,3575897337,3575897341,4
3,1259,36422,3575897337,3575897342,5
3,1259,36423,3575897337,3575897344,7
3,1259,36424,3575897337,3575897346,9
3,1259,36425,3575897337,3575897347,10
3,1259,36426,3575897337,3575897350,13
3,1259,36427,3575897337,3575897355,18
3,1259,36428,3575897337,3575897358,21
3,1259,36429,3575897337,3575897360,23
3,1259,36430,3575897337,3575897361,24
3,1259,36431,3575897337,3575897364,27
3,1259,36432,3575897337,3575897365,28
3,1259,36433,3575897337,3575897368,31
3,1259,36434,3575897337,3575897371,34
3,1259,36435,3575897337,3575897373,36
3,1259,36436,3575897337,3575897374,37
3,1259,36437,3575897337,3575897375,38
3,1259,36438,3575897337,3575897379,42
3,1259,36439,3575897337,3575897380,43
3,1259,36440,3575897337,3575897380,43
3,1259,36441,3575897337,3575897380,43
3,1259,36442,3575897337,3575897383,46
3,1259,36443,3575897337,3575897383,46
3,1259,36444,3575897337,3575897386,49
3,1259,36445,3575897337,3575897387,50
3,1260,36446,3575897402,3575897402,0
3,1260,36447,3575897402,3575897402,0
3,1260,36448,3575897402,3575897402,0
3,1260,36449,3575897402,3575897402,0
3,1260,36450,3575897402,3575897402,0
3,1260,36451,3575897402,3575897402,0
3,1260,36452,3575897402,3575897402,0
3,1260,36453,3575897402,3575897402,0
3,1260,36454,3575897402,3575897402,0
3,1260,36455,3575897402,3575897402,0
3,1260,36456,3575897402,3575897402,0
3,1260,36457,3575897402,3575897402,0
3,1260,36458,3575897402,3575897402,0
3,1260,36459,3575897402,3575897402,0
3,1260,36460,3575897402,3575897402,0
3,1260,36461,3575897402,3575897402,0
3,1260,36462,3575897402,3575897403,1
3,1260,36463,3575897402,3575897404,2
3,1260,36464,3575897402,3575897404,2
3,1260,36465,3575897402,3575897411,9
3,1260,36466,3575897402,3575897416,14
3,1260,36467,3575897402,3575897416,14
3,1260,36468,3575897402,3575897416,14
3,1260,36469,3575897402,3575897416,14
3,1260,36470,3575897402,3575897418,16
3,1260,36471,3575897402,3575897419,17
3,1260,36472,3575897402,3575897420,18
3,1260,36473,3575897402,3575897423,21
3,1260,36474,3575897402,3575897427,25
3,1260,36475,3575897402,3575897429,27
3,1260,36476,3575897402,3575897430,28
3,1260,36477,3575897402,3575897430,28
3,1260,36478,3575897402,3575897432,30
3,1260,36479,3575897402,3575897433,31
3,1260,36480,3575897402,3575897434,32
3,1260,36481,3575897402,3575897435,33
3,1260,36482,3575897402,3575897436,34
3,1260,36483,3575897402,3575897440,38
3,1260,36484,3575897402,3575897440,38
3,1260,36485,3575897402,3575897442,40
3,1260,36486,3575897402,3575897442,40
3,1260,36487,3575897402,3575897443,41
3,1260,36488,3575897402,3575897445,43
3,1260,36489,3575897402,3575897448,46
3,1260,36490,3575897402,3575897448,46
3,1260,36491,3575897402,3575897449,47
3,1260,36492,3575897402,3575897451,49
3,1261,36493,3575897468,3575897468,0
3,1261,36494,3575897468,3575897468,0
3,1261,36495,3575897468,3575897468,0
3,1261,36496,3575897468,3575897468,0
3,1261,36497,3575897468,3575897468,0
3,1261,36498,3575897468,3575897468,0
3,1261,36499,3575897468,3575897468,0
3,1261,36500,3575897468,3575897468,0
3,1261,36501,3575897468,3575897468,0
3,1261,36502,3575897468,3575897468,0
3,1261,36503,3575897468,3575897468,0
3,1261,36504,3575897468,3575897469,1
3,1261,36505,3575897468,3575897472,4
3,1261,36506,3575897468,3575897478,10
3,1261,36507,3575897468,3575897478,10
3,1261,36508,3575897468,3575897480,12
3,1261,36509,3575897468,3575897481,13
3,1261,36510,3575897468,3575897482,14
3,1261,36511,3575897468,3575897485,17
3,1261,36512,3575897468,3575897486,18
3,1261,36513,3575897468,3575897486,18
3,1261,36514,3575897468,3575897486,18
3,1261,36515,3575897468,3575897490,22
3,1261,36516,3575897468,3575897492,24
3,1261,36517,3575897468,3575897492,24
3,1261,36518,3575897468,3575897496,28
3,1261,36519,3575897468,3575897498,30
3,1261,36520,3575897468,3575897498,30
3,1261,36521,3575897468,3575897500,32
3,1261,36522,3575897468,3575897500,32
3,1261,36523,3575897468,3575897501,33
3,1261,36524,3575897468,3575897502,34
3,1261,36525,3575897468,3575897502,34
3,1261,36526,3575897468,3575897504,36
3,1261,36527,3575897468,3575897508,40
3,1261,36528,3575897468,3575897509,41
3,1261,36529,3575897468,3575897510,42
3,1261,36530,3575897468,3575897512,44
3,1261,36531,3575897468,3575897512,44
3,1261,36532,3575897468,3575897513,45
3,1262,36533,3575897531,3575897531,0
3,1262,36534,3575897531,3575897531,0
3,1262,36535,3575897531,3575897531,0
3,1262,36536,3575897531,3575897531,0
3,1262,36537,3575897531,3575897531,0
3,1262,36538,3575897531,3575897531,0
3,1262,36539,3575897531,3575897531,0
3,1262,36540,3575897531,3575897531,0
3,1262,36541,3575897531,3575897531,0
3,1262,36542,3575897531,3575897531,0
3,1262,36543,3575897531,3575897531,0
3,1262,36544,3575897531,3575897531,0
3,1262,36545,3575897531,3575897531,0
3,1262,36546,3575897531,3575897534,3
3,1262,36547,3575897531,3575897537,6
3,1262,36548,3575897531,3575897539,8
3,1262,36549,3575897531,3575897540,9
3,1262,36550,3575897531,3575897541,10
3,1262,36551,3575897531,3575897543,12
3,1262,36552,3575897531,3575897545,14
3,1262,36553,3575897531,3575897547,16
3,1262,36554,3575897531,3575897548,17
3,1262,36555,3575897531,3575897554,23
3,1262,36556,3575897531,3575897557,26
3,1262,36557,3575897531,3575897562,31
3,1262,36558,3575897531,3575897563,32
3,1262,36559,3575897531,3575897568,37
3,1262,36560,3575897531,3575897568,37
3,1262,36561,3575897531,3575897570,39
3,1262,36562,3575897531,3575897573,42
3,1262,36563,3575897531,3575897573,42
3,1262,36564,3575897531,3575897575,44
3,1262,36565,3575897531,3575897578,47
3,1262,36566,3575897531,3575897578,47
3,1262,36567,3575897531,3575897579,48
3,1263,36568,3575897597,3575897597,0
3,1263,36569,3575897597,3575897597,0
3,1263,36570,3575897597,3575897597,0
3,1263,36571,3575897597,3575897597,0
3,1263,36572,3575897597,3575897597,0
3,1263,36573,3575897597,3575897597,0
3,1263,36574,3575897597,3575897597,0
3,1263,36575,3575897597,3575897597,0
3,1263,36576,3575897597,3575897597,0
3,1263,36577,3575897597,3575897597,0
3,1263,36578,3575897597,3575897597,0
3,1263,36579,3575897597,3575897597,0
3,1263,36580,3575897597,3575897597,0
3,1263,36581,3575897597,3575897597,0
3,1263,36582,3575897597,3575897597,0
3,1263,36583,3575897597,3575897597,0
3,1263,36584,3575897597,3575897599,2
3,1263,36585,3575897597,3575897599,2
3,1263,36586,3575897597,3575897601,4
3,1263,36587,3575897597,3575897601,4
3,1263,36588,3575897597,3575897602,5
3,1263,36589,3575897597,3575897603,6
3,1263,36590,3575897597,3575897603,6
3,1263,36591,3575897597,3575897610,13
3,1263,36592,3575897597,3575897615,18
3,1263,36593,3575897597,3575897615,18
3,1263,36594,3575897597,3575897616,19
3,1263,36595,3575897597,3575897616,19
3,1263,36596,3575897597,3575897618,21
3,1263,36597,3575897597,3575897619,22
3,1263,36598,3575897597,3575897619,22
3,1263,36599,3575897597,3575897620,23
3,1263,36600,3575897597,3575897622,25
3,1263,36601,3575897597,3575897623,26
3,1263,36602,3575897597,3575897626,29
3,1263,36603,3575897597,3575897628,31
3,1263,36604,3575897597,3575897629,32
3,1263,36605,3575897597,3575897630,33
3,1263,36606,3575897597,3575897631,34
3,1263,36607,3575897597,3575897633,36
3,1263,36608,3575897597,3575897633,36
3,1263,36609,3575897597,3575897634,37
3,1263,36610,3575897597,3575897636,39
3,1263,36611,3575897597,3575897637,40
3,1263,36612,3575897597,3575897639,42
3,1263,36613,3575897597,3575897639,42
3,1263,36614,3575897597,3575897640,43
3,1263,36615,3575897597,3575897641,44
3,1263,36616,3575897597,3575897642,45
3,1263,36617,3575897597,3575897642,45
3,1263,36618,3575897597,3575897643,46
3,1263,36619,3575897597,3575897643,46
3,1263,36620,3575897597,3575897645,48
3,1263,36621,3575897597,3575897647,50
3,1264,36622,3575897661,3575897661,0
3,1264,36623,3575897661,3575897661,0
3,1264,36624,3575897661,3575897661,0
3,1264,36625,3575897661,3575897661,0
3,1264,36626,3575897661,3575897661,0
3,1264,36627,3575897661,3575897661,0
3,1264,36628,3575897661,3575897661,0
3,1264,36629,3575897661,3575897661,0
3,1264,36630,3575897661,3575897661,0
3,1264,36631,3575897661,3575897662,1
3,1264,36632,3575897661,3575897664,3
3,1264,36633,3575897661,3575897665,4
3,1264,36634,3575897661,3575897665,4
3,1264,36635,3575897661,3575897665,4
3,1264,36636,3575897661,3575897667,6
3,1264,36637,3575897661,3575897667,6
3,1264,36638,3575897661,3575897669,8
3,1264,36639,3575897661,3575897672,11
3,1264,36640,3575897661,3575897678,17
3,1264,36641,3575897661,3575897679,18
3,1264,36642,3575897661,3575897681,20
3,1264,36643,3575897661,3575897681,20
3,1264,36644,3575897661,3575897682,21
3,1264,36645,3575897661,3575897684,23
3,1264,36646,3575897661,3575897685,24
3,1264,36647,3575897661,3575897685,24
3,1264,36648,3575897661,3575897686,25
3,1264,36649,3575897661,3575897686,25
3,1264,36650,3575897661,3575897687,26
3,1264,36651,3575897661,3575897690,29
3,1264,36652,3575897661,3575897691,30
3,1264,36653,3575897661,3575897692,31
3,1264,36654,3575897661,3575897693,32
3,1264,36655,3575897661,3575897697,36
3,1264,36656,3575897661,3575897698,37
3,1264,36657,3575897661,3575897699,38
3,1264,36658,3575897661,3575897700,39
3,1264,36659,3575897661,3575897700,39
3,1264,36660,3575897661,3575897701,40
3,1264,36661,3575897661,3575897702,41
3,1264,36662,3575897661,3575897704,43
3,1264,36663,3575897661,3575897708,47
3,1264,36664,3575897661,3575897710,49
3,1265,36665,3575897725,3575897725,0
3,1265,36666,3575897725,3575897725,0
3,1265,36667,3575897725,3575897725,0
3,1265,36668,3575897725,3575897725,0
3,1265,36669,3575897725,3575897725,0
3,1265,36670,3575897725,3575897725,0
3,1265,36671,3575897725,3575897725,0
3,1265,36672,3575897725,3575897725,0
3,1265,36673,3575897725,3575897725,0
3,1265,36674,3575897725,3575897725,0
3,1265,36675,3575897725,3575897727,2
3,1265,36676,3575897725,3575897730,5
3,1265,36677,3575897725,3575897731,6
3,1265,36678,3575897725,3575897734,9
3,1265,36679,3575897725,3575897737,12
3,1265,36680,3575897725,3575897739,14
3,1265,36681,3575897725,3575897741,16
3,1265,36682,3575897725,3575897741,16
3,1265,36683,3575897725,3575897743,18
3,1265,36684,3575897725,3575897745,20
3,1265,36685,3575897725,3575897747,22
3,1265,36686,3575897725,3575897748,23
3,1265,36687,3575897725,3575897754,29
3,1265,36688,3575897725,3575897758,33
3,1265,36689,3575897725,3575897760,35
3,1265,36690,3575897725,3575897763,38
3,1265,36691,3575897725,3575897763,38
3,1265,36692,3575897725,3575897768,43
3,1265,36693,3575897725,3575897773,48
3,1265,36694,3575897725,3575897774,49
3,1266,36695,3575897791,3575897791,0
3,1266,36696,3575897791,3575897791,0
3,1266,36697,3575897791,3575897791,0
3,1266,36698,3575897791,3575897791,0
3,1266,36699,3575897791,3575897791,0
3,1266,36700,3575897791,3575897791,0
3,1266,36701,3575897791,3575897791,0
3,1266,36702,3575897791,3575897791,0
3,1266,36703,3575897791,3575897791,0
3,1266,36704,3575897791,3575897791,0
3,1266,36705,3575897791,3575897791,0
3,1266,36706,3575897791,3575897791,0
3,1266,36707,3575897791,3575897791,0
3,1266,36708,3575897791,3575897791,0
3,1266,36709,3575897791,3575897791,0
3,1266,36710,3575897791,3575897793,2
3,1266,36711,3575897791,3575897794,3
3,1266,36712,3575897791,3575897794,3
3,1266,36713,3575897791,3575897795,4
3,1266,36714,3575897791,3575897796,5
3,1266,36715,3575897791,3575897796,5
3,1266,36716,3575897791,3575897797,6
3,1266,36717,3575897791,3575897798,7
3,1266,36718,3575897791,3575897798,7
3,1266,36719,3575897791,3575897799,8
3,1266,36720,3575897791,3575897801,10
3,1266,36721,3575897791,3575897803,12
3,1266,36722,3575897791,3575897803,12
3,1266,36723,3575897791,3575897803,12
3,1266,36724,3575897791,3575897810,19
3,1266,36725,3575897791,3575897815,24
3,1266,36726,3575897791,3575897815,24
3,1266,36727,3575897791,3575897816,25
3,1266,36728,3575897791,3575897818,27
3,1266,36729,3575897791,3575897820,29
3,1266,36730,3575897791,3575897821,30
3,1266,36731,3575897791,3575897822,31
3,1266,36732,3575897791,3575897826,35
3,1266,36733,3575897791,3575897827,36
3,1266,36734,3575897791,3575897828,37
3,1266,36735,3575897791,3575897830,39
3,1266,36736,3575897791,3575897830,39
3,1266,36737,3575897791,3575897831,40
3,1266,36738,3575897791,3575897833,42
3,1266,36739,3575897791,3575897833,42
3,1266,36740,3575897791,3575897834,43
3,1266,36741,3575897791,3575897835,44
3,1266,36742,3575897791,3575897837,46
3,1266,36743,3575897791,3575897840,49
3,1266,36744,3575897791,3575897840,49
3,1267,36745,3575897855,3575897855,0
3,1267,36746,3575897855,3575897855,0
3,1267,36747,3575897855,3575897855,0
3,1267,36748,3575897855,3575897855,0
3,1267,36749,3575897855,3575897855,0
3,1267,36750,3575897855,3575897855,0
3,1267,36751,3575897855,3575897855,0
3,1267,36752,3575897855,3575897855,0
3,1267,36753,3575897855,3575897855,0
3,1267,36754,3575897855,3575897855,0
3,1267,36755,3575897855,3575897855,0
3,1267,36756,3575897855,3575897856,1
3,1267,36757,3575897855,3575897860,5
3,1267,36758,3575897855,3575897864,9
3,1267,36759,3575897855,3575897865,10
3,1267,36760,3575897855,3575897865,10
3,1267,36761,3575897855,3575897865,10
3,1267,36762,3575897855,3575897865,10
3,1267,36763,3575897855,3575897867,12
3,1267,36764,3575897855,3575897868,13
3,1267,36765,3575897855,3575897869,14
3,1267,36766,3575897855,3575897872,17
3,1267,36767,3575897855,3575897878,23
3,1267,36768,3575897855,3575897879,24
3,1267,36769,3575897855,3575897881,26
3,1267,36770,3575897855,3575897881,26
3,1267,36771,3575897855,3575897882,27
3,1267,36772,3575897855,3575897885,30
3,1267,36773,3575897855,3575897885,30
3,1267,36774,3575897855,3575897886,31
3,1267,36775,3575897855,3575897886,31
3,1267,36776,3575897855,3575897887,32
3,1267,36777,3575897855,3575897889,34
3,1267,36778,3575897855,3575897891,36
3,1267,36779,3575897855,3575897894,39
3,1267,36780,3575897855,3575897898,43
3,1267,36781,3575897855,3575897898,43
3,1267,36782,3575897855,3575897899,44
3,1267,36783,3575897855,3575897900,45
3,1267,36784,3575897855,3575897901,46
3,1267,36785,3575897855,3575897901,46
3,1267,36786,3575897855,3575897901,46
3,1267,36787,3575897855,3575897904,49
3,1268,36788,3575897922,3575897922,0
3,1268,36789,3575897922,3575897922,0
3,1268,36790,3575897922,3575897922,0
3,1268,36791,3575897922,3575897922,0
3,1268,36792,3575897922,3575897922,0
3,1268,36793,3575897922,3575897922,0
3,1268,36794,3575897922,3575897922,0
3,1268,36795,3575897922,3575897922,0
3,1268,36796,3575897922,3575897922,0
3,1268,36797,3575897922,3575897922,0
3,1268,36798,3575897922,3575897922,0
3,1268,36799,3575897922,3575897922,0
3,1268,36800,3575897922,3575897924,2
3,1268,36801,3575897922,3575897927,5
3,1268,36802,3575897922,3575897930,8
3,1268,36803,3575897922,3575897930,8
3,1268,36804,3575897922,3575897931,9
3,1268,36805,3575897922,3575897934,12
3,1268,36806,3575897922,3575897936,14
3,1268,36807,3575897922,3575897939,17
3,1268,36808,3575897922,3575897941,19
3,1268,36809,3575897922,3575897941,19
3,1268,36810,3575897922,3575897946,24
3,1268,36811,3575897922,3575897947,25
3,1268,36812,3575897922,3575897949,27
3,1268,36813,3575897922,3575897954,32
3,1268,36814,3575897922,3575897958,36
3,1268,36815,3575897922,3575897959,37
3,1268,36816,3575897922,3575897962,40
3,1268,36817,3575897922,3575897964,42
3,1268,36818,3575897922,3575897969,47
3,1268,36819,3575897922,3575897969,47
3,1268,36820,3575897922,3575897972,50
3,1269,36821,3575897986,3575897986,0
3,1269,36822,3575897986,3575897986,0
3,1269,36823,3575897986,3575897986,0
3,1269,36824,3575897986,3575897986,0
3,1269,36825,3575897986,3575897986,0
3,1269,36826,3575897986,3575897986,0
3,1269,36827,3575897986,3575897986,0
3,1269,36828,3575897986,3575897986,0
3,1269,36829,3575897986,3575897986,0
3,1269,36830,3575897986,3575897987,1
3,1269,36831,3575897986,3575897988,2
3,1269,36832,3575897986,3575897990,4
3,1269,36833,3575897986,3575897991,5
3,1269,36834,3575897986,3575897991,5
3,1269,36835,3575897986,3575897993,7
3,1269,36836,3575897986,3575897995,9
3,1269,36837,3575897986,3575897995,9
3,1269,36838,3575897986,3575897996,10
3,1269,36839,3575897986,3575897996,10
3,1269,36840,3575897986,3575897997,11
3,1269,36841,3575897986,3575897997,11
3,1269,36842,3575897986,3575897998,12
3,1269,36843,3575897986,3575897999,13
3,1269,36844,3575897986,3575898000,14
3,1269,36845,3575897986,3575898003,17
3,1269,36846,3575897986,3575898003,17
3,1269,36847,3575897986,3575898003,17
3,1269,36848,3575897986,3575898004,18
3,1269,36849,3575897986,3575898010,24
3,1269,36850,3575897986,3575898015,29
3,1269,36851,3575897986,3575898015,29
3,1269,36852,3575897986,3575898015,29
3,1269,36853,3575897986,3575898017,31
3,1269,36854,3575897986,3575898019,33
3,1269,36855,3575897986,3575898019,33
3,1269,36856,3575897986,3575898020,34
3,1269,36857,3575897986,3575898021,35
3,1269,36858,3575897986,3575898022,36
3,1269,36859,3575897986,3575898023,37
3,1269,36860,3575897986,3575898028,42
3,1269,36861,3575897986,3575898028,42
3,1269,36862,3575897986,3575898030,44
3,1269,36863,3575897986,3575898031,45
3,1269,36864,3575897986,3575898034,48
3,1269,36865,3575897986,3575898034,48
3,1269,36866,3575897986,3575898034,48
3,1269,36867,3575897986,3575898035,49
3,1270,36868,3575898052,3575898052,0
3,1270,36869,3575898052,3575898052,0
3,1270,36870,3575898052,3575898052,0
3,1270,36871,3575898052,3575898052,0
3,1270,36872,3575898052,3575898052,0
3,1270,36873,3575898052,3575898052,0
3,1270,36874,3575898052,3575898052,0
3,1270,36875,3575898052,3575898052,0
3,1270,36876,3575898052,3575898052,0
3,1270,36877,3575898052,3575898052,0
3,1270,36878,3575898052,3575898052,0
3,1270,36879,3575898052,3575898052,0
3,1270,36880,3575898052,3575898052,0
3,1270,36881,3575898052,3575898052,0
3,1270,36882,3575898052,3575898054,2
3,1270,36883,3575898052,3575898054,2
3,1270,36884,3575898052,3575898057,5
3,1270,36885,3575898052,3575898058,6
3,1270,36886,3575898052,3575898060,8
3,1270,36887,3575898052,3575898064,12
3,1270,36888,3575898052,3575898065,13
3,1270,36889,3575898052,3575898065,13
3,1270,36890,3575898052,3575898066,14
3,1270,36891,3575898052,3575898067,15
3,1270,36892,3575898052,3575898069,17
3,1270,36893,3575898052,3575898070,18
3,1270,36894,3575898052,3575898072,20
3,1270,36895,3575898052,3575898078,26
3,1270,36896,3575898052,3575898081,29
3,1270,36897,3575898052,3575898081,29
3,1270,36898,3575898052,3575898082,30
3,1270,36899,3575898052,3575898085,33
3,1270,36900,3575898052,3575898086,34
3,1270,36901,3575898052,3575898087,35
3,1270,36902,3575898052,3575898087,35
3,1270,36903,3575898052,3575898089,37
3,1270,36904,3575898052,3575898091,39
3,1270,36905,3575898052,3575898091,39
3,1270,36906,3575898052,3575898094,42
3,1270,36907,3575898052,3575898098,46
3,1270,36908,3575898052,3575898099,47
3,1270,36909,3575898052,3575898099,47
3,1270,36910,3575898052,3575898100,48
3,1270,36911,3575898052,3575898101,49
3,1270,36912,3575898052,3575898101,49
3,1270,36913,3575898052,3575898101,49
3,1271,36914,3575898115,3575898115,0
3,1271,36915,3575898115,3575898115,0
3,1271,36916,3575898115,3575898115,0
3,1271,36917,3575898115,3575898115,0
3,1271,36918,3575898115,3575898115,0
3,1271,36919,3575898115,3575898115,0
3,1271,36920,3575898115,3575898115,0
3,1271,36921,3575898115,3575898115,0
3,1271,36922,3575898115,3575898118,3
3,1271,36923,3575898115,3575898121,6
3,1271,36924,3575898115,3575898121,6
3,1271,36925,3575898115,3575898122,7
3,1271,36926,3575898115,3575898123,8
3,1271,36927,3575898115,3575898124,9
3,1271,36928,3575898115,3575898127,12
3,1271,36929,3575898115,3575898128,13
3,1271,36930,3575898115,3575898129,14
3,1271,36931,3575898115,3575898130,15
3,1271,36932,3575898115,3575898131,16
3,1271,36933,3575898115,3575898134,19
3,1271,36934,3575898115,3575898139,24
3,1271,36935,3575898115,3575898141,26
3,1271,36936,3575898115,3575898142,27
3,1271,36937,3575898115,3575898144,29
3,1271,36938,3575898115,3575898146,31
3,1271,36939,3575898115,3575898147,32
3,1271,36940,3575898115,3575898149,34
3,1271,36941,3575898115,3575898155,40
3,1271,36942,3575898115,3575898158,43
3,1271,36943,3575898115,3575898161,46
3,1271,36944,3575898115,3575898163,48
3,1271,36945,3575898115,3575898164,49
3,1272,36946,3575898178,3575898178,0
3,1272,36947,3575898178,3575898178,0
3,1272,36948,3575898178,3575898178,0
3,1272,36949,3575898178,3575898178,0
3,1272,36950,3575898178,3575898178,0
3,1272,36951,3575898178,3575898178,0
3,1272,36952,3575898178,3575898179,1
3,1272,36953,3575898178,3575898179,1
3,1272,36954,3575898178,3575898179,1
3,1272,36955,3575898178,3575898181,3
3,1272,36956,3575898178,3575898183,5
3,1272,36957,3575898178,3575898184,6
3,1272,36958,3575898178,3575898187,9
3,1272,36959,3575898178,3575898188,10
3,1272,36960,3575898178,3575898191,13
3,1272,36961,3575898178,3575898192,14
3,1272,36962,3575898178,3575898193,15
3,1272,36963,3575898178,3575898194,16
3,1272,36964,3575898178,3575898196,18
3,1272,36965,3575898178,3575898196,18
3,1272,36966,3575898178,3575898197,19
3,1272,36967,3575898178,3575898197,19
3,1272,36968,3575898178,3575898198,20
3,1272,36969,3575898178,3575898198,20
3,1272,36970,3575898178,3575898200,22
3,1272,36971,3575898178,3575898203,25
3,1272,36972,3575898178,3575898203,25
3,1272,36973,3575898178,3575898203,25
3,1272,36974,3575898178,3575898204,26
3,1272,36975,3575898178,3575898210,32
3,1272,36976,3575898178,3575898215,37
3,1272,36977,3575898178,3575898215,37
3,1272,36978,3575898178,3575898216,38
3,1272,36979,3575898178,3575898219,41
3,1272,36980,3575898178,3575898220,42
3,1272,36981,3575898178,3575898222,44
3,1272,36982,3575898178,3575898223,45
3,1272,36983,3575898178,3575898226,48
3,1272,36984,3575898178,3575898228,50
3,1273,36985,3575898243,3575898243,0
3,1273,36986,3575898243,3575898243,0
3,1273,36987,3575898243,3575898243,0
3,1273,36988,3575898243,3575898243,0
3,1273,36989,3575898243,3575898243,0
3,1273,36990,3575898243,3575898243,0
3,1273,36991,3575898243,3575898243,0
3,1273,36992,3575898243,3575898243,0
3,1273,36993,3575898243,3575898243,0
3,1273,36994,3575898243,3575898243,0
3,1273,36995,3575898243,3575898243,0
3,1273,36996,3575898243,3575898243,0
3,1273,36997,3575898243,3575898243,0
3,1273,36998,3575898243,3575898243,0
3,1273,36999,3575898243,3575898244,1
3,1273,37000,3575898243,3575898244,1
3,1273,37001,3575898243,3575898246,3
3,1273,37002,3575898243,3575898246,3
3,1273,37003,3575898243,3575898248,5
3,1273,37004,3575898243,3575898250,7
3,1273,37005,3575898243,3575898250,7
3,1273,37006,3575898243,3575898253,10
3,1273,37007,3575898243,3575898254,11
3,1273,37008,3575898243,3575898254,11
3,