t_id, iteration_count, request_count, request_start_time, request_end_time, request_processing_time
3,268,1,3578692023,3578692066,43
3,272,2,3578692226,3578692266,40
3,276,3,3578692429,3578692466,37
3,280,4,3578692631,3578692665,34
3,280,5,3578692631,3578692669,38
3,281,6,3578692682,3578692721,39
3,284,7,3578692834,3578692865,31
3,284,8,3578692834,3578692869,35
3,285,9,3578692885,3578692921,36
3,288,10,3578693036,3578693064,28
3,288,11,3578693036,3578693069,33
3,288,12,3578693036,3578693075,39
3,289,13,3578693087,3578693121,34
3,291,14,3578693188,3578693227,39
3,292,15,3578693239,3578693265,26
3,292,16,3578693239,3578693269,30
3,292,17,3578693239,3578693275,36
3,293,18,3578693290,3578693321,31
3,294,19,3578693341,3578693380,39
3,295,20,3578693391,3578693427,36
3,296,21,3578693442,3578693465,23
3,296,22,3578693442,3578693469,27
3,296,23,3578693442,3578693475,33
3,297,24,3578693492,3578693519,27
3,298,25,3578693543,3578693580,37
3,299,26,3578693594,3578693628,34
3,300,27,3578693644,3578693663,19
3,300,28,3578693644,3578693668,24
3,300,29,3578693644,3578693675,31
3,301,30,3578693695,3578693720,25
3,302,31,3578693746,3578693781,35
3,302,32,3578693746,3578693784,38
3,303,33,3578693797,3578693828,31
3,304,34,3578693848,3578693864,16
3,304,35,3578693848,3578693869,21
3,304,36,3578693848,3578693875,27
3,305,37,3578693898,3578693919,21
3,306,38,3578693949,3578693981,32
3,306,39,3578693949,3578693984,35
3,306,40,3578693949,3578693987,38
3,308,41,3578694051,3578694064,13
3,308,42,3578694051,3578694069,18
3,308,43,3578694051,3578694075,24
3,309,44,3578694101,3578694120,19
3,309,45,3578694101,3578694138,37
3,310,46,3578694152,3578694182,30
3,310,47,3578694152,3578694184,32
3,310,48,3578694152,3578694187,35
3,312,49,3578694253,3578694264,11
3,312,50,3578694253,3578694269,16
3,312,51,3578694253,3578694275,22
3,313,52,3578694304,3578694320,16
3,313,53,3578694304,3578694339,35
3,314,54,3578694355,3578694383,28
3,314,55,3578694355,3578694384,29
3,314,56,3578694355,3578694387,32
3,314,57,3578694355,3578694392,37
3,315,58,3578694405,3578694429,24
3,315,59,3578694405,3578694442,37
3,316,60,3578694456,3578694464,8
3,316,61,3578694456,3578694469,13
3,316,62,3578694456,3578694475,19
3,317,63,3578694507,3578694518,11
3,317,64,3578694507,3578694538,31
3,318,65,3578694558,3578694582,24
3,318,66,3578694558,3578694583,25
3,318,67,3578694558,3578694586,28
3,318,68,3578694558,3578694591,33
3,319,69,3578694609,3578694628,19
3,319,70,3578694609,3578694642,33
3,320,71,3578694659,3578694662,3
3,320,72,3578694659,3578694668,9
3,320,73,3578694659,3578694675,16
3,320,74,3578694659,3578694696,37
3,321,75,3578694710,3578694719,9
3,321,76,3578694710,3578694738,28
3,321,77,3578694710,3578694747,37
3,322,78,3578694761,3578694782,21
3,322,79,3578694761,3578694783,22
3,322,80,3578694761,3578694786,25
3,322,81,3578694761,3578694791,30
3,323,82,3578694812,3578694828,16
3,323,83,3578694812,3578694841,29
3,324,84,3578694863,3578694864,1
3,324,85,3578694863,3578694869,6
3,324,86,3578694863,3578694875,12
3,324,87,3578694863,3578694896,33
3,324,88,3578694863,3578694899,36
3,325,89,3578694914,3578694920,6
3,325,90,3578694914,3578694938,24
3,325,91,3578694914,3578694947,33
3,326,92,3578694965,3578694982,17
3,326,93,3578694965,3578694983,18
3,326,94,3578694965,3578694985,20
3,326,95,3578694965,3578694991,26
3,327,96,3578695016,3578695028,12
3,327,97,3578695016,3578695042,26
3,327,98,3578695016,3578695064,48
3,328,99,3578695067,3578695069,2
3,328,100,3578695067,3578695076,9
3,328,101,3578695067,3578695096,29
3,328,102,3578695067,3578695098,31
3,328,103,3578695067,3578695102,35
3,329,104,3578695117,3578695119,2
3,329,105,3578695117,3578695138,21
3,329,106,3578695117,3578695146,29
3,329,107,3578695117,3578695152,35
3,330,108,3578695168,3578695181,13
3,330,109,3578695168,3578695183,15
3,330,110,3578695168,3578695186,18
3,330,111,3578695168,3578695191,23
3,331,112,3578695219,3578695228,9
3,331,113,3578695219,3578695241,22
3,331,114,3578695219,3578695254,35
3,331,115,3578695219,3578695263,44
3,331,116,3578695219,3578695269,50
3,332,117,3578695270,3578695275,5
3,332,118,3578695270,3578695296,26
3,332,119,3578695270,3578695299,29
3,332,120,3578695270,3578695301,31
3,332,121,3578695270,3578695320,50
3,333,122,3578695321,3578695339,18
3,333,123,3578695321,3578695347,26
3,333,124,3578695321,3578695352,31
3,334,125,3578695372,3578695381,9
3,334,126,3578695372,3578695383,11
3,334,127,3578695372,3578695386,14
3,334,128,3578695372,3578695391,19
3,334,129,3578695372,3578695405,33
3,335,130,3578695423,3578695428,5
3,335,131,3578695423,3578695442,19
3,335,132,3578695423,3578695454,31
3,335,133,3578695423,3578695463,40
3,335,134,3578695423,3578695469,46
3,336,135,3578695474,3578695475,1
3,336,136,3578695474,3578695495,21
3,336,137,3578695474,3578695497,23
3,336,138,3578695474,3578695501,27
3,336,139,3578695474,3578695518,44
3,337,140,3578695525,3578695538,13
3,337,141,3578695525,3578695546,21
3,337,142,3578695525,3578695551,26
3,338,143,3578695576,3578695581,5
3,338,144,3578695576,3578695583,7
3,338,145,3578695576,3578695585,9
3,338,146,3578695576,3578695591,15
3,338,147,3578695576,3578695605,29
3,339,148,3578695627,3578695627,0
3,339,149,3578695627,3578695641,14
3,339,150,3578695627,3578695653,26
3,339,151,3578695627,3578695663,36
3,339,152,3578695627,3578695668,41
3,339,153,3578695627,3578695674,47
3,340,154,3578695678,3578695695,17
3,340,155,3578695678,3578695697,19
3,340,156,3578695678,3578695700,22
3,340,157,3578695678,3578695719,41
3,341,158,3578695728,3578695738,10
3,341,159,3578695728,3578695746,18
3,341,160,3578695728,3578695751,23
3,342,161,3578695779,3578695781,2
3,342,162,3578695779,3578695784,5
3,342,163,3578695779,3578695786,7
3,342,164,3578695779,3578695791,12
3,342,165,3578695779,3578695805,26
3,342,166,3578695779,3578695827,48
3,343,167,3578695830,3578695841,11
3,343,168,3578695830,3578695853,23
3,343,169,3578695830,3578695864,34
3,343,170,3578695830,3578695868,38
3,343,171,3578695830,3578695874,44
3,344,172,3578695881,3578695895,14
3,344,173,3578695881,3578695898,17
3,344,174,3578695881,3578695901,20
3,344,175,3578695881,3578695919,38
3,345,176,3578695931,3578695938,7
3,345,177,3578695931,3578695946,15
3,345,178,3578695931,3578695952,21
3,345,179,3578695931,3578695980,49
3,346,180,3578695982,3578695984,2
3,346,181,3578695982,3578695986,4
3,346,182,3578695982,3578695991,9
3,346,183,3578695982,3578696027,45
3,347,184,3578696033,3578696041,8
3,347,185,3578696033,3578696054,21
3,347,186,3578696033,3578696064,31
3,347,187,3578696033,3578696068,35
3,347,188,3578696033,3578696074,41
3,348,189,3578696083,3578696095,12
3,348,190,3578696083,3578696097,14
3,348,191,3578696083,3578696100,17
3,348,192,3578696083,3578696118,35
3,349,193,3578696134,3578696139,5
3,349,194,3578696134,3578696147,13
3,349,195,3578696134,3578696152,18
3,349,196,3578696134,3578696165,31
3,349,197,3578696134,3578696181,47
3,349,198,3578696134,3578696184,50
3,350,199,3578696185,3578696186,1
3,350,200,3578696185,3578696191,6
3,350,201,3578696185,3578696216,31
3,350,202,3578696185,3578696227,42
3,351,203,3578696236,3578696241,5
3,351,204,3578696236,3578696255,19
3,351,205,3578696236,3578696268,32
3,351,206,3578696236,3578696274,38
3,352,207,3578696287,3578696295,8
3,352,208,3578696287,3578696298,11
3,352,209,3578696287,3578696300,13
3,352,210,3578696287,3578696319,32
3,353,211,3578696338,3578696339,1
3,353,212,3578696338,3578696347,9
3,353,213,3578696338,3578696352,14
3,353,214,3578696338,3578696365,27
3,353,215,3578696338,3578696382,44
3,353,216,3578696338,3578696384,46
3,353,217,3578696338,3578696386,48
3,354,218,3578696389,3578696391,2
3,354,219,3578696389,3578696405,16
3,354,220,3578696389,3578696416,27
3,354,221,3578696389,3578696427,38
3,355,222,3578696440,3578696441,1
3,355,223,3578696440,3578696455,15
3,355,224,3578696440,3578696464,24
3,355,225,3578696440,3578696469,29
3,355,226,3578696440,3578696475,35
3,356,227,3578696491,3578696494,3
3,356,228,3578696491,3578696497,6
3,356,229,3578696491,3578696499,8
3,356,230,3578696491,3578696519,28
3,356,231,3578696491,3578696538,47
3,357,232,3578696542,3578696546,4
3,357,233,3578696542,3578696551,9
3,357,234,3578696542,3578696564,22
3,357,235,3578696542,3578696570,28
3,357,236,3578696542,3578696581,39
3,357,237,3578696542,3578696583,41
3,357,238,3578696542,3578696585,43
3,357,239,3578696542,3578696590,48
3,358,240,3578696593,3578696605,12
3,358,241,3578696593,3578696615,22
3,358,242,3578696593,3578696626,33
3,358,243,3578696593,3578696641,48
3,359,244,3578696644,3578696654,10
3,359,245,3578696644,3578696668,24
3,359,246,3578696644,3578696670,26
3,359,247,3578696644,3578696674,30
3,359,248,3578696644,3578696694,50
3,360,249,3578696695,3578696698,3
3,360,250,3578696695,3578696700,5
3,360,251,3578696695,3578696719,24
3,360,252,3578696695,3578696738,43
3,361,253,3578696746,3578696746,0
3,361,254,3578696746,3578696751,5
3,361,255,3578696746,3578696764,18
3,361,256,3578696746,3578696770,24
3,361,257,3578696746,3578696780,34
3,361,258,3578696746,3578696783,37
3,361,259,3578696746,3578696786,40
3,361,260,3578696746,3578696790,44
3,362,261,3578696797,3578696805,8
3,362,262,3578696797,3578696816,19
3,362,263,3578696797,3578696841,44
3,363,264,3578696848,3578696854,6
3,363,265,3578696848,3578696864,16
3,363,266,3578696848,3578696868,20
3,363,267,3578696848,3578696870,22
3,363,268,3578696848,3578696874,26
3,363,269,3578696848,3578696874,26
3,363,270,3578696848,3578696894,46
3,363,271,3578696848,3578696898,50
3,364,272,3578696899,3578696901,2
3,364,273,3578696899,3578696919,20
3,364,274,3578696899,3578696938,39
3,364,275,3578696899,3578696946,47
3,365,276,3578696950,3578696951,1
3,365,277,3578696950,3578696965,15
3,365,278,3578696950,3578696970,20
3,365,279,3578696950,3578696975,25
3,365,280,3578696950,3578696981,31
3,365,281,3578696950,3578696983,33
3,365,282,3578696950,3578696986,36
3,365,283,3578696950,3578696990,40
3,366,284,3578697001,3578697005,4
3,366,285,3578697001,3578697015,14
3,366,286,3578697001,3578697041,40
3,367,287,3578697052,3578697055,3
3,367,288,3578697052,3578697068,16
3,367,289,3578697052,3578697070,18
3,367,290,3578697052,3578697074,22
3,367,291,3578697052,3578697074,22
3,367,292,3578697052,3578697095,43
3,367,293,3578697052,3578697098,46
3,367,294,3578697052,3578697102,50
3,368,295,3578697103,3578697119,16
3,368,296,3578697103,3578697137,34
3,368,297,3578697103,3578697146,43
3,368,298,3578697103,3578697151,48
3,369,299,3578697154,3578697166,12
3,369,300,3578697154,3578697170,16
3,369,301,3578697154,3578697175,21
3,369,302,3578697154,3578697180,26
3,369,303,3578697154,3578697184,30
3,369,304,3578697154,3578697185,31
3,369,305,3578697154,3578697191,37
3,370,306,3578697205,3578697205,0
3,370,307,3578697205,3578697216,11
3,370,308,3578697205,3578697226,21
3,370,309,3578697205,3578697242,37
3,370,310,3578697205,3578697254,49
3,371,311,3578697256,3578697264,8
3,371,312,3578697256,3578697268,12
3,371,313,3578697256,3578697270,14
3,371,314,3578697256,3578697274,18
3,371,315,3578697256,3578697274,18
3,371,316,3578697256,3578697295,39
3,371,317,3578697256,3578697298,42
3,371,318,3578697256,3578697302,46
3,372,319,3578697307,3578697319,12
3,372,320,3578697307,3578697338,31
3,372,321,3578697307,3578697346,39
3,372,322,3578697307,3578697351,44
3,373,323,3578697358,3578697366,8
3,373,324,3578697358,3578697370,12
3,373,325,3578697358,3578697375,17
3,373,326,3578697358,3578697381,23
3,373,327,3578697358,3578697384,26
3,373,328,3578697358,3578697386,28
3,373,329,3578697358,3578697391,33
3,373,330,3578697358,3578697405,47
3,374,331,3578697409,3578697415,6
3,374,332,3578697409,3578697426,17
3,374,333,3578697409,3578697442,33
3,374,334,3578697409,3578697454,45
3,375,335,3578697460,3578697469,9
3,375,336,3578697460,3578697471,11
3,375,337,3578697460,3578697474,14
3,375,338,3578697460,3578697474,14
3,375,339,3578697460,3578697495,35
3,375,340,3578697460,3578697497,37
3,375,341,3578697460,3578697502,42
3,376,342,3578697511,3578697518,7
3,376,343,3578697511,3578697536,25
3,376,344,3578697511,3578697545,34
3,376,345,3578697511,3578697550,39
3,377,346,3578697561,3578697565,4
3,377,347,3578697561,3578697569,8
3,377,348,3578697561,3578697574,13
3,377,349,3578697561,3578697579,18
3,377,350,3578697561,3578697583,22
3,377,351,3578697561,3578697585,24
3,377,352,3578697561,3578697590,29
3,377,353,3578697561,3578697604,43
3,378,354,3578697613,3578697615,2
3,378,355,3578697613,3578697626,13
3,378,356,3578697613,3578697632,19
3,378,357,3578697613,3578697642,29
3,378,358,3578697613,3578697654,41
3,379,359,3578697664,3578697664,0
3,379,360,3578697664,3578697668,4
3,379,361,3578697664,3578697669,5
3,379,362,3578697664,3578697674,10
3,379,363,3578697664,3578697674,10
3,379,364,3578697664,3578697695,31
3,379,365,3578697664,3578697697,33
3,379,366,3578697664,3578697702,38
3,380,367,3578697715,3578697718,3
3,380,368,3578697715,3578697736,21
3,380,369,3578697715,3578697745,30
3,380,370,3578697715,3578697750,35
3,381,371,3578697766,3578697766,0
3,381,372,3578697766,3578697769,3
3,381,373,3578697766,3578697774,8
3,381,374,3578697766,3578697780,14
3,381,375,3578697766,3578697783,17
3,381,376,3578697766,3578697786,20
3,381,377,3578697766,3578697790,24
3,381,378,3578697766,3578697804,38
3,381,379,3578697766,3578697816,50
3,382,380,3578697817,3578697826,9
3,382,381,3578697817,3578697832,15
3,382,382,3578697817,3578697836,19
3,382,383,3578697817,3578697841,24
3,382,384,3578697817,3578697853,36
3,383,385,3578697868,3578697868,0
3,383,386,3578697868,3578697869,1
3,383,387,3578697868,3578697874,6
3,383,388,3578697868,3578697874,6
3,383,389,3578697868,3578697887,19
3,383,390,3578697868,3578697895,27
3,383,391,3578697868,3578697898,30
3,383,392,3578697868,3578697902,34
3,384,393,3578697919,3578697919,0
3,384,394,3578697919,3578697937,18
3,384,395,3578697919,3578697938,19
3,384,396,3578697919,3578697944,25
3,384,397,3578697919,3578697951,32
3,384,398,3578697919,3578697965,46
3,384,399,3578697919,3578697969,50
3,385,400,3578697970,3578697974,4
3,385,401,3578697970,3578697980,10
3,385,402,3578697970,3578697983,13
3,385,403,3578697970,3578697986,16
3,385,404,3578697970,3578697990,20
3,385,405,3578697970,3578698016,46
3,386,406,3578698021,3578698026,5
3,386,407,3578698021,3578698033,12
3,386,408,3578698021,3578698036,15
3,386,409,3578698021,3578698041,20
3,386,410,3578698021,3578698053,32
3,386,411,3578698021,3578698064,43
3,386,412,3578698021,3578698068,47
3,386,413,3578698021,3578698070,49
3,387,414,3578698072,3578698074,2
3,387,415,3578698072,3578698074,2
3,387,416,3578698072,3578698087,15
3,387,417,3578698072,3578698095,23
3,387,418,3578698072,3578698098,26
3,387,419,3578698072,3578698102,30
3,387,420,3578698072,3578698118,46
3,388,421,3578698123,3578698137,14
3,388,422,3578698123,3578698138,15
3,388,423,3578698123,3578698140,17
3,388,424,3578698123,3578698145,22
3,388,425,3578698123,3578698151,28
3,388,426,3578698123,3578698165,42
3,388,427,3578698123,3578698170,47
3,389,428,3578698174,3578698174,0
3,389,429,3578698174,3578698180,6
3,389,430,3578698174,3578698183,9
3,389,431,3578698174,3578698187,13
3,389,432,3578698174,3578698191,17
3,389,433,3578698174,3578698216,42
3,390,434,3578698225,3578698226,1
3,390,435,3578698225,3578698233,8
3,390,436,3578698225,3578698236,11
3,390,437,3578698225,3578698241,16
3,390,438,3578698225,3578698241,16
3,390,439,3578698225,3578698253,28
3,390,440,3578698225,3578698268,43
3,390,441,3578698225,3578698274,49
3,390,442,3578698225,3578698275,50
3,391,443,3578698276,3578698287,11
3,391,444,3578698276,3578698295,19
3,391,445,3578698276,3578698298,22
3,391,446,3578698276,3578698302,26
3,391,447,3578698276,3578698318,42
3,392,448,3578698327,3578698337,10
3,392,449,3578698327,3578698338,11
3,392,450,3578698327,3578698340,13
3,392,451,3578698327,3578698345,18
3,392,452,3578698327,3578698351,24
3,392,453,3578698327,3578698366,39
3,392,454,3578698327,3578698371,44
3,392,455,3578698327,3578698374,47
3,393,456,3578698379,3578698381,2
3,393,457,3578698379,3578698383,4
3,393,458,3578698379,3578698386,7
3,393,459,3578698379,3578698391,12
3,393,460,3578698379,3578698393,14
3,393,461,3578698379,3578698404,25
3,393,462,3578698379,3578698415,36
3,393,463,3578698379,3578698426,47
3,394,464,3578698430,3578698433,3
3,394,465,3578698430,3578698436,6
3,394,466,3578698430,3578698441,11
3,394,467,3578698430,3578698442,12
3,394,468,3578698430,3578698453,23
3,394,469,3578698430,3578698465,35
3,394,470,3578698430,3578698469,39
3,394,471,3578698430,3578698474,44
3,394,472,3578698430,3578698474,44
3,395,473,3578698481,3578698486,5
3,395,474,3578698481,3578698491,10
3,395,475,3578698481,3578698494,13
3,395,476,3578698481,3578698496,15
3,395,477,3578698481,3578698501,20
3,395,478,3578698481,3578698519,38
3,396,479,3578698532,3578698536,4
3,396,480,3578698532,3578698536,4
3,396,481,3578698532,3578698539,7
3,396,482,3578698532,3578698544,12
3,396,483,3578698532,3578698550,18
3,396,484,3578698532,3578698565,33
3,396,485,3578698532,3578698570,38
3,396,486,3578698532,3578698573,41
3,396,487,3578698532,3578698580,48
3,397,488,3578698583,3578698583,0
3,397,489,3578698583,3578698586,3
3,397,490,3578698583,3578698590,7
3,397,491,3578698583,3578698591,8
3,397,492,3578698583,3578698603,20
3,397,493,3578698583,3578698615,32
3,397,494,3578698583,3578698625,42
3,397,495,3578698583,3578698633,50
3,398,496,3578698634,3578698636,2
3,398,497,3578698634,3578698640,6
3,398,498,3578698634,3578698641,7
3,398,499,3578698634,3578698652,18
3,398,500,3578698634,3578698668,34
3,398,501,3578698634,3578698669,35
3,398,502,3578698634,3578698674,40
3,398,503,3578698634,3578698674,40
3,399,504,3578698685,3578698687,2
3,399,505,3578698685,3578698690,5
3,399,506,3578698685,3578698694,9
3,399,507,3578698685,3578698698,13
3,399,508,3578698685,3578698702,17
3,399,509,3578698685,3578698718,33
3,400,510,3578698736,3578698736,0
3,400,511,3578698736,3578698737,1
3,400,512,3578698736,3578698738,2
3,400,513,3578698736,3578698744,8
3,400,514,3578698736,3578698750,14
3,400,515,3578698736,3578698765,29
3,400,516,3578698736,3578698770,34
3,400,517,3578698736,3578698774,38
3,400,518,3578698736,3578698780,44
3,400,519,3578698736,3578698782,46
3,400,520,3578698736,3578698786,50
3,401,521,3578698787,3578698790,3
3,401,522,3578698787,3578698791,4
3,401,523,3578698787,3578698803,16
3,401,524,3578698787,3578698815,28
3,401,525,3578698787,3578698825,38
3,401,526,3578698787,3578698833,46
3,401,527,3578698787,3578698836,49
3,402,528,3578698838,3578698840,2
3,402,529,3578698838,3578698841,3
3,402,530,3578698838,3578698848,10
3,402,531,3578698838,3578698852,14
3,402,532,3578698838,3578698864,26
3,402,533,3578698838,3578698868,30
3,402,534,3578698838,3578698869,31
3,402,535,3578698838,3578698874,36
3,402,536,3578698838,3578698874,36
3,402,537,3578698838,3578698887,49
3,403,538,3578698889,3578698891,2
3,403,539,3578698889,3578698894,5
3,403,540,3578698889,3578698899,10
3,403,541,3578698889,3578698902,13
3,403,542,3578698889,3578698919,30
3,403,543,3578698889,3578698936,47
3,403,544,3578698889,3578698938,49
3,403,545,3578698889,3578698938,49
3,404,546,3578698940,3578698945,5
3,404,547,3578698940,3578698951,11
3,404,548,3578698940,3578698965,25
3,404,549,3578698940,3578698970,30
3,404,550,3578698940,3578698974,34
3,404,551,3578698940,3578698981,41
3,404,552,3578698940,3578698982,42
3,404,553,3578698940,3578698986,46
3,405,554,3578698991,3578698991,0
3,405,555,3578698991,3578698991,0
3,405,556,3578698991,3578699003,12
3,405,557,3578698991,3578699015,24
3,405,558,3578698991,3578699026,35
3,405,559,3578698991,3578699032,41
3,405,560,3578698991,3578699035,44
3,405,561,3578698991,3578699040,49
3,405,562,3578698991,3578699041,50
3,406,563,3578699042,3578699048,6
3,406,564,3578699042,3578699052,10
3,406,565,3578699042,3578699064,22
3,406,566,3578699042,3578699068,26
3,406,567,3578699042,3578699069,27
3,406,568,3578699042,3578699074,32
3,406,569,3578699042,3578699074,32
3,406,570,3578699042,3578699087,45
3,406,571,3578699042,3578699090,48
3,407,572,3578699093,3578699094,1
3,407,573,3578699093,3578699098,5
3,407,574,3578699093,3578699102,9
3,407,575,3578699093,3578699118,25
3,407,576,3578699093,3578699137,44
3,407,577,3578699093,3578699138,45
3,407,578,3578699093,3578699139,46
3,408,579,3578699144,3578699144,0
3,408,580,3578699144,3578699151,7
3,408,581,3578699144,3578699151,7
3,408,582,3578699144,3578699165,21
3,408,583,3578699144,3578699170,26
3,408,584,3578699144,3578699174,30
3,408,585,3578699144,3578699181,37
3,408,586,3578699144,3578699182,38
3,408,587,3578699144,3578699186,42
3,408,588,3578699144,3578699191,47
3,408,589,3578699144,3578699192,48
3,409,590,3578699195,3578699204,9
3,409,591,3578699195,3578699215,20
3,409,592,3578699195,3578699226,31
3,409,593,3578699195,3578699232,37
3,409,594,3578699195,3578699235,40
3,409,595,3578699195,3578699240,45
3,409,596,3578699195,3578699241,46
3,410,597,3578699246,3578699247,1
3,410,598,3578699246,3578699252,6
3,410,599,3578699246,3578699253,7
3,410,600,3578699246,3578699264,18
3,410,601,3578699246,3578699268,22
3,410,602,3578699246,3578699270,24
3,410,603,3578699246,3578699274,28
3,410,604,3578699246,3578699274,28
3,410,605,3578699246,3578699287,41
3,410,606,3578699246,3578699290,44
3,410,607,3578699246,3578699294,48
3,411,608,3578699297,3578699299,2
3,411,609,3578699297,3578699302,5
3,411,610,3578699297,3578699319,22
3,411,611,3578699297,3578699336,39
3,411,612,3578699297,3578699338,41
3,411,613,3578699297,3578699339,42
3,411,614,3578699297,3578699345,48
3,412,615,3578699348,3578699351,3
3,412,616,3578699348,3578699351,3
3,412,617,3578699348,3578699365,17
3,412,618,3578699348,3578699370,22
3,412,619,3578699348,3578699374,26
3,412,620,3578699348,3578699381,33
3,412,621,3578699348,3578699382,34
3,412,622,3578699348,3578699385,37
3,412,623,3578699348,3578699391,43
3,412,624,3578699348,3578699392,44
3,413,625,3578699399,3578699404,5
3,413,626,3578699399,3578699415,16
3,413,627,3578699399,3578699426,27
3,413,628,3578699399,3578699433,34
3,413,629,3578699399,3578699435,36
3,413,630,3578699399,3578699440,41
3,413,631,3578699399,3578699442,43
3,413,632,3578699399,3578699448,49
3,414,633,3578699451,3578699452,1
3,414,634,3578699451,3578699453,2
3,414,635,3578699451,3578699464,13
3,414,636,3578699451,3578699469,18
3,414,637,3578699451,3578699470,19
3,414,638,3578699451,3578699474,23
3,414,639,3578699451,3578699474,23
3,414,640,3578699451,3578699490,39
3,414,641,3578699451,3578699495,44
3,414,642,3578699451,3578699499,48
3,415,643,3578699502,3578699502,0
3,415,644,3578699502,3578699519,17
3,415,645,3578699502,3578699536,34
3,415,646,3578699502,3578699537,35
3,415,647,3578699502,3578699539,37
3,415,648,3578699502,3578699545,43
3,415,649,3578699502,3578699550,48
3,415,650,3578699502,3578699551,49
3,416,651,3578699553,3578699564,11
3,416,652,3578699553,3578699569,16
3,416,653,3578699553,3578699573,20
3,416,654,3578699553,3578699581,28
3,416,655,3578699553,3578699582,29
3,416,656,3578699553,3578699585,32
3,416,657,3578699553,3578699590,37
3,416,658,3578699553,3578699591,38
3,417,659,3578699604,3578699604,0
3,417,660,3578699604,3578699614,10
3,417,661,3578699604,3578699625,21
3,417,662,3578699604,3578699631,27
3,417,663,3578699604,3578699635,31
3,417,664,3578699604,3578699638,34
3,417,665,3578699604,3578699640,36
3,417,666,3578699604,3578699646,42
3,417,667,3578699604,3578699651,47
3,417,668,3578699604,3578699652,48
3,418,669,3578699655,3578699663,8
3,418,670,3578699655,3578699668,13
3,418,671,3578699655,3578699674,19
3,418,672,3578699655,3578699674,19
3,418,673,3578699655,3578699690,35
3,418,674,3578699655,3578699695,40
3,418,675,3578699655,3578699699,44
3,418,676,3578699655,3578699703,48
3,419,677,3578699706,3578699719,13
3,419,678,3578699706,3578699736,30
3,419,679,3578699706,3578699737,31
3,419,680,3578699706,3578699739,33
3,419,681,3578699706,3578699745,39
3,419,682,3578699706,3578699750,44
3,419,683,3578699706,3578699751,45
3,420,684,3578699757,3578699764,7
3,420,685,3578699757,3578699769,12
3,420,686,3578699757,3578699774,17
3,420,687,3578699757,3578699781,24
3,420,688,3578699757,3578699783,26
3,420,689,3578699757,3578699786,29
3,420,690,3578699757,3578699790,33
3,420,691,3578699757,3578699791,34
3,420,692,3578699757,3578699803,46
3,421,693,3578699808,3578699814,6
3,421,694,3578699808,3578699826,18
3,421,695,3578699808,3578699831,23
3,421,696,3578699808,3578699835,27
3,421,697,3578699808,3578699839,31
3,421,698,3578699808,3578699841,33
3,421,699,3578699808,3578699847,39
3,421,700,3578699808,3578699851,43
3,421,701,3578699808,3578699852,44
3,422,702,3578699860,3578699863,3
3,422,703,3578699860,3578699868,8
3,422,704,3578699860,3578699874,14
3,422,705,3578699860,3578699874,14
3,422,706,3578699860,3578699887,27
3,422,707,3578699860,3578699895,35
3,422,708,3578699860,3578699899,39
3,422,709,3578699860,3578699902,42
3,423,710,3578699912,3578699919,7
3,423,711,3578699912,3578699936,24
3,423,712,3578699912,3578699938,26
3,423,713,3578699912,3578699939,27
3,423,714,3578699912,3578699945,33
3,423,715,3578699912,3578699951,39
3,423,716,3578699912,3578699951,39
3,424,717,3578699963,3578699963,0
3,424,718,3578699963,3578699969,6
3,424,719,3578699963,3578699974,11
3,424,720,3578699963,3578699981,18
3,424,721,3578699963,3578699982,19
3,424,722,3578699963,3578699986,23
3,424,723,3578699963,3578699990,27
3,424,724,3578699963,3578699991,28
3,424,725,3578699963,3578700003,40
3,425,726,3578700014,3578700014,0
3,425,727,3578700014,3578700026,12
3,425,728,3578700014,3578700031,17
3,425,729,3578700014,3578700035,21
3,425,730,3578700014,3578700040,26
3,425,731,3578700014,3578700040,26
3,425,732,3578700014,3578700046,32
3,425,733,3578700014,3578700051,37
3,425,734,3578700014,3578700052,38
3,425,735,3578700014,3578700063,49
3,426,736,3578700065,3578700068,3
3,426,737,3578700065,3578700069,4
3,426,738,3578700065,3578700074,9
3,426,739,3578700065,3578700074,9
3,426,740,3578700065,3578700088,23
3,426,741,3578700065,3578700096,31
3,426,742,3578700065,3578700099,34
3,426,743,3578700065,3578700103,38
3,427,744,3578700117,3578700119,2
3,427,745,3578700117,3578700136,19
3,427,746,3578700117,3578700138,21
3,427,747,3578700117,3578700138,21
3,427,748,3578700117,3578700145,28
3,427,749,3578700117,3578700151,34
3,427,750,3578700117,3578700151,34
3,427,751,3578700117,3578700164,47
3,428,752,3578700168,3578700169,1
3,428,753,3578700168,3578700174,6
3,428,754,3578700168,3578700181,13
3,428,755,3578700168,3578700182,14
3,428,756,3578700168,3578700186,18
3,428,757,3578700168,3578700191,23
3,428,758,3578700168,3578700191,23
3,428,759,3578700168,3578700205,37
3,428,760,3578700168,3578700215,47
3,429,761,3578700219,3578700226,7
3,429,762,3578700219,3578700231,12
3,429,763,3578700219,3578700236,17
3,429,764,3578700219,3578700240,21
3,429,765,3578700219,3578700241,22
3,429,766,3578700219,3578700246,27
3,429,767,3578700219,3578700251,32
3,429,768,3578700219,3578700252,33
3,429,769,3578700219,3578700263,44
3,429,770,3578700219,3578700264,45
3,429,771,3578700219,3578700268,49
3,430,772,3578700271,3578700271,0
3,430,773,3578700271,3578700274,3
3,430,774,3578700271,3578700274,3
3,430,775,3578700271,3578700288,17
3,430,776,3578700271,3578700296,25
3,430,777,3578700271,3578700299,28
3,430,778,3578700271,3578700302,31
3,430,779,3578700271,3578700319,48
3,431,780,3578700322,3578700336,14
3,431,781,3578700322,3578700337,15
3,431,782,3578700322,3578700339,17
3,431,783,3578700322,3578700345,23
3,431,784,3578700322,3578700351,29
3,431,785,3578700322,3578700351,29
3,431,786,3578700322,3578700364,42
3,431,787,3578700322,3578700367,45
3,431,788,3578700322,3578700369,47
3,432,789,3578700373,3578700374,1
3,432,790,3578700373,3578700380,7
3,432,791,3578700373,3578700382,9
3,432,792,3578700373,3578700386,13
3,432,793,3578700373,3578700391,18
3,432,794,3578700373,3578700392,19
3,432,795,3578700373,3578700404,31
3,432,796,3578700373,3578700415,42
3,433,797,3578700424,3578700426,2
3,433,798,3578700424,3578700432,8
3,433,799,3578700424,3578700440,16
3,433,800,3578700424,3578700441,17
3,433,801,3578700424,3578700446,22
3,433,802,3578700424,3578700452,28
3,433,803,3578700424,3578700452,28
3,433,804,3578700424,3578700463,39
3,433,805,3578700424,3578700465,41
3,433,806,3578700424,3578700469,45
3,433,807,3578700424,3578700471,47
3,433,808,3578700424,3578700474,50
3,434,809,3578700475,3578700475,0
3,434,810,3578700475,3578700487,12
3,434,811,3578700475,3578700496,21
3,434,812,3578700475,3578700498,23
3,434,813,3578700475,3578700502,27
3,434,814,3578700475,3578700519,44
3,435,815,3578700526,3578700535,9
3,435,816,3578700526,3578700537,11
3,435,817,3578700526,3578700537,11
3,435,818,3578700526,3578700544,18
3,435,819,3578700526,3578700550,24
3,435,820,3578700526,3578700550,24
3,435,821,3578700526,3578700563,37
3,435,822,3578700526,3578700565,39
3,435,823,3578700526,3578700568,42
3,435,824,3578700526,3578700573,47
3,436,825,3578700577,3578700580,3
3,436,826,3578700577,3578700582,5
3,436,827,3578700577,3578700585,8
3,436,828,3578700577,3578700590,13
3,436,829,3578700577,3578700591,14
3,436,830,3578700577,3578700603,26
3,436,831,3578700577,3578700614,37
3,436,832,3578700577,3578700625,48
3,437,833,3578700629,3578700631,2
3,437,834,3578700629,3578700639,10
3,437,835,3578700629,3578700641,12
3,437,836,3578700629,3578700645,16
3,437,837,3578700629,3578700651,22
3,437,838,3578700629,3578700652,23
3,437,839,3578700629,3578700663,34
3,437,840,3578700629,3578700663,34
3,437,841,3578700629,3578700668,39
3,437,842,3578700629,3578700668,39
3,437,843,3578700629,3578700669,40
3,437,844,3578700629,3578700674,45
3,437,845,3578700629,3578700674,45
3,438,846,3578700680,3578700688,8
3,438,847,3578700680,3578700696,16
3,438,848,3578700680,3578700697,17
3,438,849,3578700680,3578700702,22
3,438,850,3578700680,3578700718,38
3,439,851,3578700732,3578700736,4
3,439,852,3578700732,3578700737,5
3,439,853,3578700732,3578700737,5
3,439,854,3578700732,3578700745,13
3,439,855,3578700732,3578700750,18
3,439,856,3578700732,3578700750,18
3,439,857,3578700732,3578700763,31
3,439,858,3578700732,3578700765,33
3,439,859,3578700732,3578700768,36
3,439,860,3578700732,3578700770,38
3,439,861,3578700732,3578700774,42
3,439,862,3578700732,3578700779,47
3,440,863,3578700783,3578700783,0
3,440,864,3578700783,3578700785,2
3,440,865,3578700783,3578700790,7
3,440,866,3578700783,3578700790,7
3,440,867,3578700783,3578700803,20
3,440,868,3578700783,3578700813,30
3,440,869,3578700783,3578700821,38
3,440,870,3578700783,3578700825,42
3,440,871,3578700783,3578700831,48
3,441,872,3578700834,3578700839,5
3,441,873,3578700834,3578700841,7
3,441,874,3578700834,3578700846,12
3,441,875,3578700834,3578700852,18
3,441,876,3578700834,3578700852,18
3,441,877,3578700834,3578700863,29
3,441,878,3578700834,3578700864,30
3,441,879,3578700834,3578700868,34
3,441,880,3578700834,3578700868,34
3,441,881,3578700834,3578700869,35
3,441,882,3578700834,3578700874,40
3,441,883,3578700834,3578700875,41
3,442,884,3578700885,3578700889,4
3,442,885,3578700885,3578700896,11
3,442,886,3578700885,3578700897,12
3,442,887,3578700885,3578700901,16
3,442,888,3578700885,3578700918,33
3,443,889,3578700937,3578700937,0
3,443,890,3578700937,3578700938,1
3,443,891,3578700937,3578700939,2
3,443,892,3578700937,3578700945,8
3,443,893,3578700937,3578700950,13
3,443,894,3578700937,3578700951,14
3,443,895,3578700937,3578700964,27
3,443,896,3578700937,3578700965,28
3,443,897,3578700937,3578700968,31
3,443,898,3578700937,3578700970,33
3,443,899,3578700937,3578700974,37
3,443,900,3578700937,3578700979,42
3,443,901,3578700937,3578700982,45
3,443,902,3578700937,3578700986,49
3,444,903,3578700989,3578700990,1
3,444,904,3578700989,3578700990,1
3,444,905,3578700989,3578701003,14
3,444,906,3578700989,3578701015,26
3,444,907,3578700989,3578701020,31
3,444,908,3578700989,3578701026,37
3,444,909,3578700989,3578701032,43
3,445,910,3578701041,3578701041,0
3,445,911,3578701041,3578701041,0
3,445,912,3578701041,3578701046,5
3,445,913,3578701041,3578701052,11
3,445,914,3578701041,3578701052,11
3,445,915,3578701041,3578701063,22
3,445,916,3578701041,3578701064,23
3,445,917,3578701041,3578701068,27
3,445,918,3578701041,3578701068,27
3,445,919,3578701041,3578701069,28
3,445,920,3578701041,3578701073,32
3,445,921,3578701041,3578701074,33
3,445,922,3578701041,3578701088,47
3,446,923,3578701093,3578701097,4
3,446,924,3578701093,3578701098,5
3,446,925,3578701093,3578701102,9
3,446,926,3578701093,3578701118,25
3,446,927,3578701093,3578701137,44
3,446,928,3578701093,3578701138,45
3,446,929,3578701093,3578701140,47
3,447,930,3578701145,3578701145,0
3,447,931,3578701145,3578701150,5
3,447,932,3578701145,3578701151,6
3,447,933,3578701145,3578701164,19
3,447,934,3578701145,3578701165,20
3,447,935,3578701145,3578701168,23
3,447,936,3578701145,3578701170,25
3,447,937,3578701145,3578701174,29
3,447,938,3578701145,3578701179,34
3,447,939,3578701145,3578701182,37
3,447,940,3578701145,3578701186,41
3,447,941,3578701145,3578701191,46
3,447,942,3578701145,3578701192,47
3,448,943,3578701197,3578701204,7
3,448,944,3578701197,3578701215,18
3,448,945,3578701197,3578701221,24
3,448,946,3578701197,3578701226,29
3,448,947,3578701197,3578701232,35
3,448,948,3578701197,3578701241,44
3,448,949,3578701197,3578701242,45
3,448,950,3578701197,3578701246,49
3,449,951,3578701249,3578701252,3
3,449,952,3578701249,3578701252,3
3,449,953,3578701249,3578701263,14
3,449,954,3578701249,3578701264,15
3,449,955,3578701249,3578701268,19
3,449,956,3578701249,3578701268,19
3,449,957,3578701249,3578701270,21
3,449,958,3578701249,3578701274,25
3,449,959,3578701249,3578701275,26
3,449,960,3578701249,3578701288,39
3,449,961,3578701249,3578701297,48
3,449,962,3578701249,3578701298,49
3,450,963,3578701300,3578701301,1
3,450,964,3578701300,3578701318,18
3,450,965,3578701300,3578701327,27
3,450,966,3578701300,3578701337,37
3,450,967,3578701300,3578701338,38
3,450,968,3578701300,3578701339,39
3,450,969,3578701300,3578701345,45
3,451,970,3578701352,3578701352,0
3,451,971,3578701352,3578701352,0
3,451,972,3578701352,3578701364,12
3,451,973,3578701352,3578701365,13
3,451,974,3578701352,3578701369,17
3,451,975,3578701352,3578701370,18
3,451,976,3578701352,3578701374,22
3,451,977,3578701352,3578701377,25
3,451,978,3578701352,3578701379,27
3,451,979,3578701352,3578701382,30
3,451,980,3578701352,3578701386,34
3,451,981,3578701352,3578701391,39
3,451,982,3578701352,3578701392,40
3,452,983,3578701404,3578701404,0
3,452,984,3578701404,3578701415,11
3,452,985,3578701404,3578701420,16
3,452,986,3578701404,3578701426,22
3,452,987,3578701404,3578701433,29
3,452,988,3578701404,3578701441,37
3,452,989,3578701404,3578701441,37
3,452,990,3578701404,3578701446,42
3,452,991,3578701404,3578701452,48
3,452,992,3578701404,3578701452,48
3,453,993,3578701455,3578701463,8
3,453,994,3578701455,3578701464,9
3,453,995,3578701455,3578701468,13
3,453,996,3578701455,3578701469,14
3,453,997,3578701455,3578701471,16
3,453,998,3578701455,3578701473,18
3,453,999,3578701455,3578701475,20
3,453,1000,3578701455,3578701478,23
3,453,1001,3578701455,3578701489,34
3,453,1002,3578701455,3578701497,42
3,453,1003,3578701455,3578701498,43
3,453,1004,3578701455,3578701501,46
3,454,1005,3578701507,3578701519,12
3,454,1006,3578701507,3578701526,19
3,454,1007,3578701507,3578701537,30
3,454,1008,3578701507,3578701537,30
3,454,1009,3578701507,3578701539,32
3,454,1010,3578701507,3578701545,38
3,454,1011,3578701507,3578701550,43
3,454,1012,3578701507,3578701550,43
3,455,1013,3578701559,3578701563,4
3,455,1014,3578701559,3578701564,5
3,455,1015,3578701559,3578701568,9
3,455,1016,3578701559,3578701569,10
3,455,1017,3578701559,3578701573,14
3,455,1018,3578701559,3578701576,17
3,455,1019,3578701559,3578701578,19
3,455,1020,3578701559,3578701582,23
3,455,1021,3578701559,3578701585,26
3,455,1022,3578701559,3578701590,31
3,455,1023,3578701559,3578701591,32
3,455,1024,3578701559,3578701603,44
3,456,1025,3578701611,3578701614,3
3,456,1026,3578701611,3578701620,9
3,456,1027,3578701611,3578701625,14
3,456,1028,3578701611,3578701633,22
3,456,1029,3578701611,3578701640,29
3,456,1030,3578701611,3578701641,30
3,456,1031,3578701611,3578701646,35
3,456,1032,3578701611,3578701650,39
3,456,1033,3578701611,3578701652,41
3,457,1034,3578701662,3578701662,0
3,457,1035,3578701662,3578701663,1
3,457,1036,3578701662,3578701667,5
3,457,1037,3578701662,3578701668,6
3,457,1038,3578701662,3578701669,7
3,457,1039,3578701662,3578701673,11
3,457,1040,3578701662,3578701675,13
3,457,1041,3578701662,3578701678,16
3,457,1042,3578701662,3578701688,26
3,457,1043,3578701662,3578701697,35
3,457,1044,3578701662,3578701698,36
3,457,1045,3578701662,3578701701,39
3,458,1046,3578701714,3578701719,5
3,458,1047,3578701714,3578701726,12
3,458,1048,3578701714,3578701737,23
3,458,1049,3578701714,3578701738,24
3,458,1050,3578701714,3578701739,25
3,458,1051,3578701714,3578701745,31
3,458,1052,3578701714,3578701750,36
3,458,1053,3578701714,3578701750,36
3,458,1054,3578701714,3578701762,48
3,458,1055,3578701714,3578701764,50
3,459,1056,3578701766,3578701768,2
3,459,1057,3578701766,3578701769,3
3,459,1058,3578701766,3578701774,8
3,459,1059,3578701766,3578701776,10
3,459,1060,3578701766,3578701778,12
3,459,1061,3578701766,3578701782,16
3,459,1062,3578701766,3578701786,20
3,459,1063,3578701766,3578701790,24
3,459,1064,3578701766,3578701791,25
3,459,1065,3578701766,3578701803,37
3,459,1066,3578701766,3578701814,48
3,460,1067,3578701817,3578701819,2
3,460,1068,3578701817,3578701825,8
3,460,1069,3578701817,3578701832,15
3,460,1070,3578701817,3578701839,22
3,460,1071,3578701817,3578701840,23
3,460,1072,3578701817,3578701845,28
3,460,1073,3578701817,3578701851,34
3,460,1074,3578701817,3578701851,34
3,460,1075,3578701817,3578701863,46
3,460,1076,3578701817,3578701864,47
3,461,1077,3578701869,3578701869,0
3,461,1078,3578701869,3578701869,0
3,461,1079,3578701869,3578701870,1
3,461,1080,3578701869,3578701873,4
3,461,1081,3578701869,3578701876,7
3,461,1082,3578701869,3578701878,9
3,461,1083,3578701869,3578701897,28
3,461,1084,3578701869,3578701897,28
3,461,1085,3578701869,3578701901,32
3,461,1086,3578701869,3578701918,49
3,462,1087,3578701921,3578701926,5
3,462,1088,3578701921,3578701934,13
3,462,1089,3578701921,3578701938,17
3,462,1090,3578701921,3578701938,17
3,462,1091,3578701921,3578701938,17
3,462,1092,3578701921,3578701945,24
3,462,1093,3578701921,3578701950,29
3,462,1094,3578701921,3578701951,30
3,462,1095,3578701921,3578701964,43
3,462,1096,3578701921,3578701964,43
3,462,1097,3578701921,3578701968,47
3,462,1098,3578701921,3578701969,48
3,463,1099,3578701972,3578701974,2
3,463,1100,3578701972,3578701976,4
3,463,1101,3578701972,3578701978,6
3,463,1102,3578701972,3578701982,10
3,463,1103,3578701972,3578701986,14
3,463,1104,3578701972,3578701990,18
3,463,1105,3578701972,3578701990,18
3,463,1106,3578701972,3578702003,31
3,463,1107,3578701972,3578702015,43
3,463,1108,3578701972,3578702020,48
3,464,1109,3578702024,3578702026,2
3,464,1110,3578702024,3578702032,8
3,464,1111,3578702024,3578702040,16
3,464,1112,3578702024,3578702040,16
3,464,1113,3578702024,3578702046,22
3,464,1114,3578702024,3578702052,28
3,464,1115,3578702024,3578702052,28
3,464,1116,3578702024,3578702063,39
3,464,1117,3578702024,3578702064,40
3,464,1118,3578702024,3578702068,44
3,464,1119,3578702024,3578702068,44
3,464,1120,3578702024,3578702070,46
3,464,1121,3578702024,3578702074,50
3,465,1122,3578702076,3578702076,0
3,465,1123,3578702076,3578702079,3
3,465,1124,3578702076,3578702086,10
3,465,1125,3578702076,3578702097,21
3,465,1126,3578702076,3578702098,22
3,465,1127,3578702076,3578702102,26
3,465,1128,3578702076,3578702118,42
3,465,1129,3578702076,3578702126,50
3,466,1130,3578702127,3578702134,7
3,466,1131,3578702127,3578702138,11
3,466,1132,3578702127,3578702138,11
3,466,1133,3578702127,3578702138,11
3,466,1134,3578702127,3578702145,18
3,466,1135,3578702127,3578702150,23
3,466,1136,3578702127,3578702151,24
3,466,1137,3578702127,3578702164,37
3,466,1138,3578702127,3578702165,38
3,466,1139,3578702127,3578702168,41
3,466,1140,3578702127,3578702169,42
3,466,1141,3578702127,3578702174,47
3,466,1142,3578702127,3578702176,49
3,467,1143,3578702179,3578702179,0
3,467,1144,3578702179,3578702182,3
3,467,1145,3578702179,3578702186,7
3,467,1146,3578702179,3578702191,12
3,467,1147,3578702179,3578702192,13
3,467,1148,3578702179,3578702204,25
3,467,1149,3578702179,3578702216,37
3,467,1150,3578702179,3578702220,41
3,467,1151,3578702179,3578702226,47
3,468,1152,3578702230,3578702233,3
3,468,1153,3578702230,3578702239,9
3,468,1154,3578702230,3578702242,12
3,468,1155,3578702230,3578702246,16
3,468,1156,3578702230,3578702251,21
3,468,1157,3578702230,3578702253,23
3,468,1158,3578702230,3578702263,33
3,468,1159,3578702230,3578702264,34
3,468,1160,3578702230,3578702268,38
3,468,1161,3578702230,3578702268,38
3,468,1162,3578702230,3578702270,40
3,468,1163,3578702230,3578702273,43
3,468,1164,3578702230,3578702275,45
3,468,1165,3578702230,3578702278,48
3,469,1166,3578702282,3578702286,4
3,469,1167,3578702282,3578702289,7
3,469,1168,3578702282,3578702297,15
3,469,1169,3578702282,3578702298,16
3,469,1170,3578702282,3578702302,20
3,469,1171,3578702282,3578702319,37
3,469,1172,3578702282,3578702326,44
3,470,1173,3578702334,3578702334,0
3,470,1174,3578702334,3578702338,4
3,470,1175,3578702334,3578702338,4
3,470,1176,3578702334,3578702338,4
3,470,1177,3578702334,3578702345,11
3,470,1178,3578702334,3578702350,16
3,470,1179,3578702334,3578702351,17
3,470,1180,3578702334,3578702363,29
3,470,1181,3578702334,3578702365,31
3,470,1182,3578702334,3578702369,35
3,470,1183,3578702334,3578702371,37
3,470,1184,3578702334,3578702374,40
3,470,1185,3578702334,3578702376,42
3,470,1186,3578702334,3578702379,45
3,470,1187,3578702334,3578702382,48
3,471,1188,3578702386,3578702386,0
3,471,1189,3578702386,3578702390,4
3,471,1190,3578702386,3578702391,5
3,471,1191,3578702386,3578702392,6
3,471,1192,3578702386,3578702404,18
3,471,1193,3578702386,3578702416,30
3,471,1194,3578702386,3578702420,34
3,471,1195,3578702386,3578702426,40
3,471,1196,3578702386,3578702433,47
3,472,1197,3578702438,3578702439,1
3,472,1198,3578702438,3578702442,4
3,472,1199,3578702438,3578702446,8
3,472,1200,3578702438,3578702451,13
3,472,1201,3578702438,3578702453,15
3,472,1202,3578702438,3578702463,25
3,472,1203,3578702438,3578702465,27
3,472,1204,3578702438,3578702468,30
3,472,1205,3578702438,3578702469,31
3,472,1206,3578702438,3578702470,32
3,472,1207,3578702438,3578702474,36
3,472,1208,3578702438,3578702475,37
3,472,1209,3578702438,3578702478,40
3,472,1210,3578702438,3578702486,48
3,473,1211,3578702489,3578702489,0
3,473,1212,3578702489,3578702496,7
3,473,1213,3578702489,3578702496,7
3,473,1214,3578702489,3578702502,13
3,473,1215,3578702489,3578702519,30
3,473,1216,3578702489,3578702525,36
3,473,1217,3578702489,3578702533,44
3,473,1218,3578702489,3578702536,47
3,473,1219,3578702489,3578702537,48
3,473,1220,3578702489,3578702538,49
3,474,1221,3578702541,3578702545,4
3,474,1222,3578702541,3578702550,9
3,474,1223,3578702541,3578702550,9
3,474,1224,3578702541,3578702563,22
3,474,1225,3578702541,3578702564,23
3,474,1226,3578702541,3578702568,27
3,474,1227,3578702541,3578702569,28
3,474,1228,3578702541,3578702573,32
3,474,1229,3578702541,3578702576,35
3,474,1230,3578702541,3578702578,37
3,474,1231,3578702541,3578702582,41
3,474,1232,3578702541,3578702585,44
3,474,1233,3578702541,3578702590,49
3,474,1234,3578702541,3578702590,49
3,474,1235,3578702541,3578702590,49
3,475,1236,3578702593,3578702603,10
3,475,1237,3578702593,3578702615,22
3,475,1238,3578702593,3578702619,26
3,475,1239,3578702593,3578702625,32
3,475,1240,3578702593,3578702632,39
3,475,1241,3578702593,3578702639,46
3,475,1242,3578702593,3578702640,47
3,476,1243,3578702645,3578702646,1
3,476,1244,3578702645,3578702650,5
3,476,1245,3578702645,3578702653,8
3,476,1246,3578702645,3578702662,17
3,476,1247,3578702645,3578702663,18
3,476,1248,3578702645,3578702667,22
3,476,1249,3578702645,3578702668,23
3,476,1250,3578702645,3578702669,24
3,476,1251,3578702645,3578702674,29
3,476,1252,3578702645,3578702675,30
3,476,1253,3578702645,3578702679,34
3,476,1254,3578702645,3578702686,41
3,476,1255,3578702645,3578702688,43
3,477,1256,3578702697,3578702697,0
3,477,1257,3578702697,3578702697,0
3,477,1258,3578702697,3578702702,5
3,477,1259,3578702697,3578702719,22
3,477,1260,3578702697,3578702725,28
3,477,1261,3578702697,3578702732,35
3,477,1262,3578702697,3578702737,40
3,477,1263,3578702697,3578702737,40
3,477,1264,3578702697,3578702738,41
3,477,1265,3578702697,3578702744,47
3,478,1266,3578702749,3578702750,1
3,478,1267,3578702749,3578702750,1
3,478,1268,3578702749,3578702763,14
3,478,1269,3578702749,3578702764,15
3,478,1270,3578702749,3578702768,19
3,478,1271,3578702749,3578702769,20
3,478,1272,3578702749,3578702774,25
3,478,1273,3578702749,3578702775,26
3,478,1274,3578702749,3578702779,30
3,478,1275,3578702749,3578702782,33
3,478,1276,3578702749,3578702786,37
3,478,1277,3578702749,3578702790,41
3,478,1278,3578702749,3578702790,41
3,478,1279,3578702749,3578702790,41
3,479,1280,3578702801,3578702803,2
3,479,1281,3578702801,3578702815,14
3,479,1282,3578702801,3578702819,18
3,479,1283,3578702801,3578702825,24
3,479,1284,3578702801,3578702833,32
3,479,1285,3578702801,3578702839,38
3,479,1286,3578702801,3578702841,40
3,479,1287,3578702801,3578702846,45
3,479,1288,3578702801,3578702851,50
3,480,1289,3578702853,3578702853,0
3,480,1290,3578702853,3578702862,9
3,480,1291,3578702853,3578702864,11
3,480,1292,3578702853,3578702867,14
3,480,1293,3578702853,3578702868,15
3,480,1294,3578702853,3578702869,16
3,480,1295,3578702853,3578702874,21
3,480,1296,3578702853,3578702875,22
3,480,1297,3578702853,3578702879,26
3,480,1298,3578702853,3578702886,33
3,480,1299,3578702853,3578702888,35
3,480,1300,3578702853,3578702895,42
3,480,1301,3578702853,3578702896,43
3,480,1302,3578702853,3578702898,45
3,480,1303,3578702853,3578702901,48
3,481,1304,3578702904,3578702918,14
3,481,1305,3578702904,3578702925,21
3,481,1306,3578702904,3578702933,29
3,481,1307,3578702904,3578702937,33
3,481,1308,3578702904,3578702937,33
3,481,1309,3578702904,3578702939,35
3,481,1310,3578702904,3578702944,40
3,481,1311,3578702904,3578702946,42
3,481,1312,3578702904,3578702951,47
3,481,1313,3578702904,3578702951,47
3,482,1314,3578702956,3578702964,8
3,482,1315,3578702956,3578702964,8
3,482,1316,3578702956,3578702968,12
3,482,1317,3578702956,3578702969,13
3,482,1318,3578702956,3578702974,18
3,482,1319,3578702956,3578702976,20
3,482,1320,3578702956,3578702978,22
3,482,1321,3578702956,3578702982,26
3,482,1322,3578702956,3578702986,30
3,482,1323,3578702956,3578702990,34
3,482,1324,3578702956,3578702990,34
3,482,1325,3578702956,3578702991,35
3,482,1326,3578702956,3578703003,47
3,483,1327,3578703008,3578703015,7
3,483,1328,3578703008,3578703019,11
3,483,1329,3578703008,3578703026,18
3,483,1330,3578703008,3578703033,25
3,483,1331,3578703008,3578703040,32
3,483,1332,3578703008,3578703041,33
3,483,1333,3578703008,3578703046,38
3,483,1334,3578703008,3578703051,43
3,483,1335,3578703008,3578703053,45
3,484,1336,3578703060,3578703063,3
3,484,1337,3578703060,3578703064,4
3,484,1338,3578703060,3578703067,7
3,484,1339,3578703060,3578703068,8
3,484,1340,3578703060,3578703070,10
3,484,1341,3578703060,3578703075,15
3,484,1342,3578703060,3578703075,15
3,484,1343,3578703060,3578703080,20
3,484,1344,3578703060,3578703086,26
3,484,1345,3578703060,3578703088,28
3,484,1346,3578703060,3578703096,36
3,484,1347,3578703060,3578703096,36
3,484,1348,3578703060,3578703098,38
3,484,1349,3578703060,3578703100,40
3,484,1350,3578703060,3578703101,41
3,485,1351,3578703112,3578703119,7
3,485,1352,3578703112,3578703126,14
3,485,1353,3578703112,3578703133,21
3,485,1354,3578703112,3578703137,25
3,485,1355,3578703112,3578703138,26
3,485,1356,3578703112,3578703139,27
3,485,1357,3578703112,3578703144,32
3,485,1358,3578703112,3578703146,34
3,485,1359,3578703112,3578703150,38
3,485,1360,3578703112,3578703151,39
3,486,1361,3578703164,3578703164,0
3,486,1362,3578703164,3578703166,2
3,486,1363,3578703164,3578703168,4
3,486,1364,3578703164,3578703170,6
3,486,1365,3578703164,3578703174,10
3,486,1366,3578703164,3578703176,12
3,486,1367,3578703164,3578703179,15
3,486,1368,3578703164,3578703183,19
3,486,1369,3578703164,3578703186,22
3,486,1370,3578703164,3578703190,26
3,486,1371,3578703164,3578703191,27
3,486,1372,3578703164,3578703191,27
3,486,1373,3578703164,3578703204,40
3,486,1374,3578703164,3578703214,50
3,487,1375,3578703216,3578703219,3
3,487,1376,3578703216,3578703226,10
3,487,1377,3578703216,3578703233,17
3,487,1378,3578703216,3578703240,24
3,487,1379,3578703216,3578703242,26
3,487,1380,3578703216,3578703246,30
3,487,1381,3578703216,3578703251,35
3,487,1382,3578703216,3578703252,36
3,487,1383,3578703216,3578703253,37
3,487,1384,3578703216,3578703263,47
3,487,1385,3578703216,3578703264,48
3,488,1386,3578703269,3578703269,0
3,488,1387,3578703269,3578703269,0
3,488,1388,3578703269,3578703269,0
3,488,1389,3578703269,3578703275,6
3,488,1390,3578703269,3578703276,7
3,488,1391,3578703269,3578703279,10
3,488,1392,3578703269,3578703286,17
3,488,1393,3578703269,3578703288,19
3,488,1394,3578703269,3578703295,26
3,488,1395,3578703269,3578703297,28
3,488,1396,3578703269,3578703298,29
3,488,1397,3578703269,3578703300,31
3,488,1398,3578703269,3578703302,33
3,488,1399,3578703269,3578703319,50
3,489,1400,3578703321,3578703326,5
3,489,1401,3578703321,3578703333,12
3,489,1402,3578703321,3578703338,17
3,489,1403,3578703321,3578703338,17
3,489,1404,3578703321,3578703340,19
3,489,1405,3578703321,3578703345,24
3,489,1406,3578703321,3578703346,25
3,489,1407,3578703321,3578703350,29
3,489,1408,3578703321,3578703351,30
3,489,1409,3578703321,3578703364,43
3,489,1410,3578703321,3578703365,44
3,489,1411,3578703321,3578703369,48
3,489,1412,3578703321,3578703369,48
3,490,1413,3578703373,3578703374,1
3,490,1414,3578703373,3578703376,3
3,490,1415,3578703373,3578703378,5
3,490,1416,3578703373,3578703382,9
3,490,1417,3578703373,3578703386,13
3,490,1418,3578703373,3578703390,17
3,490,1419,3578703373,3578703391,18
3,490,1420,3578703373,3578703392,19
3,490,1421,3578703373,3578703403,30
3,490,1422,3578703373,3578703404,31
3,490,1423,3578703373,3578703415,42
3,490,1424,3578703373,3578703419,46
3,491,1425,3578703425,3578703426,1
3,491,1426,3578703425,3578703432,7
3,491,1427,3578703425,3578703440,15
3,491,1428,3578703425,3578703441,16
3,491,1429,3578703425,3578703446,21
3,491,1430,3578703425,3578703451,26
3,491,1431,3578703425,3578703452,27
3,491,1432,3578703425,3578703453,28
3,491,1433,3578703425,3578703463,38
3,491,1434,3578703425,3578703463,38
3,491,1435,3578703425,3578703468,43
3,491,1436,3578703425,3578703469,44
3,491,1437,3578703425,3578703470,45
3,491,1438,3578703425,3578703475,50
3,492,1439,3578703477,3578703477,0
3,492,1440,3578703477,3578703478,1
3,492,1441,3578703477,3578703485,8
3,492,1442,3578703477,3578703487,10
3,492,1443,3578703477,3578703494,17
3,492,1444,3578703477,3578703496,19
3,492,1445,3578703477,3578703497,20
3,492,1446,3578703477,3578703499,22
3,492,1447,3578703477,3578703500,23
3,492,1448,3578703477,3578703519,42
3,492,1449,3578703477,3578703525,48
3,493,1450,3578703529,3578703532,3
3,493,1451,3578703529,3578703537,8
3,493,1452,3578703529,3578703537,8
3,493,1453,3578703529,3578703538,9
3,493,1454,3578703529,3578703545,16
3,493,1455,3578703529,3578703545,16
3,493,1456,3578703529,3578703550,21
3,493,1457,3578703529,3578703550,21
3,493,1458,3578703529,3578703554,25
3,493,1459,3578703529,3578703564,35
3,493,1460,3578703529,3578703564,35
3,493,1461,3578703529,3578703568,39
3,493,1462,3578703529,3578703568,39
3,493,1463,3578703529,3578703573,44
3,493,1464,3578703529,3578703575,46
3,493,1465,3578703529,3578703578,49
3,494,1466,3578703581,3578703582,1
3,494,1467,3578703581,3578703585,4
3,494,1468,3578703581,3578703590,9
3,494,1469,3578703581,3578703590,9
3,494,1470,3578703581,3578703590,9
3,494,1471,3578703581,3578703602,21
3,494,1472,3578703581,3578703604,23
3,494,1473,3578703581,3578703605,24
3,494,1474,3578703581,3578703614,33
3,494,1475,3578703581,3578703619,38
3,494,1476,3578703581,3578703625,44
3,495,1477,3578703633,3578703633,0
3,495,1478,3578703633,3578703639,6
3,495,1479,3578703633,3578703641,8
3,495,1480,3578703633,3578703645,12
3,495,1481,3578703633,3578703651,18
3,495,1482,3578703633,3578703651,18
3,495,1483,3578703633,3578703652,19
3,495,1484,3578703633,3578703662,29
3,495,1485,3578703633,3578703663,30
3,495,1486,3578703633,3578703667,34
3,495,1487,3578703633,3578703668,35
3,495,1488,3578703633,3578703669,36
3,495,1489,3578703633,3578703675,42
3,495,1490,3578703633,3578703676,43
3,495,1491,3578703633,3578703678,45
3,496,1492,3578703685,3578703685,0
3,496,1493,3578703685,3578703687,2
3,496,1494,3578703685,3578703695,10
3,496,1495,3578703685,3578703697,12
3,496,1496,3578703685,3578703697,12
3,496,1497,3578703685,3578703700,15
3,496,1498,3578703685,3578703701,16
3,496,1499,3578703685,3578703718,33
3,496,1500,3578703685,3578703725,40
3,496,1501,3578703685,3578703733,48
3,497,1502,3578703737,3578703737,0
3,497,1503,3578703737,3578703738,1
3,497,1504,3578703737,3578703739,2
3,497,1505,3578703737,3578703744,7
3,497,1506,3578703737,3578703745,8
3,497,1507,3578703737,3578703750,13
3,497,1508,3578703737,3578703750,13
3,497,1509,3578703737,3578703754,17
3,497,1510,3578703737,3578703764,27
3,497,1511,3578703737,3578703764,27
3,497,1512,3578703737,3578703768,31
3,497,1513,3578703737,3578703768,31
3,497,1514,3578703737,3578703774,37
3,497,1515,3578703737,3578703776,39
3,497,1516,3578703737,3578703778,41
3,497,1517,3578703737,3578703783,46
3,497,1518,3578703737,3578703786,49
3,498,1519,3578703789,3578703789,0
3,498,1520,3578703789,3578703790,1
3,498,1521,3578703789,3578703791,2
3,498,1522,3578703789,3578703803,14
3,498,1523,3578703789,3578703803,14
3,498,1524,3578703789,3578703805,16
3,498,1525,3578703789,3578703814,25
3,498,1526,3578703789,3578703818,29
3,498,1527,3578703789,3578703825,36
3,498,1528,3578703789,3578703831,42
3,498,1529,3578703789,3578703839,50
3,499,1530,3578703840,3578703841,1
3,499,1531,3578703840,3578703845,5
3,499,1532,3578703840,3578703851,11
3,499,1533,3578703840,3578703851,11
3,499,1534,3578703840,3578703852,12
3,499,1535,3578703840,3578703862,22
3,499,1536,3578703840,3578703864,24
3,499,1537,3578703840,3578703867,27
3,499,1538,3578703840,3578703868,28
3,499,1539,3578703840,3578703870,30
3,499,1540,3578703840,3578703875,35
3,499,1541,3578703840,3578703876,36
3,499,1542,3578703840,3578703879,39
3,499,1543,3578703840,3578703885,45
3,499,1544,3578703840,3578703887,47
3,500,1545,3578703892,3578703895,3
3,500,1546,3578703892,3578703897,5
3,500,1547,3578703892,3578703897,5
3,500,1548,3578703892,3578703901,9
3,500,1549,3578703892,3578703901,9
3,500,1550,3578703892,3578703918,26
3,500,1551,3578703892,3578703925,33
3,500,1552,3578703892,3578703933,41
3,500,1553,3578703892,3578703937,45
3,500,1554,3578703892,3578703938,46
3,500,1555,3578703892,3578703939,47
3,501,1556,3578703943,3578703944,1
3,501,1557,3578703943,3578703945,2
3,501,1558,3578703943,3578703950,7
3,501,1559,3578703943,3578703951,8
3,501,1560,3578703943,3578703954,11
3,501,1561,3578703943,3578703964,21
3,501,1562,3578703943,3578703968,25
3,501,1563,3578703943,3578703969,26
3,501,1564,3578703943,3578703974,31
3,501,1565,3578703943,3578703975,32
3,501,1566,3578703943,3578703977,34
3,501,1567,3578703943,3578703982,39
3,501,1568,3578703943,3578703986,43
3,501,1569,3578703943,3578703989,46
3,501,1570,3578703943,3578703990,47
3,501,1571,3578703943,3578703990,47
3,502,1572,3578703995,3578704002,7
3,502,1573,3578703995,3578704003,8
3,502,1574,3578703995,3578704004,9
3,502,1575,3578703995,3578704011,16
3,502,1576,3578703995,3578704015,20
3,502,1577,3578703995,3578704019,24
3,502,1578,3578703995,3578704026,31
3,502,1579,3578703995,3578704032,37
3,502,1580,3578703995,3578704040,45
3,502,1581,3578703995,3578704041,46
3,503,1582,3578704047,3578704047,0
3,503,1583,3578704047,3578704050,3
3,503,1584,3578704047,3578704051,4
3,503,1585,3578704047,3578704052,5
3,503,1586,3578704047,3578704064,17
3,503,1587,3578704047,3578704064,17
3,503,1588,3578704047,3578704067,20
3,503,1589,3578704047,3578704068,21
3,503,1590,3578704047,3578704070,23
3,503,1591,3578704047,3578704075,28
3,503,1592,3578704047,3578704075,28
3,503,1593,3578704047,3578704079,32
3,503,1594,3578704047,3578704085,38
3,503,1595,3578704047,3578704088,41
3,503,1596,3578704047,3578704094,47
3,503,1597,3578704047,3578704097,50
3,504,1598,3578704098,3578704098,0
3,504,1599,3578704098,3578704100,2
3,504,1600,3578704098,3578704102,4
3,504,1601,3578704098,3578704112,14
3,504,1602,3578704098,3578704119,21
3,504,1603,3578704098,3578704125,27
3,504,1604,3578704098,3578704132,34
3,504,1605,3578704098,3578704136,38
3,504,1606,3578704098,3578704138,40
3,504,1607,3578704098,3578704139,41
3,504,1608,3578704098,3578704144,46
3,504,1609,3578704098,3578704145,47
3,505,1610,3578704150,3578704151,1
3,505,1611,3578704150,3578704152,2
3,505,1612,3578704150,3578704154,4
3,505,1613,3578704150,3578704165,15
3,505,1614,3578704150,3578704168,18
3,505,1615,3578704150,3578704169,19
3,505,1616,3578704150,3578704174,24
3,505,1617,3578704150,3578704177,27
3,505,1618,3578704150,3578704178,28
3,505,1619,3578704150,3578704182,32
3,505,1620,3578704150,3578704186,36
3,505,1621,3578704150,3578704189,39
3,505,1622,3578704150,3578704191,41
3,505,1623,3578704150,3578704192,42
3,506,1624,3578704202,3578704202,0
3,506,1625,3578704202,3578704204,2
3,506,1626,3578704202,3578704204,2
3,506,1627,3578704202,3578704211,9
3,506,1628,3578704202,3578704213,11
3,506,1629,3578704202,3578704214,12
3,506,1630,3578704202,3578704219,17
3,506,1631,3578704202,3578704226,24
3,506,1632,3578704202,3578704231,29
3,506,1633,3578704202,3578704240,38
3,506,1634,3578704202,3578704242,40
3,506,1635,3578704202,3578704247,45
3,506,1636,3578704202,3578704251,49
3,507,1637,3578704254,3578704254,0
3,507,1638,3578704254,3578704254,0
3,507,1639,3578704254,3578704263,9
3,507,1640,3578704254,3578704264,10
3,507,1641,3578704254,3578704267,13
3,507,1642,3578704254,3578704268,14
3,507,1643,3578704254,3578704270,16
3,507,1644,3578704254,3578704275,21
3,507,1645,3578704254,3578704276,22
3,507,1646,3578704254,3578704278,24
3,507,1647,3578704254,3578704285,31
3,507,1648,3578704254,3578704287,33
3,507,1649,3578704254,3578704294,40
3,507,1650,3578704254,3578704297,43
3,507,1651,3578704254,3578704298,44
3,507,1652,3578704254,3578704301,47
3,507,1653,3578704254,3578704302,48
3,508,1654,3578704306,3578704313,7
3,508,1655,3578704306,3578704320,14
3,508,1656,3578704306,3578704326,20
3,508,1657,3578704306,3578704333,27
3,508,1658,3578704306,3578704336,30
3,508,1659,3578704306,3578704338,32
3,508,1660,3578704306,3578704338,32
3,508,1661,3578704306,3578704345,39
3,508,1662,3578704306,3578704345,39
3,508,1663,3578704306,3578704351,45
3,508,1664,3578704306,3578704352,46
3,508,1665,3578704306,3578704354,48
3,509,1666,3578704358,3578704365,7
3,509,1667,3578704358,3578704365,7
3,509,1668,3578704358,3578704368,10
3,509,1669,3578704358,3578704369,11
3,509,1670,3578704358,3578704374,16
3,509,1671,3578704358,3578704377,19
3,509,1672,3578704358,3578704378,20
3,509,1673,3578704358,3578704382,24
3,509,1674,3578704358,3578704386,28
3,509,1675,3578704358,3578704389,31
3,509,1676,3578704358,3578704391,33
3,509,1677,3578704358,3578704392,34
3,509,1678,3578704358,3578704402,44
3,509,1679,3578704358,3578704404,46
3,509,1680,3578704358,3578704405,47
3,510,1681,3578704410,3578704410,0
3,510,1682,3578704410,3578704413,3
3,510,1683,3578704410,3578704415,5
3,510,1684,3578704410,3578704419,9
3,510,1685,3578704410,3578704425,15
3,510,1686,3578704410,3578704433,23
3,510,1687,3578704410,3578704440,30
3,510,1688,3578704410,3578704442,32
3,510,1689,3578704410,3578704447,37
3,510,1690,3578704410,3578704450,40
3,510,1691,3578704410,3578704453,43
3,510,1692,3578704410,3578704453,43
3,511,1693,3578704462,3578704464,2
3,511,1694,3578704462,3578704464,2
3,511,1695,3578704462,3578704468,6
3,511,1696,3578704462,3578704469,7
3,511,1697,3578704462,3578704470,8
3,511,1698,3578704462,3578704475,13
3,511,1699,3578704462,3578704476,14
3,511,1700,3578704462,3578704479,17
3,511,1701,3578704462,3578704485,23
3,511,1702,3578704462,3578704488,26
3,511,1703,3578704462,3578704494,32
3,511,1704,3578704462,3578704497,35
3,511,1705,3578704462,3578704498,36
3,511,1706,3578704462,3578704501,39
3,511,1707,3578704462,3578704501,39
3,512,1708,3578704514,3578704514,0
3,512,1709,3578704514,3578704519,5
3,512,1710,3578704514,3578704525,11
3,512,1711,3578704514,3578704532,18
3,512,1712,3578704514,3578704535,21
3,512,1713,3578704514,3578704537,23
3,512,1714,3578704514,3578704537,23
3,512,1715,3578704514,3578704544,30
3,512,1716,3578704514,3578704545,31
3,512,1717,3578704514,3578704550,36
3,512,1718,3578704514,3578704551,37
3,512,1719,3578704514,3578704553,39
3,513,1720,3578704566,3578704566,0
3,513,1721,3578704566,3578704566,0
3,513,1722,3578704566,3578704568,2
3,513,1723,3578704566,3578704569,3
3,513,1724,3578704566,3578704573,7
3,513,1725,3578704566,3578704576,10
3,513,1726,3578704566,3578704578,12
3,513,1727,3578704566,3578704582,16
3,513,1728,3578704566,3578704585,19
3,513,1729,3578704566,3578704588,22
3,513,1730,3578704566,3578704590,24
3,513,1731,3578704566,3578704590,24
3,513,1732,3578704566,3578704602,36
3,513,1733,3578704566,3578704603,37
3,513,1734,3578704566,3578704605,39
3,513,1735,3578704566,3578704610,44
3,513,1736,3578704566,3578704612,46
3,513,1737,3578704566,3578704613,47
3,514,1738,3578704618,3578704618,0
3,514,1739,3578704618,3578704619,1
3,514,1740,3578704618,3578704625,7
3,514,1741,3578704618,3578704632,14
3,514,1742,3578704618,3578704639,21
3,514,1743,3578704618,3578704641,23
3,514,1744,3578704618,3578704646,28
3,514,1745,3578704618,3578704650,32
3,514,1746,3578704618,3578704651,33
3,514,1747,3578704618,3578704653,35
3,514,1748,3578704618,3578704663,45
3,514,1749,3578704618,3578704663,45
3,514,1750,3578704618,3578704667,49
3,514,1751,3578704618,3578704668,50
3,515,1752,3578704671,3578704671,0
3,515,1753,3578704671,3578704675,4
3,515,1754,3578704671,3578704677,6
3,515,1755,3578704671,3578704678,7
3,515,1756,3578704671,3578704685,14
3,515,1757,3578704671,3578704687,16
3,515,1758,3578704671,3578704694,23
3,515,1759,3578704671,3578704697,26
3,515,1760,3578704671,3578704698,27
3,515,1761,3578704671,3578704701,30
3,515,1762,3578704671,3578704701,30
3,515,1763,3578704671,3578704713,42
3,515,1764,3578704671,3578704719,48
3,515,1765,3578704671,3578704720,49
3,516,1766,3578704723,3578704725,2
3,516,1767,3578704723,3578704733,10
3,516,1768,3578704723,3578704736,13
3,516,1769,3578704723,3578704736,13
3,516,1770,3578704723,3578704737,14
3,516,1771,3578704723,3578704744,21
3,516,1772,3578704723,3578704745,22
3,516,1773,3578704723,3578704751,28
3,516,1774,3578704723,3578704751,28
3,516,1775,3578704723,3578704753,30
3,516,1776,3578704723,3578704764,41
3,516,1777,3578704723,3578704765,42
3,516,1778,3578704723,3578704768,45
3,516,1779,3578704723,3578704769,46
3,516,1780,3578704723,3578704770,47
3,517,1781,3578704775,3578704775,0
3,517,1782,3578704775,3578704777,2
3,517,1783,3578704775,3578704777,2
3,517,1784,3578704775,3578704782,7
3,517,1785,3578704775,3578704786,11
3,517,1786,3578704775,3578704788,13
3,517,1787,3578704775,3578704790,15
3,517,1788,3578704775,3578704791,16
3,517,1789,3578704775,3578704802,27
3,517,1790,3578704775,3578704803,28
3,517,1791,3578704775,3578704805,30
3,517,1792,3578704775,3578704810,35
3,517,1793,3578704775,3578704812,37
3,517,1794,3578704775,3578704814,39
3,517,1795,3578704775,3578704817,42
3,517,1796,3578704775,3578704819,44
3,518,1797,3578704827,3578704827,0
3,518,1798,3578704827,3578704831,4
3,518,1799,3578704827,3578704839,12
3,518,1800,3578704827,3578704840,13
3,518,1801,3578704827,3578704846,19
3,518,1802,3578704827,3578704850,23
3,518,1803,3578704827,3578704851,24
3,518,1804,3578704827,3578704853,26
3,518,1805,3578704827,3578704863,36
3,518,1806,3578704827,3578704863,36
3,518,1807,3578704827,3578704867,40
3,518,1808,3578704827,3578704868,41
3,518,1809,3578704827,3578704869,42
3,518,1810,3578704827,3578704875,48
3,518,1811,3578704827,3578704877,50
3,519,1812,3578704879,3578704879,0
3,519,1813,3578704879,3578704885,6
3,519,1814,3578704879,3578704888,9
3,519,1815,3578704879,3578704894,15
3,519,1816,3578704879,3578704897,18
3,519,1817,3578704879,3578704898,19
3,519,1818,3578704879,3578704901,22
3,519,1819,3578704879,3578704902,23
3,519,1820,3578704879,3578704919,40
3,519,1821,3578704879,3578704920,41
3,519,1822,3578704879,3578704922,43
3,519,1823,3578704879,3578704925,46
3,520,1824,3578704931,3578704933,2
3,520,1825,3578704931,3578704936,5
3,520,1826,3578704931,3578704938,7
3,520,1827,3578704931,3578704938,7
3,520,1828,3578704931,3578704945,14
3,520,1829,3578704931,3578704945,14
3,520,1830,3578704931,3578704950,19
3,520,1831,3578704931,3578704951,20
3,520,1832,3578704931,3578704953,22
3,520,1833,3578704931,3578704963,32
3,520,1834,3578704931,3578704965,34
3,520,1835,3578704931,3578704968,37
3,520,1836,3578704931,3578704968,37
3,520,1837,3578704931,3578704969,38
3,520,1838,3578704931,3578704972,41
3,520,1839,3578704931,3578704974,43
3,520,1840,3578704931,3578704978,47
3,520,1841,3578704931,3578704978,47
3,521,1842,3578704983,3578704983,0
3,521,1843,3578704983,3578704987,4
3,521,1844,3578704983,3578704988,5
3,521,1845,3578704983,3578704990,7
3,521,1846,3578704983,3578704991,8
3,521,1847,3578704983,3578705002,19
3,521,1848,3578704983,3578705003,20
3,521,1849,3578704983,3578705004,21
3,521,1850,3578704983,3578705010,27
3,521,1851,3578704983,3578705012,29
3,521,1852,3578704983,3578705015,32
3,521,1853,3578704983,3578705017,34
3,521,1854,3578704983,3578705019,36
3,521,1855,3578704983,3578705026,43
3,521,1856,3578704983,3578705032,49
3,522,1857,3578705035,3578705040,5
3,522,1858,3578705035,3578705040,5
3,522,1859,3578705035,3578705045,10
3,522,1860,3578705035,3578705051,16
3,522,1861,3578705035,3578705052,17
3,522,1862,3578705035,3578705053,18
3,522,1863,3578705035,3578705063,28
3,522,1864,3578705035,3578705064,29
3,522,1865,3578705035,3578705067,32
3,522,1866,3578705035,3578705068,33
3,522,1867,3578705035,3578705069,34
3,522,1868,3578705035,3578705075,40
3,522,1869,3578705035,3578705075,40
3,522,1870,3578705035,3578705077,42
3,522,1871,3578705035,3578705079,44
3,523,1872,3578705087,3578705087,0
3,523,1873,3578705087,3578705087,0
3,523,1874,3578705087,3578705095,8
3,523,1875,3578705087,3578705097,10
3,523,1876,3578705087,3578705098,11
3,523,1877,3578705087,3578705101,14
3,523,1878,3578705087,3578705101,14
3,523,1879,3578705087,3578705113,26
3,523,1880,3578705087,3578705119,32
3,523,1881,3578705087,3578705120,33
3,523,1882,3578705087,3578705123,36
3,523,1883,3578705087,3578705126,39
3,523,1884,3578705087,3578705133,46
3,523,1885,3578705087,3578705136,49
3,524,1886,3578705139,3578705139,0
3,524,1887,3578705139,3578705139,0
3,524,1888,3578705139,3578705145,6
3,524,1889,3578705139,3578705145,6
3,524,1890,3578705139,3578705150,11
3,524,1891,3578705139,3578705151,12
3,524,1892,3578705139,3578705164,25
3,524,1893,3578705139,3578705165,26
3,524,1894,3578705139,3578705168,29
3,524,1895,3578705139,3578705168,29
3,524,1896,3578705139,3578705170,31
3,524,1897,3578705139,3578705172,33
3,524,1898,3578705139,3578705175,36
3,524,1899,3578705139,3578705175,36
3,524,1900,3578705139,3578705179,40
3,524,1901,3578705139,3578705179,40
3,524,1902,3578705139,3578705182,43
3,524,1903,3578705139,3578705187,48
3,524,1904,3578705139,3578705189,50
3,525,1905,3578705191,3578705191,0
3,525,1906,3578705191,3578705191,0
3,525,1907,3578705191,3578705202,11
3,525,1908,3578705191,3578705204,13
3,525,1909,3578705191,3578705205,14
3,525,1910,3578705191,3578705210,19
3,525,1911,3578705191,3578705212,21
3,525,1912,3578705191,3578705214,23
3,525,1913,3578705191,3578705217,26
3,525,1914,3578705191,3578705218,27
3,525,1915,3578705191,3578705226,35
3,525,1916,3578705191,3578705226,35
3,525,1917,3578705191,3578705231,40
3,525,1918,3578705191,3578705240,49
3,526,1919,3578705244,3578705244,0
3,526,1920,3578705244,3578705245,1
3,526,1921,3578705244,3578705251,7
3,526,1922,3578705244,3578705252,8
3,526,1923,3578705244,3578705253,9
3,526,1924,3578705244,3578705263,19
3,526,1925,3578705244,3578705264,20
3,526,1926,3578705244,3578705267,23
3,526,1927,3578705244,3578705268,24
3,526,1928,3578705244,3578705269,25
3,526,1929,3578705244,3578705275,31
3,526,1930,3578705244,3578705275,31
3,526,1931,3578705244,3578705277,33
3,526,1932,3578705244,3578705277,33
3,526,1933,3578705244,3578705278,34
3,526,1934,3578705244,3578705284,40
3,526,1935,3578705244,3578705287,43
3,527,1936,3578705296,3578705296,0
3,527,1937,3578705296,3578705298,2
3,527,1938,3578705296,3578705298,2
3,527,1939,3578705296,3578705301,5
3,527,1940,3578705296,3578705302,6
3,527,1941,3578705296,3578705313,17
3,527,1942,3578705296,3578705318,22
3,527,1943,3578705296,3578705320,24
3,527,1944,3578705296,3578705323,27
3,527,1945,3578705296,3578705326,30
3,527,1946,3578705296,3578705333,37
3,527,1947,3578705296,3578705336,40
3,527,1948,3578705296,3578705338,42
3,527,1949,3578705296,3578705339,43
3,527,1950,3578705296,3578705345,49
3,527,1951,3578705296,3578705346,50
3,528,1952,3578705349,3578705350,1
3,528,1953,3578705349,3578705351,2
3,528,1954,3578705349,3578705365,16
3,528,1955,3578705349,3578705365,16
3,528,1956,3578705349,3578705368,19
3,528,1957,3578705349,3578705369,20
3,528,1958,3578705349,3578705370,21
3,528,1959,3578705349,3578705372,23
3,528,1960,3578705349,3578705375,26
3,528,1961,3578705349,3578705375,26
3,528,1962,3578705349,3578705378,29
3,528,1963,3578705349,3578705379,30
3,528,1964,3578705349,3578705382,33
3,528,1965,3578705349,3578705387,38
3,528,1966,3578705349,3578705389,40
3,528,1967,3578705349,3578705391,42
3,528,1968,3578705349,3578705392,43
3,529,1969,3578705401,3578705402,1
3,529,1970,3578705401,3578705404,3
3,529,1971,3578705401,3578705405,4
3,529,1972,3578705401,3578705409,8
3,529,1973,3578705401,3578705412,11
3,529,1974,3578705401,3578705415,14
3,529,1975,3578705401,3578705417,16
3,529,1976,3578705401,3578705419,18
3,529,1977,3578705401,3578705426,25
3,529,1978,3578705401,3578705426,25
3,529,1979,3578705401,3578705428,27
3,529,1980,3578705401,3578705439,38
3,529,1981,3578705401,3578705442,41
3,529,1982,3578705401,3578705446,45
3,530,1983,3578705454,3578705454,0
3,530,1984,3578705454,3578705454,0
3,530,1985,3578705454,3578705463,9
3,530,1986,3578705454,3578705465,11
3,530,1987,3578705454,3578705468,14
3,530,1988,3578705454,3578705468,14
3,530,1989,3578705454,3578705470,16
3,530,1990,3578705454,3578705475,21
3,530,1991,3578705454,3578705475,21
3,530,1992,3578705454,3578705477,23
3,530,1993,3578705454,3578705478,24
3,530,1994,3578705454,3578705479,25
3,530,1995,3578705454,3578705485,31
3,530,1996,3578705454,3578705487,33
3,530,1997,3578705454,3578705494,40
3,530,1998,3578705454,3578705498,44
3,530,1999,3578705454,3578705498,44
3,530,2000,3578705454,3578705501,47
3,530,2001,3578705454,3578705501,47
3,531,2002,3578705506,3578705512,6
3,531,2003,3578705506,3578705519,13
3,531,2004,3578705506,3578705519,13
3,531,2005,3578705506,3578705522,16
3,531,2006,3578705506,3578705524,18
3,531,2007,3578705506,3578705531,25
3,531,2008,3578705506,3578705535,29
3,531,2009,3578705506,3578705537,31
3,531,2010,3578705506,3578705538,32
3,531,2011,3578705506,3578705545,39
3,531,2012,3578705506,3578705545,39
3,531,2013,3578705506,3578705550,44
3,531,2014,3578705506,3578705550,44
3,532,2015,3578705558,3578705564,6
3,532,2016,3578705558,3578705564,6
3,532,2017,3578705558,3578705568,10
3,532,2018,3578705558,3578705568,10
3,532,2019,3578705558,3578705568,10
3,532,2020,3578705558,3578705571,13
3,532,2021,3578705558,3578705574,16
3,532,2022,3578705558,3578705575,17
3,532,2023,3578705558,3578705577,19
3,532,2024,3578705558,3578705578,20
3,532,2025,3578705558,3578705579,21
3,532,2026,3578705558,3578705582,24
3,532,2027,3578705558,3578705587,29
3,532,2028,3578705558,3578705588,30
3,532,2029,3578705558,3578705590,32
3,532,2030,3578705558,3578705591,33
3,532,2031,3578705558,3578705601,43
3,532,2032,3578705558,3578705603,45
3,532,2033,3578705558,3578705604,46
3,533,2034,3578705610,3578705610,0
3,533,2035,3578705610,3578705611,1
3,533,2036,3578705610,3578705614,4
3,533,2037,3578705610,3578705616,6
3,533,2038,3578705610,3578705619,9
3,533,2039,3578705610,3578705625,15
3,533,2040,3578705610,3578705627,17
3,533,2041,3578705610,3578705629,19
3,533,2042,3578705610,3578705632,22
3,533,2043,3578705610,3578705639,29
3,533,2044,3578705610,3578705641,31
3,533,2045,3578705610,3578705646,36
3,533,2046,3578705610,3578705650,40
3,533,2047,3578705610,3578705652,42
3,534,2048,3578705661,3578705662,1
3,534,2049,3578705661,3578705667,6
3,534,2050,3578705661,3578705668,7
3,534,2051,3578705661,3578705669,8
3,534,2052,3578705661,3578705675,14
3,534,2053,3578705661,3578705675,14
3,534,2054,3578705661,3578705677,16
3,534,2055,3578705661,3578705678,17
3,534,2056,3578705661,3578705678,17
3,534,2057,3578705661,3578705685,24
3,534,2058,3578705661,3578705688,27
3,534,2059,3578705661,3578705694,33
3,534,2060,3578705661,3578705698,37
3,534,2061,3578705661,3578705698,37
3,534,2062,3578705661,3578705701,40
3,534,2063,3578705661,3578705701,40
3,535,2064,3578705713,3578705713,0
3,535,2065,3578705713,3578705719,6
3,535,2066,3578705713,3578705719,6
3,535,2067,3578705713,3578705721,8
3,535,2068,3578705713,3578705725,12
3,535,2069,3578705713,3578705733,20
3,535,2070,3578705713,3578705736,23
3,535,2071,3578705713,3578705737,24
3,535,2072,3578705713,3578705738,25
3,535,2073,3578705713,3578705745,32
3,535,2074,3578705713,3578705746,33
3,535,2075,3578705713,3578705750,37
3,535,2076,3578705713,3578705750,37
3,535,2077,3578705713,3578705753,40
3,536,2078,3578705765,3578705765,0
3,536,2079,3578705765,3578705765,0
3,536,2080,3578705765,3578705768,3
3,536,2081,3578705765,3578705768,3
3,536,2082,3578705765,3578705769,4
3,536,2083,3578705765,3578705771,6
3,536,2084,3578705765,3578705774,9
3,536,2085,3578705765,3578705775,10
3,536,2086,3578705765,3578705778,13
3,536,2087,3578705765,3578705779,14
3,536,2088,3578705765,3578705779,14
3,536,2089,3578705765,3578705782,17
3,536,2090,3578705765,3578705787,22
3,536,2091,3578705765,3578705789,24
3,536,2092,3578705765,3578705790,25
3,536,2093,3578705765,3578705790,25
3,536,2094,3578705765,3578705801,36
3,536,2095,3578705765,3578705803,38
3,536,2096,3578705765,3578705804,39
3,536,2097,3578705765,3578705809,44
3,536,2098,3578705765,3578705811,46
3,536,2099,3578705765,3578705813,48
3,537,2100,3578705817,3578705817,0
3,537,2101,3578705817,3578705819,2
3,537,2102,3578705817,3578705824,7
3,537,2103,3578705817,3578705827,10
3,537,2104,3578705817,3578705829,12
3,537,2105,3578705817,3578705831,14
3,537,2106,3578705817,3578705839,22
3,537,2107,3578705817,3578705841,24
3,537,2108,3578705817,3578705846,29
3,537,2109,3578705817,3578705849,32
3,537,2110,3578705817,3578705851,34
3,537,2111,3578705817,3578705852,35
3,537,2112,3578705817,3578705862,45
3,537,2113,3578705817,3578705864,47
3,538,2114,3578705869,3578705869,0
3,538,2115,3578705869,3578705869,0
3,538,2116,3578705869,3578705869,0
3,538,2117,3578705869,3578705875,6
3,538,2118,3578705869,3578705875,6
3,538,2119,3578705869,3578705877,8
3,538,2120,3578705869,3578705878,9
3,538,2121,3578705869,3578705879,10
3,538,2122,3578705869,3578705884,15
3,538,2123,3578705869,3578705887,18
3,538,2124,3578705869,3578705894,25
3,538,2125,3578705869,3578705898,29
3,538,2126,3578705869,3578705898,29
3,538,2127,3578705869,3578705901,32
3,538,2128,3578705869,3578705902,33
3,538,2129,3578705869,3578705912,43
3,538,2130,3578705869,3578705918,49
3,538,2131,3578705869,3578705919,50
3,539,2132,3578705921,3578705921,0
3,539,2133,3578705921,3578705925,4
3,539,2134,3578705921,3578705933,12
3,539,2135,3578705921,3578705936,15
3,539,2136,3578705921,3578705938,17
3,539,2137,3578705921,3578705939,18
3,539,2138,3578705921,3578705945,24
3,539,2139,3578705921,3578705946,25
3,539,2140,3578705921,3578705951,30
3,539,2141,3578705921,3578705951,30
3,539,2142,3578705921,3578705953,32
3,539,2143,3578705921,3578705963,42
3,539,2144,3578705921,3578705965,44
3,539,2145,3578705921,3578705968,47
3,539,2146,3578705921,3578705968,47
3,539,2147,3578705921,3578705969,48
3,539,2148,3578705921,3578705971,50
3,540,2149,3578705973,3578705974,1
3,540,2150,3578705973,3578705975,2
3,540,2151,3578705973,3578705978,5
3,540,2152,3578705973,3578705979,6
3,540,2153,3578705973,3578705982,9
3,540,2154,3578705973,3578705985,12
3,540,2155,3578705973,3578705987,14
3,540,2156,3578705973,3578705988,15
3,540,2157,3578705973,3578705990,17
3,540,2158,3578705973,3578705991,18
3,540,2159,3578705973,3578706001,28
3,540,2160,3578705973,3578706003,30
3,540,2161,3578705973,3578706004,31
3,540,2162,3578705973,3578706009,36
3,540,2163,3578705973,3578706012,39
3,540,2164,3578705973,3578706015,42
3,540,2165,3578705973,3578706016,43
3,540,2166,3578705973,3578706020,47
3,541,2167,3578706025,3578706025,0
3,541,2168,3578706025,3578706026,1
3,541,2169,3578706025,3578706027,2
3,541,2170,3578706025,3578706029,4
3,541,2171,3578706025,3578706032,7
3,541,2172,3578706025,3578706040,15
3,541,2173,3578706025,3578706041,16
3,541,2174,3578706025,3578706046,21
3,541,2175,3578706025,3578706050,25
3,541,2176,3578706025,3578706052,27
3,541,2177,3578706025,3578706052,27
3,541,2178,3578706025,3578706064,39
3,541,2179,3578706025,3578706064,39
3,541,2180,3578706025,3578706068,43
3,541,2181,3578706025,3578706068,43
3,541,2182,3578706025,3578706069,44
3,542,2183,3578706077,3578706077,0
3,542,2184,3578706077,3578706077,0
3,542,2185,3578706077,3578706077,0
3,542,2186,3578706077,3578706078,1
3,542,2187,3578706077,3578706079,2
3,542,2188,3578706077,3578706084,7
3,542,2189,3578706077,3578706088,11
3,542,2190,3578706077,3578706094,17
3,542,2191,3578706077,3578706098,21
3,542,2192,3578706077,3578706099,22
3,542,2193,3578706077,3578706101,24
3,542,2194,3578706077,3578706102,25
3,542,2195,3578706077,3578706112,35
3,542,2196,3578706077,3578706118,41
3,542,2197,3578706077,3578706119,42
3,542,2198,3578706077,3578706121,44
3,542,2199,3578706077,3578706126,49
3,543,2200,3578706130,3578706133,3
3,543,2201,3578706130,3578706136,6
3,543,2202,3578706130,3578706138,8
3,543,2203,3578706130,3578706139,9
3,543,2204,3578706130,3578706145,15
3,543,2205,3578706130,3578706146,16
3,543,2206,3578706130,3578706151,21
3,543,2207,3578706130,3578706151,21
3,543,2208,3578706130,3578706153,23
3,543,2209,3578706130,3578706164,34
3,543,2210,3578706130,3578706165,35
3,543,2211,3578706130,3578706168,38
3,543,2212,3578706130,3578706168,38
3,543,2213,3578706130,3578706169,39
3,543,2214,3578706130,3578706171,41
3,543,2215,3578706130,3578706173,43
3,543,2216,3578706130,3578706175,45
3,543,2217,3578706130,3578706178,48
3,543,2218,3578706130,3578706179,49
3,544,2219,3578706182,3578706182,0
3,544,2220,3578706182,3578706184,2
3,544,2221,3578706182,3578706187,5
3,544,2222,3578706182,3578706188,6
3,544,2223,3578706182,3578706191,9
3,544,2224,3578706182,3578706191,9
3,544,2225,3578706182,3578706202,20
3,544,2226,3578706182,3578706204,22
3,544,2227,3578706182,3578706205,23
3,544,2228,3578706182,3578706209,27
3,544,2229,3578706182,3578706212,30
3,544,2230,3578706182,3578706214,32
3,544,2231,3578706182,3578706216,34
3,544,2232,3578706182,3578706220,38
3,544,2233,3578706182,3578706224,42
3,544,2234,3578706182,3578706226,44
3,544,2235,3578706182,3578706227,45
3,544,2236,3578706182,3578706230,48
3,544,2237,3578706182,3578706231,49
3,545,2238,3578706234,3578706239,5
3,545,2239,3578706234,3578706242,8
3,545,2240,3578706234,3578706245,11
3,545,2241,3578706234,3578706251,17
3,545,2242,3578706234,3578706252,18
3,545,2243,3578706234,3578706252,18
3,545,2244,3578706234,3578706264,30
3,545,2245,3578706234,3578706264,30
3,545,2246,3578706234,3578706268,34
3,545,2247,3578706234,3578706268,34
3,545,2248,3578706234,3578706269,35
3,545,2249,3578706234,3578706275,41
3,545,2250,3578706234,3578706275,41
3,545,2251,3578706234,3578706277,43
3,545,2252,3578706234,3578706278,44
3,546,2253,3578706286,3578706286,0
3,546,2254,3578706286,3578706288,2
3,546,2255,3578706286,3578706294,8
3,546,2256,3578706286,3578706298,12
3,546,2257,3578706286,3578706299,13
3,546,2258,3578706286,3578706301,15
3,546,2259,3578706286,3578706301,15
3,546,2260,3578706286,3578706313,27
3,546,2261,3578706286,3578706319,33
3,546,2262,3578706286,3578706319,33
3,546,2263,3578706286,3578706321,35
3,546,2264,3578706286,3578706326,40
3,546,2265,3578706286,3578706333,47
3,547,2266,3578706339,3578706339,0
3,547,2267,3578706339,3578706339,0
3,547,2268,3578706339,3578706339,0
3,547,2269,3578706339,3578706340,1
3,547,2270,3578706339,3578706345,6
3,547,2271,3578706339,3578706345,6
3,547,2272,3578706339,3578706351,12
3,547,2273,3578706339,3578706351,12
3,547,2274,3578706339,3578706354,15
3,547,2275,3578706339,3578706364,25
3,547,2276,3578706339,3578706366,27
3,547,2277,3578706339,3578706368,29
3,547,2278,3578706339,3578706369,30
3,547,2279,3578706339,3578706370,31
3,547,2280,3578706339,3578706372,33
3,547,2281,3578706339,3578706374,35
3,547,2282,3578706339,3578706375,36
3,547,2283,3578706339,3578706377,38
3,547,2284,3578706339,3578706378,39
3,547,2285,3578706339,3578706379,40
3,547,2286,3578706339,3578706382,43
3,547,2287,3578706339,3578706385,46
3,547,2288,3578706339,3578706386,47
3,547,2289,3578706339,3578706388,49
3,548,2290,3578706392,3578706392,0
3,548,2291,3578706392,3578706392,0
3,548,2292,3578706392,3578706402,10
3,548,2293,3578706392,3578706404,12
3,548,2294,3578706392,3578706405,13
3,548,2295,3578706392,3578706409,17
3,548,2296,3578706392,3578706412,20
3,548,2297,3578706392,3578706415,23
3,548,2298,3578706392,3578706417,25
3,548,2299,3578706392,3578706420,28
3,548,2300,3578706392,3578706424,32
3,548,2301,3578706392,3578706426,34
3,548,2302,3578706392,3578706427,35
3,548,2303,3578706392,3578706429,37
3,548,2304,3578706392,3578706433,41
3,548,2305,3578706392,3578706440,48
3,548,2306,3578706392,3578706442,50
3,549,2307,3578706445,3578706446,1
3,549,2308,3578706445,3578706450,5
3,549,2309,3578706445,3578706452,7
3,549,2310,3578706445,3578706452,7
3,549,2311,3578706445,3578706464,19
3,549,2312,3578706445,3578706464,19
3,549,2313,3578706445,3578706468,23
3,549,2314,3578706445,3578706469,24
3,549,2315,3578706445,3578706470,25
3,549,2316,3578706445,3578706475,30
3,549,2317,3578706445,3578706475,30
3,549,2318,3578706445,3578706477,32
3,549,2319,3578706445,3578706477,32
3,549,2320,3578706445,3578706479,34
3,549,2321,3578706445,3578706485,40
3,549,2322,3578706445,3578706488,43
3,549,2323,3578706445,3578706494,49
3,550,2324,3578706498,3578706498,0
3,550,2325,3578706498,3578706498,0
3,550,2326,3578706498,3578706500,2
3,550,2327,3578706498,3578706500,2
3,550,2328,3578706498,3578706512,14
3,550,2329,3578706498,3578706518,20
3,550,2330,3578706498,3578706519,21
3,550,2331,3578706498,3578706521,23
3,550,2332,3578706498,3578706525,27
3,550,2333,3578706498,3578706532,34
3,550,2334,3578706498,3578706535,37
3,550,2335,3578706498,3578706537,39
3,550,2336,3578706498,3578706538,40
3,550,2337,3578706498,3578706538,40
3,550,2338,3578706498,3578706541,43
3,550,2339,3578706498,3578706544,46
3,550,2340,3578706498,3578706545,47
3,551,2341,3578706551,3578706551,0
3,551,2342,3578706551,3578706551,0
3,551,2343,3578706551,3578706553,2
3,551,2344,3578706551,3578706563,12
3,551,2345,3578706551,3578706565,14
3,551,2346,3578706551,3578706568,17
3,551,2347,3578706551,3578706568,17
3,551,2348,3578706551,3578706569,18
3,551,2349,3578706551,3578706570,19
3,551,2350,3578706551,3578706573,22
3,551,2351,3578706551,3578706574,23
3,551,2352,3578706551,3578706576,25
3,551,2353,3578706551,3578706577,26
3,551,2354,3578706551,3578706578,27
3,551,2355,3578706551,3578706582,31
3,551,2356,3578706551,3578706584,33
3,551,2357,3578706551,3578706586,35
3,551,2358,3578706551,3578706587,36
3,551,2359,3578706551,3578706590,39
3,551,2360,3578706551,3578706591,40
3,552,2361,3578706603,3578706603,0
3,552,2362,3578706603,3578706603,0
3,552,2363,3578706603,3578706603,0
3,552,2364,3578706603,3578706608,5
3,552,2365,3578706603,3578706611,8
3,552,2366,3578706603,3578706615,12
3,552,2367,3578706603,3578706616,13
3,552,2368,3578706603,3578706619,16
3,552,2369,3578706603,3578706623,20
3,552,2370,3578706603,3578706625,22
3,552,2371,3578706603,3578706626,23
3,552,2372,3578706603,3578706629,26
3,552,2373,3578706603,3578706631,28
3,552,2374,3578706603,3578706640,37
3,552,2375,3578706603,3578706641,38
3,552,2376,3578706603,3578706645,42
3,552,2377,3578706603,3578706650,47
3,552,2378,3578706603,3578706651,48
3,552,2379,3578706603,3578706651,48
3,553,2380,3578706655,3578706662,7
3,553,2381,3578706655,3578706663,8
3,553,2382,3578706655,3578706668,13
3,553,2383,3578706655,3578706668,13
3,553,2384,3578706655,3578706670,15
3,553,2385,3578706655,3578706675,20
3,553,2386,3578706655,3578706675,20
3,553,2387,3578706655,3578706677,22
3,553,2388,3578706655,3578706677,22
3,553,2389,3578706655,3578706678,23
3,553,2390,3578706655,3578706688,33
3,553,2391,3578706655,3578706695,40
3,553,2392,3578706655,3578706698,43
3,553,2393,3578706655,3578706698,43
3,553,2394,3578706655,3578706700,45
3,553,2395,3578706655,3578706701,46
3,554,2396,3578706708,3578706712,4
3,554,2397,3578706708,3578706718,10
3,554,2398,3578706708,3578706719,11
3,554,2399,3578706708,3578706720,12
3,554,2400,3578706708,3578706725,17
3,554,2401,3578706708,3578706733,25
3,554,2402,3578706708,3578706736,28
3,554,2403,3578706708,3578706737,29
3,554,2404,3578706708,3578706738,30
3,554,2405,3578706708,3578706738,30
3,554,2406,3578706708,3578706741,33
3,554,2407,3578706708,3578706745,37
3,554,2408,3578706708,3578706745,37
3,554,2409,3578706708,3578706750,42
3,554,2410,3578706708,3578706750,42
3,554,2411,3578706708,3578706753,45
3,555,2412,3578706761,3578706762,1
3,555,2413,3578706761,3578706764,3
3,555,2414,3578706761,3578706768,7
3,555,2415,3578706761,3578706768,7
3,555,2416,3578706761,3578706769,8
3,555,2417,3578706761,3578706771,10
3,555,2418,3578706761,3578706773,12
3,555,2419,3578706761,3578706774,13
3,555,2420,3578706761,3578706777,16
3,555,2421,3578706761,3578706777,16
3,555,2422,3578706761,3578706778,17
3,555,2423,3578706761,3578706782,21
3,555,2424,3578706761,3578706784,23
3,555,2425,3578706761,3578706787,26
3,555,2426,3578706761,3578706787,26
3,555,2427,3578706761,3578706790,29
3,555,2428,3578706761,3578706790,29
3,555,2429,3578706761,3578706801,40
3,555,2430,3578706761,3578706803,42
3,555,2431,3578706761,3578706809,48
3,555,2432,3578706761,3578706811,50
3,556,2433,3578706814,3578706814,0
3,556,2434,3578706814,3578706816,2
3,556,2435,3578706814,3578706819,5
3,556,2436,3578706814,3578706823,9
3,556,2437,3578706814,3578706825,11
3,556,2438,3578706814,3578706826,12
3,556,2439,3578706814,3578706830,16
3,556,2440,3578706814,3578706831,17
3,556,2441,3578706814,3578706840,26
3,556,2442,3578706814,3578706841,27
3,556,2443,3578706814,3578706846,32
3,556,2444,3578706814,3578706849,35
3,556,2445,3578706814,3578706850,36
3,556,2446,3578706814,3578706852,38
3,556,2447,3578706814,3578706863,49
3,556,2448,3578706814,3578706864,50
3,557,2449,3578706867,3578706868,1
3,557,2450,3578706867,3578706869,2
3,557,2451,3578706867,3578706869,2
3,557,2452,3578706867,3578706875,8
3,557,2453,3578706867,3578706875,8
3,557,2454,3578706867,3578706877,10
3,557,2455,3578706867,3578706878,11
3,557,2456,3578706867,3578706878,11
3,557,2457,3578706867,3578706888,21
3,557,2458,3578706867,3578706894,27
3,557,2459,3578706867,3578706898,31
3,557,2460,3578706867,3578706898,31
3,557,2461,3578706867,3578706900,33
3,557,2462,3578706867,3578706900,33
3,557,2463,3578706867,3578706912,45
3,558,2464,3578706919,3578706919,0
3,558,2465,3578706919,3578706919,0
3,558,2466,3578706919,3578706920,1
3,558,2467,3578706919,3578706925,6
3,558,2468,3578706919,3578706933,14
3,558,2469,3578706919,3578706937,18
3,558,2470,3578706919,3578706938,19
3,558,2471,3578706919,3578706938,19
3,558,2472,3578706919,3578706939,20
3,558,2473,3578706919,3578706941,22
3,558,2474,3578706919,3578706945,26
3,558,2475,3578706919,3578706945,26
3,558,2476,3578706919,3578706949,30
3,558,2477,3578706919,3578706951,32
3,558,2478,3578706919,3578706953,34
3,558,2479,3578706919,3578706964,45
3,558,2480,3578706919,3578706964,45
3,558,2481,3578706919,3578706968,49
3,558,2482,3578706919,3578706968,49
3,559,2483,3578706971,3578706971,0
3,559,2484,3578706971,3578706971,0
3,559,2485,3578706971,3578706974,3
3,559,2486,3578706971,3578706974,3
3,559,2487,3578706971,3578706977,6
3,559,2488,3578706971,3578706978,7
3,559,2489,3578706971,3578706978,7
3,559,2490,3578706971,3578706982,11
3,559,2491,3578706971,3578706984,13
3,559,2492,3578706971,3578706986,15
3,559,2493,3578706971,3578706987,16
3,559,2494,3578706971,3578706990,19
3,559,2495,3578706971,3578706991,20
3,559,2496,3578706971,3578706999,28
3,559,2497,3578706971,3578707001,30
3,559,2498,3578706971,3578707003,32
3,559,2499,3578706971,3578707009,38
3,559,2500,3578706971,3578707012,41
3,559,2501,3578706971,3578707015,44
3,559,2502,3578706971,3578707016,45
3,559,2503,3578706971,3578707020,49
3,560,2504,3578707023,3578707025,2
3,560,2505,3578707023,3578707026,3
3,560,2506,3578707023,3578707026,3
3,560,2507,3578707023,3578707030,7
3,560,2508,3578707023,3578707039,16
3,560,2509,3578707023,3578707041,18
3,560,2510,3578707023,3578707046,23
3,560,2511,3578707023,3578707050,27
3,560,2512,3578707023,3578707052,29
3,560,2513,3578707023,3578707052,29
3,560,2514,3578707023,3578707063,40
3,560,2515,3578707023,3578707063,40
3,560,2516,3578707023,3578707069,46
3,560,2517,3578707023,3578707069,46
3,560,2518,3578707023,3578707070,47
3,561,2519,3578707076,3578707076,0
3,561,2520,3578707076,3578707076,0
3,561,2521,3578707076,3578707077,1
3,561,2522,3578707076,3578707078,2
3,561,2523,3578707076,3578707079,3
3,561,2524,3578707076,3578707088,12
3,561,2525,3578707076,3578707094,18
3,561,2526,3578707076,3578707098,22
3,561,2527,3578707076,3578707098,22
3,561,2528,3578707076,3578707100,24
3,561,2529,3578707076,3578707101,25
3,561,2530,3578707076,3578707112,36
3,561,2531,3578707076,3578707119,43
3,561,2532,3578707076,3578707119,43
3,561,2533,3578707076,3578707120,44
3,561,2534,3578707076,3578707125,49
3,562,2535,3578707129,3578707133,4
3,562,2536,3578707129,3578707136,7
3,562,2537,3578707129,3578707138,9
3,562,2538,3578707129,3578707138,9
3,562,2539,3578707129,3578707139,10
3,562,2540,3578707129,3578707141,12
3,562,2541,3578707129,3578707145,16
3,562,2542,3578707129,3578707145,16
3,562,2543,3578707129,3578707150,21
3,562,2544,3578707129,3578707151,22
3,562,2545,3578707129,3578707151,22
3,562,2546,3578707129,3578707153,24
3,562,2547,3578707129,3578707164,35
3,562,2548,3578707129,3578707165,36
3,562,2549,3578707129,3578707168,39
3,562,2550,3578707129,3578707168,39
3,562,2551,3578707129,3578707169,40
3,562,2552,3578707129,3578707171,42
3,562,2553,3578707129,3578707174,45
3,562,2554,3578707129,3578707174,45
3,562,2555,3578707129,3578707177,48
3,562,2556,3578707129,3578707178,49
3,562,2557,3578707129,3578707178,49
3,563,2558,3578707182,3578707183,1
3,563,2559,3578707182,3578707184,2
3,563,2560,3578707182,3578707186,4
3,563,2561,3578707182,3578707188,6
3,563,2562,3578707182,3578707191,9
3,563,2563,3578707182,3578707192,10
3,563,2564,3578707182,3578707199,17
3,563,2565,3578707182,3578707202,20
3,563,2566,3578707182,3578707204,22
3,563,2567,3578707182,3578707204,22
3,563,2568,3578707182,3578707210,28
3,563,2569,3578707182,3578707212,30
3,563,2570,3578707182,3578707215,33
3,563,2571,3578707182,3578707216,34
3,563,2572,3578707182,3578707220,38
3,563,2573,3578707182,3578707224,42
3,563,2574,3578707182,3578707226,44
3,563,2575,3578707182,3578707227,45
3,563,2576,3578707182,3578707229,47
3,564,2577,3578707234,3578707240,6
3,564,2578,3578707234,3578707242,8
3,564,2579,3578707234,3578707246,12
3,564,2580,3578707234,3578707250,16
3,564,2581,3578707234,3578707251,17
3,564,2582,3578707234,3578707252,18
3,564,2583,3578707234,3578707263,29
3,564,2584,3578707234,3578707263,29
3,564,2585,3578707234,3578707269,35
3,564,2586,3578707234,3578707269,35
3,564,2587,3578707234,3578707269,35
3,564,2588,3578707234,3578707275,41
3,564,2589,3578707234,3578707275,41
3,564,2590,3578707234,3578707277,43
3,564,2591,3578707234,3578707277,43
3,564,2592,3578707234,3578707278,44
3,565,2593,3578707287,3578707287,0
3,565,2594,3578707287,3578707288,1
3,565,2595,3578707287,3578707295,8
3,565,2596,3578707287,3578707298,11
3,565,2597,3578707287,3578707298,11
3,565,2598,3578707287,3578707300,13
3,565,2599,3578707287,3578707301,14
3,565,2600,3578707287,3578707312,25
3,565,2601,3578707287,3578707318,31
3,565,2602,3578707287,3578707319,32
3,565,2603,3578707287,3578707320,33
3,565,2604,3578707287,3578707326,39
3,565,2605,3578707287,3578707333,46
3,565,2606,3578707287,3578707336,49
3,566,2607,3578707340,3578707340,0
3,566,2608,3578707340,3578707340,0
3,566,2609,3578707340,3578707342,2
3,566,2610,3578707340,3578707345,5
3,566,2611,3578707340,3578707345,5
3,566,2612,3578707340,3578707350,10
3,566,2613,3578707340,3578707351,11
3,566,2614,3578707340,3578707351,11
3,566,2615,3578707340,3578707354,14
3,566,2616,3578707340,3578707364,24
3,566,2617,3578707340,3578707365,25
3,566,2618,3578707340,3578707368,28
3,566,2619,3578707340,3578707369,29
3,566,2620,3578707340,3578707370,30
3,566,2621,3578707340,3578707371,31
3,566,2622,3578707340,3578707374,34
3,566,2623,3578707340,3578707374,34
3,566,2624,3578707340,3578707377,37
3,566,2625,3578707340,3578707378,38
3,566,2626,3578707340,3578707379,39
3,566,2627,3578707340,3578707382,42
3,566,2628,3578707340,3578707384,44
3,566,2629,3578707340,3578707387,47
3,566,2630,3578707340,3578707388,48
3,567,2631,3578707392,3578707392,0
3,567,2632,3578707392,3578707392,0
3,567,2633,3578707392,3578707399,7
3,567,2634,3578707392,3578707402,10
3,567,2635,3578707392,3578707404,12
3,567,2636,3578707392,3578707404,12
3,567,2637,3578707392,3578707411,19
3,567,2638,3578707392,3578707412,20
3,567,2639,3578707392,3578707415,23
3,567,2640,3578707392,3578707416,24
3,567,2641,3578707392,3578707420,28
3,567,2642,3578707392,3578707425,33
3,567,2643,3578707392,3578707426,34
3,567,2644,3578707392,3578707430,38
3,567,2645,3578707392,3578707433,41
3,567,2646,3578707392,3578707441,49
3,567,2647,3578707392,3578707441,49
3,568,2648,3578707445,3578707445,0
3,568,2649,3578707445,3578707451,6
3,568,2650,3578707445,3578707452,7
3,568,2651,3578707445,3578707452,7
3,568,2652,3578707445,3578707455,10
3,568,2653,3578707445,3578707463,18
3,568,2654,3578707445,3578707464,19
3,568,2655,3578707445,3578707469,24
3,568,2656,3578707445,3578707469,24
3,568,2657,3578707445,3578707470,25
3,568,2658,3578707445,3578707475,30
3,568,2659,3578707445,3578707475,30
3,568,2660,3578707445,3578707477,32
3,568,2661,3578707445,3578707478,33
3,568,2662,3578707445,3578707478,33
3,568,2663,3578707445,3578707486,41
3,568,2664,3578707445,3578707488,43
3,568,2665,3578707445,3578707494,49
3,569,2666,3578707497,3578707497,0
3,569,2667,3578707497,3578707497,0
3,569,2668,3578707497,3578707499,2
3,569,2669,3578707497,3578707500,3
3,569,2670,3578707497,3578707505,8
3,569,2671,3578707497,3578707511,14
3,569,2672,3578707497,3578707518,21
3,569,2673,3578707497,3578707519,22
3,569,2674,3578707497,3578707519,22
3,569,2675,3578707497,3578707525,28
3,569,2676,3578707497,3578707531,34
3,569,2677,3578707497,3578707535,38
3,569,2678,3578707497,3578707539,42
3,569,2679,3578707497,3578707539,42
3,569,2680,3578707497,3578707541,44
3,569,2681,3578707497,3578707544,47
3,569,2682,3578707497,3578707545,48
3,570,2683,3578707549,3578707549,0
3,570,2684,3578707549,3578707550,1
3,570,2685,3578707549,3578707550,1
3,570,2686,3578707549,3578707551,2
3,570,2687,3578707549,3578707554,5
3,570,2688,3578707549,3578707563,14
3,570,2689,3578707549,3578707564,15
3,570,2690,3578707549,3578707568,19
3,570,2691,3578707549,3578707569,20
3,570,2692,3578707549,3578707569,20
3,570,2693,3578707549,3578707570,21
3,570,2694,3578707549,3578707573,24
3,570,2695,3578707549,3578707573,24
3,570,2696,3578707549,3578707576,27
3,570,2697,3578707549,3578707578,29
3,570,2698,3578707549,3578707578,29
3,570,2699,3578707549,3578707582,33
3,570,2700,3578707549,3578707582,33
3,570,2701,3578707549,3578707586,37
3,570,2702,3578707549,3578707588,39
3,570,2703,3578707549,3578707590,41
3,570,2704,3578707549,3578707590,41
3,570,2705,3578707549,3578707598,49
3,571,2706,3578707602,3578707602,0
3,571,2707,3578707602,3578707603,1
3,571,2708,3578707602,3578707603,1
3,571,2709,3578707602,3578707606,4
3,571,2710,3578707602,3578707609,7
3,571,2711,3578707602,3578707611,9
3,571,2712,3578707602,3578707614,12
3,571,2713,3578707602,3578707616,14
3,571,2714,3578707602,3578707618,16
3,571,2715,3578707602,3578707623,21
3,571,2716,3578707602,3578707625,23
3,571,2717,3578707602,3578707627,25
3,571,2718,3578707602,3578707629,27
3,571,2719,3578707602,3578707631,29
3,571,2720,3578707602,3578707640,38
3,571,2721,3578707602,3578707640,38
3,571,2722,3578707602,3578707646,44
3,571,2723,3578707602,3578707651,49
3,571,2724,3578707602,3578707651,49
3,571,2725,3578707602,3578707651,49
3,572,2726,3578707654,3578707655,1
3,572,2727,3578707654,3578707662,8
3,572,2728,3578707654,3578707662,8
3,572,2729,3578707654,3578707668,14
3,572,2730,3578707654,3578707668,14
3,572,2731,3578707654,3578707669,15
3,572,2732,3578707654,3578707675,21
3,572,2733,3578707654,3578707676,22
3,572,2734,3578707654,3578707677,23
3,572,2735,3578707654,3578707678,24
3,572,2736,3578707654,3578707678,24
3,572,2737,3578707654,3578707685,31
3,572,2738,3578707654,3578707688,34
3,572,2739,3578707654,3578707695,41
3,572,2740,3578707654,3578707697,43
3,572,2741,3578707654,3578707697,43
3,572,2742,3578707654,3578707699,45
3,572,2743,3578707654,3578707700,46
3,573,2744,3578707707,3578707707,0
3,573,2745,3578707707,3578707710,3
3,573,2746,3578707707,3578707718,11
3,573,2747,3578707707,3578707719,12
3,573,2748,3578707707,3578707721,14
3,573,2749,3578707707,3578707725,18
3,573,2750,3578707707,3578707732,25
3,573,2751,3578707707,3578707736,29
3,573,2752,3578707707,3578707738,31
3,573,2753,3578707707,3578707738,31
3,573,2754,3578707707,3578707739,32
3,573,2755,3578707707,3578707741,34
3,573,2756,3578707707,3578707744,37
3,573,2757,3578707707,3578707745,38
3,573,2758,3578707707,3578707749,42
3,573,2759,3578707707,3578707750,43
3,573,2760,3578707707,3578707750,43
3,573,2761,3578707707,3578707750,43
3,573,2762,3578707707,3578707754,47
3,574,2763,3578707760,3578707763,3
3,574,2764,3578707760,3578707764,4
3,574,2765,3578707760,3578707769,9
3,574,2766,3578707760,3578707769,9
3,574,2767,3578707760,3578707769,9
3,574,2768,3578707760,3578707771,11
3,574,2769,3578707760,3578707773,13
3,574,2770,3578707760,3578707774,14
3,574,2771,3578707760,3578707776,16
3,574,2772,3578707760,3578707777,17
3,574,2773,3578707760,3578707778,18
3,574,2774,3578707760,3578707782,22
3,574,2775,3578707760,3578707784,24
3,574,2776,3578707760,3578707787,27
3,574,2777,3578707760,3578707790,30
3,574,2778,3578707760,3578707791,31
3,574,2779,3578707760,3578707798,38
3,574,2780,3578707760,3578707801,41
3,574,2781,3578707760,3578707803,43
3,574,2782,3578707760,3578707803,43
3,574,2783,3578707760,3578707806,46
3,574,2784,3578707760,3578707810,50
3,575,2785,3578707813,3578707813,0
3,575,2786,3578707813,3578707813,0
3,575,2787,3578707813,3578707814,1
3,575,2788,3578707813,3578707816,3
3,575,2789,3578707813,3578707819,6
3,575,2790,3578707813,3578707823,10
3,575,2791,3578707813,3578707826,13
3,575,2792,3578707813,3578707827,14
3,575,2793,3578707813,3578707829,16
3,575,2794,3578707813,3578707831,18
3,575,2795,3578707813,3578707840,27
3,575,2796,3578707813,3578707841,28
3,575,2797,3578707813,3578707845,32
3,575,2798,3578707813,3578707851,38
3,575,2799,3578707813,3578707851,38
3,575,2800,3578707813,3578707851,38
3,575,2801,3578707813,3578707855,42
3,575,2802,3578707813,3578707862,49
3,576,2803,3578707866,3578707866,0
3,576,2804,3578707866,3578707868,2
3,576,2805,3578707866,3578707868,2
3,576,2806,3578707866,3578707869,3
3,576,2807,3578707866,3578707875,9
3,576,2808,3578707866,3578707876,10
3,576,2809,3578707866,3578707877,11
3,576,2810,3578707866,3578707878,12
3,576,2811,3578707866,3578707879,13
3,576,2812,3578707866,3578707886,20
3,576,2813,3578707866,3578707888,22
3,576,2814,3578707866,3578707894,28
3,576,2815,3578707866,3578707897,31
3,576,2816,3578707866,3578707898,32
3,576,2817,3578707866,3578707900,34
3,576,2818,3578707866,3578707900,34
3,576,2819,3578707866,3578707905,39
3,576,2820,3578707866,3578707911,45
3,577,2821,3578707918,3578707918,0
3,577,2822,3578707918,3578707918,0
3,577,2823,3578707918,3578707921,3
3,577,2824,3578707918,3578707925,7
3,577,2825,3578707918,3578707933,15
3,577,2826,3578707918,3578707936,18
3,577,2827,3578707918,3578707939,21
3,577,2828,3578707918,3578707939,21
3,577,2829,3578707918,3578707939,21
3,577,2830,3578707918,3578707941,23
3,577,2831,3578707918,3578707945,27
3,577,2832,3578707918,3578707945,27
3,577,2833,3578707918,3578707950,32
3,577,2834,3578707918,3578707950,32
3,577,2835,3578707918,3578707950,32
3,577,2836,3578707918,3578707951,33
3,577,2837,3578707918,3578707954,36
3,577,2838,3578707918,3578707963,45
3,577,2839,3578707918,3578707965,47
3,578,2840,3578707971,3578707971,0
3,578,2841,3578707971,3578707971,0
3,578,2842,3578707971,3578707971,0
3,578,2843,3578707971,3578707971,0
3,578,2844,3578707971,3578707974,3
3,578,2845,3578707971,3578707974,3
3,578,2846,3578707971,3578707976,5
3,578,2847,3578707971,3578707977,6
3,578,2848,3578707971,3578707978,7
3,578,2849,3578707971,3578707983,12
3,578,2850,3578707971,3578707984,13
3,578,2851,3578707971,3578707986,15
3,578,2852,3578707971,3578707987,16
3,578,2853,3578707971,3578707990,19
3,578,2854,3578707971,3578707991,20
3,578,2855,3578707971,3578707998,27
3,578,2856,3578707971,3578708001,30
3,578,2857,3578707971,3578708003,32
3,578,2858,3578707971,3578708003,32
3,578,2859,3578707971,3578708006,35
3,578,2860,3578707971,3578708009,38
3,578,2861,3578707971,3578708010,39
3,578,2862,3578707971,3578708012,41
3,578,2863,3578707971,3578708015,44
3,578,2864,3578707971,3578708016,45
3,578,2865,3578707971,3578708020,49
3,579,2866,3578708024,3578708024,0
3,579,2867,3578708024,3578708026,2
3,579,2868,3578708024,3578708027,3
3,579,2869,3578708024,3578708029,5
3,579,2870,3578708024,3578708031,7
3,579,2871,3578708024,3578708040,16
3,579,2872,3578708024,3578708041,17
3,579,2873,3578708024,3578708045,21
3,579,2874,3578708024,3578708051,27
3,579,2875,3578708024,3578708052,28
3,579,2876,3578708024,3578708052,28
3,579,2877,3578708024,3578708055,31
3,579,2878,3578708024,3578708063,39
3,579,2879,3578708024,3578708063,39
3,579,2880,3578708024,3578708065,41
3,579,2881,3578708024,3578708068,44
3,579,2882,3578708024,3578708068,44
3,579,2883,3578708024,3578708069,45
3,580,2884,3578708077,3578708077,0
3,580,2885,3578708077,3578708077,0
3,580,2886,3578708077,3578708077,0
3,580,2887,3578708077,3578708077,0
3,580,2888,3578708077,3578708078,1
3,580,2889,3578708077,3578708085,8
3,580,2890,3578708077,3578708088,11
3,580,2891,3578708077,3578708095,18
3,580,2892,3578708077,3578708097,20
3,580,2893,3578708077,3578708098,21
3,580,2894,3578708077,3578708099,22
3,580,2895,3578708077,3578708101,24
3,580,2896,3578708077,3578708106,29
3,580,2897,3578708077,3578708111,34
3,580,2898,3578708077,3578708118,41
3,580,2899,3578708077,3578708118,41
3,580,2900,3578708077,3578708120,43
3,580,2901,3578708077,3578708126,49
3,581,2902,3578708130,3578708133,3
3,581,2903,3578708130,3578708136,6
3,581,2904,3578708130,3578708138,8
3,581,2905,3578708130,3578708139,9
3,581,2906,3578708130,3578708139,9
3,581,2907,3578708130,3578708141,11
3,581,2908,3578708130,3578708145,15
3,581,2909,3578708130,3578708145,15
3,581,2910,3578708130,3578708150,20
3,581,2911,3578708130,3578708150,20
3,581,2912,3578708130,3578708150,20
3,581,2913,3578708130,3578708151,21
3,581,2914,3578708130,3578708154,24
3,581,2915,3578708130,3578708164,34
3,581,2916,3578708130,3578708166,36
3,581,2917,3578708130,3578708169,39
3,581,2918,3578708130,3578708169,39
3,581,2919,3578708130,3578708170,40
3,581,2920,3578708130,3578708171,41
3,581,2921,3578708130,3578708174,44
3,581,2922,3578708130,3578708175,45
3,581,2923,3578708130,3578708177,47
3,581,2924,3578708130,3578708178,48
3,581,2925,3578708130,3578708178,48
3,582,2926,3578708184,3578708184,0
3,582,2927,3578708184,3578708184,0
3,582,2928,3578708184,3578708186,2
3,582,2929,3578708184,3578708189,5
3,582,2930,3578708184,3578708191,7
3,582,2931,3578708184,3578708192,8
3,582,2932,3578708184,3578708198,14
3,582,2933,3578708184,3578708202,18
3,582,2934,3578708184,3578708204,20
3,582,2935,3578708184,3578708204,20
3,582,2936,3578708184,3578708206,22
3,582,2937,3578708184,3578708209,25
3,582,2938,3578708184,3578708210,26
3,582,2939,3578708184,3578708212,28
3,582,2940,3578708184,3578708215,31
3,582,2941,3578708184,3578708216,32
3,582,2942,3578708184,3578708220,36
3,582,2943,3578708184,3578708225,41
3,582,2944,3578708184,3578708226,42
3,582,2945,3578708184,3578708227,43
3,582,2946,3578708184,3578708228,44
3,582,2947,3578708184,3578708231,47
3,583,2948,3578708236,3578708239,3
3,583,2949,3578708236,3578708242,6
3,583,2950,3578708236,3578708246,10
3,583,2951,3578708236,3578708250,14
3,583,2952,3578708236,3578708252,16
3,583,2953,3578708236,3578708253,17
3,583,2954,3578708236,3578708255,19
3,583,2955,3578708236,3578708263,27
3,583,2956,3578708236,3578708263,27
3,583,2957,3578708236,3578708265,29
3,583,2958,3578708236,3578708268,32
3,583,2959,3578708236,3578708269,33
3,583,2960,3578708236,3578708270,34
3,583,2961,3578708236,3578708275,39
3,583,2962,3578708236,3578708276,40
3,583,2963,3578708236,3578708277,41
3,583,2964,3578708236,3578708277,41
3,583,2965,3578708236,3578708278,42
3,583,2966,3578708236,3578708286,50
3,584,2967,3578708289,3578708289,0
3,584,2968,3578708289,3578708294,5
3,584,2969,3578708289,3578708297,8
3,584,2970,3578708289,3578708298,9
3,584,2971,3578708289,3578708299,10
3,584,2972,3578708289,3578708300,11
3,584,2973,3578708289,3578708306,17
3,584,2974,3578708289,3578708310,21
3,584,2975,3578708289,3578708316,27
3,584,2976,3578708289,3578708318,29
3,584,2977,3578708289,3578708318,29
3,584,2978,3578708289,3578708320,31
3,584,2979,3578708289,3578708326,37
3,584,2980,3578708289,3578708333,44
3,584,2981,3578708289,3578708337,48
3,584,2982,3578708289,3578708338,49
3,584,2983,3578708289,3578708338,49
3,585,2984,3578708342,3578708342,0
3,585,2985,3578708342,3578708342,0
3,585,2986,3578708342,3578708345,3
3,585,2987,3578708342,3578708345,3
3,585,2988,3578708342,3578708350,8
3,585,2989,3578708342,3578708350,8
3,585,2990,3578708342,3578708350,8
3,585,2991,3578708342,3578708351,9
3,585,2992,3578708342,3578708354,12
3,585,2993,3578708342,3578708364,22
3,585,2994,3578708342,3578708366,24
3,585,2995,3578708342,3578708369,27
3,585,2996,3578708342,3578708369,27
3,585,2997,3578708342,3578708370,28
3,585,2998,3578708342,3578708374,32
3,585,2999,3578708342,3578708375,33
3,585,3000,3578708342,3578708376,34
3,585,3001,3578708342,3578708378,36
3,585,3002,3578708342,3578708379,37
3,585,3003,3578708342,3578708383,41
3,585,3004,3578708342,3578708384,42
3,585,3005,3578708342,3578708386,44
3,585,3006,3578708342,3578708389,47
3,585,3007,3578708342,3578708391,49
3,585,3008,3578708342,3578708392,50
3,586,3009,3578708395,3578708398,3
3,586,3010,3578708395,3578708403,8
3,586,3011,3578708395,3578708404,9
3,586,3012,3578708395,3578708404,9
3,586,3013,3578708395,3578708406,11
3,586,3014,3578708395,3578708410,15
3,586,3015,3578708395,3578708410,15
3,586,3016,3578708395,3578708413,18
3,586,3017,3578708395,3578708415,20
3,586,3018,3578708395,3578708417,22
3,586,3019,3578708395,3578708419,24
3,586,3020,3578708395,3578708424,29
3,586,3021,3578708395,3578708426,31
3,586,3022,3578708395,3578708427,32
3,586,3023,3578708395,3578708430,35
3,586,3024,3578708395,3578708432,37
3,586,3025,3578708395,3578708440,45
3,586,3026,3578708395,3578708442,47
3,587,3027,3578708447,3578708448,1
3,587,3028,3578708447,3578708451,4
3,587,3029,3578708447,3578708451,4
3,587,3030,3578708447,3578708454,7
3,587,3031,3578708447,3578708455,8
3,587,3032,3578708447,3578708462,15
3,587,3033,3578708447,3578708463,16
3,587,3034,3578708447,3578708464,17
3,587,3035,3578708447,3578708468,21
3,587,3036,3578708447,3578708469,22
3,587,3037,3578708447,3578708470,23
3,587,3038,3578708447,3578708475,28
3,587,3039,3578708447,3578708476,29
3,587,3040,3578708447,3578708477,30
3,587,3041,3578708447,3578708477,30
3,587,3042,3578708447,3578708479,32
3,587,3043,3578708447,3578708486,39
3,587,3044,3578708447,3578708488,41
3,587,3045,3578708447,3578708494,47
3,588,3046,3578708500,3578708500,0
3,588,3047,3578708500,3578708500,0
3,588,3048,3578708500,3578708500,0
3,588,3049,3578708500,3578708500,0
3,588,3050,3578708500,3578708505,5
3,588,3051,3578708500,3578708509,9
3,588,3052,3578708500,3578708515,15
3,588,3053,3578708500,3578708517,17
3,588,3054,3578708500,3578708518,18
3,588,3055,3578708500,3578708520,20
3,588,3056,3578708500,3578708525,25
3,588,3057,3578708500,3578708532,32
3,588,3058,3578708500,3578708536,36
3,588,3059,3578708500,3578708537,37
3,588,3060,3578708500,3578708537,37
3,588,3061,3578708500,3578708539,39
3,588,3062,3578708500,3578708540,40
3,588,3063,3578708500,3578708544,44
3,588,3064,3578708500,3578708549,49
3,588,3065,3578708500,3578708549,49
3,588,3066,3578708500,3578708550,50
3,589,3067,3578708553,3578708553,0
3,589,3068,3578708553,3578708553,0
3,589,3069,3578708553,3578708563,10
3,589,3070,3578708553,3578708564,11
3,589,3071,3578708553,3578708567,14
3,589,3072,3578708553,3578708568,15
3,589,3073,3578708553,3578708569,16
3,589,3074,3578708553,3578708573,20
3,589,3075,3578708553,3578708574,21
3,589,3076,3578708553,3578708575,22
3,589,3077,3578708553,3578708577,24
3,589,3078,3578708553,3578708578,25
3,589,3079,3578708553,3578708582,29
3,589,3080,3578708553,3578708583,30
3,589,3081,3578708553,3578708586,33
3,589,3082,3578708553,3578708588,35
3,589,3083,3578708553,3578708590,37
3,589,3084,3578708553,3578708597,44
3,589,3085,3578708553,3578708601,48
3,589,3086,3578708553,3578708603,50
3,590,3087,3578708606,3578708606,0
3,590,3088,3578708606,3578708606,0
3,590,3089,3578708606,3578708609,3
3,590,3090,3578708606,3578708609,3
3,590,3091,3578708606,3578708611,5
3,590,3092,3578708606,3578708614,8
3,590,3093,3578708606,3578708617,11
3,590,3094,3578708606,3578708618,12
3,590,3095,3578708606,3578708623,17
3,590,3096,3578708606,3578708625,19
3,590,3097,3578708606,3578708626,20
3,590,3098,3578708606,3578708629,23
3,590,3099,3578708606,3578708631,25
3,590,3100,3578708606,3578708638,32
3,590,3101,3578708606,3578708641,35
3,590,3102,3578708606,3578708646,40
3,590,3103,3578708606,3578708649,43
3,590,3104,3578708606,3578708650,44
3,590,3105,3578708606,3578708652,46
3,590,3106,3578708606,3578708654,48
3,591,3107,3578708659,3578708662,3
3,591,3108,3578708659,3578708662,3
3,591,3109,3578708659,3578708664,5
3,591,3110,3578708659,3578708667,8
3,591,3111,3578708659,3578708668,9
3,591,3112,3578708659,3578708669,10
3,591,3113,3578708659,3578708670,11
3,591,3114,3578708659,3578708675,16
3,591,3115,3578708659,3578708676,17
3,591,3116,3578708659,3578708677,18
3,591,3117,3578708659,3578708678,19
3,591,3118,3578708659,3578708678,19
3,591,3119,3578708659,3578708686,27
3,591,3120,3578708659,3578708690,31
3,591,3121,3578708659,3578708694,35
3,591,3122,3578708659,3578708698,39
3,591,3123,3578708659,3578708698,39
3,591,3124,3578708659,3578708699,40
3,591,3125,3578708659,3578708700,41
3,591,3126,3578708659,3578708706,47
3,592,3127,3578708712,3578708712,0
3,592,3128,3578708712,3578708715,3
3,592,3129,3578708712,3578708717,5
3,592,3130,3578708712,3578708719,7
3,592,3131,3578708712,3578708721,9
3,592,3132,3578708712,3578708725,13
3,592,3133,3578708712,3578708733,21
3,592,3134,3578708712,3578708736,24
3,592,3135,3578708712,3578708737,25
3,592,3136,3578708712,3578708738,26
3,592,3137,3578708712,3578708739,27
3,592,3138,3578708712,3578708740,28
3,592,3139,3578708712,3578708745,33
3,592,3140,3578708712,3578708745,33
3,592,3141,3578708712,3578708749,37
3,592,3142,3578708712,3578708750,38
3,592,3143,3578708712,3578708750,38
3,592,3144,3578708712,3578708750,38
3,592,3145,3578708712,3578708753,41
3,593,3146,3578708765,3578708765,0
3,593,3147,3578708765,3578708765,0
3,593,3148,3578708765,3578708768,3
3,593,3149,3578708765,3578708768,3
3,593,3150,3578708765,3578708769,4
3,593,3151,3578708765,3578708773,8
3,593,3152,3578708765,3578708774,9
3,593,3153,3578708765,3578708775,10
3,593,3154,3578708765,3578708777,12
3,593,3155,3578708765,3578708778,13
3,593,3156,3578708765,3578708782,17
3,593,3157,3578708765,3578708784,19
3,593,3158,3578708765,3578708786,21
3,593,3159,3578708765,3578708788,23
3,593,3160,3578708765,3578708790,25
3,593,3161,3578708765,3578708798,33
3,593,3162,3578708765,3578708802,37
3,593,3163,3578708765,3578708803,38
3,593,3164,3578708765,3578708804,39
3,593,3165,3578708765,3578708805,40
3,593,3166,3578708765,3578708809,44
3,593,3167,3578708765,3578708810,45
3,593,3168,3578708765,3578708811,46
3,593,3169,3578708765,3578708814,49
3,594,3170,3578708817,3578708817,0
3,594,3171,3578708817,3578708819,2
3,594,3172,3578708817,3578708823,6
3,594,3173,3578708817,3578708825,8
3,594,3174,3578708817,3578708826,9
3,594,3175,3578708817,3578708829,12
3,594,3176,3578708817,3578708831,14
3,594,3177,3578708817,3578708839,22
3,594,3178,3578708817,3578708841,24
3,594,3179,3578708817,3578708846,29
3,594,3180,3578708817,3578708850,33
3,594,3181,3578708817,3578708851,34
3,594,3182,3578708817,3578708853,36
3,594,3183,3578708817,3578708855,38
3,594,3184,3578708817,3578708861,44
3,594,3185,3578708817,3578708862,45
3,594,3186,3578708817,3578708863,46
3,594,3187,3578708817,3578708867,50
3,595,3188,3578708870,3578708870,0
3,595,3189,3578708870,3578708870,0
3,595,3190,3578708870,3578708870,0
3,595,3191,3578708870,3578708873,3
3,595,3192,3578708870,3578708875,5
3,595,3193,3578708870,3578708876,6
3,595,3194,3578708870,3578708877,7
3,595,3195,3578708870,3578708878,8
3,595,3196,3578708870,3578708879,9
3,595,3197,3578708870,3578708886,16
3,595,3198,3578708870,3578708891,21
3,595,3199,3578708870,3578708894,24
3,595,3200,3578708870,3578708897,27
3,595,3201,3578708870,3578708899,29
3,595,3202,3578708870,3578708899,29
3,595,3203,3578708870,3578708901,31
3,595,3204,3578708870,3578708905,35
3,595,3205,3578708870,3578708911,41
3,595,3206,3578708870,3578708915,45
3,595,3207,3578708870,3578708917,47
3,595,3208,3578708870,3578708918,48
3,596,3209,3578708923,3578708923,0
3,596,3210,3578708923,3578708925,2
3,596,3211,3578708923,3578708933,10
3,596,3212,3578708923,3578708936,13
3,596,3213,3578708923,3578708937,14
3,596,3214,3578708923,3578708938,15
3,596,3215,3578708923,3578708939,16
3,596,3216,3578708923,3578708940,17
3,596,3217,3578708923,3578708945,22
3,596,3218,3578708923,3578708945,22
3,596,3219,3578708923,3578708949,26
3,596,3220,3578708923,3578708950,27
3,596,3221,3578708923,3578708950,27
3,596,3222,3578708923,3578708951,28
3,596,3223,3578708923,3578708953,30
3,596,3224,3578708923,3578708964,41
3,596,3225,3578708923,3578708964,41
3,596,3226,3578708923,3578708968,45
3,596,3227,3578708923,3578708968,45
3,596,3228,3578708923,3578708969,46
3,597,3229,3578708976,3578708976,0
3,597,3230,3578708976,3578708976,0
3,597,3231,3578708976,3578708976,0
3,597,3232,3578708976,3578708976,0
3,597,3233,3578708976,3578708977,1
3,597,3234,3578708976,3578708978,2
3,597,3235,3578708976,3578708982,6
3,597,3236,3578708976,3578708984,8
3,597,3237,3578708976,3578708986,10
3,597,3238,3578708976,3578708988,12
3,597,3239,3578708976,3578708990,14
3,597,3240,3578708976,3578708991,15
3,597,3241,3578708976,3578708998,22
3,597,3242,3578708976,3578709001,25
3,597,3243,3578708976,3578709003,27
3,597,3244,3578708976,3578709004,28
3,597,3245,3578708976,3578709005,29
3,597,3246,3578708976,3578709009,33
3,597,3247,3578708976,3578709010,34
3,597,3248,3578708976,3578709011,35
3,597,3249,3578708976,3578709017,41
3,597,3250,3578708976,3578709019,43
3,597,3251,3578708976,3578709025,49
3,597,3252,3578708976,3578709026,50
3,598,3253,3578709029,3578709029,0
3,598,3254,3578709029,3578709029,0
3,598,3255,3578709029,3578709031,2
3,598,3256,3578709029,3578709039,10
3,598,3257,3578709029,3578709041,12
3,598,3258,3578709029,3578709047,18
3,598,3259,3578709029,3578709051,22
3,598,3260,3578709029,3578709052,23
3,598,3261,3578709029,3578709052,23
3,598,3262,3578709029,3578709062,33
3,598,3263,3578709029,3578709063,34
3,598,3264,3578709029,3578709063,34
3,598,3265,3578709029,3578709067,38
3,598,3266,3578709029,3578709068,39
3,598,3267,3578709029,3578709069,40
3,598,3268,3578709029,3578709069,40
3,598,3269,3578709029,3578709073,44
3,598,3270,3578709029,3578709076,47
3,598,3271,3578709029,3578709076,47
3,598,3272,3578709029,3578709077,48
3,598,3273,3578709029,3578709078,49
3,598,3274,3578709029,3578709079,50
3,599,3275,3578709082,3578709085,3
3,599,3276,3578709082,3578709091,9
3,599,3277,3578709082,3578709095,13
3,599,3278,3578709082,3578709097,15
3,599,3279,3578709082,3578709099,17
3,599,3280,3578709082,3578709100,18
3,599,3281,3578709082,3578709101,19
3,599,3282,3578709082,3578709106,24
3,599,3283,3578709082,3578709111,29
3,599,3284,3578709082,3578709115,33
3,599,3285,3578709082,3578709117,35
3,599,3286,3578709082,3578709118,36
3,599,3287,3578709082,3578709120,38
3,599,3288,3578709082,3578709126,44
3,600,3289,3578709135,3578709135,0
3,600,3290,3578709135,3578709136,1
3,600,3291,3578709135,3578709138,3
3,600,3292,3578709135,3578709138,3
3,600,3293,3578709135,3578709139,4
3,600,3294,3578709135,3578709140,5
3,600,3295,3578709135,3578709145,10
3,600,3296,3578709135,3578709145,10
3,600,3297,3578709135,3578709150,15
3,600,3298,3578709135,3578709150,15
3,600,3299,3578709135,3578709151,16
3,600,3300,3578709135,3578709151,16
3,600,3301,3578709135,3578709153,18
3,600,3302,3578709135,3578709163,28
3,600,3303,3578709135,3578709166,31
3,600,3304,3578709135,3578709168,33
3,600,3305,3578709135,3578709168,33
3,600,3306,3578709135,3578709170,35
3,600,3307,3578709135,3578709174,39
3,600,3308,3578709135,3578709174,39
3,600,3309,3578709135,3578709176,41
3,600,3310,3578709135,3578709176,41
3,600,3311,3578709135,3578709178,43
3,600,3312,3578709135,3578709178,43
3,600,3313,3578709135,3578709182,47
3,600,3314,3578709135,3578709184,49
3,601,3315,3578709188,3578709188,0
3,601,3316,3578709188,3578709188,0
3,601,3317,3578709188,3578709191,3
3,601,3318,3578709188,3578709191,3
3,601,3319,3578709188,3578709198,10
3,601,3320,3578709188,3578709202,14
3,601,3321,3578709188,3578709203,15
3,601,3322,3578709188,3578709204,16
3,601,3323,3578709188,3578709205,17
3,601,3324,3578709188,3578709209,21
3,601,3325,3578709188,3578709209,21
3,601,3326,3578709188,3578709212,24
3,601,3327,3578709188,3578709215,27
3,601,3328,3578709188,3578709217,29
3,601,3329,3578709188,3578709219,31
3,601,3330,3578709188,3578709226,38
3,601,3331,3578709188,3578709226,38
3,601,3332,3578709188,3578709227,39
3,601,3333,3578709188,3578709227,39
3,601,3334,3578709188,3578709228,40
3,601,3335,3578709188,3578709232,44
3,602,3336,3578709241,3578709241,0
3,602,3337,3578709241,3578709242,1
3,602,3338,3578709241,3578709248,7
3,602,3339,3578709241,3578709250,9
3,602,3340,3578709241,3578709251,10
3,602,3341,3578709241,3578709253,12
3,602,3342,3578709241,3578709262,21
3,602,3343,3578709241,3578709263,22
3,602,3344,3578709241,3578709264,23
3,602,3345,3578709241,3578709267,26
3,602,3346,3578709241,3578709268,27
3,602,3347,3578709241,3578709269,28
3,602,3348,3578709241,3578709269,28
3,602,3349,3578709241,3578709273,32
3,602,3350,3578709241,3578709276,35
3,602,3351,3578709241,3578709277,36
3,602,3352,3578709241,3578709277,36
3,602,3353,3578709241,3578709278,37
3,602,3354,3578709241,3578709279,38
3,602,3355,3578709241,3578709286,45
3,602,3356,3578709241,3578709288,47
3,603,3357,3578709294,3578709294,0
3,603,3358,3578709294,3578709295,1
3,603,3359,3578709294,3578709298,4
3,603,3360,3578709294,3578709299,5
3,603,3361,3578709294,3578709299,5
3,603,3362,3578709294,3578709302,8
3,603,3363,3578709294,3578709306,12
3,603,3364,3578709294,3578709311,17
3,603,3365,3578709294,3578709315,21
3,603,3366,3578709294,3578709317,23
3,603,3367,3578709294,3578709318,24
3,603,3368,3578709294,3578709321,27
3,603,3369,3578709294,3578709326,32
3,603,3370,3578709294,3578709334,40
3,603,3371,3578709294,3578709336,42
3,603,3372,3578709294,3578709338,44
3,603,3373,3578709294,3578709338,44
3,603,3374,3578709294,3578709339,45
3,603,3375,3578709294,3578709341,47
3,604,3376,3578709347,3578709347,0
3,604,3377,3578709347,3578709347,0
3,604,3378,3578709347,3578709349,2
3,604,3379,3578709347,3578709350,3
3,604,3380,3578709347,3578709350,3
3,604,3381,3578709347,3578709351,4
3,604,3382,3578709347,3578709354,7
3,604,3383,3578709347,3578709364,17
3,604,3384,3578709347,3578709366,19
3,604,3385,3578709347,3578709368,21
3,604,3386,3578709347,3578709369,22
3,604,3387,3578709347,3578709370,23
3,604,3388,3578709347,3578709374,27
3,604,3389,3578709347,3578709374,27
3,604,3390,3578709347,3578709375,28
3,604,3391,3578709347,3578709376,29
3,604,3392,3578709347,3578709378,31
3,604,3393,3578709347,3578709379,32
3,604,3394,3578709347,3578709382,35
3,604,3395,3578709347,3578709384,37
3,604,3396,3578709347,3578709385,38
3,604,3397,3578709347,3578709388,41
3,604,3398,3578709347,3578709391,44
3,604,3399,3578709347,3578709392,45
3,605,3400,3578709400,3578709400,0
3,605,3401,3578709400,3578709402,2
3,605,3402,3578709400,3578709404,4
3,605,3403,3578709400,3578709405,5
3,605,3404,3578709400,3578709406,6
3,605,3405,3578709400,3578709409,9
3,605,3406,3578709400,3578709412,12
3,605,3407,3578709400,3578709414,14
3,605,3408,3578709400,3578709418,18
3,605,3409,3578709400,3578709419,19
3,605,3410,3578709400,3578709425,25
3,605,3411,3578709400,3578709426,26
3,605,3412,3578709400,3578709427,27
3,605,3413,3578709400,3578709427,27
3,605,3414,3578709400,3578709429,29
3,605,3415,3578709400,3578709432,32
3,605,3416,3578709400,3578709435,35
3,605,3417,3578709400,3578709440,40
3,605,3418,3578709400,3578709441,41
3,605,3419,3578709400,3578709448,48
3,606,3420,3578709453,3578709453,0
3,606,3421,3578709453,3578709453,0
3,606,3422,3578709453,3578709453,0
3,606,3423,3578709453,3578709461,8
3,606,3424,3578709453,3578709463,10
3,606,3425,3578709453,3578709464,11
3,606,3426,3578709453,3578709469,16
3,606,3427,3578709453,3578709469,16
3,606,3428,3578709453,3578709469,16
3,606,3429,3578709453,3578709470,17
3,606,3430,3578709453,3578709473,20
3,606,3431,3578709453,3578709476,23
3,606,3432,3578709453,3578709477,24
3,606,3433,3578709453,3578709477,24
3,606,3434,3578709453,3578709478,25
3,606,3435,3578709453,3578709479,26
3,606,3436,3578709453,3578709486,33
3,606,3437,3578709453,3578709488,35
3,606,3438,3578709453,3578709492,39
3,606,3439,3578709453,3578709495,42
3,606,3440,3578709453,3578709498,45
3,606,3441,3578709453,3578709499,46
3,606,3442,3578709453,3578709502,49
3,607,3443,3578709506,3578709506,0
3,607,3444,3578709506,3578709514,8
3,607,3445,3578709506,3578709517,11
3,607,3446,3578709506,3578709518,12
3,607,3447,3578709506,3578709520,14
3,607,3448,3578709506,3578709525,19
3,607,3449,3578709506,3578709533,27
3,607,3450,3578709506,3578709535,29
3,607,3451,3578709506,3578709537,31
3,607,3452,3578709506,3578709538,32
3,607,3453,3578709506,3578709538,32
3,607,3454,3578709506,3578709540,34
3,607,3455,3578709506,3578709544,38
3,607,3456,3578709506,3578709546,40
3,607,3457,3578709506,3578709548,42
3,607,3458,3578709506,3578709549,43
3,607,3459,3578709506,3578709549,43
3,607,3460,3578709506,3578709550,44
3,607,3461,3578709506,3578709553,47
3,608,3462,3578709559,3578709563,4
3,608,3463,3578709559,3578709564,5
3,608,3464,3578709559,3578709568,9
3,608,3465,3578709559,3578709569,10
3,608,3466,3578709559,3578709569,10
3,608,3467,3578709559,3578709573,14
3,608,3468,3578709559,3578709573,14
3,608,3469,3578709559,3578709574,15
3,608,3470,3578709559,3578709575,16
3,608,3471,3578709559,3578709578,19
3,608,3472,3578709559,3578709582,23
3,608,3473,3578709559,3578709583,24
3,608,3474,3578709559,3578709584,25
3,608,3475,3578709559,3578709587,28
3,608,3476,3578709559,3578709590,31
3,608,3477,3578709559,3578709591,32
3,608,3478,3578709559,3578709598,39
3,608,3479,3578709559,3578709601,42
3,608,3480,3578709559,3578709603,44
3,608,3481,3578709559,3578709604,45
3,608,3482,3578709559,3578709605,46
3,608,3483,3578709559,3578709608,49
3,609,3484,3578709612,3578709612,0
3,609,3485,3578709612,3578709614,2
3,609,3486,3578709612,3578709617,5
3,609,3487,3578709612,3578709619,7
3,609,3488,3578709612,3578709625,13
3,609,3489,3578709612,3578709625,13
3,609,3490,3578709612,3578709626,14
3,609,3491,3578709612,3578709626,14
3,609,3492,3578709612,3578709629,17
3,609,3493,3578709612,3578709631,19
3,609,3494,3578709612,3578709634,22
3,609,3495,3578709612,3578709634,22
3,609,3496,3578709612,3578709638,26
3,609,3497,3578709612,3578709641,29
3,609,3498,3578709612,3578709647,35
3,609,3499,3578709612,3578709650,38
3,609,3500,3578709612,3578709651,39
3,609,3501,3578709612,3578709652,40
3,609,3502,3578709612,3578709654,42
3,609,3503,3578709612,3578709661,49
3,610,3504,3578709665,3578709665,0
3,610,3505,3578709665,3578709665,0
3,610,3506,3578709665,3578709668,3
3,610,3507,3578709665,3578709668,3
3,610,3508,3578709665,3578709669,4
3,610,3509,3578709665,3578709669,4
3,610,3510,3578709665,3578709673,8
3,610,3511,3578709665,3578709676,11
3,610,3512,3578709665,3578709677,12
3,610,3513,3578709665,3578709677,12
3,610,3514,3578709665,3578709678,13
3,610,3515,3578709665,3578709679,14
3,610,3516,3578709665,3578709686,21
3,610,3517,3578709665,3578709688,23
3,610,3518,3578709665,3578709692,27
3,610,3519,3578709665,3578709696,31
3,610,3520,3578709665,3578709698,33
3,610,3521,3578709665,3578709699,34
3,610,3522,3578709665,3578709700,35
3,610,3523,3578709665,3578709702,37
3,610,3524,3578709665,3578709705,40
3,610,3525,3578709665,3578709714,49
3,611,3526,3578709718,3578709718,0
3,611,3527,3578709718,3578709719,1
3,611,3528,3578709718,3578709720,2
3,611,3529,3578709718,3578709725,7
3,611,3530,3578709718,3578709734,16
3,611,3531,3578709718,3578709736,18
3,611,3532,3578709718,3578709737,19
3,611,3533,3578709718,3578709737,19
3,611,3534,3578709718,3578709738,20
3,611,3535,3578709718,3578709740,22
3,611,3536,3578709718,3578709745,27
3,611,3537,3578709718,3578709746,28
3,611,3538,3578709718,3578709748,30
3,611,3539,3578709718,3578709749,31
3,611,3540,3578709718,3578709749,31
3,611,3541,3578709718,3578709750,32
3,611,3542,3578709718,3578709753,35
3,611,3543,3578709718,3578709763,45
3,611,3544,3578709718,3578709764,46
3,611,3545,3578709718,3578709767,49
3,612,3546,3578709771,3578709771,0
3,612,3547,3578709771,3578709771,0
3,612,3548,3578709771,3578709774,3
3,612,3549,3578709771,3578709774,3
3,612,3550,3578709771,3578709775,4
3,612,3551,3578709771,3578709777,6
3,612,3552,3578709771,3578709782,11
3,612,3553,3578709771,3578709783,12
3,612,3554,3578709771,3578709786,15
3,612,3555,3578709771,3578709787,16
3,612,3556,3578709771,3578709790,19
3,612,3557,3578709771,3578709791,20
3,612,3558,3578709771,3578709798,27
3,612,3559,3578709771,3578709802,31
3,612,3560,3578709771,3578709804,33
3,612,3561,3578709771,3578709804,33
3,612,3562,3578709771,3578709805,34
3,612,3563,3578709771,3578709808,37
3,612,3564,3578709771,3578709810,39
3,612,3565,3578709771,3578709810,39
3,612,3566,3578709771,3578709813,42
3,612,3567,3578709771,3578709817,46
3,612,3568,3578709771,3578709820,49
3,613,3569,3578709824,3578709825,1
3,613,3570,3578709824,3578709826,2
3,613,3571,3578709824,3578709826,2
3,613,3572,3578709824,3578709826,2
3,613,3573,3578709824,3578709829,5
3,613,3574,3578709824,3578709832,8
3,613,3575,3578709824,3578709833,9
3,613,3576,3578709824,3578709834,10
3,613,3577,3578709824,3578709838,14
3,613,3578,3578709824,3578709841,17
3,613,3579,3578709824,3578709847,23
3,613,3580,3578709824,3578709850,26
3,613,3581,3578709824,3578709851,27
3,613,3582,3578709824,3578709852,28
3,613,3583,3578709824,3578709855,31
3,613,3584,3578709824,3578709862,38
3,613,3585,3578709824,3578709862,38
3,613,3586,3578709824,3578709863,39
3,613,3587,3578709824,3578709868,44
3,613,3588,3578709824,3578709868,44
3,613,3589,3578709824,3578709869,45
3,613,3590,3578709824,3578709869,45
3,613,3591,3578709824,3578709873,49
3,614,3592,3578709877,3578709877,0
3,614,3593,3578709877,3578709877,0
3,614,3594,3578709877,3578709878,1
3,614,3595,3578709877,3578709878,1
3,614,3596,3578709877,3578709878,1
3,614,3597,3578709877,3578709885,8
3,614,3598,3578709877,3578709889,12
3,614,3599,3578709877,3578709892,15
3,614,3600,3578709877,3578709897,20
3,614,3601,3578709877,3578709897,20
3,614,3602,3578709877,3578709899,22
3,614,3603,3578709877,3578709900,23
3,614,3604,3578709877,3578709902,25
3,614,3605,3578709877,3578709906,29
3,614,3606,3578709877,3578709911,34
3,614,3607,3578709877,3578709914,37
3,614,3608,3578709877,3578709917,40
3,614,3609,3578709877,3578709919,42
3,614,3610,3578709877,3578709920,43
3,614,3611,3578709877,3578709924,47
3,615,3612,3578709930,3578709934,4
3,615,3613,3578709930,3578709936,6
3,615,3614,3578709930,3578709937,7
3,615,3615,3578709930,3578709938,8
3,615,3616,3578709930,3578709939,9
3,615,3617,3578709930,3578709939,9
3,615,3618,3578709930,3578709940,10
3,615,3619,3578709930,3578709945,15
3,615,3620,3578709930,3578709945,15
3,615,3621,3578709930,3578709949,19
3,615,3622,3578709930,3578709950,20
3,615,3623,3578709930,3578709951,21
3,615,3624,3578709930,3578709951,21
3,615,3625,3578709930,3578709953,23
3,615,3626,3578709930,3578709964,34
3,615,3627,3578709930,3578709964,34
3,615,3628,3578709930,3578709967,37
3,615,3629,3578709930,3578709968,38
3,615,3630,3578709930,3578709970,40
3,615,3631,3578709930,3578709974,44
3,615,3632,3578709930,3578709974,44
3,615,3633,3578709930,3578709975,45
3,615,3634,3578709930,3578709976,46
3,615,3635,3578709930,3578709978,48
3,615,3636,3578709930,3578709978,48
3,616,3637,3578709983,3578709983,0
3,616,3638,3578709983,3578709984,1
3,616,3639,3578709983,3578709985,2
3,616,3640,3578709983,3578709987,4
3,616,3641,3578709983,3578709989,6
3,616,3642,3578709983,3578709990,7
3,616,3643,3578709983,3578709990,7
3,616,3644,3578709983,3578709998,15
3,616,3645,3578709983,3578710001,18
3,616,3646,3578709983,3578710003,20
3,616,3647,3578709983,3578710004,21
3,616,3648,3578709983,3578710005,22
3,616,3649,3578709983,3578710008,25
3,616,3650,3578709983,3578710010,27
3,616,3651,3578709983,3578710012,29
3,616,3652,3578709983,3578710015,32
3,616,3653,3578709983,3578710017,34
3,616,3654,3578709983,3578710026,43
3,616,3655,3578709983,3578710026,43
3,616,3656,3578709983,3578710026,43
3,616,3657,3578709983,3578710027,44
3,616,3658,3578709983,3578710029,46
3,616,3659,3578709983,3578710031,48
3,617,3660,3578710036,3578710036,0
3,617,3661,3578710036,3578710036,0
3,617,3662,3578710036,3578710039,3
3,617,3663,3578710036,3578710040,4
3,617,3664,3578710036,3578710047,11
3,617,3665,3578710036,3578710051,15
3,617,3666,3578710036,3578710051,15
3,617,3667,3578710036,3578710052,16
3,617,3668,3578710036,3578710055,19
3,617,3669,3578710036,3578710062,26
3,617,3670,3578710036,3578710063,27
3,617,3671,3578710036,3578710064,28
3,617,3672,3578710036,3578710068,32
3,617,3673,3578710036,3578710069,33
3,617,3674,3578710036,3578710069,33
3,617,3675,3578710036,3578710070,34
3,617,3676,3578710036,3578710073,37
3,617,3677,3578710036,3578710077,41
3,617,3678,3578710036,3578710077,41
3,617,3679,3578710036,3578710078,42
3,617,3680,3578710036,3578710078,42
3,617,3681,3578710036,3578710079,43
3,618,3682,3578710088,3578710088,0
3,618,3683,3578710088,3578710089,1
3,618,3684,3578710088,3578710092,4
3,618,3685,3578710088,3578710097,9
3,618,3686,3578710088,3578710098,10
3,618,3687,3578710088,3578710099,11
3,618,3688,3578710088,3578710100,12
3,618,3689,3578710088,3578710102,14
3,618,3690,3578710088,3578710106,18
3,618,3691,3578710088,3578710111,23
3,618,3692,3578710088,3578710115,27
3,618,3693,3578710088,3578710117,29
3,618,3694,3578710088,3578710119,31
3,618,3695,3578710088,3578710121,33
3,618,3696,3578710088,3578710126,38
3,618,3697,3578710088,3578710134,46
3,618,3698,3578710088,3578710136,48
3,618,3699,3578710088,3578710138,50
3,619,3700,3578710141,3578710141,0
3,619,3701,3578710141,3578710141,0
3,619,3702,3578710141,3578710141,0
3,619,3703,3578710141,3578710141,0
3,619,3704,3578710141,3578710145,4
3,619,3705,3578710141,3578710146,5
3,619,3706,3578710141,3578710148,7
3,619,3707,3578710141,3578710150,9
3,619,3708,3578710141,3578710150,9
3,619,3709,3578710141,3578710151,10
3,619,3710,3578710141,3578710153,12
3,619,3711,3578710141,3578710164,23
3,619,3712,3578710141,3578710165,24
3,619,3713,3578710141,3578710167,26
3,619,3714,3578710141,3578710168,27
3,619,3715,3578710141,3578710170,29
3,619,3716,3578710141,3578710173,32
3,619,3717,3578710141,3578710174,33
3,619,3718,3578710141,3578710175,34
3,619,3719,3578710141,3578710177,36
3,619,3720,3578710141,3578710177,36
3,619,3721,3578710141,3578710178,37
3,619,3722,3578710141,3578710182,41
3,619,3723,3578710141,3578710184,43
3,619,3724,3578710141,3578710186,45
3,619,3725,3578710141,3578710188,47
3,619,3726,3578710141,3578710189,48
3,619,3727,3578710141,3578710191,50
3,620,3728,3578710194,3578710194,0
3,620,3729,3578710194,3578710198,4
3,620,3730,3578710194,3578710202,8
3,620,3731,3578710194,3578710203,9
3,620,3732,3578710194,3578710204,10
3,620,3733,3578710194,3578710204,10
3,620,3734,3578710194,3578710208,14
3,620,3735,3578710194,3578710210,16
3,620,3736,3578710194,3578710212,18
3,620,3737,3578710194,3578710215,21
3,620,3738,3578710194,3578710217,23
3,620,3739,3578710194,3578710225,31
3,620,3740,3578710194,3578710226,32
3,620,3741,3578710194,3578710227,33
3,620,3742,3578710194,3578710227,33
3,620,3743,3578710194,3578710229,35
3,620,3744,3578710194,3578710232,38
3,620,3745,3578710194,3578710233,39
3,620,3746,3578710194,3578710234,40
3,620,3747,3578710194,3578710240,46
3,620,3748,3578710194,3578710242,48
3,621,3749,3578710247,3578710247,0
3,621,3750,3578710247,3578710251,4
3,621,3751,3578710247,3578710252,5
3,621,3752,3578710247,3578710252,5
3,621,3753,3578710247,3578710255,8
3,621,3754,3578710247,3578710262,15
3,621,3755,3578710247,3578710263,16
3,621,3756,3578710247,3578710264,17
3,621,3757,3578710247,3578710268,21
3,621,3758,3578710247,3578710270,23
3,621,3759,3578710247,3578710270,23
3,621,3760,3578710247,3578710270,23
3,621,3761,3578710247,3578710273,26
3,621,3762,3578710247,3578710276,29
3,621,3763,3578710247,3578710276,29
3,621,3764,3578710247,3578710278,31
3,621,3765,3578710247,3578710278,31
3,621,3766,3578710247,3578710279,32
3,621,3767,3578710247,3578710286,39
3,621,3768,3578710247,3578710289,42
3,621,3769,3578710247,3578710292,45
3,621,3770,3578710247,3578710297,50
3,622,3771,3578710301,3578710301,0
3,622,3772,3578710301,3578710301,0
3,622,3773,3578710301,3578710301,0
3,622,3774,3578710301,3578710302,1
3,622,3775,3578710301,3578710306,5
3,622,3776,3578710301,3578710310,9
3,622,3777,3578710301,3578710315,14
3,622,3778,3578710301,3578710317,16
3,622,3779,3578710301,3578710319,18
3,622,3780,3578710301,3578710320,19
3,622,3781,3578710301,3578710326,25
3,622,3782,3578710301,3578710334,33
3,622,3783,3578710301,3578710337,36
3,622,3784,3578710301,3578710337,36
3,622,3785,3578710301,3578710339,38
3,622,3786,3578710301,3578710339,38
3,622,3787,3578710301,3578710341,40
3,622,3788,3578710301,3578710341,40
3,622,3789,3578710301,3578710345,44
3,622,3790,3578710301,3578710346,45
3,622,3791,3578710301,3578710349,48
3,622,3792,3578710301,3578710350,49
3,622,3793,3578710301,3578710351,50
3,623,3794,3578710354,3578710354,0
3,623,3795,3578710354,3578710354,0
3,623,3796,3578710354,3578710364,10
3,623,3797,3578710354,3578710365,11
3,623,3798,3578710354,3578710368,14
3,623,3799,3578710354,3578710368,14
3,623,3800,3578710354,3578710370,16
3,623,3801,3578710354,3578710374,20
3,623,3802,3578710354,3578710374,20
3,623,3803,3578710354,3578710375,21
3,623,3804,3578710354,3578710378,24
3,623,3805,3578710354,3578710379,25
3,623,3806,3578710354,3578710379,25
3,623,3807,3578710354,3578710382,28
3,623,3808,3578710354,3578710383,29
3,623,3809,3578710354,3578710386,32
3,623,3810,3578710354,3578710389,35
3,623,3811,3578710354,3578710389,35
3,623,3812,3578710354,3578710391,37
3,623,3813,3578710354,3578710399,45
3,623,3814,3578710354,3578710402,48
3,624,3815,3578710406,3578710406,0
3,624,3816,3578710406,3578710406,0
3,624,3817,3578710406,3578710406,0
3,624,3818,3578710406,3578710409,3
3,624,3819,3578710406,3578710410,4
3,624,3820,3578710406,3578710412,6
3,624,3821,3578710406,3578710415,9
3,624,3822,3578710406,3578710417,11
3,624,3823,3578710406,3578710420,14
3,624,3824,3578710406,3578710426,20
3,624,3825,3578710406,3578710426,20
3,624,3826,3578710406,3578710426,20
3,624,3827,3578710406,3578710427,21
3,624,3828,3578710406,3578710429,23
3,624,3829,3578710406,3578710432,26
3,624,3830,3578710406,3578710434,28
3,624,3831,3578710406,3578710439,33
3,624,3832,3578710406,3578710443,37
3,624,3833,3578710406,3578710445,39
3,624,3834,3578710406,3578710447,41
3,624,3835,3578710406,3578710451,45
3,624,3836,3578710406,3578710451,45
3,624,3837,3578710406,3578710452,46
3,624,3838,3578710406,3578710455,49
3,625,3839,3578710459,3578710462,3
3,625,3840,3578710459,3578710463,4
3,625,3841,3578710459,3578710464,5
3,625,3842,3578710459,3578710468,9
3,625,3843,3578710459,3578710469,10
3,625,3844,3578710459,3578710470,11
3,625,3845,3578710459,3578710470,11
3,625,3846,3578710459,3578710473,14
3,625,3847,3578710459,3578710476,17
3,625,3848,3578710459,3578710476,17
3,625,3849,3578710459,3578710478,19
3,625,3850,3578710459,3578710478,19
3,625,3851,3578710459,3578710479,20
3,625,3852,3578710459,3578710486,27
3,625,3853,3578710459,3578710489,30
3,625,3854,3578710459,3578710492,33
3,625,3855,3578710459,3578710496,37
3,625,3856,3578710459,3578710498,39
3,625,3857,3578710459,3578710500,41
3,625,3858,3578710459,3578710500,41
3,625,3859,3578710459,3578710502,43
3,625,3860,3578710459,3578710505,46
3,626,3861,3578710513,3578710513,0
3,626,3862,3578710513,3578710514,1
3,626,3863,3578710513,3578710517,4
3,626,3864,3578710513,3578710518,5
3,626,3865,3578710513,3578710520,7
3,626,3866,3578710513,3578710525,12
3,626,3867,3578710513,3578710533,20
3,626,3868,3578710513,3578710536,23
3,626,3869,3578710513,3578710538,25
3,626,3870,3578710513,3578710538,25
3,626,3871,3578710513,3578710539,26
3,626,3872,3578710513,3578710540,27
3,626,3873,3578710513,3578710544,31
3,626,3874,3578710513,3578710545,32
3,626,3875,3578710513,3578710546,33
3,626,3876,3578710513,3578710547,34
3,626,3877,3578710513,3578710549,36
3,626,3878,3578710513,3578710549,36
3,626,3879,3578710513,3578710550,37
3,626,3880,3578710513,3578710553,40
3,626,3881,3578710513,3578710563,50
3,627,3882,3578710567,3578710567,0
3,627,3883,3578710567,3578710567,0
3,627,3884,3578710567,3578710568,1
3,627,3885,3578710567,3578710569,2
3,627,3886,3578710567,3578710573,6
3,627,3887,3578710567,3578710574,7
3,627,3888,3578710567,3578710576,9
3,627,3889,3578710567,3578710578,11
3,627,3890,3578710567,3578710578,11
3,627,3891,3578710567,3578710582,15
3,627,3892,3578710567,3578710583,16
3,627,3893,3578710567,3578710585,18
3,627,3894,3578710567,3578710588,21
3,627,3895,3578710567,3578710590,23
3,627,3896,3578710567,3578710597,30
3,627,3897,3578710567,3578710601,34
3,627,3898,3578710567,3578710605,38
3,627,3899,3578710567,3578710606,39
3,627,3900,3578710567,3578710608,41
3,627,3901,3578710567,3578710609,42
3,627,3902,3578710567,3578710611,44
3,627,3903,3578710567,3578710616,49
3,628,3904,3578710620,3578710620,0
3,628,3905,3578710620,3578710624,4
3,628,3906,3578710620,3578710625,5
3,628,3907,3578710620,3578710626,6
3,628,3908,3578710620,3578710626,6
3,628,3909,3578710620,3578710628,8
3,628,3910,3578710620,3578710631,11
3,628,3911,3578710620,3578710633,13
3,628,3912,3578710620,3578710639,19
3,628,3913,3578710620,3578710642,22
3,628,3914,3578710620,3578710645,25
3,628,3915,3578710620,3578710645,25
3,628,3916,3578710620,3578710651,31
3,628,3917,3578710620,3578710651,31
3,628,3918,3578710620,3578710651,31
3,628,3919,3578710620,3578710654,34
3,628,3920,3578710620,3578710661,41
3,628,3921,3578710620,3578710662,42
3,628,3922,3578710620,3578710662,42
3,628,3923,3578710620,3578710667,47
3,628,3924,3578710620,3578710669,49
3,628,3925,3578710620,3578710669,49
3,628,3926,3578710620,3578710669,49
3,629,3927,3578710673,3578710676,3
3,629,3928,3578710673,3578710677,4
3,629,3929,3578710673,3578710678,5
3,629,3930,3578710673,3578710679,6
3,629,3931,3578710673,3578710686,13
3,629,3932,3578710673,3578710689,16
3,629,3933,3578710673,3578710693,20
3,629,3934,3578710673,3578710697,24
3,629,3935,3578710673,3578710698,25
3,629,3936,3578710673,3578710699,26
3,629,3937,3578710673,3578710700,27
3,629,3938,3578710673,3578710702,29
3,629,3939,3578710673,3578710706,33
3,629,3940,3578710673,3578710711,38
3,629,3941,3578710673,3578710715,42
3,629,3942,3578710673,3578710717,44
3,629,3943,3578710673,3578710719,46
3,629,3944,3578710673,3578710720,47
3,630,3945,3578710727,3578710727,0
3,630,3946,3578710727,3578710732,5
3,630,3947,3578710727,3578710736,9
3,630,3948,3578710727,3578710737,10
3,630,3949,3578710727,3578710738,11
3,630,3950,3578710727,3578710739,12
3,630,3951,3578710727,3578710740,13
3,630,3952,3578710727,3578710740,13
3,630,3953,3578710727,3578710744,17
3,630,3954,3578710727,3578710745,18
3,630,3955,3578710727,3578710747,20
3,630,3956,3578710727,3578710748,21
3,630,3957,3578710727,3578710749,22
3,630,3958,3578710727,3578710749,22
3,630,3959,3578710727,3578710750,23
3,630,3960,3578710727,3578710753,26
3,630,3961,3578710727,3578710763,36
3,630,3962,3578710727,3578710764,37
3,630,3963,3578710727,3578710768,41
3,630,3964,3578710727,3578710769,42
3,630,3965,3578710727,3578710769,42
3,630,3966,3578710727,3578710774,47
3,630,3967,3578710727,3578710774,47
3,630,3968,3578710727,3578710774,47
3,631,3969,3578710780,3578710780,0
3,631,3970,3578710780,3578710780,0
3,631,3971,3578710780,3578710782,2
3,631,3972,3578710780,3578710784,4
3,631,3973,3578710780,3578710786,6
3,631,3974,3578710780,3578710787,7
3,631,3975,3578710780,3578710788,8
3,631,3976,3578710780,3578710790,10
3,631,3977,3578710780,3578710791,11
3,631,3978,3578710780,3578710798,18
3,631,3979,3578710780,3578710802,22
3,631,3980,3578710780,3578710805,25
3,631,3981,3578710780,3578710806,26
3,631,3982,3578710780,3578710808,28
3,631,3983,3578710780,3578710810,30
3,631,3984,3578710780,3578710810,30
3,631,3985,3578710780,3578710817,37
3,631,3986,3578710780,3578710819,39
3,631,3987,3578710780,3578710825,45
3,631,3988,3578710780,3578710825,45
3,631,3989,3578710780,3578710826,46
3,631,3990,3578710780,3578710827,47
3,631,3991,3578710780,3578710829,49
3,632,3992,3578710833,3578710833,0
3,632,3993,3578710833,3578710833,0
3,632,3994,3578710833,3578710838,5
3,632,3995,3578710833,3578710842,9
3,632,3996,3578710833,3578710845,12
3,632,3997,3578710833,3578710846,13
3,632,3998,3578710833,3578710850,17
3,632,3999,3578710833,3578710850,17
3,632,4000,3578710833,3578710852,19
3,632,4001,3578710833,3578710854,21
3,632,4002,3578710833,3578710862,29
3,632,4003,3578710833,3578710862,29
3,632,4004,3578710833,3578710863,30
3,632,4005,3578710833,3578710868,35
3,632,4006,3578710833,3578710868,35
3,632,4007,3578710833,3578710869,36
3,632,4008,3578710833,3578710870,37
3,632,4009,3578710833,3578710874,41
3,632,4010,3578710833,3578710876,43
3,632,4011,3578710833,3578710876,43
3,632,4012,3578710833,3578710877,44
3,632,4013,3578710833,3578710878,45
3,632,4014,3578710833,3578710880,47
3,633,4015,3578710886,3578710886,0
3,633,4016,3578710886,3578710888,2
3,633,4017,3578710886,3578710894,8
3,633,4018,3578710886,3578710896,10
3,633,4019,3578710886,3578710898,12
3,633,4020,3578710886,3578710900,14
3,633,4021,3578710886,3578710900,14
3,633,4022,3578710886,3578710902,16
3,633,4023,3578710886,3578710905,19
3,633,4024,3578710886,3578710911,25
3,633,4025,3578710886,3578710915,29
3,633,4026,3578710886,3578710918,32
3,633,4027,3578710886,3578710919,33
3,633,4028,3578710886,3578710921,35
3,633,4029,3578710886,3578710924,38
3,633,4030,3578710886,3578710932,46
3,633,4031,3578710886,3578710936,50
3,634,4032,3578710939,3578710939,0
3,634,4033,3578710939,3578710939,0
3,634,4034,3578710939,3578710939,0
3,634,4035,3578710939,3578710940,1
3,634,4036,3578710939,3578710940,1
3,634,4037,3578710939,3578710944,5
3,634,4038,3578710939,3578710945,6
3,634,4039,3578710939,3578710947,8
3,634,4040,3578710939,3578710948,9
3,634,4041,3578710939,3578710950,11
3,634,4042,3578710939,3578710950,11
3,634,4043,3578710939,3578710951,12
3,634,4044,3578710939,3578710953,14
3,634,4045,3578710939,3578710953,14
3,634,4046,3578710939,3578710964,25
3,634,4047,3578710939,3578710964,25
3,634,4048,3578710939,3578710968,29
3,634,4049,3578710939,3578710969,30
3,634,4050,3578710939,3578710969,30
3,634,4051,3578710939,3578710974,35
3,634,4052,3578710939,3578710974,35
3,634,4053,3578710939,3578710974,35
3,634,4054,3578710939,3578710979,40
3,634,4055,3578710939,3578710979,40
3,634,4056,3578710939,3578710982,43
3,634,4057,3578710939,3578710984,45
3,634,4058,3578710939,3578710986,47
3,634,4059,3578710939,3578710987,48
3,634,4060,3578710939,3578710988,49
3,635,4061,3578710992,3578710992,0
3,635,4062,3578710992,3578710992,0
3,635,4063,3578710992,3578710998,6
3,635,4064,3578710992,3578711002,10
3,635,4065,3578710992,3578711005,13
3,635,4066,3578710992,3578711006,14
3,635,4067,3578710992,3578711008,16
3,635,4068,3578710992,3578711009,17
3,635,4069,3578710992,3578711011,19
3,635,4070,3578710992,3578711015,23
3,635,4071,3578710992,3578711017,25
3,635,4072,3578710992,3578711020,28
3,635,4073,3578710992,3578711024,32
3,635,4074,3578710992,3578711026,34
3,635,4075,3578710992,3578711026,34
3,635,4076,3578710992,3578711026,34
3,635,4077,3578710992,3578711029,37
3,635,4078,3578710992,3578711033,41
3,635,4079,3578710992,3578711033,41
3,635,4080,3578710992,3578711040,48
3,636,4081,3578711045,3578711045,0
3,636,4082,3578711045,3578711045,0
3,636,4083,3578711045,3578711046,1
3,636,4084,3578711045,3578711051,6
3,636,4085,3578711045,3578711052,7
3,636,4086,3578711045,3578711052,7
3,636,4087,3578711045,3578711054,9
3,636,4088,3578711045,3578711062,17
3,636,4089,3578711045,3578711063,18
3,636,4090,3578711045,3578711064,19
3,636,4091,3578711045,3578711068,23
3,636,4092,3578711045,3578711068,23
3,636,4093,3578711045,3578711069,24
3,636,4094,3578711045,3578711070,25
3,636,4095,3578711045,3578711074,29
3,636,4096,3578711045,3578711076,31
3,636,4097,3578711045,3578711076,31
3,636,4098,3578711045,3578711078,33
3,636,4099,3578711045,3578711078,33
3,636,4100,3578711045,3578711080,35
3,636,4101,3578711045,3578711084,39
3,636,4102,3578711045,3578711086,41
3,636,4103,3578711045,3578711088,43
3,636,4104,3578711045,3578711093,48
3,637,4105,3578711098,3578711098,0
3,637,4106,3578711098,3578711098,0
3,637,4107,3578711098,3578711099,1
3,637,4108,3578711098,3578711100,2
3,637,4109,3578711098,3578711102,4
3,637,4110,3578711098,3578711106,8
3,637,4111,3578711098,3578711111,13
3,637,4112,3578711098,3578711115,17
3,637,4113,3578711098,3578711117,19
3,637,4114,3578711098,3578711119,21
3,637,4115,3578711098,3578711121,23
3,637,4116,3578711098,3578711126,28
3,637,4117,3578711098,3578711136,38
3,637,4118,3578711098,3578711138,40
3,637,4119,3578711098,3578711138,40
3,637,4120,3578711098,3578711140,42
3,637,4121,3578711098,3578711140,42
3,637,4122,3578711098,3578711144,46
3,637,4123,3578711098,3578711145,47
3,637,4124,3578711098,3578711147,49
3,638,4125,3578711151,3578711151,0
3,638,4126,3578711151,3578711151,0
3,638,4127,3578711151,3578711151,0
3,638,4128,3578711151,3578711152,1
3,638,4129,3578711151,3578711153,2
3,638,4130,3578711151,3578711153,2
3,638,4131,3578711151,3578711164,13
3,638,4132,3578711151,3578711165,14
3,638,4133,3578711151,3578711168,17
3,638,4134,3578711151,3578711168,17
3,638,4135,3578711151,3578711170,19
3,638,4136,3578711151,3578711174,23
3,638,4137,3578711151,3578711174,23
3,638,4138,3578711151,3578711175,24
3,638,4139,3578711151,3578711179,28
3,638,4140,3578711151,3578711180,29
3,638,4141,3578711151,3578711182,31
3,638,4142,3578711151,3578711184,33
3,638,4143,3578711151,3578711185,34
3,638,4144,3578711151,3578711188,37
3,638,4145,3578711151,3578711189,38
3,638,4146,3578711151,3578711191,40
3,638,4147,3578711151,3578711192,41
3,638,4148,3578711151,3578711198,47
3,639,4149,3578711204,3578711204,0
3,639,4150,3578711204,3578711205,1
3,639,4151,3578711204,3578711205,1
3,639,4152,3578711204,3578711208,4
3,639,4153,3578711204,3578711209,5
3,639,4154,3578711204,3578711212,8
3,639,4155,3578711204,3578711215,11
3,639,4156,3578711204,3578711217,13
3,639,4157,3578711204,3578711221,17
3,639,4158,3578711204,3578711225,21
3,639,4159,3578711204,3578711226,22
3,639,4160,3578711204,3578711226,22
3,639,4161,3578711204,3578711227,23
3,639,4162,3578711204,3578711228,24
3,639,4163,3578711204,3578711233,29
3,639,4164,3578711204,3578711233,29
3,639,4165,3578711204,3578711239,35
3,639,4166,3578711204,3578711242,38
3,639,4167,3578711204,3578711245,41
3,639,4168,3578711204,3578711246,42
3,639,4169,3578711204,3578711250,46
3,639,4170,3578711204,3578711251,47
3,639,4171,3578711204,3578711253,49
3,640,4172,3578711257,3578711257,0
3,640,4173,3578711257,3578711261,4
3,640,4174,3578711257,3578711263,6
3,640,4175,3578711257,3578711263,6
3,640,4176,3578711257,3578711268,11
3,640,4177,3578711257,3578711268,11
3,640,4178,3578711257,3578711269,12
3,640,4179,3578711257,3578711271,14
3,640,4180,3578711257,3578711275,18
3,640,4181,3578711257,3578711276,19
3,640,4182,3578711257,3578711276,19
3,640,4183,3578711257,3578711277,20
3,640,4184,3578711257,3578711278,21
3,640,4185,3578711257,3578711279,22
3,640,4186,3578711257,3578711285,28
3,640,4187,3578711257,3578711285,28
3,640,4188,3578711257,3578711288,31
3,640,4189,3578711257,3578711293,36
3,640,4190,3578711257,3578711296,39
3,640,4191,3578711257,3578711298,41
3,640,4192,3578711257,3578711299,42
3,640,4193,3578711257,3578711300,43
3,640,4194,3578711257,3578711303,46
3,640,4195,3578711257,3578711306,49
3,641,4196,3578711310,3578711311,1
3,641,4197,3578711310,3578711315,5
3,641,4198,3578711310,3578711317,7
3,641,4199,3578711310,3578711318,8
3,641,4200,3578711310,3578711320,10
3,641,4201,3578711310,3578711326,16
3,641,4202,3578711310,3578711337,27
3,641,4203,3578711310,3578711338,28
3,641,4204,3578711310,3578711338,28
3,641,4205,3578711310,3578711338,28
3,641,4206,3578711310,3578711339,29
3,641,4207,3578711310,3578711340,30
3,641,4208,3578711310,3578711345,35
3,641,4209,3578711310,3578711345,35
3,641,4210,3578711310,3578711346,36
3,641,4211,3578711310,3578711348,38
3,641,4212,3578711310,3578711350,40
3,641,4213,3578711310,3578711350,40
3,641,4214,3578711310,3578711352,42
3,641,4215,3578711310,3578711353,43
3,641,4216,3578711310,3578711358,48
3,642,4217,3578711364,3578711364,0
3,642,4218,3578711364,3578711366,2
3,642,4219,3578711364,3578711368,4
3,642,4220,3578711364,3578711369,5
3,642,4221,3578711364,3578711370,6
3,642,4222,3578711364,3578711374,10
3,642,4223,3578711364,3578711374,10
3,642,4224,3578711364,3578711375,11
3,642,4225,3578711364,3578711376,12
3,642,4226,3578711364,3578711379,15
3,642,4227,3578711364,3578711379,15
3,642,4228,3578711364,3578711382,18
3,642,4229,3578711364,3578711384,20
3,642,4230,3578711364,3578711385,21
3,642,4231,3578711364,3578711388,24
3,642,4232,3578711364,3578711389,25
3,642,4233,3578711364,3578711391,27
3,642,4234,3578711364,3578711392,28
3,642,4235,3578711364,3578711403,39
3,642,4236,3578711364,3578711405,41
3,642,4237,3578711364,3578711406,42
3,642,4238,3578711364,3578711408,44
3,642,4239,3578711364,3578711409,45
3,642,4240,3578711364,3578711410,46
3,642,4241,3578711364,3578711412,48
3,643,4242,3578711418,3578711418,0
3,643,4243,3578711418,3578711418,0
3,643,4244,3578711418,3578711421,3
3,643,4245,3578711418,3578711425,7
3,643,4246,3578711418,3578711426,8
3,643,4247,3578711418,3578711426,8
3,643,4248,3578711418,3578711427,9
3,643,4249,3578711418,3578711430,12
3,643,4250,3578711418,3578711432,14
3,643,4251,3578711418,3578711434,16
3,643,4252,3578711418,3578711439,21
3,643,4253,3578711418,3578711443,25
3,643,4254,3578711418,3578711445,27
3,643,4255,3578711418,3578711446,28
3,643,4256,3578711418,3578711450,32
3,643,4257,3578711418,3578711451,33
3,643,4258,3578711418,3578711452,34
3,643,4259,3578711418,3578711454,36
3,643,4260,3578711418,3578711462,44
3,643,4261,3578711418,3578711463,45
3,643,4262,3578711418,3578711464,46
3,644,4263,3578711471,3578711471,0
3,644,4264,3578711471,3578711471,0
3,644,4265,3578711471,3578711471,0
3,644,4266,3578711471,3578711471,0
3,644,4267,3578711471,3578711475,4
3,644,4268,3578711471,3578711476,5
3,644,4269,3578711471,3578711476,5
3,644,4270,3578711471,3578711477,6
3,644,4271,3578711471,3578711478,7
3,644,4272,3578711471,3578711480,9
3,644,4273,3578711471,3578711484,13
3,644,4274,3578711471,3578711486,15
3,644,4275,3578711471,3578711488,17
3,644,4276,3578711471,3578711494,23
3,644,4277,3578711471,3578711497,26
3,644,4278,3578711471,3578711498,27
3,644,4279,3578711471,3578711499,28
3,644,4280,3578711471,3578711500,29
3,644,4281,3578711471,3578711502,31
3,644,4282,3578711471,3578711506,35
3,644,4283,3578711471,3578711511,40
3,644,4284,3578711471,3578711516,45
3,644,4285,3578711471,3578711518,47
3,644,4286,3578711471,3578711519,48
3,644,4287,3578711471,3578711521,50
3,645,4288,3578711524,3578711525,1
3,645,4289,3578711524,3578711536,12
3,645,4290,3578711524,3578711537,13
3,645,4291,3578711524,3578711537,13
3,645,4292,3578711524,3578711537,13
3,645,4293,3578711524,3578711538,14
3,645,4294,3578711524,3578711540,16
3,645,4295,3578711524,3578711544,20
3,645,4296,3578711524,3578711545,21
3,645,4297,3578711524,3578711546,22
3,645,4298,3578711524,3578711546,22
3,645,4299,3578711524,3578711549,25
3,645,4300,3578711524,3578711549,25
3,645,4301,3578711524,3578711551,27
3,645,4302,3578711524,3578711552,28
3,645,4303,3578711524,3578711557,33
3,645,4304,3578711524,3578711563,39
3,645,4305,3578711524,3578711565,41
3,645,4306,3578711524,3578711568,44
3,645,4307,3578711524,3578711568,44
3,645,4308,3578711524,3578711569,45
3,645,4309,3578711524,3578711573,49
3,645,4310,3578711524,3578711573,49
3,646,4311,3578711578,3578711578,0
3,646,4312,3578711578,3578711578,0
3,646,4313,3578711578,3578711578,0
3,646,4314,3578711578,3578711579,1
3,646,4315,3578711578,3578711582,4
3,646,4316,3578711578,3578711583,5
3,646,4317,3578711578,3578711584,6
3,646,4318,3578711578,3578711587,9
3,646,4319,3578711578,3578711588,10
3,646,4320,3578711578,3578711590,12
3,646,4321,3578711578,3578711602,24
3,646,4322,3578711578,3578711605,27
3,646,4323,3578711578,3578711608,30
3,646,4324,3578711578,3578711608,30
3,646,4325,3578711578,3578711609,31
3,646,4326,3578711578,3578711611,33
3,646,4327,3578711578,3578711614,36
3,646,4328,3578711578,3578711616,38
3,646,4329,3578711578,3578711620,42
3,646,4330,3578711578,3578711623,45
3,646,4331,3578711578,3578711625,47
3,646,4332,3578711578,3578711626,48
3,646,4333,3578711578,3578711626,48
3,647,4334,3578711631,3578711631,0
3,647,4335,3578711631,3578711631,0
3,647,4336,3578711631,3578711633,2
3,647,4337,3578711631,3578711639,8
3,647,4338,3578711631,3578711642,11
3,647,4339,3578711631,3578711645,14
3,647,4340,3578711631,3578711646,15
3,647,4341,3578711631,3578711649,18
3,647,4342,3578711631,3578711650,19
3,647,4343,3578711631,3578711651,20
3,647,4344,3578711631,3578711653,22
3,647,4345,3578711631,3578711661,30
3,647,4346,3578711631,3578711662,31
3,647,4347,3578711631,3578711662,31
3,647,4348,3578711631,3578711668,37
3,647,4349,3578711631,3578711668,37
3,647,4350,3578711631,3578711669,38
3,647,4351,3578711631,3578711669,38
3,647,4352,3578711631,3578711674,43
3,647,4353,3578711631,3578711676,45
3,647,4354,3578711631,3578711678,47
3,647,4355,3578711631,3578711678,47
3,647,4356,3578711631,3578711680,49
3,648,4357,3578711685,3578711685,0
3,648,4358,3578711685,3578711686,1
3,648,4359,3578711685,3578711688,3
3,648,4360,3578711685,3578711694,9
3,648,4361,3578711685,3578711696,11
3,648,4362,3578711685,3578711698,13
3,648,4363,3578711685,3578711699,14
3,648,4364,3578711685,3578711700,15
3,648,4365,3578711685,3578711702,17
3,648,4366,3578711685,3578711705,20
3,648,4367,3578711685,3578711715,30
3,648,4368,3578711685,3578711718,33
3,648,4369,3578711685,3578711719,34
3,648,4370,3578711685,3578711721,36
3,648,4371,3578711685,3578711725,40
3,649,4372,3578711738,3578711738,0
3,649,4373,3578711738,3578711738,0
3,649,4374,3578711738,3578711738,0
3,649,4375,3578711738,3578711738,0
3,649,4376,3578711738,3578711739,1
3,649,4377,3578711738,3578711740,2
3,649,4378,3578711738,3578711745,7
3,649,4379,3578711738,3578711745,7
3,649,4380,3578711738,3578711746,8
3,649,4381,3578711738,3578711748,10
3,649,4382,3578711738,3578711749,11
3,649,4383,3578711738,3578711749,11
3,649,4384,3578711738,3578711751,13
3,649,4385,3578711738,3578711752,14
3,649,4386,3578711738,3578711753,15
3,649,4387,3578711738,3578711758,20
3,649,4388,3578711738,3578711763,25
3,649,4389,3578711738,3578711765,27
3,649,4390,3578711738,3578711768,30
3,649,4391,3578711738,3578711769,31
3,649,4392,3578711738,3578711769,31
3,649,4393,3578711738,3578711773,35
3,649,4394,3578711738,3578711774,36
3,649,4395,3578711738,3578711776,38
3,649,4396,3578711738,3578711778,40
3,649,4397,3578711738,3578711778,40
3,649,4398,3578711738,3578711782,44
3,649,4399,3578711738,3578711784,46
3,649,4400,3578711738,3578711786,48
3,649,4401,3578711738,3578711788,50
3,650,4402,3578711791,3578711791,0
3,650,4403,3578711791,3578711791,0
3,650,4404,3578711791,3578711791,0
3,650,4405,3578711791,3578711802,11
3,650,4406,3578711791,3578711805,14
3,650,4407,3578711791,3578711807,16
3,650,4408,3578711791,3578711808,17
3,650,4409,3578711791,3578711810,19
3,650,4410,3578711791,3578711811,20
3,650,4411,3578711791,3578711813,22
3,650,4412,3578711791,3578711816,25
3,650,4413,3578711791,3578711820,29
3,650,4414,3578711791,3578711824,33
3,650,4415,3578711791,3578711825,34
3,650,4416,3578711791,3578711825,34
3,650,4417,3578711791,3578711829,38
3,650,4418,3578711791,3578711831,40
3,650,4419,3578711791,3578711834,43
3,650,4420,3578711791,3578711838,47
3,651,4421,3578711844,3578711844,0
3,651,4422,3578711844,3578711844,0
3,651,4423,3578711844,3578711847,3
3,651,4424,3578711844,3578711849,5
3,651,4425,3578711844,3578711850,6
3,651,4426,3578711844,3578711851,7
3,651,4427,3578711844,3578711853,9
3,651,4428,3578711844,3578711862,18
3,651,4429,3578711844,3578711862,18
3,651,4430,3578711844,3578711863,19
3,651,4431,3578711844,3578711868,24
3,651,4432,3578711844,3578711868,24
3,651,4433,3578711844,3578711869,25
3,651,4434,3578711844,3578711869,25
3,651,4435,3578711844,3578711874,30
3,651,4436,3578711844,3578711876,32
3,651,4437,3578711844,3578711876,32
3,651,4438,3578711844,3578711878,34
3,651,4439,3578711844,3578711878,34
3,651,4440,3578711844,3578711879,35
3,651,4441,3578711844,3578711884,40
3,651,4442,3578711844,3578711886,42
3,651,4443,3578711844,3578711894,50
3,652,4444,3578711898,3578711898,0
3,652,4445,3578711898,3578711898,0
3,652,4446,3578711898,3578711899,1
3,652,4447,3578711898,3578711900,2
3,652,4448,3578711898,3578711902,4
3,652,4449,3578711898,3578711911,13
3,652,4450,3578711898,3578711915,17
3,652,4451,3578711898,3578711918,20
3,652,4452,3578711898,3578711920,22
3,652,4453,3578711898,3578711921,23
3,652,4454,3578711898,3578711925,27
3,652,4455,3578711898,3578711936,38
3,652,4456,3578711898,3578711938,40
3,652,4457,3578711898,3578711938,40
3,652,4458,3578711898,3578711938,40
3,652,4459,3578711898,3578711938,40
3,652,4460,3578711898,3578711940,42
3,652,4461,3578711898,3578711945,47
3,652,4462,3578711898,3578711946,48
3,652,4463,3578711898,3578711947,49
3,653,4464,3578711951,3578711951,0
3,653,4465,3578711951,3578711951,0
3,653,4466,3578711951,3578711952,1
3,653,4467,3578711951,3578711952,1
3,653,4468,3578711951,3578711953,2
3,653,4469,3578711951,3578711957,6
3,653,4470,3578711951,3578711964,13
3,653,4471,3578711951,3578711966,15
3,653,4472,3578711951,3578711968,17
3,653,4473,3578711951,3578711968,17
3,653,4474,3578711951,3578711969,18
3,653,4475,3578711951,3578711974,23
3,653,4476,3578711951,3578711974,23
3,653,4477,3578711951,3578711976,25
3,653,4478,3578711951,3578711978,27
3,653,4479,3578711951,3578711978,27
3,653,4480,3578711951,3578711982,31
3,653,4481,3578711951,3578711984,33
3,653,4482,3578711951,3578711986,35
3,653,4483,3578711951,3578711987,36
3,653,4484,3578711951,3578711990,39
3,653,4485,3578711951,3578711991,40
3,654,4486,3578712004,3578712004,0
3,654,4487,3578712004,3578712005,1
3,654,4488,3578712004,3578712005,1
3,654,4489,3578712004,3578712008,4
3,654,4490,3578712004,3578712008,4
3,654,4491,3578712004,3578712010,6
3,654,4492,3578712004,3578712012,8
3,654,4493,3578712004,3578712015,11
3,654,4494,3578712004,3578712020,16
3,654,4495,3578712004,3578712025,21
3,654,4496,3578712004,3578712026,22
3,654,4497,3578712004,3578712026,22
3,654,4498,3578712004,3578712028,24
3,654,4499,3578712004,3578712032,28
3,654,4500,3578712004,3578712034,30
3,654,4501,3578712004,3578712040,36
3,654,4502,3578712004,3578712041,37
3,654,4503,3578712004,3578712044,40
3,654,4504,3578712004,3578712048,44
3,654,4505,3578712004,3578712050,46
3,654,4506,3578712004,3578712051,47
3,654,4507,3578712004,3578712052,48
3,654,4508,3578712004,3578712054,50
3,655,4509,3578712057,3578712061,4
3,655,4510,3578712057,3578712063,6
3,655,4511,3578712057,3578712063,6
3,655,4512,3578712057,3578712068,11
3,655,4513,3578712057,3578712068,11
3,655,4514,3578712057,3578712069,12
3,655,4515,3578712057,3578712069,12
3,655,4516,3578712057,3578712074,17
3,655,4517,3578712057,3578712076,19
3,655,4518,3578712057,3578712076,19
3,655,4519,3578712057,3578712077,20
3,655,4520,3578712057,3578712078,21
3,655,4521,3578712057,3578712080,23
3,655,4522,3578712057,3578712085,28
3,655,4523,3578712057,3578712085,28
3,655,4524,3578712057,3578712093,36
3,655,4525,3578712057,3578712096,39
3,655,4526,3578712057,3578712098,41
3,655,4527,3578712057,3578712099,42
3,655,4528,3578712057,3578712100,43
3,655,4529,3578712057,3578712102,45
3,655,4530,3578712057,3578712105,48
3,656,4531,3578712110,3578712110,0
3,656,4532,3578712110,3578712115,5
3,656,4533,3578712110,3578712118,8
3,656,4534,3578712110,3578712120,10
3,656,4535,3578712110,3578712121,11
3,656,4536,3578712110,3578712126,16
3,656,4537,3578712110,3578712136,26
3,656,4538,3578712110,3578712138,28
3,656,4539,3578712110,3578712138,28
3,656,4540,3578712110,3578712139,29
3,656,4541,3578712110,3578712139,29
3,656,4542,3578712110,3578712140,30
3,656,4543,3578712110,3578712146,36
3,656,4544,3578712110,3578712146,36
3,656,4545,3578712110,3578712147,37
3,656,4546,3578712110,3578712148,38
3,656,4547,3578712110,3578712150,40
3,656,4548,3578712110,3578712151,41
3,656,4549,3578712110,3578712151,41
3,656,4550,3578712110,3578712152,42
3,656,4551,3578712110,3578712153,43
3,656,4552,3578712110,3578712158,48
3,657,4553,3578712163,3578712164,1
3,657,4554,3578712163,3578712166,3
3,657,4555,3578712163,3578712168,5
3,657,4556,3578712163,3578712168,5
3,657,4557,3578712163,3578712169,6
3,657,4558,3578712163,3578712171,8
3,657,4559,3578712163,3578712174,11
3,657,4560,3578712163,3578712174,11
3,657,4561,3578712163,3578712176,13
3,657,4562,3578712163,3578712176,13
3,657,4563,3578712163,3578712178,15
3,657,4564,3578712163,3578712178,15
3,657,4565,3578712163,3578712182,19
3,657,4566,3578712163,3578712184,21
3,657,4567,3578712163,3578712186,23
3,657,4568,3578712163,3578712188,25
3,657,4569,3578712163,3578712189,26
3,657,4570,3578712163,3578712191,28
3,657,4571,3578712163,3578712203,40
3,657,4572,3578712163,3578712205,42
3,657,4573,3578712163,3578712205,42
3,657,4574,3578712163,3578712205,42
3,657,4575,3578712163,3578712208,45
3,657,4576,3578712163,3578712208,45
3,657,4577,3578712163,3578712210,47
3,657,4578,3578712163,3578712212,49
3,658,4579,3578712217,3578712217,0
3,658,4580,3578712217,3578712220,3
3,658,4581,3578712217,3578712225,8
3,658,4582,3578712217,3578712226,9
3,658,4583,3578712217,3578712227,10
3,658,4584,3578712217,3578712227,10
3,658,4585,3578712217,3578712229,12
3,658,4586,3578712217,3578712231,14
3,658,4587,3578712217,3578712234,17
3,658,4588,3578712217,3578712239,22
3,658,4589,3578712217,3578712242,25
3,658,4590,3578712217,3578712244,27
3,658,4591,3578712217,3578712248,31
3,658,4592,3578712217,3578712250,33
3,658,4593,3578712217,3578712252,35
3,658,4594,3578712217,3578712252,35
3,658,4595,3578712217,3578712254,37
3,658,4596,3578712217,3578712262,45
3,658,4597,3578712217,3578712263,46
3,658,4598,3578712217,3578712264,47
3,659,4599,3578712271,3578712271,0
3,659,4600,3578712271,3578712271,0
3,659,4601,3578712271,3578712271,0
3,659,4602,3578712271,3578712271,0
3,659,4603,3578712271,3578712275,4
3,659,4604,3578712271,3578712277,6
3,659,4605,3578712271,3578712277,6
3,659,4606,3578712271,3578712277,6
3,659,4607,3578712271,3578712278,7
3,659,4608,3578712271,3578712279,8
3,659,4609,3578712271,3578712285,14
3,659,4610,3578712271,3578712286,15
3,659,4611,3578712271,3578712288,17
3,659,4612,3578712271,3578712294,23
3,659,4613,3578712271,3578712297,26
3,659,4614,3578712271,3578712298,27
3,659,4615,3578712271,3578712299,28
3,659,4616,3578712271,3578712300,29
3,659,4617,3578712271,3578712302,31
3,659,4618,3578712271,3578712306,35
3,659,4619,3578712271,3578712310,39
3,659,4620,3578712271,3578712315,44
3,659,4621,3578712271,3578712318,47
3,659,4622,3578712271,3578712321,50
3,660,4623,3578712324,3578712324,0
3,660,4624,3578712324,3578712324,0
3,660,4625,3578712324,3578712326,2
3,660,4626,3578712324,3578712336,12
3,660,4627,3578712324,3578712338,14
3,660,4628,3578712324,3578712338,14
3,660,4629,3578712324,3578712338,14
3,660,4630,3578712324,3578712340,16
3,660,4631,3578712324,3578712341,17
3,660,4632,3578712324,3578712346,22
3,660,4633,3578712324,3578712346,22
3,660,4634,3578712324,3578712346,22
3,660,4635,3578712324,3578712347,23
3,660,4636,3578712324,3578712350,26
3,660,4637,3578712324,3578712351,27
3,660,4638,3578712324,3578712352,28
3,660,4639,3578712324,3578712352,28
3,660,4640,3578712324,3578712354,30
3,660,4641,3578712324,3578712358,34
3,660,4642,3578712324,3578712364,40
3,660,4643,3578712324,3578712366,42
3,660,4644,3578712324,3578712368,44
3,660,4645,3578712324,3578712368,44
3,660,4646,3578712324,3578712369,45
3,660,4647,3578712324,3578712371,47
3,660,4648,3578712324,3578712374,50
3,661,4649,3578712379,3578712379,0
3,661,4650,3578712379,3578712379,0
3,661,4651,3578712379,3578712379,0
3,661,4652,3578712379,3578712379,0
3,661,4653,3578712379,3578712382,3
3,661,4654,3578712379,3578712383,4
3,661,4655,3578712379,3578712386,7
3,661,4656,3578712379,3578712389,10
3,661,4657,3578712379,3578712390,11
3,661,4658,3578712379,3578712391,12
3,661,4659,3578712379,3578712404,25
3,661,4660,3578712379,3578712405,26
3,661,4661,3578712379,3578712406,27
3,661,4662,3578712379,3578712406,27
3,661,4663,3578712379,3578712407,28
3,661,4664,3578712379,3578712408,29
3,661,4665,3578712379,3578712410,31
3,661,4666,3578712379,3578712413,34
3,661,4667,3578712379,3578712414,35
3,661,4668,3578712379,3578712417,38
3,661,4669,3578712379,3578712420,41
3,661,4670,3578712379,3578712425,46
3,661,4671,3578712379,3578712425,46
3,661,4672,3578712379,3578712426,47
3,661,4673,3578712379,3578712427,48
3,661,4674,3578712379,3578712428,49
3,662,4675,3578712432,3578712432,0
3,662,4676,3578712432,3578712432,0
3,662,4677,3578712432,3578712434,2
3,662,4678,3578712432,3578712440,8
3,662,4679,3578712432,3578712443,11
3,662,4680,3578712432,3578712445,13
3,662,4681,3578712432,3578712448,16
3,662,4682,3578712432,3578712451,19
3,662,4683,3578712432,3578712451,19
3,662,4684,3578712432,3578712452,20
3,662,4685,3578712432,3578712454,22
3,662,4686,3578712432,3578712462,30
3,662,4687,3578712432,3578712463,31
3,662,4688,3578712432,3578712464,32
3,662,4689,3578712432,3578712468,36
3,662,4690,3578712432,3578712469,37
3,662,4691,3578712432,3578712470,38
3,662,4692,3578712432,3578712470,38
3,662,4693,3578712432,3578712475,43
3,662,4694,3578712432,3578712476,44
3,662,4695,3578712432,3578712477,45
3,662,4696,3578712432,3578712478,46
3,662,4697,3578712432,3578712478,46
3,662,4698,3578712432,3578712480,48
3,663,4699,3578712486,3578712486,0
3,663,4700,3578712486,3578712486,0
3,663,4701,3578712486,3578712488,2
3,663,4702,3578712486,3578712493,7
3,663,4703,3578712486,3578712496,10
3,663,4704,3578712486,3578712497,11
3,663,4705,3578712486,3578712499,13
3,663,4706,3578712486,3578712499,13
3,663,4707,3578712486,3578712501,15
3,663,4708,3578712486,3578712505,19
3,663,4709,3578712486,3578712505,19
3,663,4710,3578712486,3578712510,24
3,663,4711,3578712486,3578712514,28
3,663,4712,3578712486,3578712517,31
3,663,4713,3578712486,3578712519,33
3,663,4714,3578712486,3578712520,34
3,663,4715,3578712486,3578712524,38
3,663,4716,3578712486,3578712525,39
3,663,4717,3578712486,3578712535,49
3,664,4718,3578712539,3578712539,0
3,664,4719,3578712539,3578712539,0
3,664,4720,3578712539,3578712539,0
3,664,4721,3578712539,3578712540,1
3,664,4722,3578712539,3578712540,1
3,664,4723,3578712539,3578712545,6
3,664,4724,3578712539,3578712545,6
3,664,4725,3578712539,3578712545,6
3,664,4726,3578712539,3578712547,8
3,664,4727,3578712539,3578712549,10
3,664,4728,3578712539,3578712551,12
3,664,4729,3578712539,3578712551,12
3,664,4730,3578712539,3578712551,12
3,664,4731,3578712539,3578712554,15
3,664,4732,3578712539,3578712556,17
3,664,4733,3578712539,3578712563,24
3,664,4734,3578712539,3578712565,26
3,664,4735,3578712539,3578712567,28
3,664,4736,3578712539,3578712568,29
3,664,4737,3578712539,3578712568,29
3,664,4738,3578712539,3578712571,32
3,664,4739,3578712539,3578712573,34
3,664,4740,3578712539,3578712575,36
3,664,4741,3578712539,3578712576,37
3,664,4742,3578712539,3578712578,39
3,664,4743,3578712539,3578712578,39
3,664,4744,3578712539,3578712583,44
3,664,4745,3578712539,3578712583,44
3,664,4746,3578712539,3578712585,46
3,665,4747,3578712593,3578712593,0
3,665,4748,3578712593,3578712593,0
3,665,4749,3578712593,3578712602,9
3,665,4750,3578712593,3578712604,11
3,665,4751,3578712593,3578712605,12
3,665,4752,3578712593,3578712605,12
3,665,4753,3578712593,3578712607,14
3,665,4754,3578712593,3578712608,15
3,665,4755,3578712593,3578712609,16
3,665,4756,3578712593,3578712612,19
3,665,4757,3578712593,3578712616,23
3,665,4758,3578712593,3578712618,25
3,665,4759,3578712593,3578712623,30
3,665,4760,3578712593,3578712623,30
3,665,4761,3578712593,3578712626,33
3,665,4762,3578712593,3578712626,33
3,665,4763,3578712593,3578712627,34
3,665,4764,3578712593,3578712631,38
3,665,4765,3578712593,3578712633,40
3,665,4766,3578712593,3578712639,46
3,665,4767,3578712593,3578712642,49
3,666,4768,3578712647,3578712647,0
3,666,4769,3578712647,3578712647,0
3,666,4770,3578712647,3578712649,2
3,666,4771,3578712647,3578712650,3
3,666,4772,3578712647,3578712651,4
3,666,4773,3578712647,3578712653,6
3,666,4774,3578712647,3578712661,14
3,666,4775,3578712647,3578712662,15
3,666,4776,3578712647,3578712662,15
3,666,4777,3578712647,3578712667,20
3,666,4778,3578712647,3578712668,21
3,666,4779,3578712647,3578712669,22
3,666,4780,3578712647,3578712669,22
3,666,4781,3578712647,3578712676,29
3,666,4782,3578712647,3578712677,30
3,666,4783,3578712647,3578712678,31
3,666,4784,3578712647,3578712678,31
3,666,4785,3578712647,3578712678,31
3,666,4786,3578712647,3578712680,33
3,666,4787,3578712647,3578712684,37
3,666,4788,3578712647,3578712685,38
3,666,4789,3578712647,3578712687,40
3,666,4790,3578712647,3578712694,47
3,666,4791,3578712647,3578712695,48
3,667,4792,3578712701,3578712701,0
3,667,4793,3578712701,3578712701,0
3,667,4794,3578712701,3578712701,0
3,667,4795,3578712701,3578712701,0
3,667,4796,3578712701,3578712704,3
3,667,4797,3578712701,3578712705,4
3,667,4798,3578712701,3578712710,9
3,667,4799,3578712701,3578712714,13
3,667,4800,3578712701,3578712717,16
3,667,4801,3578712701,3578712720,19
3,667,4802,3578712701,3578712721,20
3,667,4803,3578712701,3578712723,22
3,667,4804,3578712701,3578712725,24
3,667,4805,3578712701,3578712736,35
3,667,4806,3578712701,3578712737,36
3,667,4807,3578712701,3578712737,36
3,667,4808,3578712701,3578712737,36
3,667,4809,3578712701,3578712740,39
3,667,4810,3578712701,3578712740,39
3,667,4811,3578712701,3578712745,44
3,667,4812,3578712701,3578712745,44
3,667,4813,3578712701,3578712746,45
3,667,4814,3578712701,3578712747,46
3,667,4815,3578712701,3578712749,48
3,667,4816,3578712701,3578712750,49
3,667,4817,3578712701,3578712751,50
3,668,4818,3578712754,3578712754,0
3,668,4819,3578712754,3578712754,0
3,668,4820,3578712754,3578712757,3
3,668,4821,3578712754,3578712763,9
3,668,4822,3578712754,3578712766,12
3,668,4823,3578712754,3578712768,14
3,668,4824,3578712754,3578712768,14
3,668,4825,3578712754,3578712768,14
3,668,4826,3578712754,3578712770,16
3,668,4827,3578712754,3578712773,19
3,668,4828,3578712754,3578712774,20
3,668,4829,3578712754,3578712775,21
3,668,4830,3578712754,3578712776,22
3,668,4831,3578712754,3578712777,23
3,668,4832,3578712754,3578712778,24
3,668,4833,3578712754,3578712783,29
3,668,4834,3578712754,3578712784,30
3,668,4835,3578712754,3578712786,32
3,668,4836,3578712754,3578712788,34
3,668,4837,3578712754,3578712791,37
3,668,4838,3578712754,3578712791,37
3,668,4839,3578712754,3578712792,38
3,668,4840,3578712754,3578712803,49
3,668,4841,3578712754,3578712803,49
3,669,4842,3578712808,3578712808,0
3,669,4843,3578712808,3578712808,0
3,669,4844,3578712808,3578712808,0
3,669,4845,3578712808,3578712808,0
3,669,4846,3578712808,3578712809,1
3,669,4847,3578712808,3578712812,4
3,669,4848,3578712808,3578712816,8
3,669,4849,3578712808,3578712819,11
3,669,4850,3578712808,3578712823,15
3,669,4851,3578712808,3578712824,16
3,669,4852,3578712808,3578712826,18
3,669,4853,3578712808,3578712826,18
3,669,4854,3578712808,3578712827,19
3,669,4855,3578712808,3578712831,23
3,669,4856,3578712808,3578712833,25
3,669,4857,3578712808,3578712839,31
3,669,4858,3578712808,3578712842,34
3,669,4859,3578712808,3578712844,36
3,669,4860,3578712808,3578712846,38
3,669,4861,3578712808,3578712850,42
3,669,4862,3578712808,3578712851,43
3,669,4863,3578712808,3578712851,43
3,669,4864,3578712808,3578712853,45
3,670,4865,3578712862,3578712862,0
3,670,4866,3578712862,3578712862,0
3,670,4867,3578712862,3578712864,2
3,670,4868,3578712862,3578712867,5
3,670,4869,3578712862,3578712868,6
3,670,4870,3578712862,3578712869,7
3,670,4871,3578712862,3578712869,7
3,670,4872,3578712862,3578712876,14
3,670,4873,3578712862,3578712878,16
3,670,4874,3578712862,3578712878,16
3,670,4875,3578712862,3578712878,16
3,670,4876,3578712862,3578712879,17
3,670,4877,3578712862,3578712884,22
3,670,4878,3578712862,3578712885,23
3,670,4879,3578712862,3578712888,26
3,670,4880,3578712862,3578712895,33
3,670,4881,3578712862,3578712898,36
3,670,4882,3578712862,3578712899,37
3,670,4883,3578712862,3578712900,38
3,670,4884,3578712862,3578712901,39
3,670,4885,3578712862,3578712904,42
3,670,4886,3578712862,3578712906,44
3,670,4887,3578712862,3578712911,49
3,671,4888,3578712915,3578712915,0
3,671,4889,3578712915,3578712917,2
3,671,4890,3578712915,3578712920,5
3,671,4891,3578712915,3578712921,6
3,671,4892,3578712915,3578712923,8
3,671,4893,3578712915,3578712925,10
3,671,4894,3578712915,3578712936,21
3,671,4895,3578712915,3578712937,22
3,671,4896,3578712915,3578712938,23
3,671,4897,3578712915,3578712938,23
3,671,4898,3578712915,3578712940,25
3,671,4899,3578712915,3578712940,25
3,671,4900,3578712915,3578712945,30
3,671,4901,3578712915,3578712945,30
3,671,4902,3578712915,3578712946,31
3,671,4903,3578712915,3578712947,32
3,671,4904,3578712915,3578712950,35
3,671,4905,3578712915,3578712950,35
3,671,4906,3578712915,3578712951,36
3,671,4907,3578712915,3578712952,37
3,671,4908,3578712915,3578712953,38
3,671,4909,3578712915,3578712957,42
3,671,4910,3578712915,3578712964,49
3,672,4911,3578712968,3578712968,0
3,672,4912,3578712968,3578712968,0
3,672,4913,3578712968,3578712968,0
3,672,4914,3578712968,3578712968,0
3,672,4915,3578712968,3578712970,2
3,672,4916,3578712968,3578712974,6
3,672,4917,3578712968,3578712974,6
3,672,4918,3578712968,3578712975,7
3,672,4919,3578712968,3578712977,9
3,672,4920,3578712968,3578712977,9
3,672,4921,3578712968,3578712978,10
3,672,4922,3578712968,3578712983,15
3,672,4923,3578712968,3578712984,16
3,672,4924,3578712968,3578712987,19
3,672,4925,3578712968,3578712990,22
3,672,4926,3578712968,3578712990,22
3,672,4927,3578712968,3578712992,24
3,672,4928,3578712968,3578713003,35
3,672,4929,3578712968,3578713004,36
3,672,4930,3578712968,3578713005,37
3,672,4931,3578712968,3578713007,39
3,672,4932,3578712968,3578713007,39
3,672,4933,3578712968,3578713008,40
3,672,4934,3578712968,3578713010,42
3,672,4935,3578712968,3578713011,43
3,672,4936,3578712968,3578713014,46
3,672,4937,3578712968,3578713016,48
3,673,4938,3578713022,3578713022,0
3,673,4939,3578713022,3578713023,1
3,673,4940,3578713022,3578713024,2
3,673,4941,3578713022,3578713026,4
3,673,4942,3578713022,3578713027,5
3,673,4943,3578713022,3578713027,5
3,673,4944,3578713022,3578713029,7
3,673,4945,3578713022,3578713032,10
3,673,4946,3578713022,3578713033,11
3,673,4947,3578713022,3578713040,18
3,673,4948,3578713022,3578713042,20
3,673,4949,3578713022,3578713044,22
3,673,4950,3578713022,3578713047,25
3,673,4951,3578713022,3578713051,29
3,673,4952,3578713022,3578713052,30
3,673,4953,3578713022,3578713052,30
3,673,4954,3578713022,3578713053,31
3,673,4955,3578713022,3578713062,40
3,673,4956,3578713022,3578713063,41
3,673,4957,3578713022,3578713064,42
3,673,4958,3578713022,3578713067,45
3,673,4959,3578713022,3578713069,47
3,673,4960,3578713022,3578713069,47
3,673,4961,3578713022,3578713069,47
3,674,4962,3578713076,3578713076,0
3,674,4963,3578713076,3578713076,0
3,674,4964,3578713076,3578713077,1
3,674,4965,3578713076,3578713078,2
3,674,4966,3578713076,3578713078,2
3,674,4967,3578713076,3578713078,2
3,674,4968,3578713076,3578713080,4
3,674,4969,3578713076,3578713084,8
3,674,4970,3578713076,3578713084,8
3,674,4971,3578713076,3578713087,11
3,674,4972,3578713076,3578713096,20
3,674,4973,3578713076,3578713098,22
3,674,4974,3578713076,3578713099,23
3,674,4975,3578713076,3578713100,24
3,674,4976,3578713076,3578713101,25
3,674,4977,3578713076,3578713104,28
3,674,4978,3578713076,3578713106,30
3,674,4979,3578713076,3578713111,35
3,674,4980,3578713076,3578713115,39
3,674,4981,3578713076,3578713118,42
3,674,4982,3578713076,3578713120,44
3,674,4983,3578713076,3578713123,47
3,674,4984,3578713076,3578713125,49
3,675,4985,3578713129,3578713136,7
3,675,4986,3578713129,3578713138,9
3,675,4987,3578713129,3578713138,9
3,675,4988,3578713129,3578713138,9
3,675,4989,3578713129,3578713140,11
3,675,4990,3578713129,3578713140,11
3,675,4991,3578713129,3578713145,16
3,675,4992,3578713129,3578713145,16
3,675,4993,3578713129,3578713146,17
3,675,4994,3578713129,3578713147,18
3,675,4995,3578713129,3578713150,21
3,675,4996,3578713129,3578713151,22
3,675,4997,3578713129,3578713151,22
3,675,4998,3578713129,3578713152,23
3,675,4999,3578713129,3578713153,24
3,675,5000,3578713129,3578713157,28
3,675,5001,3578713129,3578713164,35
3,675,5002,3578713129,3578713167,38
3,675,5003,3578713129,3578713168,39
3,675,5004,3578713129,3578713168,39
3,675,5005,3578713129,3578713171,42
3,675,5006,3578713129,3578713174,45
3,675,5007,3578713129,3578713174,45
3,675,5008,3578713129,3578713176,47
3,675,5009,3578713129,3578713177,48
3,675,5010,3578713129,3578713178,49
3,675,5011,3578713129,3578713178,49
3,676,5012,3578713182,3578713183,1
3,676,5013,3578713182,3578713184,2
3,676,5014,3578713182,3578713185,3
3,676,5015,3578713182,3578713187,5
3,676,5016,3578713182,3578713191,9
3,676,5017,3578713182,3578713192,10
3,676,5018,3578713182,3578713203,21
3,676,5019,3578713182,3578713204,22
3,676,5020,3578713182,3578713205,23
3,676,5021,3578713182,3578713207,25
3,676,5022,3578713182,3578713208,26
3,676,5023,3578713182,3578713209,27
3,676,5024,3578713182,3578713210,28
3,676,5025,3578713182,3578713211,29
3,676,5026,3578713182,3578713215,33
3,676,5027,3578713182,3578713216,34
3,676,5028,3578713182,3578713219,37
3,676,5029,3578713182,3578713224,42
3,676,5030,3578713182,3578713225,43
3,676,5031,3578713182,3578713226,44
3,676,5032,3578713182,3578713226,44
3,676,5033,3578713182,3578713227,45
3,676,5034,3578713182,3578713230,48
3,677,5035,3578713235,3578713235,0
3,677,5036,3578713235,3578713235,0
3,677,5037,3578713235,3578713239,4
3,677,5038,3578713235,3578713242,7
3,677,5039,3578713235,3578713244,9
3,677,5040,3578713235,3578713247,12
3,677,5041,3578713235,3578713250,15
3,677,5042,3578713235,3578713251,16
3,677,5043,3578713235,3578713253,18
3,677,5044,3578713235,3578713254,19
3,677,5045,3578713235,3578713261,26
3,677,5046,3578713235,3578713263,28
3,677,5047,3578713235,3578713263,28
3,677,5048,3578713235,3578713267,32
3,677,5049,3578713235,3578713269,34
3,677,5050,3578713235,3578713269,34
3,677,5051,3578713235,3578713275,40
3,677,5052,3578713235,3578713276,41
3,677,5053,3578713235,3578713277,42
3,677,5054,3578713235,3578713277,42
3,677,5055,3578713235,3578713277,42
3,677,5056,3578713235,3578713278,43
3,677,5057,3578713235,3578713280,45
3,677,5058,3578713235,3578713284,49
3,677,5059,3578713235,3578713284,49
3,678,5060,3578713289,3578713289,0
3,678,5061,3578713289,3578713296,7
3,678,5062,3578713289,3578713297,8
3,678,5063,3578713289,3578713299,10
3,678,5064,3578713289,3578713299,10
3,678,5065,3578713289,3578713301,12
3,678,5066,3578713289,3578713305,16
3,678,5067,3578713289,3578713306,17
3,678,5068,3578713289,3578713311,22
3,678,5069,3578713289,3578713316,27
3,678,5070,3578713289,3578713317,28
3,678,5071,3578713289,3578713320,31
3,678,5072,3578713289,3578713323,34
3,678,5073,3578713289,3578713326,37
3,678,5074,3578713289,3578713336,47
3,678,5075,3578713289,3578713337,48
3,678,5076,3578713289,3578713338,49
3,678,5077,3578713289,3578713338,49
3,678,5078,3578713289,3578713339,50
3,679,5079,3578713342,3578713342,0
3,679,5080,3578713342,3578713345,3
3,679,5081,3578713342,3578713345,3
3,679,5082,3578713342,3578713346,4
3,679,5083,3578713342,3578713348,6
3,679,5084,3578713342,3578713350,8
3,679,5085,3578713342,3578713351,9
3,679,5086,3578713342,3578713352,10
3,679,5087,3578713342,3578713353,11
3,679,5088,3578713342,3578713354,12
3,679,5089,3578713342,3578713357,15
3,679,5090,3578713342,3578713364,22
3,679,5091,3578713342,3578713366,24
3,679,5092,3578713342,3578713368,26
3,679,5093,3578713342,3578713368,26
3,679,5094,3578713342,3578713369,27
3,679,5095,3578713342,3578713370,28
3,679,5096,3578713342,3578713374,32
3,679,5097,3578713342,3578713374,32
3,679,5098,3578713342,3578713376,34
3,679,5099,3578713342,3578713376,34
3,679,5100,3578713342,3578713378,36
3,679,5101,3578713342,3578713379,37
3,679,5102,3578713342,3578713383,41
3,679,5103,3578713342,3578713384,42
3,679,5104,3578713342,3578713385,43
3,679,5105,3578713342,3578713387,45
3,679,5106,3578713342,3578713388,46
3,679,5107,3578713342,3578713391,49
3,679,5108,3578713342,3578713392,50
3,680,5109,3578713395,3578713395,0
3,680,5110,3578713395,3578713402,7
3,680,5111,3578713395,3578713405,10
3,680,5112,3578713395,3578713405,10
3,680,5113,3578713395,3578713406,11
3,680,5114,3578713395,3578713408,13
3,680,5115,3578713395,3578713409,14
3,680,5116,3578713395,3578713409,14
3,680,5117,3578713395,3578713412,17
3,680,5118,3578713395,3578713415,20
3,680,5119,3578713395,3578713417,22
3,680,5120,3578713395,3578713420,25
3,680,5121,3578713395,3578713425,30
3,680,5122,3578713395,3578713425,30
3,680,5123,3578713395,3578713426,31
3,680,5124,3578713395,3578713426,31
3,680,5125,3578713395,3578713429,34
3,680,5126,3578713395,3578713433,38
3,680,5127,3578713395,3578713434,39
3,680,5128,3578713395,3578713439,44
3,680,5129,3578713395,3578713442,47
3,680,5130,3578713395,3578713444,49
3,681,5131,3578713449,3578713449,0
3,681,5132,3578713449,3578713450,1
3,681,5133,3578713449,3578713451,2
3,681,5134,3578713449,3578713452,3
3,681,5135,3578713449,3578713454,5
3,681,5136,3578713449,3578713462,13
3,681,5137,3578713449,3578713463,14
3,681,5138,3578713449,3578713464,15
3,681,5139,3578713449,3578713468,19
3,681,5140,3578713449,3578713468,19
3,681,5141,3578713449,3578713470,21
3,681,5142,3578713449,3578713475,26
3,681,5143,3578713449,3578713476,27
3,681,5144,3578713449,3578713477,28
3,681,5145,3578713449,3578713478,29
3,681,5146,3578713449,3578713478,29
3,681,5147,3578713449,3578713478,29
3,681,5148,3578713449,3578713480,31
3,681,5149,3578713449,3578713484,35
3,681,5150,3578713449,3578713485,36
3,681,5151,3578713449,3578713487,38
3,681,5152,3578713449,3578713489,40
3,681,5153,3578713449,3578713495,46
3,681,5154,3578713449,3578713498,49
3,682,5155,3578713502,3578713502,0
3,682,5156,3578713502,3578713502,0
3,682,5157,3578713502,3578713502,0
3,682,5158,3578713502,3578713503,1
3,682,5159,3578713502,3578713505,3
3,682,5160,3578713502,3578713510,8
3,682,5161,3578713502,3578713514,12
3,682,5162,3578713502,3578713517,15
3,682,5163,3578713502,3578713519,17
3,682,5164,3578713502,3578713519,17
3,682,5165,3578713502,3578713522,20
3,682,5166,3578713502,3578713525,23
3,682,5167,3578713502,3578713535,33
3,682,5168,3578713502,3578713536,34
3,682,5169,3578713502,3578713537,35
3,682,5170,3578713502,3578713537,35
3,682,5171,3578713502,3578713539,37
3,682,5172,3578713502,3578713539,37
3,682,5173,3578713502,3578713540,38
3,682,5174,3578713502,3578713545,43
3,682,5175,3578713502,3578713545,43
3,682,5176,3578713502,3578713546,44
3,682,5177,3578713502,3578713549,47
3,682,5178,3578713502,3578713550,48
3,682,5179,3578713502,3578713551,49
3,682,5180,3578713502,3578713552,50
3,683,5181,3578713555,3578713555,0
3,683,5182,3578713555,3578713556,1
3,683,5183,3578713555,3578713564,9
3,683,5184,3578713555,3578713565,10
3,683,5185,3578713555,3578713568,13
3,683,5186,3578713555,3578713568,13
3,683,5187,3578713555,3578713568,13
3,683,5188,3578713555,3578713569,14
3,683,5189,3578713555,3578713573,18
3,683,5190,3578713555,3578713573,18
3,683,5191,3578713555,3578713575,20
3,683,5192,3578713555,3578713576,21
3,683,5193,3578713555,3578713577,22
3,683,5194,3578713555,3578713578,23
3,683,5195,3578713555,3578713583,28
3,683,5196,3578713555,3578713585,30
3,683,5197,3578713555,3578713586,31
3,683,5198,3578713555,3578713587,32
3,683,5199,3578713555,3578713587,32
3,683,5200,3578713555,3578713589,34
3,683,5201,3578713555,3578713591,36
3,683,5202,3578713555,3578713601,46
3,683,5203,3578713555,3578713604,49
3,684,5204,3578713609,3578713609,0
3,684,5205,3578713609,3578713609,0
3,684,5206,3578713609,3578713609,0
3,684,5207,3578713609,3578713609,0
3,684,5208,3578713609,3578713611,2
3,684,5209,3578713609,3578713614,5
3,684,5210,3578713609,3578713616,7
3,684,5211,3578713609,3578713619,10
3,684,5212,3578713609,3578713623,14
3,684,5213,3578713609,3578713623,14
3,684,5214,3578713609,3578713624,15
3,684,5215,3578713609,3578713626,17
3,684,5216,3578713609,3578713628,19
3,684,5217,3578713609,3578713632,23
3,684,5218,3578713609,3578713633,24
3,684,5219,3578713609,3578713639,30
3,684,5220,3578713609,3578713641,32
3,684,5221,3578713609,3578713643,34
3,684,5222,3578713609,3578713646,37
3,684,5223,3578713609,3578713650,41
3,684,5224,3578713609,3578713650,41
3,684,5225,3578713609,3578713652,43
3,684,5226,3578713609,3578713653,44
3,685,5227,3578713664,3578713664,0
3,685,5228,3578713664,3578713664,0
3,685,5229,3578713664,3578713664,0
3,685,5230,3578713664,3578713667,3
3,685,5231,3578713664,3578713668,4
3,685,5232,3578713664,3578713669,5
3,685,5233,3578713664,3578713670,6
3,685,5234,3578713664,3578713675,11
3,685,5235,3578713664,3578713676,12
3,685,5236,3578713664,3578713677,13
3,685,5237,3578713664,3578713678,14
3,685,5238,3578713664,3578713678,14
3,685,5239,3578713664,3578713678,14
3,685,5240,3578713664,3578713680,16
3,685,5241,3578713664,3578713684,20
3,685,5242,3578713664,3578713685,21
3,685,5243,3578713664,3578713687,23
3,685,5244,3578713664,3578713689,25
3,685,5245,3578713664,3578713696,32
3,685,5246,3578713664,3578713699,35
3,685,5247,3578713664,3578713700,36
3,685,5248,3578713664,3578713700,36
3,685,5249,3578713664,3578713704,40
3,685,5250,3578713664,3578713705,41
3,685,5251,3578713664,3578713710,46
3,686,5252,3578713718,3578713718,0
3,686,5253,3578713718,3578713718,0
3,686,5254,3578713718,3578713719,1
3,686,5255,3578713718,3578713721,3
3,686,5256,3578713718,3578713722,4
3,686,5257,3578713718,3578713725,7
3,686,5258,3578713718,3578713733,15
3,686,5259,3578713718,3578713736,18
3,686,5260,3578713718,3578713736,18
3,686,5261,3578713718,3578713737,19
3,686,5262,3578713718,3578713737,19
3,686,5263,3578713718,3578713739,21
3,686,5264,3578713718,3578713739,21
3,686,5265,3578713718,3578713744,26
3,686,5266,3578713718,3578713745,27
3,686,5267,3578713718,3578713745,27
3,686,5268,3578713718,3578713747,29
3,686,5269,3578713718,3578713749,31
3,686,5270,3578713718,3578713750,32
3,686,5271,3578713718,3578713751,33
3,686,5272,3578713718,3578713752,34
3,686,5273,3578713718,3578713753,35
3,686,5274,3578713718,3578713757,39
3,686,5275,3578713718,3578713763,45
3,686,5276,3578713718,3578713766,48
3,687,5277,3578713772,3578713772,0
3,687,5278,3578713772,3578713772,0
3,687,5279,3578713772,3578713772,0
3,687,5280,3578713772,3578713772,0
3,687,5281,3578713772,3578713773,1
3,687,5282,3578713772,3578713774,2
3,687,5283,3578713772,3578713775,3
3,687,5284,3578713772,3578713776,4
3,687,5285,3578713772,3578713777,5
3,687,5286,3578713772,3578713778,6
3,687,5287,3578713772,3578713782,10
3,687,5288,3578713772,3578713784,12
3,687,5289,3578713772,3578713785,13
3,687,5290,3578713772,3578713785,13
3,687,5291,3578713772,3578713787,15
3,687,5292,3578713772,3578713787,15
3,687,5293,3578713772,3578713790,18
3,687,5294,3578713772,3578713791,19
3,687,5295,3578713772,3578713796,24
3,687,5296,3578713772,3578713802,30
3,687,5297,3578713772,3578713806,34
3,687,5298,3578713772,3578713807,35
3,687,5299,3578713772,3578713808,36
3,687,5300,3578713772,3578713810,38
3,687,5301,3578713772,3578713811,39
3,687,5302,3578713772,3578713814,42
3,687,5303,3578713772,3578713816,44
3,687,5304,3578713772,3578713818,46
3,688,5305,3578713861,3578713861,0
3,688,5306,3578713861,3578713861,0
3,688,5307,3578713861,3578713861,0
3,688,5308,3578713861,3578713861,0
3,688,5309,3578713861,3578713861,0
3,688,5310,3578713861,3578713861,0
3,688,5311,3578713861,3578713861,0
3,688,5312,3578713861,3578713861,0
3,688,5313,3578713861,3578713861,0
3,688,5314,3578713861,3578713861,0
3,688,5315,3578713861,3578713861,0
3,688,5316,3578713861,3578713861,0
3,688,5317,3578713861,3578713861,0
3,688,5318,3578713861,3578713861,0
3,688,5319,3578713861,3578713861,0
3,688,5320,3578713861,3578713862,1
3,688,5321,3578713861,3578713862,1
3,688,5322,3578713861,3578713863,2
3,688,5323,3578713861,3578713867,6
3,688,5324,3578713861,3578713869,8
3,688,5325,3578713861,3578713869,8
3,688,5326,3578713861,3578713869,8
3,688,5327,3578713861,3578713875,14
3,688,5328,3578713861,3578713876,15
3,688,5329,3578713861,3578713877,16
3,688,5330,3578713861,3578713878,17
3,688,5331,3578713861,3578713878,17
3,688,5332,3578713861,3578713878,17
3,688,5333,3578713861,3578713880,19
3,688,5334,3578713861,3578713884,23
3,688,5335,3578713861,3578713885,24
3,688,5336,3578713861,3578713887,26
3,688,5337,3578713861,3578713889,28
3,688,5338,3578713861,3578713895,34
3,688,5339,3578713861,3578713898,37
3,688,5340,3578713861,3578713900,39
3,688,5341,3578713861,3578713900,39
3,688,5342,3578713861,3578713900,39
3,688,5343,3578713861,3578713903,42
3,688,5344,3578713861,3578713905,44
3,688,5345,3578713861,3578713911,50
3,689,5346,3578713916,3578713916,0
3,689,5347,3578713916,3578713917,1
3,689,5348,3578713916,3578713919,3
3,689,5349,3578713916,3578713921,5
3,689,5350,3578713916,3578713922,6
3,689,5351,3578713916,3578713926,10
3,689,5352,3578713916,3578713933,17
3,689,5353,3578713916,3578713936,20
3,689,5354,3578713916,3578713936,20
3,689,5355,3578713916,3578713938,22
3,689,5356,3578713916,3578713938,22
3,689,5357,3578713916,3578713939,23
3,689,5358,3578713916,3578713939,23
3,689,5359,3578713916,3578713940,24
3,689,5360,3578713916,3578713945,29
3,689,5361,3578713916,3578713945,29
3,689,5362,3578713916,3578713945,29
3,689,5363,3578713916,3578713948,32
3,689,5364,3578713916,3578713951,35
3,689,5365,3578713916,3578713951,35
3,689,5366,3578713916,3578713951,35
3,689,5367,3578713916,3578713952,36
3,689,5368,3578713916,3578713953,37
3,689,5369,3578713916,3578713957,41
3,689,5370,3578713916,3578713963,47
3,690,5371,3578713969,3578713969,0
3,690,5372,3578713969,3578713969,0
3,690,5373,3578713969,3578713969,0
3,690,5374,3578713969,3578713969,0
3,690,5375,3578713969,3578713971,2
3,690,5376,3578713969,3578713974,5
3,690,5377,3578713969,3578713974,5
3,690,5378,3578713969,3578713976,7
3,690,5379,3578713969,3578713976,7
3,690,5380,3578713969,3578713977,8
3,690,5381,3578713969,3578713978,9
3,690,5382,3578713969,3578713982,13
3,690,5383,3578713969,3578713983,14
3,690,5384,3578713969,3578713985,16
3,690,5385,3578713969,3578713986,17
3,690,5386,3578713969,3578713988,19
3,690,5387,3578713969,3578713990,21
3,690,5388,3578713969,3578713991,22
3,690,5389,3578713969,3578713991,22
3,690,5390,3578713969,3578713997,28
3,690,5391,3578713969,3578714001,32
3,690,5392,3578713969,3578714004,35
3,690,5393,3578713969,3578714006,37
3,690,5394,3578713969,3578714007,38
3,690,5395,3578713969,3578714008,39
3,690,5396,3578713969,3578714010,41
3,690,5397,3578713969,3578714012,43
3,690,5398,3578713969,3578714016,47
3,690,5399,3578713969,3578714016,47
3,690,5400,3578713969,3578714019,50
3,691,5401,3578714022,3578714023,1
3,691,5402,3578714022,3578714024,2
3,691,5403,3578714022,3578714026,4
3,691,5404,3578714022,3578714026,4
3,691,5405,3578714022,3578714026,4
3,691,5406,3578714022,3578714029,7
3,691,5407,3578714022,3578714032,10
3,691,5408,3578714022,3578714033,11
3,691,5409,3578714022,3578714040,18
3,691,5410,3578714022,3578714041,19
3,691,5411,3578714022,3578714044,22
3,691,5412,3578714022,3578714046,24
3,691,5413,3578714022,3578714046,24
3,691,5414,3578714022,3578714051,29
3,691,5415,3578714022,3578714051,29
3,691,5416,3578714022,3578714052,30
3,691,5417,3578714022,3578714053,31
3,691,5418,3578714022,3578714062,40
3,691,5419,3578714022,3578714063,41
3,691,5420,3578714022,3578714063,41
3,691,5421,3578714022,3578714068,46
3,691,5422,3578714022,3578714069,47
3,691,5423,3578714022,3578714069,47
3,691,5424,3578714022,3578714070,48
3,692,5425,3578714075,3578714075,0
3,692,5426,3578714075,3578714076,1
3,692,5427,3578714075,3578714077,2
3,692,5428,3578714075,3578714077,2
3,692,5429,3578714075,3578714077,2
3,692,5430,3578714075,3578714078,3
3,692,5431,3578714075,3578714080,5
3,692,5432,3578714075,3578714084,9
3,692,5433,3578714075,3578714085,10
3,692,5434,3578714075,3578714087,12
3,692,5435,3578714075,3578714089,14
3,692,5436,3578714075,3578714096,21
3,692,5437,3578714075,3578714097,22
3,692,5438,3578714075,3578714099,24
3,692,5439,3578714075,3578714100,25
3,692,5440,3578714075,3578714101,26
3,692,5441,3578714075,3578714104,29
3,692,5442,3578714075,3578714106,31
3,692,5443,3578714075,3578714111,36
3,692,5444,3578714075,3578714116,41
3,692,5445,3578714075,3578714117,42
3,692,5446,3578714075,3578714118,43
3,692,5447,3578714075,3578714121,46
3,692,5448,3578714075,3578714123,48
3,693,5449,3578714128,3578714128,0
3,693,5450,3578714128,3578714134,6
3,693,5451,3578714128,3578714136,8
3,693,5452,3578714128,3578714137,9
3,693,5453,3578714128,3578714137,9
3,693,5454,3578714128,3578714138,10
3,693,5455,3578714128,3578714138,10
3,693,5456,3578714128,3578714139,11
3,693,5457,3578714128,3578714139,11
3,693,5458,3578714128,3578714144,16
3,693,5459,3578714128,3578714145,17
3,693,5460,3578714128,3578714145,17
3,693,5461,3578714128,3578714148,20
3,693,5462,3578714128,3578714151,23
3,693,5463,3578714128,3578714152,24
3,693,5464,3578714128,3578714152,24
3,693,5465,3578714128,3578714152,24
3,693,5466,3578714128,3578714153,25
3,693,5467,3578714128,3578714157,29
3,693,5468,3578714128,3578714164,36
3,693,5469,3578714128,3578714166,38
3,693,5470,3578714128,3578714168,40
3,693,5471,3578714128,3578714169,41
3,693,5472,3578714128,3578714170,42
3,693,5473,3578714128,3578714174,46
3,693,5474,3578714128,3578714174,46
3,693,5475,3578714128,3578714175,47
3,693,5476,3578714128,3578714177,49
3,694,5477,3578714182,3578714182,0
3,694,5478,3578714182,3578714182,0
3,694,5479,3578714182,3578714182,0
3,694,5480,3578714182,3578714184,2
3,694,5481,3578714182,3578714185,3
3,694,5482,3578714182,3578714187,5
3,694,5483,3578714182,3578714189,7
3,694,5484,3578714182,3578714191,9
3,694,5485,3578714182,3578714192,10
3,694,5486,3578714182,3578714197,15
3,694,5487,3578714182,3578714202,20
3,694,5488,3578714182,3578714203,21
3,694,5489,3578714182,3578714204,22
3,694,5490,3578714182,3578714206,24
3,694,5491,3578714182,3578714208,26
3,694,5492,3578714182,3578714208,26
3,694,5493,3578714182,3578714210,28
3,694,5494,3578714182,3578714212,30
3,694,5495,3578714182,3578714216,34
3,694,5496,3578714182,3578714218,36
3,694,5497,3578714182,3578714221,39
3,694,5498,3578714182,3578714224,42
3,694,5499,3578714182,3578714224,42
3,694,5500,3578714182,3578714226,44
3,694,5501,3578714182,3578714227,45
3,694,5502,3578714182,3578714227,45
3,694,5503,3578714182,3578714229,47
3,695,5504,3578714236,3578714236,0
3,695,5505,3578714236,3578714236,0
3,695,5506,3578714236,3578714240,4
3,695,5507,3578714236,3578714242,6
3,695,5508,3578714236,3578714245,9
3,695,5509,3578714236,3578714245,9
3,695,5510,3578714236,3578714247,11
3,695,5511,3578714236,3578714251,15
3,695,5512,3578714236,3578714252,16
3,695,5513,3578714236,3578714252,16
3,695,5514,3578714236,3578714254,18
3,695,5515,3578714236,3578714262,26
3,695,5516,3578714236,3578714263,27
3,695,5517,3578714236,3578714264,28
3,695,5518,3578714236,3578714268,32
3,695,5519,3578714236,3578714269,33
3,695,5520,3578714236,3578714269,33
3,695,5521,3578714236,3578714269,33
3,695,5522,3578714236,3578714275,39
3,695,5523,3578714236,3578714276,40
3,695,5524,3578714236,3578714278,42
3,695,5525,3578714236,3578714278,42
3,695,5526,3578714236,3578714278,42
3,695,5527,3578714236,3578714280,44
3,695,5528,3578714236,3578714285,49
3,695,5529,3578714236,3578714285,49
3,696,5530,3578714290,3578714290,0
3,696,5531,3578714290,3578714290,0
3,696,5532,3578714290,3578714297,7
3,696,5533,3578714290,3578714298,8
3,696,5534,3578714290,3578714298,8
3,696,5535,3578714290,3578714300,10
3,696,5536,3578714290,3578714300,10
3,696,5537,3578714290,3578714301,11
3,696,5538,3578714290,3578714305,15
3,696,5539,3578714290,3578714306,16
3,696,5540,3578714290,3578714311,21
3,696,5541,3578714290,3578714317,27
3,696,5542,3578714290,3578714319,29
3,696,5543,3578714290,3578714321,31
3,696,5544,3578714290,3578714328,38
3,696,5545,3578714290,3578714334,44
3,696,5546,3578714290,3578714335,45
3,696,5547,3578714290,3578714336,46
3,696,5548,3578714290,3578714338,48
3,696,5549,3578714290,3578714339,49
3,696,5550,3578714290,3578714339,49
3,696,5551,3578714290,3578714339,49
3,697,5552,3578714344,3578714344,0
3,697,5553,3578714344,3578714344,0
3,697,5554,3578714344,3578714345,1
3,697,5555,3578714344,3578714345,1
3,697,5556,3578714344,3578714349,5
3,697,5557,3578714344,3578714351,7
3,697,5558,3578714344,3578714352,8
3,697,5559,3578714344,3578714352,8
3,697,5560,3578714344,3578714352,8
3,697,5561,3578714344,3578714355,11
3,697,5562,3578714344,3578714358,14
3,697,5563,3578714344,3578714364,20
3,697,5564,3578714344,3578714366,22
3,697,5565,3578714344,3578714367,23
3,697,5566,3578714344,3578714369,25
3,697,5567,3578714344,3578714369,25
3,697,5568,3578714344,3578714371,27
3,697,5569,3578714344,3578714374,30
3,697,5570,3578714344,3578714374,30
3,697,5571,3578714344,3578714375,31
3,697,5572,3578714344,3578714377,33
3,697,5573,3578714344,3578714379,35
3,697,5574,3578714344,3578714379,35
3,697,5575,3578714344,3578714382,38
3,697,5576,3578714344,3578714384,40
3,697,5577,3578714344,3578714385,41
3,697,5578,3578714344,3578714387,43
3,697,5579,3578714344,3578714389,45
3,697,5580,3578714344,3578714390,46
3,697,5581,3578714344,3578714392,48
3,698,5582,3578714398,3578714398,0
3,698,5583,3578714398,3578714402,4
3,698,5584,3578714398,3578714402,4
3,698,5585,3578714398,3578714404,6
3,698,5586,3578714398,3578714405,7
3,698,5587,3578714398,3578714406,8
3,698,5588,3578714398,3578714408,10
3,698,5589,3578714398,3578714408,10
3,698,5590,3578714398,3578714411,13
3,698,5591,3578714398,3578714412,14
3,698,5592,3578714398,3578714417,19
3,698,5593,3578714398,3578714419,21
3,698,5594,3578714398,3578714421,23
3,698,5595,3578714398,3578714423,25
3,698,5596,3578714398,3578714425,27
3,698,5597,3578714398,3578714426,28
3,698,5598,3578714398,3578714427,29
3,698,5599,3578714398,3578714427,29
3,698,5600,3578714398,3578714430,32
3,698,5601,3578714398,3578714432,34
3,698,5602,3578714398,3578714434,36
3,698,5603,3578714398,3578714440,42
3,698,5604,3578714398,3578714445,47
3,698,5605,3578714398,3578714445,47
3,698,5606,3578714398,3578714447,49
3,699,5607,3578714452,3578714452,0
3,699,5608,3578714452,3578714453,1
3,699,5609,3578714452,3578714454,2
3,699,5610,3578714452,3578714462,10
3,699,5611,3578714452,3578714463,11
3,699,5612,3578714452,3578714464,12
3,699,5613,3578714452,3578714468,16
3,699,5614,3578714452,3578714469,17
3,699,5615,3578714452,3578714469,17
3,699,5616,3578714452,3578714471,19
3,699,5617,3578714452,3578714476,24
3,699,5618,3578714452,3578714477,25
3,699,5619,3578714452,3578714478,26
3,699,5620,3578714452,3578714478,26
3,699,5621,3578714452,3578714478,26
3,699,5622,3578714452,3578714479,27
3,699,5623,3578714452,3578714485,33
3,699,5624,3578714452,3578714485,33
3,699,5625,3578714452,3578714488,36
3,699,5626,3578714452,3578714489,37
3,699,5627,3578714452,3578714497,45
3,699,5628,3578714452,3578714498,46
3,699,5629,3578714452,3578714498,46
3,699,5630,3578714452,3578714500,48
3,699,5631,3578714452,3578714500,48
3,699,5632,3578714452,3578714501,49
3,700,5633,3578714506,3578714506,0
3,700,5634,3578714506,3578714506,0
3,700,5635,3578714506,3578714509,3
3,700,5636,3578714506,3578714515,9
3,700,5637,3578714506,3578714517,11
3,700,5638,3578714506,3578714519,13
3,700,5639,3578714506,3578714519,13
3,700,5640,3578714506,3578714521,15
3,700,5641,3578714506,3578714526,20
3,700,5642,3578714506,3578714533,27
3,700,5643,3578714506,3578714535,29
3,700,5644,3578714506,3578714535,29
3,700,5645,3578714506,3578714537,31
3,700,5646,3578714506,3578714538,32
3,700,5647,3578714506,3578714538,32
3,700,5648,3578714506,3578714538,32
3,700,5649,3578714506,3578714539,33
3,700,5650,3578714506,3578714544,38
3,700,5651,3578714506,3578714544,38
3,700,5652,3578714506,3578714545,39
3,700,5653,3578714506,3578714548,42
3,700,5654,3578714506,3578714551,45
3,700,5655,3578714506,3578714551,45
3,700,5656,3578714506,3578714551,45
3,700,5657,3578714506,3578714551,45
3,700,5658,3578714506,3578714555,49
3,701,5659,3578714559,3578714559,0
3,701,5660,3578714559,3578714563,4
3,701,5661,3578714559,3578714565,6
3,701,5662,3578714559,3578714567,8
3,701,5663,3578714559,3578714568,9
3,701,5664,3578714559,3578714569,10
3,701,5665,3578714559,3578714570,11
3,701,5666,3578714559,3578714573,14
3,701,5667,3578714559,3578714574,15
3,701,5668,3578714559,3578714574,15
3,701,5669,3578714559,3578714578,19
3,701,5670,3578714559,3578714579,20
3,701,5671,3578714559,3578714582,23
3,701,5672,3578714559,3578714583,24
3,701,5673,3578714559,3578714584,25
3,701,5674,3578714559,3578714586,27
3,701,5675,3578714559,3578714588,29
3,701,5676,3578714559,3578714588,29
3,701,5677,3578714559,3578714591,32
3,701,5678,3578714559,3578714597,38
3,701,5679,3578714559,3578714601,42
3,701,5680,3578714559,3578714602,43
3,701,5681,3578714559,3578714603,44
3,701,5682,3578714559,3578714603,44
3,701,5683,3578714559,3578714604,45
3,701,5684,3578714559,3578714605,46
3,701,5685,3578714559,3578714607,48
3,701,5686,3578714559,3578714608,49
3,702,5687,3578714613,3578714613,0
3,702,5688,3578714613,3578714613,0
3,702,5689,3578714613,3578714615,2
3,702,5690,3578714613,3578714616,3
3,702,5691,3578714613,3578714619,6
3,702,5692,3578714613,3578714620,7
3,702,5693,3578714613,3578714623,10
3,702,5694,3578714613,3578714625,12
3,702,5695,3578714613,3578714625,12
3,702,5696,3578714613,3578714626,13
3,702,5697,3578714613,3578714629,16
3,702,5698,3578714613,3578714633,20
3,702,5699,3578714613,3578714639,26
3,702,5700,3578714613,3578714644,31
3,702,5701,3578714613,3578714645,32
3,702,5702,3578714613,3578714646,33
3,702,5703,3578714613,3578714652,39
3,702,5704,3578714613,3578714653,40
3,702,5705,3578714613,3578714661,48
3,702,5706,3578714613,3578714662,49
3,702,5707,3578714613,3578714662,49
3,703,5708,3578714667,3578714667,0
3,703,5709,3578714667,3578714668,1
3,703,5710,3578714667,3578714669,2
3,703,5711,3578714667,3578714670,3
3,703,5712,3578714667,3578714676,9
3,703,5713,3578714667,3578714677,10
3,703,5714,3578714667,3578714677,10
3,703,5715,3578714667,3578714678,11
3,703,5716,3578714667,3578714678,11
3,703,5717,3578714667,3578714679,12
3,703,5718,3578714667,3578714685,18
3,703,5719,3578714667,3578714685,18
3,703,5720,3578714667,3578714688,21
3,703,5721,3578714667,3578714689,22
3,703,5722,3578714667,3578714697,30
3,703,5723,3578714667,3578714697,30
3,703,5724,3578714667,3578714699,32
3,703,5725,3578714667,3578714700,33
3,703,5726,3578714667,3578714700,33
3,703,5727,3578714667,3578714700,33
3,703,5728,3578714667,3578714702,35
3,703,5729,3578714667,3578714705,38
3,703,5730,3578714667,3578714706,39
3,703,5731,3578714667,3578714710,43
3,703,5732,3578714667,3578714715,48
3,703,5733,3578714667,3578714717,50
3,704,5734,3578714721,3578714721,0
3,704,5735,3578714721,3578714721,0
3,704,5736,3578714721,3578714721,0
3,704,5737,3578714721,3578714726,5
3,704,5738,3578714721,3578714733,12
3,704,5739,3578714721,3578714735,14
3,704,5740,3578714721,3578714736,15
3,704,5741,3578714721,3578714737,16
3,704,5742,3578714721,3578714738,17
3,704,5743,3578714721,3578714738,17
3,704,5744,3578714721,3578714739,18
3,704,5745,3578714721,3578714739,18
3,704,5746,3578714721,3578714740,19
3,704,5747,3578714721,3578714744,23
3,704,5748,3578714721,3578714745,24
3,704,5749,3578714721,3578714745,24
3,704,5750,3578714721,3578714747,26
3,704,5751,3578714721,3578714750,29
3,704,5752,3578714721,3578714751,30
3,704,5753,3578714721,3578714751,30
3,704,5754,3578714721,3578714752,31
3,704,5755,3578714721,3578714754,33
3,704,5756,3578714721,3578714759,38
3,704,5757,3578714721,3578714763,42
3,704,5758,3578714721,3578714765,44
3,704,5759,3578714721,3578714768,47
3,704,5760,3578714721,3578714768,47
3,704,5761,3578714721,3578714769,48
3,704,5762,3578714721,3578714770,49
3,705,5763,3578714776,3578714776,0
3,705,5764,3578714776,3578714776,0
3,705,5765,3578714776,3578714776,0
3,705,5766,3578714776,3578714777,1
3,705,5767,3578714776,3578714779,3
3,705,5768,3578714776,3578714782,6
3,705,5769,3578714776,3578714784,8
3,705,5770,3578714776,3578714784,8
3,705,5771,3578714776,3578714785,9
3,705,5772,3578714776,3578714789,13
3,705,5773,3578714776,3578714789,13
3,705,5774,3578714776,3578714791,15
3,705,5775,3578714776,3578714801,25
3,705,5776,3578714776,3578714803,27
3,705,5777,3578714776,3578714804,28
3,705,5778,3578714776,3578714804,28
3,705,5779,3578714776,3578714804,28
3,705,5780,3578714776,3578714805,29
3,705,5781,3578714776,3578714807,31
3,705,5782,3578714776,3578714807,31
3,705,5783,3578714776,3578714810,34
3,705,5784,3578714776,3578714811,35
3,705,5785,3578714776,3578714814,38
3,705,5786,3578714776,3578714816,40
3,705,5787,3578714776,3578714820,44
3,705,5788,3578714776,3578714820,44
3,705,5789,3578714776,3578714824,48
3,705,5790,3578714776,3578714825,49
3,705,5791,3578714776,3578714825,49
3,706,5792,3578714831,3578714831,0
3,706,5793,3578714831,3578714831,0
3,706,5794,3578714831,3578714833,2
3,706,5795,3578714831,3578714839,8
3,706,5796,3578714831,3578714844,13
3,706,5797,3578714831,3578714845,14
3,706,5798,3578714831,3578714846,15
3,706,5799,3578714831,3578714851,20
3,706,5800,3578714831,3578714852,21
3,706,5801,3578714831,3578714853,22
3,706,5802,3578714831,3578714862,31
3,706,5803,3578714831,3578714862,31
3,706,5804,3578714831,3578714864,33
3,706,5805,3578714831,3578714868,37
3,706,5806,3578714831,3578714868,37
3,706,5807,3578714831,3578714868,37
3,706,5808,3578714831,3578714870,39
3,706,5809,3578714831,3578714876,45
3,706,5810,3578714831,3578714876,45
3,706,5811,3578714831,3578714877,46
3,706,5812,3578714831,3578714877,46
3,706,5813,3578714831,3578714878,47
3,706,5814,3578714831,3578714878,47
3,706,5815,3578714831,3578714879,48
3,707,5816,3578714885,3578714885,0
3,707,5817,3578714885,3578714889,4
3,707,5818,3578714885,3578714889,4
3,707,5819,3578714885,3578714898,13
3,707,5820,3578714885,3578714898,13
3,707,5821,3578714885,3578714899,14
3,707,5822,3578714885,3578714900,15
3,707,5823,3578714885,3578714900,15
3,707,5824,3578714885,3578714900,15
3,707,5825,3578714885,3578714901,16
3,707,5826,3578714885,3578714905,20
3,707,5827,3578714885,3578714906,21
3,707,5828,3578714885,3578714911,26
3,707,5829,3578714885,3578714916,31
3,707,5830,3578714885,3578714917,32
3,707,5831,3578714885,3578714919,34
3,707,5832,3578714885,3578714921,36
3,707,5833,3578714885,3578714922,37
3,707,5834,3578714885,3578714927,42
3,707,5835,3578714885,3578714933,48
3,708,5836,3578714939,3578714939,0
3,708,5837,3578714939,3578714939,0
3,708,5838,3578714939,3578714939,0
3,708,5839,3578714939,3578714939,0
3,708,5840,3578714939,3578714939,0
3,708,5841,3578714939,3578714939,0
3,708,5842,3578714939,3578714939,0
3,708,5843,3578714939,3578714940,1
3,708,5844,3578714939,3578714944,5
3,708,5845,3578714939,3578714945,6
3,708,5846,3578714939,3578714945,6
3,708,5847,3578714939,3578714948,9
3,708,5848,3578714939,3578714951,12
3,708,5849,3578714939,3578714951,12
3,708,5850,3578714939,3578714952,13
3,708,5851,3578714939,3578714952,13
3,708,5852,3578714939,3578714954,15
3,708,5853,3578714939,3578714958,19
3,708,5854,3578714939,3578714965,26
3,708,5855,3578714939,3578714968,29
3,708,5856,3578714939,3578714968,29
3,708,5857,3578714939,3578714968,29
3,708,5858,3578714939,3578714971,32
3,708,5859,3578714939,3578714974,35
3,708,5860,3578714939,3578714974,35
3,708,5861,3578714939,3578714975,36
3,708,5862,3578714939,3578714977,38
3,708,5863,3578714939,3578714977,38
3,708,5864,3578714939,3578714979,40
3,708,5865,3578714939,3578714982,43
3,708,5866,3578714939,3578714984,45
3,708,5867,3578714939,3578714985,46
3,708,5868,3578714939,3578714986,47
3,708,5869,3578714939,3578714989,50
3,709,5870,3578714993,3578714993,0
3,709,5871,3578714993,3578714993,0
3,709,5872,3578714993,3578714993,0
3,709,5873,3578714993,3578714997,4
3,709,5874,3578714993,3578715001,8
3,709,5875,3578714993,3578715002,9
3,709,5876,3578714993,3578715003,10
3,709,5877,3578714993,3578715004,11
3,709,5878,3578714993,3578715004,11
3,709,5879,3578714993,3578715005,12
3,709,5880,3578714993,3578715007,14
3,709,5881,3578714993,3578715008,15
3,709,5882,3578714993,3578715010,17
3,709,5883,3578714993,3578715012,19
3,709,5884,3578714993,3578715015,22
3,709,5885,3578714993,3578715016,23
3,709,5886,3578714993,3578715020,27
3,709,5887,3578714993,3578715021,28
3,709,5888,3578714993,3578715023,30
3,709,5889,3578714993,3578715024,31
3,709,5890,3578714993,3578715026,33
3,709,5891,3578714993,3578715027,34
3,709,5892,3578714993,3578715027,34
3,709,5893,3578714993,3578715030,37
3,709,5894,3578714993,3578715033,40
3,709,5895,3578714993,3578715040,47
3,709,5896,3578714993,3578715041,48
3,710,5897,3578715047,3578715047,0
3,710,5898,3578715047,3578715047,0
3,710,5899,3578715047,3578715047,0
3,710,5900,3578715047,3578715051,4
3,710,5901,3578715047,3578715052,5
3,710,5902,3578715047,3578715052,5
3,710,5903,3578715047,3578715053,6
3,710,5904,3578715047,3578715062,15
3,710,5905,3578715047,3578715064,17
3,710,5906,3578715047,3578715064,17
3,710,5907,3578715047,3578715067,20
3,710,5908,3578715047,3578715068,21
3,710,5909,3578715047,3578715069,22
3,710,5910,3578715047,3578715070,23
3,710,5911,3578715047,3578715076,29
3,710,5912,3578715047,3578715076,29
3,710,5913,3578715047,3578715077,30
3,710,5914,3578715047,3578715078,31
3,710,5915,3578715047,3578715078,31
3,710,5916,3578715047,3578715078,31
3,710,5917,3578715047,3578715080,33
3,710,5918,3578715047,3578715085,38
3,710,5919,3578715047,3578715088,41
3,710,5920,3578715047,3578715090,43
3,711,5921,3578715101,3578715101,0
3,711,5922,3578715101,3578715101,0
3,711,5923,3578715101,3578715101,0
3,711,5924,3578715101,3578715101,0
3,711,5925,3578715101,3578715101,0
3,711,5926,3578715101,3578715101,0
3,711,5927,3578715101,3578715101,0
3,711,5928,3578715101,3578715105,4
3,711,5929,3578715101,3578715105,4
3,711,5930,3578715101,3578715110,9
3,711,5931,3578715101,3578715116,15
3,711,5932,3578715101,3578715117,16
3,711,5933,3578715101,3578715119,18
3,711,5934,3578715101,3578715122,21
3,711,5935,3578715101,3578715123,22
3,711,5936,3578715101,3578715127,26
3,711,5937,3578715101,3578715133,32
3,711,5938,3578715101,3578715136,35
3,711,5939,3578715101,3578715137,36
3,711,5940,3578715101,3578715137,36
3,711,5941,3578715101,3578715138,37
3,711,5942,3578715101,3578715138,37
3,711,5943,3578715101,3578715139,38
3,711,5944,3578715101,3578715139,38
3,711,5945,3578715101,3578715140,39
3,711,5946,3578715101,3578715145,44
3,711,5947,3578715101,3578715145,44
3,711,5948,3578715101,3578715145,44
3,711,5949,3578715101,3578715149,48
3,711,5950,3578715101,3578715151,50
3,712,5951,3578715155,3578715155,0
3,712,5952,3578715155,3578715155,0
3,712,5953,3578715155,3578715155,0
3,712,5954,3578715155,3578715155,0
3,712,5955,3578715155,3578715158,3
3,712,5956,3578715155,3578715164,9
3,712,5957,3578715155,3578715164,9
3,712,5958,3578715155,3578715165,10
3,712,5959,3578715155,3578715168,13
3,712,5960,3578715155,3578715168,13
3,712,5961,3578715155,3578715168,13
3,712,5962,3578715155,3578715171,16
3,712,5963,3578715155,3578715174,19
3,712,5964,3578715155,3578715175,20
3,712,5965,3578715155,3578715176,21
3,712,5966,3578715155,3578715179,24
3,712,5967,3578715155,3578715179,24
3,712,5968,3578715155,3578715182,27
3,712,5969,3578715155,3578715184,29
3,712,5970,3578715155,3578715185,30
3,712,5971,3578715155,3578715187,32
3,712,5972,3578715155,3578715189,34
3,712,5973,3578715155,3578715189,34
3,712,5974,3578715155,3578715191,36
3,712,5975,3578715155,3578715192,37
3,712,5976,3578715155,3578715197,42
3,712,5977,3578715155,3578715202,47
3,712,5978,3578715155,3578715203,48
3,712,5979,3578715155,3578715204,49
3,712,5980,3578715155,3578715204,49
3,712,5981,3578715155,3578715205,50
3,713,5982,3578715209,3578715209,0
3,713,5983,3578715209,3578715209,0
3,713,5984,3578715209,3578715209,0
3,713,5985,3578715209,3578715211,2
3,713,5986,3578715209,3578715211,2
3,713,5987,3578715209,3578715215,6
3,713,5988,3578715209,3578715215,6
3,713,5989,3578715209,3578715216,7
3,713,5990,3578715209,3578715219,10
3,713,5991,3578715209,3578715222,13
3,713,5992,3578715209,3578715224,15
3,713,5993,3578715209,3578715226,17
3,713,5994,3578715209,3578715226,17
3,713,5995,3578715209,3578715227,18
3,713,5996,3578715209,3578715230,21
3,713,5997,3578715209,3578715233,24
3,713,5998,3578715209,3578715233,24
3,713,5999,3578715209,3578715239,30
3,713,6000,3578715209,3578715241,32
3,713,6001,3578715209,3578715244,35
3,713,6002,3578715209,3578715245,36
3,713,6003,3578715209,3578715247,38
3,713,6004,3578715209,3578715250,41
3,713,6005,3578715209,3578715251,42
3,713,6006,3578715209,3578715252,43
3,713,6007,3578715209,3578715254,45
3,714,6008,3578715263,3578715263,0
3,714,6009,3578715263,3578715263,0
3,714,6010,3578715263,3578715263,0
3,714,6011,3578715263,3578715267,4
3,714,6012,3578715263,3578715268,5
3,714,6013,3578715263,3578715270,7
3,714,6014,3578715263,3578715276,13
3,714,6015,3578715263,3578715277,14
3,714,6016,3578715263,3578715277,14
3,714,6017,3578715263,3578715278,15
3,714,6018,3578715263,3578715278,15
3,714,6019,3578715263,3578715278,15
3,714,6020,3578715263,3578715280,17
3,714,6021,3578715263,3578715285,22
3,714,6022,3578715263,3578715286,23
3,714,6023,3578715263,3578715288,25
3,714,6024,3578715263,3578715290,27
3,714,6025,3578715263,3578715298,35
3,714,6026,3578715263,3578715299,36
3,714,6027,3578715263,3578715300,37
3,714,6028,3578715263,3578715300,37
3,714,6029,3578715263,3578715300,37
3,714,6030,3578715263,3578715301,38
3,714,6031,3578715263,3578715305,42
3,714,6032,3578715263,3578715311,48
3,715,6033,3578715317,3578715317,0
3,715,6034,3578715317,3578715317,0
3,715,6035,3578715317,3578715319,2
3,715,6036,3578715317,3578715322,5
3,715,6037,3578715317,3578715324,7
3,715,6038,3578715317,3578715327,10
3,715,6039,3578715317,3578715333,16
3,715,6040,3578715317,3578715336,19
3,715,6041,3578715317,3578715336,19
3,715,6042,3578715317,3578715338,21
3,715,6043,3578715317,3578715338,21
3,715,6044,3578715317,3578715338,21
3,715,6045,3578715317,3578715339,22
3,715,6046,3578715317,3578715341,24
3,715,6047,3578715317,3578715344,27
3,715,6048,3578715317,3578715345,28
3,715,6049,3578715317,3578715346,29
3,715,6050,3578715317,3578715349,32
3,715,6051,3578715317,3578715351,34
3,715,6052,3578715317,3578715351,34
3,715,6053,3578715317,3578715352,35
3,715,6054,3578715317,3578715354,37
3,715,6055,3578715317,3578715356,39
3,715,6056,3578715317,3578715358,41
3,715,6057,3578715317,3578715364,47
3,715,6058,3578715317,3578715364,47
3,715,6059,3578715317,3578715366,49
3,716,6060,3578715370,3578715371,1
3,716,6061,3578715370,3578715371,1
3,716,6062,3578715370,3578715371,1
3,716,6063,3578715370,3578715374,4
3,716,6064,3578715370,3578715375,5
3,716,6065,3578715370,3578715375,5
3,716,6066,3578715370,3578715376,6
3,716,6067,3578715370,3578715378,8
3,716,6068,3578715370,3578715379,9
3,716,6069,3578715370,3578715382,12
3,716,6070,3578715370,3578715384,14
3,716,6071,3578715370,3578715384,14
3,716,6072,3578715370,3578715387,17
3,716,6073,3578715370,3578715388,18
3,716,6074,3578715370,3578715389,19
3,716,6075,3578715370,3578715391,21
3,716,6076,3578715370,3578715391,21
3,716,6077,3578715370,3578715397,27
3,716,6078,3578715370,3578715403,33
3,716,6079,3578715370,3578715403,33
3,716,6080,3578715370,3578715404,34
3,716,6081,3578715370,3578715405,35
3,716,6082,3578715370,3578715405,35
3,716,6083,3578715370,3578715406,36
3,716,6084,3578715370,3578715408,38
3,716,6085,3578715370,3578715408,38
3,716,6086,3578715370,3578715411,41
3,716,6087,3578715370,3578715411,41
3,716,6088,3578715370,3578715414,44
3,716,6089,3578715370,3578715415,45
3,716,6090,3578715370,3578715417,47
3,716,6091,3578715370,3578715420,50
3,717,6092,3578715425,3578715425,0
3,717,6093,3578715425,3578715425,0
3,717,6094,3578715425,3578715425,0
3,717,6095,3578715425,3578715426,1
3,717,6096,3578715425,3578715426,1
3,717,6097,3578715425,3578715427,2
3,717,6098,3578715425,3578715430,5
3,717,6099,3578715425,3578715432,7
3,717,6100,3578715425,3578715435,10
3,717,6101,3578715425,3578715439,14
3,717,6102,3578715425,3578715442,17
3,717,6103,3578715425,3578715444,19
3,717,6104,3578715425,3578715445,20
3,717,6105,3578715425,3578715447,22
3,717,6106,3578715425,3578715450,25
3,717,6107,3578715425,3578715452,27
3,717,6108,3578715425,3578715452,27
3,717,6109,3578715425,3578715454,29
3,717,6110,3578715425,3578715462,37
3,717,6111,3578715425,3578715463,38
3,717,6112,3578715425,3578715464,39
3,717,6113,3578715425,3578715468,43
3,717,6114,3578715425,3578715469,44
3,717,6115,3578715425,3578715470,45
3,718,6116,3578715479,3578715479,0
3,718,6117,3578715479,3578715479,0
3,718,6118,3578715479,3578715479,0
3,718,6119,3578715479,3578715479,0
3,718,6120,3578715479,3578715479,0
3,718,6121,3578715479,3578715479,0
3,718,6122,3578715479,3578715479,0
3,718,6123,3578715479,3578715485,6
3,718,6124,3578715479,3578715485,6
3,718,6125,3578715479,3578715487,8
3,718,6126,3578715479,3578715489,10
3,718,6127,3578715479,3578715497,18
3,718,6128,3578715479,3578715497,18
3,718,6129,3578715479,3578715499,20
3,718,6130,3578715479,3578715499,20
3,718,6131,3578715479,3578715499,20
3,718,6132,3578715479,3578715499,20
3,718,6133,3578715479,3578715501,22
3,718,6134,3578715479,3578715504,25
3,718,6135,3578715479,3578715510,31
3,718,6136,3578715479,3578715515,36
3,718,6137,3578715479,3578715517,38
3,718,6138,3578715479,3578715518,39
3,718,6139,3578715479,3578715518,39
3,718,6140,3578715479,3578715520,41
3,718,6141,3578715479,3578715523,44
3,718,6142,3578715479,3578715526,47
3,719,6143,3578715533,3578715533,0
3,719,6144,3578715533,3578715535,2
3,719,6145,3578715533,3578715535,2
3,719,6146,3578715533,3578715537,4
3,719,6147,3578715533,3578715537,4
3,719,6148,3578715533,3578715537,4
3,719,6149,3578715533,3578715538,5
3,719,6150,3578715533,3578715538,5
3,719,6151,3578715533,3578715539,6
3,719,6152,3578715533,3578715544,11
3,719,6153,3578715533,3578715545,12
3,719,6154,3578715533,3578715545,12
3,719,6155,3578715533,3578715548,15
3,719,6156,3578715533,3578715549,16
3,719,6157,3578715533,3578715550,17
3,719,6158,3578715533,3578715551,18
3,719,6159,3578715533,3578715553,20
3,719,6160,3578715533,3578715555,22
3,719,6161,3578715533,3578715557,24
3,719,6162,3578715533,3578715563,30
3,719,6163,3578715533,3578715563,30
3,719,6164,3578715533,3578715564,31
3,719,6165,3578715533,3578715568,35
3,719,6166,3578715533,3578715569,36
3,719,6167,3578715533,3578715573,40
3,719,6168,3578715533,3578715573,40
3,719,6169,3578715533,3578715574,41
3,719,6170,3578715533,3578715575,42
3,719,6171,3578715533,3578715577,44
3,719,6172,3578715533,3578715578,45
3,719,6173,3578715533,3578715582,49
3,719,6174,3578715533,3578715583,50
3,720,6175,3578715587,3578715587,0
3,720,6176,3578715587,3578715587,0
3,720,6177,3578715587,3578715588,1
3,720,6178,3578715587,3578715588,1
3,720,6179,3578715587,3578715590,3
3,720,6180,3578715587,3578715590,3
3,720,6181,3578715587,3578715596,9
3,720,6182,3578715587,3578715602,15
3,720,6183,3578715587,3578715603,16
3,720,6184,3578715587,3578715603,16
3,720,6185,3578715587,3578715604,17
3,720,6186,3578715587,3578715604,17
3,720,6187,3578715587,3578715605,18
3,720,6188,3578715587,3578715607,20
3,720,6189,3578715587,3578715608,21
3,720,6190,3578715587,3578715610,23
3,720,6191,3578715587,3578715610,23
3,720,6192,3578715587,3578715614,27
3,720,6193,3578715587,3578715614,27
3,720,6194,3578715587,3578715616,29
3,720,6195,3578715587,3578715619,32
3,720,6196,3578715587,3578715621,34
3,720,6197,3578715587,3578715622,35
3,720,6198,3578715587,3578715625,38
3,720,6199,3578715587,3578715626,39
3,720,6200,3578715587,3578715629,42
3,720,6201,3578715587,3578715631,44
3,720,6202,3578715587,3578715633,46
3,721,6203,3578715642,3578715642,0
3,721,6204,3578715642,3578715642,0
3,721,6205,3578715642,3578715643,1
3,721,6206,3578715642,3578715644,2
3,721,6207,3578715642,3578715645,3
3,721,6208,3578715642,3578715650,8
3,721,6209,3578715642,3578715651,9
3,721,6210,3578715642,3578715651,9
3,721,6211,3578715642,3578715653,11
3,721,6212,3578715642,3578715661,19
3,721,6213,3578715642,3578715662,20
3,721,6214,3578715642,3578715667,25
3,721,6215,3578715642,3578715668,26
3,721,6216,3578715642,3578715669,27
3,721,6217,3578715642,3578715676,34
3,721,6218,3578715642,3578715676,34
3,721,6219,3578715642,3578715678,36
3,721,6220,3578715642,3578715678,36
3,721,6221,3578715642,3578715678,36
3,721,6222,3578715642,3578715678,36
3,721,6223,3578715642,3578715680,38
3,721,6224,3578715642,3578715685,43
3,721,6225,3578715642,3578715686,44
3,721,6226,3578715642,3578715688,46
3,721,6227,3578715642,3578715689,47
3,722,6228,3578715696,3578715697,1
3,722,6229,3578715696,3578715698,2
3,722,6230,3578715696,3578715699,3
3,722,6231,3578715696,3578715699,3
3,722,6232,3578715696,3578715699,3
3,722,6233,3578715696,3578715700,4
3,722,6234,3578715696,3578715700,4
3,722,6235,3578715696,3578715704,8
3,722,6236,3578715696,3578715710,14
3,722,6237,3578715696,3578715715,19
3,722,6238,3578715696,3578715717,21
3,722,6239,3578715696,3578715718,22
3,722,6240,3578715696,3578715719,23
3,722,6241,3578715696,3578715720,24
3,722,6242,3578715696,3578715723,27
3,722,6243,3578715696,3578715726,30
3,722,6244,3578715696,3578715733,37
3,722,6245,3578715696,3578715735,39
3,722,6246,3578715696,3578715736,40
3,722,6247,3578715696,3578715737,41
3,722,6248,3578715696,3578715737,41
3,722,6249,3578715696,3578715737,41
3,722,6250,3578715696,3578715738,42
3,722,6251,3578715696,3578715738,42
3,722,6252,3578715696,3578715740,44
3,722,6253,3578715696,3578715744,48
3,722,6254,3578715696,3578715745,49
3,722,6255,3578715696,3578715745,49
3,723,6256,3578715751,3578715751,0
3,723,6257,3578715751,3578715751,0
3,723,6258,3578715751,3578715751,0
3,723,6259,3578715751,3578715752,1
3,723,6260,3578715751,3578715753,2
3,723,6261,3578715751,3578715757,6
3,723,6262,3578715751,3578715763,12
3,723,6263,3578715751,3578715764,13
3,723,6264,3578715751,3578715764,13
3,723,6265,3578715751,3578715768,17
3,723,6266,3578715751,3578715769,18
3,723,6267,3578715751,3578715769,18
3,723,6268,3578715751,3578715773,22
3,723,6269,3578715751,3578715774,23
3,723,6270,3578715751,3578715774,23
3,723,6271,3578715751,3578715775,24
3,723,6272,3578715751,3578715778,27
3,723,6273,3578715751,3578715778,27
3,723,6274,3578715751,3578715783,32
3,723,6275,3578715751,3578715783,32
3,723,6276,3578715751,3578715785,34
3,723,6277,3578715751,3578715787,36
3,723,6278,3578715751,3578715788,37
3,723,6279,3578715751,3578715789,38
3,723,6280,3578715751,3578715790,39
3,723,6281,3578715751,3578715791,40
3,724,6282,3578715805,3578715805,0
3,724,6283,3578715805,3578715805,0
3,724,6284,3578715805,3578715805,0
3,724,6285,3578715805,3578715805,0
3,724,6286,3578715805,3578715805,0
3,724,6287,3578715805,3578715805,0
3,724,6288,3578715805,3578715807,2
3,724,6289,3578715805,3578715808,3
3,724,6290,3578715805,3578715809,4
3,724,6291,3578715805,3578715811,6
3,724,6292,3578715805,3578715814,9
3,724,6293,3578715805,3578715814,9
3,724,6294,3578715805,3578715816,11
3,724,6295,3578715805,3578715820,15
3,724,6296,3578715805,3578715822,17
3,724,6297,3578715805,3578715822,17
3,724,6298,3578715805,3578715823,18
3,724,6299,3578715805,3578715824,19
3,724,6300,3578715805,3578715825,20
3,724,6301,3578715805,3578715828,23
3,724,6302,3578715805,3578715831,26
3,724,6303,3578715805,3578715833,28
3,724,6304,3578715805,3578715839,34
3,724,6305,3578715805,3578715842,37
3,724,6306,3578715805,3578715843,38
3,724,6307,3578715805,3578715844,39
3,724,6308,3578715805,3578715846,41
3,724,6309,3578715805,3578715850,45
3,724,6310,3578715805,3578715851,46
3,724,6311,3578715805,3578715851,46
3,724,6312,3578715805,3578715853,48
3,725,6313,3578715859,3578715862,3
3,725,6314,3578715859,3578715862,3
3,725,6315,3578715859,3578715868,9
3,725,6316,3578715859,3578715868,9
3,725,6317,3578715859,3578715869,10
3,725,6318,3578715859,3578715870,11
3,725,6319,3578715859,3578715876,17
3,725,6320,3578715859,3578715876,17
3,725,6321,3578715859,3578715877,18
3,725,6322,3578715859,3578715878,19
3,725,6323,3578715859,3578715878,19
3,725,6324,3578715859,3578715878,19
3,725,6325,3578715859,3578715880,21
3,725,6326,3578715859,3578715886,27
3,725,6327,3578715859,3578715886,27
3,725,6328,3578715859,3578715887,28
3,725,6329,3578715859,3578715889,30
3,725,6330,3578715859,3578715897,38
3,725,6331,3578715859,3578715898,39
3,725,6332,3578715859,3578715898,39
3,725,6333,3578715859,3578715899,40
3,725,6334,3578715859,3578715899,40
3,725,6335,3578715859,3578715900,41
3,725,6336,3578715859,3578715900,41
3,725,6337,3578715859,3578715904,45
3,726,6338,3578715913,3578715913,0
3,726,6339,3578715913,3578715915,2
3,726,6340,3578715913,3578715917,4
3,726,6341,3578715913,3578715918,5
3,726,6342,3578715913,3578715918,5
3,726,6343,3578715913,3578715921,8
3,726,6344,3578715913,3578715923,10
3,726,6345,3578715913,3578715926,13
3,726,6346,3578715913,3578715933,20
3,726,6347,3578715913,3578715935,22
3,726,6348,3578715913,3578715936,23
3,726,6349,3578715913,3578715937,24
3,726,6350,3578715913,3578715938,25
3,726,6351,3578715913,3578715938,25
3,726,6352,3578715913,3578715938,25
3,726,6353,3578715913,3578715939,26
3,726,6354,3578715913,3578715941,28
3,726,6355,3578715913,3578715945,32
3,726,6356,3578715913,3578715945,32
3,726,6357,3578715913,3578715945,32
3,726,6358,3578715913,3578715947,34
3,726,6359,3578715913,3578715950,37
3,726,6360,3578715913,3578715950,37
3,726,6361,3578715913,3578715952,39
3,726,6362,3578715913,3578715953,40
3,726,6363,3578715913,3578715955,42
3,726,6364,3578715913,3578715958,45
3,727,6365,3578715967,3578715967,0
3,727,6366,3578715967,3578715967,0
3,727,6367,3578715967,3578715967,0
3,727,6368,3578715967,3578715970,3
3,727,6369,3578715967,3578715970,3
3,727,6370,3578715967,3578715974,7
3,727,6371,3578715967,3578715974,7
3,727,6372,3578715967,3578715974,7
3,727,6373,3578715967,3578715975,8
3,727,6374,3578715967,3578715978,11
3,727,6375,3578715967,3578715982,15
3,727,6376,3578715967,3578715984,17
3,727,6377,3578715967,3578715985,18
3,727,6378,3578715967,3578715986,19
3,727,6379,3578715967,3578715988,21
3,727,6380,3578715967,3578715988,21
3,727,6381,3578715967,3578715990,23
3,727,6382,3578715967,3578715990,23
3,727,6383,3578715967,3578716001,34
3,727,6384,3578715967,3578716002,35
3,727,6385,3578715967,3578716003,36
3,727,6386,3578715967,3578716003,36
3,727,6387,3578715967,3578716003,36
3,727,6388,3578715967,3578716005,38
3,727,6389,3578715967,3578716007,40
3,727,6390,3578715967,3578716007,40
3,727,6391,3578715967,3578716009,42
3,727,6392,3578715967,3578716012,45
3,727,6393,3578715967,3578716014,47
3,727,6394,3578715967,3578716014,47
3,727,6395,3578715967,3578716016,49
3,728,6396,3578716021,3578716021,0
3,728,6397,3578716021,3578716022,1
3,728,6398,3578716021,3578716023,2
3,728,6399,3578716021,3578716025,4
3,728,6400,3578716021,3578716026,5
3,728,6401,3578716021,3578716027,6
3,728,6402,3578716021,3578716029,8
3,728,6403,3578716021,3578716032,11
3,728,6404,3578716021,3578716033,12
3,728,6405,3578716021,3578716040,19
3,728,6406,3578716021,3578716041,20
3,728,6407,3578716021,3578716043,22
3,728,6408,3578716021,3578716045,24
3,728,6409,3578716021,3578716046,25
3,728,6410,3578716021,3578716050,29
3,728,6411,3578716021,3578716052,31
3,728,6412,3578716021,3578716052,31
3,728,6413,3578716021,3578716054,33
3,728,6414,3578716021,3578716062,41
3,728,6415,3578716021,3578716063,42
3,728,6416,3578716021,3578716064,43
3,728,6417,3578716021,3578716067,46
3,728,6418,3578716021,3578716068,47
3,728,6419,3578716021,3578716069,48
3,728,6420,3578716021,3578716069,48
3,729,6421,3578716075,3578716076,1
3,729,6422,3578716075,3578716076,1
3,729,6423,3578716075,3578716078,3
3,729,6424,3578716075,3578716078,3
3,729,6425,3578716075,3578716078,3
3,729,6426,3578716075,3578716078,3
3,729,6427,3578716075,3578716079,4
3,729,6428,3578716075,3578716081,6
3,729,6429,3578716075,3578716086,11
3,729,6430,3578716075,3578716086,11
3,729,6431,3578716075,3578716087,12
3,729,6432,3578716075,3578716089,14
3,729,6433,3578716075,3578716097,22
3,729,6434,3578716075,3578716098,23
3,729,6435,3578716075,3578716098,23
3,729,6436,3578716075,3578716099,24
3,729,6437,3578716075,3578716100,25
3,729,6438,3578716075,3578716100,25
3,729,6439,3578716075,3578716100,25
3,729,6440,3578716075,3578716103,28
3,729,6441,3578716075,3578716111,36
3,729,6442,3578716075,3578716115,40
3,729,6443,3578716075,3578716117,42
3,729,6444,3578716075,3578716118,43
3,729,6445,3578716075,3578716118,43
3,729,6446,3578716075,3578716121,46
3,729,6447,3578716075,3578716123,48
3,730,6448,3578716128,3578716128,0
3,730,6449,3578716128,3578716134,6
3,730,6450,3578716128,3578716136,8
3,730,6451,3578716128,3578716137,9
3,730,6452,3578716128,3578716138,10
3,730,6453,3578716128,3578716138,10
3,730,6454,3578716128,3578716138,10
3,730,6455,3578716128,3578716138,10
3,730,6456,3578716128,3578716139,11
3,730,6457,3578716128,3578716141,13
3,730,6458,3578716128,3578716144,16
3,730,6459,3578716128,3578716145,17
3,730,6460,3578716128,3578716145,17
3,730,6461,3578716128,3578716147,19
3,730,6462,3578716128,3578716150,22
3,730,6463,3578716128,3578716150,22
3,730,6464,3578716128,3578716153,25
3,730,6465,3578716128,3578716153,25
3,730,6466,3578716128,3578716157,29
3,730,6467,3578716128,3578716163,35
3,730,6468,3578716128,3578716164,36
3,730,6469,3578716128,3578716165,37
3,730,6470,3578716128,3578716168,40
3,730,6471,3578716128,3578716169,41
3,730,6472,3578716128,3578716170,42
3,730,6473,3578716128,3578716173,45
3,730,6474,3578716128,3578716174,46
3,730,6475,3578716128,3578716174,46
3,730,6476,3578716128,3578716176,48
3,731,6477,3578716183,3578716183,0
3,731,6478,3578716183,3578716183,0
3,731,6479,3578716183,3578716183,0
3,731,6480,3578716183,3578716183,0
3,731,6481,3578716183,3578716184,1
3,731,6482,3578716183,3578716186,3
3,731,6483,3578716183,3578716187,4
3,731,6484,3578716183,3578716188,5
3,731,6485,3578716183,3578716189,6
3,731,6486,3578716183,3578716191,8
3,731,6487,3578716183,3578716192,9
3,731,6488,3578716183,3578716202,19
3,731,6489,3578716183,3578716202,19
3,731,6490,3578716183,3578716203,20
3,731,6491,3578716183,3578716203,20
3,731,6492,3578716183,3578716204,21
3,731,6493,3578716183,3578716206,23
3,731,6494,3578716183,3578716208,25
3,731,6495,3578716183,3578716208,25
3,731,6496,3578716183,3578716210,27
3,731,6497,3578716183,3578716212,29
3,731,6498,3578716183,3578716214,31
3,731,6499,3578716183,3578716216,33
3,731,6500,3578716183,3578716221,38
3,731,6501,3578716183,3578716222,39
3,731,6502,3578716183,3578716223,40
3,731,6503,3578716183,3578716226,43
3,731,6504,3578716183,3578716227,44
3,731,6505,3578716183,3578716227,44
3,731,6506,3578716183,3578716229,46
3,731,6507,3578716183,3578716231,48
3,732,6508,3578716238,3578716238,0
3,732,6509,3578716238,3578716239,1
3,732,6510,3578716238,3578716242,4
3,732,6511,3578716238,3578716244,6
3,732,6512,3578716238,3578716246,8
3,732,6513,3578716238,3578716251,13
3,732,6514,3578716238,3578716253,15
3,732,6515,3578716238,3578716254,16
3,732,6516,3578716238,3578716261,23
3,732,6517,3578716238,3578716263,25
3,732,6518,3578716238,3578716264,26
3,732,6519,3578716238,3578716268,30
3,732,6520,3578716238,3578716268,30
3,732,6521,3578716238,3578716269,31
3,732,6522,3578716238,3578716270,32
3,732,6523,3578716238,3578716277,39
3,732,6524,3578716238,3578716277,39
3,732,6525,3578716238,3578716277,39
3,732,6526,3578716238,3578716277,39
3,732,6527,3578716238,3578716278,40
3,732,6528,3578716238,3578716278,40
3,732,6529,3578716238,3578716278,40
3,732,6530,3578716238,3578716281,43
3,732,6531,3578716238,3578716287,49
3,732,6532,3578716238,3578716287,49
3,733,6533,3578716293,3578716293,0
3,733,6534,3578716293,3578716297,4
3,733,6535,3578716293,3578716297,4
3,733,6536,3578716293,3578716299,6
3,733,6537,3578716293,3578716299,6
3,733,6538,3578716293,3578716300,7
3,733,6539,3578716293,3578716300,7
3,733,6540,3578716293,3578716300,7
3,733,6541,3578716293,3578716305,12
3,733,6542,3578716293,3578716311,18
3,733,6543,3578716293,3578716315,22
3,733,6544,3578716293,3578716317,24
3,733,6545,3578716293,3578716318,25
3,733,6546,3578716293,3578716318,25
3,733,6547,3578716293,3578716320,27
3,733,6548,3578716293,3578716323,30
3,733,6549,3578716293,3578716326,33
3,733,6550,3578716293,3578716335,42
3,733,6551,3578716293,3578716336,43
3,733,6552,3578716293,3578716337,44
3,733,6553,3578716293,3578716338,45
3,733,6554,3578716293,3578716339,46
3,733,6555,3578716293,3578716339,46
3,733,6556,3578716293,3578716339,46
3,733,6557,3578716293,3578716339,46
3,733,6558,3578716293,3578716341,48
3,734,6559,3578716347,3578716347,0
3,734,6560,3578716347,3578716347,0
3,734,6561,3578716347,3578716347,0
3,734,6562,3578716347,3578716348,1
3,734,6563,3578716347,3578716350,3
3,734,6564,3578716347,3578716351,4
3,734,6565,3578716347,3578716353,6
3,734,6566,3578716347,3578716353,6
3,734,6567,3578716347,3578716355,8
3,734,6568,3578716347,3578716357,10
3,734,6569,3578716347,3578716364,17
3,734,6570,3578716347,3578716364,17
3,734,6571,3578716347,3578716366,19
3,734,6572,3578716347,3578716368,21
3,734,6573,3578716347,3578716369,22
3,734,6574,3578716347,3578716371,24
3,734,6575,3578716347,3578716373,26
3,734,6576,3578716347,3578716374,27
3,734,6577,3578716347,3578716374,27
3,734,6578,3578716347,3578716377,30
3,734,6579,3578716347,3578716379,32
3,734,6580,3578716347,3578716380,33
3,734,6581,3578716347,3578716382,35
3,734,6582,3578716347,3578716384,37
3,734,6583,3578716347,3578716386,39
3,734,6584,3578716347,3578716387,40
3,734,6585,3578716347,3578716389,42
3,734,6586,3578716347,3578716389,42
3,734,6587,3578716347,3578716391,44
3,735,6588,3578716401,3578716402,1
3,735,6589,3578716401,3578716403,2
3,735,6590,3578716401,3578716404,3
3,735,6591,3578716401,3578716404,3
3,735,6592,3578716401,3578716405,4
3,735,6593,3578716401,3578716406,5
3,735,6594,3578716401,3578716408,7
3,735,6595,3578716401,3578716408,7
3,735,6596,3578716401,3578716410,9
3,735,6597,3578716401,3578716412,11
3,735,6598,3578716401,3578716414,13
3,735,6599,3578716401,3578716415,14
3,735,6600,3578716401,3578716417,16
3,735,6601,3578716401,3578716421,20
3,735,6602,3578716401,3578716422,21
3,735,6603,3578716401,3578716424,23
3,735,6604,3578716401,3578716425,24
3,735,6605,3578716401,3578716426,25
3,735,6606,3578716401,3578716426,25
3,735,6607,3578716401,3578716427,26
3,735,6608,3578716401,3578716429,28
3,735,6609,3578716401,3578716432,31
3,735,6610,3578716401,3578716433,32
3,735,6611,3578716401,3578716434,33
3,735,6612,3578716401,3578716439,38
3,735,6613,3578716401,3578716442,41
3,735,6614,3578716401,3578716444,43
3,735,6615,3578716401,3578716444,43
3,735,6616,3578716401,3578716446,45
3,735,6617,3578716401,3578716450,49
3,736,6618,3578716456,3578716456,0
3,736,6619,3578716456,3578716456,0
3,736,6620,3578716456,3578716456,0
3,736,6621,3578716456,3578716462,6
3,736,6622,3578716456,3578716463,7
3,736,6623,3578716456,3578716465,9
3,736,6624,3578716456,3578716468,12
3,736,6625,3578716456,3578716469,13
3,736,6626,3578716456,3578716470,14
3,736,6627,3578716456,3578716470,14
3,736,6628,3578716456,3578716477,21
3,736,6629,3578716456,3578716477,21
3,736,6630,3578716456,3578716477,21
3,736,6631,3578716456,3578716478,22
3,736,6632,3578716456,3578716478,22
3,736,6633,3578716456,3578716478,22
3,736,6634,3578716456,3578716478,22
3,736,6635,3578716456,3578716481,25
3,736,6636,3578716456,3578716487,31
3,736,6637,3578716456,3578716487,31
3,736,6638,3578716456,3578716488,32
3,736,6639,3578716456,3578716489,33
3,736,6640,3578716456,3578716497,41
3,736,6641,3578716456,3578716498,42
3,736,6642,3578716456,3578716498,42
3,736,6643,3578716456,3578716499,43
3,736,6644,3578716456,3578716499,43
3,736,6645,3578716456,3578716500,44
3,736,6646,3578716456,3578716500,44
3,736,6647,3578716456,3578716505,49
3,737,6648,3578716513,3578716513,0
3,737,6649,3578716513,3578716514,1
3,737,6650,3578716513,3578716517,4
3,737,6651,3578716513,3578716517,4
3,737,6652,3578716513,3578716518,5
3,737,6653,3578716513,3578716519,6
3,737,6654,3578716513,3578716522,9
3,737,6655,3578716513,3578716525,12
3,737,6656,3578716513,3578716534,21
3,737,6657,3578716513,3578716535,22
3,737,6658,3578716513,3578716536,23
3,737,6659,3578716513,3578716536,23
3,737,6660,3578716513,3578716537,24
3,737,6661,3578716513,3578716538,25
3,737,6662,3578716513,3578716538,25
3,737,6663,3578716513,3578716539,26
3,737,6664,3578716513,3578716544,31
3,737,6665,3578716513,3578716544,31
3,737,6666,3578716513,3578716545,32
3,737,6667,3578716513,3578716546,33
3,737,6668,3578716513,3578716549,36
3,737,6669,3578716513,3578716550,37
3,737,6670,3578716513,3578716552,39
3,737,6671,3578716513,3578716552,39
3,737,6672,3578716513,3578716557,44
3,737,6673,3578716513,3578716562,49
3,738,6674,3578716567,3578716567,0
3,738,6675,3578716567,3578716567,0
3,738,6676,3578716567,3578716568,1
3,738,6677,3578716567,3578716568,1
3,738,6678,3578716567,3578716570,3
3,738,6679,3578716567,3578716573,6
3,738,6680,3578716567,3578716573,6
3,738,6681,3578716567,3578716573,6
3,738,6682,3578716567,3578716578,11
3,738,6683,3578716567,3578716578,11
3,738,6684,3578716567,3578716579,12
3,738,6685,3578716567,3578716583,16
3,738,6686,3578716567,3578716583,16
3,738,6687,3578716567,3578716585,18
3,738,6688,3578716567,3578716585,18
3,738,6689,3578716567,3578716585,18
3,738,6690,3578716567,3578716587,20
3,738,6691,3578716567,3578716588,21
3,738,6692,3578716567,3578716590,23
3,738,6693,3578716567,3578716601,34
3,738,6694,3578716567,3578716602,35
3,738,6695,3578716567,3578716603,36
3,738,6696,3578716567,3578716603,36
3,738,6697,3578716567,3578716603,36
3,738,6698,3578716567,3578716605,38
3,738,6699,3578716567,3578716607,40
3,738,6700,3578716567,3578716608,41
3,738,6701,3578716567,3578716609,42
3,738,6702,3578716567,3578716611,44
3,738,6703,3578716567,3578716614,47
3,738,6704,3578716567,3578716615,48
3,738,6705,3578716567,3578716616,49
3,739,6706,3578716621,3578716621,0
3,739,6707,3578716621,3578716621,0
3,739,6708,3578716621,3578716622,1
3,739,6709,3578716621,3578716623,2
3,739,6710,3578716621,3578716625,4
3,739,6711,3578716621,3578716626,5
3,739,6712,3578716621,3578716626,5
3,739,6713,3578716621,3578716629,8
3,739,6714,3578716621,3578716631,10
3,739,6715,3578716621,3578716632,11
3,739,6716,3578716621,3578716633,12
3,739,6717,3578716621,3578716639,18
3,739,6718,3578716621,3578716641,20
3,739,6719,3578716621,3578716643,22
3,739,6720,3578716621,3578716644,23
3,739,6721,3578716621,3578716646,25
3,739,6722,3578716621,3578716650,29
3,739,6723,3578716621,3578716651,30
3,739,6724,3578716621,3578716653,32
3,739,6725,3578716621,3578716653,32
3,739,6726,3578716621,3578716661,40
3,739,6727,3578716621,3578716662,41
3,739,6728,3578716621,3578716664,43
3,739,6729,3578716621,3578716667,46
3,739,6730,3578716621,3578716668,47
3,739,6731,3578716621,3578716669,48
3,739,6732,3578716621,3578716669,48
3,740,6733,3578716675,3578716677,2
3,740,6734,3578716675,3578716677,2
3,740,6735,3578716675,3578716678,3
3,740,6736,3578716675,3578716678,3
3,740,6737,3578716675,3578716678,3
3,740,6738,3578716675,3578716678,3
3,740,6739,3578716675,3578716688,13
3,740,6740,3578716675,3578716688,13
3,740,6741,3578716675,3578716688,13
3,740,6742,3578716675,3578716689,14
3,740,6743,3578716675,3578716697,22
3,740,6744,3578716675,3578716698,23
3,740,6745,3578716675,3578716699,24
3,740,6746,3578716675,3578716699,24
3,740,6747,3578716675,3578716699,24
3,740,6748,3578716675,3578716700,25
3,740,6749,3578716675,3578716700,25
3,740,6750,3578716675,3578716705,30
3,740,6751,3578716675,3578716710,35
3,740,6752,3578716675,3578716714,39
3,740,6753,3578716675,3578716717,42
3,740,6754,3578716675,3578716719,44
3,740,6755,3578716675,3578716721,46
3,740,6756,3578716675,3578716723,48
3,740,6757,3578716675,3578716724,49
3,741,6758,3578716729,3578716735,6
3,741,6759,3578716729,3578716735,6
3,741,6760,3578716729,3578716736,7
3,741,6761,3578716729,3578716737,8
3,741,6762,3578716729,3578716737,8
3,741,6763,3578716729,3578716738,9
3,741,6764,3578716729,3578716738,9
3,741,6765,3578716729,3578716739,10
3,741,6766,3578716729,3578716740,11
3,741,6767,3578716729,3578716745,16
3,741,6768,3578716729,3578716745,16
3,741,6769,3578716729,3578716745,16
3,741,6770,3578716729,3578716747,18
3,741,6771,3578716729,3578716749,20
3,741,6772,3578716729,3578716749,20
3,741,6773,3578716729,3578716751,22
3,741,6774,3578716729,3578716752,23
3,741,6775,3578716729,3578716754,25
3,741,6776,3578716729,3578716756,27
3,741,6777,3578716729,3578716763,34
3,741,6778,3578716729,3578716763,34
3,741,6779,3578716729,3578716765,36
3,741,6780,3578716729,3578716768,39
3,741,6781,3578716729,3578716770,41
3,741,6782,3578716729,3578716773,44
3,741,6783,3578716729,3578716773,44
3,741,6784,3578716729,3578716774,45
3,741,6785,3578716729,3578716776,47
3,741,6786,3578716729,3578716778,49
3,741,6787,3578716729,3578716778,49
3,741,6788,3578716729,3578716779,50
3,742,6789,3578716783,3578716783,0
3,742,6790,3578716783,3578716783,0
3,742,6791,3578716783,3578716785,2
3,742,6792,3578716783,3578716786,3
3,742,6793,3578716783,3578716786,3
3,742,6794,3578716783,3578716788,5
3,742,6795,3578716783,3578716788,5
3,742,6796,3578716783,3578716790,7
3,742,6797,3578716783,3578716794,11
3,742,6798,3578716783,3578716801,18
3,742,6799,3578716783,3578716803,20
3,742,6800,3578716783,3578716803,20
3,742,6801,3578716783,3578716804,21
3,742,6802,3578716783,3578716804,21
3,742,6803,3578716783,3578716805,22
3,742,6804,3578716783,3578716807,24
3,742,6805,3578716783,3578716808,25
3,742,6806,3578716783,3578716810,27
3,742,6807,3578716783,3578716811,28
3,742,6808,3578716783,3578716813,30
3,742,6809,3578716783,3578716815,32
3,742,6810,3578716783,3578716816,33
3,742,6811,3578716783,3578716820,37
3,742,6812,3578716783,3578716821,38
3,742,6813,3578716783,3578716822,39
3,742,6814,3578716783,3578716823,40
3,742,6815,3578716783,3578716825,42
3,742,6816,3578716783,3578716825,42
3,742,6817,3578716783,3578716826,43
3,742,6818,3578716783,3578716829,46
3,742,6819,3578716783,3578716831,48
3,742,6820,3578716783,3578716832,49
3,742,6821,3578716783,3578716833,50
3,743,6822,3578716838,3578716839,1
3,743,6823,3578716838,3578716840,2
3,743,6824,3578716838,3578716843,5
3,743,6825,3578716838,3578716844,6
3,743,6826,3578716838,3578716845,7
3,743,6827,3578716838,3578716845,7
3,743,6828,3578716838,3578716849,11
3,743,6829,3578716838,3578716851,13
3,743,6830,3578716838,3578716853,15
3,743,6831,3578716838,3578716853,15
3,743,6832,3578716838,3578716862,24
3,743,6833,3578716838,3578716862,24
3,743,6834,3578716838,3578716863,25
3,743,6835,3578716838,3578716867,29
3,743,6836,3578716838,3578716868,30
3,743,6837,3578716838,3578716869,31
3,743,6838,3578716838,3578716869,31
3,743,6839,3578716838,3578716877,39
3,743,6840,3578716838,3578716877,39
3,743,6841,3578716838,3578716878,40
3,743,6842,3578716838,3578716878,40
3,743,6843,3578716838,3578716879,41
3,744,6844,3578716892,3578716892,0
3,744,6845,3578716892,3578716892,0
3,744,6846,3578716892,3578716892,0
3,744,6847,3578716892,3578716897,5
3,744,6848,3578716892,3578716898,6
3,744,6849,3578716892,3578716899,7
3,744,6850,3578716892,3578716899,7
3,744,6851,3578716892,3578716900,8
3,744,6852,3578716892,3578716900,8
3,744,6853,3578716892,3578716900,8
3,744,6854,3578716892,3578716905,13
3,744,6855,3578716892,3578716911,19
3,744,6856,3578716892,3578716914,22
3,744,6857,3578716892,3578716917,25
3,744,6858,3578716892,3578716920,28
3,744,6859,3578716892,3578716923,31
3,744,6860,3578716892,3578716925,33
3,744,6861,3578716892,3578716935,43
3,744,6862,3578716892,3578716936,44
3,744,6863,3578716892,3578716936,44
3,744,6864,3578716892,3578716938,46
3,744,6865,3578716892,3578716938,46
3,744,6866,3578716892,3578716939,47
3,744,6867,3578716892,3578716939,47
3,744,6868,3578716892,3578716939,47
3,744,6869,3578716892,3578716940,48
3,745,6870,3578716946,3578716946,0
3,745,6871,3578716946,3578716946,0
3,745,6872,3578716946,3578716946,0
3,745,6873,3578716946,3578716947,1
3,745,6874,3578716946,3578716950,4
3,745,6875,3578716946,3578716951,5
3,745,6876,3578716946,3578716952,6
3,745,6877,3578716946,3578716952,6
3,745,6878,3578716946,3578716957,11
3,745,6879,3578716946,3578716963,17
3,745,6880,3578716946,3578716964,18
3,745,6881,3578716946,3578716966,20
3,745,6882,3578716946,3578716969,23
3,745,6883,3578716946,3578716970,24
3,745,6884,3578716946,3578716973,27
3,745,6885,3578716946,3578716974,28
3,745,6886,3578716946,3578716975,29
3,745,6887,3578716946,3578716975,29
3,745,6888,3578716946,3578716977,31
3,745,6889,3578716946,3578716978,32
3,745,6890,3578716946,3578716979,33
3,745,6891,3578716946,3578716982,36
3,745,6892,3578716946,3578716984,38
3,745,6893,3578716946,3578716985,39
3,745,6894,3578716946,3578716986,40
3,745,6895,3578716946,3578716987,41
3,745,6896,3578716946,3578716987,41
3,745,6897,3578716946,3578716989,43
3,745,6898,3578716946,3578716990,44
3,745,6899,3578716946,3578716991,45
3,745,6900,3578716946,3578716994,48
3,746,6901,3578717001,3578717001,0
3,746,6902,3578717001,3578717003,2
3,746,6903,3578717001,3578717003,2
3,746,6904,3578717001,3578717004,3
3,746,6905,3578717001,3578717005,4
3,746,6906,3578717001,3578717005,4
3,746,6907,3578717001,3578717007,6
3,746,6908,3578717001,3578717008,7
3,746,6909,3578717001,3578717009,8
3,746,6910,3578717001,3578717012,11
3,746,6911,3578717001,3578717014,13
3,746,6912,3578717001,3578717015,14
3,746,6913,3578717001,3578717017,16
3,746,6914,3578717001,3578717020,19
3,746,6915,3578717001,3578717021,20
3,746,6916,3578717001,3578717022,21
3,746,6917,3578717001,3578717026,25
3,746,6918,3578717001,3578717026,25
3,746,6919,3578717001,3578717027,26
3,746,6920,3578717001,3578717029,28
3,746,6921,3578717001,3578717032,31
3,746,6922,3578717001,3578717033,32
3,746,6923,3578717001,3578717040,39
3,746,6924,3578717001,3578717041,40
3,746,6925,3578717001,3578717044,43
3,746,6926,3578717001,3578717044,43
3,746,6927,3578717001,3578717045,44
3,746,6928,3578717001,3578717045,44
3,746,6929,3578717001,3578717048,47
3,747,6930,3578717056,3578717056,0
3,747,6931,3578717056,3578717056,0
3,747,6932,3578717056,3578717056,0
3,747,6933,3578717056,3578717062,6
3,747,6934,3578717056,3578717063,7
3,747,6935,3578717056,3578717063,7
3,747,6936,3578717056,3578717068,12
3,747,6937,3578717056,3578717068,12
3,747,6938,3578717056,3578717068,12
3,747,6939,3578717056,3578717069,13
3,747,6940,3578717056,3578717077,21
3,747,6941,3578717056,3578717077,21
3,747,6942,3578717056,3578717078,22
3,747,6943,3578717056,3578717078,22
3,747,6944,3578717056,3578717079,23
3,747,6945,3578717056,3578717088,32
3,747,6946,3578717056,3578717088,32
3,747,6947,3578717056,3578717089,33
3,747,6948,3578717056,3578717089,33
3,747,6949,3578717056,3578717098,42
3,747,6950,3578717056,3578717099,43
3,747,6951,3578717056,3578717099,43
3,747,6952,3578717056,3578717099,43
3,747,6953,3578717056,3578717100,44
3,747,6954,3578717056,3578717100,44
3,747,6955,3578717056,3578717104,48
3,748,6956,3578717110,3578717111,1
3,748,6957,3578717110,3578717115,5
3,748,6958,3578717110,3578717117,7
3,748,6959,3578717110,3578717117,7
3,748,6960,3578717110,3578717120,10
3,748,6961,3578717110,3578717123,13
3,748,6962,3578717110,3578717126,16
3,748,6963,3578717110,3578717136,26
3,748,6964,3578717110,3578717136,26
3,748,6965,3578717110,3578717136,26
3,748,6966,3578717110,3578717138,28
3,748,6967,3578717110,3578717139,29
3,748,6968,3578717110,3578717139,29
3,748,6969,3578717110,3578717139,29
3,748,6970,3578717110,3578717140,30
3,748,6971,3578717110,3578717144,34
3,748,6972,3578717110,3578717145,35
3,748,6973,3578717110,3578717145,35
3,748,6974,3578717110,3578717148,38
3,748,6975,3578717110,3578717150,40
3,748,6976,3578717110,3578717152,42
3,748,6977,3578717110,3578717152,42
3,748,6978,3578717110,3578717155,45
3,748,6979,3578717110,3578717157,47
3,748,6980,3578717110,3578717157,47
3,749,6981,3578717165,3578717165,0
3,749,6982,3578717165,3578717165,0
3,749,6983,3578717165,3578717167,2
3,749,6984,3578717165,3578717168,3
3,749,6985,3578717165,3578717170,5
3,749,6986,3578717165,3578717174,9
3,749,6987,3578717165,3578717174,9
3,749,6988,3578717165,3578717175,10
3,749,6989,3578717165,3578717176,11
3,749,6990,3578717165,3578717178,13
3,749,6991,3578717165,3578717178,13
3,749,6992,3578717165,3578717179,14
3,749,6993,3578717165,3578717182,17
3,749,6994,3578717165,3578717184,19
3,749,6995,3578717165,3578717185,20
3,749,6996,3578717165,3578717186,21
3,749,6997,3578717165,3578717187,22
3,749,6998,3578717165,3578717188,23
3,749,6999,3578717165,3578717188,23
3,749,7000,3578717165,3578717191,26
3,749,7001,3578717165,3578717191,26
3,749,7002,3578717165,3578717194,29
3,749,7003,3578717165,3578717203,38
3,749,7004,3578717165,3578717203,38
3,749,7005,3578717165,3578717204,39
3,749,7006,3578717165,3578717204,39
3,749,7007,3578717165,3578717205,40
3,749,7008,3578717165,3578717206,41
3,749,7009,3578717165,3578717208,43
3,749,7010,3578717165,3578717208,43
3,749,7011,3578717165,3578717210,45
3,749,7012,3578717165,3578717212,47
3,749,7013,3578717165,3578717214,49
3,749,7014,3578717165,3578717214,49
3,750,7015,3578717221,3578717221,0
3,750,7016,3578717221,3578717221,0
3,750,7017,3578717221,3578717224,3
3,750,7018,3578717221,3578717225,4
3,750,7019,3578717221,3578717226,5
3,750,7020,3578717221,3578717226,5
3,750,7021,3578717221,3578717227,6
3,750,7022,3578717221,3578717229,8
3,750,7023,3578717221,3578717232,11
3,750,7024,3578717221,3578717234,13
3,750,7025,3578717221,3578717239,18
3,750,7026,3578717221,3578717242,21
3,750,7027,3578717221,3578717244,23
3,750,7028,3578717221,3578717244,23
3,750,7029,3578717221,3578717245,24
3,750,7030,3578717221,3578717246,25
3,750,7031,3578717221,3578717248,27
3,750,7032,3578717221,3578717251,30
3,750,7033,3578717221,3578717252,31
3,750,7034,3578717221,3578717253,32
3,750,7035,3578717221,3578717254,33
3,750,7036,3578717221,3578717261,40
3,750,7037,3578717221,3578717263,42
3,750,7038,3578717221,3578717263,42
3,750,7039,3578717221,3578717267,46
3,750,7040,3578717221,3578717267,46
3,750,7041,3578717221,3578717269,48
3,751,7042,3578717275,3578717277,2
3,751,7043,3578717275,3578717277,2
3,751,7044,3578717275,3578717278,3
3,751,7045,3578717275,3578717279,4
3,751,7046,3578717275,3578717279,4
3,751,7047,3578717275,3578717288,13
3,751,7048,3578717275,3578717289,14
3,751,7049,3578717275,3578717289,14
3,751,7050,3578717275,3578717297,22
3,751,7051,3578717275,3578717298,23
3,751,7052,3578717275,3578717299,24
3,751,7053,3578717275,3578717299,24
3,751,7054,3578717275,3578717300,25
3,751,7055,3578717275,3578717300,25
3,751,7056,3578717275,3578717300,25
3,751,7057,3578717275,3578717304,29
3,751,7058,3578717275,3578717312,37
3,751,7059,3578717275,3578717316,41
3,751,7060,3578717275,3578717317,42
3,751,7061,3578717275,3578717318,43
3,751,7062,3578717275,3578717320,45
3,751,7063,3578717275,3578717323,48
3,752,7064,3578717329,3578717329,0
3,752,7065,3578717329,3578717336,7
3,752,7066,3578717329,3578717336,7
3,752,7067,3578717329,3578717337,8
3,752,7068,3578717329,3578717338,9
3,752,7069,3578717329,3578717338,9
3,752,7070,3578717329,3578717339,10
3,752,7071,3578717329,3578717340,11
3,752,7072,3578717329,3578717340,11
3,752,7073,3578717329,3578717341,12
3,752,7074,3578717329,3578717344,15
3,752,7075,3578717329,3578717345,16
3,752,7076,3578717329,3578717346,17
3,752,7077,3578717329,3578717348,19
3,752,7078,3578717329,3578717350,21
3,752,7079,3578717329,3578717351,22
3,752,7080,3578717329,3578717352,23
3,752,7081,3578717329,3578717352,23
3,752,7082,3578717329,3578717357,28
3,752,7083,3578717329,3578717358,29
3,752,7084,3578717329,3578717363,34
3,752,7085,3578717329,3578717365,36
3,752,7086,3578717329,3578717366,37
3,752,7087,3578717329,3578717367,38
3,752,7088,3578717329,3578717369,40
3,752,7089,3578717329,3578717371,42
3,752,7090,3578717329,3578717374,45
3,752,7091,3578717329,3578717374,45
3,752,7092,3578717329,3578717375,46
3,752,7093,3578717329,3578717377,48
3,752,7094,3578717329,3578717379,50
3,753,7095,3578717383,3578717383,0
3,753,7096,3578717383,3578717383,0
3,753,7097,3578717383,3578717383,0
3,753,7098,3578717383,3578717384,1
3,753,7099,3578717383,3578717385,2
3,753,7100,3578717383,3578717387,4
3,753,7101,3578717383,3578717387,4
3,753,7102,3578717383,3578717388,5
3,753,7103,3578717383,3578717389,6
3,753,7104,3578717383,3578717391,8
3,753,7105,3578717383,3578717391,8
3,753,7106,3578717383,3578717394,11
3,753,7107,3578717383,3578717403,20
3,753,7108,3578717383,3578717403,20
3,753,7109,3578717383,3578717405,22
3,753,7110,3578717383,3578717405,22
3,753,7111,3578717383,3578717405,22
3,753,7112,3578717383,3578717406,23
3,753,7113,3578717383,3578717407,24
3,753,7114,3578717383,3578717408,25
3,753,7115,3578717383,3578717408,25
3,753,7116,3578717383,3578717410,27
3,753,7117,3578717383,3578717414,31
3,753,7118,3578717383,3578717415,32
3,753,7119,3578717383,3578717420,37
3,753,7120,3578717383,3578717421,38
3,753,7121,3578717383,3578717424,41
3,753,7122,3578717383,3578717426,43
3,753,7123,3578717383,3578717426,43
3,753,7124,3578717383,3578717426,43
3,753,7125,3578717383,3578717430,47
3,753,7126,3578717383,3578717432,49
3,753,7127,3578717383,3578717432,49
3,754,7128,3578717437,3578717437,0
3,754,7129,3578717437,3578717439,2
3,754,7130,3578717437,3578717442,5
3,754,7131,3578717437,3578717444,7
3,754,7132,3578717437,3578717445,8
3,754,7133,3578717437,3578717445,8
3,754,7134,3578717437,3578717446,9
3,754,7135,3578717437,3578717448,11
3,754,7136,3578717437,3578717450,13
3,754,7137,3578717437,3578717452,15
3,754,7138,3578717437,3578717453,16
3,754,7139,3578717437,3578717454,17
3,754,7140,3578717437,3578717462,25
3,754,7141,3578717437,3578717463,26
3,754,7142,3578717437,3578717464,27
3,754,7143,3578717437,3578717468,31
3,754,7144,3578717437,3578717469,32
3,754,7145,3578717437,3578717470,33
3,754,7146,3578717437,3578717477,40
3,754,7147,3578717437,3578717478,41
3,754,7148,3578717437,3578717478,41
3,754,7149,3578717437,3578717478,41
3,754,7150,3578717437,3578717478,41
3,754,7151,3578717437,3578717479,42
3,755,7152,3578717491,3578717491,0
3,755,7153,3578717491,3578717491,0
3,755,7154,3578717491,3578717491,0
3,755,7155,3578717491,3578717491,0
3,755,7156,3578717491,3578717497,6
3,755,7157,3578717491,3578717497,6
3,755,7158,3578717491,3578717498,7
3,755,7159,3578717491,3578717498,7
3,755,7160,3578717491,3578717500,9
3,755,7161,3578717491,3578717500,9
3,755,7162,3578717491,3578717500,9
3,755,7163,3578717491,3578717504,13
3,755,7164,3578717491,3578717512,21
3,755,7165,3578717491,3578717514,23
3,755,7166,3578717491,3578717517,26
3,755,7167,3578717491,3578717517,26
3,755,7168,3578717491,3578717520,29
3,755,7169,3578717491,3578717523,32
3,755,7170,3578717491,3578717527,36
3,755,7171,3578717491,3578717535,44
3,755,7172,3578717491,3578717535,44
3,755,7173,3578717491,3578717536,45
3,755,7174,3578717491,3578717536,45
3,755,7175,3578717491,3578717537,46
3,755,7176,3578717491,3578717537,46
3,755,7177,3578717491,3578717538,47
3,755,7178,3578717491,3578717540,49
3,756,7179,3578717545,3578717545,0
3,756,7180,3578717545,3578717545,0
3,756,7181,3578717545,3578717545,0
3,756,7182,3578717545,3578717546,1
3,756,7183,3578717545,3578717549,4
3,756,7184,3578717545,3578717549,4
3,756,7185,3578717545,3578717551,6
3,756,7186,3578717545,3578717551,6
3,756,7187,3578717545,3578717554,9
3,756,7188,3578717545,3578717555,10
3,756,7189,3578717545,3578717557,12
3,756,7190,3578717545,3578717562,17
3,756,7191,3578717545,3578717564,19
3,756,7192,3578717545,3578717566,21
3,756,7193,3578717545,3578717568,23
3,756,7194,3578717545,3578717568,23
3,756,7195,3578717545,3578717569,24
3,756,7196,3578717545,3578717572,27
3,756,7197,3578717545,3578717573,28
3,756,7198,3578717545,3578717575,30
3,756,7199,3578717545,3578717577,32
3,756,7200,3578717545,3578717578,33
3,756,7201,3578717545,3578717578,33
3,756,7202,3578717545,3578717582,37
3,756,7203,3578717545,3578717583,38
3,756,7204,3578717545,3578717584,39
3,756,7205,3578717545,3578717585,40
3,756,7206,3578717545,3578717586,41
3,756,7207,3578717545,3578717588,43
3,756,7208,3578717545,3578717590,45
3,756,7209,3578717545,3578717593,48
3,757,7210,3578717600,3578717601,1
3,757,7211,3578717600,3578717601,1
3,757,7212,3578717600,3578717603,3
3,757,7213,3578717600,3578717604,4
3,757,7214,3578717600,3578717604,4
3,757,7215,3578717600,3578717605,5
3,757,7216,3578717600,3578717605,5
3,757,7217,3578717600,3578717606,6
3,757,7218,3578717600,3578717607,7
3,757,7219,3578717600,3578717608,8
3,757,7220,3578717600,3578717608,8
3,757,7221,3578717600,3578717613,13
3,757,7222,3578717600,3578717614,14
3,757,7223,3578717600,3578717617,17
3,757,7224,3578717600,3578717619,19
3,757,7225,3578717600,3578717620,20
3,757,7226,3578717600,3578717622,22
3,757,7227,3578717600,3578717625,25
3,757,7228,3578717600,3578717625,25
3,757,7229,3578717600,3578717626,26
3,757,7230,3578717600,3578717628,28
3,757,7231,3578717600,3578717631,31
3,757,7232,3578717600,3578717632,32
3,757,7233,3578717600,3578717635,35
3,757,7234,3578717600,3578717639,39
3,757,7235,3578717600,3578717641,41
3,757,7236,3578717600,3578717643,43
3,757,7237,3578717600,3578717644,44
3,757,7238,3578717600,3578717644,44
3,757,7239,3578717600,3578717645,45
3,757,7240,3578717600,3578717648,48
3,758,7241,3578717654,3578717654,0
3,758,7242,3578717654,3578717654,0
3,758,7243,3578717654,3578717654,0
3,758,7244,3578717654,3578717660,6
3,758,7245,3578717654,3578717663,9
3,758,7246,3578717654,3578717663,9
3,758,7247,3578717654,3578717667,13
3,758,7248,3578717654,3578717669,15
3,758,7249,3578717654,3578717670,16
3,758,7250,3578717654,3578717671,17
3,758,7251,3578717654,3578717677,23
3,758,7252,3578717654,3578717677,23
3,758,7253,3578717654,3578717678,24
3,758,7254,3578717654,3578717679,25
3,758,7255,3578717654,3578717679,25
3,758,7256,3578717654,3578717680,26
3,758,7257,3578717654,3578717688,34
3,758,7258,3578717654,3578717688,34
3,758,7259,3578717654,3578717689,35
3,758,7260,3578717654,3578717690,36
3,758,7261,3578717654,3578717698,44
3,758,7262,3578717654,3578717698,44
3,758,7263,3578717654,3578717698,44
3,758,7264,3578717654,3578717699,45
3,758,7265,3578717654,3578717699,45
3,758,7266,3578717654,3578717701,47
3,758,7267,3578717654,3578717704,50
3,759,7268,3578717709,3578717712,3
3,759,7269,3578717709,3578717715,6
3,759,7270,3578717709,3578717717,8
3,759,7271,3578717709,3578717718,9
3,759,7272,3578717709,3578717720,11
3,759,7273,3578717709,3578717722,13
3,759,7274,3578717709,3578717727,18
3,759,7275,3578717709,3578717735,26
3,759,7276,3578717709,3578717735,26
3,759,7277,3578717709,3578717736,27
3,759,7278,3578717709,3578717737,28
3,759,7279,3578717709,3578717738,29
3,759,7280,3578717709,3578717738,29
3,759,7281,3578717709,3578717738,29
3,759,7282,3578717709,3578717739,30
3,759,7283,3578717709,3578717740,31
3,759,7284,3578717709,3578717744,35
3,759,7285,3578717709,3578717745,36
3,759,7286,3578717709,3578717745,36
3,759,7287,3578717709,3578717748,39
3,759,7288,3578717709,3578717749,40
3,759,7289,3578717709,3578717750,41
3,759,7290,3578717709,3578717751,42
3,759,7291,3578717709,3578717752,43
3,759,7292,3578717709,3578717754,45
3,759,7293,3578717709,3578717756,47
3,759,7294,3578717709,3578717757,48
3,760,7295,3578717764,3578717764,0
3,760,7296,3578717764,3578717764,0
3,760,7297,3578717764,3578717766,2
3,760,7298,3578717764,3578717769,5
3,760,7299,3578717764,3578717769,5
3,760,7300,3578717764,3578717771,7
3,760,7301,3578717764,3578717774,10
3,760,7302,3578717764,3578717775,11
3,760,7303,3578717764,3578717776,12
3,760,7304,3578717764,3578717778,14
3,760,7305,3578717764,3578717778,14
3,760,7306,3578717764,3578717782,18
3,760,7307,3578717764,3578717784,20
3,760,7308,3578717764,3578717785,21
3,760,7309,3578717764,3578717785,21
3,760,7310,3578717764,3578717787,23
3,760,7311,3578717764,3578717789,25
3,760,7312,3578717764,3578717791,27
3,760,7313,3578717764,3578717793,29
3,760,7314,3578717764,3578717801,37
3,760,7315,3578717764,3578717802,38
3,760,7316,3578717764,3578717803,39
3,760,7317,3578717764,3578717804,40
3,760,7318,3578717764,3578717804,40
3,760,7319,3578717764,3578717805,41
3,760,7320,3578717764,3578717805,41
3,760,7321,3578717764,3578717807,43
3,760,7322,3578717764,3578717807,43
3,760,7323,3578717764,3578717808,44
3,760,7324,3578717764,3578717810,46
3,760,7325,3578717764,3578717811,47
3,760,7326,3578717764,3578717813,49
3,760,7327,3578717764,3578717814,50
3,761,7328,3578717818,3578717818,0
3,761,7329,3578717818,3578717819,1
3,761,7330,3578717818,3578717821,3
3,761,7331,3578717818,3578717822,4
3,761,7332,3578717818,3578717825,7
3,761,7333,3578717818,3578717825,7
3,761,7334,3578717818,3578717825,7
3,761,7335,3578717818,3578717829,11
3,761,7336,3578717818,3578717831,13
3,761,7337,3578717818,3578717831,13
3,761,7338,3578717818,3578717835,17
3,761,7339,3578717818,3578717838,20
3,761,7340,3578717818,3578717841,23
3,761,7341,3578717818,3578717844,26
3,761,7342,3578717818,3578717844,26
3,761,7343,3578717818,3578717846,28
3,761,7344,3578717818,3578717848,30
3,761,7345,3578717818,3578717849,31
3,761,7346,3578717818,3578717851,33
3,761,7347,3578717818,3578717853,35
3,761,7348,3578717818,3578717853,35
3,761,7349,3578717818,3578717860,42
3,761,7350,3578717818,3578717862,44
3,761,7351,3578717818,3578717862,44
3,761,7352,3578717818,3578717863,45
3,761,7353,3578717818,3578717867,49
3,762,7354,3578717873,3578717873,0
3,762,7355,3578717873,3578717873,0
3,762,7356,3578717873,3578717873,0
3,762,7357,3578717873,3578717877,4
3,762,7358,3578717873,3578717878,5
3,762,7359,3578717873,3578717879,6
3,762,7360,3578717873,3578717879,6
3,762,7361,3578717873,3578717879,6
3,762,7362,3578717873,3578717880,7
3,762,7363,3578717873,3578717888,15
3,762,7364,3578717873,3578717889,16
3,762,7365,3578717873,3578717890,17
3,762,7366,3578717873,3578717891,18
3,762,7367,3578717873,3578717897,24
3,762,7368,3578717873,3578717897,24
3,762,7369,3578717873,3578717898,25
3,762,7370,3578717873,3578717900,27
3,762,7371,3578717873,3578717900,27
3,762,7372,3578717873,3578717900,27
3,762,7373,3578717873,3578717902,29
3,762,7374,3578717873,3578717903,30
3,762,7375,3578717873,3578717904,31
3,762,7376,3578717873,3578717913,40
3,762,7377,3578717873,3578717915,42
3,762,7378,3578717873,3578717917,44
3,762,7379,3578717873,3578717918,45
3,762,7380,3578717873,3578717921,48
3,762,7381,3578717873,3578717922,49
3,763,7382,3578717928,3578717928,0
3,763,7383,3578717928,3578717934,6
3,763,7384,3578717928,3578717934,6
3,763,7385,3578717928,3578717936,8
3,763,7386,3578717928,3578717937,9
3,763,7387,3578717928,3578717938,10
3,763,7388,3578717928,3578717939,11
3,763,7389,3578717928,3578717939,11
3,763,7390,3578717928,3578717940,12
3,763,7391,3578717928,3578717944,16
3,763,7392,3578717928,3578717945,17
3,763,7393,3578717928,3578717946,18
3,763,7394,3578717928,3578717948,20
3,763,7395,3578717928,3578717950,22
3,763,7396,3578717928,3578717951,23
3,763,7397,3578717928,3578717951,23
3,763,7398,3578717928,3578717952,24
3,763,7399,3578717928,3578717954,26
3,763,7400,3578717928,3578717954,26
3,763,7401,3578717928,3578717957,29
3,763,7402,3578717928,3578717957,29
3,763,7403,3578717928,3578717961,33
3,763,7404,3578717928,3578717964,36
3,763,7405,3578717928,3578717964,36
3,763,7406,3578717928,3578717966,38
3,763,7407,3578717928,3578717968,40
3,763,7408,3578717928,3578717969,41
3,763,7409,3578717928,3578717971,43
3,763,7410,3578717928,3578717971,43
3,763,7411,3578717928,3578717973,45
3,763,7412,3578717928,3578717974,46
3,763,7413,3578717928,3578717975,47
3,763,7414,3578717928,3578717976,48
3,763,7415,3578717928,3578717977,49
3,764,7416,3578717983,3578717983,0
3,764,7417,3578717983,3578717983,0
3,764,7418,3578717983,3578717984,1
3,764,7419,3578717983,3578717985,2
3,764,7420,3578717983,3578717986,3
3,764,7421,3578717983,3578717988,5
3,764,7422,3578717983,3578717989,6
3,764,7423,3578717983,3578717993,10
3,764,7424,3578717983,3578718001,18
3,764,7425,3578717983,3578718002,19
3,764,7426,3578717983,3578718003,20
3,764,7427,3578717983,3578718003,20
3,764,7428,3578717983,3578718004,21
3,764,7429,3578717983,3578718005,22
3,764,7430,3578717983,3578718006,23
3,764,7431,3578717983,3578718006,23
3,764,7432,3578717983,3578718007,24
3,764,7433,3578717983,3578718008,25
3,764,7434,3578717983,3578718011,28
3,764,7435,3578717983,3578718012,29
3,764,7436,3578717983,3578718014,31
3,764,7437,3578717983,3578718015,32
3,764,7438,3578717983,3578718017,34
3,764,7439,3578717983,3578718019,36
3,764,7440,3578717983,3578718021,38
3,764,7441,3578717983,3578718022,39
3,764,7442,3578717983,3578718025,42
3,764,7443,3578717983,3578718026,43
3,764,7444,3578717983,3578718026,43
3,764,7445,3578717983,3578718027,44
3,764,7446,3578717983,3578718031,48
3,764,7447,3578717983,3578718032,49
3,765,7448,3578718037,3578718037,0
3,765,7449,3578718037,3578718039,2
3,765,7450,3578718037,3578718041,4
3,765,7451,3578718037,3578718043,6
3,765,7452,3578718037,3578718044,7
3,765,7453,3578718037,3578718045,8
3,765,7454,3578718037,3578718048,11
3,765,7455,3578718037,3578718052,15
3,765,7456,3578718037,3578718053,16
3,765,7457,3578718037,3578718054,17
3,765,7458,3578718037,3578718059,22
3,765,7459,3578718037,3578718062,25
3,765,7460,3578718037,3578718062,25
3,765,7461,3578718037,3578718063,26
3,765,7462,3578718037,3578718063,26
3,765,7463,3578718037,3578718067,30
3,765,7464,3578718037,3578718069,32
3,765,7465,3578718037,3578718069,32
3,765,7466,3578718037,3578718077,40
3,765,7467,3578718037,3578718078,41
3,765,7468,3578718037,3578718079,42
3,765,7469,3578718037,3578718079,42
3,765,7470,3578718037,3578718079,42
3,765,7471,3578718037,3578718080,43
3,766,7472,3578718091,3578718091,0
3,766,7473,3578718091,3578718091,0
3,766,7474,3578718091,3578718091,0
3,766,7475,3578718091,3578718091,0
3,766,7476,3578718091,3578718096,5
3,766,7477,3578718091,3578718098,7
3,766,7478,3578718091,3578718098,7
3,766,7479,3578718091,3578718099,8
3,766,7480,3578718091,3578718100,9
3,766,7481,3578718091,3578718100,9
3,766,7482,3578718091,3578718101,10
3,766,7483,3578718091,3578718104,13
3,766,7484,3578718091,3578718104,13
3,766,7485,3578718091,3578718113,22
3,766,7486,3578718091,3578718115,24
3,766,7487,3578718091,3578718117,26
3,766,7488,3578718091,3578718118,27
3,766,7489,3578718091,3578718122,31
3,766,7490,3578718091,3578718123,32
3,766,7491,3578718091,3578718128,37
3,766,7492,3578718091,3578718135,44
3,766,7493,3578718091,3578718136,45
3,766,7494,3578718091,3578718136,45
3,766,7495,3578718091,3578718138,47
3,766,7496,3578718091,3578718138,47
3,766,7497,3578718091,3578718139,48
3,766,7498,3578718091,3578718139,48
3,766,7499,3578718091,3578718139,48
3,766,7500,3578718091,3578718140,49
3,767,7501,3578718145,3578718145,0
3,767,7502,3578718145,3578718145,0
3,767,7503,3578718145,3578718146,1
3,767,7504,3578718145,3578718147,2
3,767,7505,3578718145,3578718150,5
3,767,7506,3578718145,3578718151,6
3,767,7507,3578718145,3578718152,7
3,767,7508,3578718145,3578718155,10
3,767,7509,3578718145,3578718158,13
3,767,7510,3578718145,3578718161,16
3,767,7511,3578718145,3578718163,18
3,767,7512,3578718145,3578718164,19
3,767,7513,3578718145,3578718166,21
3,767,7514,3578718145,3578718168,23
3,767,7515,3578718145,3578718171,26
3,767,7516,3578718145,3578718172,27
3,767,7517,3578718145,3578718174,29
3,767,7518,3578718145,3578718174,29
3,767,7519,3578718145,3578718176,31
3,767,7520,3578718145,3578718176,31
3,767,7521,3578718145,3578718178,33
3,767,7522,3578718145,3578718179,34
3,767,7523,3578718145,3578718182,37
3,767,7524,3578718145,3578718184,39
3,767,7525,3578718145,3578718185,40
3,767,7526,3578718145,3578718187,42
3,767,7527,3578718145,3578718188,43
3,767,7528,3578718145,3578718189,44
3,767,7529,3578718145,3578718192,47
3,767,7530,3578718145,3578718192,47
3,767,7531,3578718145,3578718194,49
3,768,7532,3578718199,3578718202,3
3,768,7533,3578718199,3578718203,4
3,768,7534,3578718199,3578718203,4
3,768,7535,3578718199,3578718204,5
3,768,7536,3578718199,3578718204,5
3,768,7537,3578718199,3578718205,6
3,768,7538,3578718199,3578718206,7
3,768,7539,3578718199,3578718207,8
3,768,7540,3578718199,3578718208,9
3,768,7541,3578718199,3578718208,9
3,768,7542,3578718199,3578718211,12
3,768,7543,3578718199,3578718212,13
3,768,7544,3578718199,3578718214,15
3,768,7545,3578718199,3578718214,15
3,768,7546,3578718199,3578718218,19
3,768,7547,3578718199,3578718218,19
3,768,7548,3578718199,3578718219,20
3,768,7549,3578718199,3578718221,22
3,768,7550,3578718199,3578718224,25
3,768,7551,3578718199,3578718225,26
3,768,7552,3578718199,3578718226,27
3,768,7553,3578718199,3578718226,27
3,768,7554,3578718199,3578718232,33
3,768,7555,3578718199,3578718233,34
3,768,7556,3578718199,3578718235,36
3,768,7557,3578718199,3578718239,40
3,768,7558,3578718199,3578718241,42
3,768,7559,3578718199,3578718243,44
3,768,7560,3578718199,3578718244,45
3,768,7561,3578718199,3578718246,47
3,768,7562,3578718199,3578718248,49
3,769,7563,3578718254,3578718254,0
3,769,7564,3578718254,3578718254,0
3,769,7565,3578718254,3578718254,0
3,769,7566,3578718254,3578718254,0
3,769,7567,3578718254,3578718260,6
3,769,7568,3578718254,3578718262,8
3,769,7569,3578718254,3578718263,9
3,769,7570,3578718254,3578718263,9
3,769,7571,3578718254,3578718264,10
3,769,7572,3578718254,3578718266,12
3,769,7573,3578718254,3578718267,13
3,769,7574,3578718254,3578718269,15
3,769,7575,3578718254,3578718269,15
3,769,7576,3578718254,3578718271,17
3,769,7577,3578718254,3578718278,24
3,769,7578,3578718254,3578718279,25
3,769,7579,3578718254,3578718279,25
3,769,7580,3578718254,3578718279,25
3,769,7581,3578718254,3578718288,34
3,769,7582,3578718254,3578718289,35
3,769,7583,3578718254,3578718290,36
3,769,7584,3578718254,3578718291,37
3,769,7585,3578718254,3578718297,43
3,769,7586,3578718254,3578718298,44
3,769,7587,3578718254,3578718298,44
3,769,7588,3578718254,3578718300,46
3,769,7589,3578718254,3578718300,46
3,769,7590,3578718254,3578718301,47
3,769,7591,3578718254,3578718302,48
3,770,7592,3578718309,3578718309,0
3,770,7593,3578718309,3578718314,5
3,770,7594,3578718309,3578718315,6
3,770,7595,3578718309,3578718318,9
3,770,7596,3578718309,3578718318,9
3,770,7597,3578718309,3578718321,12
3,770,7598,3578718309,3578718323,14
3,770,7599,3578718309,3578718328,19
3,770,7600,3578718309,3578718334,25
3,770,7601,3578718309,3578718336,27
3,770,7602,3578718309,3578718336,27
3,770,7603,3578718309,3578718337,28
3,770,7604,3578718309,3578718338,29
3,770,7605,3578718309,3578718339,30
3,770,7606,3578718309,3578718340,31
3,770,7607,3578718309,3578718340,31
3,770,7608,3578718309,3578718345,36
3,770,7609,3578718309,3578718346,37
3,770,7610,3578718309,3578718346,37
3,770,7611,3578718309,3578718348,39
3,770,7612,3578718309,3578718350,41
3,770,7613,3578718309,3578718351,42
3,770,7614,3578718309,3578718351,42
3,770,7615,3578718309,3578718352,43
3,770,7616,3578718309,3578718354,45
3,770,7617,3578718309,3578718355,46
3,770,7618,3578718309,3578718357,48
3,770,7619,3578718309,3578718358,49
3,771,7620,3578718363,3578718363,0
3,771,7621,3578718363,3578718363,0
3,771,7622,3578718363,3578718364,1
3,771,7623,3578718363,3578718367,4
3,771,7624,3578718363,3578718368,5
3,771,7625,3578718363,3578718368,5
3,771,7626,3578718363,3578718370,7
3,771,7627,3578718363,3578718372,9
3,771,7628,3578718363,3578718374,11
3,771,7629,3578718363,3578718375,12
3,771,7630,3578718363,3578718376,13
3,771,7631,3578718363,3578718378,15
3,771,7632,3578718363,3578718379,16
3,771,7633,3578718363,3578718382,19
3,771,7634,3578718363,3578718384,21
3,771,7635,3578718363,3578718385,22
3,771,7636,3578718363,3578718387,24
3,771,7637,3578718363,3578718388,25
3,771,7638,3578718363,3578718388,25
3,771,7639,3578718363,3578718392,29
3,771,7640,3578718363,3578718393,30
3,771,7641,3578718363,3578718402,39
3,771,7642,3578718363,3578718403,40
3,771,7643,3578718363,3578718404,41
3,771,7644,3578718363,3578718404,41
3,771,7645,3578718363,3578718405,42
3,771,7646,3578718363,3578718405,42
3,771,7647,3578718363,3578718406,43
3,771,7648,3578718363,3578718408,45
3,771,7649,3578718363,3578718408,45
3,771,7650,3578718363,3578718408,45
3,771,7651,3578718363,3578718412,49
3,771,7652,3578718363,3578718412,49
3,772,7653,3578718418,3578718418,0
3,772,7654,3578718418,3578718418,0
3,772,7655,3578718418,3578718418,0
3,772,7656,3578718418,3578718418,0
3,772,7657,3578718418,3578718419,1
3,772,7658,3578718418,3578718421,3
3,772,7659,3578718418,3578718424,6
3,772,7660,3578718418,3578718425,7
3,772,7661,3578718418,3578718425,7
3,772,7662,3578718418,3578718427,9
3,772,7663,3578718418,3578718427,9
3,772,7664,3578718418,3578718432,14
3,772,7665,3578718418,3578718433,15
3,772,7666,3578718418,3578718435,17
3,772,7667,3578718418,3578718440,22
3,772,7668,3578718418,3578718442,24
3,772,7669,3578718418,3578718443,25
3,772,7670,3578718418,3578718444,26
3,772,7671,3578718418,3578718446,28
3,772,7672,3578718418,3578718446,28
3,772,7673,3578718418,3578718448,30
3,772,7674,3578718418,3578718450,32
3,772,7675,3578718418,3578718452,34
3,772,7676,3578718418,3578718453,35
3,772,7677,3578718418,3578718454,36
3,772,7678,3578718418,3578718460,42
3,772,7679,3578718418,3578718462,44
3,772,7680,3578718418,3578718463,45
3,772,7681,3578718418,3578718463,45
3,772,7682,3578718418,3578718464,46
3,772,7683,3578718418,3578718465,47
3,773,7684,3578718473,3578718473,0
3,773,7685,3578718473,3578718473,0
3,773,7686,3578718473,3578718473,0
3,773,7687,3578718473,3578718473,0
3,773,7688,3578718473,3578718476,3
3,773,7689,3578718473,3578718477,4
3,773,7690,3578718473,3578718478,5
3,773,7691,3578718473,3578718479,6
3,773,7692,3578718473,3578718479,6
3,773,7693,3578718473,3578718479,6
3,773,7694,3578718473,3578718488,15
3,773,7695,3578718473,3578718489,16
3,773,7696,3578718473,3578718490,17
3,773,7697,3578718473,3578718490,17
3,773,7698,3578718473,3578718497,24
3,773,7699,3578718473,3578718498,25
3,773,7700,3578718473,3578718498,25
3,773,7701,3578718473,3578718499,26
3,773,7702,3578718473,3578718500,27
3,773,7703,3578718473,3578718500,27
3,773,7704,3578718473,3578718501,28
3,773,7705,3578718473,3578718504,31
3,773,7706,3578718473,3578718506,33
3,773,7707,3578718473,3578718514,41
3,773,7708,3578718473,3578718514,41
3,773,7709,3578718473,3578718518,45
3,773,7710,3578718473,3578718519,46
3,773,7711,3578718473,3578718520,47
3,773,7712,3578718473,3578718522,49
3,774,7713,3578718528,3578718528,0
3,774,7714,3578718528,3578718535,7
3,774,7715,3578718528,3578718536,8
3,774,7716,3578718528,3578718537,9
3,774,7717,3578718528,3578718537,9
3,774,7718,3578718528,3578718538,10
3,774,7719,3578718528,3578718539,11
3,774,7720,3578718528,3578718540,12
3,774,7721,3578718528,3578718545,17
3,774,7722,3578718528,3578718545,17
3,774,7723,3578718528,3578718545,17
3,774,7724,3578718528,3578718546,18
3,774,7725,3578718528,3578718549,21
3,774,7726,3578718528,3578718550,22
3,774,7727,3578718528,3578718550,22
3,774,7728,3578718528,3578718551,23
3,774,7729,3578718528,3578718554,26
3,774,7730,3578718528,3578718557,29
3,774,7731,3578718528,3578718557,29
3,774,7732,3578718528,3578718560,32
3,774,7733,3578718528,3578718562,34
3,774,7734,3578718528,3578718564,36
3,774,7735,3578718528,3578718565,37
3,774,7736,3578718528,3578718568,40
3,774,7737,3578718528,3578718568,40
3,774,7738,3578718528,3578718570,42
3,774,7739,3578718528,3578718572,44
3,774,7740,3578718528,3578718573,45
3,774,7741,3578718528,3578718574,46
3,774,7742,3578718528,3578718575,47
3,774,7743,3578718528,3578718577,49
3,774,7744,3578718528,3578718577,49
3,775,7745,3578718584,3578718584,0
3,775,7746,3578718584,3578718584,0
3,775,7747,3578718584,3578718584,0
3,775,7748,3578718584,3578718586,2
3,775,7749,3578718584,3578718587,3
3,775,7750,3578718584,3578718588,4
3,775,7751,3578718584,3578718591,7
3,775,7752,3578718584,3578718592,8
3,775,7753,3578718584,3578718601,17
3,775,7754,3578718584,3578718602,18
3,775,7755,3578718584,3578718602,18
3,775,7756,3578718584,3578718603,19
3,775,7757,3578718584,3578718604,20
3,775,7758,3578718584,3578718604,20
3,775,7759,3578718584,3578718606,22
3,775,7760,3578718584,3578718607,23
3,775,7761,3578718584,3578718608,24
3,775,7762,3578718584,3578718608,24
3,775,7763,3578718584,3578718611,27
3,775,7764,3578718584,3578718611,27
3,775,7765,3578718584,3578718614,30
3,775,7766,3578718584,3578718615,31
3,775,7767,3578718584,3578718617,33
3,775,7768,3578718584,3578718617,33
3,775,7769,3578718584,3578718619,35
3,775,7770,3578718584,3578718620,36
3,775,7771,3578718584,3578718622,38
3,775,7772,3578718584,3578718623,39
3,775,7773,3578718584,3578718625,41
3,775,7774,3578718584,3578718625,41
3,775,7775,3578718584,3578718628,44
3,775,7776,3578718584,3578718631,47
3,775,7777,3578718584,3578718632,48
3,776,7778,3578718638,3578718638,0
3,776,7779,3578718638,3578718639,1
3,776,7780,3578718638,3578718641,3
3,776,7781,3578718638,3578718643,5
3,776,7782,3578718638,3578718643,5
3,776,7783,3578718638,3578718645,7
3,776,7784,3578718638,3578718645,7
3,776,7785,3578718638,3578718648,10
3,776,7786,3578718638,3578718651,13
3,776,7787,3578718638,3578718651,13
3,776,7788,3578718638,3578718653,15
3,776,7789,3578718638,3578718659,21
3,776,7790,3578718638,3578718661,23
3,776,7791,3578718638,3578718662,24
3,776,7792,3578718638,3578718662,24
3,776,7793,3578718638,3578718663,25
3,776,7794,3578718638,3578718664,26
3,776,7795,3578718638,3578718668,30
3,776,7796,3578718638,3578718670,32
3,776,7797,3578718638,3578718671,33
3,776,7798,3578718638,3578718671,33
3,776,7799,3578718638,3578718672,34
3,776,7800,3578718638,3578718676,38
3,776,7801,3578718638,3578718677,39
3,776,7802,3578718638,3578718678,40
3,776,7803,3578718638,3578718679,41
3,776,7804,3578718638,3578718679,41
3,776,7805,3578718638,3578718679,41
3,777,7806,3578718693,3578718693,0
3,777,7807,3578718693,3578718693,0
3,777,7808,3578718693,3578718693,0
3,777,7809,3578718693,3578718693,0
3,777,7810,3578718693,3578718697,4
3,777,7811,3578718693,3578718698,5
3,777,7812,3578718693,3578718699,6
3,777,7813,3578718693,3578718700,7
3,777,7814,3578718693,3578718700,7
3,777,7815,3578718693,3578718701,8
3,777,7816,3578718693,3578718704,11
3,777,7817,3578718693,3578718706,13
3,777,7818,3578718693,3578718714,21
3,777,7819,3578718693,3578718715,22
3,777,7820,3578718693,3578718719,26
3,777,7821,3578718693,3578718719,26
3,777,7822,3578718693,3578718720,27
3,777,7823,3578718693,3578718722,29
3,777,7824,3578718693,3578718722,29
3,777,7825,3578718693,3578718727,34
3,777,7826,3578718693,3578718735,42
3,777,7827,3578718693,3578718737,44
3,777,7828,3578718693,3578718738,45
3,777,7829,3578718693,3578718739,46
3,777,7830,3578718693,3578718739,46
3,778,7831,3578718747,3578718747,0
3,778,7832,3578718747,3578718747,0
3,778,7833,3578718747,3578718747,0
3,778,7834,3578718747,3578718748,1
3,778,7835,3578718747,3578718750,3
3,778,7836,3578718747,3578718750,3
3,778,7837,3578718747,3578718750,3
3,778,7838,3578718747,3578718752,5
3,778,7839,3578718747,3578718753,6
3,778,7840,3578718747,3578718754,7
3,778,7841,3578718747,3578718757,10
3,778,7842,3578718747,3578718758,11
3,778,7843,3578718747,3578718760,13
3,778,7844,3578718747,3578718762,15
3,778,7845,3578718747,3578718765,18
3,778,7846,3578718747,3578718767,20
3,778,7847,3578718747,3578718769,22
3,778,7848,3578718747,3578718769,22
3,778,7849,3578718747,3578718772,25
3,778,7850,3578718747,3578718773,26
3,778,7851,3578718747,3578718774,27
3,778,7852,3578718747,3578718774,27
3,778,7853,3578718747,3578718775,28
3,778,7854,3578718747,3578718776,29
3,778,7855,3578718747,3578718778,31
3,778,7856,3578718747,3578718778,31
3,778,7857,3578718747,3578718782,35
3,778,7858,3578718747,3578718784,37
3,778,7859,3578718747,3578718784,37
3,778,7860,3578718747,3578718786,39
3,778,7861,3578718747,3578718787,40
3,778,7862,3578718747,3578718789,42
3,778,7863,3578718747,3578718791,44
3,778,7864,3578718747,3578718792,45
3,779,7865,3578718803,3578718803,0
3,779,7866,3578718803,3578718803,0
3,779,7867,3578718803,3578718803,0
3,779,7868,3578718803,3578718803,0
3,779,7869,3578718803,3578718804,1
3,779,7870,3578718803,3578718807,4
3,779,7871,3578718803,3578718807,4
3,779,7872,3578718803,3578718808,5
3,779,7873,3578718803,3578718810,7
3,779,7874,3578718803,3578718811,8
3,779,7875,3578718803,3578718815,12
3,779,7876,3578718803,3578718816,13
3,779,7877,3578718803,3578718817,14
3,779,7878,3578718803,3578718819,16
3,779,7879,3578718803,3578718820,17
3,779,7880,3578718803,3578718822,19
3,779,7881,3578718803,3578718824,21
3,779,7882,3578718803,3578718824,21
3,779,7883,3578718803,3578718825,22
3,779,7884,3578718803,3578718825,22
3,779,7885,3578718803,3578718827,24
3,779,7886,3578718803,3578718828,25
3,779,7887,3578718803,3578718831,28
3,779,7888,3578718803,3578718831,28
3,779,7889,3578718803,3578718836,33
3,779,7890,3578718803,3578718839,36
3,779,7891,3578718803,3578718841,38
3,779,7892,3578718803,3578718843,40
3,779,7893,3578718803,3578718843,40
3,779,7894,3578718803,3578718845,42
3,779,7895,3578718803,3578718845,42
3,779,7896,3578718803,3578718847,44
3,779,7897,3578718803,3578718851,48
3,779,7898,3578718803,3578718852,49
3,780,7899,3578718858,3578718858,0
3,780,7900,3578718858,3578718859,1
3,780,7901,3578718858,3578718862,4
3,780,7902,3578718858,3578718862,4
3,780,7903,3578718858,3578718862,4
3,780,7904,3578718858,3578718864,6
3,780,7905,3578718858,3578718865,7
3,780,7906,3578718858,3578718868,10
3,780,7907,3578718858,3578718870,12
3,780,7908,3578718858,3578718871,13
3,780,7909,3578718858,3578718872,14
3,780,7910,3578718858,3578718876,18
3,780,7911,3578718858,3578718877,19
3,780,7912,3578718858,3578718878,20
3,780,7913,3578718858,3578718879,21
3,780,7914,3578718858,3578718879,21
3,780,7915,3578718858,3578718879,21
3,780,7916,3578718858,3578718888,30
3,780,7917,3578718858,3578718889,31
3,780,7918,3578718858,3578718890,32
3,780,7919,3578718858,3578718890,32
3,780,7920,3578718858,3578718897,39
3,780,7921,3578718858,3578718898,40
3,780,7922,3578718858,3578718898,40
3,780,7923,3578718858,3578718900,42
3,780,7924,3578718858,3578718900,42
3,780,7925,3578718858,3578718901,43
3,780,7926,3578718858,3578718901,43
3,780,7927,3578718858,3578718904,46
3,780,7928,3578718858,3578718907,49
3,781,7929,3578718912,3578718914,2
3,781,7930,3578718912,3578718916,4
3,781,7931,3578718912,3578718918,6
3,781,7932,3578718912,3578718919,7
3,781,7933,3578718912,3578718920,8
3,781,7934,3578718912,3578718922,10
3,781,7935,3578718912,3578718922,10
3,781,7936,3578718912,3578718927,15
3,781,7937,3578718912,3578718934,22
3,781,7938,3578718912,3578718935,23
3,781,7939,3578718912,3578718936,24
3,781,7940,3578718912,3578718938,26
3,781,7941,3578718912,3578718938,26
3,781,7942,3578718912,3578718938,26
3,781,7943,3578718912,3578718938,26
3,781,7944,3578718912,3578718938,26
3,781,7945,3578718912,3578718940,28
3,781,7946,3578718912,3578718945,33
3,781,7947,3578718912,3578718945,33
3,781,7948,3578718912,3578718947,35
3,781,7949,3578718912,3578718950,38
3,781,7950,3578718912,3578718951,39
3,781,7951,3578718912,3578718952,40
3,781,7952,3578718912,3578718952,40
3,781,7953,3578718912,3578718955,43
3,781,7954,3578718912,3578718957,45
3,781,7955,3578718912,3578718958,46
3,781,7956,3578718912,3578718961,49
3,782,7957,3578718967,3578718967,0
3,782,7958,3578718967,3578718967,0
3,782,7959,3578718967,3578718967,0
3,782,7960,3578718967,3578718968,1
3,782,7961,3578718967,3578718969,2
3,782,7962,3578718967,3578718970,3
3,782,7963,3578718967,3578718972,5
3,782,7964,3578718967,3578718974,7
3,782,7965,3578718967,3578718975,8
3,782,7966,3578718967,3578718975,8
3,782,7967,3578718967,3578718977,10
3,782,7968,3578718967,3578718979,12
3,782,7969,3578718967,3578718982,15
3,782,7970,3578718967,3578718983,16
3,782,7971,3578718967,3578718985,18
3,782,7972,3578718967,3578718986,19
3,782,7973,3578718967,3578718987,20
3,782,7974,3578718967,3578718988,21
3,782,7975,3578718967,3578718991,24
3,782,7976,3578718967,3578718992,25
3,782,7977,3578718967,3578718992,25
3,782,7978,3578718967,3578719001,34
3,782,7979,3578718967,3578719002,35
3,782,7980,3578718967,3578719003,36
3,782,7981,3578718967,3578719003,36
3,782,7982,3578718967,3578719004,37
3,782,7983,3578718967,3578719004,37
3,782,7984,3578718967,3578719007,40
3,782,7985,3578718967,3578719007,40
3,782,7986,3578718967,3578719008,41
3,782,7987,3578718967,3578719008,41
3,782,7988,3578718967,3578719011,44
3,782,7989,3578718967,3578719012,45
3,782,7990,3578718967,3578719015,48
3,782,7991,3578718967,3578719017,50
3,783,7992,3578719022,3578719022,0
3,783,7993,3578719022,3578719022,0
3,783,7994,3578719022,3578719022,0
3,783,7995,3578719022,3578719022,0
3,783,7996,3578719022,3578719024,2
3,783,7997,3578719022,3578719024,2
3,783,7998,3578719022,3578719026,4
3,783,7999,3578719022,3578719027,5
3,783,8000,3578719022,3578719029,7
3,783,8001,3578719022,3578719031,9
3,783,8002,3578719022,3578719031,9
3,783,8003,3578719022,3578719036,14
3,783,8004,3578719022,3578719040,18
3,783,8005,3578719022,3578719041,19
3,783,8006,3578719022,3578719043,21
3,783,8007,3578719022,3578719043,21
3,783,8008,3578719022,3578719045,23
3,783,8009,3578719022,3578719046,24
3,783,8010,3578719022,3578719048,26
3,783,8011,3578719022,3578719052,30
3,783,8012,3578719022,3578719052,30
3,783,8013,3578719022,3578719053,31
3,783,8014,3578719022,3578719059,37
3,783,8015,3578719022,3578719062,40
3,783,8016,3578719022,3578719062,40
3,783,8017,3578719022,3578719064,42
3,783,8018,3578719022,3578719064,42
3,783,8019,3578719022,3578719064,42
3,783,8020,3578719022,3578719068,46
3,783,8021,3578719022,3578719071,49
3,783,8022,3578719022,3578719071,49
3,783,8023,3578719022,3578719072,50
3,784,8024,3578719077,3578719077,0
3,784,8025,3578719077,3578719077,0
3,784,8026,3578719077,3578719077,0
3,784,8027,3578719077,3578719078,1
3,784,8028,3578719077,3578719079,2
3,784,8029,3578719077,3578719079,2
3,784,8030,3578719077,3578719079,2
3,784,8031,3578719077,3578719089,12
3,784,8032,3578719077,3578719090,13
3,784,8033,3578719077,3578719090,13
3,784,8034,3578719077,3578719090,13
3,784,8035,3578719077,3578719097,20
3,784,8036,3578719077,3578719098,21
3,784,8037,3578719077,3578719098,21
3,784,8038,3578719077,3578719100,23
3,784,8039,3578719077,3578719100,23
3,784,8040,3578719077,3578719100,23
3,784,8041,3578719077,3578719101,24
3,784,8042,3578719077,3578719104,27
3,784,8043,3578719077,3578719107,30
3,784,8044,3578719077,3578719115,38
3,784,8045,3578719077,3578719116,39
3,784,8046,3578719077,3578719118,41
3,784,8047,3578719077,3578719119,42
3,784,8048,3578719077,3578719121,44
3,784,8049,3578719077,3578719122,45
3,784,8050,3578719077,3578719123,46
3,785,8051,3578719131,3578719131,0
3,785,8052,3578719131,3578719135,4
3,785,8053,3578719131,3578719136,5
3,785,8054,3578719131,3578719136,5
3,785,8055,3578719131,3578719138,7
3,785,8056,3578719131,3578719138,7
3,785,8057,3578719131,3578719138,7
3,785,8058,3578719131,3578719139,8
3,785,8059,3578719131,3578719139,8
3,785,8060,3578719131,3578719145,14
3,785,8061,3578719131,3578719145,14
3,785,8062,3578719131,3578719148,17
3,785,8063,3578719131,3578719150,19
3,785,8064,3578719131,3578719152,21
3,785,8065,3578719131,3578719152,21
3,785,8066,3578719131,3578719152,21
3,785,8067,3578719131,3578719153,22
3,785,8068,3578719131,3578719154,23
3,785,8069,3578719131,3578719157,26
3,785,8070,3578719131,3578719157,26
3,785,8071,3578719131,3578719160,29
3,785,8072,3578719131,3578719165,34
3,785,8073,3578719131,3578719165,34
3,785,8074,3578719131,3578719165,34
3,785,8075,3578719131,3578719168,37
3,785,8076,3578719131,3578719170,39
3,785,8077,3578719131,3578719173,42
3,785,8078,3578719131,3578719173,42
3,785,8079,3578719131,3578719174,43
3,785,8080,3578719131,3578719176,45
3,785,8081,3578719131,3578719178,47
3,785,8082,3578719131,3578719179,48
3,786,8083,3578719186,3578719186,0
3,786,8084,3578719186,3578719186,0
3,786,8085,3578719186,3578719186,0
3,786,8086,3578719186,3578719187,1
3,786,8087,3578719186,3578719188,2
3,786,8088,3578719186,3578719189,3
3,786,8089,3578719186,3578719191,5
3,786,8090,3578719186,3578719193,7
3,786,8091,3578719186,3578719201,15
3,786,8092,3578719186,3578719202,16
3,786,8093,3578719186,3578719204,18
3,786,8094,3578719186,3578719204,18
3,786,8095,3578719186,3578719204,18
3,786,8096,3578719186,3578719207,21
3,786,8097,3578719186,3578719208,22
3,786,8098,3578719186,3578719208,22
3,786,8099,3578719186,3578719209,23
3,786,8100,3578719186,3578719212,26
3,786,8101,3578719186,3578719212,26
3,786,8102,3578719186,3578719215,29
3,786,8103,3578719186,3578719215,29
3,786,8104,3578719186,3578719217,31
3,786,8105,3578719186,3578719217,31
3,786,8106,3578719186,3578719219,33
3,786,8107,3578719186,3578719221,35
3,786,8108,3578719186,3578719223,37
3,786,8109,3578719186,3578719224,38
3,786,8110,3578719186,3578719225,39
3,786,8111,3578719186,3578719226,40
3,786,8112,3578719186,3578719227,41
3,786,8113,3578719186,3578719227,41
3,786,8114,3578719186,3578719229,43
3,786,8115,3578719186,3578719231,45
3,786,8116,3578719186,3578719233,47
3,787,8117,3578719240,3578719240,0
3,787,8118,3578719240,3578719240,0
3,787,8119,3578719240,3578719242,2
3,787,8120,3578719240,3578719243,3
3,787,8121,3578719240,3578719244,4
3,787,8122,3578719240,3578719245,5
3,787,8123,3578719240,3578719245,5
3,787,8124,3578719240,3578719248,8
3,787,8125,3578719240,3578719250,10
3,787,8126,3578719240,3578719252,12
3,787,8127,3578719240,3578719252,12
3,787,8128,3578719240,3578719254,14
3,787,8129,3578719240,3578719260,20
3,787,8130,3578719240,3578719262,22
3,787,8131,3578719240,3578719262,22
3,787,8132,3578719240,3578719263,23
3,787,8133,3578719240,3578719265,25
3,787,8134,3578719240,3578719268,28
3,787,8135,3578719240,3578719270,30
3,787,8136,3578719240,3578719271,31
3,787,8137,3578719240,3578719271,31
3,787,8138,3578719240,3578719272,32
3,787,8139,3578719240,3578719277,37
3,787,8140,3578719240,3578719277,37
3,787,8141,3578719240,3578719278,38
3,787,8142,3578719240,3578719279,39
3,787,8143,3578719240,3578719279,39
3,787,8144,3578719240,3578719288,48
3,787,8145,3578719240,3578719288,48
3,787,8146,3578719240,3578719290,50
3,788,8147,3578719294,3578719294,0
3,788,8148,3578719294,3578719294,0
3,788,8149,3578719294,3578719297,3
3,788,8150,3578719294,3578719297,3
3,788,8151,3578719294,3578719298,4
3,788,8152,3578719294,3578719299,5
3,788,8153,3578719294,3578719300,6
3,788,8154,3578719294,3578719300,6
3,788,8155,3578719294,3578719301,7
3,788,8156,3578719294,3578719304,10
3,788,8157,3578719294,3578719308,14
3,788,8158,3578719294,3578719315,21
3,788,8159,3578719294,3578719315,21
3,788,8160,3578719294,3578719319,25
3,788,8161,3578719294,3578719319,25
3,788,8162,3578719294,3578719321,27
3,788,8163,3578719294,3578719322,28
3,788,8164,3578719294,3578719327,33
3,788,8165,3578719294,3578719335,41
3,788,8166,3578719294,3578719336,42
3,788,8167,3578719294,3578719336,42
3,788,8168,3578719294,3578719337,43
3,788,8169,3578719294,3578719338,44
3,788,8170,3578719294,3578719338,44
3,788,8171,3578719294,3578719338,44
3,788,8172,3578719294,3578719340,46
3,788,8173,3578719294,3578719341,47
3,789,8174,3578719349,3578719349,0
3,789,8175,3578719349,3578719349,0
3,789,8176,3578719349,3578719349,0
3,789,8177,3578719349,3578719349,0
3,789,8178,3578719349,3578719350,1
3,789,8179,3578719349,3578719352,3
3,789,8180,3578719349,3578719352,3
3,789,8181,3578719349,3578719352,3
3,789,8182,3578719349,3578719354,5
3,789,8183,3578719349,3578719357,8
3,789,8184,3578719349,3578719357,8
3,789,8185,3578719349,3578719360,11
3,789,8186,3578719349,3578719365,16
3,789,8187,3578719349,3578719365,16
3,789,8188,3578719349,3578719366,17
3,789,8189,3578719349,3578719368,19
3,789,8190,3578719349,3578719368,19
3,789,8191,3578719349,3578719371,22
3,789,8192,3578719349,3578719373,24
3,789,8193,3578719349,3578719374,25
3,789,8194,3578719349,3578719375,26
3,789,8195,3578719349,3578719377,28
3,789,8196,3578719349,3578719379,30
3,789,8197,3578719349,3578719379,30
3,789,8198,3578719349,3578719383,34
3,789,8199,3578719349,3578719384,35
3,789,8200,3578719349,3578719385,36
3,789,8201,3578719349,3578719387,38
3,789,8202,3578719349,3578719388,39
3,789,8203,3578719349,3578719389,40
3,789,8204,3578719349,3578719390,41
3,789,8205,3578719349,3578719391,42
3,789,8206,3578719349,3578719393,44
3,790,8207,3578719405,3578719405,0
3,790,8208,3578719405,3578719405,0
3,790,8209,3578719405,3578719405,0
3,790,8210,3578719405,3578719405,0
3,790,8211,3578719405,3578719405,0
3,790,8212,3578719405,3578719406,1
3,790,8213,3578719405,3578719407,2
3,790,8214,3578719405,3578719409,4
3,790,8215,3578719405,3578719409,4
3,790,8216,3578719405,3578719412,7
3,790,8217,3578719405,3578719412,7
3,790,8218,3578719405,3578719414,9
3,790,8219,3578719405,3578719415,10
3,790,8220,3578719405,3578719417,12
3,790,8221,3578719405,3578719417,12
3,790,8222,3578719405,3578719418,13
3,790,8223,3578719405,3578719423,18
3,790,8224,3578719405,3578719425,20
3,790,8225,3578719405,3578719425,20
3,790,8226,3578719405,3578719427,22
3,790,8227,3578719405,3578719427,22
3,790,8228,3578719405,3578719427,22
3,790,8229,3578719405,3578719432,27
3,790,8230,3578719405,3578719433,28
3,790,8231,3578719405,3578719437,32
3,790,8232,3578719405,3578719440,35
3,790,8233,3578719405,3578719440,35
3,790,8234,3578719405,3578719442,37
3,790,8235,3578719405,3578719443,38
3,790,8236,3578719405,3578719444,39
3,790,8237,3578719405,3578719445,40
3,790,8238,3578719405,3578719446,41
3,790,8239,3578719405,3578719448,43
3,790,8240,3578719405,3578719452,47
3,790,8241,3578719405,3578719452,47
3,790,8242,3578719405,3578719454,49
3,791,8243,3578719462,3578719462,0
3,791,8244,3578719462,3578719462,0
3,791,8245,3578719462,3578719462,0
3,791,8246,3578719462,3578719464,2
3,791,8247,3578719462,3578719464,2
3,791,8248,3578719462,3578719464,2
3,791,8249,3578719462,3578719469,7
3,791,8250,3578719462,3578719470,8
3,791,8251,3578719462,3578719470,8
3,791,8252,3578719462,3578719471,9
3,791,8253,3578719462,3578719472,10
3,791,8254,3578719462,3578719476,14
3,791,8255,3578719462,3578719477,15
3,791,8256,3578719462,3578719478,16
3,791,8257,3578719462,3578719480,18
3,791,8258,3578719462,3578719480,18
3,791,8259,3578719462,3578719487,25
3,791,8260,3578719462,3578719488,26
3,791,8261,3578719462,3578719490,28
3,791,8262,3578719462,3578719493,31
3,791,8263,3578719462,3578719494,32
3,791,8264,3578719462,3578719497,35
3,791,8265,3578719462,3578719498,36
3,791,8266,3578719462,3578719498,36
3,791,8267,3578719462,3578719499,37
3,791,8268,3578719462,3578719500,38
3,791,8269,3578719462,3578719501,39
3,791,8270,3578719462,3578719504,42
3,792,8271,3578719518,3578719518,0
3,792,8272,3578719518,3578719518,0
3,792,8273,3578719518,3578719518,0
3,792,8274,3578719518,3578719520,2
3,792,8275,3578719518,3578719521,3
3,792,8276,3578719518,3578719527,9
3,792,8277,3578719518,3578719535,17
3,792,8278,3578719518,3578719535,17
3,792,8279,3578719518,3578719537,19
3,792,8280,3578719518,3578719538,20
3,792,8281,3578719518,3578719538,20
3,792,8282,3578719518,3578719538,20
3,792,8283,3578719518,3578719539,21
3,792,8284,3578719518,3578719540,22
3,792,8285,3578719518,3578719545,27
3,792,8286,3578719518,3578719545,27
3,792,8287,3578719518,3578719546,28
3,792,8288,3578719518,3578719546,28
3,792,8289,3578719518,3578719550,32
3,792,8290,3578719518,3578719550,32
3,792,8291,3578719518,3578719551,33
3,792,8292,3578719518,3578719552,34
3,792,8293,3578719518,3578719553,35
3,792,8294,3578719518,3578719554,36
3,792,8295,3578719518,3578719557,39
3,792,8296,3578719518,3578719557,39
3,792,8297,3578719518,3578719559,41
3,792,8298,3578719518,3578719563,45
3,792,8299,3578719518,3578719564,46
3,792,8300,3578719518,3578719565,47
3,793,8301,3578719572,3578719572,0
3,793,8302,3578719572,3578719572,0
3,793,8303,3578719572,3578719572,0
3,793,8304,3578719572,3578719572,0
3,793,8305,3578719572,3578719573,1
3,793,8306,3578719572,3578719573,1
3,793,8307,3578719572,3578719574,2
3,793,8308,3578719572,3578719574,2
3,793,8309,3578719572,3578719576,4
3,793,8310,3578719572,3578719577,5
3,793,8311,3578719572,3578719578,6
3,793,8312,3578719572,3578719582,10
3,793,8313,3578719572,3578719583,11
3,793,8314,3578719572,3578719585,13
3,793,8315,3578719572,3578719586,14
3,793,8316,3578719572,3578719587,15
3,793,8317,3578719572,3578719587,15
3,793,8318,3578719572,3578719589,17
3,793,8319,3578719572,3578719590,18
3,793,8320,3578719572,3578719592,20
3,793,8321,3578719572,3578719601,29
3,793,8322,3578719572,3578719601,29
3,793,8323,3578719572,3578719603,31
3,793,8324,3578719572,3578719603,31
3,793,8325,3578719572,3578719604,32
3,793,8326,3578719572,3578719606,34
3,793,8327,3578719572,3578719608,36
3,793,8328,3578719572,3578719608,36
3,793,8329,3578719572,3578719610,38
3,793,8330,3578719572,3578719612,40
3,793,8331,3578719572,3578719614,42
3,793,8332,3578719572,3578719614,42
3,793,8333,3578719572,3578719615,43
3,793,8334,3578719572,3578719616,44
3,793,8335,3578719572,3578719619,47
3,794,8336,3578719628,3578719628,0
3,794,8337,3578719628,3578719628,0
3,794,8338,3578719628,3578719628,0
3,794,8339,3578719628,3578719628,0
3,794,8340,3578719628,3578719628,0
3,794,8341,3578719628,3578719631,3
3,794,8342,3578719628,3578719632,4
3,794,8343,3578719628,3578719636,8
3,794,8344,3578719628,3578719639,11
3,794,8345,3578719628,3578719639,11
3,794,8346,3578719628,3578719642,14
3,794,8347,3578719628,3578719643,15
3,794,8348,3578719628,3578719644,16
3,794,8349,3578719628,3578719645,17
3,794,8350,3578719628,3578719646,18
3,794,8351,3578719628,3578719647,19
3,794,8352,3578719628,3578719650,22
3,794,8353,3578719628,3578719650,22
3,794,8354,3578719628,3578719653,25
3,794,8355,3578719628,3578719660,32
3,794,8356,3578719628,3578719661,33
3,794,8357,3578719628,3578719662,34
3,794,8358,3578719628,3578719663,35
3,794,8359,3578719628,3578719663,35
3,794,8360,3578719628,3578719668,40
3,794,8361,3578719628,3578719669,41
3,794,8362,3578719628,3578719670,42
3,794,8363,3578719628,3578719671,43
3,794,8364,3578719628,3578719672,44
3,794,8365,3578719628,3578719676,48
3,794,8366,3578719628,3578719677,49
3,795,8367,3578719684,3578719684,0
3,795,8368,3578719684,3578719684,0
3,795,8369,3578719684,3578719684,0
3,795,8370,3578719684,3578719684,0
3,795,8371,3578719684,3578719688,4
3,795,8372,3578719684,3578719688,4
3,795,8373,3578719684,3578719689,5
3,795,8374,3578719684,3578719693,9
3,795,8375,3578719684,3578719694,10
3,795,8376,3578719684,3578719697,13
3,795,8377,3578719684,3578719698,14
3,795,8378,3578719684,3578719700,16
3,795,8379,3578719684,3578719700,16
3,795,8380,3578719684,3578719701,17
3,795,8381,3578719684,3578719704,20
3,795,8382,3578719684,3578719709,25
3,795,8383,3578719684,3578719715,31
3,795,8384,3578719684,3578719715,31
3,795,8385,3578719684,3578719717,33
3,795,8386,3578719684,3578719718,34
3,795,8387,3578719684,3578719720,36
3,795,8388,3578719684,3578719721,37
3,795,8389,3578719684,3578719729,45
3,796,8390,3578719738,3578719738,0
3,796,8391,3578719738,3578719738,0
3,796,8392,3578719738,3578719738,0
3,796,8393,3578719738,3578719738,0
3,796,8394,3578719738,3578719738,0
3,796,8395,3578719738,3578719739,1
3,796,8396,3578719738,3578719740,2
3,796,8397,3578719738,3578719740,2
3,796,8398,3578719738,3578719745,7
3,796,8399,3578719738,3578719745,7
3,796,8400,3578719738,3578719746,8
3,796,8401,3578719738,3578719748,10
3,796,8402,3578719738,3578719750,12
3,796,8403,3578719738,3578719751,13
3,796,8404,3578719738,3578719752,14
3,796,8405,3578719738,3578719752,14
3,796,8406,3578719738,3578719753,15
3,796,8407,3578719738,3578719754,16
3,796,8408,3578719738,3578719757,19
3,796,8409,3578719738,3578719757,19
3,796,8410,3578719738,3578719760,22
3,796,8411,3578719738,3578719763,25
3,796,8412,3578719738,3578719764,26
3,796,8413,3578719738,3578719764,26
3,796,8414,3578719738,3578719768,30
3,796,8415,3578719738,3578719769,31
3,796,8416,3578719738,3578719770,32
3,796,8417,3578719738,3578719773,35
3,796,8418,3578719738,3578719774,36
3,796,8419,3578719738,3578719774,36
3,796,8420,3578719738,3578719774,36
3,796,8421,3578719738,3578719774,36
3,796,8422,3578719738,3578719777,39
3,796,8423,3578719738,3578719778,40
3,796,8424,3578719738,3578719782,44
3,796,8425,3578719738,3578719784,46
3,796,8426,3578719738,3578719785,47
3,796,8427,3578719738,3578719786,48
3,796,8428,3578719738,3578719787,49
3,797,8429,3578719793,3578719793,0
3,797,8430,3578719793,3578719793,0
3,797,8431,3578719793,3578719793,0
3,797,8432,3578719793,3578719793,0
3,797,8433,3578719793,3578719793,0
3,797,8434,3578719793,3578719800,7
3,797,8435,3578719793,3578719801,8
3,797,8436,3578719793,3578719803,10
3,797,8437,3578719793,3578719804,11
3,797,8438,3578719793,3578719804,11
3,797,8439,3578719793,3578719806,13
3,797,8440,3578719793,3578719808,15
3,797,8441,3578719793,3578719808,15
3,797,8442,3578719793,3578719808,15
3,797,8443,3578719793,3578719811,18
3,797,8444,3578719793,3578719812,19
3,797,8445,3578719793,3578719814,21
3,797,8446,3578719793,3578719814,21
3,797,8447,3578719793,3578719816,23
3,797,8448,3578719793,3578719816,23
3,797,8449,3578719793,3578719819,26
3,797,8450,3578719793,3578719820,27
3,797,8451,3578719793,3578719822,29
3,797,8452,3578719793,3578719823,30
3,797,8453,3578719793,3578719823,30
3,797,8454,3578719793,3578719826,33
3,797,8455,3578719793,3578719826,33
3,797,8456,3578719793,3578719827,34
3,797,8457,3578719793,3578719831,38
3,797,8458,3578719793,3578719831,38
3,797,8459,3578719793,3578719835,42
3,797,8460,3578719793,3578719836,43
3,797,8461,3578719793,3578719838,45
3,797,8462,3578719793,3578719839,46
3,797,8463,3578719793,3578719842,49
3,798,8464,3578719847,3578719847,0
3,798,8465,3578719847,3578719847,0
3,798,8466,3578719847,3578719847,0
3,798,8467,3578719847,3578719847,0
3,798,8468,3578719847,3578719847,0
3,798,8469,3578719847,3578719851,4
3,798,8470,3578719847,3578719853,6
3,798,8471,3578719847,3578719861,14
3,798,8472,3578719847,3578719862,15
3,798,8473,3578719847,3578719862,15
3,798,8474,3578719847,3578719863,16
3,798,8475,3578719847,3578719863,16
3,798,8476,3578719847,3578719864,17
3,798,8477,3578719847,3578719868,21
3,798,8478,3578719847,3578719870,23
3,798,8479,3578719847,3578719871,24
3,798,8480,3578719847,3578719872,25
3,798,8481,3578719847,3578719876,29
3,798,8482,3578719847,3578719877,30
3,798,8483,3578719847,3578719878,31
3,798,8484,3578719847,3578719879,32
3,798,8485,3578719847,3578719880,33
3,798,8486,3578719847,3578719881,34
3,798,8487,3578719847,3578719888,41
3,798,8488,3578719847,3578719888,41
3,798,8489,3578719847,3578719890,43
3,798,8490,3578719847,3578719893,46
3,798,8491,3578719847,3578719894,47
3,798,8492,3578719847,3578719897,50
3,799,8493,3578719901,3578719901,0
3,799,8494,3578719901,3578719901,0
3,799,8495,3578719901,3578719901,0
3,799,8496,3578719901,3578719901,0
3,799,8497,3578719901,3578719902,1
3,799,8498,3578719901,3578719904,3
3,799,8499,3578719901,3578719909,8
3,799,8500,3578719901,3578719915,14
3,799,8501,3578719901,3578719916,15
3,799,8502,3578719901,3578719917,16
3,799,8503,3578719901,3578719918,17
3,799,8504,3578719901,3578719920,19
3,799,8505,3578719901,3578719921,20
3,799,8506,3578719901,3578719929,28
3,799,8507,3578719901,3578719935,34
3,799,8508,3578719901,3578719936,35
3,799,8509,3578719901,3578719938,37
3,799,8510,3578719901,3578719938,37
3,799,8511,3578719901,3578719939,38
3,799,8512,3578719901,3578719939,38
3,799,8513,3578719901,3578719940,39
3,799,8514,3578719901,3578719945,44
3,799,8515,3578719901,3578719945,44
3,799,8516,3578719901,3578719946,45
3,799,8517,3578719901,3578719948,47
3,799,8518,3578719901,3578719950,49
3,800,8519,3578719956,3578719956,0
3,800,8520,3578719956,3578719956,0
3,800,8521,3578719956,3578719956,0
3,800,8522,3578719956,3578719956,0
3,800,8523,3578719956,3578719956,0
3,800,8524,3578719956,3578719957,1
3,800,8525,3578719956,3578719960,4
3,800,8526,3578719956,3578719964,8
3,800,8527,3578719956,3578719964,8
3,800,8528,3578719956,3578719964,8
3,800,8529,3578719956,3578719967,11
3,800,8530,3578719956,3578719971,15
3,800,8531,3578719956,3578719971,15
3,800,8532,3578719956,3578719973,17
3,800,8533,3578719956,3578719973,17
3,800,8534,3578719956,3578719973,17
3,800,8535,3578719956,3578719974,18
3,800,8536,3578719956,3578719974,18
3,800,8537,3578719956,3578719978,22
3,800,8538,3578719956,3578719979,23
3,800,8539,3578719956,3578719983,27
3,800,8540,3578719956,3578719984,28
3,800,8541,3578719956,3578719985,29
3,800,8542,3578719956,3578719985,29
3,800,8543,3578719956,3578719988,32
3,800,8544,3578719956,3578719989,33
3,800,8545,3578719956,3578719989,33
3,800,8546,3578719956,3578719990,34
3,800,8547,3578719956,3578719993,37
3,800,8548,3578719956,3578720000,44
3,800,8549,3578719956,3578720001,45
3,800,8550,3578719956,3578720003,47
3,800,8551,3578719956,3578720003,47
3,800,8552,3578719956,3578720005,49
3,801,8553,3578720010,3578720010,0
3,801,8554,3578720010,3578720010,0
3,801,8555,3578720010,3578720010,0
3,801,8556,3578720010,3578720012,2
3,801,8557,3578720010,3578720012,2
3,801,8558,3578720010,3578720014,4
3,801,8559,3578720010,3578720014,4
3,801,8560,3578720010,3578720016,6
3,801,8561,3578720010,3578720016,6
3,801,8562,3578720010,3578720019,9
3,801,8563,3578720010,3578720021,11
3,801,8564,3578720010,3578720022,12
3,801,8565,3578720010,3578720023,13
3,801,8566,3578720010,3578720024,14
3,801,8567,3578720010,3578720026,16
3,801,8568,3578720010,3578720026,16
3,801,8569,3578720010,3578720027,17
3,801,8570,3578720010,3578720031,21
3,801,8571,3578720010,3578720035,25
3,801,8572,3578720010,3578720036,26
3,801,8573,3578720010,3578720040,30
3,801,8574,3578720010,3578720040,30
3,801,8575,3578720010,3578720042,32
3,801,8576,3578720010,3578720044,34
3,801,8577,3578720010,3578720045,35
3,801,8578,3578720010,3578720046,36
3,801,8579,3578720010,3578720046,36
3,801,8580,3578720010,3578720047,37
3,801,8581,3578720010,3578720051,41
3,801,8582,3578720010,3578720052,42
3,801,8583,3578720010,3578720052,42
3,801,8584,3578720010,3578720053,43
3,802,8585,3578720065,3578720065,0
3,802,8586,3578720065,3578720065,0
3,802,8587,3578720065,3578720065,0
3,802,8588,3578720065,3578720065,0
3,802,8589,3578720065,3578720065,0
3,802,8590,3578720065,3578720068,3
3,802,8591,3578720065,3578720069,4
3,802,8592,3578720065,3578720070,5
3,802,8593,3578720065,3578720070,5
3,802,8594,3578720065,3578720072,7
3,802,8595,3578720065,3578720076,11
3,802,8596,3578720065,3578720077,12
3,802,8597,3578720065,3578720078,13
3,802,8598,3578720065,3578720079,14
3,802,8599,3578720065,3578720080,15
3,802,8600,3578720065,3578720088,23
3,802,8601,3578720065,3578720090,25
3,802,8602,3578720065,3578720093,28
3,802,8603,3578720065,3578720095,30
3,802,8604,3578720065,3578720097,32
3,802,8605,3578720065,3578720098,33
3,802,8606,3578720065,3578720099,34
3,802,8607,3578720065,3578720100,35
3,802,8608,3578720065,3578720100,35
3,802,8609,3578720065,3578720102,37
3,802,8610,3578720065,3578720104,39
3,802,8611,3578720065,3578720109,44
3,802,8612,3578720065,3578720115,50
3,803,8613,3578720121,3578720121,0
3,803,8614,3578720121,3578720121,0
3,803,8615,3578720121,3578720121,0
3,803,8616,3578720121,3578720121,0
3,803,8617,3578720121,3578720121,0
3,803,8618,3578720121,3578720129,8
3,803,8619,3578720121,3578720136,15
3,803,8620,3578720121,3578720136,15
3,803,8621,3578720121,3578720138,17
3,803,8622,3578720121,3578720138,17
3,803,8623,3578720121,3578720139,18
3,803,8624,3578720121,3578720139,18
3,803,8625,3578720121,3578720140,19
3,803,8626,3578720121,3578720141,20
3,803,8627,3578720121,3578720145,24
3,803,8628,3578720121,3578720145,24
3,803,8629,3578720121,3578720145,24
3,803,8630,3578720121,3578720148,27
3,803,8631,3578720121,3578720151,30
3,803,8632,3578720121,3578720152,31
3,803,8633,3578720121,3578720154,33
3,803,8634,3578720121,3578720154,33
3,803,8635,3578720121,3578720155,34
3,803,8636,3578720121,3578720155,34
3,803,8637,3578720121,3578720157,36
3,803,8638,3578720121,3578720161,40
3,803,8639,3578720121,3578720164,43
3,803,8640,3578720121,3578720165,44
3,803,8641,3578720121,3578720165,44
3,803,8642,3578720121,3578720167,46
3,803,8643,3578720121,3578720171,50
3,804,8644,3578720176,3578720176,0
3,804,8645,3578720176,3578720176,0
3,804,8646,3578720176,3578720176,0
3,804,8647,3578720176,3578720176,0
3,804,8648,3578720176,3578720176,0
3,804,8649,3578720176,3578720176,0
3,804,8650,3578720176,3578720179,3
3,804,8651,3578720176,3578720179,3
3,804,8652,3578720176,3578720182,6
3,804,8653,3578720176,3578720184,8
3,804,8654,3578720176,3578720185,9
3,804,8655,3578720176,3578720187,11
3,804,8656,3578720176,3578720188,12
3,804,8657,3578720176,3578720188,12
3,804,8658,3578720176,3578720191,15
3,804,8659,3578720176,3578720192,16
3,804,8660,3578720176,3578720202,26
3,804,8661,3578720176,3578720202,26
3,804,8662,3578720176,3578720204,28
3,804,8663,3578720176,3578720205,29
3,804,8664,3578720176,3578720206,30
3,804,8665,3578720176,3578720206,30
3,804,8666,3578720176,3578720209,33
3,804,8667,3578720176,3578720209,33
3,804,8668,3578720176,3578720210,34
3,804,8669,3578720176,3578720212,36
3,804,8670,3578720176,3578720213,37
3,804,8671,3578720176,3578720214,38
3,804,8672,3578720176,3578720215,39
3,804,8673,3578720176,3578720216,40
3,804,8674,3578720176,3578720216,40
3,804,8675,3578720176,3578720219,43
3,804,8676,3578720176,3578720221,45
3,804,8677,3578720176,3578720223,47
3,804,8678,3578720176,3578720224,48
3,804,8679,3578720176,3578720224,48
3,805,8680,3578720231,3578720231,0
3,805,8681,3578720231,3578720231,0
3,805,8682,3578720231,3578720231,0
3,805,8683,3578720231,3578720235,4
3,805,8684,3578720231,3578720236,5
3,805,8685,3578720231,3578720239,8
3,805,8686,3578720231,3578720240,9
3,805,8687,3578720231,3578720242,11
3,805,8688,3578720231,3578720244,13
3,805,8689,3578720231,3578720245,14
3,805,8690,3578720231,3578720246,15
3,805,8691,3578720231,3578720246,15
3,805,8692,3578720231,3578720247,16
3,805,8693,3578720231,3578720252,21
3,805,8694,3578720231,3578720252,21
3,805,8695,3578720231,3578720252,21
3,805,8696,3578720231,3578720254,23
3,805,8697,3578720231,3578720262,31
3,805,8698,3578720231,3578720262,31
3,805,8699,3578720231,3578720262,31
3,805,8700,3578720231,3578720263,32
3,805,8701,3578720231,3578720264,33
3,805,8702,3578720231,3578720265,34
3,805,8703,3578720231,3578720268,37
3,805,8704,3578720231,3578720269,38
3,805,8705,3578720231,3578720270,39
3,805,8706,3578720231,3578720271,40
3,805,8707,3578720231,3578720272,41
3,805,8708,3578720231,3578720276,45
3,805,8709,3578720231,3578720277,46
3,805,8710,3578720231,3578720278,47
3,805,8711,3578720231,3578720279,48
3,805,8712,3578720231,3578720280,49
3,806,8713,3578720287,3578720287,0
3,806,8714,3578720287,3578720288,1
3,806,8715,3578720287,3578720289,2
3,806,8716,3578720287,3578720293,6
3,806,8717,3578720287,3578720296,9
3,806,8718,3578720287,3578720297,10
3,806,8719,3578720287,3578720297,10
3,806,8720,3578720287,3578720299,12
3,806,8721,3578720287,3578720299,12
3,806,8722,3578720287,3578720300,13
3,806,8723,3578720287,3578720302,15
3,806,8724,3578720287,3578720304,17
3,806,8725,3578720287,3578720310,23
3,806,8726,3578720287,3578720315,28
3,806,8727,3578720287,3578720316,29
3,806,8728,3578720287,3578720317,30
3,806,8729,3578720287,3578720319,32
3,806,8730,3578720287,3578720321,34
3,806,8731,3578720287,3578720322,35
3,806,8732,3578720287,3578720329,42
3,806,8733,3578720287,3578720336,49
3,806,8734,3578720287,3578720336,49
3,807,8735,3578720343,3578720343,0
3,807,8736,3578720343,3578720343,0
3,807,8737,3578720343,3578720343,0
3,807,8738,3578720343,3578720343,0
3,807,8739,3578720343,3578720343,0
3,807,8740,3578720343,3578720343,0
3,807,8741,3578720343,3578720345,2
3,807,8742,3578720343,3578720346,3
3,807,8743,3578720343,3578720346,3
3,807,8744,3578720343,3578720348,5
3,807,8745,3578720343,3578720350,7
3,807,8746,3578720343,3578720353,10
3,807,8747,3578720343,3578720354,11
3,807,8748,3578720343,3578720355,12
3,807,8749,3578720343,3578720356,13
3,807,8750,3578720343,3578720357,14
3,807,8751,3578720343,3578720358,15
3,807,8752,3578720343,3578720360,17
3,807,8753,3578720343,3578720364,21
3,807,8754,3578720343,3578720365,22
3,807,8755,3578720343,3578720366,23
3,807,8756,3578720343,3578720368,25
3,807,8757,3578720343,3578720371,28
3,807,8758,3578720343,3578720372,29
3,807,8759,3578720343,3578720373,30
3,807,8760,3578720343,3578720374,31
3,807,8761,3578720343,3578720374,31
3,807,8762,3578720343,3578720374,31
3,807,8763,3578720343,3578720377,34
3,807,8764,3578720343,3578720378,35
3,807,8765,3578720343,3578720379,36
3,807,8766,3578720343,3578720382,39
3,807,8767,3578720343,3578720383,40
3,807,8768,3578720343,3578720386,43
3,807,8769,3578720343,3578720387,44
3,807,8770,3578720343,3578720388,45
3,807,8771,3578720343,3578720389,46
3,807,8772,3578720343,3578720389,46
3,807,8773,3578720343,3578720391,48
3,807,8774,3578720343,3578720393,50
3,808,8775,3578720397,3578720401,4
3,808,8776,3578720397,3578720402,5
3,808,8777,3578720397,3578720404,7
3,808,8778,3578720397,3578720417,20
3,808,8779,3578720397,3578720417,20
3,808,8780,3578720397,3578720417,20
3,808,8781,3578720397,3578720417,20
3,808,8782,3578720397,3578720417,20
3,808,8783,3578720397,3578720417,20
3,808,8784,3578720397,3578720417,20
3,808,8785,3578720397,3578720417,20
3,808,8786,3578720397,3578720417,20
3,808,8787,3578720397,3578720417,20
3,808,8788,3578720397,3578720417,20
3,808,8789,3578720397,3578720419,22
3,808,8790,3578720397,3578720421,24
3,808,8791,3578720397,3578720423,26
3,808,8792,3578720397,3578720424,27
3,808,8793,3578720397,3578720424,27
3,808,8794,3578720397,3578720427,30
3,808,8795,3578720397,3578720427,30
3,808,8796,3578720397,3578720427,30
3,808,8797,3578720397,3578720432,35
3,808,8798,3578720397,3578720434,37
3,808,8799,3578720397,3578720435,38
3,808,8800,3578720397,3578720435,38
3,808,8801,3578720397,3578720439,42
3,808,8802,3578720397,3578720440,43
3,808,8803,3578720397,3578720442,45
3,808,8804,3578720397,3578720444,47
3,808,8805,3578720397,3578720445,48
3,808,8806,3578720397,3578720446,49
3,808,8807,3578720397,3578720446,49
3,808,8808,3578720397,3578720447,50
3,809,8809,3578720452,3578720452,0
3,809,8810,3578720452,3578720452,0
3,809,8811,3578720452,3578720454,2
3,809,8812,3578720452,3578720461,9
3,809,8813,3578720452,3578720461,9
3,809,8814,3578720452,3578720463,11
3,809,8815,3578720452,3578720463,11
3,809,8816,3578720452,3578720464,12
3,809,8817,3578720452,3578720469,17
3,809,8818,3578720452,3578720470,18
3,809,8819,3578720452,3578720471,19
3,809,8820,3578720452,3578720472,20
3,809,8821,3578720452,3578720476,24
3,809,8822,3578720452,3578720478,26
3,809,8823,3578720452,3578720478,26
3,809,8824,3578720452,3578720479,27
3,809,8825,3578720452,3578720481,29
3,809,8826,3578720452,3578720481,29
3,809,8827,3578720452,3578720488,36
3,809,8828,3578720452,3578720488,36
3,809,8829,3578720452,3578720490,38
3,809,8830,3578720452,3578720493,41
3,809,8831,3578720452,3578720495,43
3,809,8832,3578720452,3578720497,45
3,809,8833,3578720452,3578720498,46
3,809,8834,3578720452,3578720499,47
3,809,8835,3578720452,3578720500,48
3,809,8836,3578720452,3578720500,48
3,809,8837,3578720452,3578720502,50
3,810,8838,3578720506,3578720506,0
3,810,8839,3578720506,3578720509,3
3,810,8840,3578720506,3578720514,8
3,810,8841,3578720506,3578720515,9
3,810,8842,3578720506,3578720517,11
3,810,8843,3578720506,3578720518,12
3,810,8844,3578720506,3578720520,14
3,810,8845,3578720506,3578720521,15
3,810,8846,3578720506,3578720528,22
3,810,8847,3578720506,3578720535,29
3,810,8848,3578720506,3578720535,29
3,810,8849,3578720506,3578720537,31
3,810,8850,3578720506,3578720537,31
3,810,8851,3578720506,3578720537,31
3,810,8852,3578720506,3578720538,32
3,810,8853,3578720506,3578720538,32
3,810,8854,3578720506,3578720539,33
3,810,8855,3578720506,3578720540,34
3,810,8856,3578720506,3578720544,38
3,810,8857,3578720506,3578720544,38
3,810,8858,3578720506,3578720544,38
3,810,8859,3578720506,3578720548,42
3,810,8860,3578720506,3578720549,43
3,810,8861,3578720506,3578720553,47
3,810,8862,3578720506,3578720553,47
3,810,8863,3578720506,3578720554,48
3,810,8864,3578720506,3578720554,48
3,810,8865,3578720506,3578720554,48
3,811,8866,3578720561,3578720561,0
3,811,8867,3578720561,3578720561,0
3,811,8868,3578720561,3578720561,0
3,811,8869,3578720561,3578720563,2
3,811,8870,3578720561,3578720564,3
3,811,8871,3578720561,3578720565,4
3,811,8872,3578720561,3578720568,7
3,811,8873,3578720561,3578720570,9
3,811,8874,3578720561,3578720572,11
3,811,8875,3578720561,3578720572,11
3,811,8876,3578720561,3578720572,11
3,811,8877,3578720561,3578720573,12
3,811,8878,3578720561,3578720573,12
3,811,8879,3578720561,3578720573,12
3,811,8880,3578720561,3578720576,15
3,811,8881,3578720561,3578720578,17
3,811,8882,3578720561,3578720578,17
3,811,8883,3578720561,3578720582,21
3,811,8884,3578720561,3578720583,22
3,811,8885,3578720561,3578720585,24
3,811,8886,3578720561,3578720586,25
3,811,8887,3578720561,3578720588,27
3,811,8888,3578720561,3578720588,27
3,811,8889,3578720561,3578720589,28
3,811,8890,3578720561,3578720590,29
3,811,8891,3578720561,3578720591,30
3,811,8892,3578720561,3578720593,32
3,811,8893,3578720561,3578720601,40
3,811,8894,3578720561,3578720602,41
3,811,8895,3578720561,3578720604,43
3,811,8896,3578720561,3578720604,43
3,811,8897,3578720561,3578720605,44
3,811,8898,3578720561,3578720605,44
3,811,8899,3578720561,3578720608,47
3,811,8900,3578720561,3578720610,49
3,811,8901,3578720561,3578720611,50
3,812,8902,3578720616,3578720616,0
3,812,8903,3578720616,3578720616,0
3,812,8904,3578720616,3578720616,0
3,812,8905,3578720616,3578720616,0
3,812,8906,3578720616,3578720616,0
3,812,8907,3578720616,3578720619,3
3,812,8908,3578720616,3578720621,5
3,812,8909,3578720616,3578720622,6
3,812,8910,3578720616,3578720624,8
3,812,8911,3578720616,3578720624,8
3,812,8912,3578720616,3578720626,10
3,812,8913,3578720616,3578720626,10
3,812,8914,3578720616,3578720627,11
3,812,8915,3578720616,3578720631,15
3,812,8916,3578720616,3578720635,19
3,812,8917,3578720616,3578720635,19
3,812,8918,3578720616,3578720639,23
3,812,8919,3578720616,3578720639,23
3,812,8920,3578720616,3578720641,25
3,812,8921,3578720616,3578720643,27
3,812,8922,3578720616,3578720645,29
3,812,8923,3578720616,3578720646,30
3,812,8924,3578720616,3578720646,30
3,812,8925,3578720616,3578720650,34
3,812,8926,3578720616,3578720651,35
3,812,8927,3578720616,3578720652,36
3,812,8928,3578720616,3578720653,37
3,812,8929,3578720616,3578720661,45
3,812,8930,3578720616,3578720662,46
3,812,8931,3578720616,3578720662,46
3,812,8932,3578720616,3578720663,47
3,812,8933,3578720616,3578720665,49
3,813,8934,3578720671,3578720671,0
3,813,8935,3578720671,3578720671,0
3,813,8936,3578720671,3578720671,0
3,813,8937,3578720671,3578720676,5
3,813,8938,3578720671,3578720677,6
3,813,8939,3578720671,3578720678,7
3,813,8940,3578720671,3578720679,8
3,813,8941,3578720671,3578720682,11
3,813,8942,3578720671,3578720688,17
3,813,8943,3578720671,3578720688,17
3,813,8944,3578720671,3578720690,19
3,813,8945,3578720671,3578720693,22
3,813,8946,3578720671,3578720696,25
3,813,8947,3578720671,3578720697,26
3,813,8948,3578720671,3578720698,27
3,813,8949,3578720671,3578720699,28
3,813,8950,3578720671,3578720700,29
3,813,8951,3578720671,3578720700,29
3,813,8952,3578720671,3578720702,31
3,813,8953,3578720671,3578720703,32
3,813,8954,3578720671,3578720709,38
3,813,8955,3578720671,3578720714,43
3,813,8956,3578720671,3578720715,44
3,813,8957,3578720671,3578720717,46
3,813,8958,3578720671,3578720718,47
3,813,8959,3578720671,3578720721,50
3,814,8960,3578720727,3578720727,0
3,814,8961,3578720727,3578720728,1
3,814,8962,3578720727,3578720735,8
3,814,8963,3578720727,3578720736,9
3,814,8964,3578720727,3578720737,10
3,814,8965,3578720727,3578720737,10
3,814,8966,3578720727,3578720737,10
3,814,8967,3578720727,3578720738,11
3,814,8968,3578720727,3578720739,12
3,814,8969,3578720727,3578720740,13
3,814,8970,3578720727,3578720744,17
3,814,8971,3578720727,3578720745,18
3,814,8972,3578720727,3578720747,20
3,814,8973,3578720727,3578720749,22
3,814,8974,3578720727,3578720753,26
3,814,8975,3578720727,3578720753,26
3,814,8976,3578720727,3578720753,26
3,814,8977,3578720727,3578720753,26
3,814,8978,3578720727,3578720755,28
3,814,8979,3578720727,3578720756,29
3,814,8980,3578720727,3578720757,30
3,814,8981,3578720727,3578720760,33
3,814,8982,3578720727,3578720763,36
3,814,8983,3578720727,3578720764,37
3,814,8984,3578720727,3578720764,37
3,814,8985,3578720727,3578720770,43
3,814,8986,3578720727,3578720772,45
3,814,8987,3578720727,3578720773,46
3,814,8988,3578720727,3578720773,46
3,814,8989,3578720727,3578720774,47
3,814,8990,3578720727,3578720774,47
3,814,8991,3578720727,3578720776,49
3,815,8992,3578720783,3578720783,0
3,815,8993,3578720783,3578720783,0
3,815,8994,3578720783,3578720783,0
3,815,8995,3578720783,3578720784,1
3,815,8996,3578720783,3578720785,2
3,815,8997,3578720783,3578720786,3
3,815,8998,3578720783,3578720788,5
3,815,8999,3578720783,3578720788,5
3,815,9000,3578720783,3578720789,6
3,815,9001,3578720783,3578720790,7
3,815,9002,3578720783,3578720792,9
3,815,9003,3578720783,3578720801,18
3,815,9004,3578720783,3578720802,19
3,815,9005,3578720783,3578720804,21
3,815,9006,3578720783,3578720804,21
3,815,9007,3578720783,3578720804,21
3,815,9008,3578720783,3578720805,22
3,815,9009,3578720783,3578720805,22
3,815,9010,3578720783,3578720808,25
3,815,9011,3578720783,3578720809,26
3,815,9012,3578720783,3578720810,27
3,815,9013,3578720783,3578720811,28
3,815,9014,3578720783,3578720814,31
3,815,9015,3578720783,3578720814,31
3,815,9016,3578720783,3578720815,32
3,815,9017,3578720783,3578720815,32
3,815,9018,3578720783,3578720817,34
3,815,9019,3578720783,3578720820,37
3,815,9020,3578720783,3578720821,38
3,815,9021,3578720783,3578720822,39
3,815,9022,3578720783,3578720823,40
3,815,9023,3578720783,3578720826,43
3,815,9024,3578720783,3578720826,43
3,815,9025,3578720783,3578720826,43
3,815,9026,3578720783,3578720827,44
3,815,9027,3578720783,3578720831,48
3,815,9028,3578720783,3578720832,49
3,816,9029,3578720838,3578720838,0
3,816,9030,3578720838,3578720838,0
3,816,9031,3578720838,3578720838,0
3,816,9032,3578720838,3578720839,1
3,816,9033,3578720838,3578720841,3
3,816,9034,3578720838,3578720843,5
3,816,9035,3578720838,3578720845,7
3,816,9036,3578720838,3578720846,8
3,816,9037,3578720838,3578720846,8
3,816,9038,3578720838,3578720847,9
3,816,9039,3578720838,3578720851,13
3,816,9040,3578720838,3578720852,14
3,816,9041,3578720838,3578720853,15
3,816,9042,3578720838,3578720862,24
3,816,9043,3578720838,3578720862,24
3,816,9044,3578720838,3578720862,24
3,816,9045,3578720838,3578720863,25
3,816,9046,3578720838,3578720864,26
3,816,9047,3578720838,3578720866,28
3,816,9048,3578720838,3578720868,30
3,816,9049,3578720838,3578720870,32
3,816,9050,3578720838,3578720870,32
3,816,9051,3578720838,3578720870,32
3,816,9052,3578720838,3578720877,39
3,816,9053,3578720838,3578720877,39
3,816,9054,3578720838,3578720878,40
3,816,9055,3578720838,3578720878,40
3,816,9056,3578720838,3578720880,42
3,816,9057,3578720838,3578720881,43
3,816,9058,3578720838,3578720882,44
3,816,9059,3578720838,3578720888,50
3,817,9060,3578720893,3578720893,0
3,817,9061,3578720893,3578720893,0
3,817,9062,3578720893,3578720893,0
3,817,9063,3578720893,3578720897,4
3,817,9064,3578720893,3578720897,4
3,817,9065,3578720893,3578720898,5
3,817,9066,3578720893,3578720899,6
3,817,9067,3578720893,3578720900,7
3,817,9068,3578720893,3578720900,7
3,817,9069,3578720893,3578720903,10
3,817,9070,3578720893,3578720903,10
3,817,9071,3578720893,3578720909,16
3,817,9072,3578720893,3578720915,22
3,817,9073,3578720893,3578720916,23
3,817,9074,3578720893,3578720917,24
3,817,9075,3578720893,3578720919,26
3,817,9076,3578720893,3578720921,28
3,817,9077,3578720893,3578720921,28
3,817,9078,3578720893,3578720928,35
3,817,9079,3578720893,3578720934,41
3,817,9080,3578720893,3578720936,43
3,817,9081,3578720893,3578720937,44
3,817,9082,3578720893,3578720937,44
3,817,9083,3578720893,3578720938,45
3,817,9084,3578720893,3578720939,46
3,817,9085,3578720893,3578720939,46
3,817,9086,3578720893,3578720940,47
3,817,9087,3578720893,3578720940,47
3,818,9088,3578720948,3578720948,0
3,818,9089,3578720948,3578720948,0
3,818,9090,3578720948,3578720948,0
3,818,9091,3578720948,3578720948,0
3,818,9092,3578720948,3578720950,2
3,818,9093,3578720948,3578720953,5
3,818,9094,3578720948,3578720954,6
3,818,9095,3578720948,3578720954,6
3,818,9096,3578720948,3578720954,6
3,818,9097,3578720948,3578720957,9
3,818,9098,3578720948,3578720957,9
3,818,9099,3578720948,3578720960,12
3,818,9100,3578720948,3578720964,16
3,818,9101,3578720948,3578720964,16
3,818,9102,3578720948,3578720964,16
3,818,9103,3578720948,3578720968,20
3,818,9104,3578720948,3578720971,23
3,818,9105,3578720948,3578720972,24
3,818,9106,3578720948,3578720974,26
3,818,9107,3578720948,3578720974,26
3,818,9108,3578720948,3578720974,26
3,818,9109,3578720948,3578720974,26
3,818,9110,3578720948,3578720978,30
3,818,9111,3578720948,3578720979,31
3,818,9112,3578720948,3578720982,34
3,818,9113,3578720948,3578720984,36
3,818,9114,3578720948,3578720985,37
3,818,9115,3578720948,3578720987,39
3,818,9116,3578720948,3578720988,40
3,818,9117,3578720948,3578720989,41
3,818,9118,3578720948,3578720990,42
3,818,9119,3578720948,3578720993,45
3,819,9120,3578721004,3578721004,0
3,819,9121,3578721004,3578721004,0
3,819,9122,3578721004,3578721004,0
3,819,9123,3578721004,3578721005,1
3,819,9124,3578721004,3578721005,1
3,819,9125,3578721004,3578721005,1
3,819,9126,3578721004,3578721008,4
3,819,9127,3578721004,3578721010,6
3,819,9128,3578721004,3578721012,8
3,819,9129,3578721004,3578721014,10
3,819,9130,3578721004,3578721014,10
3,819,9131,3578721004,3578721015,11
3,819,9132,3578721004,3578721015,11
3,819,9133,3578721004,3578721017,13
3,819,9134,3578721004,3578721020,16
3,819,9135,3578721004,3578721021,17
3,819,9136,3578721004,3578721023,19
3,819,9137,3578721004,3578721025,21
3,819,9138,3578721004,3578721026,22
3,819,9139,3578721004,3578721027,23
3,819,9140,3578721004,3578721028,24
3,819,9141,3578721004,3578721031,27
3,819,9142,3578721004,3578721032,28
3,819,9143,3578721004,3578721036,32
3,819,9144,3578721004,3578721037,33
3,819,9145,3578721004,3578721038,34
3,819,9146,3578721004,3578721040,36
3,819,9147,3578721004,3578721041,37
3,819,9148,3578721004,3578721043,39
3,819,9149,3578721004,3578721046,42
3,819,9150,3578721004,3578721047,43
3,819,9151,3578721004,3578721047,43
3,819,9152,3578721004,3578721051,47
3,819,9153,3578721004,3578721052,48
3,819,9154,3578721004,3578721053,49
3,819,9155,3578721004,3578721053,49
3,820,9156,3578721059,3578721062,3
3,820,9157,3578721059,3578721062,3
3,820,9158,3578721059,3578721062,3
3,820,9159,3578721059,3578721064,5
3,820,9160,3578721059,3578721065,6
3,820,9161,3578721059,3578721066,7
3,820,9162,3578721059,3578721069,10
3,820,9163,3578721059,3578721069,10
3,820,9164,3578721059,3578721070,11
3,820,9165,3578721059,3578721070,11
3,820,9166,3578721059,3578721077,18
3,820,9167,3578721059,3578721078,19
3,820,9168,3578721059,3578721078,19
3,820,9169,3578721059,3578721078,19
3,820,9170,3578721059,3578721079,20
3,820,9171,3578721059,3578721082,23
3,820,9172,3578721059,3578721088,29
3,820,9173,3578721059,3578721088,29
3,820,9174,3578721059,3578721093,34
3,820,9175,3578721059,3578721097,38
3,820,9176,3578721059,3578721097,38
3,820,9177,3578721059,3578721098,39
3,820,9178,3578721059,3578721100,41
3,820,9179,3578721059,3578721100,41
3,820,9180,3578721059,3578721101,42
3,820,9181,3578721059,3578721102,43
3,820,9182,3578721059,3578721103,44
3,821,9183,3578721115,3578721115,0
3,821,9184,3578721115,3578721115,0
3,821,9185,3578721115,3578721116,1
3,821,9186,3578721115,3578721117,2
3,821,9187,3578721115,3578721119,4
3,821,9188,3578721115,3578721121,6
3,821,9189,3578721115,3578721121,6
3,821,9190,3578721115,3578721128,13
3,821,9191,3578721115,3578721136,21
3,821,9192,3578721115,3578721136,21
3,821,9193,3578721115,3578721138,23
3,821,9194,3578721115,3578721138,23
3,821,9195,3578721115,3578721138,23
3,821,9196,3578721115,3578721139,24
3,821,9197,3578721115,3578721139,24
3,821,9198,3578721115,3578721140,25
3,821,9199,3578721115,3578721145,30
3,821,9200,3578721115,3578721146,31
3,821,9201,3578721115,3578721147,32
3,821,9202,3578721115,3578721147,32
3,821,9203,3578721115,3578721150,35
3,821,9204,3578721115,3578721153,38
3,821,9205,3578721115,3578721153,38
3,821,9206,3578721115,3578721154,39
3,821,9207,3578721115,3578721154,39
3,821,9208,3578721115,3578721155,40
3,821,9209,3578721115,3578721157,42
3,821,9210,3578721115,3578721158,43
3,821,9211,3578721115,3578721160,45
3,821,9212,3578721115,3578721163,48
3,821,9213,3578721115,3578721164,49
3,822,9214,3578721171,3578721171,0
3,822,9215,3578721171,3578721171,0
3,822,9216,3578721171,3578721171,0
3,822,9217,3578721171,3578721172,1
3,822,9218,3578721171,3578721174,3
3,822,9219,3578721171,3578721174,3
3,822,9220,3578721171,3578721174,3
3,822,9221,3578721171,3578721176,5
3,822,9222,3578721171,3578721178,7
3,822,9223,3578721171,3578721179,8
3,822,9224,3578721171,3578721182,11
3,822,9225,3578721171,3578721185,14
3,822,9226,3578721171,3578721185,14
3,822,9227,3578721171,3578721187,16
3,822,9228,3578721171,3578721189,18
3,822,9229,3578721171,3578721189,18
3,822,9230,3578721171,3578721189,18
3,822,9231,3578721171,3578721191,20
3,822,9232,3578721171,3578721193,22
3,822,9233,3578721171,3578721202,31
3,822,9234,3578721171,3578721203,32
3,822,9235,3578721171,3578721204,33
3,822,9236,3578721171,3578721205,34
3,822,9237,3578721171,3578721205,34
3,822,9238,3578721171,3578721208,37
3,822,9239,3578721171,3578721210,39
3,822,9240,3578721171,3578721212,41
3,822,9241,3578721171,3578721214,43
3,822,9242,3578721171,3578721215,44
3,822,9243,3578721171,3578721216,45
3,822,9244,3578721171,3578721217,46
3,822,9245,3578721171,3578721220,49
3,822,9246,3578721171,3578721221,50
3,823,9247,3578721226,3578721226,0
3,823,9248,3578721226,3578721226,0
3,823,9249,3578721226,3578721226,0
3,823,9250,3578721226,3578721227,1
3,823,9251,3578721226,3578721227,1
3,823,9252,3578721226,3578721228,2
3,823,9253,3578721226,3578721232,6
3,823,9254,3578721226,3578721233,7
3,823,9255,3578721226,3578721236,10
3,823,9256,3578721226,3578721237,11
3,823,9257,3578721226,3578721239,13
3,823,9258,3578721226,3578721242,16
3,823,9259,3578721226,3578721243,17
3,823,9260,3578721226,3578721245,19
3,823,9261,3578721226,3578721246,20
3,823,9262,3578721226,3578721246,20
3,823,9263,3578721226,3578721247,21
3,823,9264,3578721226,3578721253,27
3,823,9265,3578721226,3578721253,27
3,823,9266,3578721226,3578721254,28
3,823,9267,3578721226,3578721261,35
3,823,9268,3578721226,3578721261,35
3,823,9269,3578721226,3578721263,37
3,823,9270,3578721226,3578721264,38
3,823,9271,3578721226,3578721265,39
3,823,9272,3578721226,3578721267,41
3,823,9273,3578721226,3578721269,43
3,823,9274,3578721226,3578721269,43
3,823,9275,3578721226,3578721270,44
3,823,9276,3578721226,3578721270,44
3,823,9277,3578721226,3578721272,46
3,824,9278,3578721281,3578721281,0
3,824,9279,3578721281,3578721281,0
3,824,9280,3578721281,3578721281,0
3,824,9281,3578721281,3578721281,0
3,824,9282,3578721281,3578721281,0
3,824,9283,3578721281,3578721281,0
3,824,9284,3578721281,3578721282,1
3,824,9285,3578721281,3578721288,7
3,824,9286,3578721281,3578721288,7
3,824,9287,3578721281,3578721291,10
3,824,9288,3578721281,3578721293,12
3,824,9289,3578721281,3578721297,16
3,824,9290,3578721281,3578721298,17
3,824,9291,3578721281,3578721299,18
3,824,9292,3578721281,3578721300,19
3,824,9293,3578721281,3578721300,19
3,824,9294,3578721281,3578721301,20
3,824,9295,3578721281,3578721302,21
3,824,9296,3578721281,3578721304,23
3,824,9297,3578721281,3578721309,28
3,824,9298,3578721281,3578721315,34
3,824,9299,3578721281,3578721316,35
3,824,9300,3578721281,3578721317,36
3,824,9301,3578721281,3578721319,38
3,824,9302,3578721281,3578721321,40
3,824,9303,3578721281,3578721322,41
3,824,9304,3578721281,3578721328,47
3,825,9305,3578721336,3578721336,0
3,825,9306,3578721336,3578721337,1
3,825,9307,3578721336,3578721337,1
3,825,9308,3578721336,3578721338,2
3,825,9309,3578721336,3578721339,3
3,825,9310,3578721336,3578721339,3
3,825,9311,3578721336,3578721339,3
3,825,9312,3578721336,3578721342,6
3,825,9313,3578721336,3578721345,9
3,825,9314,3578721336,3578721347,11
3,825,9315,3578721336,3578721347,11
3,825,9316,3578721336,3578721348,12
3,825,9317,3578721336,3578721350,14
3,825,9318,3578721336,3578721354,18
3,825,9319,3578721336,3578721354,18
3,825,9320,3578721336,3578721354,18
3,825,9321,3578721336,3578721354,18
3,825,9322,3578721336,3578721355,19
3,825,9323,3578721336,3578721357,21
3,825,9324,3578721336,3578721358,22
3,825,9325,3578721336,3578721360,24
3,825,9326,3578721336,3578721364,28
3,825,9327,3578721336,3578721364,28
3,825,9328,3578721336,3578721367,31
3,825,9329,3578721336,3578721368,32
3,825,9330,3578721336,3578721371,35
3,825,9331,3578721336,3578721372,36
3,825,9332,3578721336,3578721373,37
3,825,9333,3578721336,3578721374,38
3,825,9334,3578721336,3578721374,38
3,825,9335,3578721336,3578721375,39
3,825,9336,3578721336,3578721375,39
3,825,9337,3578721336,3578721376,40
3,825,9338,3578721336,3578721379,43
3,825,9339,3578721336,3578721379,43
3,825,9340,3578721336,3578721382,46
3,825,9341,3578721336,3578721384,48
3,825,9342,3578721336,3578721385,49
3,825,9343,3578721336,3578721386,50
3,826,9344,3578721393,3578721393,0
3,826,9345,3578721393,3578721393,0
3,826,9346,3578721393,3578721393,0
3,826,9347,3578721393,3578721393,0
3,826,9348,3578721393,3578721393,0
3,826,9349,3578721393,3578721393,0
3,826,9350,3578721393,3578721393,0
3,826,9351,3578721393,3578721402,9
3,826,9352,3578721393,3578721403,10
3,826,9353,3578721393,3578721403,10
3,826,9354,3578721393,3578721404,11
3,826,9355,3578721393,3578721405,12
3,826,9356,3578721393,3578721406,13
3,826,9357,3578721393,3578721408,15
3,826,9358,3578721393,3578721410,17
3,826,9359,3578721393,3578721412,19
3,826,9360,3578721393,3578721414,21
3,826,9361,3578721393,3578721415,22
3,826,9362,3578721393,3578721416,23
3,826,9363,3578721393,3578721416,23
3,826,9364,3578721393,3578721417,24
3,826,9365,3578721393,3578721420,27
3,826,9366,3578721393,3578721421,28
3,826,9367,3578721393,3578721423,30
3,826,9368,3578721393,3578721426,33
3,826,9369,3578721393,3578721426,33
3,826,9370,3578721393,3578721427,34
3,826,9371,3578721393,3578721427,34
3,826,9372,3578721393,3578721428,35
3,826,9373,3578721393,3578721433,40
3,826,9374,3578721393,3578721436,43
3,826,9375,3578721393,3578721436,43
3,826,9376,3578721393,3578721437,44
3,826,9377,3578721393,3578721440,47
3,826,9378,3578721393,3578721440,47
3,826,9379,3578721393,3578721442,49
3,827,9380,3578721448,3578721448,0
3,827,9381,3578721448,3578721448,0
3,827,9382,3578721448,3578721448,0
3,827,9383,3578721448,3578721448,0
3,827,9384,3578721448,3578721450,2
3,827,9385,3578721448,3578721452,4
3,827,9386,3578721448,3578721453,5
3,827,9387,3578721448,3578721454,6
3,827,9388,3578721448,3578721462,14
3,827,9389,3578721448,3578721462,14
3,827,9390,3578721448,3578721463,15
3,827,9391,3578721448,3578721464,16
3,827,9392,3578721448,3578721466,18
3,827,9393,3578721448,3578721467,19
3,827,9394,3578721448,3578721469,21
3,827,9395,3578721448,3578721470,22
3,827,9396,3578721448,3578721470,22
3,827,9397,3578721448,3578721472,24
3,827,9398,3578721448,3578721477,29
3,827,9399,3578721448,3578721478,30
3,827,9400,3578721448,3578721478,30
3,827,9401,3578721448,3578721479,31
3,827,9402,3578721448,3578721479,31
3,827,9403,3578721448,3578721482,34
3,827,9404,3578721448,3578721488,40
3,827,9405,3578721448,3578721488,40
3,827,9406,3578721448,3578721492,44
3,827,9407,3578721448,3578721493,45
3,827,9408,3578721448,3578721497,49
3,827,9409,3578721448,3578721498,50
3,828,9410,3578721504,3578721504,0
3,828,9411,3578721504,3578721504,0
3,828,9412,3578721504,3578721504,0
3,828,9413,3578721504,3578721504,0
3,828,9414,3578721504,3578721504,0
3,828,9415,3578721504,3578721504,0
3,828,9416,3578721504,3578721508,4
3,828,9417,3578721504,3578721515,11
3,828,9418,3578721504,3578721515,11
3,828,9419,3578721504,3578721518,14
3,828,9420,3578721504,3578721518,14
3,828,9421,3578721504,3578721520,16
3,828,9422,3578721504,3578721521,17
3,828,9423,3578721504,3578721526,22
3,828,9424,3578721504,3578721535,31
3,828,9425,3578721504,3578721536,32
3,828,9426,3578721504,3578721537,33
3,828,9427,3578721504,3578721537,33
3,828,9428,3578721504,3578721538,34
3,828,9429,3578721504,3578721538,34
3,828,9430,3578721504,3578721539,35
3,828,9431,3578721504,3578721544,40
3,828,9432,3578721504,3578721545,41
3,828,9433,3578721504,3578721546,42
3,828,9434,3578721504,3578721547,43
3,828,9435,3578721504,3578721549,45
3,828,9436,3578721504,3578721552,48
3,828,9437,3578721504,3578721553,49
3,828,9438,3578721504,3578721553,49
3,828,9439,3578721504,3578721553,49
3,828,9440,3578721504,3578721554,50
3,829,9441,3578721560,3578721560,0
3,829,9442,3578721560,3578721560,0
3,829,9443,3578721560,3578721560,0
3,829,9444,3578721560,3578721563,3
3,829,9445,3578721560,3578721564,4
3,829,9446,3578721560,3578721567,7
3,829,9447,3578721560,3578721567,7
3,829,9448,3578721560,3578721571,11
3,829,9449,3578721560,3578721571,11
3,829,9450,3578721560,3578721574,14
3,829,9451,3578721560,3578721574,14
3,829,9452,3578721560,3578721575,15
3,829,9453,3578721560,3578721575,15
3,829,9454,3578721560,3578721576,16
3,829,9455,3578721560,3578721578,18
3,829,9456,3578721560,3578721578,18
3,829,9457,3578721560,3578721582,22
3,829,9458,3578721560,3578721583,23
3,829,9459,3578721560,3578721583,23
3,829,9460,3578721560,3578721584,24
3,829,9461,3578721560,3578721584,24
3,829,9462,3578721560,3578721586,26
3,829,9463,3578721560,3578721587,27
3,829,9464,3578721560,3578721587,27
3,829,9465,3578721560,3578721588,28
3,829,9466,3578721560,3578721589,29
3,829,9467,3578721560,3578721590,30
3,829,9468,3578721560,3578721592,32
3,829,9469,3578721560,3578721600,40
3,829,9470,3578721560,3578721601,41
3,829,9471,3578721560,3578721603,43
3,829,9472,3578721560,3578721603,43
3,829,9473,3578721560,3578721605,45
3,829,9474,3578721560,3578721605,45
3,829,9475,3578721560,3578721605,45
3,829,9476,3578721560,3578721606,46
3,829,9477,3578721560,3578721608,48
3,829,9478,3578721560,3578721609,49
3,830,9479,3578721615,3578721615,0
3,830,9480,3578721615,3578721615,0
3,830,9481,3578721615,3578721615,0
3,830,9482,3578721615,3578721615,0
3,830,9483,3578721615,3578721616,1
3,830,9484,3578721615,3578721617,2
3,830,9485,3578721615,3578721618,3
3,830,9486,3578721615,3578721620,5
3,830,9487,3578721615,3578721622,7
3,830,9488,3578721615,3578721623,8
3,830,9489,3578721615,3578721625,10
3,830,9490,3578721615,3578721626,11
3,830,9491,3578721615,3578721626,11
3,830,9492,3578721615,3578721626,11
3,830,9493,3578721615,3578721627,12
3,830,9494,3578721615,3578721631,16
3,830,9495,3578721615,3578721631,16
3,830,9496,3578721615,3578721635,20
3,830,9497,3578721615,3578721639,24
3,830,9498,3578721615,3578721641,26
3,830,9499,3578721615,3578721643,28
3,830,9500,3578721615,3578721644,29
3,830,9501,3578721615,3578721645,30
3,830,9502,3578721615,3578721646,31
3,830,9503,3578721615,3578721646,31
3,830,9504,3578721615,3578721652,37
3,830,9505,3578721615,3578721653,38
3,830,9506,3578721615,3578721653,38
3,830,9507,3578721615,3578721661,46
3,830,9508,3578721615,3578721661,46
3,830,9509,3578721615,3578721661,46
3,830,9510,3578721615,3578721662,47
3,830,9511,3578721615,3578721665,50
3,831,9512,3578721670,3578721670,0
3,831,9513,3578721670,3578721670,0
3,831,9514,3578721670,3578721670,0
3,831,9515,3578721670,3578721670,0
3,831,9516,3578721670,3578721670,0
3,831,9517,3578721670,3578721672,2
3,831,9518,3578721670,3578721678,8
3,831,9519,3578721670,3578721678,8
3,831,9520,3578721670,3578721678,8
3,831,9521,3578721670,3578721681,11
3,831,9522,3578721670,3578721682,12
3,831,9523,3578721670,3578721688,18
3,831,9524,3578721670,3578721688,18
3,831,9525,3578721670,3578721692,22
3,831,9526,3578721670,3578721693,23
3,831,9527,3578721670,3578721697,27
3,831,9528,3578721670,3578721698,28
3,831,9529,3578721670,3578721698,28
3,831,9530,3578721670,3578721699,29
3,831,9531,3578721670,3578721700,30
3,831,9532,3578721670,3578721700,30
3,831,9533,3578721670,3578721701,31
3,831,9534,3578721670,3578721703,33
3,831,9535,3578721670,3578721708,38
3,831,9536,3578721670,3578721715,45
3,831,9537,3578721670,3578721715,45
3,831,9538,3578721670,3578721718,48
3,831,9539,3578721670,3578721718,48
3,832,9540,3578721725,3578721725,0
3,832,9541,3578721725,3578721725,0
3,832,9542,3578721725,3578721727,2
3,832,9543,3578721725,3578721735,10
3,832,9544,3578721725,3578721736,11
3,832,9545,3578721725,3578721737,12
3,832,9546,3578721725,3578721737,12
3,832,9547,3578721725,3578721738,13
3,832,9548,3578721725,3578721739,14
3,832,9549,3578721725,3578721739,14
3,832,9550,3578721725,3578721740,15
3,832,9551,3578721725,3578721742,17
3,832,9552,3578721725,3578721745,20
3,832,9553,3578721725,3578721745,20
3,832,9554,3578721725,3578721747,22
3,832,9555,3578721725,3578721749,24
3,832,9556,3578721725,3578721753,28
3,832,9557,3578721725,3578721753,28
3,832,9558,3578721725,3578721753,28
3,832,9559,3578721725,3578721753,28
3,832,9560,3578721725,3578721754,29
3,832,9561,3578721725,3578721757,32
3,832,9562,3578721725,3578721757,32
3,832,9563,3578721725,3578721761,36
3,832,9564,3578721725,3578721762,37
3,832,9565,3578721725,3578721764,39
3,832,9566,3578721725,3578721767,42
3,832,9567,3578721725,3578721767,42
3,832,9568,3578721725,3578721771,46
3,832,9569,3578721725,3578721771,46
3,832,9570,3578721725,3578721774,49
3,832,9571,3578721725,3578721774,49
3,833,9572,3578721780,3578721780,0
3,833,9573,3578721780,3578721780,0
3,833,9574,3578721780,3578721780,0
3,833,9575,3578721780,3578721780,0
3,833,9576,3578721780,3578721780,0
3,833,9577,3578721780,3578721782,2
3,833,9578,3578721780,3578721783,3
3,833,9579,3578721780,3578721784,4
3,833,9580,3578721780,3578721784,4
3,833,9581,3578721780,3578721784,4
3,833,9582,3578721780,3578721786,6
3,833,9583,3578721780,3578721787,7
3,833,9584,3578721780,3578721787,7
3,833,9585,3578721780,3578721789,9
3,833,9586,3578721780,3578721790,10
3,833,9587,3578721780,3578721791,11
3,833,9588,3578721780,3578721792,12
3,833,9589,3578721780,3578721801,21
3,833,9590,3578721780,3578721801,21
3,833,9591,3578721780,3578721803,23
3,833,9592,3578721780,3578721803,23
3,833,9593,3578721780,3578721805,25
3,833,9594,3578721780,3578721805,25
3,833,9595,3578721780,3578721806,26
3,833,9596,3578721780,3578721807,27
3,833,9597,3578721780,3578721809,29
3,833,9598,3578721780,3578721813,33
3,833,9599,3578721780,3578721814,34
3,833,9600,3578721780,3578721816,36
3,833,9601,3578721780,3578721817,37
3,833,9602,3578721780,3578721818,38
3,833,9603,3578721780,3578721820,40
3,833,9604,3578721780,3578721821,41
3,833,9605,3578721780,3578721823,43
3,833,9606,3578721780,3578721825,45
3,833,9607,3578721780,3578721826,46
3,833,9608,3578721780,3578721826,46
3,833,9609,3578721780,3578721826,46
3,833,9610,3578721780,3578721827,47
3,834,9611,3578721835,3578721835,0
3,834,9612,3578721835,3578721835,0
3,834,9613,3578721835,3578721836,1
3,834,9614,3578721835,3578721839,4
3,834,9615,3578721835,3578721839,4
3,834,9616,3578721835,3578721841,6
3,834,9617,3578721835,3578721843,8
3,834,9618,3578721835,3578721844,9
3,834,9619,3578721835,3578721846,11
3,834,9620,3578721835,3578721846,11
3,834,9621,3578721835,3578721846,11
3,834,9622,3578721835,3578721849,14
3,834,9623,3578721835,3578721852,17
3,834,9624,3578721835,3578721854,19
3,834,9625,3578721835,3578721854,19
3,834,9626,3578721835,3578721861,26
3,834,9627,3578721835,3578721861,26
3,834,9628,3578721835,3578721862,27
3,834,9629,3578721835,3578721864,29
3,834,9630,3578721835,3578721864,29
3,834,9631,3578721835,3578721866,31
3,834,9632,3578721835,3578721869,34
3,834,9633,3578721835,3578721869,34
3,834,9634,3578721835,3578721869,34
3,834,9635,3578721835,3578721872,37
3,834,9636,3578721835,3578721878,43
3,834,9637,3578721835,3578721878,43
3,834,9638,3578721835,3578721878,43
3,834,9639,3578721835,3578721880,45
3,834,9640,3578721835,3578721880,45
3,834,9641,3578721835,3578721881,46
3,834,9642,3578721835,3578721882,47
3,835,9643,3578721891,3578721891,0
3,835,9644,3578721891,3578721891,0
3,835,9645,3578721891,3578721892,1
3,835,9646,3578721891,3578721893,2
3,835,9647,3578721891,3578721893,2
3,835,9648,3578721891,3578721897,6
3,835,9649,3578721891,3578721897,6
3,835,9650,3578721891,3578721899,8
3,835,9651,3578721891,3578721900,9
3,835,9652,3578721891,3578721900,9
3,835,9653,3578721891,3578721901,10
3,835,9654,3578721891,3578721901,10
3,835,9655,3578721891,3578721903,12
3,835,9656,3578721891,3578721908,17
3,835,9657,3578721891,3578721914,23
3,835,9658,3578721891,3578721915,24
3,835,9659,3578721891,3578721918,27
3,835,9660,3578721891,3578721919,28
3,835,9661,3578721891,3578721921,30
3,835,9662,3578721891,3578721921,30
3,835,9663,3578721891,3578721927,36
3,835,9664,3578721891,3578721935,44
3,835,9665,3578721891,3578721936,45
3,835,9666,3578721891,3578721937,46
3,835,9667,3578721891,3578721937,46
3,835,9668,3578721891,3578721938,47
3,835,9669,3578721891,3578721939,48
3,835,9670,3578721891,3578721939,48
3,835,9671,3578721891,3578721940,49
3,836,9672,3578721946,3578721946,0
3,836,9673,3578721946,3578721946,0
3,836,9674,3578721946,3578721948,2
3,836,9675,3578721946,3578721950,4
3,836,9676,3578721946,3578721953,7
3,836,9677,3578721946,3578721953,7
3,836,9678,3578721946,3578721953,7
3,836,9679,3578721946,3578721954,8
3,836,9680,3578721946,3578721956,10
3,836,9681,3578721946,3578721957,11
3,836,9682,3578721946,3578721961,15
3,836,9683,3578721946,3578721963,17
3,836,9684,3578721946,3578721964,18
3,836,9685,3578721946,3578721968,22
3,836,9686,3578721946,3578721968,22
3,836,9687,3578721946,3578721970,24
3,836,9688,3578721946,3578721972,26
3,836,9689,3578721946,3578721974,28
3,836,9690,3578721946,3578721974,28
3,836,9691,3578721946,3578721975,29
3,836,9692,3578721946,3578721975,29
3,836,9693,3578721946,3578721975,29
3,836,9694,3578721946,3578721976,30
3,836,9695,3578721946,3578721979,33
3,836,9696,3578721946,3578721979,33
3,836,9697,3578721946,3578721982,36
3,836,9698,3578721946,3578721983,37
3,836,9699,3578721946,3578721984,38
3,836,9700,3578721946,3578721984,38
3,836,9701,3578721946,3578721985,39
3,836,9702,3578721946,3578721987,41
3,836,9703,3578721946,3578721988,42
3,836,9704,3578721946,3578721988,42
3,836,9705,3578721946,3578721989,43
3,836,9706,3578721946,3578721990,44
3,837,9707,3578722002,3578722002,0
3,837,9708,3578722002,3578722002,0
3,837,9709,3578722002,3578722002,0
3,837,9710,3578722002,3578722003,1
3,837,9711,3578722002,3578722004,2
3,837,9712,3578722002,3578722005,3
3,837,9713,3578722002,3578722005,3
3,837,9714,3578722002,3578722007,5
3,837,9715,3578722002,3578722007,5
3,837,9716,3578722002,3578722009,7
3,837,9717,3578722002,3578722013,11
3,837,9718,3578722002,3578722014,12
3,837,9719,3578722002,3578722014,12
3,837,9720,3578722002,3578722017,15
3,837,9721,3578722002,3578722017,15
3,837,9722,3578722002,3578722018,16
3,837,9723,3578722002,3578722021,19
3,837,9724,3578722002,3578722023,21
3,837,9725,3578722002,3578722026,24
3,837,9726,3578722002,3578722026,24
3,837,9727,3578722002,3578722026,24
3,837,9728,3578722002,3578722026,24
3,837,9729,3578722002,3578722027,25
3,837,9730,3578722002,3578722031,29
3,837,9731,3578722002,3578722035,33
3,837,9732,3578722002,3578722036,34
3,837,9733,3578722002,3578722039,37
3,837,9734,3578722002,3578722040,38
3,837,9735,3578722002,3578722044,42
3,837,9736,3578722002,3578722044,42
3,837,9737,3578722002,3578722045,43
3,837,9738,3578722002,3578722045,43
3,837,9739,3578722002,3578722047,45
3,837,9740,3578722002,3578722052,50
3,838,9741,3578722057,3578722057,0
3,838,9742,3578722057,3578722057,0
3,838,9743,3578722057,3578722061,4
3,838,9744,3578722057,3578722061,4
3,838,9745,3578722057,3578722062,5
3,838,9746,3578722057,3578722065,8
3,838,9747,3578722057,3578722065,8
3,838,9748,3578722057,3578722066,9
3,838,9749,3578722057,3578722069,12
3,838,9750,3578722057,3578722069,12
3,838,9751,3578722057,3578722069,12
3,838,9752,3578722057,3578722072,15
3,838,9753,3578722057,3578722078,21
3,838,9754,3578722057,3578722078,21
3,838,9755,3578722057,3578722079,22
3,838,9756,3578722057,3578722079,22
3,838,9757,3578722057,3578722079,22
3,838,9758,3578722057,3578722082,25
3,838,9759,3578722057,3578722082,25
3,838,9760,3578722057,3578722088,31
3,838,9761,3578722057,3578722088,31
3,838,9762,3578722057,3578722092,35
3,838,9763,3578722057,3578722093,36
3,838,9764,3578722057,3578722093,36
3,838,9765,3578722057,3578722097,40
3,838,9766,3578722057,3578722098,41
3,838,9767,3578722057,3578722099,42
3,838,9768,3578722057,3578722100,43
3,838,9769,3578722057,3578722100,43
3,838,9770,3578722057,3578722100,43
3,838,9771,3578722057,3578722101,44
3,838,9772,3578722057,3578722102,45
3,839,9773,3578722113,3578722113,0
3,839,9774,3578722113,3578722114,1
3,839,9775,3578722113,3578722116,3
3,839,9776,3578722113,3578722118,5
3,839,9777,3578722113,3578722119,6
3,839,9778,3578722113,3578722120,7
3,839,9779,3578722113,3578722121,8
3,839,9780,3578722113,3578722126,13
3,839,9781,3578722113,3578722136,23
3,839,9782,3578722113,3578722136,23
3,839,9783,3578722113,3578722137,24
3,839,9784,3578722113,3578722138,25
3,839,9785,3578722113,3578722138,25
3,839,9786,3578722113,3578722139,26
3,839,9787,3578722113,3578722139,26
3,839,9788,3578722113,3578722139,26
3,839,9789,3578722113,3578722142,29
3,839,9790,3578722113,3578722144,31
3,839,9791,3578722113,3578722146,33
3,839,9792,3578722113,3578722146,33
3,839,9793,3578722113,3578722149,36
3,839,9794,3578722113,3578722150,37
3,839,9795,3578722113,3578722153,40
3,839,9796,3578722113,3578722153,40
3,839,9797,3578722113,3578722153,40
3,839,9798,3578722113,3578722154,41
3,839,9799,3578722113,3578722154,41
3,839,9800,3578722113,3578722157,44
3,839,9801,3578722113,3578722161,48
3,839,9802,3578722113,3578722163,50
3,840,9803,3578722168,3578722168,0
3,840,9804,3578722168,3578722168,0
3,840,9805,3578722168,3578722168,0
3,840,9806,3578722168,3578722170,2
3,840,9807,3578722168,3578722172,4
3,840,9808,3578722168,3578722173,5
3,840,9809,3578722168,3578722174,6
3,840,9810,3578722168,3578722175,7
3,840,9811,3578722168,3578722176,8
3,840,9812,3578722168,3578722177,9
3,840,9813,3578722168,3578722177,9
3,840,9814,3578722168,3578722178,10
3,840,9815,3578722168,3578722180,12
3,840,9816,3578722168,3578722182,14
3,840,9817,3578722168,3578722183,15
3,840,9818,3578722168,3578722184,16
3,840,9819,3578722168,3578722184,16
3,840,9820,3578722168,3578722185,17
3,840,9821,3578722168,3578722187,19
3,840,9822,3578722168,3578722187,19
3,840,9823,3578722168,3578722189,21
3,840,9824,3578722168,3578722189,21
3,840,9825,3578722168,3578722191,23
3,840,9826,3578722168,3578722192,24
3,840,9827,3578722168,3578722201,33
3,840,9828,3578722168,3578722203,35
3,840,9829,3578722168,3578722203,35
3,840,9830,3578722168,3578722204,36
3,840,9831,3578722168,3578722205,37
3,840,9832,3578722168,3578722206,38
3,840,9833,3578722168,3578722206,38
3,840,9834,3578722168,3578722208,40
3,840,9835,3578722168,3578722209,41
3,840,9836,3578722168,3578722214,46
3,840,9837,3578722168,3578722214,46
3,840,9838,3578722168,3578722217,49
3,840,9839,3578722168,3578722217,49
3,841,9840,3578722224,3578722224,0
3,841,9841,3578722224,3578722224,0
3,841,9842,3578722224,3578722224,0
3,841,9843,3578722224,3578722224,0
3,841,9844,3578722224,3578722225,1
3,841,9845,3578722224,3578722226,2
3,841,9846,3578722224,3578722226,2
3,841,9847,3578722224,3578722227,3
3,841,9848,3578722224,3578722229,5
3,841,9849,3578722224,3578722233,9
3,841,9850,3578722224,3578722235,11
3,841,9851,3578722224,3578722236,12
3,841,9852,3578722224,3578722239,15
3,841,9853,3578722224,3578722240,16
3,841,9854,3578722224,3578722241,17
3,841,9855,3578722224,3578722244,20
3,841,9856,3578722224,3578722244,20
3,841,9857,3578722224,3578722246,22
3,841,9858,3578722224,3578722246,22
3,841,9859,3578722224,3578722247,23
3,841,9860,3578722224,3578722251,27
3,841,9861,3578722224,3578722253,29
3,841,9862,3578722224,3578722254,30
3,841,9863,3578722224,3578722256,32
3,841,9864,3578722224,3578722260,36
3,841,9865,3578722224,3578722262,38
3,841,9866,3578722224,3578722262,38
3,841,9867,3578722224,3578722264,40
3,841,9868,3578722224,3578722265,41
3,841,9869,3578722224,3578722266,42
3,841,9870,3578722224,3578722269,45
3,841,9871,3578722224,3578722270,46
3,841,9872,3578722224,3578722273,49
3,842,9873,3578722280,3578722280,0
3,842,9874,3578722280,3578722280,0
3,842,9875,3578722280,3578722280,0
3,842,9876,3578722280,3578722280,0
3,842,9877,3578722280,3578722281,1
3,842,9878,3578722280,3578722281,1
3,842,9879,3578722280,3578722282,2
3,842,9880,3578722280,3578722288,8
3,842,9881,3578722280,3578722289,9
3,842,9882,3578722280,3578722292,12
3,842,9883,3578722280,3578722293,13
3,842,9884,3578722280,3578722294,14
3,842,9885,3578722280,3578722297,17
3,842,9886,3578722280,3578722299,19
3,842,9887,3578722280,3578722299,19
3,842,9888,3578722280,3578722300,20
3,842,9889,3578722280,3578722300,20
3,842,9890,3578722280,3578722300,20
3,842,9891,3578722280,3578722301,21
3,842,9892,3578722280,3578722304,24
3,842,9893,3578722280,3578722310,30
3,842,9894,3578722280,3578722314,34
3,842,9895,3578722280,3578722315,35
3,842,9896,3578722280,3578722318,38
3,842,9897,3578722280,3578722319,39
3,842,9898,3578722280,3578722320,40
3,842,9899,3578722280,3578722321,41
3,842,9900,3578722280,3578722326,46
3,843,9901,3578722336,3578722336,0
3,843,9902,3578722336,3578722336,0
3,843,9903,3578722336,3578722338,2
3,843,9904,3578722336,3578722338,2
3,843,9905,3578722336,3578722339,3
3,843,9906,3578722336,3578722339,3
3,843,9907,3578722336,3578722339,3
3,843,9908,3578722336,3578722341,5
3,843,9909,3578722336,3578722346,10
3,843,9910,3578722336,3578722346,10
3,843,9911,3578722336,3578722346,10
3,843,9912,3578722336,3578722348,12
3,843,9913,3578722336,3578722350,14
3,843,9914,3578722336,3578722351,15
3,843,9915,3578722336,3578722353,17
3,843,9916,3578722336,3578722353,17
3,843,9917,3578722336,3578722354,18
3,843,9918,3578722336,3578722354,18
3,843,9919,3578722336,3578722354,18
3,843,9920,3578722336,3578722357,21
3,843,9921,3578722336,3578722361,25
3,843,9922,3578722336,3578722364,28
3,843,9923,3578722336,3578722364,28
3,843,9924,3578722336,3578722368,32
3,843,9925,3578722336,3578722370,34
3,843,9926,3578722336,3578722372,36
3,843,9927,3578722336,3578722373,37
3,843,9928,3578722336,3578722374,38
3,843,9929,3578722336,3578722375,39
3,843,9930,3578722336,3578722377,41
3,843,9931,3578722336,3578722377,41
3,843,9932,3578722336,3578722378,42
3,843,9933,3578722336,3578722379,43
3,843,9934,3578722336,3578722380,44
3,843,9935,3578722336,3578722382,46
3,843,9936,3578722336,3578722383,47
3,843,9937,3578722336,3578722384,48
3,843,9938,3578722336,3578722384,48
3,843,9939,3578722336,3578722385,49
3,844,9940,3578722392,3578722392,0
3,844,9941,3578722392,3578722392,0
3,844,9942,3578722392,3578722392,0
3,844,9943,3578722392,3578722392,0
3,844,9944,3578722392,3578722392,0
3,844,9945,3578722392,3578722392,0
3,844,9946,3578722392,3578722402,10
3,844,9947,3578722392,3578722402,10
3,844,9948,3578722392,3578722403,11
3,844,9949,3578722392,3578722404,12
3,844,9950,3578722392,3578722404,12
3,844,9951,3578722392,3578722404,12
3,844,9952,3578722392,3578722405,13
3,844,9953,3578722392,3578722405,13
3,844,9954,3578722392,3578722406,14
3,844,9955,3578722392,3578722407,15
3,844,9956,3578722392,3578722407,15
3,844,9957,3578722392,3578722409,17
3,844,9958,3578722392,3578722414,22
3,844,9959,3578722392,3578722414,22
3,844,9960,3578722392,3578722417,25
3,844,9961,3578722392,3578722417,25
3,844,9962,3578722392,3578722417,25
3,844,9963,3578722392,3578722419,27
3,844,9964,3578722392,3578722421,29
3,844,9965,3578722392,3578722422,30
3,844,9966,3578722392,3578722424,32
3,844,9967,3578722392,3578722426,34
3,844,9968,3578722392,3578722427,35
3,844,9969,3578722392,3578722427,35
3,844,9970,3578722392,3578722434,42
3,844,9971,3578722392,3578722435,43
3,844,9972,3578722392,3578722436,44
3,844,9973,3578722392,3578722439,47
3,845,9974,3578722447,3578722447,0
3,845,9975,3578722447,3578722447,0
3,845,9976,3578722447,3578722447,0
3,845,9977,3578722447,3578722447,0
3,845,9978,3578722447,3578722448,1
3,845,9979,3578722447,3578722450,3
3,845,9980,3578722447,3578722452,5
3,845,9981,3578722447,3578722454,7
3,845,9982,3578722447,3578722456,9
3,845,9983,3578722447,3578722461,14
3,845,9984,3578722447,3578722462,15
3,845,9985,3578722447,3578722462,15
3,845,9986,3578722447,3578722465,18
3,845,9987,3578722447,3578722465,18
3,845,9988,3578722447,3578722467,20
3,845,9989,3578722447,3578722469,22
3,845,9990,3578722447,3578722470,23
3,845,9991,3578722447,3578722471,24
3,845,9992,3578722447,3578722471,24
3,845,9993,3578722447,3578722472,25
3,845,9994,3578722447,3578722478,31
3,845,9995,3578722447,3578722478,31
3,845,9996,3578722447,3578722479,32
3,845,9997,3578722447,3578722480,33
3,845,9998,3578722447,3578722481,34
3,845,9999,3578722447,3578722481,34
3,845,10000,3578722447,3578722483,36
3,845,10001,3578722447,3578722488,41
3,845,10002,3578722447,3578722488,41
3,845,10003,3578722447,3578722491,44
3,845,10004,3578722447,3578722493,46
3,845,10005,3578722447,3578722494,47
3,846,10006,3578722502,3578722502,0
3,846,10007,3578722502,3578722502,0
3,846,10008,3578722502,3578722502,0
3,846,10009,3578722502,3578722502,0
3,846,10010,3578722502,3578722502,0
3,846,10011,3578722502,3578722502,0
3,846,10012,3578722502,3578722502,0
3,846,10013,3578722502,3578722503,1
3,846,10014,3578722502,3578722509,7
3,846,10015,3578722502,3578722514,12
3,846,10016,3578722502,3578722515,13
3,846,10017,3578722502,3578722517,15
3,846,10018,3578722502,3578722518,16
3,846,10019,3578722502,3578722519,17
3,846,10020,3578722502,3578722520,18
3,846,10021,3578722502,3578722526,24
3,846,10022,3578722502,3578722535,33
3,846,10023,3578722502,3578722535,33
3,846,10024,3578722502,3578722537,35
3,846,10025,3578722502,3578722537,35
3,846,10026,3578722502,3578722538,36
3,846,10027,3578722502,3578722538,36
3,846,10028,3578722502,3578722538,36
3,846,10029,3578722502,3578722540,38
3,846,10030,3578722502,3578722542,40
3,846,10031,3578722502,3578722545,43
3,846,10032,3578722502,3578722545,43
3,846,10033,3578722502,3578722546,44
3,846,10034,3578722502,3578722547,45
3,846,10035,3578722502,3578722549,47
3,846,10036,3578722502,3578722550,48
3,847,10037,3578722558,3578722558,0
3,847,10038,3578722558,3578722558,0
3,847,10039,3578722558,3578722558,0
3,847,10040,3578722558,3578722558,0
3,847,10041,3578722558,3578722558,0
3,847,10042,3578722558,3578722560,2
3,847,10043,3578722558,3578722562,4
3,847,10044,3578722558,3578722563,5
3,847,10045,3578722558,3578722567,9
3,847,10046,3578722558,3578722567,9
3,847,10047,3578722558,3578722570,12
3,847,10048,3578722558,3578722571,13
3,847,10049,3578722558,3578722572,14
3,847,10050,3578722558,3578722573,15
3,847,10051,3578722558,3578722574,16
3,847,10052,3578722558,3578722575,17
3,847,10053,3578722558,3578722576,18
3,847,10054,3578722558,3578722577,19
3,847,10055,3578722558,3578722578,20
3,847,10056,3578722558,3578722579,21
3,847,10057,3578722558,3578722582,24
3,847,10058,3578722558,3578722583,25
3,847,10059,3578722558,3578722583,25
3,847,10060,3578722558,3578722583,25
3,847,10061,3578722558,3578722584,26
3,847,10062,3578722558,3578722585,27
3,847,10063,3578722558,3578722585,27
3,847,10064,3578722558,3578722586,28
3,847,10065,3578722558,3578722588,30
3,847,10066,3578722558,3578722588,30
3,847,10067,3578722558,3578722591,33
3,847,10068,3578722558,3578722591,33
3,847,10069,3578722558,3578722592,34
3,847,10070,3578722558,3578722600,42
3,847,10071,3578722558,3578722601,43
3,847,10072,3578722558,3578722603,45
3,847,10073,3578722558,3578722603,45
3,847,10074,3578722558,3578722604,46
3,847,10075,3578722558,3578722604,46
3,847,10076,3578722558,3578722604,46
3,847,10077,3578722558,3578722605,47
3,847,10078,3578722558,3578722607,49
3,847,10079,3578722558,3578722607,49
3,847,10080,3578722558,3578722608,50
3,848,10081,3578722614,3578722614,0
3,848,10082,3578722614,3578722616,2
3,848,10083,3578722614,3578722617,3
3,848,10084,3578722614,3578722618,4
3,848,10085,3578722614,3578722620,6
3,848,10086,3578722614,3578722621,7
3,848,10087,3578722614,3578722623,9
3,848,10088,3578722614,3578722625,11
3,848,10089,3578722614,3578722625,11
3,848,10090,3578722614,3578722626,12
3,848,10091,3578722614,3578722626,12
3,848,10092,3578722614,3578722632,18
3,848,10093,3578722614,3578722632,18
3,848,10094,3578722614,3578722634,20
3,848,10095,3578722614,3578722635,21
3,848,10096,3578722614,3578722638,24
3,848,10097,3578722614,3578722639,25
3,848,10098,3578722614,3578722640,26
3,848,10099,3578722614,3578722643,29
3,848,10100,3578722614,3578722645,31
3,848,10101,3578722614,3578722646,32
3,848,10102,3578722614,3578722648,34
3,848,10103,3578722614,3578722650,36
3,848,10104,3578722614,3578722652,38
3,848,10105,3578722614,3578722653,39
3,848,10106,3578722614,3578722656,42
3,848,10107,3578722614,3578722660,46
3,848,10108,3578722614,3578722660,46
3,848,10109,3578722614,3578722661,47
3,848,10110,3578722614,3578722663,49
3,848,10111,3578722614,3578722664,50
3,849,10112,3578722669,3578722669,0
3,849,10113,3578722669,3578722669,0
3,849,10114,3578722669,3578722669,0
3,849,10115,3578722669,3578722669,0
3,849,10116,3578722669,3578722672,3
3,849,10117,3578722669,3578722678,9
3,849,10118,3578722669,3578722679,10
3,849,10119,3578722669,3578722679,10
3,849,10120,3578722669,3578722680,11
3,849,10121,3578722669,3578722681,12
3,849,10122,3578722669,3578722681,12
3,849,10123,3578722669,3578722682,13
3,849,10124,3578722669,3578722683,14
3,849,10125,3578722669,3578722688,19
3,849,10126,3578722669,3578722689,20
3,849,10127,3578722669,3578722691,22
3,849,10128,3578722669,3578722693,24
3,849,10129,3578722669,3578722694,25
3,849,10130,3578722669,3578722697,28
3,849,10131,3578722669,3578722699,30
3,849,10132,3578722669,3578722700,31
3,849,10133,3578722669,3578722700,31
3,849,10134,3578722669,3578722700,31
3,849,10135,3578722669,3578722700,31
3,849,10136,3578722669,3578722700,31
3,849,10137,3578722669,3578722703,34
3,849,10138,3578722669,3578722709,40
3,849,10139,3578722669,3578722714,45
3,849,10140,3578722669,3578722714,45
3,849,10141,3578722669,3578722717,48
3,849,10142,3578722669,3578722718,49
3,850,10143,3578722725,3578722725,0
3,850,10144,3578722725,3578722725,0
3,850,10145,3578722725,3578722725,0
3,850,10146,3578722725,3578722735,10
3,850,10147,3578722725,3578722735,10
3,850,10148,3578722725,3578722736,11
3,850,10149,3578722725,3578722736,11
3,850,10150,3578722725,3578722737,12
3,850,10151,3578722725,3578722738,13
3,850,10152,3578722725,3578722738,13
3,850,10153,3578722725,3578722739,14
3,850,10154,3578722725,3578722740,15
3,850,10155,3578722725,3578722744,19
3,850,10156,3578722725,3578722745,20
3,850,10157,3578722725,3578722746,21
3,850,10158,3578722725,3578722748,23
3,850,10159,3578722725,3578722749,24
3,850,10160,3578722725,3578722750,25
3,850,10161,3578722725,3578722753,28
3,850,10162,3578722725,3578722753,28
3,850,10163,3578722725,3578722753,28
3,850,10164,3578722725,3578722754,29
3,850,10165,3578722725,3578722756,31
3,850,10166,3578722725,3578722757,32
3,850,10167,3578722725,3578722760,35
3,850,10168,3578722725,3578722762,37
3,850,10169,3578722725,3578722763,38
3,850,10170,3578722725,3578722768,43
3,850,10171,3578722725,3578722768,43
3,850,10172,3578722725,3578722771,46
3,850,10173,3578722725,3578722771,46
3,850,10174,3578722725,3578722774,49
3,850,10175,3578722725,3578722774,49
3,850,10176,3578722725,3578722774,49
3,851,10177,3578722782,3578722782,0
3,851,10178,3578722782,3578722782,0
3,851,10179,3578722782,3578722782,0
3,851,10180,3578722782,3578722782,0
3,851,10181,3578722782,3578722783,1
3,851,10182,3578722782,3578722783,1
3,851,10183,3578722782,3578722783,1
3,851,10184,3578722782,3578722783,1
3,851,10185,3578722782,3578722784,2
3,851,10186,3578722782,3578722785,3
3,851,10187,3578722782,3578722785,3
3,851,10188,3578722782,3578722786,4
3,851,10189,3578722782,3578722786,4
3,851,10190,3578722782,3578722787,5
3,851,10191,3578722782,3578722789,7
3,851,10192,3578722782,3578722791,9
3,851,10193,3578722782,3578722792,10
3,851,10194,3578722782,3578722800,18
3,851,10195,3578722782,3578722802,20
3,851,10196,3578722782,3578722803,21
3,851,10197,3578722782,3578722803,21
3,851,10198,3578722782,3578722804,22
3,851,10199,3578722782,3578722804,22
3,851,10200,3578722782,3578722804,22
3,851,10201,3578722782,3578722805,23
3,851,10202,3578722782,3578722806,24
3,851,10203,3578722782,3578722807,25
3,851,10204,3578722782,3578722808,26
3,851,10205,3578722782,3578722812,30
3,851,10206,3578722782,3578722813,31
3,851,10207,3578722782,3578722813,31
3,851,10208,3578722782,3578722816,34
3,851,10209,3578722782,3578722817,35
3,851,10210,3578722782,3578722819,37
3,851,10211,3578722782,3578722820,38
3,851,10212,3578722782,3578722821,39
3,851,10213,3578722782,3578722824,42
3,851,10214,3578722782,3578722825,43
3,851,10215,3578722782,3578722826,44
3,851,10216,3578722782,3578722826,44
3,851,10217,3578722782,3578722826,44
3,851,10218,3578722782,3578722828,46
3,851,10219,3578722782,3578722831,49
3,852,10220,3578722838,3578722838,0
3,852,10221,3578722838,3578722838,0
3,852,10222,3578722838,3578722838,0
3,852,10223,3578722838,3578722839,1
3,852,10224,3578722838,3578722841,3
3,852,10225,3578722838,3578722844,6
3,852,10226,3578722838,3578722844,6
3,852,10227,3578722838,3578722846,8
3,852,10228,3578722838,3578722848,10
3,852,10229,3578722838,3578722850,12
3,852,10230,3578722838,3578722853,15
3,852,10231,3578722838,3578722853,15
3,852,10232,3578722838,3578722857,19
3,852,10233,3578722838,3578722860,22
3,852,10234,3578722838,3578722861,23
3,852,10235,3578722838,3578722861,23
3,852,10236,3578722838,3578722863,25
3,852,10237,3578722838,3578722864,26
3,852,10238,3578722838,3578722865,27
3,852,10239,3578722838,3578722869,31
3,852,10240,3578722838,3578722869,31
3,852,10241,3578722838,3578722869,31
3,852,10242,3578722838,3578722873,35
3,852,10243,3578722838,3578722878,40
3,852,10244,3578722838,3578722879,41
3,852,10245,3578722838,3578722880,42
3,852,10246,3578722838,3578722880,42
3,852,10247,3578722838,3578722881,43
3,852,10248,3578722838,3578722881,43
3,852,10249,3578722838,3578722881,43
3,852,10250,3578722838,3578722883,45
3,852,10251,3578722838,3578722887,49
3,853,10252,3578722894,3578722894,0
3,853,10253,3578722894,3578722894,0
3,853,10254,3578722894,3578722894,0
3,853,10255,3578722894,3578722894,0
3,853,10256,3578722894,3578722897,3
3,853,10257,3578722894,3578722899,5
3,853,10258,3578722894,3578722900,6
3,853,10259,3578722894,3578722900,6
3,853,10260,3578722894,3578722900,6
3,853,10261,3578722894,3578722900,6
3,853,10262,3578722894,3578722901,7
3,853,10263,3578722894,3578722903,9
3,853,10264,3578722894,3578722909,15
3,853,10265,3578722894,3578722913,19
3,853,10266,3578722894,3578722914,20
3,853,10267,3578722894,3578722917,23
3,853,10268,3578722894,3578722918,24
3,853,10269,3578722894,3578722921,27
3,853,10270,3578722894,3578722921,27
3,853,10271,3578722894,3578722925,31
3,853,10272,3578722894,3578722935,41
3,853,10273,3578722894,3578722936,42
3,853,10274,3578722894,3578722936,42
3,853,10275,3578722894,3578722937,43
3,853,10276,3578722894,3578722937,43
3,853,10277,3578722894,3578722938,44
3,853,10278,3578722894,3578722938,44
3,853,10279,3578722894,3578722939,45
3,853,10280,3578722894,3578722940,46
3,853,10281,3578722894,3578722942,48
3,854,10282,3578722950,3578722950,0
3,854,10283,3578722950,3578722950,0
3,854,10284,3578722950,3578722950,0
3,854,10285,3578722950,3578722950,0
3,854,10286,3578722950,3578722950,0
3,854,10287,3578722950,3578722950,0
3,854,10288,3578722950,3578722953,3
3,854,10289,3578722950,3578722953,3
3,854,10290,3578722950,3578722953,3
3,854,10291,3578722950,3578722954,4
3,854,10292,3578722950,3578722956,6
3,854,10293,3578722950,3578722957,7
3,854,10294,3578722950,3578722960,10
3,854,10295,3578722950,3578722963,13
3,854,10296,3578722950,3578722964,14
3,854,10297,3578722950,3578722967,17
3,854,10298,3578722950,3578722968,18
3,854,10299,3578722950,3578722971,21
3,854,10300,3578722950,3578722971,21
3,854,10301,3578722950,3578722974,24
3,854,10302,3578722950,3578722974,24
3,854,10303,3578722950,3578722974,24
3,854,10304,3578722950,3578722977,27
3,854,10305,3578722950,3578722978,28
3,854,10306,3578722950,3578722979,29
3,854,10307,3578722950,3578722980,30
3,854,10308,3578722950,3578722982,32
3,854,10309,3578722950,3578722983,33
3,854,10310,3578722950,3578722983,33
3,854,10311,3578722950,3578722984,34
3,854,10312,3578722950,3578722984,34
3,854,10313,3578722950,3578722986,36
3,854,10314,3578722950,3578722986,36
3,854,10315,3578722950,3578722986,36
3,854,10316,3578722950,3578722988,38
3,854,10317,3578722950,3578722989,39
3,854,10318,3578722950,3578722991,41
3,854,10319,3578722950,3578722991,41
3,854,10320,3578722950,3578722993,43
3,855,10321,3578723007,3578723007,0
3,855,10322,3578723007,3578723007,0
3,855,10323,3578723007,3578723007,0
3,855,10324,3578723007,3578723007,0
3,855,10325,3578723007,3578723007,0
3,855,10326,3578723007,3578723007,0
3,855,10327,3578723007,3578723007,0
3,855,10328,3578723007,3578723007,0
3,855,10329,3578723007,3578723007,0
3,855,10330,3578723007,3578723007,0
3,855,10331,3578723007,3578723008,1
3,855,10332,3578723007,3578723008,1
3,855,10333,3578723007,3578723013,6
3,855,10334,3578723007,3578723014,7
3,855,10335,3578723007,3578723014,7
3,855,10336,3578723007,3578723017,10
3,855,10337,3578723007,3578723017,10
3,855,10338,3578723007,3578723018,11
3,855,10339,3578723007,3578723019,12
3,855,10340,3578723007,3578723021,14
3,855,10341,3578723007,3578723021,14
3,855,10342,3578723007,3578723023,16
3,855,10343,3578723007,3578723024,17
3,855,10344,3578723007,3578723025,18
3,855,10345,3578723007,3578723026,19
3,855,10346,3578723007,3578723026,19
3,855,10347,3578723007,3578723026,19
3,855,10348,3578723007,3578723031,24
3,855,10349,3578723007,3578723032,25
3,855,10350,3578723007,3578723034,27
3,855,10351,3578723007,3578723035,28
3,855,10352,3578723007,3578723039,32
3,855,10353,3578723007,3578723040,33
3,855,10354,3578723007,3578723041,34
3,855,10355,3578723007,3578723043,36
3,855,10356,3578723007,3578723044,37
3,855,10357,3578723007,3578723044,37
3,855,10358,3578723007,3578723046,39
3,855,10359,3578723007,3578723048,41
3,855,10360,3578723007,3578723050,43
3,855,10361,3578723007,3578723053,46
3,855,10362,3578723007,3578723054,47
3,856,10363,3578723063,3578723063,0
3,856,10364,3578723063,3578723063,0
3,856,10365,3578723063,3578723063,0
3,856,10366,3578723063,3578723063,0
3,856,10367,3578723063,3578723065,2
3,856,10368,3578723063,3578723065,2
3,856,10369,3578723063,3578723069,6
3,856,10370,3578723063,3578723069,6
3,856,10371,3578723063,3578723073,10
3,856,10372,3578723063,3578723078,15
3,856,10373,3578723063,3578723079,16
3,856,10374,3578723063,3578723080,17
3,856,10375,3578723063,3578723080,17
3,856,10376,3578723063,3578723081,18
3,856,10377,3578723063,3578723081,18
3,856,10378,3578723063,3578723082,19
3,856,10379,3578723063,3578723084,21
3,856,10380,3578723063,3578723088,25
3,856,10381,3578723063,3578723088,25
3,856,10382,3578723063,3578723091,28
3,856,10383,3578723063,3578723093,30
3,856,10384,3578723063,3578723094,31
3,856,10385,3578723063,3578723097,34
3,856,10386,3578723063,3578723100,37
3,856,10387,3578723063,3578723100,37
3,856,10388,3578723063,3578723100,37
3,856,10389,3578723063,3578723100,37
3,856,10390,3578723063,3578723101,38
3,856,10391,3578723063,3578723102,39
3,856,10392,3578723063,3578723103,40
3,856,10393,3578723063,3578723109,46
3,857,10394,3578723117,3578723117,0
3,857,10395,3578723117,3578723117,0
3,857,10396,3578723117,3578723117,0
3,857,10397,3578723117,3578723118,1
3,857,10398,3578723117,3578723121,4
3,857,10399,3578723117,3578723121,4
3,857,10400,3578723117,3578723126,9
3,857,10401,3578723117,3578723136,19
3,857,10402,3578723117,3578723136,19
3,857,10403,3578723117,3578723136,19
3,857,10404,3578723117,3578723138,21
3,857,10405,3578723117,3578723138,21
3,857,10406,3578723117,3578723138,21
3,857,10407,3578723117,3578723138,21
3,857,10408,3578723117,3578723139,22
3,857,10409,3578723117,3578723141,24
3,857,10410,3578723117,3578723145,28
3,857,10411,3578723117,3578723146,29
3,857,10412,3578723117,3578723147,30
3,857,10413,3578723117,3578723148,31
3,857,10414,3578723117,3578723150,33
3,857,10415,3578723117,3578723150,33
3,857,10416,3578723117,3578723152,35
3,857,10417,3578723117,3578723153,36
3,857,10418,3578723117,3578723153,36
3,857,10419,3578723117,3578723154,37
3,857,10420,3578723117,3578723154,37
3,857,10421,3578723117,3578723157,40
3,857,10422,3578723117,3578723157,40
3,857,10423,3578723117,3578723160,43
3,857,10424,3578723117,3578723163,46
3,857,10425,3578723117,3578723164,47
3,858,10426,3578723173,3578723173,0
3,858,10427,3578723173,3578723173,0
3,858,10428,3578723173,3578723173,0
3,858,10429,3578723173,3578723173,0
3,858,10430,3578723173,3578723174,1
3,858,10431,3578723173,3578723175,2
3,858,10432,3578723173,3578723176,3
3,858,10433,3578723173,3578723177,4
3,858,10434,3578723173,3578723178,5
3,858,10435,3578723173,3578723180,7
3,858,10436,3578723173,3578723182,9
3,858,10437,3578723173,3578723183,10
3,858,10438,3578723173,3578723184,11
3,858,10439,3578723173,3578723185,12
3,858,10440,3578723173,3578723186,13
3,858,10441,3578723173,3578723186,13
3,858,10442,3578723173,3578723187,14
3,858,10443,3578723173,3578723188,15
3,858,10444,3578723173,3578723189,16
3,858,10445,3578723173,3578723191,18
3,858,10446,3578723173,3578723193,20
3,858,10447,3578723173,3578723202,29
3,858,10448,3578723173,3578723202,29
3,858,10449,3578723173,3578723203,30
3,858,10450,3578723173,3578723204,31
3,858,10451,3578723173,3578723204,31
3,858,10452,3578723173,3578723204,31
3,858,10453,3578723173,3578723204,31
3,858,10454,3578723173,3578723205,32
3,858,10455,3578723173,3578723205,32
3,858,10456,3578723173,3578723207,34
3,858,10457,3578723173,3578723207,34
3,858,10458,3578723173,3578723208,35
3,858,10459,3578723173,3578723213,40
3,858,10460,3578723173,3578723214,41
3,858,10461,3578723173,3578723217,44
3,858,10462,3578723173,3578723217,44
3,858,10463,3578723173,3578723218,45
3,858,10464,3578723173,3578723219,46
3,858,10465,3578723173,3578723220,47
3,858,10466,3578723173,3578723221,48
3,858,10467,3578723173,3578723223,50
3,859,10468,3578723228,3578723228,0
3,859,10469,3578723228,3578723228,0
3,859,10470,3578723228,3578723228,0
3,859,10471,3578723228,3578723228,0
3,859,10472,3578723228,3578723231,3
3,859,10473,3578723228,3578723233,5
3,859,10474,3578723228,3578723234,6
3,859,10475,3578723228,3578723235,7
3,859,10476,3578723228,3578723239,11
3,859,10477,3578723228,3578723242,14
3,859,10478,3578723228,3578723244,16
3,859,10479,3578723228,3578723244,16
3,859,10480,3578723228,3578723245,17
3,859,10481,3578723228,3578723248,20
3,859,10482,3578723228,3578723251,23
3,859,10483,3578723228,3578723253,25
3,859,10484,3578723228,3578723255,27
3,859,10485,3578723228,3578723257,29
3,859,10486,3578723228,3578723260,32
3,859,10487,3578723228,3578723262,34
3,859,10488,3578723228,3578723264,36
3,859,10489,3578723228,3578723265,37
3,859,10490,3578723228,3578723265,37
3,859,10491,3578723228,3578723268,40
3,859,10492,3578723228,3578723269,41
3,859,10493,3578723228,3578723269,41
3,859,10494,3578723228,3578723269,41
3,859,10495,3578723228,3578723273,45
3,859,10496,3578723228,3578723278,50
3,860,10497,3578723284,3578723284,0
3,860,10498,3578723284,3578723284,0
3,860,10499,3578723284,3578723284,0
3,860,10500,3578723284,3578723284,0
3,860,10501,3578723284,3578723284,0
3,860,10502,3578723284,3578723284,0
3,860,10503,3578723284,3578723284,0
3,860,10504,3578723284,3578723288,4
3,860,10505,3578723284,3578723288,4
3,860,10506,3578723284,3578723292,8
3,860,10507,3578723284,3578723293,9
3,860,10508,3578723284,3578723294,10
3,860,10509,3578723284,3578723297,13
3,860,10510,3578723284,3578723300,16
3,860,10511,3578723284,3578723300,16
3,860,10512,3578723284,3578723300,16
3,860,10513,3578723284,3578723300,16
3,860,10514,3578723284,3578723301,17
3,860,10515,3578723284,3578723303,19
3,860,10516,3578723284,3578723304,20
3,860,10517,3578723284,3578723310,26
3,860,10518,3578723284,3578723313,29
3,860,10519,3578723284,3578723315,31
3,860,10520,3578723284,3578723318,34
3,860,10521,3578723284,3578723318,34
3,860,10522,3578723284,3578723320,36
3,860,10523,3578723284,3578723321,37
3,860,10524,3578723284,3578723326,42
3,861,10525,3578723339,3578723340,1
3,861,10526,3578723339,3578723340,1
3,861,10527,3578723339,3578723340,1
3,861,10528,3578723339,3578723340,1
3,861,10529,3578723339,3578723340,1
3,861,10530,3578723339,3578723340,1
3,861,10531,3578723339,3578723340,1
3,861,10532,3578723339,3578723340,1
3,861,10533,3578723339,3578723342,3
3,861,10534,3578723339,3578723342,3
3,861,10535,3578723339,3578723346,7
3,861,10536,3578723339,3578723346,7
3,861,10537,3578723339,3578723348,9
3,861,10538,3578723339,3578723349,10
3,861,10539,3578723339,3578723350,11
3,861,10540,3578723339,3578723352,13
3,861,10541,3578723339,3578723353,14
3,861,10542,3578723339,3578723354,15
3,861,10543,3578723339,3578723354,15
3,861,10544,3578723339,3578723355,16
3,861,10545,3578723339,3578723357,18
3,861,10546,3578723339,3578723357,18
3,861,10547,3578723339,3578723361,22
3,861,10548,3578723339,3578723364,25
3,861,10549,3578723339,3578723364,25
3,861,10550,3578723339,3578723368,29
3,861,10551,3578723339,3578723369,30
3,861,10552,3578723339,3578723369,30
3,861,10553,3578723339,3578723371,32
3,861,10554,3578723339,3578723371,32
3,861,10555,3578723339,3578723375,36
3,861,10556,3578723339,3578723375,36
3,861,10557,3578723339,3578723376,37
3,861,10558,3578723339,3578723377,38
3,861,10559,3578723339,3578723378,39
3,861,10560,3578723339,3578723381,42
3,861,10561,3578723339,3578723383,44
3,861,10562,3578723339,3578723384,45
3,861,10563,3578723339,3578723384,45
3,861,10564,3578723339,3578723385,46
3,861,10565,3578723339,3578723386,47
3,861,10566,3578723339,3578723386,47
3,861,10567,3578723339,3578723387,48
3,861,10568,3578723339,3578723387,48
3,861,10569,3578723339,3578723388,49
3,861,10570,3578723339,3578723388,49
3,862,10571,3578723398,3578723398,0
3,862,10572,3578723398,3578723398,0
3,862,10573,3578723398,3578723398,0
3,862,10574,3578723398,3578723401,3
3,862,10575,3578723398,3578723402,4
3,862,10576,3578723398,3578723404,6
3,862,10577,3578723398,3578723404,6
3,862,10578,3578723398,3578723404,6
3,862,10579,3578723398,3578723405,7
3,862,10580,3578723398,3578723405,7
3,862,10581,3578723398,3578723407,9
3,862,10582,3578723398,3578723407,9
3,862,10583,3578723398,3578723408,10
3,862,10584,3578723398,3578723413,15
3,862,10585,3578723398,3578723414,16
3,862,10586,3578723398,3578723417,19
3,862,10587,3578723398,3578723417,19
3,862,10588,3578723398,3578723418,20
3,862,10589,3578723398,3578723419,21
3,862,10590,3578723398,3578723421,23
3,862,10591,3578723398,3578723424,26
3,862,10592,3578723398,3578723428,30
3,862,10593,3578723398,3578723428,30
3,862,10594,3578723398,3578723432,34
3,862,10595,3578723398,3578723433,35
3,862,10596,3578723398,3578723434,36
3,862,10597,3578723398,3578723436,38
3,862,10598,3578723398,3578723439,41
3,862,10599,3578723398,3578723440,42
3,862,10600,3578723398,3578723442,44
3,862,10601,3578723398,3578723443,45
3,862,10602,3578723398,3578723443,45
3,862,10603,3578723398,3578723444,46
3,862,10604,3578723398,3578723446,48
3,863,10605,3578723453,3578723453,0
3,863,10606,3578723453,3578723453,0
3,863,10607,3578723453,3578723453,0
3,863,10608,3578723453,3578723457,4
3,863,10609,3578723453,3578723461,8
3,863,10610,3578723453,3578723463,10
3,863,10611,3578723453,3578723464,11
3,863,10612,3578723453,3578723465,12
3,863,10613,3578723453,3578723465,12
3,863,10614,3578723453,3578723469,16
3,863,10615,3578723453,3578723470,17
3,863,10616,3578723453,3578723470,17
3,863,10617,3578723453,3578723473,20
3,863,10618,3578723453,3578723478,25
3,863,10619,3578723453,3578723479,26
3,863,10620,3578723453,3578723480,27
3,863,10621,3578723453,3578723481,28
3,863,10622,3578723453,3578723482,29
3,863,10623,3578723453,3578723482,29
3,863,10624,3578723453,3578723487,34
3,863,10625,3578723453,3578723488,35
3,863,10626,3578723453,3578723492,39
3,863,10627,3578723453,3578723494,41
3,863,10628,3578723453,3578723494,41
3,863,10629,3578723453,3578723497,44
3,863,10630,3578723453,3578723500,47
3,863,10631,3578723453,3578723500,47
3,863,10632,3578723453,3578723500,47
3,863,10633,3578723453,3578723501,48
3,864,10634,3578723509,3578723509,0
3,864,10635,3578723509,3578723509,0
3,864,10636,3578723509,3578723510,1
3,864,10637,3578723509,3578723513,4
3,864,10638,3578723509,3578723514,5
3,864,10639,3578723509,3578723517,8
3,864,10640,3578723509,3578723517,8
3,864,10641,3578723509,3578723519,10
3,864,10642,3578723509,3578723520,11
3,864,10643,3578723509,3578723522,13
3,864,10644,3578723509,3578723525,16
3,864,10645,3578723509,3578723535,26
3,864,10646,3578723509,3578723535,26
3,864,10647,3578723509,3578723536,27
3,864,10648,3578723509,3578723537,28
3,864,10649,3578723509,3578723537,28
3,864,10650,3578723509,3578723538,29
3,864,10651,3578723509,3578723538,29
3,864,10652,3578723509,3578723539,30
3,864,10653,3578723509,3578723540,31
3,864,10654,3578723509,3578723545,36
3,864,10655,3578723509,3578723545,36
3,864,10656,3578723509,3578723547,38
3,864,10657,3578723509,3578723549,40
3,864,10658,3578723509,3578723549,40
3,864,10659,3578723509,3578723551,42
3,864,10660,3578723509,3578723552,43
3,864,10661,3578723509,3578723554,45
3,864,10662,3578723509,3578723554,45
3,864,10663,3578723509,3578723557,48
3,864,10664,3578723509,3578723557,48
3,865,10665,3578723565,3578723565,0
3,865,10666,3578723565,3578723565,0
3,865,10667,3578723565,3578723565,0
3,865,10668,3578723565,3578723567,2
3,865,10669,3578723565,3578723568,3
3,865,10670,3578723565,3578723568,3
3,865,10671,3578723565,3578723570,5
3,865,10672,3578723565,3578723571,6
3,865,10673,3578723565,3578723573,8
3,865,10674,3578723565,3578723574,9
3,865,10675,3578723565,3578723574,9
3,865,10676,3578723565,3578723576,11
3,865,10677,3578723565,3578723576,11
3,865,10678,3578723565,3578723578,13
3,865,10679,3578723565,3578723578,13
3,865,10680,3578723565,3578723581,16
3,865,10681,3578723565,3578723582,17
3,865,10682,3578723565,3578723583,18
3,865,10683,3578723565,3578723583,18
3,865,10684,3578723565,3578723584,19
3,865,10685,3578723565,3578723585,20
3,865,10686,3578723565,3578723585,20
3,865,10687,3578723565,3578723586,21
3,865,10688,3578723565,3578723586,21
3,865,10689,3578723565,3578723587,22
3,865,10690,3578723565,3578723588,23
3,865,10691,3578723565,3578723590,25
3,865,10692,3578723565,3578723593,28
3,865,10693,3578723565,3578723601,36
3,865,10694,3578723565,3578723602,37
3,865,10695,3578723565,3578723603,38
3,865,10696,3578723565,3578723604,39
3,865,10697,3578723565,3578723604,39
3,865,10698,3578723565,3578723604,39
3,865,10699,3578723565,3578723604,39
3,865,10700,3578723565,3578723605,40
3,865,10701,3578723565,3578723607,42
3,865,10702,3578723565,3578723607,42
3,865,10703,3578723565,3578723608,43
3,865,10704,3578723565,3578723613,48
3,865,10705,3578723565,3578723613,48
3,866,10706,3578723621,3578723621,0
3,866,10707,3578723621,3578723621,0
3,866,10708,3578723621,3578723621,0
3,866,10709,3578723621,3578723621,0
3,866,10710,3578723621,3578723621,0
3,866,10711,3578723621,3578723622,1
3,866,10712,3578723621,3578723627,6
3,866,10713,3578723621,3578723627,6
3,866,10714,3578723621,3578723628,7
3,866,10715,3578723621,3578723631,10
3,866,10716,3578723621,3578723631,10
3,866,10717,3578723621,3578723633,12
3,866,10718,3578723621,3578723634,13
3,866,10719,3578723621,3578723638,17
3,866,10720,3578723621,3578723641,20
3,866,10721,3578723621,3578723643,22
3,866,10722,3578723621,3578723644,23
3,866,10723,3578723621,3578723646,25
3,866,10724,3578723621,3578723647,26
3,866,10725,3578723621,3578723649,28
3,866,10726,3578723621,3578723653,32
3,866,10727,3578723621,3578723656,35
3,866,10728,3578723621,3578723660,39
3,866,10729,3578723621,3578723663,42
3,866,10730,3578723621,3578723663,42
3,866,10731,3578723621,3578723664,43
3,866,10732,3578723621,3578723668,47
3,866,10733,3578723621,3578723669,48
3,866,10734,3578723621,3578723669,48
3,866,10735,3578723621,3578723669,48
3,867,10736,3578723676,3578723676,0
3,867,10737,3578723676,3578723678,2
3,867,10738,3578723676,3578723679,3
3,867,10739,3578723676,3578723680,4
3,867,10740,3578723676,3578723682,6
3,867,10741,3578723676,3578723682,6
3,867,10742,3578723676,3578723683,7
3,867,10743,3578723676,3578723683,7
3,867,10744,3578723676,3578723688,12
3,867,10745,3578723676,3578723692,16
3,867,10746,3578723676,3578723693,17
3,867,10747,3578723676,3578723694,18
3,867,10748,3578723676,3578723697,21
3,867,10749,3578723676,3578723700,24
3,867,10750,3578723676,3578723700,24
3,867,10751,3578723676,3578723700,24
3,867,10752,3578723676,3578723700,24
3,867,10753,3578723676,3578723701,25
3,867,10754,3578723676,3578723704,28
3,867,10755,3578723676,3578723704,28
3,867,10756,3578723676,3578723710,34
3,867,10757,3578723676,3578723714,38
3,867,10758,3578723676,3578723714,38
3,867,10759,3578723676,3578723717,41
3,867,10760,3578723676,3578723717,41
3,867,10761,3578723676,3578723721,45
3,867,10762,3578723676,3578723721,45
3,867,10763,3578723676,3578723723,47
3,867,10764,3578723676,3578723725,49
3,868,10765,3578723733,3578723735,2
3,868,10766,3578723733,3578723735,2
3,868,10767,3578723733,3578723736,3
3,868,10768,3578723733,3578723737,4
3,868,10769,3578723733,3578723737,4
3,868,10770,3578723733,3578723738,5
3,868,10771,3578723733,3578723738,5
3,868,10772,3578723733,3578723738,5
3,868,10773,3578723733,3578723741,8
3,868,10774,3578723733,3578723741,8
3,868,10775,3578723733,3578723745,12
3,868,10776,3578723733,3578723745,12
3,868,10777,3578723733,3578723748,15
3,868,10778,3578723733,3578723749,16
3,868,10779,3578723733,3578723750,17
3,868,10780,3578723733,3578723750,17
3,868,10781,3578723733,3578723752,19
3,868,10782,3578723733,3578723753,20
3,868,10783,3578723733,3578723753,20
3,868,10784,3578723733,3578723754,21
3,868,10785,3578723733,3578723757,24
3,868,10786,3578723733,3578723760,27
3,868,10787,3578723733,3578723763,30
3,868,10788,3578723733,3578723764,31
3,868,10789,3578723733,3578723766,33
3,868,10790,3578723733,3578723767,34
3,868,10791,3578723733,3578723768,35
3,868,10792,3578723733,3578723770,37
3,868,10793,3578723733,3578723771,38
3,868,10794,3578723733,3578723773,40
3,868,10795,3578723733,3578723773,40
3,868,10796,3578723733,3578723774,41
3,868,10797,3578723733,3578723776,43
3,868,10798,3578723733,3578723777,44
3,868,10799,3578723733,3578723779,46
3,868,10800,3578723733,3578723779,46
3,868,10801,3578723733,3578723782,49
3,868,10802,3578723733,3578723782,49
3,869,10803,3578723791,3578723791,0
3,869,10804,3578723791,3578723791,0
3,869,10805,3578723791,3578723791,0
3,869,10806,3578723791,3578723791,0
3,869,10807,3578723791,3578723791,0
3,869,10808,3578723791,3578723791,0
3,869,10809,3578723791,3578723791,0
3,869,10810,3578723791,3578723791,0
3,869,10811,3578723791,3578723791,0
3,869,10812,3578723791,3578723791,0
3,869,10813,3578723791,3578723791,0
3,869,10814,3578723791,3578723793,2
3,869,10815,3578723791,3578723800,9
3,869,10816,3578723791,3578723802,11
3,869,10817,3578723791,3578723803,12
3,869,10818,3578723791,3578723803,12
3,869,10819,3578723791,3578723804,13
3,869,10820,3578723791,3578723804,13
3,869,10821,3578723791,3578723805,14
3,869,10822,3578723791,3578723806,15
3,869,10823,3578723791,3578723807,16
3,869,10824,3578723791,3578723807,16
3,869,10825,3578723791,3578723813,22
3,869,10826,3578723791,3578723813,22
3,869,10827,3578723791,3578723813,22
3,869,10828,3578723791,3578723818,27
3,869,10829,3578723791,3578723818,27
3,869,10830,3578723791,3578723818,27
3,869,10831,3578723791,3578723818,27
3,869,10832,3578723791,3578723821,30
3,869,10833,3578723791,3578723823,32
3,869,10834,3578723791,3578723824,33
3,869,10835,3578723791,3578723827,36
3,869,10836,3578723791,3578723828,37
3,869,10837,3578723791,3578723829,38
3,869,10838,3578723791,3578723831,40
3,869,10839,3578723791,3578723831,40
3,869,10840,3578723791,3578723833,42
3,869,10841,3578723791,3578723834,43
3,869,10842,3578723791,3578723838,47
3,869,10843,3578723791,3578723840,49
3,870,10844,3578723848,3578723848,0
3,870,10845,3578723848,3578723848,0
3,870,10846,3578723848,3578723848,0
3,870,10847,3578723848,3578723848,0
3,870,10848,3578723848,3578723848,0
3,870,10849,3578723848,3578723849,1
3,870,10850,3578723848,3578723853,5
3,870,10851,3578723848,3578723856,8
3,870,10852,3578723848,3578723859,11
3,870,10853,3578723848,3578723861,13
3,870,10854,3578723848,3578723863,15
3,870,10855,3578723848,3578723864,16
3,870,10856,3578723848,3578723864,16
3,870,10857,3578723848,3578723865,17
3,870,10858,3578723848,3578723869,21
3,870,10859,3578723848,3578723869,21
3,870,10860,3578723848,3578723869,21
3,870,10861,3578723848,3578723873,25
3,870,10862,3578723848,3578723878,30
3,870,10863,3578723848,3578723879,31
3,870,10864,3578723848,3578723880,32
3,870,10865,3578723848,3578723881,33
3,870,10866,3578723848,3578723881,33
3,870,10867,3578723848,3578723882,34
3,870,10868,3578723848,3578723882,34
3,870,10869,3578723848,3578723883,35
3,870,10870,3578723848,3578723883,35
3,870,10871,3578723848,3578723888,40
3,870,10872,3578723848,3578723892,44
3,870,10873,3578723848,3578723894,46
3,870,10874,3578723848,3578723894,46
3,870,10875,3578723848,3578723897,49
3,871,10876,3578723905,3578723905,0
3,871,10877,3578723905,3578723905,0
3,871,10878,3578723905,3578723905,0
3,871,10879,3578723905,3578723905,0
3,871,10880,3578723905,3578723905,0
3,871,10881,3578723905,3578723905,0
3,871,10882,3578723905,3578723905,0
3,871,10883,3578723905,3578723910,5
3,871,10884,3578723905,3578723913,8
3,871,10885,3578723905,3578723914,9
3,871,10886,3578723905,3578723917,12
3,871,10887,3578723905,3578723918,13
3,871,10888,3578723905,3578723921,16
3,871,10889,3578723905,3578723922,17
3,871,10890,3578723905,3578723922,17
3,871,10891,3578723905,3578723925,20
3,871,10892,3578723905,3578723935,30
3,871,10893,3578723905,3578723935,30
3,871,10894,3578723905,3578723937,32
3,871,10895,3578723905,3578723937,32
3,871,10896,3578723905,3578723938,33
3,871,10897,3578723905,3578723938,33
3,871,10898,3578723905,3578723938,33
3,871,10899,3578723905,3578723939,34
3,871,10900,3578723905,3578723941,36
3,871,10901,3578723905,3578723945,40
3,871,10902,3578723905,3578723945,40
3,871,10903,3578723905,3578723949,44
3,871,10904,3578723905,3578723949,44
3,871,10905,3578723905,3578723950,45
3,871,10906,3578723905,3578723950,45
3,871,10907,3578723905,3578723952,47
3,871,10908,3578723905,3578723953,48
3,871,10909,3578723905,3578723954,49
3,871,10910,3578723905,3578723954,49
3,872,10911,3578723961,3578723961,0
3,872,10912,3578723961,3578723961,0
3,872,10913,3578723961,3578723963,2
3,872,10914,3578723961,3578723964,3
3,872,10915,3578723961,3578723966,5
3,872,10916,3578723961,3578723967,6
3,872,10917,3578723961,3578723968,7
3,872,10918,3578723961,3578723970,9
3,872,10919,3578723961,3578723971,10
3,872,10920,3578723961,3578723973,12
3,872,10921,3578723961,3578723974,13
3,872,10922,3578723961,3578723975,14
3,872,10923,3578723961,3578723977,16
3,872,10924,3578723961,3578723978,17
3,872,10925,3578723961,3578723979,18
3,872,10926,3578723961,3578723980,19
3,872,10927,3578723961,3578723982,21
3,872,10928,3578723961,3578723983,22
3,872,10929,3578723961,3578723983,22
3,872,10930,3578723961,3578723985,24
3,872,10931,3578723961,3578723985,24
3,872,10932,3578723961,3578723985,24
3,872,10933,3578723961,3578723985,24
3,872,10934,3578723961,3578723986,25
3,872,10935,3578723961,3578723987,26
3,872,10936,3578723961,3578723988,27
3,872,10937,3578723961,3578723988,27
3,872,10938,3578723961,3578723990,29
3,872,10939,3578723961,3578723993,32
3,872,10940,3578723961,3578724000,39
3,872,10941,3578723961,3578724002,41
3,872,10942,3578723961,3578724002,41
3,872,10943,3578723961,3578724003,42
3,872,10944,3578723961,3578724003,42
3,872,10945,3578723961,3578724004,43
3,872,10946,3578723961,3578724004,43
3,872,10947,3578723961,3578724004,43
3,872,10948,3578723961,3578724005,44
3,872,10949,3578723961,3578724006,45
3,872,10950,3578723961,3578724007,46
3,872,10951,3578723961,3578724008,47
3,873,10952,3578724017,3578724017,0
3,873,10953,3578724017,3578724017,0
3,873,10954,3578724017,3578724018,1
3,873,10955,3578724017,3578724018,1
3,873,10956,3578724017,3578724019,2
3,873,10957,3578724017,3578724021,4
3,873,10958,3578724017,3578724023,6
3,873,10959,3578724017,3578724025,8
3,873,10960,3578724017,3578724026,9
3,873,10961,3578724017,3578724027,10
3,873,10962,3578724017,3578724028,11
3,873,10963,3578724017,3578724029,12
3,873,10964,3578724017,3578724031,14
3,873,10965,3578724017,3578724032,15
3,873,10966,3578724017,3578724033,16
3,873,10967,3578724017,3578724034,17
3,873,10968,3578724017,3578724038,21
3,873,10969,3578724017,3578724041,24
3,873,10970,3578724017,3578724043,26
3,873,10971,3578724017,3578724043,26
3,873,10972,3578724017,3578724047,30
3,873,10973,3578724017,3578724051,34
3,873,10974,3578724017,3578724053,36
3,873,10975,3578724017,3578724054,37
3,873,10976,3578724017,3578724056,39
3,873,10977,3578724017,3578724059,42
3,873,10978,3578724017,3578724063,46
3,873,10979,3578724017,3578724064,47
3,873,10980,3578724017,3578724065,48
3,874,10981,3578724073,3578724073,0
3,874,10982,3578724073,3578724073,0
3,874,10983,3578724073,3578724073,0
3,874,10984,3578724073,3578724073,0
3,874,10985,3578724073,3578724077,4
3,874,10986,3578724073,3578724079,6
3,874,10987,3578724073,3578724080,7
3,874,10988,3578724073,3578724080,7
3,874,10989,3578724073,3578724081,8
3,874,10990,3578724073,3578724082,9
3,874,10991,3578724073,3578724083,10
3,874,10992,3578724073,3578724083,10
3,874,10993,3578724073,3578724084,11
3,874,10994,3578724073,3578724087,14
3,874,10995,3578724073,3578724088,15
3,874,10996,3578724073,3578724091,18
3,874,10997,3578724073,3578724093,20
3,874,10998,3578724073,3578724094,21
3,874,10999,3578724073,3578724097,24
3,874,11000,3578724073,3578724100,27
3,874,11001,3578724073,3578724100,27
3,874,11002,3578724073,3578724101,28
3,874,11003,3578724073,3578724102,29
3,874,11004,3578724073,3578724104,31
3,874,11005,3578724073,3578724105,32
3,874,11006,3578724073,3578724109,36
3,874,11007,3578724073,3578724114,41
3,874,11008,3578724073,3578724115,42
3,874,11009,3578724073,3578724117,44
3,874,11010,3578724073,3578724118,45
3,874,11011,3578724073,3578724121,48
3,874,11012,3578724073,3578724122,49
3,874,11013,3578724073,3578724122,49
3,875,11014,3578724129,3578724129,0
3,875,11015,3578724129,3578724135,6
3,875,11016,3578724129,3578724136,7
3,875,11017,3578724129,3578724137,8
3,875,11018,3578724129,3578724138,9
3,875,11019,3578724129,3578724138,9
3,875,11020,3578724129,3578724138,9
3,875,11021,3578724129,3578724139,10
3,875,11022,3578724129,3578724139,10
3,875,11023,3578724129,3578724140,11
3,875,11024,3578724129,3578724141,12
3,875,11025,3578724129,3578724144,15
3,875,11026,3578724129,3578724146,17
3,875,11027,3578724129,3578724149,20
3,875,11028,3578724129,3578724149,20
3,875,11029,3578724129,3578724151,22
3,875,11030,3578724129,3578724151,22
3,875,11031,3578724129,3578724152,23
3,875,11032,3578724129,3578724154,25
3,875,11033,3578724129,3578724154,25
3,875,11034,3578724129,3578724155,26
3,875,11035,3578724129,3578724157,28
3,875,11036,3578724129,3578724158,29
3,875,11037,3578724129,3578724160,31
3,875,11038,3578724129,3578724163,34
3,875,11039,3578724129,3578724164,35
3,875,11040,3578724129,3578724167,38
3,875,11041,3578724129,3578724168,39
3,875,11042,3578724129,3578724168,39
3,875,11043,3578724129,3578724171,42
3,875,11044,3578724129,3578724171,42
3,875,11045,3578724129,3578724173,44
3,875,11046,3578724129,3578724174,45
3,875,11047,3578724129,3578724176,47
3,875,11048,3578724129,3578724177,48
3,875,11049,3578724129,3578724178,49
3,875,11050,3578724129,3578724179,50
3,876,11051,3578724186,3578724186,0
3,876,11052,3578724186,3578724186,0
3,876,11053,3578724186,3578724186,0
3,876,11054,3578724186,3578724186,0
3,876,11055,3578724186,3578724186,0
3,876,11056,3578724186,3578724186,0
3,876,11057,3578724186,3578724186,0
3,876,11058,3578724186,3578724186,0
3,876,11059,3578724186,3578724186,0
3,876,11060,3578724186,3578724186,0
3,876,11061,3578724186,3578724188,2
3,876,11062,3578724186,3578724188,2
3,876,11063,3578724186,3578724189,3
3,876,11064,3578724186,3578724191,5
3,876,11065,3578724186,3578724192,6
3,876,11066,3578724186,3578724193,7
3,876,11067,3578724186,3578724202,16
3,876,11068,3578724186,3578724203,17
3,876,11069,3578724186,3578724203,17
3,876,11070,3578724186,3578724204,18
3,876,11071,3578724186,3578724204,18
3,876,11072,3578724186,3578724204,18
3,876,11073,3578724186,3578724204,18
3,876,11074,3578724186,3578724205,19
3,876,11075,3578724186,3578724205,19
3,876,11076,3578724186,3578724207,21
3,876,11077,3578724186,3578724208,22
3,876,11078,3578724186,3578724208,22
3,876,11079,3578724186,3578724213,27
3,876,11080,3578724186,3578724214,28
3,876,11081,3578724186,3578724214,28
3,876,11082,3578724186,3578724218,32
3,876,11083,3578724186,3578724219,33
3,876,11084,3578724186,3578724219,33
3,876,11085,3578724186,3578724223,37
3,876,11086,3578724186,3578724225,39
3,876,11087,3578724186,3578724226,40
3,876,11088,3578724186,3578724227,41
3,876,11089,3578724186,3578724229,43
3,876,11090,3578724186,3578724232,46
3,876,11091,3578724186,3578724232,46
3,876,11092,3578724186,3578724233,47
3,876,11093,3578724186,3578724235,49
3,877,11094,3578724243,3578724243,0
3,877,11095,3578724243,3578724243,0
3,877,11096,3578724243,3578724243,0
3,877,11097,3578724243,3578724243,0
3,877,11098,3578724243,3578724243,0
3,877,11099,3578724243,3578724244,1
3,877,11100,3578724243,3578724244,1
3,877,11101,3578724243,3578724247,4
3,877,11102,3578724243,3578724248,5
3,877,11103,3578724243,3578724251,8
3,877,11104,3578724243,3578724253,10
3,877,11105,3578724243,3578724254,11
3,877,11106,3578724243,3578724256,13
3,877,11107,3578724243,3578724261,18
3,877,11108,3578724243,3578724263,20
3,877,11109,3578724243,3578724264,21
3,877,11110,3578724243,3578724265,22
3,877,11111,3578724243,3578724265,22
3,877,11112,3578724243,3578724269,26
3,877,11113,3578724243,3578724270,27
3,877,11114,3578724243,3578724270,27
3,877,11115,3578724243,3578724273,30
3,877,11116,3578724243,3578724278,35
3,877,11117,3578724243,3578724279,36
3,877,11118,3578724243,3578724280,37
3,877,11119,3578724243,3578724281,38
3,877,11120,3578724243,3578724281,38
3,877,11121,3578724243,3578724282,39
3,877,11122,3578724243,3578724282,39
3,877,11123,3578724243,3578724283,40
3,877,11124,3578724243,3578724285,42
3,877,11125,3578724243,3578724287,44
3,877,11126,3578724243,3578724289,46
3,877,11127,3578724243,3578724292,49
3,878,11128,3578724299,3578724299,0
3,878,11129,3578724299,3578724299,0
3,878,11130,3578724299,3578724299,0
3,878,11131,3578724299,3578724301,2
3,878,11132,3578724299,3578724301,2
3,878,11133,3578724299,3578724302,3
3,878,11134,3578724299,3578724302,3
3,878,11135,3578724299,3578724304,5
3,878,11136,3578724299,3578724304,5
3,878,11137,3578724299,3578724310,11
3,878,11138,3578724299,3578724314,15
3,878,11139,3578724299,3578724316,17
3,878,11140,3578724299,3578724317,18
3,878,11141,3578724299,3578724318,19
3,878,11142,3578724299,3578724321,22
3,878,11143,3578724299,3578724321,22
3,878,11144,3578724299,3578724323,24
3,878,11145,3578724299,3578724325,26
3,878,11146,3578724299,3578724335,36
3,878,11147,3578724299,3578724336,37
3,878,11148,3578724299,3578724337,38
3,878,11149,3578724299,3578724338,39
3,878,11150,3578724299,3578724339,40
3,878,11151,3578724299,3578724339,40
3,878,11152,3578724299,3578724339,40
3,878,11153,3578724299,3578724339,40
3,878,11154,3578724299,3578724340,41
3,878,11155,3578724299,3578724346,47
3,878,11156,3578724299,3578724346,47
3,879,11157,3578724356,3578724356,0
3,879,11158,3578724356,3578724356,0
3,879,11159,3578724356,3578724356,0
3,879,11160,3578724356,3578724356,0
3,879,11161,3578724356,3578724356,0
3,879,11162,3578724356,3578724356,0
3,879,11163,3578724356,3578724356,0
3,879,11164,3578724356,3578724356,0
3,879,11165,3578724356,3578724357,1
3,879,11166,3578724356,3578724357,1
3,879,11167,3578724356,3578724360,4
3,879,11168,3578724356,3578724364,8
3,879,11169,3578724356,3578724364,8
3,879,11170,3578724356,3578724366,10
3,879,11171,3578724356,3578724368,12
3,879,11172,3578724356,3578724369,13
3,879,11173,3578724356,3578724371,15
3,879,11174,3578724356,3578724371,15
3,879,11175,3578724356,3578724373,17
3,879,11176,3578724356,3578724374,18
3,879,11177,3578724356,3578724377,21
3,879,11178,3578724356,3578724377,21
3,879,11179,3578724356,3578724378,22
3,879,11180,3578724356,3578724379,23
3,879,11181,3578724356,3578724380,24
3,879,11182,3578724356,3578724382,26
3,879,11183,3578724356,3578724383,27
3,879,11184,3578724356,3578724384,28
3,879,11185,3578724356,3578724385,29
3,879,11186,3578724356,3578724385,29
3,879,11187,3578724356,3578724385,29
3,879,11188,3578724356,3578724386,30
3,879,11189,3578724356,3578724387,31
3,879,11190,3578724356,3578724387,31
3,879,11191,3578724356,3578724388,32
3,879,11192,3578724356,3578724389,33
3,879,11193,3578724356,3578724390,34
3,879,11194,3578724356,3578724391,35
3,879,11195,3578724356,3578724394,38
3,879,11196,3578724356,3578724402,46
3,879,11197,3578724356,3578724404,48
3,879,11198,3578724356,3578724404,48
3,879,11199,3578724356,3578724404,48
3,879,11200,3578724356,3578724404,48
3,879,11201,3578724356,3578724405,49
3,879,11202,3578724356,3578724405,49
3,879,11203,3578724356,3578724405,49
3,879,11204,3578724356,3578724406,50
3,880,11205,3578724413,3578724413,0
3,880,11206,3578724413,3578724413,0
3,880,11207,3578724413,3578724413,0
3,880,11208,3578724413,3578724414,1
3,880,11209,3578724413,3578724414,1
3,880,11210,3578724413,3578724418,5
3,880,11211,3578724413,3578724418,5
3,880,11212,3578724413,3578724419,6
3,880,11213,3578724413,3578724420,7
3,880,11214,3578724413,3578724424,11
3,880,11215,3578724413,3578724426,13
3,880,11216,3578724413,3578724427,14
3,880,11217,3578724413,3578724427,14
3,880,11218,3578724413,3578724429,16
3,880,11219,3578724413,3578724432,19
3,880,11220,3578724413,3578724433,20
3,880,11221,3578724413,3578724434,21
3,880,11222,3578724413,3578724435,22
3,880,11223,3578724413,3578724437,24
3,880,11224,3578724413,3578724440,27
3,880,11225,3578724413,3578724441,28
3,880,11226,3578724413,3578724442,29
3,880,11227,3578724413,3578724443,30
3,880,11228,3578724413,3578724444,31
3,880,11229,3578724413,3578724444,31
3,880,11230,3578724413,3578724450,37
3,880,11231,3578724413,3578724453,40
3,880,11232,3578724413,3578724454,41
3,880,11233,3578724413,3578724456,43
3,880,11234,3578724413,3578724463,50
3,881,11235,3578724469,3578724470,1
3,881,11236,3578724469,3578724470,1
3,881,11237,3578724469,3578724470,1
3,881,11238,3578724469,3578724470,1
3,881,11239,3578724469,3578724470,1
3,881,11240,3578724469,3578724471,2
3,881,11241,3578724469,3578724474,5
3,881,11242,3578724469,3578724478,9
3,881,11243,3578724469,3578724479,10
3,881,11244,3578724469,3578724481,12
3,881,11245,3578724469,3578724481,12
3,881,11246,3578724469,3578724481,12
3,881,11247,3578724469,3578724482,13
3,881,11248,3578724469,3578724483,14
3,881,11249,3578724469,3578724483,14
3,881,11250,3578724469,3578724486,17
3,881,11251,3578724469,3578724488,19
3,881,11252,3578724469,3578724489,20
3,881,11253,3578724469,3578724492,23
3,881,11254,3578724469,3578724494,25
3,881,11255,3578724469,3578724496,27
3,881,11256,3578724469,3578724497,28
3,881,11257,3578724469,3578724501,32
3,881,11258,3578724469,3578724501,32
3,881,11259,3578724469,3578724502,33
3,881,11260,3578724469,3578724502,33
3,881,11261,3578724469,3578724504,35
3,881,11262,3578724469,3578724505,36
3,881,11263,3578724469,3578724510,41
3,881,11264,3578724469,3578724514,45
3,881,11265,3578724469,3578724517,48
3,881,11266,3578724469,3578724518,49
3,881,11267,3578724469,3578724518,49
3,882,11268,3578724526,3578724526,0
3,882,11269,3578724526,3578724526,0
3,882,11270,3578724526,3578724526,0
3,882,11271,3578724526,3578724526,0
3,882,11272,3578724526,3578724533,7
3,882,11273,3578724526,3578724535,9
3,882,11274,3578724526,3578724536,10
3,882,11275,3578724526,3578724536,10
3,882,11276,3578724526,3578724538,12
3,882,11277,3578724526,3578724538,12
3,882,11278,3578724526,3578724539,13
3,882,11279,3578724526,3578724539,13
3,882,11280,3578724526,3578724540,14
3,882,11281,3578724526,3578724540,14
3,882,11282,3578724526,3578724544,18
3,882,11283,3578724526,3578724545,19
3,882,11284,3578724526,3578724550,24
3,882,11285,3578724526,3578724551,25
3,882,11286,3578724526,3578724551,25
3,882,11287,3578724526,3578724552,26
3,882,11288,3578724526,3578724552,26
3,882,11289,3578724526,3578724553,27
3,882,11290,3578724526,3578724553,27
3,882,11291,3578724526,3578724556,30
3,882,11292,3578724526,3578724556,30
3,882,11293,3578724526,3578724557,31
3,882,11294,3578724526,3578724559,33
3,882,11295,3578724526,3578724562,36
3,882,11296,3578724526,3578724563,37
3,882,11297,3578724526,3578724565,39
3,882,11298,3578724526,3578724568,42
3,882,11299,3578724526,3578724568,42
3,882,11300,3578724526,3578724570,44
3,882,11301,3578724526,3578724571,45
3,882,11302,3578724526,3578724572,46
3,882,11303,3578724526,3578724573,47
3,883,11304,3578724582,3578724582,0
3,883,11305,3578724582,3578724582,0
3,883,11306,3578724582,3578724582,0
3,883,11307,3578724582,3578724582,0
3,883,11308,3578724582,3578724582,0
3,883,11309,3578724582,3578724582,0
3,883,11310,3578724582,3578724584,2
3,883,11311,3578724582,3578724584,2
3,883,11312,3578724582,3578724584,2
3,883,11313,3578724582,3578724585,3
3,883,11314,3578724582,3578724586,4
3,883,11315,3578724582,3578724586,4
3,883,11316,3578724582,3578724588,6
3,883,11317,3578724582,3578724588,6
3,883,11318,3578724582,3578724588,6
3,883,11319,3578724582,3578724590,8
3,883,11320,3578724582,3578724590,8
3,883,11321,3578724582,3578724592,10
3,883,11322,3578724582,3578724601,19
3,883,11323,3578724582,3578724603,21
3,883,11324,3578724582,3578724603,21
3,883,11325,3578724582,3578724603,21
3,883,11326,3578724582,3578724603,21
3,883,11327,3578724582,3578724603,21
3,883,11328,3578724582,3578724604,22
3,883,11329,3578724582,3578724605,23
3,883,11330,3578724582,3578724606,24
3,883,11331,3578724582,3578724609,27
3,883,11332,3578724582,3578724609,27
3,883,11333,3578724582,3578724612,30
3,883,11334,3578724582,3578724613,31
3,883,11335,3578724582,3578724613,31
3,883,11336,3578724582,3578724617,35
3,883,11337,3578724582,3578724618,36
3,883,11338,3578724582,3578724619,37
3,883,11339,3578724582,3578724619,37
3,883,11340,3578724582,3578724621,39
3,883,11341,3578724582,3578724625,43
3,883,11342,3578724582,3578724625,43
3,883,11343,3578724582,3578724626,44
3,883,11344,3578724582,3578724627,45
3,883,11345,3578724582,3578724628,46
3,883,11346,3578724582,3578724632,50
3,884,11347,3578724638,3578724638,0
3,884,11348,3578724638,3578724638,0
3,884,11349,3578724638,3578724638,0
3,884,11350,3578724638,3578724638,0
3,884,11351,3578724638,3578724639,1
3,884,11352,3578724638,3578724640,2
3,884,11353,3578724638,3578724640,2
3,884,11354,3578724638,3578724641,3
3,884,11355,3578724638,3578724643,5
3,884,11356,3578724638,3578724644,6
3,884,11357,3578724638,3578724646,8
3,884,11358,3578724638,3578724648,10
3,884,11359,3578724638,3578724649,11
3,884,11360,3578724638,3578724652,14
3,884,11361,3578724638,3578724653,15
3,884,11362,3578724638,3578724655,17
3,884,11363,3578724638,3578724661,23
3,884,11364,3578724638,3578724662,24
3,884,11365,3578724638,3578724663,25
3,884,11366,3578724638,3578724664,26
3,884,11367,3578724638,3578724665,27
3,884,11368,3578724638,3578724669,31
3,884,11369,3578724638,3578724669,31
3,884,11370,3578724638,3578724669,31
3,884,11371,3578724638,3578724673,35
3,884,11372,3578724638,3578724678,40
3,884,11373,3578724638,3578724679,41
3,884,11374,3578724638,3578724681,43
3,884,11375,3578724638,3578724681,43
3,884,11376,3578724638,3578724682,44
3,884,11377,3578724638,3578724682,44
3,884,11378,3578724638,3578724683,45
3,884,11379,3578724638,3578724683,45
3,884,11380,3578724638,3578724687,49
3,885,11381,3578724693,3578724693,0
3,885,11382,3578724693,3578724693,0
3,885,11383,3578724693,3578724693,0
3,885,11384,3578724693,3578724694,1
3,885,11385,3578724693,3578724695,2
3,885,11386,3578724693,3578724697,4
3,885,11387,3578724693,3578724701,8
3,885,11388,3578724693,3578724701,8
3,885,11389,3578724693,3578724703,10
3,885,11390,3578724693,3578724703,10
3,885,11391,3578724693,3578724704,11
3,885,11392,3578724693,3578724704,11
3,885,11393,3578724693,3578724711,18
3,885,11394,3578724693,3578724714,21
3,885,11395,3578724693,3578724718,25
3,885,11396,3578724693,3578724718,25
3,885,11397,3578724693,3578724718,25
3,885,11398,3578724693,3578724721,28
3,885,11399,3578724693,3578724721,28
3,885,11400,3578724693,3578724726,33
3,885,11401,3578724693,3578724734,41
3,885,11402,3578724693,3578724735,42
3,885,11403,3578724693,3578724736,43
3,885,11404,3578724693,3578724737,44
3,885,11405,3578724693,3578724738,45
3,885,11406,3578724693,3578724738,45
3,885,11407,3578724693,3578724738,45
3,885,11408,3578724693,3578724739,46
3,885,11409,3578724693,3578724739,46
3,886,11410,3578724749,3578724749,0
3,886,11411,3578724749,3578724749,0
3,886,11412,3578724749,3578724749,0
3,886,11413,3578724749,3578724751,2
3,886,11414,3578724749,3578724751,2
3,886,11415,3578724749,3578724752,3
3,886,11416,3578724749,3578724752,3
3,886,11417,3578724749,3578724752,3
3,886,11418,3578724749,3578724753,4
3,886,11419,3578724749,3578724753,4
3,886,11420,3578724749,3578724755,6
3,886,11421,3578724749,3578724757,8
3,886,11422,3578724749,3578724761,12
3,886,11423,3578724749,3578724762,13
3,886,11424,3578724749,3578724763,14
3,886,11425,3578724749,3578724766,17
3,886,11426,3578724749,3578724768,19
3,886,11427,3578724749,3578724768,19
3,886,11428,3578724749,3578724771,22
3,886,11429,3578724749,3578724773,24
3,886,11430,3578724749,3578724774,25
3,886,11431,3578724749,3578724776,27
3,886,11432,3578724749,3578724779,30
3,886,11433,3578724749,3578724780,31
3,886,11434,3578724749,3578724780,31
3,886,11435,3578724749,3578724782,33
3,886,11436,3578724749,3578724783,34
3,886,11437,3578724749,3578724785,36
3,886,11438,3578724749,3578724785,36
3,886,11439,3578724749,3578724785,36
3,886,11440,3578724749,3578724785,36
3,886,11441,3578724749,3578724786,37
3,886,11442,3578724749,3578724786,37
3,886,11443,3578724749,3578724788,39
3,886,11444,3578724749,3578724789,40
3,886,11445,3578724749,3578724789,40
3,886,11446,3578724749,3578724789,40
3,886,11447,3578724749,3578724790,41
3,886,11448,3578724749,3578724792,43
3,887,11449,3578724805,3578724805,0
3,887,11450,3578724805,3578724805,0
3,887,11451,3578724805,3578724805,0
3,887,11452,3578724805,3578724805,0
3,887,11453,3578724805,3578724805,0
3,887,11454,3578724805,3578724805,0
3,887,11455,3578724805,3578724805,0
3,887,11456,3578724805,3578724805,0
3,887,11457,3578724805,3578724805,0
3,887,11458,3578724805,3578724805,0
3,887,11459,3578724805,3578724809,4
3,887,11460,3578724805,3578724810,5
3,887,11461,3578724805,3578724814,9
3,887,11462,3578724805,3578724814,9
3,887,11463,3578724805,3578724818,13
3,887,11464,3578724805,3578724818,13
3,887,11465,3578724805,3578724819,14
3,887,11466,3578724805,3578724820,15
3,887,11467,3578724805,3578724821,16
3,887,11468,3578724805,3578724822,17
3,887,11469,3578724805,3578724825,20
3,887,11470,3578724805,3578724826,21
3,887,11471,3578724805,3578724828,23
3,887,11472,3578724805,3578724828,23
3,887,11473,3578724805,3578724831,26
3,887,11474,3578724805,3578724832,27
3,887,11475,3578724805,3578724833,28
3,887,11476,3578724805,3578724836,31
3,887,11477,3578724805,3578724836,31
3,887,11478,3578724805,3578724839,34
3,887,11479,3578724805,3578724840,35
3,887,11480,3578724805,3578724840,35
3,887,11481,3578724805,3578724841,36
3,887,11482,3578724805,3578724843,38
3,887,11483,3578724805,3578724843,38
3,887,11484,3578724805,3578724847,42
3,887,11485,3578724805,3578724848,43
3,887,11486,3578724805,3578724850,45
3,887,11487,3578724805,3578724852,47
3,887,11488,3578724805,3578724853,48
3,887,11489,3578724805,3578724855,50
3,888,11490,3578724862,3578724862,0
3,888,11491,3578724862,3578724862,0
3,888,11492,3578724862,3578724862,0
3,888,11493,3578724862,3578724862,0
3,888,11494,3578724862,3578724864,2
3,888,11495,3578724862,3578724864,2
3,888,11496,3578724862,3578724869,7
3,888,11497,3578724862,3578724869,7
3,888,11498,3578724862,3578724870,8
3,888,11499,3578724862,3578724870,8
3,888,11500,3578724862,3578724874,12
3,888,11501,3578724862,3578724878,16
3,888,11502,3578724862,3578724878,16
3,888,11503,3578724862,3578724881,19
3,888,11504,3578724862,3578724882,20
3,888,11505,3578724862,3578724883,21
3,888,11506,3578724862,3578724883,21
3,888,11507,3578724862,3578724883,21
3,888,11508,3578724862,3578724888,26
3,888,11509,3578724862,3578724889,27
3,888,11510,3578724862,3578724893,31
3,888,11511,3578724862,3578724893,31
3,888,11512,3578724862,3578724896,34
3,888,11513,3578724862,3578724896,34
3,888,11514,3578724862,3578724901,39
3,888,11515,3578724862,3578724903,41
3,888,11516,3578724862,3578724903,41
3,888,11517,3578724862,3578724904,42
3,888,11518,3578724862,3578724904,42
3,888,11519,3578724862,3578724911,49
3,889,11520,3578724919,3578724919,0
3,889,11521,3578724919,3578724919,0
3,889,11522,3578724919,3578724919,0
3,889,11523,3578724919,3578724919,0
3,889,11524,3578724919,3578724921,2
3,889,11525,3578724919,3578724922,3
3,889,11526,3578724919,3578724926,7
3,889,11527,3578724919,3578724934,15
3,889,11528,3578724919,3578724935,16
3,889,11529,3578724919,3578724936,17
3,889,11530,3578724919,3578724938,19
3,889,11531,3578724919,3578724938,19
3,889,11532,3578724919,3578724938,19
3,889,11533,3578724919,3578724939,20
3,889,11534,3578724919,3578724939,20
3,889,11535,3578724919,3578724940,21
3,889,11536,3578724919,3578724940,21
3,889,11537,3578724919,3578724945,26
3,889,11538,3578724919,3578724945,26
3,889,11539,3578724919,3578724949,30
3,889,11540,3578724919,3578724951,32
3,889,11541,3578724919,3578724951,32
3,889,11542,3578724919,3578724951,32
3,889,11543,3578724919,3578724952,33
3,889,11544,3578724919,3578724952,33
3,889,11545,3578724919,3578724953,34
3,889,11546,3578724919,3578724954,35
3,889,11547,3578724919,3578724956,37
3,889,11548,3578724919,3578724956,37
3,889,11549,3578724919,3578724961,42
3,889,11550,3578724919,3578724964,45
3,889,11551,3578724919,3578724965,46
3,889,11552,3578724919,3578724967,48
3,889,11553,3578724919,3578724967,48
3,890,11554,3578724976,3578724976,0
3,890,11555,3578724976,3578724976,0
3,890,11556,3578724976,3578724976,0
3,890,11557,3578724976,3578724976,0
3,890,11558,3578724976,3578724976,0
3,890,11559,3578724976,3578724977,1
3,890,11560,3578724976,3578724979,3
3,890,11561,3578724976,3578724980,4
3,890,11562,3578724976,3578724980,4
3,890,11563,3578724976,3578724982,6
3,890,11564,3578724976,3578724982,6
3,890,11565,3578724976,3578724984,8
3,890,11566,3578724976,3578724985,9
3,890,11567,3578724976,3578724986,10
3,890,11568,3578724976,3578724986,10
3,890,11569,3578724976,3578724986,10
3,890,11570,3578724976,3578724987,11
3,890,11571,3578724976,3578724988,12
3,890,11572,3578724976,3578724989,13
3,890,11573,3578724976,3578724989,13
3,890,11574,3578724976,3578724989,13
3,890,11575,3578724976,3578724990,14
3,890,11576,3578724976,3578724991,15
3,890,11577,3578724976,3578724993,17
3,890,11578,3578724976,3578725002,26
3,890,11579,3578724976,3578725003,27
3,890,11580,3578724976,3578725003,27
3,890,11581,3578724976,3578725003,27
3,890,11582,3578724976,3578725003,27
3,890,11583,3578724976,3578725004,28
3,890,11584,3578724976,3578725004,28
3,890,11585,3578724976,3578725005,29
3,890,11586,3578724976,3578725006,30
3,890,11587,3578724976,3578725006,30
3,890,11588,3578724976,3578725009,33
3,890,11589,3578724976,3578725009,33
3,890,11590,3578724976,3578725009,33
3,890,11591,3578724976,3578725014,38
3,890,11592,3578724976,3578725014,38
3,890,11593,3578724976,3578725015,39
3,890,11594,3578724976,3578725018,42
3,890,11595,3578724976,3578725019,43
3,890,11596,3578724976,3578725019,43
3,890,11597,3578724976,3578725020,44
3,890,11598,3578724976,3578725022,46
3,890,11599,3578724976,3578725023,47
3,890,11600,3578724976,3578725025,49
3,891,11601,3578725033,3578725033,0
3,891,11602,3578725033,3578725033,0
3,891,11603,3578725033,3578725033,0
3,891,11604,3578725033,3578725033,0
3,891,11605,3578725033,3578725033,0
3,891,11606,3578725033,3578725033,0
3,891,11607,3578725033,3578725033,0
3,891,11608,3578725033,3578725036,3
3,891,11609,3578725033,3578725036,3
3,891,11610,3578725033,3578725039,6
3,891,11611,3578725033,3578725039,6
3,891,11612,3578725033,3578725040,7
3,891,11613,3578725033,3578725042,9
3,891,11614,3578725033,3578725043,10
3,891,11615,3578725033,3578725043,10
3,891,11616,3578725033,3578725044,11
3,891,11617,3578725033,3578725047,14
3,891,11618,3578725033,3578725048,15
3,891,11619,3578725033,3578725050,17
3,891,11620,3578725033,3578725052,19
3,891,11621,3578725033,3578725053,20
3,891,11622,3578725033,3578725055,22
3,891,11623,3578725033,3578725059,26
3,891,11624,3578725033,3578725060,27
3,891,11625,3578725033,3578725062,29
3,891,11626,3578725033,3578725062,29
3,891,11627,3578725033,3578725064,31
3,891,11628,3578725033,3578725065,32
3,891,11629,3578725033,3578725066,33
3,891,11630,3578725033,3578725069,36
3,891,11631,3578725033,3578725070,37
3,891,11632,3578725033,3578725070,37
3,891,11633,3578725033,3578725073,40
3,891,11634,3578725033,3578725079,46
3,891,11635,3578725033,3578725079,46
3,891,11636,3578725033,3578725082,49
3,892,11637,3578725089,3578725089,0
3,892,11638,3578725089,3578725089,0
3,892,11639,3578725089,3578725089,0
3,892,11640,3578725089,3578725089,0
3,892,11641,3578725089,3578725089,0
3,892,11642,3578725089,3578725089,0
3,892,11643,3578725089,3578725093,4
3,892,11644,3578725089,3578725094,5
3,892,11645,3578725089,3578725096,7
3,892,11646,3578725089,3578725096,7
3,892,11647,3578725089,3578725101,12
3,892,11648,3578725089,3578725103,14
3,892,11649,3578725089,3578725103,14
3,892,11650,3578725089,3578725104,15
3,892,11651,3578725089,3578725104,15
3,892,11652,3578725089,3578725110,21
3,892,11653,3578725089,3578725111,22
3,892,11654,3578725089,3578725112,23
3,892,11655,3578725089,3578725114,25
3,892,11656,3578725089,3578725118,29
3,892,11657,3578725089,3578725118,29
3,892,11658,3578725089,3578725119,30
3,892,11659,3578725089,3578725121,32
3,892,11660,3578725089,3578725122,33
3,892,11661,3578725089,3578725126,37
3,892,11662,3578725089,3578725134,45
3,892,11663,3578725089,3578725136,47
3,892,11664,3578725089,3578725136,47
3,892,11665,3578725089,3578725138,49
3,892,11666,3578725089,3578725138,49
3,892,11667,3578725089,3578725138,49
3,892,11668,3578725089,3578725138,49
3,892,11669,3578725089,3578725139,50
3,893,11670,3578725145,3578725145,0
3,893,11671,3578725145,3578725145,0
3,893,11672,3578725145,3578725146,1
3,893,11673,3578725145,3578725150,5
3,893,11674,3578725145,3578725151,6
3,893,11675,3578725145,3578725152,7
3,893,11676,3578725145,3578725152,7
3,893,11677,3578725145,3578725152,7
3,893,11678,3578725145,3578725152,7
3,893,11679,3578725145,3578725153,8
3,893,11680,3578725145,3578725154,9
3,893,11681,3578725145,3578725155,10
3,893,11682,3578725145,3578725157,12
3,893,11683,3578725145,3578725161,16
3,893,11684,3578725145,3578725164,19
3,893,11685,3578725145,3578725166,21
3,893,11686,3578725145,3578725168,23
3,893,11687,3578725145,3578725168,23
3,893,11688,3578725145,3578725171,26
3,893,11689,3578725145,3578725172,27
3,893,11690,3578725145,3578725173,28
3,893,11691,3578725145,3578725173,28
3,893,11692,3578725145,3578725176,31
3,893,11693,3578725145,3578725177,32
3,893,11694,3578725145,3578725180,35
3,893,11695,3578725145,3578725180,35
3,893,11696,3578725145,3578725181,36
3,893,11697,3578725145,3578725182,37
3,893,11698,3578725145,3578725182,37
3,893,11699,3578725145,3578725184,39
3,893,11700,3578725145,3578725184,39
3,893,11701,3578725145,3578725186,41
3,893,11702,3578725145,3578725186,41
3,893,11703,3578725145,3578725186,41
3,893,11704,3578725145,3578725187,42
3,893,11705,3578725145,3578725187,42
3,893,11706,3578725145,3578725189,44
3,893,11707,3578725145,3578725189,44
3,893,11708,3578725145,3578725189,44
3,893,11709,3578725145,3578725190,45
3,893,11710,3578725145,3578725191,46
3,893,11711,3578725145,3578725193,48
3,894,11712,3578725201,3578725202,1
3,894,11713,3578725201,3578725203,2
3,894,11714,3578725201,3578725203,2
3,894,11715,3578725201,3578725204,3
3,894,11716,3578725201,3578725204,3
3,894,11717,3578725201,3578725204,3
3,894,11718,3578725201,3578725205,4
3,894,11719,3578725201,3578725206,5
3,894,11720,3578725201,3578725209,8
3,894,11721,3578725201,3578725209,8
3,894,11722,3578725201,3578725210,9
3,894,11723,3578725201,3578725215,14
3,894,11724,3578725201,3578725215,14
3,894,11725,3578725201,3578725217,16
3,894,11726,3578725201,3578725219,18
3,894,11727,3578725201,3578725220,19
3,894,11728,3578725201,3578725220,19
3,894,11729,3578725201,3578725223,22
3,894,11730,3578725201,3578725223,22
3,894,11731,3578725201,3578725224,23
3,894,11732,3578725201,3578725226,25
3,894,11733,3578725201,3578725227,26
3,894,11734,3578725201,3578725228,27
3,894,11735,3578725201,3578725228,27
3,894,11736,3578725201,3578725232,31
3,894,11737,3578725201,3578725232,31
3,894,11738,3578725201,3578725233,32
3,894,11739,3578725201,3578725236,35
3,894,11740,3578725201,3578725237,36
3,894,11741,3578725201,3578725239,38
3,894,11742,3578725201,3578725240,39
3,894,11743,3578725201,3578725240,39
3,894,11744,3578725201,3578725242,41
3,894,11745,3578725201,3578725243,42
3,894,11746,3578725201,3578725244,43
3,894,11747,3578725201,3578725247,46
3,894,11748,3578725201,3578725249,48
3,895,11749,3578725258,3578725258,0
3,895,11750,3578725258,3578725258,0
3,895,11751,3578725258,3578725258,0
3,895,11752,3578725258,3578725258,0
3,895,11753,3578725258,3578725260,2
3,895,11754,3578725258,3578725262,4
3,895,11755,3578725258,3578725264,6
3,895,11756,3578725258,3578725264,6
3,895,11757,3578725258,3578725266,8
3,895,11758,3578725258,3578725269,11
3,895,11759,3578725258,3578725269,11
3,895,11760,3578725258,3578725270,12
3,895,11761,3578725258,3578725271,13
3,895,11762,3578725258,3578725273,15
3,895,11763,3578725258,3578725279,21
3,895,11764,3578725258,3578725279,21
3,895,11765,3578725258,3578725281,23
3,895,11766,3578725258,3578725283,25
3,895,11767,3578725258,3578725283,25
3,895,11768,3578725258,3578725283,25
3,895,11769,3578725258,3578725289,31
3,895,11770,3578725258,3578725290,32
3,895,11771,3578725258,3578725291,33
3,895,11772,3578725258,3578725293,35
3,895,11773,3578725258,3578725293,35
3,895,11774,3578725258,3578725296,38
3,895,11775,3578725258,3578725298,40
3,895,11776,3578725258,3578725301,43
3,895,11777,3578725258,3578725301,43
3,895,11778,3578725258,3578725303,45
3,895,11779,3578725258,3578725304,46
3,895,11780,3578725258,3578725304,46
3,895,11781,3578725258,3578725305,47
3,896,11782,3578725314,3578725314,0
3,896,11783,3578725314,3578725314,0
3,896,11784,3578725314,3578725314,0
3,896,11785,3578725314,3578725314,0
3,896,11786,3578725314,3578725318,4
3,896,11787,3578725314,3578725318,4
3,896,11788,3578725314,3578725319,5
3,896,11789,3578725314,3578725322,8
3,896,11790,3578725314,3578725326,12
3,896,11791,3578725314,3578725334,20
3,896,11792,3578725314,3578725336,22
3,896,11793,3578725314,3578725336,22
3,896,11794,3578725314,3578725338,24
3,896,11795,3578725314,3578725338,24
3,896,11796,3578725314,3578725338,24
3,896,11797,3578725314,3578725338,24
3,896,11798,3578725314,3578725339,25
3,896,11799,3578725314,3578725341,27
3,896,11800,3578725314,3578725343,29
3,896,11801,3578725314,3578725345,31
3,896,11802,3578725314,3578725345,31
3,896,11803,3578725314,3578725349,35
3,896,11804,3578725314,3578725351,37
3,896,11805,3578725314,3578725352,38
3,896,11806,3578725314,3578725352,38
3,896,11807,3578725314,3578725353,39
3,896,11808,3578725314,3578725354,40
3,896,11809,3578725314,3578725355,41
3,896,11810,3578725314,3578725355,41
3,896,11811,3578725314,3578725358,44
3,896,11812,3578725314,3578725358,44
3,896,11813,3578725314,3578725361,47
3,896,11814,3578725314,3578725363,49
3,896,11815,3578725314,3578725364,50
3,897,11816,3578725371,3578725371,0
3,897,11817,3578725371,3578725371,0
3,897,11818,3578725371,3578725371,0
3,897,11819,3578725371,3578725372,1
3,897,11820,3578725371,3578725373,2
3,897,11821,3578725371,3578725376,5
3,897,11822,3578725371,3578725376,5
3,897,11823,3578725371,3578725379,8
3,897,11824,3578725371,3578725379,8
3,897,11825,3578725371,3578725382,11
3,897,11826,3578725371,3578725383,12
3,897,11827,3578725371,3578725383,12
3,897,11828,3578725371,3578725383,12
3,897,11829,3578725371,3578725385,14
3,897,11830,3578725371,3578725385,14
3,897,11831,3578725371,3578725386,15
3,897,11832,3578725371,3578725387,16
3,897,11833,3578725371,3578725388,17
3,897,11834,3578725371,3578725388,17
3,897,11835,3578725371,3578725388,17
3,897,11836,3578725371,3578725389,18
3,897,11837,3578725371,3578725389,18
3,897,11838,3578725371,3578725390,19
3,897,11839,3578725371,3578725391,20
3,897,11840,3578725371,3578725392,21
3,897,11841,3578725371,3578725394,23
3,897,11842,3578725371,3578725401,30
3,897,11843,3578725371,3578725402,31
3,897,11844,3578725371,3578725403,32
3,897,11845,3578725371,3578725404,33
3,897,11846,3578725371,3578725404,33
3,897,11847,3578725371,3578725404,33
3,897,11848,3578725371,3578725406,35
3,897,11849,3578725371,3578725406,35
3,897,11850,3578725371,3578725406,35
3,897,11851,3578725371,3578725409,38
3,897,11852,3578725371,3578725409,38
3,897,11853,3578725371,3578725410,39
3,897,11854,3578725371,3578725415,44
3,897,11855,3578725371,3578725415,44
3,897,11856,3578725371,3578725417,46
3,897,11857,3578725371,3578725417,46
3,897,11858,3578725371,3578725419,48
3,898,11859,3578725429,3578725429,0
3,898,11860,3578725429,3578725429,0
3,898,11861,3578725429,3578725429,0
3,898,11862,3578725429,3578725429,0
3,898,11863,3578725429,3578725429,0
3,898,11864,3578725429,3578725429,0
3,898,11865,3578725429,3578725429,0
3,898,11866,3578725429,3578725429,0
3,898,11867,3578725429,3578725429,0
3,898,11868,3578725429,3578725432,3
3,898,11869,3578725429,3578725432,3
3,898,11870,3578725429,3578725434,5
3,898,11871,3578725429,3578725436,7
3,898,11872,3578725429,3578725436,7
3,898,11873,3578725429,3578725439,10
3,898,11874,3578725429,3578725439,10
3,898,11875,3578725429,3578725439,10
3,898,11876,3578725429,3578725442,13
3,898,11877,3578725429,3578725443,14
3,898,11878,3578725429,3578725444,15
3,898,11879,3578725429,3578725447,18
3,898,11880,3578725429,3578725449,20
3,898,11881,3578725429,3578725450,21
3,898,11882,3578725429,3578725452,23
3,898,11883,3578725429,3578725455,26
3,898,11884,3578725429,3578725459,30
3,898,11885,3578725429,3578725461,32
3,898,11886,3578725429,3578725462,33
3,898,11887,3578725429,3578725464,35
3,898,11888,3578725429,3578725465,36
3,898,11889,3578725429,3578725465,36
3,898,11890,3578725429,3578725466,37
3,898,11891,3578725429,3578725470,41
3,898,11892,3578725429,3578725471,42
3,898,11893,3578725429,3578725471,42
3,898,11894,3578725429,3578725473,44
3,898,11895,3578725429,3578725478,49
3,898,11896,3578725429,3578725479,50
3,899,11897,3578725485,3578725485,0
3,899,11898,3578725485,3578725485,0
3,899,11899,3578725485,3578725485,0
3,899,11900,3578725485,3578725485,0
3,899,11901,3578725485,3578725485,0
3,899,11902,3578725485,3578725488,3
3,899,11903,3578725485,3578725490,5
3,899,11904,3578725485,3578725490,5
3,899,11905,3578725485,3578725492,7
3,899,11906,3578725485,3578725493,8
3,899,11907,3578725485,3578725495,10
3,899,11908,3578725485,3578725497,12
3,899,11909,3578725485,3578725500,15
3,899,11910,3578725485,3578725500,15
3,899,11911,3578725485,3578725502,17
3,899,11912,3578725485,3578725503,18
3,899,11913,3578725485,3578725503,18
3,899,11914,3578725485,3578725503,18
3,899,11915,3578725485,3578725510,25
3,899,11916,3578725485,3578725511,26
3,899,11917,3578725485,3578725512,27
3,899,11918,3578725485,3578725513,28
3,899,11919,3578725485,3578725517,32
3,899,11920,3578725485,3578725517,32
3,899,11921,3578725485,3578725519,34
3,899,11922,3578725485,3578725521,36
3,899,11923,3578725485,3578725521,36
3,899,11924,3578725485,3578725521,36
3,899,11925,3578725485,3578725525,40
3,899,11926,3578725485,3578725533,48
3,899,11927,3578725485,3578725535,50
3,900,11928,3578725542,3578725542,0
3,900,11929,3578725542,3578725542,0
3,900,11930,3578725542,3578725542,0
3,900,11931,3578725542,3578725542,0
3,900,11932,3578725542,3578725542,0
3,900,11933,3578725542,3578725542,0
3,900,11934,3578725542,3578725544,2
3,900,11935,3578725542,3578725545,3
3,900,11936,3578725542,3578725549,7
3,900,11937,3578725542,3578725550,8
3,900,11938,3578725542,3578725552,10
3,900,11939,3578725542,3578725552,10
3,900,11940,3578725542,3578725552,10
3,900,11941,3578725542,3578725553,11
3,900,11942,3578725542,3578725556,14
3,900,11943,3578725542,3578725557,15
3,900,11944,3578725542,3578725560,18
3,900,11945,3578725542,3578725562,20
3,900,11946,3578725542,3578725563,21
3,900,11947,3578725542,3578725565,23
3,900,11948,3578725542,3578725566,24
3,900,11949,3578725542,3578725566,24
3,900,11950,3578725542,3578725567,25
3,900,11951,3578725542,3578725569,27
3,900,11952,3578725542,3578725571,29
3,900,11953,3578725542,3578725571,29
3,900,11954,3578725542,3578725572,30
3,900,11955,3578725542,3578725575,33
3,900,11956,3578725542,3578725576,34
3,900,11957,3578725542,3578725578,36
3,900,11958,3578725542,3578725578,36
3,900,11959,3578725542,3578725581,39
3,900,11960,3578725542,3578725582,40
3,900,11961,3578725542,3578725583,41
3,900,11962,3578725542,3578725583,41
3,900,11963,3578725542,3578725584,42
3,900,11964,3578725542,3578725586,44
3,900,11965,3578725542,3578725586,44
3,900,11966,3578725542,3578725587,45
3,900,11967,3578725542,3578725587,45
3,900,11968,3578725542,3578725587,45
3,900,11969,3578725542,3578725587,45
3,900,11970,3578725542,3578725588,46
3,900,11971,3578725542,3578725589,47
3,900,11972,3578725542,3578725590,48
3,901,11973,3578725599,3578725599,0
3,901,11974,3578725599,3578725600,1
3,901,11975,3578725599,3578725602,3
3,901,11976,3578725599,3578725602,3
3,901,11977,3578725599,3578725603,4
3,901,11978,3578725599,3578725603,4
3,901,11979,3578725599,3578725604,5
3,901,11980,3578725599,3578725605,6
3,901,11981,3578725599,3578725605,6
3,901,11982,3578725599,3578725605,6
3,901,11983,3578725599,3578725608,9
3,901,11984,3578725599,3578725608,9
3,901,11985,3578725599,3578725609,10
3,901,11986,3578725599,3578725614,15
3,901,11987,3578725599,3578725614,15
3,901,11988,3578725599,3578725616,17
3,901,11989,3578725599,3578725618,19
3,901,11990,3578725599,3578725620,21
3,901,11991,3578725599,3578725621,22
3,901,11992,3578725599,3578725623,24
3,901,11993,3578725599,3578725624,25
3,901,11994,3578725599,3578725624,25
3,901,11995,3578725599,3578725625,26
3,901,11996,3578725599,3578725627,28
3,901,11997,3578725599,3578725627,28
3,901,11998,3578725599,3578725631,32
3,901,11999,3578725599,3578725631,32
3,901,12000,3578725599,3578725633,34
3,901,12001,3578725599,3578725635,36
3,901,12002,3578725599,3578725638,39
3,901,12003,3578725599,3578725639,40
3,901,12004,3578725599,3578725639,40
3,901,12005,3578725599,3578725641,42
3,901,12006,3578725599,3578725643,44
3,901,12007,3578725599,3578725643,44
3,901,12008,3578725599,3578725646,47
3,901,12009,3578725599,3578725648,49
3,902,12010,3578725655,3578725655,0
3,902,12011,3578725655,3578725655,0
3,902,12012,3578725655,3578725655,0
3,902,12013,3578725655,3578725655,0
3,902,12014,3578725655,3578725658,3
3,902,12015,3578725655,3578725660,5
3,902,12016,3578725655,3578725661,6
3,902,12017,3578725655,3578725663,8
3,902,12018,3578725655,3578725665,10
3,902,12019,3578725655,3578725668,13
3,902,12020,3578725655,3578725670,15
3,902,12021,3578725655,3578725670,15
3,902,12022,3578725655,3578725670,15
3,902,12023,3578725655,3578725673,18
3,902,12024,3578725655,3578725679,24
3,902,12025,3578725655,3578725680,25
3,902,12026,3578725655,3578725681,26
3,902,12027,3578725655,3578725682,27
3,902,12028,3578725655,3578725682,27
3,902,12029,3578725655,3578725682,27
3,902,12030,3578725655,3578725684,29
3,902,12031,3578725655,3578725688,33
3,902,12032,3578725655,3578725689,34
3,902,12033,3578725655,3578725690,35
3,902,12034,3578725655,3578725691,36
3,902,12035,3578725655,3578725693,38
3,902,12036,3578725655,3578725695,40
3,902,12037,3578725655,3578725697,42
3,902,12038,3578725655,3578725700,45
3,902,12039,3578725655,3578725701,46
3,902,12040,3578725655,3578725702,47
3,902,12041,3578725655,3578725703,48
3,902,12042,3578725655,3578725703,48
3,902,12043,3578725655,3578725703,48
3,903,12044,3578725712,3578725712,0
3,903,12045,3578725712,3578725712,0
3,903,12046,3578725712,3578725712,0
3,903,12047,3578725712,3578725712,0
3,903,12048,3578725712,3578725717,5
3,903,12049,3578725712,3578725717,5
3,903,12050,3578725712,3578725720,8
3,903,12051,3578725712,3578725721,9
3,903,12052,3578725712,3578725721,9
3,903,12053,3578725712,3578725725,13
3,903,12054,3578725712,3578725733,21
3,903,12055,3578725712,3578725735,23
3,903,12056,3578725712,3578725736,24
3,903,12057,3578725712,3578725737,25
3,903,12058,3578725712,3578725737,25
3,903,12059,3578725712,3578725738,26
3,903,12060,3578725712,3578725738,26
3,903,12061,3578725712,3578725740,28
3,903,12062,3578725712,3578725742,30
3,903,12063,3578725712,3578725745,33
3,903,12064,3578725712,3578725749,37
3,903,12065,3578725712,3578725750,38
3,903,12066,3578725712,3578725751,39
3,903,12067,3578725712,3578725752,40
3,903,12068,3578725712,3578725753,41
3,903,12069,3578725712,3578725754,42
3,903,12070,3578725712,3578725757,45
3,903,12071,3578725712,3578725757,45
3,903,12072,3578725712,3578725760,48
3,904,12073,3578725769,3578725769,0
3,904,12074,3578725769,3578725769,0
3,904,12075,3578725769,3578725769,0
3,904,12076,3578725769,3578725769,0
3,904,12077,3578725769,3578725769,0
3,904,12078,3578725769,3578725771,2
3,904,12079,3578725769,3578725771,2
3,904,12080,3578725769,3578725772,3
3,904,12081,3578725769,3578725775,6
3,904,12082,3578725769,3578725775,6
3,904,12083,3578725769,3578725779,10
3,904,12084,3578725769,3578725779,10
3,904,12085,3578725769,3578725781,12
3,904,12086,3578725769,3578725784,15
3,904,12087,3578725769,3578725785,16
3,904,12088,3578725769,3578725786,17
3,904,12089,3578725769,3578725787,18
3,904,12090,3578725769,3578725788,19
3,904,12091,3578725769,3578725788,19
3,904,12092,3578725769,3578725788,19
3,904,12093,3578725769,3578725788,19
3,904,12094,3578725769,3578725789,20
3,904,12095,3578725769,3578725789,20
3,904,12096,3578725769,3578725790,21
3,904,12097,3578725769,3578725791,22
3,904,12098,3578725769,3578725794,25
3,904,12099,3578725769,3578725801,32
3,904,12100,3578725769,3578725802,33
3,904,12101,3578725769,3578725802,33
3,904,12102,3578725769,3578725802,33
3,904,12103,3578725769,3578725803,34
3,904,12104,3578725769,3578725804,35
3,904,12105,3578725769,3578725804,35
3,904,12106,3578725769,3578725805,36
3,904,12107,3578725769,3578725805,36
3,904,12108,3578725769,3578725808,39
3,904,12109,3578725769,3578725808,39
3,904,12110,3578725769,3578725809,40
3,904,12111,3578725769,3578725813,44
3,904,12112,3578725769,3578725814,45
3,904,12113,3578725769,3578725814,45
3,904,12114,3578725769,3578725817,48
3,904,12115,3578725769,3578725818,49
3,905,12116,3578725825,3578725825,0
3,905,12117,3578725825,3578725825,0
3,905,12118,3578725825,3578725825,0
3,905,12119,3578725825,3578725825,0
3,905,12120,3578725825,3578725825,0
3,905,12121,3578725825,3578725825,0
3,905,12122,3578725825,3578725826,1
3,905,12123,3578725825,3578725827,2
3,905,12124,3578725825,3578725827,2
3,905,12125,3578725825,3578725831,6
3,905,12126,3578725825,3578725832,7
3,905,12127,3578725825,3578725833,8
3,905,12128,3578725825,3578725835,10
3,905,12129,3578725825,3578725835,10
3,905,12130,3578725825,3578725838,13
3,905,12131,3578725825,3578725838,13
3,905,12132,3578725825,3578725839,14
3,905,12133,3578725825,3578725842,17
3,905,12134,3578725825,3578725843,18
3,905,12135,3578725825,3578725843,18
3,905,12136,3578725825,3578725844,19
3,905,12137,3578725825,3578725847,22
3,905,12138,3578725825,3578725848,23
3,905,12139,3578725825,3578725850,25
3,905,12140,3578725825,3578725851,26
3,905,12141,3578725825,3578725853,28
3,905,12142,3578725825,3578725856,31
3,905,12143,3578725825,3578725858,33
3,905,12144,3578725825,3578725861,36
3,905,12145,3578725825,3578725861,36
3,905,12146,3578725825,3578725864,39
3,905,12147,3578725825,3578725864,39
3,905,12148,3578725825,3578725865,40
3,905,12149,3578725825,3578725870,45
3,905,12150,3578725825,3578725870,45
3,905,12151,3578725825,3578725870,45
3,905,12152,3578725825,3578725873,48
3,906,12153,3578725882,3578725882,0
3,906,12154,3578725882,3578725882,0
3,906,12155,3578725882,3578725882,0
3,906,12156,3578725882,3578725882,0
3,906,12157,3578725882,3578725882,0
3,906,12158,3578725882,3578725883,1
3,906,12159,3578725882,3578725885,3
3,906,12160,3578725882,3578725889,7
3,906,12161,3578725882,3578725889,7
3,906,12162,3578725882,3578725890,8
3,906,12163,3578725882,3578725891,9
3,906,12164,3578725882,3578725892,10
3,906,12165,3578725882,3578725895,13
3,906,12166,3578725882,3578725897,15
3,906,12167,3578725882,3578725902,20
3,906,12168,3578725882,3578725903,21
3,906,12169,3578725882,3578725903,21
3,906,12170,3578725882,3578725903,21
3,906,12171,3578725882,3578725909,27
3,906,12172,3578725882,3578725911,29
3,906,12173,3578725882,3578725912,30
3,906,12174,3578725882,3578725913,31
3,906,12175,3578725882,3578725917,35
3,906,12176,3578725882,3578725917,35
3,906,12177,3578725882,3578725920,38
3,906,12178,3578725882,3578725921,39
3,906,12179,3578725882,3578725921,39
3,906,12180,3578725882,3578725924,42
3,907,12181,3578725940,3578725940,0
3,907,12182,3578725940,3578725940,0
3,907,12183,3578725940,3578725940,0
3,907,12184,3578725940,3578725940,0
3,907,12185,3578725940,3578725940,0
3,907,12186,3578725940,3578725940,0
3,907,12187,3578725940,3578725940,0
3,907,12188,3578725940,3578725940,0
3,907,12189,3578725940,3578725945,5
3,907,12190,3578725940,3578725949,9
3,907,12191,3578725940,3578725951,11
3,907,12192,3578725940,3578725952,12
3,907,12193,3578725940,3578725952,12
3,907,12194,3578725940,3578725952,12
3,907,12195,3578725940,3578725954,14
3,907,12196,3578725940,3578725954,14
3,907,12197,3578725940,3578725956,16
3,907,12198,3578725940,3578725957,17
3,907,12199,3578725940,3578725960,20
3,907,12200,3578725940,3578725966,26
3,907,12201,3578725940,3578725966,26
3,907,12202,3578725940,3578725966,26
3,907,12203,3578725940,3578725967,27
3,907,12204,3578725940,3578725970,30
3,907,12205,3578725940,3578725971,31
3,907,12206,3578725940,3578725971,31
3,907,12207,3578725940,3578725972,32
3,907,12208,3578725940,3578725974,34
3,907,12209,3578725940,3578725975,35
3,907,12210,3578725940,3578725975,35
3,907,12211,3578725940,3578725978,38
3,907,12212,3578725940,3578725979,39
3,907,12213,3578725940,3578725980,40
3,907,12214,3578725940,3578725984,44
3,907,12215,3578725940,3578725985,45
3,907,12216,3578725940,3578725986,46
3,907,12217,3578725940,3578725987,47
3,907,12218,3578725940,3578725988,48
3,907,12219,3578725940,3578725988,48
3,907,12220,3578725940,3578725988,48
3,907,12221,3578725940,3578725988,48
3,907,12222,3578725940,3578725989,49
3,907,12223,3578725940,3578725990,50
3,908,12224,3578725996,3578725996,0
3,908,12225,3578725996,3578726001,5
3,908,12226,3578725996,3578726002,6
3,908,12227,3578725996,3578726003,7
3,908,12228,3578725996,3578726003,7
3,908,12229,3578725996,3578726003,7
3,908,12230,3578725996,3578726004,8
3,908,12231,3578725996,3578726005,9
3,908,12232,3578725996,3578726005,9
3,908,12233,3578725996,3578726005,9
3,908,12234,3578725996,3578726008,12
3,908,12235,3578725996,3578726008,12
3,908,12236,3578725996,3578726008,12
3,908,12237,3578725996,3578726014,18
3,908,12238,3578725996,3578726017,21
3,908,12239,3578725996,3578726019,23
3,908,12240,3578725996,3578726021,25
3,908,12241,3578725996,3578726023,27
3,908,12242,3578725996,3578726024,28
3,908,12243,3578725996,3578726024,28
3,908,12244,3578725996,3578726025,29
3,908,12245,3578725996,3578726026,30
3,908,12246,3578725996,3578726026,30
3,908,12247,3578725996,3578726027,31
3,908,12248,3578725996,3578726027,31
3,908,12249,3578725996,3578726031,35
3,908,12250,3578725996,3578726031,35
3,908,12251,3578725996,3578726034,38
3,908,12252,3578725996,3578726035,39
3,908,12253,3578725996,3578726036,40
3,908,12254,3578725996,3578726039,43
3,908,12255,3578725996,3578726039,43
3,908,12256,3578725996,3578726039,43
3,908,12257,3578725996,3578726042,46
3,908,12258,3578725996,3578726043,47
3,908,12259,3578725996,3578726043,47
3,909,12260,3578726053,3578726053,0
3,909,12261,3578726053,3578726054,1
3,909,12262,3578726053,3578726054,1
3,909,12263,3578726053,3578726054,1
3,909,12264,3578726053,3578726056,3
3,909,12265,3578726053,3578726058,5
3,909,12266,3578726053,3578726060,7
3,909,12267,3578726053,3578726062,9
3,909,12268,3578726053,3578726062,9
3,909,12269,3578726053,3578726064,11
3,909,12270,3578726053,3578726064,11
3,909,12271,3578726053,3578726065,12
3,909,12272,3578726053,3578726069,16
3,909,12273,3578726053,3578726070,17
3,909,12274,3578726053,3578726070,17
3,909,12275,3578726053,3578726074,21
3,909,12276,3578726053,3578726078,25
3,909,12277,3578726053,3578726080,27
3,909,12278,3578726053,3578726081,28
3,909,12279,3578726053,3578726082,29
3,909,12280,3578726053,3578726083,30
3,909,12281,3578726053,3578726083,30
3,909,12282,3578726053,3578726084,31
3,909,12283,3578726053,3578726088,35
3,909,12284,3578726053,3578726089,36
3,909,12285,3578726053,3578726090,37
3,909,12286,3578726053,3578726092,39
3,909,12287,3578726053,3578726093,40
3,909,12288,3578726053,3578726095,42
3,909,12289,3578726053,3578726097,44
3,909,12290,3578726053,3578726102,49
3,909,12291,3578726053,3578726103,50
3,910,12292,3578726111,3578726111,0
3,910,12293,3578726111,3578726111,0
3,910,12294,3578726111,3578726111,0
3,910,12295,3578726111,3578726112,1
3,910,12296,3578726111,3578726112,1
3,910,12297,3578726111,3578726113,2
3,910,12298,3578726111,3578726117,6
3,910,12299,3578726111,3578726117,6
3,910,12300,3578726111,3578726119,8
3,910,12301,3578726111,3578726121,10
3,910,12302,3578726111,3578726121,10
3,910,12303,3578726111,3578726126,15
3,910,12304,3578726111,3578726132,21
3,910,12305,3578726111,3578726136,25
3,910,12306,3578726111,3578726137,26
3,910,12307,3578726111,3578726138,27
3,910,12308,3578726111,3578726138,27
3,910,12309,3578726111,3578726139,28
3,910,12310,3578726111,3578726139,28
3,910,12311,3578726111,3578726139,28
3,910,12312,3578726111,3578726140,29
3,910,12313,3578726111,3578726142,31
3,910,12314,3578726111,3578726145,34
3,910,12315,3578726111,3578726145,34
3,910,12316,3578726111,3578726150,39
3,910,12317,3578726111,3578726151,40
3,910,12318,3578726111,3578726151,40
3,910,12319,3578726111,3578726152,41
3,910,12320,3578726111,3578726152,41
3,910,12321,3578726111,3578726153,42
3,910,12322,3578726111,3578726154,43
3,910,12323,3578726111,3578726154,43
3,910,12324,3578726111,3578726154,43
3,910,12325,3578726111,3578726157,46
3,910,12326,3578726111,3578726160,49
3,911,12327,3578726168,3578726168,0
3,911,12328,3578726168,3578726168,0
3,911,12329,3578726168,3578726168,0
3,911,12330,3578726168,3578726169,1
3,911,12331,3578726168,3578726171,3
3,911,12332,3578726168,3578726171,3
3,911,12333,3578726168,3578726172,4
3,911,12334,3578726168,3578726173,5
3,911,12335,3578726168,3578726177,9
3,911,12336,3578726168,3578726179,11
3,911,12337,3578726168,3578726179,11
3,911,12338,3578726168,3578726181,13
3,911,12339,3578726168,3578726184,16
3,911,12340,3578726168,3578726186,18
3,911,12341,3578726168,3578726186,18
3,911,12342,3578726168,3578726186,18
3,911,12343,3578726168,3578726187,19
3,911,12344,3578726168,3578726188,20
3,911,12345,3578726168,3578726188,20
3,911,12346,3578726168,3578726188,20
3,911,12347,3578726168,3578726189,21
3,911,12348,3578726168,3578726189,21
3,911,12349,3578726168,3578726190,22
3,911,12350,3578726168,3578726191,23
3,911,12351,3578726168,3578726191,23
3,911,12352,3578726168,3578726202,34
3,911,12353,3578726168,3578726203,35
3,911,12354,3578726168,3578726204,36
3,911,12355,3578726168,3578726204,36
3,911,12356,3578726168,3578726204,36
3,911,12357,3578726168,3578726205,37
3,911,12358,3578726168,3578726205,37
3,911,12359,3578726168,3578726205,37
3,911,12360,3578726168,3578726208,40
3,911,12361,3578726168,3578726208,40
3,911,12362,3578726168,3578726209,41
3,911,12363,3578726168,3578726214,46
3,911,12364,3578726168,3578726214,46
3,911,12365,3578726168,3578726217,49
3,911,12366,3578726168,3578726217,49
3,912,12367,3578726225,3578726225,0
3,912,12368,3578726225,3578726225,0
3,912,12369,3578726225,3578726225,0
3,912,12370,3578726225,3578726225,0
3,912,12371,3578726225,3578726225,0
3,912,12372,3578726225,3578726226,1
3,912,12373,3578726225,3578726227,2
3,912,12374,3578726225,3578726227,2
3,912,12375,3578726225,3578726227,2
3,912,12376,3578726225,3578726231,6
3,912,12377,3578726225,3578726232,7
3,912,12378,3578726225,3578726233,8
3,912,12379,3578726225,3578726233,8
3,912,12380,3578726225,3578726233,8
3,912,12381,3578726225,3578726235,10
3,912,12382,3578726225,3578726236,11
3,912,12383,3578726225,3578726239,14
3,912,12384,3578726225,3578726240,15
3,912,12385,3578726225,3578726240,15
3,912,12386,3578726225,3578726242,17
3,912,12387,3578726225,3578726243,18
3,912,12388,3578726225,3578726245,20
3,912,12389,3578726225,3578726247,22
3,912,12390,3578726225,3578726249,24
3,912,12391,3578726225,3578726251,26
3,912,12392,3578726225,3578726252,27
3,912,12393,3578726225,3578726254,29
3,912,12394,3578726225,3578726256,31
3,912,12395,3578726225,3578726258,33
3,912,12396,3578726225,3578726260,35
3,912,12397,3578726225,3578726261,36
3,912,12398,3578726225,3578726264,39
3,912,12399,3578726225,3578726264,39
3,912,12400,3578726225,3578726265,40
3,912,12401,3578726225,3578726268,43
3,912,12402,3578726225,3578726270,45
3,912,12403,3578726225,3578726270,45
3,912,12404,3578726225,3578726273,48
3,913,12405,3578726281,3578726281,0
3,913,12406,3578726281,3578726281,0
3,913,12407,3578726281,3578726281,0
3,913,12408,3578726281,3578726282,1
3,913,12409,3578726281,3578726282,1
3,913,12410,3578726281,3578726282,1
3,913,12411,3578726281,3578726283,2
3,913,12412,3578726281,3578726283,2
3,913,12413,3578726281,3578726284,3
3,913,12414,3578726281,3578726288,7
3,913,12415,3578726281,3578726289,8
3,913,12416,3578726281,3578726290,9
3,913,12417,3578726281,3578726292,11
3,913,12418,3578726281,3578726292,11
3,913,12419,3578726281,3578726295,14
3,913,12420,3578726281,3578726297,16
3,913,12421,3578726281,3578726300,19
3,913,12422,3578726281,3578726303,22
3,913,12423,3578726281,3578726303,22
3,913,12424,3578726281,3578726304,23
3,913,12425,3578726281,3578726309,28
3,913,12426,3578726281,3578726312,31
3,913,12427,3578726281,3578726313,32
3,913,12428,3578726281,3578726313,32
3,913,12429,3578726281,3578726317,36
3,913,12430,3578726281,3578726318,37
3,913,12431,3578726281,3578726319,38
3,913,12432,3578726281,3578726321,40
3,913,12433,3578726281,3578726322,41
3,913,12434,3578726281,3578726322,41
3,913,12435,3578726281,3578726326,45
3,914,12436,3578726337,3578726337,0
3,914,12437,3578726337,3578726337,0
3,914,12438,3578726337,3578726337,0
3,914,12439,3578726337,3578726338,1
3,914,12440,3578726337,3578726339,2
3,914,12441,3578726337,3578726339,2
3,914,12442,3578726337,3578726339,2
3,914,12443,3578726337,3578726340,3
3,914,12444,3578726337,3578726346,9
3,914,12445,3578726337,3578726346,9
3,914,12446,3578726337,3578726350,13
3,914,12447,3578726337,3578726351,14
3,914,12448,3578726337,3578726351,14
3,914,12449,3578726337,3578726352,15
3,914,12450,3578726337,3578726353,16
3,914,12451,3578726337,3578726354,17
3,914,12452,3578726337,3578726355,18
3,914,12453,3578726337,3578726355,18
3,914,12454,3578726337,3578726357,20
3,914,12455,3578726337,3578726358,21
3,914,12456,3578726337,3578726360,23
3,914,12457,3578726337,3578726365,28
3,914,12458,3578726337,3578726365,28
3,914,12459,3578726337,3578726366,29
3,914,12460,3578726337,3578726366,29
3,914,12461,3578726337,3578726367,30
3,914,12462,3578726337,3578726369,32
3,914,12463,3578726337,3578726371,34
3,914,12464,3578726337,3578726371,34
3,914,12465,3578726337,3578726373,36
3,914,12466,3578726337,3578726373,36
3,914,12467,3578726337,3578726375,38
3,914,12468,3578726337,3578726377,40
3,914,12469,3578726337,3578726379,42
3,914,12470,3578726337,3578726379,42
3,914,12471,3578726337,3578726382,45
3,914,12472,3578726337,3578726383,46
3,914,12473,3578726337,3578726385,48
3,914,12474,3578726337,3578726386,49
3,914,12475,3578726337,3578726386,49
3,915,12476,3578726394,3578726394,0
3,915,12477,3578726394,3578726394,0
3,915,12478,3578726394,3578726394,0
3,915,12479,3578726394,3578726394,0
3,915,12480,3578726394,3578726394,0
3,915,12481,3578726394,3578726394,0
3,915,12482,3578726394,3578726395,1
3,915,12483,3578726394,3578726401,7
3,915,12484,3578726394,3578726403,9
3,915,12485,3578726394,3578726403,9
3,915,12486,3578726394,3578726404,10
3,915,12487,3578726394,3578726404,10
3,915,12488,3578726394,3578726405,11
3,915,12489,3578726394,3578726405,11
3,915,12490,3578726394,3578726405,11
3,915,12491,3578726394,3578726405,11
3,915,12492,3578726394,3578726406,12
3,915,12493,3578726394,3578726408,14
3,915,12494,3578726394,3578726408,14
3,915,12495,3578726394,3578726408,14
3,915,12496,3578726394,3578726415,21
3,915,12497,3578726394,3578726416,22
3,915,12498,3578726394,3578726417,23
3,915,12499,3578726394,3578726417,23
3,915,12500,3578726394,3578726420,26
3,915,12501,3578726394,3578726421,27
3,915,12502,3578726394,3578726423,29
3,915,12503,3578726394,3578726423,29
3,915,12504,3578726394,3578726426,32
3,915,12505,3578726394,3578726427,33
3,915,12506,3578726394,3578726427,33
3,915,12507,3578726394,3578726428,34
3,915,12508,3578726394,3578726432,38
3,915,12509,3578726394,3578726433,39
3,915,12510,3578726394,3578726434,40
3,915,12511,3578726394,3578726434,40
3,915,12512,3578726394,3578726436,42
3,915,12513,3578726394,3578726436,42
3,915,12514,3578726394,3578726437,43
3,915,12515,3578726394,3578726439,45
3,915,12516,3578726394,3578726439,45
3,915,12517,3578726394,3578726440,46
3,915,12518,3578726394,3578726442,48
3,915,12519,3578726394,3578726443,49
3,915,12520,3578726394,3578726444,50
3,916,12521,3578726453,3578726453,0
3,916,12522,3578726453,3578726453,0
3,916,12523,3578726453,3578726453,0
3,916,12524,3578726453,3578726453,0
3,916,12525,3578726453,3578726454,1
3,916,12526,3578726453,3578726456,3
3,916,12527,3578726453,3578726458,5
3,916,12528,3578726453,3578726460,7
3,916,12529,3578726453,3578726462,9
3,916,12530,3578726453,3578726462,9
3,916,12531,3578726453,3578726464,11
3,916,12532,3578726453,3578726465,12
3,916,12533,3578726453,3578726465,12
3,916,12534,3578726453,3578726470,17
3,916,12535,3578726453,3578726470,17
3,916,12536,3578726453,3578726471,18
3,916,12537,3578726453,3578726472,19
3,916,12538,3578726453,3578726473,20
3,916,12539,3578726453,3578726479,26
3,916,12540,3578726453,3578726480,27
3,916,12541,3578726453,3578726481,28
3,916,12542,3578726453,3578726482,29
3,916,12543,3578726453,3578726482,29
3,916,12544,3578726453,3578726482,29
3,916,12545,3578726453,3578726483,30
3,916,12546,3578726453,3578726483,30
3,916,12547,3578726453,3578726484,31
3,916,12548,3578726453,3578726488,35
3,916,12549,3578726453,3578726490,37
3,916,12550,3578726453,3578726490,37
3,916,12551,3578726453,3578726492,39
3,916,12552,3578726453,3578726495,42
3,916,12553,3578726453,3578726497,44
3,916,12554,3578726453,3578726500,47
3,916,12555,3578726453,3578726500,47
3,916,12556,3578726453,3578726503,50
3,917,12557,3578726510,3578726510,0
3,917,12558,3578726510,3578726510,0
3,917,12559,3578726510,3578726510,0
3,917,12560,3578726510,3578726511,1
3,917,12561,3578726510,3578726511,1
3,917,12562,3578726510,3578726513,3
3,917,12563,3578726510,3578726517,7
3,917,12564,3578726510,3578726517,7
3,917,12565,3578726510,3578726518,8
3,917,12566,3578726510,3578726520,10
3,917,12567,3578726510,3578726521,11
3,917,12568,3578726510,3578726524,14
3,917,12569,3578726510,3578726532,22
3,917,12570,3578726510,3578726535,25
3,917,12571,3578726510,3578726535,25
3,917,12572,3578726510,3578726538,28
3,917,12573,3578726510,3578726538,28
3,917,12574,3578726510,3578726538,28
3,917,12575,3578726510,3578726538,28
3,917,12576,3578726510,3578726538,28
3,917,12577,3578726510,3578726540,30
3,917,12578,3578726510,3578726542,32
3,917,12579,3578726510,3578726545,35
3,917,12580,3578726510,3578726545,35
3,917,12581,3578726510,3578726549,39
3,917,12582,3578726510,3578726550,40
3,917,12583,3578726510,3578726551,41
3,917,12584,3578726510,3578726551,41
3,917,12585,3578726510,3578726552,42
3,917,12586,3578726510,3578726553,43
3,917,12587,3578726510,3578726554,44
3,917,12588,3578726510,3578726554,44
3,917,12589,3578726510,3578726557,47
3,917,12590,3578726510,3578726557,47
3,917,12591,3578726510,3578726559,49
3,918,12592,3578726568,3578726568,0
3,918,12593,3578726568,3578726568,0
3,918,12594,3578726568,3578726568,0
3,918,12595,3578726568,3578726568,0
3,918,12596,3578726568,3578726568,0
3,918,12597,3578726568,3578726568,0
3,918,12598,3578726568,3578726570,2
3,918,12599,3578726568,3578726571,3
3,918,12600,3578726568,3578726571,3
3,918,12601,3578726568,3578726573,5
3,918,12602,3578726568,3578726575,7
3,918,12603,3578726568,3578726576,8
3,918,12604,3578726568,3578726578,10
3,918,12605,3578726568,3578726579,11
3,918,12606,3578726568,3578726581,13
3,918,12607,3578726568,3578726583,15
3,918,12608,3578726568,3578726585,17
3,918,12609,3578726568,3578726585,17
3,918,12610,3578726568,3578726586,18
3,918,12611,3578726568,3578726587,19
3,918,12612,3578726568,3578726587,19
3,918,12613,3578726568,3578726587,19
3,918,12614,3578726568,3578726587,19
3,918,12615,3578726568,3578726588,20
3,918,12616,3578726568,3578726588,20
3,918,12617,3578726568,3578726591,23
3,918,12618,3578726568,3578726593,25
3,918,12619,3578726568,3578726601,33
3,918,12620,3578726568,3578726602,34
3,918,12621,3578726568,3578726603,35
3,918,12622,3578726568,3578726603,35
3,918,12623,3578726568,3578726604,36
3,918,12624,3578726568,3578726604,36
3,918,12625,3578726568,3578726604,36
3,918,12626,3578726568,3578726605,37
3,918,12627,3578726568,3578726605,37
3,918,12628,3578726568,3578726605,37
3,918,12629,3578726568,3578726607,39
3,918,12630,3578726568,3578726607,39
3,918,12631,3578726568,3578726608,40
3,918,12632,3578726568,3578726613,45
3,918,12633,3578726568,3578726616,48
3,918,12634,3578726568,3578726616,48
3,918,12635,3578726568,3578726616,48
3,919,12636,3578726626,3578726626,0
3,919,12637,3578726626,3578726626,0
3,919,12638,3578726626,3578726626,0
3,919,12639,3578726626,3578726626,0
3,919,12640,3578726626,3578726626,0
3,919,12641,3578726626,3578726626,0
3,919,12642,3578726626,3578726627,1
3,919,12643,3578726626,3578726628,2
3,919,12644,3578726626,3578726628,2
3,919,12645,3578726626,3578726630,4
3,919,12646,3578726626,3578726631,5
3,919,12647,3578726626,3578726631,5
3,919,12648,3578726626,3578726632,6
3,919,12649,3578726626,3578726633,7
3,919,12650,3578726626,3578726633,7
3,919,12651,3578726626,3578726635,9
3,919,12652,3578726626,3578726636,10
3,919,12653,3578726626,3578726636,10
3,919,12654,3578726626,3578726638,12
3,919,12655,3578726626,3578726639,13
3,919,12656,3578726626,3578726639,13
3,919,12657,3578726626,3578726640,14
3,919,12658,3578726626,3578726643,17
3,919,12659,3578726626,3578726643,17
3,919,12660,3578726626,3578726644,18
3,919,12661,3578726626,3578726646,20
3,919,12662,3578726626,3578726649,23
3,919,12663,3578726626,3578726651,25
3,919,12664,3578726626,3578726653,27
3,919,12665,3578726626,3578726656,30
3,919,12666,3578726626,3578726657,31
3,919,12667,3578726626,3578726659,33
3,919,12668,3578726626,3578726661,35
3,919,12669,3578726626,3578726661,35
3,919,12670,3578726626,3578726663,37
3,919,12671,3578726626,3578726663,37
3,919,12672,3578726626,3578726665,39
3,919,12673,3578726626,3578726669,43
3,919,12674,3578726626,3578726670,44
3,919,12675,3578726626,3578726670,44
3,919,12676,3578726626,3578726672,46
3,919,12677,3578726626,3578726673,47
3,920,12678,3578726683,3578726683,0
3,920,12679,3578726683,3578726683,0
3,920,12680,3578726683,3578726683,0
3,920,12681,3578726683,3578726683,0
3,920,12682,3578726683,3578726683,0
3,920,12683,3578726683,3578726683,0
3,920,12684,3578726683,3578726683,0
3,920,12685,3578726683,3578726684,1
3,920,12686,3578726683,3578726685,2
3,920,12687,3578726683,3578726688,5
3,920,12688,3578726683,3578726690,7
3,920,12689,3578726683,3578726691,8
3,920,12690,3578726683,3578726692,9
3,920,12691,3578726683,3578726695,12
3,920,12692,3578726683,3578726697,14
3,920,12693,3578726683,3578726700,17
3,920,12694,3578726683,3578726700,17
3,920,12695,3578726683,3578726703,20
3,920,12696,3578726683,3578726703,20
3,920,12697,3578726683,3578726704,21
3,920,12698,3578726683,3578726704,21
3,920,12699,3578726683,3578726709,26
3,920,12700,3578726683,3578726711,28
3,920,12701,3578726683,3578726712,29
3,920,12702,3578726683,3578726712,29
3,920,12703,3578726683,3578726717,34
3,920,12704,3578726683,3578726717,34
3,920,12705,3578726683,3578726719,36
3,920,12706,3578726683,3578726719,36
3,920,12707,3578726683,3578726722,39
3,920,12708,3578726683,3578726725,42
3,921,12709,3578726739,3578726739,0
3,921,12710,3578726739,3578726739,0
3,921,12711,3578726739,3578726739,0
3,921,12712,3578726739,3578726739,0
3,921,12713,3578726739,3578726739,0
3,921,12714,3578726739,3578726739,0
3,921,12715,3578726739,3578726740,1
3,921,12716,3578726739,3578726740,1
3,921,12717,3578726739,3578726740,1
3,921,12718,3578726739,3578726742,3
3,921,12719,3578726739,3578726745,6
3,921,12720,3578726739,3578726746,7
3,921,12721,3578726739,3578726746,7
3,921,12722,3578726739,3578726749,10
3,921,12723,3578726739,3578726750,11
3,921,12724,3578726739,3578726751,12
3,921,12725,3578726739,3578726751,12
3,921,12726,3578726739,3578726753,14
3,921,12727,3578726739,3578726753,14
3,921,12728,3578726739,3578726754,15
3,921,12729,3578726739,3578726755,16
3,921,12730,3578726739,3578726757,18
3,921,12731,3578726739,3578726757,18
3,921,12732,3578726739,3578726760,21
3,921,12733,3578726739,3578726764,25
3,921,12734,3578726739,3578726765,26
3,921,12735,3578726739,3578726765,26
3,921,12736,3578726739,3578726766,27
3,921,12737,3578726739,3578726768,29
3,921,12738,3578726739,3578726770,31
3,921,12739,3578726739,3578726771,32
3,921,12740,3578726739,3578726771,32
3,921,12741,3578726739,3578726774,35
3,921,12742,3578726739,3578726775,36
3,921,12743,3578726739,3578726776,37
3,921,12744,3578726739,3578726777,38
3,921,12745,3578726739,3578726779,40
3,921,12746,3578726739,3578726781,42
3,921,12747,3578726739,3578726782,43
3,921,12748,3578726739,3578726785,46
3,921,12749,3578726739,3578726785,46
3,921,12750,3578726739,3578726785,46
3,921,12751,3578726739,3578726786,47
3,921,12752,3578726739,3578726787,48
3,921,12753,3578726739,3578726787,48
3,921,12754,3578726739,3578726787,48
3,921,12755,3578726739,3578726788,49
3,921,12756,3578726739,3578726788,49
3,921,12757,3578726739,3578726788,49
3,921,12758,3578726739,3578726789,50
3,922,12759,3578726796,3578726796,0
3,922,12760,3578726796,3578726801,5
3,922,12761,3578726796,3578726802,6
3,922,12762,3578726796,3578726803,7
3,922,12763,3578726796,3578726803,7
3,922,12764,3578726796,3578726804,8
3,922,12765,3578726796,3578726804,8
3,922,12766,3578726796,3578726805,9
3,922,12767,3578726796,3578726805,9
3,922,12768,3578726796,3578726805,9
3,922,12769,3578726796,3578726805,9
3,922,12770,3578726796,3578726807,11
3,922,12771,3578726796,3578726807,11
3,922,12772,3578726796,3578726808,12
3,922,12773,3578726796,3578726815,19
3,922,12774,3578726796,3578726816,20
3,922,12775,3578726796,3578726816,20
3,922,12776,3578726796,3578726822,26
3,922,12777,3578726796,3578726822,26
3,922,12778,3578726796,3578726823,27
3,922,12779,3578726796,3578726824,28
3,922,12780,3578726796,3578726825,29
3,922,12781,3578726796,3578726826,30
3,922,12782,3578726796,3578726827,31
3,922,12783,3578726796,3578726827,31
3,922,12784,3578726796,3578726828,32
3,922,12785,3578726796,3578726830,34
3,922,12786,3578726796,3578726831,35
3,922,12787,3578726796,3578726831,35
3,922,12788,3578726796,3578726832,36
3,922,12789,3578726796,3578726833,37
3,922,12790,3578726796,3578726834,38
3,922,12791,3578726796,3578726835,39
3,922,12792,3578726796,3578726836,40
3,922,12793,3578726796,3578726838,42
3,922,12794,3578726796,3578726839,43
3,922,12795,3578726796,3578726839,43
3,922,12796,3578726796,3578726841,45
3,922,12797,3578726796,3578726843,47
3,922,12798,3578726796,3578726844,48
3,923,12799,3578726853,3578726853,0
3,923,12800,3578726853,3578726853,0
3,923,12801,3578726853,3578726853,0
3,923,12802,3578726853,3578726856,3
3,923,12803,3578726853,3578726857,4
3,923,12804,3578726853,3578726861,8
3,923,12805,3578726853,3578726862,9
3,923,12806,3578726853,3578726864,11
3,923,12807,3578726853,3578726864,11
3,923,12808,3578726853,3578726864,11
3,923,12809,3578726853,3578726869,16
3,923,12810,3578726853,3578726870,17
3,923,12811,3578726853,3578726870,17
3,923,12812,3578726853,3578726873,20
3,923,12813,3578726853,3578726873,20
3,923,12814,3578726853,3578726879,26
3,923,12815,3578726853,3578726880,27
3,923,12816,3578726853,3578726881,28
3,923,12817,3578726853,3578726882,29
3,923,12818,3578726853,3578726882,29
3,923,12819,3578726853,3578726883,30
3,923,12820,3578726853,3578726883,30
3,923,12821,3578726853,3578726884,31
3,923,12822,3578726853,3578726885,32
3,923,12823,3578726853,3578726889,36
3,923,12824,3578726853,3578726890,37
3,923,12825,3578726853,3578726891,38
3,923,12826,3578726853,3578726893,40
3,923,12827,3578726853,3578726895,42
3,923,12828,3578726853,3578726897,44
3,923,12829,3578726853,3578726900,47
3,923,12830,3578726853,3578726900,47
3,923,12831,3578726853,3578726903,50
3,924,12832,3578726909,3578726910,1
3,924,12833,3578726909,3578726910,1
3,924,12834,3578726909,3578726910,1
3,924,12835,3578726909,3578726910,1
3,924,12836,3578726909,3578726911,2
3,924,12837,3578726909,3578726912,3
3,924,12838,3578726909,3578726913,4
3,924,12839,3578726909,3578726917,8
3,924,12840,3578726909,3578726918,9
3,924,12841,3578726909,3578726919,10
3,924,12842,3578726909,3578726920,11
3,924,12843,3578726909,3578726922,13
3,924,12844,3578726909,3578726925,16
3,924,12845,3578726909,3578726934,25
3,924,12846,3578726909,3578726935,26
3,924,12847,3578726909,3578726938,29
3,924,12848,3578726909,3578726938,29
3,924,12849,3578726909,3578726938,29
3,924,12850,3578726909,3578726939,30
3,924,12851,3578726909,3578726939,30
3,924,12852,3578726909,3578726939,30
3,924,12853,3578726909,3578726940,31
3,924,12854,3578726909,3578726942,33
3,924,12855,3578726909,3578726945,36
3,924,12856,3578726909,3578726946,37
3,924,12857,3578726909,3578726946,37
3,924,12858,3578726909,3578726948,39
3,924,12859,3578726909,3578726951,42
3,924,12860,3578726909,3578726952,43
3,924,12861,3578726909,3578726953,44
3,924,12862,3578726909,3578726954,45
3,924,12863,3578726909,3578726955,46
3,924,12864,3578726909,3578726955,46
3,924,12865,3578726909,3578726955,46
3,924,12866,3578726909,3578726957,48
3,925,12867,3578726967,3578726967,0
3,925,12868,3578726967,3578726967,0
3,925,12869,3578726967,3578726967,0
3,925,12870,3578726967,3578726967,0
3,925,12871,3578726967,3578726967,0
3,925,12872,3578726967,3578726967,0
3,925,12873,3578726967,3578726968,1
3,925,12874,3578726967,3578726971,4
3,925,12875,3578726967,3578726971,4
3,925,12876,3578726967,3578726972,5
3,925,12877,3578726967,3578726975,8
3,925,12878,3578726967,3578726975,8
3,925,12879,3578726967,3578726976,9
3,925,12880,3578726967,3578726978,11
3,925,12881,3578726967,3578726979,12
3,925,12882,3578726967,3578726981,14
3,925,12883,3578726967,3578726983,16
3,925,12884,3578726967,3578726984,17
3,925,12885,3578726967,3578726985,18
3,925,12886,3578726967,3578726985,18
3,925,12887,3578726967,3578726986,19
3,925,12888,3578726967,3578726987,20
3,925,12889,3578726967,3578726987,20
3,925,12890,3578726967,3578726987,20
3,925,12891,3578726967,3578726988,21
3,925,12892,3578726967,3578726988,21
3,925,12893,3578726967,3578726988,21
3,925,12894,3578726967,3578726989,22
3,925,12895,3578726967,3578726989,22
3,925,12896,3578726967,3578726990,23
3,925,12897,3578726967,3578726991,24
3,925,12898,3578726967,3578726994,27
3,925,12899,3578726967,3578727002,35
3,925,12900,3578726967,3578727003,36
3,925,12901,3578726967,3578727004,37
3,925,12902,3578726967,3578727004,37
3,925,12903,3578726967,3578727004,37
3,925,12904,3578726967,3578727005,38
3,925,12905,3578726967,3578727005,38
3,925,12906,3578726967,3578727005,38
3,925,12907,3578726967,3578727005,38
3,925,12908,3578726967,3578727007,40
3,925,12909,3578726967,3578727008,41
3,925,12910,3578726967,3578727009,42
3,925,12911,3578726967,3578727015,48
3,925,12912,3578726967,3578727016,49
3,925,12913,3578726967,3578727017,50
3,926,12914,3578727024,3578727024,0
3,926,12915,3578727024,3578727024,0
3,926,12916,3578727024,3578727024,0
3,926,12917,3578727024,3578727024,0
3,926,12918,3578727024,3578727024,0
3,926,12919,3578727024,3578727024,0
3,926,12920,3578727024,3578727026,2
3,926,12921,3578727024,3578727027,3
3,926,12922,3578727024,3578727027,3
3,926,12923,3578727024,3578727027,3
3,926,12924,3578727024,3578727028,4
3,926,12925,3578727024,3578727031,7
3,926,12926,3578727024,3578727031,7
3,926,12927,3578727024,3578727032,8
3,926,12928,3578727024,3578727033,9
3,926,12929,3578727024,3578727033,9
3,926,12930,3578727024,3578727034,10
3,926,12931,3578727024,3578727035,11
3,926,12932,3578727024,3578727036,12
3,926,12933,3578727024,3578727036,12
3,926,12934,3578727024,3578727037,13
3,926,12935,3578727024,3578727038,14
3,926,12936,3578727024,3578727040,16
3,926,12937,3578727024,3578727040,16
3,926,12938,3578727024,3578727040,16
3,926,12939,3578727024,3578727043,19
3,926,12940,3578727024,3578727043,19
3,926,12941,3578727024,3578727047,23
3,926,12942,3578727024,3578727050,26
3,926,12943,3578727024,3578727050,26
3,926,12944,3578727024,3578727052,28
3,926,12945,3578727024,3578727053,29
3,926,12946,3578727024,3578727056,32
3,926,12947,3578727024,3578727057,33
3,926,12948,3578727024,3578727061,37
3,926,12949,3578727024,3578727062,38
3,926,12950,3578727024,3578727063,39
3,926,12951,3578727024,3578727064,40
3,926,12952,3578727024,3578727065,41
3,926,12953,3578727024,3578727069,45
3,926,12954,3578727024,3578727070,46
3,926,12955,3578727024,3578727072,48
3,926,12956,3578727024,3578727073,49
3,927,12957,3578727080,3578727080,0
3,927,12958,3578727080,3578727080,0
3,927,12959,3578727080,3578727081,1
3,927,12960,3578727080,3578727081,1
3,927,12961,3578727080,3578727082,2
3,927,12962,3578727080,3578727083,3
3,927,12963,3578727080,3578727083,3
3,927,12964,3578727080,3578727084,4
3,927,12965,3578727080,3578727086,6
3,927,12966,3578727080,3578727089,9
3,927,12967,3578727080,3578727090,10
3,927,12968,3578727080,3578727091,11
3,927,12969,3578727080,3578727092,12
3,927,12970,3578727080,3578727093,13
3,927,12971,3578727080,3578727095,15
3,927,12972,3578727080,3578727097,17
3,927,12973,3578727080,3578727101,21
3,927,12974,3578727080,3578727101,21
3,927,12975,3578727080,3578727103,23
3,927,12976,3578727080,3578727104,24
3,927,12977,3578727080,3578727106,26
3,927,12978,3578727080,3578727109,29
3,927,12979,3578727080,3578727109,29
3,927,12980,3578727080,3578727111,31
3,927,12981,3578727080,3578727112,32
3,927,12982,3578727080,3578727113,33
3,927,12983,3578727080,3578727118,38
3,927,12984,3578727080,3578727118,38
3,927,12985,3578727080,3578727120,40
3,927,12986,3578727080,3578727120,40
3,927,12987,3578727080,3578727120,40
3,927,12988,3578727080,3578727122,42
3,927,12989,3578727080,3578727125,45
3,928,12990,3578727138,3578727138,0
3,928,12991,3578727138,3578727138,0
3,928,12992,3578727138,3578727138,0
3,928,12993,3578727138,3578727139,1
3,928,12994,3578727138,3578727139,1
3,928,12995,3578727138,3578727140,2
3,928,12996,3578727138,3578727140,2
3,928,12997,3578727138,3578727140,2
3,928,12998,3578727138,3578727141,3
3,928,12999,3578727138,3578727144,6
3,928,13000,3578727138,3578727146,8
3,928,13001,3578727138,3578727146,8
3,928,13002,3578727138,3578727150,12
3,928,13003,3578727138,3578727151,13
3,928,13004,3578727138,3578727152,14
3,928,13005,3578727138,3578727154,16
3,928,13006,3578727138,3578727154,16
3,928,13007,3578727138,3578727154,16
3,928,13008,3578727138,3578727155,17
3,928,13009,3578727138,3578727155,17
3,928,13010,3578727138,3578727157,19
3,928,13011,3578727138,3578727158,20
3,928,13012,3578727138,3578727159,21
3,928,13013,3578727138,3578727160,22
3,928,13014,3578727138,3578727164,26
3,928,13015,3578727138,3578727166,28
3,928,13016,3578727138,3578727166,28
3,928,13017,3578727138,3578727166,28
3,928,13018,3578727138,3578727167,29
3,928,13019,3578727138,3578727170,32
3,928,13020,3578727138,3578727171,33
3,928,13021,3578727138,3578727172,34
3,928,13022,3578727138,3578727174,36
3,928,13023,3578727138,3578727176,38
3,928,13024,3578727138,3578727176,38
3,928,13025,3578727138,3578727178,40
3,928,13026,3578727138,3578727178,40
3,928,13027,3578727138,3578727182,44
3,928,13028,3578727138,3578727183,45
3,928,13029,3578727138,3578727184,46
3,928,13030,3578727138,3578727185,47
3,928,13031,3578727138,3578727186,48
3,928,13032,3578727138,3578727186,48
3,928,13033,3578727138,3578727187,49
3,928,13034,3578727138,3578727188,50
3,928,13035,3578727138,3578727188,50
3,929,13036,3578727194,3578727194,0
3,929,13037,3578727194,3578727194,0
3,929,13038,3578727194,3578727194,0
3,929,13039,3578727194,3578727194,0
3,929,13040,3578727194,3578727194,0
3,929,13041,3578727194,3578727194,0
3,929,13042,3578727194,3578727194,0
3,929,13043,3578727194,3578727195,1
3,929,13044,3578727194,3578727203,9
3,929,13045,3578727194,3578727203,9
3,929,13046,3578727194,3578727203,9
3,929,13047,3578727194,3578727204,10
3,929,13048,3578727194,3578727204,10
3,929,13049,3578727194,3578727205,11
3,929,13050,3578727194,3578727205,11
3,929,13051,3578727194,3578727205,11
3,929,13052,3578727194,3578727207,13
3,929,13053,3578727194,3578727208,14
3,929,13054,3578727194,3578727208,14
3,929,13055,3578727194,3578727210,16
3,929,13056,3578727194,3578727214,20
3,929,13057,3578727194,3578727216,22
3,929,13058,3578727194,3578727216,22
3,929,13059,3578727194,3578727216,22
3,929,13060,3578727194,3578727222,28
3,929,13061,3578727194,3578727222,28
3,929,13062,3578727194,3578727223,29
3,929,13063,3578727194,3578727224,30
3,929,13064,3578727194,3578727224,30
3,929,13065,3578727194,3578727225,31
3,929,13066,3578727194,3578727225,31
3,929,13067,3578727194,3578727227,33
3,929,13068,3578727194,3578727227,33
3,929,13069,3578727194,3578727228,34
3,929,13070,3578727194,3578727229,35
3,929,13071,3578727194,3578727231,37
3,929,13072,3578727194,3578727232,38
3,929,13073,3578727194,3578727232,38
3,929,13074,3578727194,3578727233,39
3,929,13075,3578727194,3578727234,40
3,929,13076,3578727194,3578727235,41
3,929,13077,3578727194,3578727235,41
3,929,13078,3578727194,3578727236,42
3,929,13079,3578727194,3578727236,42
3,929,13080,3578727194,3578727238,44
3,929,13081,3578727194,3578727239,45
3,929,13082,3578727194,3578727240,46
3,929,13083,3578727194,3578727240,46
3,929,13084,3578727194,3578727243,49
3,930,13085,3578727251,3578727251,0
3,930,13086,3578727251,3578727251,0
3,930,13087,3578727251,3578727251,0
3,930,13088,3578727251,3578727251,0
3,930,13089,3578727251,3578727254,3
3,930,13090,3578727251,3578727256,5
3,930,13091,3578727251,3578727259,8
3,930,13092,3578727251,3578727261,10
3,930,13093,3578727251,3578727261,10
3,930,13094,3578727251,3578727264,13
3,930,13095,3578727251,3578727264,13
3,930,13096,3578727251,3578727264,13
3,930,13097,3578727251,3578727265,14
3,930,13098,3578727251,3578727269,18
3,930,13099,3578727251,3578727270,19
3,930,13100,3578727251,3578727272,21
3,930,13101,3578727251,3578727273,22
3,930,13102,3578727251,3578727279,28
3,930,13103,3578727251,3578727280,29
3,930,13104,3578727251,3578727281,30
3,930,13105,3578727251,3578727282,31
3,930,13106,3578727251,3578727282,31
3,930,13107,3578727251,3578727283,32
3,930,13108,3578727251,3578727284,33
3,930,13109,3578727251,3578727285,34
3,930,13110,3578727251,3578727288,37
3,930,13111,3578727251,3578727289,38
3,930,13112,3578727251,3578727292,41
3,930,13113,3578727251,3578727292,41
3,930,13114,3578727251,3578727293,42
3,930,13115,3578727251,3578727295,44
3,930,13116,3578727251,3578727300,49
3,931,13117,3578727308,3578727308,0
3,931,13118,3578727308,3578727308,0
3,931,13119,3578727308,3578727308,0
3,931,13120,3578727308,3578727308,0
3,931,13121,3578727308,3578727308,0
3,931,13122,3578727308,3578727308,0
3,931,13123,3578727308,3578727309,1
3,931,13124,3578727308,3578727310,2
3,931,13125,3578727308,3578727313,5
3,931,13126,3578727308,3578727318,10
3,931,13127,3578727308,3578727319,11
3,931,13128,3578727308,3578727320,12
3,931,13129,3578727308,3578727320,12
3,931,13130,3578727308,3578727322,14
3,931,13131,3578727308,3578727323,15
3,931,13132,3578727308,3578727326,18
3,931,13133,3578727308,3578727333,25
3,931,13134,3578727308,3578727336,28
3,931,13135,3578727308,3578727338,30
3,931,13136,3578727308,3578727339,31
3,931,13137,3578727308,3578727339,31
3,931,13138,3578727308,3578727339,31
3,931,13139,3578727308,3578727340,32
3,931,13140,3578727308,3578727340,32
3,931,13141,3578727308,3578727341,33
3,931,13142,3578727308,3578727342,34
3,931,13143,3578727308,3578727345,37
3,931,13144,3578727308,3578727346,38
3,931,13145,3578727308,3578727350,42
3,931,13146,3578727308,3578727351,43
3,931,13147,3578727308,3578727351,43
3,931,13148,3578727308,3578727352,44
3,931,13149,3578727308,3578727354,46
3,931,13150,3578727308,3578727354,46
3,931,13151,3578727308,3578727354,46
3,931,13152,3578727308,3578727354,46
3,931,13153,3578727308,3578727355,47
3,931,13154,3578727308,3578727357,49
3,931,13155,3578727308,3578727358,50
3,932,13156,3578727364,3578727364,0
3,932,13157,3578727364,3578727364,0
3,932,13158,3578727364,3578727365,1
3,932,13159,3578727364,3578727366,2
3,932,13160,3578727364,3578727366,2
3,932,13161,3578727364,3578727367,3
3,932,13162,3578727364,3578727367,3
3,932,13163,3578727364,3578727368,4
3,932,13164,3578727364,3578727369,5
3,932,13165,3578727364,3578727370,6
3,932,13166,3578727364,3578727371,7
3,932,13167,3578727364,3578727371,7
3,932,13168,3578727364,3578727375,11
3,932,13169,3578727364,3578727376,12
3,932,13170,3578727364,3578727377,13
3,932,13171,3578727364,3578727378,14
3,932,13172,3578727364,3578727379,15
3,932,13173,3578727364,3578727382,18
3,932,13174,3578727364,3578727384,20
3,932,13175,3578727364,3578727385,21
3,932,13176,3578727364,3578727385,21
3,932,13177,3578727364,3578727386,22
3,932,13178,3578727364,3578727387,23
3,932,13179,3578727364,3578727387,23
3,932,13180,3578727364,3578727388,24
3,932,13181,3578727364,3578727388,24
3,932,13182,3578727364,3578727389,25
3,932,13183,3578727364,3578727389,25
3,932,13184,3578727364,3578727390,26
3,932,13185,3578727364,3578727391,27
3,932,13186,3578727364,3578727391,27
3,932,13187,3578727364,3578727396,32
3,932,13188,3578727364,3578727403,39
3,932,13189,3578727364,3578727404,40
3,932,13190,3578727364,3578727404,40
3,932,13191,3578727364,3578727405,41
3,932,13192,3578727364,3578727405,41
3,932,13193,3578727364,3578727405,41
3,932,13194,3578727364,3578727406,42
3,932,13195,3578727364,3578727406,42
3,932,13196,3578727364,3578727408,44
3,932,13197,3578727364,3578727408,44
3,932,13198,3578727364,3578727408,44
3,932,13199,3578727364,3578727410,46
3,932,13200,3578727364,3578727413,49
3,933,13201,3578727422,3578727422,0
3,933,13202,3578727422,3578727422,0
3,933,13203,3578727422,3578727422,0
3,933,13204,3578727422,3578727422,0
3,933,13205,3578727422,3578727423,1
3,933,13206,3578727422,3578727424,2
3,933,13207,3578727422,3578727424,2
3,933,13208,3578727422,3578727426,4
3,933,13209,3578727422,3578727427,5
3,933,13210,3578727422,3578727427,5
3,933,13211,3578727422,3578727428,6
3,933,13212,3578727422,3578727429,7
3,933,13213,3578727422,3578727431,9
3,933,13214,3578727422,3578727432,10
3,933,13215,3578727422,3578727432,10
3,933,13216,3578727422,3578727433,11
3,933,13217,3578727422,3578727434,12
3,933,13218,3578727422,3578727435,13
3,933,13219,3578727422,3578727436,14
3,933,13220,3578727422,3578727436,14
3,933,13221,3578727422,3578727439,17
3,933,13222,3578727422,3578727439,17
3,933,13223,3578727422,3578727440,18
3,933,13224,3578727422,3578727442,20
3,933,13225,3578727422,3578727443,21
3,933,13226,3578727422,3578727444,22
3,933,13227,3578727422,3578727445,23
3,933,13228,3578727422,3578727446,24
3,933,13229,3578727422,3578727450,28
3,933,13230,3578727422,3578727450,28
3,933,13231,3578727422,3578727452,30
3,933,13232,3578727422,3578727454,32
3,933,13233,3578727422,3578727456,34
3,933,13234,3578727422,3578727457,35
3,933,13235,3578727422,3578727460,38
3,933,13236,3578727422,3578727461,39
3,933,13237,3578727422,3578727462,40
3,933,13238,3578727422,3578727463,41
3,933,13239,3578727422,3578727464,42
3,933,13240,3578727422,3578727465,43
3,933,13241,3578727422,3578727465,43
3,933,13242,3578727422,3578727469,47
3,933,13243,3578727422,3578727470,48
3,933,13244,3578727422,3578727470,48
3,933,13245,3578727422,3578727470,48
3,934,13246,3578727480,3578727480,0
3,934,13247,3578727480,3578727480,0
3,934,13248,3578727480,3578727480,0
3,934,13249,3578727480,3578727481,1
3,934,13250,3578727480,3578727481,1
3,934,13251,3578727480,3578727482,2
3,934,13252,3578727480,3578727482,2
3,934,13253,3578727480,3578727482,2
3,934,13254,3578727480,3578727483,3
3,934,13255,3578727480,3578727486,6
3,934,13256,3578727480,3578727487,7
3,934,13257,3578727480,3578727489,9
3,934,13258,3578727480,3578727491,11
3,934,13259,3578727480,3578727492,12
3,934,13260,3578727480,3578727493,13
3,934,13261,3578727480,3578727494,14
3,934,13262,3578727480,3578727499,19
3,934,13263,3578727480,3578727499,19
3,934,13264,3578727480,3578727500,20
3,934,13265,3578727480,3578727503,23
3,934,13266,3578727480,3578727503,23
3,934,13267,3578727480,3578727505,25
3,934,13268,3578727480,3578727508,28
3,934,13269,3578727480,3578727508,28
3,934,13270,3578727480,3578727509,29
3,934,13271,3578727480,3578727511,31
3,934,13272,3578727480,3578727512,32
3,934,13273,3578727480,3578727517,37
3,934,13274,3578727480,3578727517,37
3,934,13275,3578727480,3578727520,40
3,934,13276,3578727480,3578727520,40
3,934,13277,3578727480,3578727521,41
3,934,13278,3578727480,3578727522,42
3,934,13279,3578727480,3578727525,45
3,935,13280,3578727537,3578727537,0
3,935,13281,3578727537,3578727537,0
3,935,13282,3578727537,3578727537,0
3,935,13283,3578727537,3578727537,0
3,935,13284,3578727537,3578727538,1
3,935,13285,3578727537,3578727539,2
3,935,13286,3578727537,3578727539,2
3,935,13287,3578727537,3578727540,3
3,935,13288,3578727537,3578727541,4
3,935,13289,3578727537,3578727544,7
3,935,13290,3578727537,3578727545,8
3,935,13291,3578727537,3578727549,12
3,935,13292,3578727537,3578727550,13
3,935,13293,3578727537,3578727551,14
3,935,13294,3578727537,3578727552,15
3,935,13295,3578727537,3578727552,15
3,935,13296,3578727537,3578727553,16
3,935,13297,3578727537,3578727553,16
3,935,13298,3578727537,3578727553,16
3,935,13299,3578727537,3578727554,17
3,935,13300,3578727537,3578727557,20
3,935,13301,3578727537,3578727558,21
3,935,13302,3578727537,3578727560,23
3,935,13303,3578727537,3578727564,27
3,935,13304,3578727537,3578727565,28
3,935,13305,3578727537,3578727565,28
3,935,13306,3578727537,3578727565,28
3,935,13307,3578727537,3578727566,29
3,935,13308,3578727537,3578727568,31
3,935,13309,3578727537,3578727568,31
3,935,13310,3578727537,3578727569,32
3,935,13311,3578727537,3578727570,33
3,935,13312,3578727537,3578727574,37
3,935,13313,3578727537,3578727575,38
3,935,13314,3578727537,3578727575,38
3,935,13315,3578727537,3578727578,41
3,935,13316,3578727537,3578727578,41
3,935,13317,3578727537,3578727582,45
3,935,13318,3578727537,3578727583,46
3,935,13319,3578727537,3578727584,47
3,935,13320,3578727537,3578727585,48
3,935,13321,3578727537,3578727585,48
3,935,13322,3578727537,3578727586,49
3,935,13323,3578727537,3578727586,49
3,935,13324,3578727537,3578727587,50
3,936,13325,3578727595,3578727595,0
3,936,13326,3578727595,3578727595,0
3,936,13327,3578727595,3578727595,0
3,936,13328,3578727595,3578727595,0
3,936,13329,3578727595,3578727595,0
3,936,13330,3578727595,3578727595,0
3,936,13331,3578727595,3578727595,0
3,936,13332,3578727595,3578727601,6
3,936,13333,3578727595,3578727602,7
3,936,13334,3578727595,3578727603,8
3,936,13335,3578727595,3578727603,8
3,936,13336,3578727595,3578727604,9
3,936,13337,3578727595,3578727604,9
3,936,13338,3578727595,3578727604,9
3,936,13339,3578727595,3578727604,9
3,936,13340,3578727595,3578727605,10
3,936,13341,3578727595,3578727607,12
3,936,13342,3578727595,3578727608,13
3,936,13343,3578727595,3578727608,13
3,936,13344,3578727595,3578727610,15
3,936,13345,3578727595,3578727613,18
3,936,13346,3578727595,3578727614,19
3,936,13347,3578727595,3578727616,21
3,936,13348,3578727595,3578727616,21
3,936,13349,3578727595,3578727621,26
3,936,13350,3578727595,3578727621,26
3,936,13351,3578727595,3578727623,28
3,936,13352,3578727595,3578727624,29
3,936,13353,3578727595,3578727626,31
3,936,13354,3578727595,3578727626,31
3,936,13355,3578727595,3578727626,31
3,936,13356,3578727595,3578727627,32
3,936,13357,3578727595,3578727628,33
3,936,13358,3578727595,3578727629,34
3,936,13359,3578727595,3578727632,37
3,936,13360,3578727595,3578727632,37
3,936,13361,3578727595,3578727632,37
3,936,13362,3578727595,3578727634,39
3,936,13363,3578727595,3578727634,39
3,936,13364,3578727595,3578727635,40
3,936,13365,3578727595,3578727636,41
3,936,13366,3578727595,3578727638,43
3,936,13367,3578727595,3578727638,43
3,936,13368,3578727595,3578727639,44
3,936,13369,3578727595,3578727642,47
3,936,13370,3578727595,3578727643,48
3,936,13371,3578727595,3578727643,48
3,936,13372,3578727595,3578727645,50
3,937,13373,3578727651,3578727651,0
3,937,13374,3578727651,3578727651,0
3,937,13375,3578727651,3578727651,0
3,937,13376,3578727651,3578727653,2
3,937,13377,3578727651,3578727655,4
3,937,13378,3578727651,3578727656,5
3,937,13379,3578727651,3578727658,7
3,937,13380,3578727651,3578727661,10
3,937,13381,3578727651,3578727661,10
3,937,13382,3578727651,3578727663,12
3,937,13383,3578727651,3578727663,12
3,937,13384,3578727651,3578727664,13
3,937,13385,3578727651,3578727668,17
3,937,13386,3578727651,3578727669,18
3,937,13387,3578727651,3578727670,19
3,937,13388,3578727651,3578727670,19
3,937,13389,3578727651,3578727673,22
3,937,13390,3578727651,3578727680,29
3,937,13391,3578727651,3578727680,29
3,937,13392,3578727651,3578727681,30
3,937,13393,3578727651,3578727681,30
3,937,13394,3578727651,3578727682,31
3,937,13395,3578727651,3578727682,31
3,937,13396,3578727651,3578727683,32
3,937,13397,3578727651,3578727685,34
3,937,13398,3578727651,3578727687,36
3,937,13399,3578727651,3578727689,38
3,937,13400,3578727651,3578727691,40
3,937,13401,3578727651,3578727692,41
3,937,13402,3578727651,3578727693,42
3,937,13403,3578727651,3578727695,44
3,937,13404,3578727651,3578727696,45
3,937,13405,3578727651,3578727699,48
3,937,13406,3578727651,3578727700,49
3,937,13407,3578727651,3578727701,50
3,938,13408,3578727709,3578727709,0
3,938,13409,3578727709,3578727709,0
3,938,13410,3578727709,3578727709,0
3,938,13411,3578727709,3578727709,0
3,938,13412,3578727709,3578727709,0
3,938,13413,3578727709,3578727709,0
3,938,13414,3578727709,3578727710,1
3,938,13415,3578727709,3578727712,3
3,938,13416,3578727709,3578727713,4
3,938,13417,3578727709,3578727717,8
3,938,13418,3578727709,3578727717,8
3,938,13419,3578727709,3578727721,12
3,938,13420,3578727709,3578727721,12
3,938,13421,3578727709,3578727722,13
3,938,13422,3578727709,3578727723,14
3,938,13423,3578727709,3578727724,15
3,938,13424,3578727709,3578727733,24
3,938,13425,3578727709,3578727735,26
3,938,13426,3578727709,3578727737,28
3,938,13427,3578727709,3578727738,29
3,938,13428,3578727709,3578727738,29
3,938,13429,3578727709,3578727738,29
3,938,13430,3578727709,3578727739,30
3,938,13431,3578727709,3578727739,30
3,938,13432,3578727709,3578727740,31
3,938,13433,3578727709,3578727741,32
3,938,13434,3578727709,3578727745,36
3,938,13435,3578727709,3578727745,36
3,938,13436,3578727709,3578727745,36
3,938,13437,3578727709,3578727749,40
3,938,13438,3578727709,3578727750,41
3,938,13439,3578727709,3578727752,43
3,938,13440,3578727709,3578727752,43
3,938,13441,3578727709,3578727753,44
3,938,13442,3578727709,3578727753,44
3,938,13443,3578727709,3578727753,44
3,938,13444,3578727709,3578727754,45
3,938,13445,3578727709,3578727754,45
3,938,13446,3578727709,3578727757,48
3,938,13447,3578727709,3578727757,48
3,938,13448,3578727709,3578727758,49
3,939,13449,3578727766,3578727766,0
3,939,13450,3578727766,3578727766,0
3,939,13451,3578727766,3578727766,0
3,939,13452,3578727766,3578727766,0
3,939,13453,3578727766,3578727766,0
3,939,13454,3578727766,3578727766,0
3,939,13455,3578727766,3578727767,1
3,939,13456,3578727766,3578727768,2
3,939,13457,3578727766,3578727769,3
3,939,13458,3578727766,3578727771,5
3,939,13459,3578727766,3578727774,8
3,939,13460,3578727766,3578727775,9
3,939,13461,3578727766,3578727776,10
3,939,13462,3578727766,3578727777,11
3,939,13463,3578727766,3578727778,12
3,939,13464,3578727766,3578727782,16
3,939,13465,3578727766,3578727783,17
3,939,13466,3578727766,3578727784,18
3,939,13467,3578727766,3578727785,19
3,939,13468,3578727766,3578727785,19
3,939,13469,3578727766,3578727787,21
3,939,13470,3578727766,3578727787,21
3,939,13471,3578727766,3578727787,21
3,939,13472,3578727766,3578727787,21
3,939,13473,3578727766,3578727788,22
3,939,13474,3578727766,3578727788,22
3,939,13475,3578727766,3578727792,26
3,939,13476,3578727766,3578727792,26
3,939,13477,3578727766,3578727792,26
3,939,13478,3578727766,3578727796,30
3,939,13479,3578727766,3578727802,36
3,939,13480,3578727766,3578727803,37
3,939,13481,3578727766,3578727803,37
3,939,13482,3578727766,3578727804,38
3,939,13483,3578727766,3578727804,38
3,939,13484,3578727766,3578727804,38
3,939,13485,3578727766,3578727805,39
3,939,13486,3578727766,3578727805,39
3,939,13487,3578727766,3578727808,42
3,939,13488,3578727766,3578727808,42
3,939,13489,3578727766,3578727809,43
3,939,13490,3578727766,3578727810,44
3,939,13491,3578727766,3578727813,47
3,939,13492,3578727766,3578727815,49
3,939,13493,3578727766,3578727815,49
3,940,13494,3578727823,3578727823,0
3,940,13495,3578727823,3578727823,0
3,940,13496,3578727823,3578727823,0
3,940,13497,3578727823,3578727823,0
3,940,13498,3578727823,3578727825,2
3,940,13499,3578727823,3578727826,3
3,940,13500,3578727823,3578727826,3
3,940,13501,3578727823,3578727826,3
3,940,13502,3578727823,3578727827,4
3,940,13503,3578727823,3578727828,5
3,940,13504,3578727823,3578727830,7
3,940,13505,3578727823,3578727832,9
3,940,13506,3578727823,3578727833,10
3,940,13507,3578727823,3578727833,10
3,940,13508,3578727823,3578727834,11
3,940,13509,3578727823,3578727835,12
3,940,13510,3578727823,3578727836,13
3,940,13511,3578727823,3578727837,14
3,940,13512,3578727823,3578727838,15
3,940,13513,3578727823,3578727839,16
3,940,13514,3578727823,3578727839,16
3,940,13515,3578727823,3578727841,18
3,940,13516,3578727823,3578727843,20
3,940,13517,3578727823,3578727844,21
3,940,13518,3578727823,3578727846,23
3,940,13519,3578727823,3578727851,28
3,940,13520,3578727823,3578727853,30
3,940,13521,3578727823,3578727856,33
3,940,13522,3578727823,3578727856,33
3,940,13523,3578727823,3578727861,38
3,940,13524,3578727823,3578727862,39
3,940,13525,3578727823,3578727863,40
3,940,13526,3578727823,3578727863,40
3,940,13527,3578727823,3578727863,40
3,940,13528,3578727823,3578727864,41
3,940,13529,3578727823,3578727867,44
3,940,13530,3578727823,3578727869,46
3,940,13531,3578727823,3578727869,46
3,940,13532,3578727823,3578727870,47
3,941,13533,3578727881,3578727881,0
3,941,13534,3578727881,3578727881,0
3,941,13535,3578727881,3578727881,0
3,941,13536,3578727881,3578727881,0
3,941,13537,3578727881,3578727881,0
3,941,13538,3578727881,3578727881,0
3,941,13539,3578727881,3578727882,1
3,941,13540,3578727881,3578727883,2
3,941,13541,3578727881,3578727883,2
3,941,13542,3578727881,3578727885,4
3,941,13543,3578727881,3578727887,6
3,941,13544,3578727881,3578727888,7
3,941,13545,3578727881,3578727892,11
3,941,13546,3578727881,3578727893,12
3,941,13547,3578727881,3578727895,14
3,941,13548,3578727881,3578727896,15
3,941,13549,3578727881,3578727899,18
3,941,13550,3578727881,3578727900,19
3,941,13551,3578727881,3578727900,19
3,941,13552,3578727881,3578727902,21
3,941,13553,3578727881,3578727903,22
3,941,13554,3578727881,3578727904,23
3,941,13555,3578727881,3578727905,24
3,941,13556,3578727881,3578727907,26
3,941,13557,3578727881,3578727908,27
3,941,13558,3578727881,3578727910,29
3,941,13559,3578727881,3578727912,31
3,941,13560,3578727881,3578727913,32
3,941,13561,3578727881,3578727917,36
3,941,13562,3578727881,3578727921,40
3,941,13563,3578727881,3578727921,40
3,941,13564,3578727881,3578727922,41
3,941,13565,3578727881,3578727923,42
3,941,13566,3578727881,3578727924,43
3,942,13567,3578727939,3578727939,0
3,942,13568,3578727939,3578727939,0
3,942,13569,3578727939,3578727939,0
3,942,13570,3578727939,3578727939,0
3,942,13571,3578727939,3578727939,0
3,942,13572,3578727939,3578727939,0
3,942,13573,3578727939,3578727940,1
3,942,13574,3578727939,3578727941,2
3,942,13575,3578727939,3578727941,2
3,942,13576,3578727939,3578727945,6
3,942,13577,3578727939,3578727945,6
3,942,13578,3578727939,3578727945,6
3,942,13579,3578727939,3578727950,11
3,942,13580,3578727939,3578727951,12
3,942,13581,3578727939,3578727952,13
3,942,13582,3578727939,3578727952,13
3,942,13583,3578727939,3578727953,14
3,942,13584,3578727939,3578727953,14
3,942,13585,3578727939,3578727953,14
3,942,13586,3578727939,3578727954,15
3,942,13587,3578727939,3578727954,15
3,942,13588,3578727939,3578727957,18
3,942,13589,3578727939,3578727957,18
3,942,13590,3578727939,3578727958,19
3,942,13591,3578727939,3578727960,21
3,942,13592,3578727939,3578727964,25
3,942,13593,3578727939,3578727965,26
3,942,13594,3578727939,3578727965,26
3,942,13595,3578727939,3578727965,26
3,942,13596,3578727939,3578727966,27
3,942,13597,3578727939,3578727968,29
3,942,13598,3578727939,3578727968,29
3,942,13599,3578727939,3578727969,30
3,942,13600,3578727939,3578727971,32
3,942,13601,3578727939,3578727971,32
3,942,13602,3578727939,3578727974,35
3,942,13603,3578727939,3578727975,36
3,942,13604,3578727939,3578727976,37
3,942,13605,3578727939,3578727978,39
3,942,13606,3578727939,3578727979,40
3,942,13607,3578727939,3578727983,44
3,942,13608,3578727939,3578727984,45
3,942,13609,3578727939,3578727985,46
3,942,13610,3578727939,3578727985,46
3,942,13611,3578727939,3578727987,48
3,942,13612,3578727939,3578727987,48
3,942,13613,3578727939,3578727987,48
3,942,13614,3578727939,3578727988,49
3,942,13615,3578727939,3578727988,49
3,942,13616,3578727939,3578727989,50
3,943,13617,3578727996,3578727996,0
3,943,13618,3578727996,3578727996,0
3,943,13619,3578727996,3578727996,0
3,943,13620,3578727996,3578727996,0
3,943,13621,3578727996,3578727996,0
3,943,13622,3578727996,3578728002,6
3,943,13623,3578727996,3578728003,7
3,943,13624,3578727996,3578728003,7
3,943,13625,3578727996,3578728003,7
3,943,13626,3578727996,3578728005,9
3,943,13627,3578727996,3578728005,9
3,943,13628,3578727996,3578728005,9
3,943,13629,3578727996,3578728008,12
3,943,13630,3578727996,3578728008,12
3,943,13631,3578727996,3578728008,12
3,943,13632,3578727996,3578728014,18
3,943,13633,3578727996,3578728015,19
3,943,13634,3578727996,3578728015,19
3,943,13635,3578727996,3578728016,20
3,943,13636,3578727996,3578728021,25
3,943,13637,3578727996,3578728023,27
3,943,13638,3578727996,3578728023,27
3,943,13639,3578727996,3578728023,27
3,943,13640,3578727996,3578728023,27
3,943,13641,3578727996,3578728026,30
3,943,13642,3578727996,3578728026,30
3,943,13643,3578727996,3578728026,30
3,943,13644,3578727996,3578728027,31
3,943,13645,3578727996,3578728027,31
3,943,13646,3578727996,3578728029,33
3,943,13647,3578727996,3578728029,33
3,943,13648,3578727996,3578728030,34
3,943,13649,3578727996,3578728032,36
3,943,13650,3578727996,3578728033,37
3,943,13651,3578727996,3578728033,37
3,943,13652,3578727996,3578728034,38
3,943,13653,3578727996,3578728034,38
3,943,13654,3578727996,3578728036,40
3,943,13655,3578727996,3578728036,40
3,943,13656,3578727996,3578728037,41
3,943,13657,3578727996,3578728039,43
3,943,13658,3578727996,3578728039,43
3,943,13659,3578727996,3578728039,43
3,943,13660,3578727996,3578728040,44
3,943,13661,3578727996,3578728042,46
3,943,13662,3578727996,3578728043,47
3,943,13663,3578727996,3578728044,48
3,944,13664,3578728056,3578728056,0
3,944,13665,3578728056,3578728056,0
3,944,13666,3578728056,3578728056,0
3,944,13667,3578728056,3578728056,0
3,944,13668,3578728056,3578728061,5
3,944,13669,3578728056,3578728062,6
3,944,13670,3578728056,3578728063,7
3,944,13671,3578728056,3578728063,7
3,944,13672,3578728056,3578728063,7
3,944,13673,3578728056,3578728065,9
3,944,13674,3578728056,3578728068,12
3,944,13675,3578728056,3578728069,13
3,944,13676,3578728056,3578728071,15
3,944,13677,3578728056,3578728073,17
3,944,13678,3578728056,3578728073,17
3,944,13679,3578728056,3578728079,23
3,944,13680,3578728056,3578728080,24
3,944,13681,3578728056,3578728080,24
3,944,13682,3578728056,3578728081,25
3,944,13683,3578728056,3578728081,25
3,944,13684,3578728056,3578728082,26
3,944,13685,3578728056,3578728082,26
3,944,13686,3578728056,3578728083,27
3,944,13687,3578728056,3578728085,29
3,944,13688,3578728056,3578728087,31
3,944,13689,3578728056,3578728089,33
3,944,13690,3578728056,3578728090,34
3,944,13691,3578728056,3578728093,37
3,944,13692,3578728056,3578728093,37
3,944,13693,3578728056,3578728095,39
3,944,13694,3578728056,3578728096,40
3,944,13695,3578728056,3578728099,43
3,944,13696,3578728056,3578728099,43
3,944,13697,3578728056,3578728100,44
3,944,13698,3578728056,3578728101,45
3,944,13699,3578728056,3578728103,47
3,944,13700,3578728056,3578728105,49
3,944,13701,3578728056,3578728105,49
3,945,13702,3578728114,3578728114,0
3,945,13703,3578728114,3578728114,0
3,945,13704,3578728114,3578728114,0
3,945,13705,3578728114,3578728114,0
3,945,13706,3578728114,3578728115,1
3,945,13707,3578728114,3578728117,3
3,945,13708,3578728114,3578728117,3
3,945,13709,3578728114,3578728122,8
3,945,13710,3578728114,3578728122,8
3,945,13711,3578728114,3578728122,8
3,945,13712,3578728114,3578728124,10
3,945,13713,3578728114,3578728126,12
3,945,13714,3578728114,3578728133,19
3,945,13715,3578728114,3578728136,22
3,945,13716,3578728114,3578728138,24
3,945,13717,3578728114,3578728139,25
3,945,13718,3578728114,3578728139,25
3,945,13719,3578728114,3578728139,25
3,945,13720,3578728114,3578728139,25
3,945,13721,3578728114,3578728140,26
3,945,13722,3578728114,3578728141,27
3,945,13723,3578728114,3578728141,27
3,945,13724,3578728114,3578728145,31
3,945,13725,3578728114,3578728145,31
3,945,13726,3578728114,3578728145,31
3,945,13727,3578728114,3578728151,37
3,945,13728,3578728114,3578728151,37
3,945,13729,3578728114,3578728152,38
3,945,13730,3578728114,3578728153,39
3,945,13731,3578728114,3578728153,39
3,945,13732,3578728114,3578728154,40
3,945,13733,3578728114,3578728154,40
3,945,13734,3578728114,3578728154,40
3,945,13735,3578728114,3578728158,44
3,945,13736,3578728114,3578728158,44
3,945,13737,3578728114,3578728160,46
3,946,13738,3578728170,3578728170,0
3,946,13739,3578728170,3578728170,0
3,946,13740,3578728170,3578728170,0
3,946,13741,3578728170,3578728170,0
3,946,13742,3578728170,3578728170,0
3,946,13743,3578728170,3578728170,0
3,946,13744,3578728170,3578728170,0
3,946,13745,3578728170,3578728170,0
3,946,13746,3578728170,3578728172,2
3,946,13747,3578728170,3578728175,5
3,946,13748,3578728170,3578728175,5
3,946,13749,3578728170,3578728177,7
3,946,13750,3578728170,3578728177,7
3,946,13751,3578728170,3578728178,8
3,946,13752,3578728170,3578728184,14
3,946,13753,3578728170,3578728184,14
3,946,13754,3578728170,3578728184,14
3,946,13755,3578728170,3578728185,15
3,946,13756,3578728170,3578728186,16
3,946,13757,3578728170,3578728187,17
3,946,13758,3578728170,3578728187,17
3,946,13759,3578728170,3578728187,17
3,946,13760,3578728170,3578728188,18
3,946,13761,3578728170,3578728189,19
3,946,13762,3578728170,3578728189,19
3,946,13763,3578728170,3578728192,22
3,946,13764,3578728170,3578728192,22
3,946,13765,3578728170,3578728192,22
3,946,13766,3578728170,3578728193,23
3,946,13767,3578728170,3578728196,26
3,946,13768,3578728170,3578728203,33
3,946,13769,3578728170,3578728203,33
3,946,13770,3578728170,3578728203,33
3,946,13771,3578728170,3578728204,34
3,946,13772,3578728170,3578728204,34
3,946,13773,3578728170,3578728205,35
3,946,13774,3578728170,3578728205,35
3,946,13775,3578728170,3578728206,36
3,946,13776,3578728170,3578728208,38
3,946,13777,3578728170,3578728208,38
3,946,13778,3578728170,3578728209,39
3,946,13779,3578728170,3578728210,40
3,946,13780,3578728170,3578728214,44
3,946,13781,3578728170,3578728214,44
3,946,13782,3578728170,3578728216,46
3,946,13783,3578728170,3578728216,46
3,946,13784,3578728170,3578728217,47
3,947,13785,3578728227,3578728227,0
3,947,13786,3578728227,3578728227,0
3,947,13787,3578728227,3578728227,0
3,947,13788,3578728227,3578728227,0
3,947,13789,3578728227,3578728227,0
3,947,13790,3578728227,3578728227,0
3,947,13791,3578728227,3578728227,0
3,947,13792,3578728227,3578728227,0
3,947,13793,3578728227,3578728227,0
3,947,13794,3578728227,3578728228,1
3,947,13795,3578728227,3578728229,2
3,947,13796,3578728227,3578728229,2
3,947,13797,3578728227,3578728232,5
3,947,13798,3578728227,3578728233,6
3,947,13799,3578728227,3578728233,6
3,947,13800,3578728227,3578728234,7
3,947,13801,3578728227,3578728235,8
3,947,13802,3578728227,3578728235,8
3,947,13803,3578728227,3578728236,9
3,947,13804,3578728227,3578728237,10
3,947,13805,3578728227,3578728239,12
3,947,13806,3578728227,3578728239,12
3,947,13807,3578728227,3578728240,13
3,947,13808,3578728227,3578728240,13
3,947,13809,3578728227,3578728241,14
3,947,13810,3578728227,3578728243,16
3,947,13811,3578728227,3578728244,17
3,947,13812,3578728227,3578728247,20
3,947,13813,3578728227,3578728250,23
3,947,13814,3578728227,3578728252,25
3,947,13815,3578728227,3578728254,27
3,947,13816,3578728227,3578728256,29
3,947,13817,3578728227,3578728256,29
3,947,13818,3578728227,3578728262,35
3,947,13819,3578728227,3578728262,35
3,947,13820,3578728227,3578728263,36
3,947,13821,3578728227,3578728264,37
3,947,13822,3578728227,3578728264,37
3,947,13823,3578728227,3578728265,38
3,947,13824,3578728227,3578728267,40
3,947,13825,3578728227,3578728269,42
3,947,13826,3578728227,3578728271,44
3,947,13827,3578728227,3578728273,46
3,947,13828,3578728227,3578728273,46
3,948,13829,3578728284,3578728284,0
3,948,13830,3578728284,3578728284,0
3,948,13831,3578728284,3578728284,0
3,948,13832,3578728284,3578728284,0
3,948,13833,3578728284,3578728284,0
3,948,13834,3578728284,3578728284,0
3,948,13835,3578728284,3578728284,0
3,948,13836,3578728284,3578728284,0
3,948,13837,3578728284,3578728284,0
3,948,13838,3578728284,3578728285,1
3,948,13839,3578728284,3578728287,3
3,948,13840,3578728284,3578728289,5
3,948,13841,3578728284,3578728291,7
3,948,13842,3578728284,3578728292,8
3,948,13843,3578728284,3578728293,9
3,948,13844,3578728284,3578728295,11
3,948,13845,3578728284,3578728296,12
3,948,13846,3578728284,3578728299,15
3,948,13847,3578728284,3578728300,16
3,948,13848,3578728284,3578728300,16
3,948,13849,3578728284,3578728301,17
3,948,13850,3578728284,3578728304,20
3,948,13851,3578728284,3578728305,21
3,948,13852,3578728284,3578728306,22
3,948,13853,3578728284,3578728307,23
3,948,13854,3578728284,3578728309,25
3,948,13855,3578728284,3578728310,26
3,948,13856,3578728284,3578728313,29
3,948,13857,3578728284,3578728315,31
3,948,13858,3578728284,3578728318,34
3,948,13859,3578728284,3578728318,34
3,948,13860,3578728284,3578728322,38
3,948,13861,3578728284,3578728322,38
3,948,13862,3578728284,3578728323,39
3,948,13863,3578728284,3578728323,39
3,948,13864,3578728284,3578728326,42
3,948,13865,3578728284,3578728332,48
3,948,13866,3578728284,3578728332,48
3,949,13867,3578728343,3578728343,0
3,949,13868,3578728343,3578728343,0
3,949,13869,3578728343,3578728343,0
3,949,13870,3578728343,3578728343,0
3,949,13871,3578728343,3578728343,0
3,949,13872,3578728343,3578728343,0
3,949,13873,3578728343,3578728343,0
3,949,13874,3578728343,3578728343,0
3,949,13875,3578728343,3578728343,0
3,949,13876,3578728343,3578728343,0
3,949,13877,3578728343,3578728345,2
3,949,13878,3578728343,3578728345,2
3,949,13879,3578728343,3578728346,3
3,949,13880,3578728343,3578728351,8
3,949,13881,3578728343,3578728352,9
3,949,13882,3578728343,3578728352,9
3,949,13883,3578728343,3578728353,10
3,949,13884,3578728343,3578728353,10
3,949,13885,3578728343,3578728354,11
3,949,13886,3578728343,3578728354,11
3,949,13887,3578728343,3578728354,11
3,949,13888,3578728343,3578728355,12
3,949,13889,3578728343,3578728357,14
3,949,13890,3578728343,3578728358,15
3,949,13891,3578728343,3578728361,18
3,949,13892,3578728343,3578728365,22
3,949,13893,3578728343,3578728366,23
3,949,13894,3578728343,3578728366,23
3,949,13895,3578728343,3578728366,23
3,949,13896,3578728343,3578728367,24
3,949,13897,3578728343,3578728368,25
3,949,13898,3578728343,3578728369,26
3,949,13899,3578728343,3578728370,27
3,949,13900,3578728343,3578728370,27
3,949,13901,3578728343,3578728373,30
3,949,13902,3578728343,3578728375,32
3,949,13903,3578728343,3578728375,32
3,949,13904,3578728343,3578728377,34
3,949,13905,3578728343,3578728379,36
3,949,13906,3578728343,3578728384,41
3,949,13907,3578728343,3578728384,41
3,949,13908,3578728343,3578728384,41
3,949,13909,3578728343,3578728385,42
3,949,13910,3578728343,3578728385,42
3,949,13911,3578728343,3578728386,43
3,949,13912,3578728343,3578728387,44
3,949,13913,3578728343,3578728387,44
3,949,13914,3578728343,3578728387,44
3,949,13915,3578728343,3578728388,45
3,949,13916,3578728343,3578728389,46
3,949,13917,3578728343,3578728389,46
3,949,13918,3578728343,3578728391,48
3,949,13919,3578728343,3578728392,49
3,949,13920,3578728343,3578728393,50
3,950,13921,3578728401,3578728401,0
3,950,13922,3578728401,3578728401,0
3,950,13923,3578728401,3578728402,1
3,950,13924,3578728401,3578728403,2
3,950,13925,3578728401,3578728404,3
3,950,13926,3578728401,3578728404,3
3,950,13927,3578728401,3578728404,3
3,950,13928,3578728401,3578728405,4
3,950,13929,3578728401,3578728405,4
3,950,13930,3578728401,3578728406,5
3,950,13931,3578728401,3578728407,6
3,950,13932,3578728401,3578728408,7
3,950,13933,3578728401,3578728408,7
3,950,13934,3578728401,3578728408,7
3,950,13935,3578728401,3578728410,9
3,950,13936,3578728401,3578728416,15
3,950,13937,3578728401,3578728416,15
3,950,13938,3578728401,3578728417,16
3,950,13939,3578728401,3578728421,20
3,950,13940,3578728401,3578728423,22
3,950,13941,3578728401,3578728423,22
3,950,13942,3578728401,3578728424,23
3,950,13943,3578728401,3578728426,25
3,950,13944,3578728401,3578728427,26
3,950,13945,3578728401,3578728427,26
3,950,13946,3578728401,3578728428,27
3,950,13947,3578728401,3578728428,27
3,950,13948,3578728401,3578728430,29
3,950,13949,3578728401,3578728430,29
3,950,13950,3578728401,3578728433,32
3,950,13951,3578728401,3578728433,32
3,950,13952,3578728401,3578728433,32
3,950,13953,3578728401,3578728435,34
3,950,13954,3578728401,3578728435,34
3,950,13955,3578728401,3578728435,34
3,950,13956,3578728401,3578728437,36
3,950,13957,3578728401,3578728439,38
3,950,13958,3578728401,3578728439,38
3,950,13959,3578728401,3578728440,39
3,950,13960,3578728401,3578728440,39
3,950,13961,3578728401,3578728442,41
3,950,13962,3578728401,3578728443,42
3,950,13963,3578728401,3578728444,43
3,950,13964,3578728401,3578728444,43
3,950,13965,3578728401,3578728448,47
3,951,13966,3578728461,3578728461,0
3,951,13967,3578728461,3578728461,0
3,951,13968,3578728461,3578728461,0
3,951,13969,3578728461,3578728461,0
3,951,13970,3578728461,3578728461,0
3,951,13971,3578728461,3578728461,0
3,951,13972,3578728461,3578728462,1
3,951,13973,3578728461,3578728464,3
3,951,13974,3578728461,3578728464,3
3,951,13975,3578728461,3578728468,7
3,951,13976,3578728461,3578728469,8
3,951,13977,3578728461,3578728470,9
3,951,13978,3578728461,3578728471,10
3,951,13979,3578728461,3578728473,12
3,951,13980,3578728461,3578728474,13
3,951,13981,3578728461,3578728479,18
3,951,13982,3578728461,3578728479,18
3,951,13983,3578728461,3578728480,19
3,951,13984,3578728461,3578728481,20
3,951,13985,3578728461,3578728481,20
3,951,13986,3578728461,3578728482,21
3,951,13987,3578728461,3578728483,22
3,951,13988,3578728461,3578728485,24
3,951,13989,3578728461,3578728485,24
3,951,13990,3578728461,3578728487,26
3,951,13991,3578728461,3578728489,28
3,951,13992,3578728461,3578728490,29
3,951,13993,3578728461,3578728492,31
3,951,13994,3578728461,3578728494,33
3,951,13995,3578728461,3578728495,34
3,951,13996,3578728461,3578728496,35
3,951,13997,3578728461,3578728499,38
3,951,13998,3578728461,3578728500,39
3,951,13999,3578728461,3578728501,40
3,951,14000,3578728461,3578728502,41
3,951,14001,3578728461,3578728503,42
3,951,14002,3578728461,3578728505,44
3,951,14003,3578728461,3578728506,45
3,951,14004,3578728461,3578728507,46
3,951,14005,3578728461,3578728510,49
3,951,14006,3578728461,3578728511,50
3,952,14007,3578728516,3578728516,0
3,952,14008,3578728516,3578728516,0
3,952,14009,3578728516,3578728517,1
3,952,14010,3578728516,3578728517,1
3,952,14011,3578728516,3578728521,5
3,952,14012,3578728516,3578728522,6
3,952,14013,3578728516,3578728522,6
3,952,14014,3578728516,3578728523,7
3,952,14015,3578728516,3578728525,9
3,952,14016,3578728516,3578728531,15
3,952,14017,3578728516,3578728532,16
3,952,14018,3578728516,3578728535,19
3,952,14019,3578728516,3578728537,21
3,952,14020,3578728516,3578728538,22
3,952,14021,3578728516,3578728538,22
3,952,14022,3578728516,3578728538,22
3,952,14023,3578728516,3578728539,23
3,952,14024,3578728516,3578728539,23
3,952,14025,3578728516,3578728539,23
3,952,14026,3578728516,3578728541,25
3,952,14027,3578728516,3578728541,25
3,952,14028,3578728516,3578728544,28
3,952,14029,3578728516,3578728545,29
3,952,14030,3578728516,3578728546,30
3,952,14031,3578728516,3578728550,34
3,952,14032,3578728516,3578728551,35
3,952,14033,3578728516,3578728552,36
3,952,14034,3578728516,3578728552,36
3,952,14035,3578728516,3578728552,36
3,952,14036,3578728516,3578728552,36
3,952,14037,3578728516,3578728553,37
3,952,14038,3578728516,3578728554,38
3,952,14039,3578728516,3578728554,38
3,952,14040,3578728516,3578728557,41
3,952,14041,3578728516,3578728558,42
3,952,14042,3578728516,3578728559,43
3,952,14043,3578728516,3578728563,47
3,952,14044,3578728516,3578728565,49
3,952,14045,3578728516,3578728565,49
3,952,14046,3578728516,3578728566,50
3,953,14047,3578728573,3578728573,0
3,953,14048,3578728573,3578728573,0
3,953,14049,3578728573,3578728573,0
3,953,14050,3578728573,3578728573,0
3,953,14051,3578728573,3578728574,1
3,953,14052,3578728573,3578728574,1
3,953,14053,3578728573,3578728576,3
3,953,14054,3578728573,3578728578,5
3,953,14055,3578728573,3578728582,9
3,953,14056,3578728573,3578728583,10
3,953,14057,3578728573,3578728583,10
3,953,14058,3578728573,3578728584,11
3,953,14059,3578728573,3578728584,11
3,953,14060,3578728573,3578728585,12
3,953,14061,3578728573,3578728586,13
3,953,14062,3578728573,3578728586,13
3,953,14063,3578728573,3578728586,13
3,953,14064,3578728573,3578728587,14
3,953,14065,3578728573,3578728587,14
3,953,14066,3578728573,3578728588,15
3,953,14067,3578728573,3578728590,17
3,953,14068,3578728573,3578728591,18
3,953,14069,3578728573,3578728592,19
3,953,14070,3578728573,3578728595,22
3,953,14071,3578728573,3578728600,27
3,953,14072,3578728573,3578728602,29
3,953,14073,3578728573,3578728603,30
3,953,14074,3578728573,3578728603,30
3,953,14075,3578728573,3578728603,30
3,953,14076,3578728573,3578728603,30
3,953,14077,3578728573,3578728604,31
3,953,14078,3578728573,3578728604,31
3,953,14079,3578728573,3578728605,32
3,953,14080,3578728573,3578728606,33
3,953,14081,3578728573,3578728607,34
3,953,14082,3578728573,3578728608,35
3,953,14083,3578728573,3578728608,35
3,953,14084,3578728573,3578728610,37
3,953,14085,3578728573,3578728613,40
3,953,14086,3578728573,3578728615,42
3,953,14087,3578728573,3578728615,42
3,953,14088,3578728573,3578728616,43
3,953,14089,3578728573,3578728620,47
3,953,14090,3578728573,3578728622,49
3,953,14091,3578728573,3578728622,49
3,953,14092,3578728573,3578728622,49
3,953,14093,3578728573,3578728622,49
3,954,14094,3578728631,3578728631,0
3,954,14095,3578728631,3578728631,0
3,954,14096,3578728631,3578728631,0
3,954,14097,3578728631,3578728631,0
3,954,14098,3578728631,3578728631,0
3,954,14099,3578728631,3578728631,0
3,954,14100,3578728631,3578728631,0
3,954,14101,3578728631,3578728631,0
3,954,14102,3578728631,3578728631,0
3,954,14103,3578728631,3578728632,1
3,954,14104,3578728631,3578728632,1
3,954,14105,3578728631,3578728634,3
3,954,14106,3578728631,3578728634,3
3,954,14107,3578728631,3578728635,4
3,954,14108,3578728631,3578728635,4
3,954,14109,3578728631,3578728636,5
3,954,14110,3578728631,3578728638,7
3,954,14111,3578728631,3578728638,7
3,954,14112,3578728631,3578728639,8
3,954,14113,3578728631,3578728639,8
3,954,14114,3578728631,3578728640,9
3,954,14115,3578728631,3578728641,10
3,954,14116,3578728631,3578728643,12
3,954,14117,3578728631,3578728643,12
3,954,14118,3578728631,3578728644,13
3,954,14119,3578728631,3578728647,16
3,954,14120,3578728631,3578728650,19
3,954,14121,3578728631,3578728651,20
3,954,14122,3578728631,3578728653,22
3,954,14123,3578728631,3578728655,24
3,954,14124,3578728631,3578728656,25
3,954,14125,3578728631,3578728658,27
3,954,14126,3578728631,3578728660,29
3,954,14127,3578728631,3578728661,30
3,954,14128,3578728631,3578728663,32
3,954,14129,3578728631,3578728663,32
3,954,14130,3578728631,3578728664,33
3,954,14131,3578728631,3578728667,36
3,954,14132,3578728631,3578728668,37
3,954,14133,3578728631,3578728669,38
3,954,14134,3578728631,3578728670,39
3,954,14135,3578728631,3578728673,42
3,954,14136,3578728631,3578728673,42
3,954,14137,3578728631,3578728679,48
3,954,14138,3578728631,3578728680,49
3,954,14139,3578728631,3578728680,49
3,954,14140,3578728631,3578728681,50
3,955,14141,3578728688,3578728688,0
3,955,14142,3578728688,3578728688,0
3,955,14143,3578728688,3578728688,0
3,955,14144,3578728688,3578728688,0
3,955,14145,3578728688,3578728688,0
3,955,14146,3578728688,3578728688,0
3,955,14147,3578728688,3578728689,1
3,955,14148,3578728688,3578728691,3
3,955,14149,3578728688,3578728692,4
3,955,14150,3578728688,3578728692,4
3,955,14151,3578728688,3578728694,6
3,955,14152,3578728688,3578728695,7
3,955,14153,3578728688,3578728696,8
3,955,14154,3578728688,3578728700,12
3,955,14155,3578728688,3578728700,12
3,955,14156,3578728688,3578728702,14
3,955,14157,3578728688,3578728704,16
3,955,14158,3578728688,3578728705,17
3,955,14159,3578728688,3578728705,17
3,955,14160,3578728688,3578728708,20
3,955,14161,3578728688,3578728710,22
3,955,14162,3578728688,3578728711,23
3,955,14163,3578728688,3578728714,26
3,955,14164,3578728688,3578728716,28
3,955,14165,3578728688,3578728717,29
3,955,14166,3578728688,3578728717,29
3,955,14167,3578728688,3578728720,32
3,955,14168,3578728688,3578728721,33
3,955,14169,3578728688,3578728722,34
3,955,14170,3578728688,3578728723,35
3,955,14171,3578728688,3578728724,36
3,955,14172,3578728688,3578728725,37
3,955,14173,3578728688,3578728731,43
3,955,14174,3578728688,3578728733,45
3,955,14175,3578728688,3578728735,47
3,955,14176,3578728688,3578728737,49
3,955,14177,3578728688,3578728738,50
3,956,14178,3578728745,3578728745,0
3,956,14179,3578728745,3578728745,0
3,956,14180,3578728745,3578728745,0
3,956,14181,3578728745,3578728745,0
3,956,14182,3578728745,3578728745,0
3,956,14183,3578728745,3578728745,0
3,956,14184,3578728745,3578728745,0
3,956,14185,3578728745,3578728746,1
3,956,14186,3578728745,3578728747,2
3,956,14187,3578728745,3578728750,5
3,956,14188,3578728745,3578728751,6
3,956,14189,3578728745,3578728752,7
3,956,14190,3578728745,3578728752,7
3,956,14191,3578728745,3578728752,7
3,956,14192,3578728745,3578728753,8
3,956,14193,3578728745,3578728753,8
3,956,14194,3578728745,3578728753,8
3,956,14195,3578728745,3578728754,9
3,956,14196,3578728745,3578728756,11
3,956,14197,3578728745,3578728757,12
3,956,14198,3578728745,3578728758,13
3,956,14199,3578728745,3578728760,15
3,956,14200,3578728745,3578728763,18
3,956,14201,3578728745,3578728765,20
3,956,14202,3578728745,3578728765,20
3,956,14203,3578728745,3578728766,21
3,956,14204,3578728745,3578728769,24
3,956,14205,3578728745,3578728770,25
3,956,14206,3578728745,3578728772,27
3,956,14207,3578728745,3578728773,28
3,956,14208,3578728745,3578728774,29
3,956,14209,3578728745,3578728774,29
3,956,14210,3578728745,3578728775,30
3,956,14211,3578728745,3578728777,32
3,956,14212,3578728745,3578728778,33
3,956,14213,3578728745,3578728782,37
3,956,14214,3578728745,3578728782,37
3,956,14215,3578728745,3578728783,38
3,956,14216,3578728745,3578728784,39
3,956,14217,3578728745,3578728784,39
3,956,14218,3578728745,3578728785,40
3,956,14219,3578728745,3578728785,40
3,956,14220,3578728745,3578728786,41
3,956,14221,3578728745,3578728786,41
3,956,14222,3578728745,3578728787,42
3,956,14223,3578728745,3578728788,43
3,956,14224,3578728745,3578728788,43
3,956,14225,3578728745,3578728790,45
3,956,14226,3578728745,3578728792,47
3,956,14227,3578728745,3578728792,47
3,956,14228,3578728745,3578728795,50
3,957,14229,3578728802,3578728802,0
3,957,14230,3578728802,3578728802,0
3,957,14231,3578728802,3578728803,1
3,957,14232,3578728802,3578728803,1
3,957,14233,3578728802,3578728804,2
3,957,14234,3578728802,3578728804,2
3,957,14235,3578728802,3578728804,2
3,957,14236,3578728802,3578728805,3
3,957,14237,3578728802,3578728805,3
3,957,14238,3578728802,3578728806,4
3,957,14239,3578728802,3578728808,6
3,957,14240,3578728802,3578728808,6
3,957,14241,3578728802,3578728809,7
3,957,14242,3578728802,3578728810,8
3,957,14243,3578728802,3578728813,11
3,957,14244,3578728802,3578728815,13
3,957,14245,3578728802,3578728816,14
3,957,14246,3578728802,3578728816,14
3,957,14247,3578728802,3578728821,19
3,957,14248,3578728802,3578728822,20
3,957,14249,3578728802,3578728822,20
3,957,14250,3578728802,3578728822,20
3,957,14251,3578728802,3578728822,20
3,957,14252,3578728802,3578728826,24
3,957,14253,3578728802,3578728826,24
3,957,14254,3578728802,3578728826,24
3,957,14255,3578728802,3578728827,25
3,957,14256,3578728802,3578728828,26
3,957,14257,3578728802,3578728828,26
3,957,14258,3578728802,3578728830,28
3,957,14259,3578728802,3578728831,29
3,957,14260,3578728802,3578728831,29
3,957,14261,3578728802,3578728832,30
3,957,14262,3578728802,3578728834,32
3,957,14263,3578728802,3578728834,32
3,957,14264,3578728802,3578728835,33
3,957,14265,3578728802,3578728836,34
3,957,14266,3578728802,3578728836,34
3,957,14267,3578728802,3578728838,36
3,957,14268,3578728802,3578728838,36
3,957,14269,3578728802,3578728839,37
3,957,14270,3578728802,3578728839,37
3,957,14271,3578728802,3578728840,38
3,957,14272,3578728802,3578728840,38
3,957,14273,3578728802,3578728843,41
3,957,14274,3578728802,3578728844,42
3,957,14275,3578728802,3578728844,42
3,957,14276,3578728802,3578728847,45
3,957,14277,3578728802,3578728851,49
3,957,14278,3578728802,3578728851,49
3,958,14279,3578728862,3578728862,0
3,958,14280,3578728862,3578728862,0
3,958,14281,3578728862,3578728862,0
3,958,14282,3578728862,3578728862,0
3,958,14283,3578728862,3578728863,1
3,958,14284,3578728862,3578728863,1
3,958,14285,3578728862,3578728864,2
3,958,14286,3578728862,3578728867,5
3,958,14287,3578728862,3578728868,6
3,958,14288,3578728862,3578728870,8
3,958,14289,3578728862,3578728871,9
3,958,14290,3578728862,3578728873,11
3,958,14291,3578728862,3578728873,11
3,958,14292,3578728862,3578728879,17
3,958,14293,3578728862,3578728880,18
3,958,14294,3578728862,3578728881,19
3,958,14295,3578728862,3578728881,19
3,958,14296,3578728862,3578728881,19
3,958,14297,3578728862,3578728883,21
3,958,14298,3578728862,3578728884,22
3,958,14299,3578728862,3578728885,23
3,958,14300,3578728862,3578728886,24
3,958,14301,3578728862,3578728887,25
3,958,14302,3578728862,3578728889,27
3,958,14303,3578728862,3578728891,29
3,958,14304,3578728862,3578728892,30
3,958,14305,3578728862,3578728893,31
3,958,14306,3578728862,3578728895,33
3,958,14307,3578728862,3578728895,33
3,958,14308,3578728862,3578728896,34
3,958,14309,3578728862,3578728900,38
3,958,14310,3578728862,3578728901,39
3,958,14311,3578728862,3578728902,40
3,958,14312,3578728862,3578728905,43
3,958,14313,3578728862,3578728905,43
3,958,14314,3578728862,3578728906,44
3,958,14315,3578728862,3578728908,46
3,958,14316,3578728862,3578728910,48
3,958,14317,3578728862,3578728911,49
3,959,14318,3578728919,3578728919,0
3,959,14319,3578728919,3578728919,0
3,959,14320,3578728919,3578728919,0
3,959,14321,3578728919,3578728919,0
3,959,14322,3578728919,3578728922,3
3,959,14323,3578728919,3578728922,3
3,959,14324,3578728919,3578728923,4
3,959,14325,3578728919,3578728925,6
3,959,14326,3578728919,3578728926,7
3,959,14327,3578728919,3578728932,13
3,959,14328,3578728919,3578728933,14
3,959,14329,3578728919,3578728937,18
3,959,14330,3578728919,3578728938,19
3,959,14331,3578728919,3578728939,20
3,959,14332,3578728919,3578728939,20
3,959,14333,3578728919,3578728940,21
3,959,14334,3578728919,3578728940,21
3,959,14335,3578728919,3578728940,21
3,959,14336,3578728919,3578728940,21
3,959,14337,3578728919,3578728941,22
3,959,14338,3578728919,3578728944,25
3,959,14339,3578728919,3578728946,27
3,959,14340,3578728919,3578728947,28
3,959,14341,3578728919,3578728950,31
3,959,14342,3578728919,3578728951,32
3,959,14343,3578728919,3578728952,33
3,959,14344,3578728919,3578728952,33
3,959,14345,3578728919,3578728953,34
3,959,14346,3578728919,3578728953,34
3,959,14347,3578728919,3578728953,34
3,959,14348,3578728919,3578728954,35
3,959,14349,3578728919,3578728957,38
3,959,14350,3578728919,3578728958,39
3,959,14351,3578728919,3578728960,41
3,959,14352,3578728919,3578728964,45
3,959,14353,3578728919,3578728965,46
3,959,14354,3578728919,3578728966,47
3,959,14355,3578728919,3578728966,47
3,959,14356,3578728919,3578728966,47
3,959,14357,3578728919,3578728968,49
3,959,14358,3578728919,3578728968,49
3,960,14359,3578728976,3578728976,0
3,960,14360,3578728976,3578728976,0
3,960,14361,3578728976,3578728976,0
3,960,14362,3578728976,3578728976,0
3,960,14363,3578728976,3578728976,0
3,960,14364,3578728976,3578728976,0
3,960,14365,3578728976,3578728978,2
3,960,14366,3578728976,3578728979,3
3,960,14367,3578728976,3578728983,7
3,960,14368,3578728976,3578728983,7
3,960,14369,3578728976,3578728984,8
3,960,14370,3578728976,3578728985,9
3,960,14371,3578728976,3578728985,9
3,960,14372,3578728976,3578728985,9
3,960,14373,3578728976,3578728986,10
3,960,14374,3578728976,3578728986,10
3,960,14375,3578728976,3578728986,10
3,960,14376,3578728976,3578728987,11
3,960,14377,3578728976,3578728988,12
3,960,14378,3578728976,3578728989,13
3,960,14379,3578728976,3578728991,15
3,960,14380,3578728976,3578728991,15
3,960,14381,3578728976,3578728993,17
3,960,14382,3578728976,3578728995,19
3,960,14383,3578728976,3578728999,23
3,960,14384,3578728976,3578729002,26
3,960,14385,3578728976,3578729002,26
3,960,14386,3578728976,3578729003,27
3,960,14387,3578728976,3578729003,27
3,960,14388,3578728976,3578729004,28
3,960,14389,3578728976,3578729004,28
3,960,14390,3578728976,3578729004,28
3,960,14391,3578728976,3578729005,29
3,960,14392,3578728976,3578729007,31
3,960,14393,3578728976,3578729008,32
3,960,14394,3578728976,3578729008,32
3,960,14395,3578728976,3578729008,32
3,960,14396,3578728976,3578729014,38
3,960,14397,3578728976,3578729014,38
3,960,14398,3578728976,3578729015,39
3,960,14399,3578728976,3578729016,40
3,960,14400,3578728976,3578729016,40
3,960,14401,3578728976,3578729021,45
3,960,14402,3578728976,3578729021,45
3,960,14403,3578728976,3578729022,46
3,960,14404,3578728976,3578729022,46
3,960,14405,3578728976,3578729023,47
3,960,14406,3578728976,3578729026,50
3,961,14407,3578729035,3578729035,0
3,961,14408,3578729035,3578729035,0
3,961,14409,3578729035,3578729035,0
3,961,14410,3578729035,3578729035,0
3,961,14411,3578729035,3578729035,0
3,961,14412,3578729035,3578729035,0
3,961,14413,3578729035,3578729035,0
3,961,14414,3578729035,3578729035,0
3,961,14415,3578729035,3578729035,0
3,961,14416,3578729035,3578729035,0
3,961,14417,3578729035,3578729035,0
3,961,14418,3578729035,3578729036,1
3,961,14419,3578729035,3578729036,1
3,961,14420,3578729035,3578729036,1
3,961,14421,3578729035,3578729038,3
3,961,14422,3578729035,3578729038,3
3,961,14423,3578729035,3578729039,4
3,961,14424,3578729035,3578729040,5
3,961,14425,3578729035,3578729041,6
3,961,14426,3578729035,3578729041,6
3,961,14427,3578729035,3578729043,8
3,961,14428,3578729035,3578729043,8
3,961,14429,3578729035,3578729043,8
3,961,14430,3578729035,3578729047,12
3,961,14431,3578729035,3578729050,15
3,961,14432,3578729035,3578729052,17
3,961,14433,3578729035,3578729053,18
3,961,14434,3578729035,3578729055,20
3,961,14435,3578729035,3578729058,23
3,961,14436,3578729035,3578729062,27
3,961,14437,3578729035,3578729062,27
3,961,14438,3578729035,3578729063,28
3,961,14439,3578729035,3578729064,29
3,961,14440,3578729035,3578729064,29
3,961,14441,3578729035,3578729064,29
3,961,14442,3578729035,3578729066,31
3,961,14443,3578729035,3578729068,33
3,961,14444,3578729035,3578729070,35
3,961,14445,3578729035,3578729071,36
3,961,14446,3578729035,3578729073,38
3,961,14447,3578729035,3578729073,38
3,961,14448,3578729035,3578729078,43
3,961,14449,3578729035,3578729080,45
3,961,14450,3578729035,3578729080,45
3,961,14451,3578729035,3578729081,46
3,961,14452,3578729035,3578729081,46
3,961,14453,3578729035,3578729081,46
3,961,14454,3578729035,3578729083,48
3,961,14455,3578729035,3578729084,49
3,962,14456,3578729092,3578729092,0
3,962,14457,3578729092,3578729092,0
3,962,14458,3578729092,3578729092,0
3,962,14459,3578729092,3578729092,0
3,962,14460,3578729092,3578729092,0
3,962,14461,3578729092,3578729092,0
3,962,14462,3578729092,3578729094,2
3,962,14463,3578729092,3578729095,3
3,962,14464,3578729092,3578729096,4
3,962,14465,3578729092,3578729096,4
3,962,14466,3578729092,3578729099,7
3,962,14467,3578729092,3578729100,8
3,962,14468,3578729092,3578729100,8
3,962,14469,3578729092,3578729103,11
3,962,14470,3578729092,3578729105,13
3,962,14471,3578729092,3578729106,14
3,962,14472,3578729092,3578729107,15
3,962,14473,3578729092,3578729108,16
3,962,14474,3578729092,3578729110,18
3,962,14475,3578729092,3578729111,19
3,962,14476,3578729092,3578729117,25
3,962,14477,3578729092,3578729117,25
3,962,14478,3578729092,3578729117,25
3,962,14479,3578729092,3578729117,25
3,962,14480,3578729092,3578729122,30
3,962,14481,3578729092,3578729122,30
3,962,14482,3578729092,3578729123,31
3,962,14483,3578729092,3578729125,33
3,962,14484,3578729092,3578729126,34
3,962,14485,3578729092,3578729131,39
3,962,14486,3578729092,3578729133,41
3,962,14487,3578729092,3578729136,44
3,962,14488,3578729092,3578729138,46
3,962,14489,3578729092,3578729138,46
3,962,14490,3578729092,3578729139,47
3,962,14491,3578729092,3578729139,47
3,962,14492,3578729092,3578729139,47
3,962,14493,3578729092,3578729140,48
3,962,14494,3578729092,3578729140,48
3,962,14495,3578729092,3578729141,49
3,962,14496,3578729092,3578729141,49
3,963,14497,3578729150,3578729150,0
3,963,14498,3578729150,3578729150,0
3,963,14499,3578729150,3578729150,0
3,963,14500,3578729150,3578729152,2
3,963,14501,3578729150,3578729152,2
3,963,14502,3578729150,3578729153,3
3,963,14503,3578729150,3578729153,3
3,963,14504,3578729150,3578729153,3
3,963,14505,3578729150,3578729153,3
3,963,14506,3578729150,3578729154,4
3,963,14507,3578729150,3578729158,8
3,963,14508,3578729150,3578729158,8
3,963,14509,3578729150,3578729158,8
3,963,14510,3578729150,3578729161,11
3,963,14511,3578729150,3578729164,14
3,963,14512,3578729150,3578729166,16
3,963,14513,3578729150,3578729166,16
3,963,14514,3578729150,3578729166,16
3,963,14515,3578729150,3578729166,16
3,963,14516,3578729150,3578729168,18
3,963,14517,3578729150,3578729168,18
3,963,14518,3578729150,3578729171,21
3,963,14519,3578729150,3578729173,23
3,963,14520,3578729150,3578729173,23
3,963,14521,3578729150,3578729174,24
3,963,14522,3578729150,3578729174,24
3,963,14523,3578729150,3578729175,25
3,963,14524,3578729150,3578729177,27
3,963,14525,3578729150,3578729179,29
3,963,14526,3578729150,3578729179,29
3,963,14527,3578729150,3578729183,33
3,963,14528,3578729150,3578729184,34
3,963,14529,3578729150,3578729184,34
3,963,14530,3578729150,3578729185,35
3,963,14531,3578729150,3578729185,35
3,963,14532,3578729150,3578729186,36
3,963,14533,3578729150,3578729186,36
3,963,14534,3578729150,3578729186,36
3,963,14535,3578729150,3578729187,37
3,963,14536,3578729150,3578729187,37
3,963,14537,3578729150,3578729188,38
3,963,14538,3578729150,3578729189,39
3,963,14539,3578729150,3578729189,39
3,963,14540,3578729150,3578729191,41
3,963,14541,3578729150,3578729191,41
3,963,14542,3578729150,3578729192,42
3,963,14543,3578729150,3578729193,43
3,963,14544,3578729150,3578729195,45
3,963,14545,3578729150,3578729199,49
3,964,14546,3578729208,3578729208,0
3,964,14547,3578729208,3578729208,0
3,964,14548,3578729208,3578729208,0
3,964,14549,3578729208,3578729208,0
3,964,14550,3578729208,3578729208,0
3,964,14551,3578729208,3578729208,0
3,964,14552,3578729208,3578729208,0
3,964,14553,3578729208,3578729208,0
3,964,14554,3578729208,3578729208,0
3,964,14555,3578729208,3578729208,0
3,964,14556,3578729208,3578729210,2
3,964,14557,3578729208,3578729214,6
3,964,14558,3578729208,3578729215,7
3,964,14559,3578729208,3578729216,8
3,964,14560,3578729208,3578729216,8
3,964,14561,3578729208,3578729221,13
3,964,14562,3578729208,3578729222,14
3,964,14563,3578729208,3578729222,14
3,964,14564,3578729208,3578729222,14
3,964,14565,3578729208,3578729223,15
3,964,14566,3578729208,3578729227,19
3,964,14567,3578729208,3578729227,19
3,964,14568,3578729208,3578729228,20
3,964,14569,3578729208,3578729229,21
3,964,14570,3578729208,3578729229,21
3,964,14571,3578729208,3578729231,23
3,964,14572,3578729208,3578729233,25
3,964,14573,3578729208,3578729233,25
3,964,14574,3578729208,3578729234,26
3,964,14575,3578729208,3578729235,27
3,964,14576,3578729208,3578729236,28
3,964,14577,3578729208,3578729236,28
3,964,14578,3578729208,3578729236,28
3,964,14579,3578729208,3578729238,30
3,964,14580,3578729208,3578729240,32
3,964,14581,3578729208,3578729241,33
3,964,14582,3578729208,3578729241,33
3,964,14583,3578729208,3578729244,36
3,964,14584,3578729208,3578729244,36
3,964,14585,3578729208,3578729245,37
3,964,14586,3578729208,3578729246,38
3,964,14587,3578729208,3578729251,43
3,964,14588,3578729208,3578729253,45
3,964,14589,3578729208,3578729255,47
3,965,14590,3578729267,3578729267,0
3,965,14591,3578729267,3578729267,0
3,965,14592,3578729267,3578729267,0
3,965,14593,3578729267,3578729267,0
3,965,14594,3578729267,3578729267,0
3,965,14595,3578729267,3578729267,0
3,965,14596,3578729267,3578729267,0
3,965,14597,3578729267,3578729268,1
3,965,14598,3578729267,3578729269,2
3,965,14599,3578729267,3578729273,6
3,965,14600,3578729267,3578729274,7
3,965,14601,3578729267,3578729278,11
3,965,14602,3578729267,3578729280,13
3,965,14603,3578729267,3578729280,13
3,965,14604,3578729267,3578729282,15
3,965,14605,3578729267,3578729282,15
3,965,14606,3578729267,3578729282,15
3,965,14607,3578729267,3578729284,17
3,965,14608,3578729267,3578729285,18
3,965,14609,3578729267,3578729288,21
3,965,14610,3578729267,3578729289,22
3,965,14611,3578729267,3578729289,22
3,965,14612,3578729267,3578729293,26
3,965,14613,3578729267,3578729293,26
3,965,14614,3578729267,3578729294,27
3,965,14615,3578729267,3578729296,29
3,965,14616,3578729267,3578729296,29
3,965,14617,3578729267,3578729299,32
3,965,14618,3578729267,3578729299,32
3,965,14619,3578729267,3578729301,34
3,965,14620,3578729267,3578729303,36
3,965,14621,3578729267,3578729305,38
3,965,14622,3578729267,3578729306,39
3,965,14623,3578729267,3578729308,41
3,965,14624,3578729267,3578729308,41
3,965,14625,3578729267,3578729311,44
3,965,14626,3578729267,3578729317,50
3,966,14627,3578729325,3578729325,0
3,966,14628,3578729325,3578729325,0
3,966,14629,3578729325,3578729325,0
3,966,14630,3578729325,3578729325,0
3,966,14631,3578729325,3578729325,0
3,966,14632,3578729325,3578729325,0
3,966,14633,3578729325,3578729326,1
3,966,14634,3578729325,3578729326,1
3,966,14635,3578729325,3578729331,6
3,966,14636,3578729325,3578729333,8
3,966,14637,3578729325,3578729337,12
3,966,14638,3578729325,3578729338,13
3,966,14639,3578729325,3578729338,13
3,966,14640,3578729325,3578729338,13
3,966,14641,3578729325,3578729340,15
3,966,14642,3578729325,3578729340,15
3,966,14643,3578729325,3578729340,15
3,966,14644,3578729325,3578729341,16
3,966,14645,3578729325,3578729341,16
3,966,14646,3578729325,3578729342,17
3,966,14647,3578729325,3578729344,19
3,966,14648,3578729325,3578729346,21
3,966,14649,3578729325,3578729348,23
3,966,14650,3578729325,3578729349,24
3,966,14651,3578729325,3578729353,28
3,966,14652,3578729325,3578729353,28
3,966,14653,3578729325,3578729353,28
3,966,14654,3578729325,3578729354,29
3,966,14655,3578729325,3578729354,29
3,966,14656,3578729325,3578729355,30
3,966,14657,3578729325,3578729358,33
3,966,14658,3578729325,3578729358,33
3,966,14659,3578729325,3578729360,35
3,966,14660,3578729325,3578729363,38
3,966,14661,3578729325,3578729365,40
3,966,14662,3578729325,3578729366,41
3,966,14663,3578729325,3578729366,41
3,966,14664,3578729325,3578729366,41
3,966,14665,3578729325,3578729368,43
3,966,14666,3578729325,3578729369,44
3,966,14667,3578729325,3578729370,45
3,966,14668,3578729325,3578729373,48
3,966,14669,3578729325,3578729373,48
3,966,14670,3578729325,3578729375,50
3,967,14671,3578729383,3578729383,0
3,967,14672,3578729383,3578729383,0
3,967,14673,3578729383,3578729383,0
3,967,14674,3578729383,3578729383,0
3,967,14675,3578729383,3578729384,1
3,967,14676,3578729383,3578729384,1
3,967,14677,3578729383,3578729385,2
3,967,14678,3578729383,3578729385,2
3,967,14679,3578729383,3578729386,3
3,967,14680,3578729383,3578729386,3
3,967,14681,3578729383,3578729387,4
3,967,14682,3578729383,3578729387,4
3,967,14683,3578729383,3578729387,4
3,967,14684,3578729383,3578729388,5
3,967,14685,3578729383,3578729389,6
3,967,14686,3578729383,3578729389,6
3,967,14687,3578729383,3578729392,9
3,967,14688,3578729383,3578729392,9
3,967,14689,3578729383,3578729393,10
3,967,14690,3578729383,3578729396,13
3,967,14691,3578729383,3578729399,16
3,967,14692,3578729383,3578729402,19
3,967,14693,3578729383,3578729403,20
3,967,14694,3578729383,3578729404,21
3,967,14695,3578729383,3578729405,22
3,967,14696,3578729383,3578729405,22
3,967,14697,3578729383,3578729405,22
3,967,14698,3578729383,3578729406,23
3,967,14699,3578729383,3578729407,24
3,967,14700,3578729383,3578729407,24
3,967,14701,3578729383,3578729408,25
3,967,14702,3578729383,3578729409,26
3,967,14703,3578729383,3578729410,27
3,967,14704,3578729383,3578729414,31
3,967,14705,3578729383,3578729416,33
3,967,14706,3578729383,3578729416,33
3,967,14707,3578729383,3578729416,33
3,967,14708,3578729383,3578729421,38
3,967,14709,3578729383,3578729422,39
3,967,14710,3578729383,3578729422,39
3,967,14711,3578729383,3578729424,41
3,967,14712,3578729383,3578729426,43
3,967,14713,3578729383,3578729427,44
3,967,14714,3578729383,3578729427,44
3,967,14715,3578729383,3578729428,45
3,967,14716,3578729383,3578729428,45
3,967,14717,3578729383,3578729430,47
3,967,14718,3578729383,3578729431,48
3,967,14719,3578729383,3578729433,50
3,968,14720,3578729442,3578729442,0
3,968,14721,3578729442,3578729442,0
3,968,14722,3578729442,3578729442,0
3,968,14723,3578729442,3578729442,0
3,968,14724,3578729442,3578729442,0
3,968,14725,3578729442,3578729442,0
3,968,14726,3578729442,3578729442,0
3,968,14727,3578729442,3578729442,0
3,968,14728,3578729442,3578729442,0
3,968,14729,3578729442,3578729442,0
3,968,14730,3578729442,3578729442,0
3,968,14731,3578729442,3578729444,2
3,968,14732,3578729442,3578729444,2
3,968,14733,3578729442,3578729444,2
3,968,14734,3578729442,3578729446,4
3,968,14735,3578729442,3578729450,8
3,968,14736,3578729442,3578729453,11
3,968,14737,3578729442,3578729454,12
3,968,14738,3578729442,3578729455,13
3,968,14739,3578729442,3578729457,15
3,968,14740,3578729442,3578729458,16
3,968,14741,3578729442,3578729462,20
3,968,14742,3578729442,3578729462,20
3,968,14743,3578729442,3578729463,21
3,968,14744,3578729442,3578729464,22
3,968,14745,3578729442,3578729464,22
3,968,14746,3578729442,3578729465,23
3,968,14747,3578729442,3578729468,26
3,968,14748,3578729442,3578729469,27
3,968,14749,3578729442,3578729470,28
3,968,14750,3578729442,3578729473,31
3,968,14751,3578729442,3578729474,32
3,968,14752,3578729442,3578729478,36
3,968,14753,3578729442,3578729479,37
3,968,14754,3578729442,3578729480,38
3,968,14755,3578729442,3578729481,39
3,968,14756,3578729442,3578729481,39
3,968,14757,3578729442,3578729482,40
3,968,14758,3578729442,3578729485,43
3,968,14759,3578729442,3578729485,43
3,968,14760,3578729442,3578729488,46
3,968,14761,3578729442,3578729488,46
3,968,14762,3578729442,3578729489,47
3,968,14763,3578729442,3578729491,49
3,968,14764,3578729442,3578729492,50
3,969,14765,3578729499,3578729499,0
3,969,14766,3578729499,3578729499,0
3,969,14767,3578729499,3578729499,0
3,969,14768,3578729499,3578729499,0
3,969,14769,3578729499,3578729499,0
3,969,14770,3578729499,3578729499,0
3,969,14771,3578729499,3578729500,1
3,969,14772,3578729499,3578729502,3
3,969,14773,3578729499,3578729504,5
3,969,14774,3578729499,3578729504,5
3,969,14775,3578729499,3578729507,8
3,969,14776,3578729499,3578729508,9
3,969,14777,3578729499,3578729510,11
3,969,14778,3578729499,3578729516,17
3,969,14779,3578729499,3578729517,18
3,969,14780,3578729499,3578729518,19
3,969,14781,3578729499,3578729519,20
3,969,14782,3578729499,3578729520,21
3,969,14783,3578729499,3578729522,23
3,969,14784,3578729499,3578729523,24
3,969,14785,3578729499,3578729523,24
3,969,14786,3578729499,3578729524,25
3,969,14787,3578729499,3578729526,27
3,969,14788,3578729499,3578729531,32
3,969,14789,3578729499,3578729532,33
3,969,14790,3578729499,3578729536,37
3,969,14791,3578729499,3578729537,38
3,969,14792,3578729499,3578729537,38
3,969,14793,3578729499,3578729538,39
3,969,14794,3578729499,3578729539,40
3,969,14795,3578729499,3578729540,41
3,969,14796,3578729499,3578729540,41
3,969,14797,3578729499,3578729540,41
3,969,14798,3578729499,3578729540,41
3,969,14799,3578729499,3578729541,42
3,969,14800,3578729499,3578729544,45
3,969,14801,3578729499,3578729546,47
3,969,14802,3578729499,3578729547,48
3,969,14803,3578729499,3578729549,50
3,970,14804,3578729556,3578729556,0
3,970,14805,3578729556,3578729556,0
3,970,14806,3578729556,3578729556,0
3,970,14807,3578729556,3578729556,0
3,970,14808,3578729556,3578729556,0
3,970,14809,3578729556,3578729556,0
3,970,14810,3578729556,3578729556,0
3,970,14811,3578729556,3578729556,0
3,970,14812,3578729556,3578729556,0
3,970,14813,3578729556,3578729557,1
3,970,14814,3578729556,3578729560,4
3,970,14815,3578729556,3578729562,6
3,970,14816,3578729556,3578729566,10
3,970,14817,3578729556,3578729566,10
3,970,14818,3578729556,3578729566,10
3,970,14819,3578729556,3578729569,13
3,970,14820,3578729556,3578729569,13
3,970,14821,3578729556,3578729571,15
3,970,14822,3578729556,3578729572,16
3,970,14823,3578729556,3578729573,17
3,970,14824,3578729556,3578729574,18
3,970,14825,3578729556,3578729574,18
3,970,14826,3578729556,3578729575,19
3,970,14827,3578729556,3578729577,21
3,970,14828,3578729556,3578729578,22
3,970,14829,3578729556,3578729582,26
3,970,14830,3578729556,3578729583,27
3,970,14831,3578729556,3578729584,28
3,970,14832,3578729556,3578729584,28
3,970,14833,3578729556,3578729584,28
3,970,14834,3578729556,3578729585,29
3,970,14835,3578729556,3578729586,30
3,970,14836,3578729556,3578729586,30
3,970,14837,3578729556,3578729586,30
3,970,14838,3578729556,3578729587,31
3,970,14839,3578729556,3578729588,32
3,970,14840,3578729556,3578729589,33
3,970,14841,3578729556,3578729591,35
3,970,14842,3578729556,3578729591,35
3,970,14843,3578729556,3578729592,36
3,970,14844,3578729556,3578729594,38
3,970,14845,3578729556,3578729598,42
3,970,14846,3578729556,3578729601,45
3,970,14847,3578729556,3578729603,47
3,970,14848,3578729556,3578729603,47
3,970,14849,3578729556,3578729604,48
3,970,14850,3578729556,3578729604,48
3,970,14851,3578729556,3578729604,48
3,970,14852,3578729556,3578729605,49
3,971,14853,3578729613,3578729613,0
3,971,14854,3578729613,3578729613,0
3,971,14855,3578729613,3578729613,0
3,971,14856,3578729613,3578729613,0
3,971,14857,3578729613,3578729613,0
3,971,14858,3578729613,3578729613,0
3,971,14859,3578729613,3578729615,2
3,971,14860,3578729613,3578729616,3
3,971,14861,3578729613,3578729616,3
3,971,14862,3578729613,3578729617,4
3,971,14863,3578729613,3578729620,7
3,971,14864,3578729613,3578729621,8
3,971,14865,3578729613,3578729621,8
3,971,14866,3578729613,3578729622,9
3,971,14867,3578729613,3578729623,10
3,971,14868,3578729613,3578729624,11
3,971,14869,3578729613,3578729626,13
3,971,14870,3578729613,3578729627,14
3,971,14871,3578729613,3578729627,14
3,971,14872,3578729613,3578729627,14
3,971,14873,3578729613,3578729628,15
3,971,14874,3578729613,3578729629,16
3,971,14875,3578729613,3578729631,18
3,971,14876,3578729613,3578729633,20
3,971,14877,3578729613,3578729633,20
3,971,14878,3578729613,3578729634,21
3,971,14879,3578729613,3578729635,22
3,971,14880,3578729613,3578729635,22
3,971,14881,3578729613,3578729635,22
3,971,14882,3578729613,3578729635,22
3,971,14883,3578729613,3578729637,24
3,971,14884,3578729613,3578729637,24
3,971,14885,3578729613,3578729638,25
3,971,14886,3578729613,3578729638,25
3,971,14887,3578729613,3578729639,26
3,971,14888,3578729613,3578729642,29
3,971,14889,3578729613,3578729643,30
3,971,14890,3578729613,3578729643,30
3,971,14891,3578729613,3578729643,30
3,971,14892,3578729613,3578729646,33
3,971,14893,3578729613,3578729652,39
3,971,14894,3578729613,3578729655,42
3,971,14895,3578729613,3578729657,44
3,971,14896,3578729613,3578729660,47
3,971,14897,3578729613,3578729661,48
3,971,14898,3578729613,3578729662,49
3,971,14899,3578729613,3578729662,49
3,971,14900,3578729613,3578729663,50
3,972,14901,3578729670,3578729670,0
3,972,14902,3578729670,3578729670,0
3,972,14903,3578729670,3578729670,0
3,972,14904,3578729670,3578729671,1
3,972,14905,3578729670,3578729673,3
3,972,14906,3578729670,3578729674,4
3,972,14907,3578729670,3578729679,9
3,972,14908,3578729670,3578729680,10
3,972,14909,3578729670,3578729681,11
3,972,14910,3578729670,3578729682,12
3,972,14911,3578729670,3578729683,13
3,972,14912,3578729670,3578729685,15
3,972,14913,3578729670,3578729685,15
3,972,14914,3578729670,3578729688,18
3,972,14915,3578729670,3578729688,18
3,972,14916,3578729670,3578729689,19
3,972,14917,3578729670,3578729691,21
3,972,14918,3578729670,3578729692,22
3,972,14919,3578729670,3578729694,24
3,972,14920,3578729670,3578729694,24
3,972,14921,3578729670,3578729695,25
3,972,14922,3578729670,3578729696,26
3,972,14923,3578729670,3578729698,28
3,972,14924,3578729670,3578729699,29
3,972,14925,3578729670,3578729700,30
3,972,14926,3578729670,3578729700,30
3,972,14927,3578729670,3578729701,31
3,972,14928,3578729670,3578729704,34
3,972,14929,3578729670,3578729704,34
3,972,14930,3578729670,3578729707,37
3,972,14931,3578729670,3578729708,38
3,972,14932,3578729670,3578729710,40
3,972,14933,3578729670,3578729716,46
3,972,14934,3578729670,3578729718,48
3,972,14935,3578729670,3578729718,48
3,973,14936,3578729730,3578729730,0
3,973,14937,3578729730,3578729730,0
3,973,14938,3578729730,3578729730,0
3,973,14939,3578729730,3578729730,0
3,973,14940,3578729730,3578729730,0
3,973,14941,3578729730,3578729730,0
3,973,14942,3578729730,3578729730,0
3,973,14943,3578729730,3578729731,1
3,973,14944,3578729730,3578729732,2
3,973,14945,3578729730,3578729736,6
3,973,14946,3578729730,3578729738,8
3,973,14947,3578729730,3578729738,8
3,973,14948,3578729730,3578729739,9
3,973,14949,3578729730,3578729740,10
3,973,14950,3578729730,3578729740,10
3,973,14951,3578729730,3578729740,10
3,973,14952,3578729730,3578729741,11
3,973,14953,3578729730,3578729741,11
3,973,14954,3578729730,3578729744,14
3,973,14955,3578729730,3578729746,16
3,973,14956,3578729730,3578729747,17
3,973,14957,3578729730,3578729749,19
3,973,14958,3578729730,3578729751,21
3,973,14959,3578729730,3578729752,22
3,973,14960,3578729730,3578729752,22
3,973,14961,3578729730,3578729753,23
3,973,14962,3578729730,3578729753,23
3,973,14963,3578729730,3578729753,23
3,973,14964,3578729730,3578729753,23
3,973,14965,3578729730,3578729754,24
3,973,14966,3578729730,3578729756,26
3,973,14967,3578729730,3578729757,27
3,973,14968,3578729730,3578729761,31
3,973,14969,3578729730,3578729763,33
3,973,14970,3578729730,3578729765,35
3,973,14971,3578729730,3578729766,36
3,973,14972,3578729730,3578729766,36
3,973,14973,3578729730,3578729766,36
3,973,14974,3578729730,3578729768,38
3,973,14975,3578729730,3578729769,39
3,973,14976,3578729730,3578729771,41
3,973,14977,3578729730,3578729771,41
3,973,14978,3578729730,3578729772,42
3,973,14979,3578729730,3578729772,42
3,973,14980,3578729730,3578729774,44
3,973,14981,3578729730,3578729774,44
3,973,14982,3578729730,3578729774,44
3,973,14983,3578729730,3578729775,45
3,973,14984,3578729730,3578729778,48
3,974,14985,3578729792,3578729792,0
3,974,14986,3578729792,3578729792,0
3,974,14987,3578729792,3578729792,0
3,974,14988,3578729792,3578729792,0
3,974,14989,3578729792,3578729792,0
3,974,14990,3578729792,3578729792,0
3,974,14991,3578729792,3578729792,0
3,974,14992,3578729792,3578729792,0
3,974,14993,3578729792,3578729792,0
3,974,14994,3578729792,3578729792,0
3,974,14995,3578729792,3578729792,0
3,974,14996,3578729792,3578729792,0
3,974,14997,3578729792,3578729792,0
3,974,14998,3578729792,3578729792,0
3,974,14999,3578729792,3578729793,1
3,974,15000,3578729792,3578729794,2
3,974,15001,3578729792,3578729798,6
3,974,15002,3578729792,3578729801,9
3,974,15003,3578729792,3578729802,10
3,974,15004,3578729792,3578729803,11
3,974,15005,3578729792,3578729803,11
3,974,15006,3578729792,3578729804,12
3,974,15007,3578729792,3578729804,12
3,974,15008,3578729792,3578729804,12
3,974,15009,3578729792,3578729804,12
3,974,15010,3578729792,3578729805,13
3,974,15011,3578729792,3578729807,15
3,974,15012,3578729792,3578729807,15
3,974,15013,3578729792,3578729808,16
3,974,15014,3578729792,3578729808,16
3,974,15015,3578729792,3578729809,17
3,974,15016,3578729792,3578729813,21
3,974,15017,3578729792,3578729813,21
3,974,15018,3578729792,3578729815,23
3,974,15019,3578729792,3578729816,24
3,974,15020,3578729792,3578729816,24
3,974,15021,3578729792,3578729818,26
3,974,15022,3578729792,3578729820,28
3,974,15023,3578729792,3578729821,29
3,974,15024,3578729792,3578729821,29
3,974,15025,3578729792,3578729823,31
3,974,15026,3578729792,3578729825,33
3,974,15027,3578729792,3578729826,34
3,974,15028,3578729792,3578729826,34
3,974,15029,3578729792,3578729827,35
3,974,15030,3578729792,3578729827,35
3,974,15031,3578729792,3578729828,36
3,974,15032,3578729792,3578729829,37
3,974,15033,3578729792,3578729831,39
3,974,15034,3578729792,3578729831,39
3,974,15035,3578729792,3578729832,40
3,974,15036,3578729792,3578729832,40
3,974,15037,3578729792,3578729834,42
3,974,15038,3578729792,3578729835,43
3,974,15039,3578729792,3578729835,43
3,974,15040,3578729792,3578729835,43
3,974,15041,3578729792,3578729836,44
3,974,15042,3578729792,3578729836,44
3,974,15043,3578729792,3578729838,46
3,974,15044,3578729792,3578729839,47
3,974,15045,3578729792,3578729839,47
3,974,15046,3578729792,3578729839,47
3,975,15047,3578729852,3578729852,0
3,975,15048,3578729852,3578729852,0
3,975,15049,3578729852,3578729852,0
3,975,15050,3578729852,3578729852,0
3,975,15051,3578729852,3578729852,0
3,975,15052,3578729852,3578729853,1
3,975,15053,3578729852,3578729853,1
3,975,15054,3578729852,3578729855,3
3,975,15055,3578729852,3578729857,5
3,975,15056,3578729852,3578729862,10
3,975,15057,3578729852,3578729862,10
3,975,15058,3578729852,3578729863,11
3,975,15059,3578729852,3578729864,12
3,975,15060,3578729852,3578729865,13
3,975,15061,3578729852,3578729868,16
3,975,15062,3578729852,3578729869,17
3,975,15063,3578729852,3578729869,17
3,975,15064,3578729852,3578729873,21
3,975,15065,3578729852,3578729873,21
3,975,15066,3578729852,3578729874,22
3,975,15067,3578729852,3578729879,27
3,975,15068,3578729852,3578729880,28
3,975,15069,3578729852,3578729880,28
3,975,15070,3578729852,3578729881,29
3,975,15071,3578729852,3578729881,29
3,975,15072,3578729852,3578729883,31
3,975,15073,3578729852,3578729885,33
3,975,15074,3578729852,3578729885,33
3,975,15075,3578729852,3578729888,36
3,975,15076,3578729852,3578729888,36
3,975,15077,3578729852,3578729892,40
3,975,15078,3578729852,3578729892,40
3,975,15079,3578729852,3578729894,42
3,975,15080,3578729852,3578729895,43
3,975,15081,3578729852,3578729896,44
3,975,15082,3578729852,3578729898,46
3,975,15083,3578729852,3578729899,47
3,975,15084,3578729852,3578729900,48
3,975,15085,3578729852,3578729900,48
3,976,15086,3578729909,3578729909,0
3,976,15087,3578729909,3578729909,0
3,976,15088,3578729909,3578729909,0
3,976,15089,3578729909,3578729909,0
3,976,15090,3578729909,3578729910,1
3,976,15091,3578729909,3578729915,6
3,976,15092,3578729909,3578729918,9
3,976,15093,3578729909,3578729918,9
3,976,15094,3578729909,3578729920,11
3,976,15095,3578729909,3578729922,13
3,976,15096,3578729909,3578729922,13
3,976,15097,3578729909,3578729924,15
3,976,15098,3578729909,3578729925,16
3,976,15099,3578729909,3578729926,17
3,976,15100,3578729909,3578729926,17
3,976,15101,3578729909,3578729932,23
3,976,15102,3578729909,3578729936,27
3,976,15103,3578729909,3578729938,29
3,976,15104,3578729909,3578729939,30
3,976,15105,3578729909,3578729939,30
3,976,15106,3578729909,3578729939,30
3,976,15107,3578729909,3578729939,30
3,976,15108,3578729909,3578729940,31
3,976,15109,3578729909,3578729941,32
3,976,15110,3578729909,3578729941,32
3,976,15111,3578729909,3578729941,32
3,976,15112,3578729909,3578729944,35
3,976,15113,3578729909,3578729946,37
3,976,15114,3578729909,3578729947,38
3,976,15115,3578729909,3578729949,40
3,976,15116,3578729909,3578729951,42
3,976,15117,3578729909,3578729952,43
3,976,15118,3578729909,3578729952,43
3,976,15119,3578729909,3578729953,44
3,976,15120,3578729909,3578729953,44
3,976,15121,3578729909,3578729953,44
3,976,15122,3578729909,3578729954,45
3,976,15123,3578729909,3578729954,45
3,976,15124,3578729909,3578729957,48
3,976,15125,3578729909,3578729957,48
3,977,15126,3578729968,3578729968,0
3,977,15127,3578729968,3578729968,0
3,977,15128,3578729968,3578729968,0
3,977,15129,3578729968,3578729968,0
3,977,15130,3578729968,3578729968,0
3,977,15131,3578729968,3578729968,0
3,977,15132,3578729968,3578729968,0
3,977,15133,3578729968,3578729969,1
3,977,15134,3578729968,3578729972,4
3,977,15135,3578729968,3578729972,4
3,977,15136,3578729968,3578729972,4
3,977,15137,3578729968,3578729973,5
3,977,15138,3578729968,3578729973,5
3,977,15139,3578729968,3578729974,6
3,977,15140,3578729968,3578729975,7
3,977,15141,3578729968,3578729975,7
3,977,15142,3578729968,3578729979,11
3,977,15143,3578729968,3578729983,15
3,977,15144,3578729968,3578729984,16
3,977,15145,3578729968,3578729984,16
3,977,15146,3578729968,3578729986,18
3,977,15147,3578729968,3578729986,18
3,977,15148,3578729968,3578729986,18
3,977,15149,3578729968,3578729986,18
3,977,15150,3578729968,3578729987,19
3,977,15151,3578729968,3578729987,19
3,977,15152,3578729968,3578729988,20
3,977,15153,3578729968,3578729988,20
3,977,15154,3578729968,3578729990,22
3,977,15155,3578729968,3578729990,22
3,977,15156,3578729968,3578729991,23
3,977,15157,3578729968,3578729991,23
3,977,15158,3578729968,3578729993,25
3,977,15159,3578729968,3578729995,27
3,977,15160,3578729968,3578729998,30
3,977,15161,3578729968,3578730001,33
3,977,15162,3578729968,3578730003,35
3,977,15163,3578729968,3578730003,35
3,977,15164,3578729968,3578730004,36
3,977,15165,3578729968,3578730004,36
3,977,15166,3578729968,3578730004,36
3,977,15167,3578729968,3578730004,36
3,977,15168,3578729968,3578730008,40
3,977,15169,3578729968,3578730008,40
3,977,15170,3578729968,3578730008,40
3,977,15171,3578729968,3578730008,40
3,977,15172,3578729968,3578730015,47
3,977,15173,3578729968,3578730015,47
3,977,15174,3578729968,3578730015,47
3,977,15175,3578729968,3578730016,48
3,977,15176,3578729968,3578730018,50
3,978,15177,3578730024,3578730024,0
3,978,15178,3578730024,3578730024,0
3,978,15179,3578730024,3578730024,0
3,978,15180,3578730024,3578730025,1
3,978,15181,3578730024,3578730025,1
3,978,15182,3578730024,3578730025,1
3,978,15183,3578730024,3578730026,2
3,978,15184,3578730024,3578730027,3
3,978,15185,3578730024,3578730027,3
3,978,15186,3578730024,3578730027,3
3,978,15187,3578730024,3578730029,5
3,978,15188,3578730024,3578730030,6
3,978,15189,3578730024,3578730031,7
3,978,15190,3578730024,3578730032,8
3,978,15191,3578730024,3578730032,8
3,978,15192,3578730024,3578730033,9
3,978,15193,3578730024,3578730034,10
3,978,15194,3578730024,3578730034,10
3,978,15195,3578730024,3578730035,11
3,978,15196,3578730024,3578730036,12
3,978,15197,3578730024,3578730037,13
3,978,15198,3578730024,3578730037,13
3,978,15199,3578730024,3578730038,14
3,978,15200,3578730024,3578730039,15
3,978,15201,3578730024,3578730039,15
3,978,15202,3578730024,3578730039,15
3,978,15203,3578730024,3578730039,15
3,978,15204,3578730024,3578730043,19
3,978,15205,3578730024,3578730045,21
3,978,15206,3578730024,3578730045,21
3,978,15207,3578730024,3578730046,22
3,978,15208,3578730024,3578730047,23
3,978,15209,3578730024,3578730051,27
3,978,15210,3578730024,3578730053,29
3,978,15211,3578730024,3578730055,31
3,978,15212,3578730024,3578730058,34
3,978,15213,3578730024,3578730061,37
3,978,15214,3578730024,3578730062,38
3,978,15215,3578730024,3578730063,39
3,978,15216,3578730024,3578730064,40
3,978,15217,3578730024,3578730066,42
3,978,15218,3578730024,3578730068,44
3,978,15219,3578730024,3578730068,44
3,978,15220,3578730024,3578730070,46
3,978,15221,3578730024,3578730073,49
3,978,15222,3578730024,3578730073,49
3,978,15223,3578730024,3578730073,49
3,978,15224,3578730024,3578730074,50
3,979,15225,3578730081,3578730081,0
3,979,15226,3578730081,3578730081,0
3,979,15227,3578730081,3578730081,0
3,979,15228,3578730081,3578730081,0
3,979,15229,3578730081,3578730082,1
3,979,15230,3578730081,3578730083,2
3,979,15231,3578730081,3578730083,2
3,979,15232,3578730081,3578730085,4
3,979,15233,3578730081,3578730085,4
3,979,15234,3578730081,3578730088,7
3,979,15235,3578730081,3578730088,7
3,979,15236,3578730081,3578730089,8
3,979,15237,3578730081,3578730092,11
3,979,15238,3578730081,3578730092,11
3,979,15239,3578730081,3578730094,13
3,979,15240,3578730081,3578730094,13
3,979,15241,3578730081,3578730095,14
3,979,15242,3578730081,3578730096,15
3,979,15243,3578730081,3578730098,17
3,979,15244,3578730081,3578730099,18
3,979,15245,3578730081,3578730099,18
3,979,15246,3578730081,3578730100,19
3,979,15247,3578730081,3578730103,22
3,979,15248,3578730081,3578730104,23
3,979,15249,3578730081,3578730108,27
3,979,15250,3578730081,3578730110,29
3,979,15251,3578730081,3578730110,29
3,979,15252,3578730081,3578730116,35
3,979,15253,3578730081,3578730118,37
3,979,15254,3578730081,3578730118,37
3,979,15255,3578730081,3578730122,41
3,979,15256,3578730081,3578730122,41
3,979,15257,3578730081,3578730125,44
3,979,15258,3578730081,3578730126,45
3,979,15259,3578730081,3578730126,45
3,979,15260,3578730081,3578730126,45
3,980,15261,3578730139,3578730139,0
3,980,15262,3578730139,3578730139,0
3,980,15263,3578730139,3578730139,0
3,980,15264,3578730139,3578730139,0
3,980,15265,3578730139,3578730139,0
3,980,15266,3578730139,3578730139,0
3,980,15267,3578730139,3578730140,1
3,980,15268,3578730139,3578730140,1
3,980,15269,3578730139,3578730141,2
3,980,15270,3578730139,3578730141,2
3,980,15271,3578730139,3578730144,5
3,980,15272,3578730139,3578730147,8
3,980,15273,3578730139,3578730149,10
3,980,15274,3578730139,3578730149,10
3,980,15275,3578730139,3578730151,12
3,980,15276,3578730139,3578730152,13
3,980,15277,3578730139,3578730153,14
3,980,15278,3578730139,3578730153,14
3,980,15279,3578730139,3578730153,14
3,980,15280,3578730139,3578730154,15
3,980,15281,3578730139,3578730154,15
3,980,15282,3578730139,3578730155,16
3,980,15283,3578730139,3578730158,19
3,980,15284,3578730139,3578730158,19
3,980,15285,3578730139,3578730161,22
3,980,15286,3578730139,3578730164,25
3,980,15287,3578730139,3578730165,26
3,980,15288,3578730139,3578730166,27
3,980,15289,3578730139,3578730166,27
3,980,15290,3578730139,3578730167,28
3,980,15291,3578730139,3578730169,30
3,980,15292,3578730139,3578730172,33
3,980,15293,3578730139,3578730173,34
3,980,15294,3578730139,3578730174,35
3,980,15295,3578730139,3578730174,35
3,980,15296,3578730139,3578730174,35
3,980,15297,3578730139,3578730176,37
3,980,15298,3578730139,3578730179,40
3,980,15299,3578730139,3578730183,44
3,980,15300,3578730139,3578730184,45
3,980,15301,3578730139,3578730184,45
3,980,15302,3578730139,3578730185,46
3,980,15303,3578730139,3578730186,47
3,980,15304,3578730139,3578730186,47
3,980,15305,3578730139,3578730186,47
3,980,15306,3578730139,3578730186,47
3,980,15307,3578730139,3578730187,48
3,980,15308,3578730139,3578730188,49
3,980,15309,3578730139,3578730188,49
3,981,15310,3578730196,3578730196,0
3,981,15311,3578730196,3578730196,0
3,981,15312,3578730196,3578730196,0
3,981,15313,3578730196,3578730197,1
3,981,15314,3578730196,3578730197,1
3,981,15315,3578730196,3578730198,2
3,981,15316,3578730196,3578730202,6
3,981,15317,3578730196,3578730204,8
3,981,15318,3578730196,3578730204,8
3,981,15319,3578730196,3578730204,8
3,981,15320,3578730196,3578730205,9
3,981,15321,3578730196,3578730205,9
3,981,15322,3578730196,3578730207,11
3,981,15323,3578730196,3578730208,12
3,981,15324,3578730196,3578730208,12
3,981,15325,3578730196,3578730208,12
3,981,15326,3578730196,3578730215,19
3,981,15327,3578730196,3578730216,20
3,981,15328,3578730196,3578730217,21
3,981,15329,3578730196,3578730217,21
3,981,15330,3578730196,3578730219,23
3,981,15331,3578730196,3578730220,24
3,981,15332,3578730196,3578730221,25
3,981,15333,3578730196,3578730222,26
3,981,15334,3578730196,3578730222,26
3,981,15335,3578730196,3578730223,27
3,981,15336,3578730196,3578730225,29
3,981,15337,3578730196,3578730226,30
3,981,15338,3578730196,3578730226,30
3,981,15339,3578730196,3578730227,31
3,981,15340,3578730196,3578730227,31
3,981,15341,3578730196,3578730227,31
3,981,15342,3578730196,3578730230,34
3,981,15343,3578730196,3578730231,35
3,981,15344,3578730196,3578730232,36
3,981,15345,3578730196,3578730232,36
3,981,15346,3578730196,3578730235,39
3,981,15347,3578730196,3578730235,39
3,981,15348,3578730196,3578730236,40
3,981,15349,3578730196,3578730237,41
3,981,15350,3578730196,3578730237,41
3,981,15351,3578730196,3578730239,43
3,981,15352,3578730196,3578730239,43
3,981,15353,3578730196,3578730239,43
3,981,15354,3578730196,3578730240,44
3,981,15355,3578730196,3578730240,44
3,981,15356,3578730196,3578730244,48
3,981,15357,3578730196,3578730245,49
3,981,15358,3578730196,3578730246,50
3,982,15359,3578730254,3578730254,0
3,982,15360,3578730254,3578730254,0
3,982,15361,3578730254,3578730254,0
3,982,15362,3578730254,3578730254,0
3,982,15363,3578730254,3578730254,0
3,982,15364,3578730254,3578730255,1
3,982,15365,3578730254,3578730257,3
3,982,15366,3578730254,3578730259,5
3,982,15367,3578730254,3578730261,7
3,982,15368,3578730254,3578730263,9
3,982,15369,3578730254,3578730264,10
3,982,15370,3578730254,3578730265,11
3,982,15371,3578730254,3578730265,11
3,982,15372,3578730254,3578730268,14
3,982,15373,3578730254,3578730268,14
3,982,15374,3578730254,3578730269,15
3,982,15375,3578730254,3578730273,19
3,982,15376,3578730254,3578730273,19
3,982,15377,3578730254,3578730273,19
3,982,15378,3578730254,3578730275,21
3,982,15379,3578730254,3578730276,22
3,982,15380,3578730254,3578730278,24
3,982,15381,3578730254,3578730281,27
3,982,15382,3578730254,3578730281,27
3,982,15383,3578730254,3578730283,29
3,982,15384,3578730254,3578730283,29
3,982,15385,3578730254,3578730283,29
3,982,15386,3578730254,3578730285,31
3,982,15387,3578730254,3578730286,32
3,982,15388,3578730254,3578730288,34
3,982,15389,3578730254,3578730288,34
3,982,15390,3578730254,3578730292,38
3,982,15391,3578730254,3578730292,38
3,982,15392,3578730254,3578730293,39
3,982,15393,3578730254,3578730294,40
3,982,15394,3578730254,3578730295,41
3,982,15395,3578730254,3578730296,42
3,982,15396,3578730254,3578730298,44
3,982,15397,3578730254,3578730299,45
3,982,15398,3578730254,3578730300,46
3,982,15399,3578730254,3578730303,49
3,983,15400,3578730314,3578730314,0
3,983,15401,3578730314,3578730314,0
3,983,15402,3578730314,3578730314,0
3,983,15403,3578730314,3578730314,0
3,983,15404,3578730314,3578730317,3
3,983,15405,3578730314,3578730318,4
3,983,15406,3578730314,3578730318,4
3,983,15407,3578730314,3578730320,6
3,983,15408,3578730314,3578730321,7
3,983,15409,3578730314,3578730322,8
3,983,15410,3578730314,3578730325,11
3,983,15411,3578730314,3578730326,12
3,983,15412,3578730314,3578730326,12
3,983,15413,3578730314,3578730326,12
3,983,15414,3578730314,3578730331,17
3,983,15415,3578730314,3578730333,19
3,983,15416,3578730314,3578730339,25
3,983,15417,3578730314,3578730340,26
3,983,15418,3578730314,3578730340,26
3,983,15419,3578730314,3578730340,26
3,983,15420,3578730314,3578730341,27
3,983,15421,3578730314,3578730341,27
3,983,15422,3578730314,3578730342,28
3,983,15423,3578730314,3578730344,30
3,983,15424,3578730314,3578730347,33
3,983,15425,3578730314,3578730349,35
3,983,15426,3578730314,3578730350,36
3,983,15427,3578730314,3578730352,38
3,983,15428,3578730314,3578730353,39
3,983,15429,3578730314,3578730354,40
3,983,15430,3578730314,3578730354,40
3,983,15431,3578730314,3578730354,40
3,983,15432,3578730314,3578730355,41
3,983,15433,3578730314,3578730355,41
3,983,15434,3578730314,3578730357,43
3,983,15435,3578730314,3578730358,44
3,983,15436,3578730314,3578730358,44
3,983,15437,3578730314,3578730361,47
3,984,15438,3578730372,3578730372,0
3,984,15439,3578730372,3578730372,0
3,984,15440,3578730372,3578730372,0
3,984,15441,3578730372,3578730372,0
3,984,15442,3578730372,3578730372,0
3,984,15443,3578730372,3578730372,0
3,984,15444,3578730372,3578730372,0
3,984,15445,3578730372,3578730372,0
3,984,15446,3578730372,3578730373,1
3,984,15447,3578730372,3578730373,1
3,984,15448,3578730372,3578730374,2
3,984,15449,3578730372,3578730375,3
3,984,15450,3578730372,3578730375,3
3,984,15451,3578730372,3578730377,5
3,984,15452,3578730372,3578730379,7
3,984,15453,3578730372,3578730383,11
3,984,15454,3578730372,3578730385,13
3,984,15455,3578730372,3578730385,13
3,984,15456,3578730372,3578730385,13
3,984,15457,3578730372,3578730386,14
3,984,15458,3578730372,3578730387,15
3,984,15459,3578730372,3578730387,15
3,984,15460,3578730372,3578730387,15
3,984,15461,3578730372,3578730388,16
3,984,15462,3578730372,3578730388,16
3,984,15463,3578730372,3578730388,16
3,984,15464,3578730372,3578730390,18
3,984,15465,3578730372,3578730391,19
3,984,15466,3578730372,3578730391,19
3,984,15467,3578730372,3578730391,19
3,984,15468,3578730372,3578730393,21
3,984,15469,3578730372,3578730394,22
3,984,15470,3578730372,3578730394,22
3,984,15471,3578730372,3578730398,26
3,984,15472,3578730372,3578730402,30
3,984,15473,3578730372,3578730404,32
3,984,15474,3578730372,3578730404,32
3,984,15475,3578730372,3578730405,33
3,984,15476,3578730372,3578730405,33
3,984,15477,3578730372,3578730405,33
3,984,15478,3578730372,3578730405,33
3,984,15479,3578730372,3578730406,34
3,984,15480,3578730372,3578730407,35
3,984,15481,3578730372,3578730408,36
3,984,15482,3578730372,3578730408,36
3,984,15483,3578730372,3578730409,37
3,984,15484,3578730372,3578730409,37
3,984,15485,3578730372,3578730415,43
3,984,15486,3578730372,3578730415,43
3,984,15487,3578730372,3578730416,44
3,984,15488,3578730372,3578730417,45
3,984,15489,3578730372,3578730420,48
3,984,15490,3578730372,3578730421,49
3,984,15491,3578730372,3578730422,50
3,985,15492,3578730431,3578730431,0
3,985,15493,3578730431,3578730431,0
3,985,15494,3578730431,3578730431,0
3,985,15495,3578730431,3578730431,0
3,985,15496,3578730431,3578730431,0
3,985,15497,3578730431,3578730431,0
3,985,15498,3578730431,3578730431,0
3,985,15499,3578730431,3578730431,0
3,985,15500,3578730431,3578730431,0
3,985,15501,3578730431,3578730431,0
3,985,15502,3578730431,3578730432,1
3,985,15503,3578730431,3578730432,1
3,985,15504,3578730431,3578730433,2
3,985,15505,3578730431,3578730434,3
3,985,15506,3578730431,3578730435,4
3,985,15507,3578730431,3578730436,5
3,985,15508,3578730431,3578730436,5
3,985,15509,3578730431,3578730437,6
3,985,15510,3578730431,3578730437,6
3,985,15511,3578730431,3578730438,7
3,985,15512,3578730431,3578730439,8
3,985,15513,3578730431,3578730440,9
3,985,15514,3578730431,3578730441,10
3,985,15515,3578730431,3578730441,10
3,985,15516,3578730431,3578730444,13
3,985,15517,3578730431,3578730445,14
3,985,15518,3578730431,3578730447,16
3,985,15519,3578730431,3578730447,16
3,985,15520,3578730431,3578730454,23
3,985,15521,3578730431,3578730455,24
3,985,15522,3578730431,3578730459,28
3,985,15523,3578730431,3578730462,31
3,985,15524,3578730431,3578730462,31
3,985,15525,3578730431,3578730464,33
3,985,15526,3578730431,3578730464,33
3,985,15527,3578730431,3578730465,34
3,985,15528,3578730431,3578730466,35
3,985,15529,3578730431,3578730468,37
3,985,15530,3578730431,3578730469,38
3,985,15531,3578730431,3578730470,39
3,985,15532,3578730431,3578730473,42
3,985,15533,3578730431,3578730473,42
3,985,15534,3578730431,3578730473,42
3,985,15535,3578730431,3578730474,43
3,985,15536,3578730431,3578730476,45
3,985,15537,3578730431,3578730479,48
3,986,15538,3578730489,3578730489,0
3,986,15539,3578730489,3578730489,0
3,986,15540,3578730489,3578730489,0
3,986,15541,3578730489,3578730489,0
3,986,15542,3578730489,3578730489,0
3,986,15543,3578730489,3578730489,0
3,986,15544,3578730489,3578730489,0
3,986,15545,3578730489,3578730489,0
3,986,15546,3578730489,3578730491,2
3,986,15547,3578730489,3578730492,3
3,986,15548,3578730489,3578730492,3
3,986,15549,3578730489,3578730493,4
3,986,15550,3578730489,3578730495,6
3,986,15551,3578730489,3578730495,6
3,986,15552,3578730489,3578730498,9
3,986,15553,3578730489,3578730499,10
3,986,15554,3578730489,3578730499,10
3,986,15555,3578730489,3578730499,10
3,986,15556,3578730489,3578730502,13
3,986,15557,3578730489,3578730503,14
3,986,15558,3578730489,3578730506,17
3,986,15559,3578730489,3578730509,20
3,986,15560,3578730489,3578730511,22
3,986,15561,3578730489,3578730516,27
3,986,15562,3578730489,3578730516,27
3,986,15563,3578730489,3578730517,28
3,986,15564,3578730489,3578730520,31
3,986,15565,3578730489,3578730521,32
3,986,15566,3578730489,3578730521,32
3,986,15567,3578730489,3578730525,36
3,986,15568,3578730489,3578730525,36
3,986,15569,3578730489,3578730525,36
3,986,15570,3578730489,3578730525,36
3,986,15571,3578730489,3578730532,43
3,986,15572,3578730489,3578730537,48
3,986,15573,3578730489,3578730538,49
3,986,15574,3578730489,3578730539,50
3,987,15575,3578730546,3578730546,0
3,987,15576,3578730546,3578730546,0
3,987,15577,3578730546,3578730546,0
3,987,15578,3578730546,3578730546,0
3,987,15579,3578730546,3578730546,0
3,987,15580,3578730546,3578730546,0
3,987,15581,3578730546,3578730546,0
3,987,15582,3578730546,3578730547,1
3,987,15583,3578730546,3578730548,2
3,987,15584,3578730546,3578730549,3
3,987,15585,3578730546,3578730551,5
3,987,15586,3578730546,3578730552,6
3,987,15587,3578730546,3578730553,7
3,987,15588,3578730546,3578730553,7
3,987,15589,3578730546,3578730553,7
3,987,15590,3578730546,3578730554,8
3,987,15591,3578730546,3578730554,8
3,987,15592,3578730546,3578730557,11
3,987,15593,3578730546,3578730557,11
3,987,15594,3578730546,3578730557,11
3,987,15595,3578730546,3578730560,14
3,987,15596,3578730546,3578730563,17
3,987,15597,3578730546,3578730564,18
3,987,15598,3578730546,3578730565,19
3,987,15599,3578730546,3578730566,20
3,987,15600,3578730546,3578730566,20
3,987,15601,3578730546,3578730568,22
3,987,15602,3578730546,3578730571,25
3,987,15603,3578730546,3578730571,25
3,987,15604,3578730546,3578730572,26
3,987,15605,3578730546,3578730572,26
3,987,15606,3578730546,3578730573,27
3,987,15607,3578730546,3578730574,28
3,987,15608,3578730546,3578730574,28
3,987,15609,3578730546,3578730576,30
3,987,15610,3578730546,3578730578,32
3,987,15611,3578730546,3578730582,36
3,987,15612,3578730546,3578730584,38
3,987,15613,3578730546,3578730585,39
3,987,15614,3578730546,3578730585,39
3,987,15615,3578730546,3578730585,39
3,987,15616,3578730546,3578730585,39
3,987,15617,3578730546,3578730586,40
3,987,15618,3578730546,3578730586,40
3,987,15619,3578730546,3578730587,41
3,987,15620,3578730546,3578730587,41
3,987,15621,3578730546,3578730587,41
3,987,15622,3578730546,3578730589,43
3,987,15623,3578730546,3578730590,44
3,987,15624,3578730546,3578730591,45
3,987,15625,3578730546,3578730593,47
3,987,15626,3578730546,3578730593,47
3,988,15627,3578730605,3578730605,0
3,988,15628,3578730605,3578730605,0
3,988,15629,3578730605,3578730605,0
3,988,15630,3578730605,3578730605,0
3,988,15631,3578730605,3578730605,0
3,988,15632,3578730605,3578730605,0
3,988,15633,3578730605,3578730605,0
3,988,15634,3578730605,3578730605,0
3,988,15635,3578730605,3578730605,0
3,988,15636,3578730605,3578730605,0
3,988,15637,3578730605,3578730606,1
3,988,15638,3578730605,3578730607,2
3,988,15639,3578730605,3578730607,2
3,988,15640,3578730605,3578730608,3
3,988,15641,3578730605,3578730608,3
3,988,15642,3578730605,3578730613,8
3,988,15643,3578730605,3578730614,9
3,988,15644,3578730605,3578730614,9
3,988,15645,3578730605,3578730614,9
3,988,15646,3578730605,3578730615,10
3,988,15647,3578730605,3578730619,14
3,988,15648,3578730605,3578730619,14
3,988,15649,3578730605,3578730620,15
3,988,15650,3578730605,3578730622,17
3,988,15651,3578730605,3578730623,18
3,988,15652,3578730605,3578730623,18
3,988,15653,3578730605,3578730624,19
3,988,15654,3578730605,3578730626,21
3,988,15655,3578730605,3578730626,21
3,988,15656,3578730605,3578730626,21
3,988,15657,3578730605,3578730626,21
3,988,15658,3578730605,3578730628,23
3,988,15659,3578730605,3578730628,23
3,988,15660,3578730605,3578730630,25
3,988,15661,3578730605,3578730631,26
3,988,15662,3578730605,3578730631,26
3,988,15663,3578730605,3578730632,27
3,988,15664,3578730605,3578730633,28
3,988,15665,3578730605,3578730634,29
3,988,15666,3578730605,3578730635,30
3,988,15667,3578730605,3578730635,30
3,988,15668,3578730605,3578730636,31
3,988,15669,3578730605,3578730636,31
3,988,15670,3578730605,3578730637,32
3,988,15671,3578730605,3578730638,33
3,988,15672,3578730605,3578730639,34
3,988,15673,3578730605,3578730639,34
3,988,15674,3578730605,3578730641,36
3,988,15675,3578730605,3578730643,38
3,988,15676,3578730605,3578730645,40
3,988,15677,3578730605,3578730646,41
3,988,15678,3578730605,3578730646,41
3,988,15679,3578730605,3578730653,48
3,988,15680,3578730605,3578730655,50
3,989,15681,3578730664,3578730665,1
3,989,15682,3578730664,3578730665,1
3,989,15683,3578730664,3578730665,1
3,989,15684,3578730664,3578730665,1
3,989,15685,3578730664,3578730665,1
3,989,15686,3578730664,3578730665,1
3,989,15687,3578730664,3578730665,1
3,989,15688,3578730664,3578730665,1
3,989,15689,3578730664,3578730667,3
3,989,15690,3578730664,3578730670,6
3,989,15691,3578730664,3578730673,9
3,989,15692,3578730664,3578730673,9
3,989,15693,3578730664,3578730673,9
3,989,15694,3578730664,3578730674,10
3,989,15695,3578730664,3578730676,12
3,989,15696,3578730664,3578730679,15
3,989,15697,3578730664,3578730680,16
3,989,15698,3578730664,3578730681,17
3,989,15699,3578730664,3578730681,17
3,989,15700,3578730664,3578730683,19
3,989,15701,3578730664,3578730684,20
3,989,15702,3578730664,3578730684,20
3,989,15703,3578730664,3578730685,21
3,989,15704,3578730664,3578730686,22
3,989,15705,3578730664,3578730687,23
3,989,15706,3578730664,3578730688,24
3,989,15707,3578730664,3578730692,28
3,989,15708,3578730664,3578730692,28
3,989,15709,3578730664,3578730694,30
3,989,15710,3578730664,3578730694,30
3,989,15711,3578730664,3578730695,31
3,989,15712,3578730664,3578730698,34
3,989,15713,3578730664,3578730699,35
3,989,15714,3578730664,3578730699,35
3,989,15715,3578730664,3578730703,39
3,989,15716,3578730664,3578730703,39
3,989,15717,3578730664,3578730706,42
3,989,15718,3578730664,3578730709,45
3,989,15719,3578730664,3578730712,48
3,990,15720,3578730723,3578730723,0
3,990,15721,3578730723,3578730723,0
3,990,15722,3578730723,3578730723,0
3,990,15723,3578730723,3578730723,0
3,990,15724,3578730723,3578730723,0
3,990,15725,3578730723,3578730725,2
3,990,15726,3578730723,3578730725,2
3,990,15727,3578730723,3578730725,2
3,990,15728,3578730723,3578730725,2
3,990,15729,3578730723,3578730732,9
3,990,15730,3578730723,3578730735,12
3,990,15731,3578730723,3578730738,15
3,990,15732,3578730723,3578730738,15
3,990,15733,3578730723,3578730739,16
3,990,15734,3578730723,3578730740,17
3,990,15735,3578730723,3578730742,19
3,990,15736,3578730723,3578730742,19
3,990,15737,3578730723,3578730743,20
3,990,15738,3578730723,3578730744,21
3,990,15739,3578730723,3578730744,21
3,990,15740,3578730723,3578730748,25
3,990,15741,3578730723,3578730748,25
3,990,15742,3578730723,3578730749,26
3,990,15743,3578730723,3578730751,28
3,990,15744,3578730723,3578730752,29
3,990,15745,3578730723,3578730753,30
3,990,15746,3578730723,3578730754,31
3,990,15747,3578730723,3578730754,31
3,990,15748,3578730723,3578730754,31
3,990,15749,3578730723,3578730755,32
3,990,15750,3578730723,3578730756,33
3,990,15751,3578730723,3578730757,34
3,990,15752,3578730723,3578730760,37
3,990,15753,3578730723,3578730764,41
3,990,15754,3578730723,3578730765,42
3,990,15755,3578730723,3578730765,42
3,990,15756,3578730723,3578730766,43
3,990,15757,3578730723,3578730767,44
3,990,15758,3578730723,3578730768,45
3,990,15759,3578730723,3578730768,45
3,990,15760,3578730723,3578730771,48
3,990,15761,3578730723,3578730771,48
3,990,15762,3578730723,3578730772,49
3,990,15763,3578730723,3578730772,49
3,991,15764,3578730781,3578730781,0
3,991,15765,3578730781,3578730781,0
3,991,15766,3578730781,3578730781,0
3,991,15767,3578730781,3578730781,0
3,991,15768,3578730781,3578730783,2
3,991,15769,3578730781,3578730784,3
3,991,15770,3578730781,3578730785,4
3,991,15771,3578730781,3578730785,4
3,991,15772,3578730781,3578730785,4
3,991,15773,3578730781,3578730785,4
3,991,15774,3578730781,3578730786,5
3,991,15775,3578730781,3578730786,5
3,991,15776,3578730781,3578730788,7
3,991,15777,3578730781,3578730788,7
3,991,15778,3578730781,3578730788,7
3,991,15779,3578730781,3578730789,8
3,991,15780,3578730781,3578730791,10
3,991,15781,3578730781,3578730791,10
3,991,15782,3578730781,3578730792,11
3,991,15783,3578730781,3578730792,11
3,991,15784,3578730781,3578730794,13
3,991,15785,3578730781,3578730797,16
3,991,15786,3578730781,3578730801,20
3,991,15787,3578730781,3578730801,20
3,991,15788,3578730781,3578730802,21
3,991,15789,3578730781,3578730803,22
3,991,15790,3578730781,3578730803,22
3,991,15791,3578730781,3578730804,23
3,991,15792,3578730781,3578730804,23
3,991,15793,3578730781,3578730805,24
3,991,15794,3578730781,3578730805,24
3,991,15795,3578730781,3578730806,25
3,991,15796,3578730781,3578730807,26
3,991,15797,3578730781,3578730807,26
3,991,15798,3578730781,3578730808,27
3,991,15799,3578730781,3578730808,27
3,991,15800,3578730781,3578730809,28
3,991,15801,3578730781,3578730814,33
3,991,15802,3578730781,3578730815,34
3,991,15803,3578730781,3578730815,34
3,991,15804,3578730781,3578730815,34
3,991,15805,3578730781,3578730819,38
3,991,15806,3578730781,3578730819,38
3,991,15807,3578730781,3578730820,39
3,991,15808,3578730781,3578730822,41
3,991,15809,3578730781,3578730822,41
3,991,15810,3578730781,3578730822,41
3,991,15811,3578730781,3578730825,44
3,991,15812,3578730781,3578730825,44
3,991,15813,3578730781,3578730825,44
3,991,15814,3578730781,3578730826,45
3,991,15815,3578730781,3578730828,47
3,991,15816,3578730781,3578730828,47
3,991,15817,3578730781,3578730829,48
3,991,15818,3578730781,3578730830,49
3,991,15819,3578730781,3578730831,50
3,992,15820,3578730839,3578730839,0
3,992,15821,3578730839,3578730839,0
3,992,15822,3578730839,3578730839,0
3,992,15823,3578730839,3578730839,0
3,992,15824,3578730839,3578730839,0
3,992,15825,3578730839,3578730839,0
3,992,15826,3578730839,3578730839,0
3,992,15827,3578730839,3578730839,0
3,992,15828,3578730839,3578730839,0
3,992,15829,3578730839,3578730839,0
3,992,15830,3578730839,3578730839,0
3,992,15831,3578730839,3578730839,0
3,992,15832,3578730839,3578730841,2
3,992,15833,3578730839,3578730843,4
3,992,15834,3578730839,3578730844,5
3,992,15835,3578730839,3578730844,5
3,992,15836,3578730839,3578730847,8
3,992,15837,3578730839,3578730847,8
3,992,15838,3578730839,3578730852,13
3,992,15839,3578730839,3578730855,16
3,992,15840,3578730839,3578730856,17
3,992,15841,3578730839,3578730858,19
3,992,15842,3578730839,3578730862,23
3,992,15843,3578730839,3578730862,23
3,992,15844,3578730839,3578730863,24
3,992,15845,3578730839,3578730864,25
3,992,15846,3578730839,3578730864,25
3,992,15847,3578730839,3578730864,25
3,992,15848,3578730839,3578730867,28
3,992,15849,3578730839,3578730869,30
3,992,15850,3578730839,3578730873,34
3,992,15851,3578730839,3578730873,34
3,992,15852,3578730839,3578730873,34
3,992,15853,3578730839,3578730875,36
3,992,15854,3578730839,3578730876,37
3,992,15855,3578730839,3578730879,40
3,992,15856,3578730839,3578730880,41
3,992,15857,3578730839,3578730880,41
3,992,15858,3578730839,3578730882,43
3,992,15859,3578730839,3578730884,45
3,992,15860,3578730839,3578730885,46
3,992,15861,3578730839,3578730887,48
3,992,15862,3578730839,3578730887,48
3,992,15863,3578730839,3578730888,49
3,992,15864,3578730839,3578730888,49
3,993,15865,3578730896,3578730896,0
3,993,15866,3578730896,3578730896,0
3,993,15867,3578730896,3578730897,1
3,993,15868,3578730896,3578730897,1
3,993,15869,3578730896,3578730897,1
3,993,15870,3578730896,3578730897,1
3,993,15871,3578730896,3578730899,3
3,993,15872,3578730896,3578730899,3
3,993,15873,3578730896,3578730900,4
3,993,15874,3578730896,3578730903,7
3,993,15875,3578730896,3578730904,8
3,993,15876,3578730896,3578730908,12
3,993,15877,3578730896,3578730909,13
3,993,15878,3578730896,3578730912,16
3,993,15879,3578730896,3578730916,20
3,993,15880,3578730896,3578730918,22
3,993,15881,3578730896,3578730918,22
3,993,15882,3578730896,3578730921,25
3,993,15883,3578730896,3578730921,25
3,993,15884,3578730896,3578730924,28
3,993,15885,3578730896,3578730924,28
3,993,15886,3578730896,3578730926,30
3,993,15887,3578730896,3578730926,30
3,993,15888,3578730896,3578730931,35
3,993,15889,3578730896,3578730934,38
3,993,15890,3578730896,3578730938,42
3,993,15891,3578730896,3578730938,42
3,993,15892,3578730896,3578730939,43
3,993,15893,3578730896,3578730939,43
3,993,15894,3578730896,3578730940,44
3,993,15895,3578730896,3578730942,46
3,993,15896,3578730896,3578730943,47
3,993,15897,3578730896,3578730944,48
3,993,15898,3578730896,3578730944,48
3,994,15899,3578730953,3578730953,0
3,994,15900,3578730953,3578730953,0
3,994,15901,3578730953,3578730953,0
3,994,15902,3578730953,3578730953,0
3,994,15903,3578730953,3578730953,0
3,994,15904,3578730953,3578730953,0
3,994,15905,3578730953,3578730953,0
3,994,15906,3578730953,3578730953,0
3,994,15907,3578730953,3578730953,0
3,994,15908,3578730953,3578730954,1
3,994,15909,3578730953,3578730955,2
3,994,15910,3578730953,3578730955,2
3,994,15911,3578730953,3578730957,4
3,994,15912,3578730953,3578730957,4
3,994,15913,3578730953,3578730958,5
3,994,15914,3578730953,3578730960,7
3,994,15915,3578730953,3578730963,10
3,994,15916,3578730953,3578730964,11
3,994,15917,3578730953,3578730965,12
3,994,15918,3578730953,3578730966,13
3,994,15919,3578730953,3578730967,14
3,994,15920,3578730953,3578730969,16
3,994,15921,3578730953,3578730971,18
3,994,15922,3578730953,3578730972,19
3,994,15923,3578730953,3578730972,19
3,994,15924,3578730953,3578730972,19
3,994,15925,3578730953,3578730972,19
3,994,15926,3578730953,3578730973,20
3,994,15927,3578730953,3578730974,21
3,994,15928,3578730953,3578730974,21
3,994,15929,3578730953,3578730978,25
3,994,15930,3578730953,3578730979,26
3,994,15931,3578730953,3578730983,30
3,994,15932,3578730953,3578730984,31
3,994,15933,3578730953,3578730985,32
3,994,15934,3578730953,3578730985,32
3,994,15935,3578730953,3578730986,33
3,994,15936,3578730953,3578730986,33
3,994,15937,3578730953,3578730986,33
3,994,15938,3578730953,3578730986,33
3,994,15939,3578730953,3578730987,34
3,994,15940,3578730953,3578730988,35
3,994,15941,3578730953,3578730988,35
3,994,15942,3578730953,3578730989,36
3,994,15943,3578730953,3578730991,38
3,994,15944,3578730953,3578730991,38
3,994,15945,3578730953,3578730992,39
3,994,15946,3578730953,3578730992,39
3,994,15947,3578730953,3578730993,40
3,994,15948,3578730953,3578730997,44
3,994,15949,3578730953,3578731000,47
3,994,15950,3578730953,3578731001,48
3,994,15951,3578730953,3578731002,49
3,994,15952,3578730953,3578731003,50
3,995,15953,3578731011,3578731011,0
3,995,15954,3578731011,3578731011,0
3,995,15955,3578731011,3578731011,0
3,995,15956,3578731011,3578731011,0
3,995,15957,3578731011,3578731011,0
3,995,15958,3578731011,3578731011,0
3,995,15959,3578731011,3578731011,0
3,995,15960,3578731011,3578731011,0
3,995,15961,3578731011,3578731011,0
3,995,15962,3578731011,3578731014,3
3,995,15963,3578731011,3578731015,4
3,995,15964,3578731011,3578731016,5
3,995,15965,3578731011,3578731016,5
3,995,15966,3578731011,3578731019,8
3,995,15967,3578731011,3578731019,8
3,995,15968,3578731011,3578731022,11
3,995,15969,3578731011,3578731022,11
3,995,15970,3578731011,3578731022,11
3,995,15971,3578731011,3578731025,14
3,995,15972,3578731011,3578731025,14
3,995,15973,3578731011,3578731026,15
3,995,15974,3578731011,3578731026,15
3,995,15975,3578731011,3578731028,17
3,995,15976,3578731011,3578731028,17
3,995,15977,3578731011,3578731030,19
3,995,15978,3578731011,3578731031,20
3,995,15979,3578731011,3578731031,20
3,995,15980,3578731011,3578731032,21
3,995,15981,3578731011,3578731032,21
3,995,15982,3578731011,3578731033,22
3,995,15983,3578731011,3578731034,23
3,995,15984,3578731011,3578731035,24
3,995,15985,3578731011,3578731036,25
3,995,15986,3578731011,3578731036,25
3,995,15987,3578731011,3578731038,27
3,995,15988,3578731011,3578731038,27
3,995,15989,3578731011,3578731040,29
3,995,15990,3578731011,3578731040,29
3,995,15991,3578731011,3578731043,32
3,995,15992,3578731011,3578731044,33
3,995,15993,3578731011,3578731045,34
3,995,15994,3578731011,3578731047,36
3,995,15995,3578731011,3578731047,36
3,995,15996,3578731011,3578731050,39
3,995,15997,3578731011,3578731052,41
3,995,15998,3578731011,3578731053,42
3,995,15999,3578731011,3578731055,44
3,995,16000,3578731011,3578731057,46
3,995,16001,3578731011,3578731058,47
3,996,16002,3578731069,3578731069,0
3,996,16003,3578731069,3578731069,0
3,996,16004,3578731069,3578731069,0
3,996,16005,3578731069,3578731069,0
3,996,16006,3578731069,3578731069,0
3,996,16007,3578731069,3578731069,0
3,996,16008,3578731069,3578731069,0
3,996,16009,3578731069,3578731070,1
3,996,16010,3578731069,3578731073,4
3,996,16011,3578731069,3578731073,4
3,996,16012,3578731069,3578731073,4
3,996,16013,3578731069,3578731076,7
3,996,16014,3578731069,3578731076,7
3,996,16015,3578731069,3578731079,10
3,996,16016,3578731069,3578731080,11
3,996,16017,3578731069,3578731080,11
3,996,16018,3578731069,3578731081,12
3,996,16019,3578731069,3578731083,14
3,996,16020,3578731069,3578731084,15
3,996,16021,3578731069,3578731084,15
3,996,16022,3578731069,3578731085,16
3,996,16023,3578731069,3578731086,17
3,996,16024,3578731069,3578731087,18
3,996,16025,3578731069,3578731088,19
3,996,16026,3578731069,3578731091,22
3,996,16027,3578731069,3578731092,23
3,996,16028,3578731069,3578731092,23
3,996,16029,3578731069,3578731095,26
3,996,16030,3578731069,3578731095,26
3,996,16031,3578731069,3578731095,26
3,996,16032,3578731069,3578731099,30
3,996,16033,3578731069,3578731100,31
3,996,16034,3578731069,3578731100,31
3,996,16035,3578731069,3578731103,34
3,996,16036,3578731069,3578731105,36
3,996,16037,3578731069,3578731108,39
3,996,16038,3578731069,3578731109,40
3,996,16039,3578731069,3578731112,43
3,996,16040,3578731069,3578731116,47
3,996,16041,3578731069,3578731117,48
3,996,16042,3578731069,3578731118,49
3,997,16043,3578731129,3578731129,0
3,997,16044,3578731129,3578731129,0
3,997,16045,3578731129,3578731129,0
3,997,16046,3578731129,3578731129,0
3,997,16047,3578731129,3578731129,0
3,997,16048,3578731129,3578731129,0
3,997,16049,3578731129,3578731129,0
3,997,16050,3578731129,3578731131,2
3,997,16051,3578731129,3578731136,7
3,997,16052,3578731129,3578731138,9
3,997,16053,3578731129,3578731139,10
3,997,16054,3578731129,3578731139,10
3,997,16055,3578731129,3578731140,11
3,997,16056,3578731129,3578731143,14
3,997,16057,3578731129,3578731143,14
3,997,16058,3578731129,3578731143,14
3,997,16059,3578731129,3578731144,15
3,997,16060,3578731129,3578731144,15
3,997,16061,3578731129,3578731149,20
3,997,16062,3578731129,3578731150,21
3,997,16063,3578731129,3578731150,21
3,997,16064,3578731129,3578731151,22
3,997,16065,3578731129,3578731151,22
3,997,16066,3578731129,3578731152,23
3,997,16067,3578731129,3578731153,24
3,997,16068,3578731129,3578731153,24
3,997,16069,3578731129,3578731154,25
3,997,16070,3578731129,3578731154,25
3,997,16071,3578731129,3578731155,26
3,997,16072,3578731129,3578731156,27
3,997,16073,3578731129,3578731157,28
3,997,16074,3578731129,3578731157,28
3,997,16075,3578731129,3578731158,29
3,997,16076,3578731129,3578731160,31
3,997,16077,3578731129,3578731164,35
3,997,16078,3578731129,3578731165,36
3,997,16079,3578731129,3578731166,37
3,997,16080,3578731129,3578731167,38
3,997,16081,3578731129,3578731167,38
3,997,16082,3578731129,3578731168,39
3,997,16083,3578731129,3578731168,39
3,997,16084,3578731129,3578731171,42
3,997,16085,3578731129,3578731171,42
3,997,16086,3578731129,3578731171,42
3,997,16087,3578731129,3578731172,43
3,997,16088,3578731129,3578731174,45
3,997,16089,3578731129,3578731174,45
3,997,16090,3578731129,3578731179,50
3,998,16091,3578731189,3578731189,0
3,998,16092,3578731189,3578731189,0
3,998,16093,3578731189,3578731189,0
3,998,16094,3578731189,3578731189,0
3,998,16095,3578731189,3578731189,0
3,998,16096,3578731189,3578731189,0
3,998,16097,3578731189,3578731189,0
3,998,16098,3578731189,3578731189,0
3,998,16099,3578731189,3578731189,0
3,998,16100,3578731189,3578731189,0
3,998,16101,3578731189,3578731189,0
3,998,16102,3578731189,3578731189,0
3,998,16103,3578731189,3578731189,0
3,998,16104,3578731189,3578731189,0
3,998,16105,3578731189,3578731191,2
3,998,16106,3578731189,3578731192,3
3,998,16107,3578731189,3578731192,3
3,998,16108,3578731189,3578731192,3
3,998,16109,3578731189,3578731194,5
3,998,16110,3578731189,3578731197,8
3,998,16111,3578731189,3578731200,11
3,998,16112,3578731189,3578731202,13
3,998,16113,3578731189,3578731203,14
3,998,16114,3578731189,3578731204,15
3,998,16115,3578731189,3578731204,15
3,998,16116,3578731189,3578731204,15
3,998,16117,3578731189,3578731205,16
3,998,16118,3578731189,3578731207,18
3,998,16119,3578731189,3578731208,19
3,998,16120,3578731189,3578731208,19
3,998,16121,3578731189,3578731209,20
3,998,16122,3578731189,3578731209,20
3,998,16123,3578731189,3578731214,25
3,998,16124,3578731189,3578731215,26
3,998,16125,3578731189,3578731216,27
3,998,16126,3578731189,3578731216,27
3,998,16127,3578731189,3578731216,27
3,998,16128,3578731189,3578731219,30
3,998,16129,3578731189,3578731219,30
3,998,16130,3578731189,3578731221,32
3,998,16131,3578731189,3578731222,33
3,998,16132,3578731189,3578731224,35
3,998,16133,3578731189,3578731225,36
3,998,16134,3578731189,3578731225,36
3,998,16135,3578731189,3578731227,38
3,998,16136,3578731189,3578731227,38
3,998,16137,3578731189,3578731227,38
3,998,16138,3578731189,3578731228,39
3,998,16139,3578731189,3578731229,40
3,998,16140,3578731189,3578731231,42
3,998,16141,3578731189,3578731231,42
3,998,16142,3578731189,3578731232,43
3,998,16143,3578731189,3578731233,44
3,998,16144,3578731189,3578731233,44
3,998,16145,3578731189,3578731233,44
3,998,16146,3578731189,3578731235,46
3,998,16147,3578731189,3578731235,46
3,998,16148,3578731189,3578731236,47
3,998,16149,3578731189,3578731236,47
3,998,16150,3578731189,3578731238,49
3,998,16151,3578731189,3578731239,50
3,999,16152,3578731247,3578731247,0
3,999,16153,3578731247,3578731247,0
3,999,16154,3578731247,3578731247,0
3,999,16155,3578731247,3578731247,0
3,999,16156,3578731247,3578731247,0
3,999,16157,3578731247,3578731247,0
3,999,16158,3578731247,3578731247,0
3,999,16159,3578731247,3578731247,0
3,999,16160,3578731247,3578731250,3
3,999,16161,3578731247,3578731252,5
3,999,16162,3578731247,3578731255,8
3,999,16163,3578731247,3578731258,11
3,999,16164,3578731247,3578731258,11
3,999,16165,3578731247,3578731264,17
3,999,16166,3578731247,3578731264,17
3,999,16167,3578731247,3578731264,17
3,999,16168,3578731247,3578731267,20
3,999,16169,3578731247,3578731267,20
3,999,16170,3578731247,3578731267,20
3,999,16171,3578731247,3578731269,22
3,999,16172,3578731247,3578731270,23
3,999,16173,3578731247,3578731273,26
3,999,16174,3578731247,3578731273,26
3,999,16175,3578731247,3578731274,27
3,999,16176,3578731247,3578731276,29
3,999,16177,3578731247,3578731276,29
3,999,16178,3578731247,3578731279,32
3,999,16179,3578731247,3578731280,33
3,999,16180,3578731247,3578731280,33
3,999,16181,3578731247,3578731281,34
3,999,16182,3578731247,3578731283,36
3,999,16183,3578731247,3578731284,37
3,999,16184,3578731247,3578731284,37
3,999,16185,3578731247,3578731285,38
3,999,16186,3578731247,3578731286,39
3,999,16187,3578731247,3578731288,41
3,999,16188,3578731247,3578731291,44
3,999,16189,3578731247,3578731292,45
3,999,16190,3578731247,3578731292,45
3,999,16191,3578731247,3578731294,47
3,999,16192,3578731247,3578731295,48
3,999,16193,3578731247,3578731295,48
3,1000,16194,3578731305,3578731305,0
3,1000,16195,3578731305,3578731305,0
3,1000,16196,3578731305,3578731305,0
3,1000,16197,3578731305,3578731305,0
3,1000,16198,3578731305,3578731305,0
3,1000,16199,3578731305,3578731305,0
3,1000,16200,3578731305,3578731307,2
3,1000,16201,3578731305,3578731309,4
3,1000,16202,3578731305,3578731312,7
3,1000,16203,3578731305,3578731317,12
3,1000,16204,3578731305,3578731317,12
3,1000,16205,3578731305,3578731319,14
3,1000,16206,3578731305,3578731322,17
3,1000,16207,3578731305,3578731323,18
3,1000,16208,3578731305,3578731326,21
3,1000,16209,3578731305,3578731326,21
3,1000,16210,3578731305,3578731326,21
3,1000,16211,3578731305,3578731326,21
3,1000,16212,3578731305,3578731331,26
3,1000,16213,3578731305,3578731336,31
3,1000,16214,3578731305,3578731338,33
3,1000,16215,3578731305,3578731339,34
3,1000,16216,3578731305,3578731340,35
3,1000,16217,3578731305,3578731340,35
3,1000,16218,3578731305,3578731343,38
3,1000,16219,3578731305,3578731343,38
3,1000,16220,3578731305,3578731343,38
3,1000,16221,3578731305,3578731343,38
3,1000,16222,3578731305,3578731344,39
3,1000,16223,3578731305,3578731344,39
3,1000,16224,3578731305,3578731350,45
3,1000,16225,3578731305,3578731350,45
3,1000,16226,3578731305,3578731350,45
3,1000,16227,3578731305,3578731351,46
3,1000,16228,3578731305,3578731351,46
3,1000,16229,3578731305,3578731352,47
3,1000,16230,3578731305,3578731354,49
3,1000,16231,3578731305,3578731354,49
3,1000,16232,3578731305,3578731354,49
3,1000,16233,3578731305,3578731355,50
3,1001,16234,3578731364,3578731364,0
3,1001,16235,3578731364,3578731364,0
3,1001,16236,3578731364,3578731364,0
3,1001,16237,3578731364,3578731364,0
3,1001,16238,3578731364,3578731364,0
3,1001,16239,3578731364,3578731364,0
3,1001,16240,3578731364,3578731364,0
3,1001,16241,3578731364,3578731366,2
3,1001,16242,3578731364,3578731366,2
3,1001,16243,3578731364,3578731367,3
3,1001,16244,3578731364,3578731367,3
3,1001,16245,3578731364,3578731369,5
3,1001,16246,3578731364,3578731369,5
3,1001,16247,3578731364,3578731371,7
3,1001,16248,3578731364,3578731371,7
3,1001,16249,3578731364,3578731372,8
3,1001,16250,3578731364,3578731372,8
3,1001,16251,3578731364,3578731372,8
3,1001,16252,3578731364,3578731373,9
3,1001,16253,3578731364,3578731375,11
3,1001,16254,3578731364,3578731375,11
3,1001,16255,3578731364,3578731378,14
3,1001,16256,3578731364,3578731379,15
3,1001,16257,3578731364,3578731384,20
3,1001,16258,3578731364,3578731385,21
3,1001,16259,3578731364,3578731386,22
3,1001,16260,3578731364,3578731386,22
3,1001,16261,3578731364,3578731387,23
3,1001,16262,3578731364,3578731387,23
3,1001,16263,3578731364,3578731387,23
3,1001,16264,3578731364,3578731388,24
3,1001,16265,3578731364,3578731388,24
3,1001,16266,3578731364,3578731388,24
3,1001,16267,3578731364,3578731389,25
3,1001,16268,3578731364,3578731389,25
3,1001,16269,3578731364,3578731390,26
3,1001,16270,3578731364,3578731391,27
3,1001,16271,3578731364,3578731392,28
3,1001,16272,3578731364,3578731392,28
3,1001,16273,3578731364,3578731393,29
3,1001,16274,3578731364,3578731397,33
3,1001,16275,3578731364,3578731401,37
3,1001,16276,3578731364,3578731402,38
3,1001,16277,3578731364,3578731403,39
3,1001,16278,3578731364,3578731403,39
3,1001,16279,3578731364,3578731405,41
3,1001,16280,3578731364,3578731405,41
3,1001,16281,3578731364,3578731408,44
3,1001,16282,3578731364,3578731408,44
3,1001,16283,3578731364,3578731408,44
3,1001,16284,3578731364,3578731409,45
3,1001,16285,3578731364,3578731410,46
3,1002,16286,3578731423,3578731423,0
3,1002,16287,3578731423,3578731424,1
3,1002,16288,3578731423,3578731424,1
3,1002,16289,3578731423,3578731424,1
3,1002,16290,3578731423,3578731424,1
3,1002,16291,3578731423,3578731424,1
3,1002,16292,3578731423,3578731424,1
3,1002,16293,3578731423,3578731424,1
3,1002,16294,3578731423,3578731424,1
3,1002,16295,3578731423,3578731425,2
3,1002,16296,3578731423,3578731425,2
3,1002,16297,3578731423,3578731426,3
3,1002,16298,3578731423,3578731427,4
3,1002,16299,3578731423,3578731427,4
3,1002,16300,3578731423,3578731427,4
3,1002,16301,3578731423,3578731428,5
3,1002,16302,3578731423,3578731431,8
3,1002,16303,3578731423,3578731433,10
3,1002,16304,3578731423,3578731433,10
3,1002,16305,3578731423,3578731433,10
3,1002,16306,3578731423,3578731433,10
3,1002,16307,3578731423,3578731434,11
3,1002,16308,3578731423,3578731435,12
3,1002,16309,3578731423,3578731435,12
3,1002,16310,3578731423,3578731436,13
3,1002,16311,3578731423,3578731436,13
3,1002,16312,3578731423,3578731439,16
3,1002,16313,3578731423,3578731441,18
3,1002,16314,3578731423,3578731441,18
3,1002,16315,3578731423,3578731441,18
3,1002,16316,3578731423,3578731443,20
3,1002,16317,3578731423,3578731444,21
3,1002,16318,3578731423,3578731445,22
3,1002,16319,3578731423,3578731446,23
3,1002,16320,3578731423,3578731447,24
3,1002,16321,3578731423,3578731450,27
3,1002,16322,3578731423,3578731452,29
3,1002,16323,3578731423,3578731455,32
3,1002,16324,3578731423,3578731458,35
3,1002,16325,3578731423,3578731463,40
3,1002,16326,3578731423,3578731464,41
3,1002,16327,3578731423,3578731465,42
3,1002,16328,3578731423,3578731466,43
3,1002,16329,3578731423,3578731467,44
3,1002,16330,3578731423,3578731468,45
3,1002,16331,3578731423,3578731469,46
3,1002,16332,3578731423,3578731470,47
3,1002,16333,3578731423,3578731473,50
3,1003,16334,3578731485,3578731485,0
3,1003,16335,3578731485,3578731485,0
3,1003,16336,3578731485,3578731485,0
3,1003,16337,3578731485,3578731485,0
3,1003,16338,3578731485,3578731485,0
3,1003,16339,3578731485,3578731485,0
3,1003,16340,3578731485,3578731485,0
3,1003,16341,3578731485,3578731485,0
3,1003,16342,3578731485,3578731485,0
3,1003,16343,3578731485,3578731485,0
3,1003,16344,3578731485,3578731485,0
3,1003,16345,3578731485,3578731485,0
3,1003,16346,3578731485,3578731485,0
3,1003,16347,3578731485,3578731486,1
3,1003,16348,3578731485,3578731487,2
3,1003,16349,3578731485,3578731488,3
3,1003,16350,3578731485,3578731490,5
3,1003,16351,3578731485,3578731491,6
3,1003,16352,3578731485,3578731493,8
3,1003,16353,3578731485,3578731494,9
3,1003,16354,3578731485,3578731494,9
3,1003,16355,3578731485,3578731497,12
3,1003,16356,3578731485,3578731500,15
3,1003,16357,3578731485,3578731501,16
3,1003,16358,3578731485,3578731503,18
3,1003,16359,3578731485,3578731504,19
3,1003,16360,3578731485,3578731506,21
3,1003,16361,3578731485,3578731508,23
3,1003,16362,3578731485,3578731512,27
3,1003,16363,3578731485,3578731515,30
3,1003,16364,3578731485,3578731516,31
3,1003,16365,3578731485,3578731517,32
3,1003,16366,3578731485,3578731518,33
3,1003,16367,3578731485,3578731521,36
3,1003,16368,3578731485,3578731521,36
3,1003,16369,3578731485,3578731524,39
3,1003,16370,3578731485,3578731525,40
3,1003,16371,3578731485,3578731525,40
3,1003,16372,3578731485,3578731525,40
3,1003,16373,3578731485,3578731531,46
3,1003,16374,3578731485,3578731535,50
3,1004,16375,3578731543,3578731543,0
3,1004,16376,3578731543,3578731543,0
3,1004,16377,3578731543,3578731543,0
3,1004,16378,3578731543,3578731543,0
3,1004,16379,3578731543,3578731543,0
3,1004,16380,3578731543,3578731543,0
3,1004,16381,3578731543,3578731543,0
3,1004,16382,3578731543,3578731543,0
3,1004,16383,3578731543,3578731543,0
3,1004,16384,3578731543,3578731544,1
3,1004,16385,3578731543,3578731549,6
3,1004,16386,3578731543,3578731549,6
3,1004,16387,3578731543,3578731549,6
3,1004,16388,3578731543,3578731550,7
3,1004,16389,3578731543,3578731551,8
3,1004,16390,3578731543,3578731551,8
3,1004,16391,3578731543,3578731553,10
3,1004,16392,3578731543,3578731553,10
3,1004,16393,3578731543,3578731553,10
3,1004,16394,3578731543,3578731554,11
3,1004,16395,3578731543,3578731554,11
3,1004,16396,3578731543,3578731557,14
3,1004,16397,3578731543,3578731557,14
3,1004,16398,3578731543,3578731557,14
3,1004,16399,3578731543,3578731557,14
3,1004,16400,3578731543,3578731559,16
3,1004,16401,3578731543,3578731563,20
3,1004,16402,3578731543,3578731564,21
3,1004,16403,3578731543,3578731566,23
3,1004,16404,3578731543,3578731566,23
3,1004,16405,3578731543,3578731567,24
3,1004,16406,3578731543,3578731568,25
3,1004,16407,3578731543,3578731568,25
3,1004,16408,3578731543,3578731570,27
3,1004,16409,3578731543,3578731570,27
3,1004,16410,3578731543,3578731571,28
3,1004,16411,3578731543,3578731571,28
3,1004,16412,3578731543,3578731574,31
3,1004,16413,3578731543,3578731574,31
3,1004,16414,3578731543,3578731578,35
3,1004,16415,3578731543,3578731578,35
3,1004,16416,3578731543,3578731582,39
3,1004,16417,3578731543,3578731583,40
3,1004,16418,3578731543,3578731584,41
3,1004,16419,3578731543,3578731584,41
3,1004,16420,3578731543,3578731585,42
3,1004,16421,3578731543,3578731586,43
3,1004,16422,3578731543,3578731586,43
3,1004,16423,3578731543,3578731586,43
3,1004,16424,3578731543,3578731587,44
3,1004,16425,3578731543,3578731587,44
3,1004,16426,3578731543,3578731587,44
3,1004,16427,3578731543,3578731588,45
3,1004,16428,3578731543,3578731590,47
3,1004,16429,3578731543,3578731590,47
3,1004,16430,3578731543,3578731592,49
3,1004,16431,3578731543,3578731592,49
3,1004,16432,3578731543,3578731592,49
3,1005,16433,3578731602,3578731602,0
3,1005,16434,3578731602,3578731602,0
3,1005,16435,3578731602,3578731602,0
3,1005,16436,3578731602,3578731602,0
3,1005,16437,3578731602,3578731602,0
3,1005,16438,3578731602,3578731604,2
3,1005,16439,3578731602,3578731604,2
3,1005,16440,3578731602,3578731604,2
3,1005,16441,3578731602,3578731608,6
3,1005,16442,3578731602,3578731608,6
3,1005,16443,3578731602,3578731608,6
3,1005,16444,3578731602,3578731608,6
3,1005,16445,3578731602,3578731608,6
3,1005,16446,3578731602,3578731613,11
3,1005,16447,3578731602,3578731615,13
3,1005,16448,3578731602,3578731615,13
3,1005,16449,3578731602,3578731615,13
3,1005,16450,3578731602,3578731616,14
3,1005,16451,3578731602,3578731618,16
3,1005,16452,3578731602,3578731619,17
3,1005,16453,3578731602,3578731620,18
3,1005,16454,3578731602,3578731622,20
3,1005,16455,3578731602,3578731623,21
3,1005,16456,3578731602,3578731625,23
3,1005,16457,3578731602,3578731625,23
3,1005,16458,3578731602,3578731626,24
3,1005,16459,3578731602,3578731626,24
3,1005,16460,3578731602,3578731626,24
3,1005,16461,3578731602,3578731627,25
3,1005,16462,3578731602,3578731629,27
3,1005,16463,3578731602,3578731631,29
3,1005,16464,3578731602,3578731632,30
3,1005,16465,3578731602,3578731632,30
3,1005,16466,3578731602,3578731632,30
3,1005,16467,3578731602,3578731632,30
3,1005,16468,3578731602,3578731633,31
3,1005,16469,3578731602,3578731634,32
3,1005,16470,3578731602,3578731634,32
3,1005,16471,3578731602,3578731635,33
3,1005,16472,3578731602,3578731635,33
3,1005,16473,3578731602,3578731637,35
3,1005,16474,3578731602,3578731639,37
3,1005,16475,3578731602,3578731640,38
3,1005,16476,3578731602,3578731640,38
3,1005,16477,3578731602,3578731640,38
3,1005,16478,3578731602,3578731643,41
3,1005,16479,3578731602,3578731644,42
3,1005,16480,3578731602,3578731644,42
3,1005,16481,3578731602,3578731645,43
3,1005,16482,3578731602,3578731647,45
3,1005,16483,3578731602,3578731649,47
3,1005,16484,3578731602,3578731651,49
3,1006,16485,3578731660,3578731660,0
3,1006,16486,3578731660,3578731660,0
3,1006,16487,3578731660,3578731660,0
3,1006,16488,3578731660,3578731662,2
3,1006,16489,3578731660,3578731663,3
3,1006,16490,3578731660,3578731664,4
3,1006,16491,3578731660,3578731665,5
3,1006,16492,3578731660,3578731666,6
3,1006,16493,3578731660,3578731668,8
3,1006,16494,3578731660,3578731668,8
3,1006,16495,3578731660,3578731673,13
3,1006,16496,3578731660,3578731674,14
3,1006,16497,3578731660,3578731674,14
3,1006,16498,3578731660,3578731676,16
3,1006,16499,3578731660,3578731678,18
3,1006,16500,3578731660,3578731679,19
3,1006,16501,3578731660,3578731680,20
3,1006,16502,3578731660,3578731680,20
3,1006,16503,3578731660,3578731680,20
3,1006,16504,3578731660,3578731682,22
3,1006,16505,3578731660,3578731683,23
3,1006,16506,3578731660,3578731685,25
3,1006,16507,3578731660,3578731685,25
3,1006,16508,3578731660,3578731686,26
3,1006,16509,3578731660,3578731686,26
3,1006,16510,3578731660,3578731688,28
3,1006,16511,3578731660,3578731690,30
3,1006,16512,3578731660,3578731691,31
3,1006,16513,3578731660,3578731694,34
3,1006,16514,3578731660,3578731695,35
3,1006,16515,3578731660,3578731695,35
3,1006,16516,3578731660,3578731697,37
3,1006,16517,3578731660,3578731698,38
3,1006,16518,3578731660,3578731700,40
3,1006,16519,3578731660,3578731700,40
3,1006,16520,3578731660,3578731703,43
3,1006,16521,3578731660,3578731705,45
3,1006,16522,3578731660,3578731706,46
3,1006,16523,3578731660,3578731707,47
3,1006,16524,3578731660,3578731709,49
3,1007,16525,3578731718,3578731718,0
3,1007,16526,3578731718,3578731718,0
3,1007,16527,3578731718,3578731718,0
3,1007,16528,3578731718,3578731718,0
3,1007,16529,3578731718,3578731720,2
3,1007,16530,3578731718,3578731721,3
3,1007,16531,3578731718,3578731721,3
3,1007,16532,3578731718,3578731725,7
3,1007,16533,3578731718,3578731725,7
3,1007,16534,3578731718,3578731725,7
3,1007,16535,3578731718,3578731732,14
3,1007,16536,3578731718,3578731734,16
3,1007,16537,3578731718,3578731737,19
3,1007,16538,3578731718,3578731738,20
3,1007,16539,3578731718,3578731738,20
3,1007,16540,3578731718,3578731739,21
3,1007,16541,3578731718,3578731740,22
3,1007,16542,3578731718,3578731741,23
3,1007,16543,3578731718,3578731742,24
3,1007,16544,3578731718,3578731743,25
3,1007,16545,3578731718,3578731743,25
3,1007,16546,3578731718,3578731743,25
3,1007,16547,3578731718,3578731744,26
3,1007,16548,3578731718,3578731749,31
3,1007,16549,3578731718,3578731749,31
3,1007,16550,3578731718,3578731750,32
3,1007,16551,3578731718,3578731750,32
3,1007,16552,3578731718,3578731751,33
3,1007,16553,3578731718,3578731753,35
3,1007,16554,3578731718,3578731753,35
3,1007,16555,3578731718,3578731754,36
3,1007,16556,3578731718,3578731754,36
3,1007,16557,3578731718,3578731754,36
3,1007,16558,3578731718,3578731757,39
3,1007,16559,3578731718,3578731757,39
3,1007,16560,3578731718,3578731757,39
3,1007,16561,3578731718,3578731757,39
3,1007,16562,3578731718,3578731760,42
3,1007,16563,3578731718,3578731763,45
3,1007,16564,3578731718,3578731765,47
3,1007,16565,3578731718,3578731765,47
3,1007,16566,3578731718,3578731765,47
3,1007,16567,3578731718,3578731768,50
3,1008,16568,3578731776,3578731776,0
3,1008,16569,3578731776,3578731776,0
3,1008,16570,3578731776,3578731776,0
3,1008,16571,3578731776,3578731776,0
3,1008,16572,3578731776,3578731776,0
3,1008,16573,3578731776,3578731776,0
3,1008,16574,3578731776,3578731776,0
3,1008,16575,3578731776,3578731776,0
3,1008,16576,3578731776,3578731776,0
3,1008,16577,3578731776,3578731776,0
3,1008,16578,3578731776,3578731777,1
3,1008,16579,3578731776,3578731779,3
3,1008,16580,3578731776,3578731783,7
3,1008,16581,3578731776,3578731783,7
3,1008,16582,3578731776,3578731785,9
3,1008,16583,3578731776,3578731785,9
3,1008,16584,3578731776,3578731785,9
3,1008,16585,3578731776,3578731786,10
3,1008,16586,3578731776,3578731786,10
3,1008,16587,3578731776,3578731786,10
3,1008,16588,3578731776,3578731786,10
3,1008,16589,3578731776,3578731787,11
3,1008,16590,3578731776,3578731788,12
3,1008,16591,3578731776,3578731788,12
3,1008,16592,3578731776,3578731788,12
3,1008,16593,3578731776,3578731789,13
3,1008,16594,3578731776,3578731790,14
3,1008,16595,3578731776,3578731791,15
3,1008,16596,3578731776,3578731792,16
3,1008,16597,3578731776,3578731793,17
3,1008,16598,3578731776,3578731797,21
3,1008,16599,3578731776,3578731800,24
3,1008,16600,3578731776,3578731802,26
3,1008,16601,3578731776,3578731802,26
3,1008,16602,3578731776,3578731803,27
3,1008,16603,3578731776,3578731803,27
3,1008,16604,3578731776,3578731804,28
3,1008,16605,3578731776,3578731804,28
3,1008,16606,3578731776,3578731805,29
3,1008,16607,3578731776,3578731808,32
3,1008,16608,3578731776,3578731809,33
3,1008,16609,3578731776,3578731809,33
3,1008,16610,3578731776,3578731813,37
3,1008,16611,3578731776,3578731815,39
3,1008,16612,3578731776,3578731815,39
3,1008,16613,3578731776,3578731815,39
3,1008,16614,3578731776,3578731815,39
3,1008,16615,3578731776,3578731818,42
3,1008,16616,3578731776,3578731819,43
3,1008,16617,3578731776,3578731820,44
3,1008,16618,3578731776,3578731821,45
3,1008,16619,3578731776,3578731821,45
3,1008,16620,3578731776,3578731823,47
3,1008,16621,3578731776,3578731825,49
3,1008,16622,3578731776,3578731826,50
3,1009,16623,3578731836,3578731836,0
3,1009,16624,3578731836,3578731836,0
3,1009,16625,3578731836,3578731836,0
3,1009,16626,3578731836,3578731836,0
3,1009,16627,3578731836,3578731836,0
3,1009,16628,3578731836,3578731836,0
3,1009,16629,3578731836,3578731836,0
3,1009,16630,3578731836,3578731836,0
3,1009,16631,3578731836,3578731836,0
3,1009,16632,3578731836,3578731836,0
3,1009,16633,3578731836,3578731836,0
3,1009,16634,3578731836,3578731836,0
3,1009,16635,3578731836,3578731836,0
3,1009,16636,3578731836,3578731836,0
3,1009,16637,3578731836,3578731836,0
3,1009,16638,3578731836,3578731838,2
3,1009,16639,3578731836,3578731840,4
3,1009,16640,3578731836,3578731840,4
3,1009,16641,3578731836,3578731840,4
3,1009,16642,3578731836,3578731843,7
3,1009,16643,3578731836,3578731844,8
3,1009,16644,3578731836,3578731847,11
3,1009,16645,3578731836,3578731847,11
3,1009,16646,3578731836,3578731850,14
3,1009,16647,3578731836,3578731850,14
3,1009,16648,3578731836,3578731853,17
3,1009,16649,3578731836,3578731855,19
3,1009,16650,3578731836,3578731857,21
3,1009,16651,3578731836,3578731862,26
3,1009,16652,3578731836,3578731863,27
3,1009,16653,3578731836,3578731863,27
3,1009,16654,3578731836,3578731865,29
3,1009,16655,3578731836,3578731866,30
3,1009,16656,3578731836,3578731868,32
3,1009,16657,3578731836,3578731868,32
3,1009,16658,3578731836,3578731873,37
3,1009,16659,3578731836,3578731873,37
3,1009,16660,3578731836,3578731875,39
3,1009,16661,3578731836,3578731876,40
3,1009,16662,3578731836,3578731878,42
3,1009,16663,3578731836,3578731879,43
3,1009,16664,3578731836,3578731880,44
3,1009,16665,3578731836,3578731880,44
3,1009,16666,3578731836,3578731881,45
3,1009,16667,3578731836,3578731882,46
3,1009,16668,3578731836,3578731883,47
3,1009,16669,3578731836,3578731885,49
3,1009,16670,3578731836,3578731886,50
3,1010,16671,3578731894,3578731894,0
3,1010,16672,3578731894,3578731894,0
3,1010,16673,3578731894,3578731894,0
3,1010,16674,3578731894,3578731894,0
3,1010,16675,3578731894,3578731894,0
3,1010,16676,3578731894,3578731894,0
3,1010,16677,3578731894,3578731895,1
3,1010,16678,3578731894,3578731895,1
3,1010,16679,3578731894,3578731895,1
3,1010,16680,3578731894,3578731898,4
3,1010,16681,3578731894,3578731900,6
3,1010,16682,3578731894,3578731901,7
3,1010,16683,3578731894,3578731901,7
3,1010,16684,3578731894,3578731903,9
3,1010,16685,3578731894,3578731905,11
3,1010,16686,3578731894,3578731907,13
3,1010,16687,3578731894,3578731908,14
3,1010,16688,3578731894,3578731910,16
3,1010,16689,3578731894,3578731910,16
3,1010,16690,3578731894,3578731912,18
3,1010,16691,3578731894,3578731915,21
3,1010,16692,3578731894,3578731916,22
3,1010,16693,3578731894,3578731918,24
3,1010,16694,3578731894,3578731920,26
3,1010,16695,3578731894,3578731920,26
3,1010,16696,3578731894,3578731922,28
3,1010,16697,3578731894,3578731924,30
3,1010,16698,3578731894,3578731925,31
3,1010,16699,3578731894,3578731925,31
3,1010,16700,3578731894,3578731931,37
3,1010,16701,3578731894,3578731935,41
3,1010,16702,3578731894,3578731937,43
3,1010,16703,3578731894,3578731938,44
3,1010,16704,3578731894,3578731938,44
3,1010,16705,3578731894,3578731939,45
3,1010,16706,3578731894,3578731941,47
3,1010,16707,3578731894,3578731941,47
3,1010,16708,3578731894,3578731943,49
3,1010,16709,3578731894,3578731943,49
3,1010,16710,3578731894,3578731943,49
3,1010,16711,3578731894,3578731944,50
3,1011,16712,3578731954,3578731955,1
3,1011,16713,3578731954,3578731955,1
3,1011,16714,3578731954,3578731955,1
3,1011,16715,3578731954,3578731955,1
3,1011,16716,3578731954,3578731955,1
3,1011,16717,3578731954,3578731955,1
3,1011,16718,3578731954,3578731955,1
3,1011,16719,3578731954,3578731955,1
3,1011,16720,3578731954,3578731955,1
3,1011,16721,3578731954,3578731955,1
3,1011,16722,3578731954,3578731955,1
3,1011,16723,3578731954,3578731957,3
3,1011,16724,3578731954,3578731957,3
3,1011,16725,3578731954,3578731957,3
3,1011,16726,3578731954,3578731958,4
3,1011,16727,3578731954,3578731964,10
3,1011,16728,3578731954,3578731965,11
3,1011,16729,3578731954,3578731965,11
3,1011,16730,3578731954,3578731965,11
3,1011,16731,3578731954,3578731968,14
3,1011,16732,3578731954,3578731971,17
3,1011,16733,3578731954,3578731971,17
3,1011,16734,3578731954,3578731971,17
3,1011,16735,3578731954,3578731971,17
3,1011,16736,3578731954,3578731972,18
3,1011,16737,3578731954,3578731972,18
3,1011,16738,3578731954,3578731974,20
3,1011,16739,3578731954,3578731975,21
3,1011,16740,3578731954,3578731978,24
3,1011,16741,3578731954,3578731979,25
3,1011,16742,3578731954,3578731983,29
3,1011,16743,3578731954,3578731984,30
3,1011,16744,3578731954,3578731984,30
3,1011,16745,3578731954,3578731985,31
3,1011,16746,3578731954,3578731986,32
3,1011,16747,3578731954,3578731986,32
3,1011,16748,3578731954,3578731987,33
3,1011,16749,3578731954,3578731987,33
3,1011,16750,3578731954,3578731987,33
3,1011,16751,3578731954,3578731987,33
3,1011,16752,3578731954,3578731987,33
3,1011,16753,3578731954,3578731988,34
3,1011,16754,3578731954,3578731990,36
3,1011,16755,3578731954,3578731990,36
3,1011,16756,3578731954,3578731991,37
3,1011,16757,3578731954,3578731992,38
3,1011,16758,3578731954,3578731992,38
3,1011,16759,3578731954,3578731992,38
3,1011,16760,3578731954,3578731997,43
3,1011,16761,3578731954,3578732000,46
3,1011,16762,3578731954,3578732002,48
3,1011,16763,3578731954,3578732002,48
3,1011,16764,3578731954,3578732003,49
3,1011,16765,3578731954,3578732003,49
3,1011,16766,3578731954,3578732004,50
3,1012,16767,3578732013,3578732013,0
3,1012,16768,3578732013,3578732013,0
3,1012,16769,3578732013,3578732013,0
3,1012,16770,3578732013,3578732013,0
3,1012,16771,3578732013,3578732013,0
3,1012,16772,3578732013,3578732013,0
3,1012,16773,3578732013,3578732013,0
3,1012,16774,3578732013,3578732013,0
3,1012,16775,3578732013,3578732013,0
3,1012,16776,3578732013,3578732014,1
3,1012,16777,3578732013,3578732015,2
3,1012,16778,3578732013,3578732015,2
3,1012,16779,3578732013,3578732016,3
3,1012,16780,3578732013,3578732016,3
3,1012,16781,3578732013,3578732018,5
3,1012,16782,3578732013,3578732018,5
3,1012,16783,3578732013,3578732021,8
3,1012,16784,3578732013,3578732021,8
3,1012,16785,3578732013,3578732024,11
3,1012,16786,3578732013,3578732026,13
3,1012,16787,3578732013,3578732026,13
3,1012,16788,3578732013,3578732026,13
3,1012,16789,3578732013,3578732026,13
3,1012,16790,3578732013,3578732027,14
3,1012,16791,3578732013,3578732027,14
3,1012,16792,3578732013,3578732029,16
3,1012,16793,3578732013,3578732029,16
3,1012,16794,3578732013,3578732031,18
3,1012,16795,3578732013,3578732032,19
3,1012,16796,3578732013,3578732032,19
3,1012,16797,3578732013,3578732033,20
3,1012,16798,3578732013,3578732033,20
3,1012,16799,3578732013,3578732033,20
3,1012,16800,3578732013,3578732034,21
3,1012,16801,3578732013,3578732034,21
3,1012,16802,3578732013,3578732034,21
3,1012,16803,3578732013,3578732036,23
3,1012,16804,3578732013,3578732036,23
3,1012,16805,3578732013,3578732038,25
3,1012,16806,3578732013,3578732039,26
3,1012,16807,3578732013,3578732039,26
3,1012,16808,3578732013,3578732041,28
3,1012,16809,3578732013,3578732041,28
3,1012,16810,3578732013,3578732043,30
3,1012,16811,3578732013,3578732043,30
3,1012,16812,3578732013,3578732046,33
3,1012,16813,3578732013,3578732047,34
3,1012,16814,3578732013,3578732050,37
3,1012,16815,3578732013,3578732056,43
3,1012,16816,3578732013,3578732057,44
3,1012,16817,3578732013,3578732058,45
3,1013,16818,3578732072,3578732072,0
3,1013,16819,3578732072,3578732072,0
3,1013,16820,3578732072,3578732072,0
3,1013,16821,3578732072,3578732072,0
3,1013,16822,3578732072,3578732072,0
3,1013,16823,3578732072,3578732072,0
3,1013,16824,3578732072,3578732072,0
3,1013,16825,3578732072,3578732072,0
3,1013,16826,3578732072,3578732073,1
3,1013,16827,3578732072,3578732074,2
3,1013,16828,3578732072,3578732075,3
3,1013,16829,3578732072,3578732075,3
3,1013,16830,3578732072,3578732078,6
3,1013,16831,3578732072,3578732079,7
3,1013,16832,3578732072,3578732079,7
3,1013,16833,3578732072,3578732080,8
3,1013,16834,3578732072,3578732080,8
3,1013,16835,3578732072,3578732082,10
3,1013,16836,3578732072,3578732083,11
3,1013,16837,3578732072,3578732083,11
3,1013,16838,3578732072,3578732085,13
3,1013,16839,3578732072,3578732085,13
3,1013,16840,3578732072,3578732087,15
3,1013,16841,3578732072,3578732089,17
3,1013,16842,3578732072,3578732090,18
3,1013,16843,3578732072,3578732091,19
3,1013,16844,3578732072,3578732095,23
3,1013,16845,3578732072,3578732095,23
3,1013,16846,3578732072,3578732096,24
3,1013,16847,3578732072,3578732098,26
3,1013,16848,3578732072,3578732100,28
3,1013,16849,3578732072,3578732101,29
3,1013,16850,3578732072,3578732103,31
3,1013,16851,3578732072,3578732105,33
3,1013,16852,3578732072,3578732106,34
3,1013,16853,3578732072,3578732109,37
3,1013,16854,3578732072,3578732110,38
3,1013,16855,3578732072,3578732110,38
3,1013,16856,3578732072,3578732113,41
3,1013,16857,3578732072,3578732115,43
3,1013,16858,3578732072,3578732115,43
3,1013,16859,3578732072,3578732119,47
3,1013,16860,3578732072,3578732120,48
3,1013,16861,3578732072,3578732121,49
3,1013,16862,3578732072,3578732122,50
3,1014,16863,3578732129,3578732129,0
3,1014,16864,3578732129,3578732129,0
3,1014,16865,3578732129,3578732129,0
3,1014,16866,3578732129,3578732129,0
3,1014,16867,3578732129,3578732136,7
3,1014,16868,3578732129,3578732138,9
3,1014,16869,3578732129,3578732138,9
3,1014,16870,3578732129,3578732138,9
3,1014,16871,3578732129,3578732139,10
3,1014,16872,3578732129,3578732141,12
3,1014,16873,3578732129,3578732141,12
3,1014,16874,3578732129,3578732142,13
3,1014,16875,3578732129,3578732143,14
3,1014,16876,3578732129,3578732143,14
3,1014,16877,3578732129,3578732143,14
3,1014,16878,3578732129,3578732144,15
3,1014,16879,3578732129,3578732145,16
3,1014,16880,3578732129,3578732149,20
3,1014,16881,3578732129,3578732150,21
3,1014,16882,3578732129,3578732151,22
3,1014,16883,3578732129,3578732151,22
3,1014,16884,3578732129,3578732153,24
3,1014,16885,3578732129,3578732154,25
3,1014,16886,3578732129,3578732154,25
3,1014,16887,3578732129,3578732154,25
3,1014,16888,3578732129,3578732154,25
3,1014,16889,3578732129,3578732157,28
3,1014,16890,3578732129,3578732157,28
3,1014,16891,3578732129,3578732157,28
3,1014,16892,3578732129,3578732160,31
3,1014,16893,3578732129,3578732163,34
3,1014,16894,3578732129,3578732166,37
3,1014,16895,3578732129,3578732166,37
3,1014,16896,3578732129,3578732168,39
3,1014,16897,3578732129,3578732168,39
3,1014,16898,3578732129,3578732171,42
3,1014,16899,3578732129,3578732171,42
3,1014,16900,3578732129,3578732171,42
3,1014,16901,3578732129,3578732172,43
3,1014,16902,3578732129,3578732172,43
3,1014,16903,3578732129,3578732173,44
3,1014,16904,3578732129,3578732173,44
3,1014,16905,3578732129,3578732174,45
3,1014,16906,3578732129,3578732174,45
3,1014,16907,3578732129,3578732175,46
3,1014,16908,3578732129,3578732178,49
3,1014,16909,3578732129,3578732179,50
3,1015,16910,3578732186,3578732186,0
3,1015,16911,3578732186,3578732186,0
3,1015,16912,3578732186,3578732186,0
3,1015,16913,3578732186,3578732186,0
3,1015,16914,3578732186,3578732186,0
3,1015,16915,3578732186,3578732186,0
3,1015,16916,3578732186,3578732186,0
3,1015,16917,3578732186,3578732187,1
3,1015,16918,3578732186,3578732187,1
3,1015,16919,3578732186,3578732188,2
3,1015,16920,3578732186,3578732189,3
3,1015,16921,3578732186,3578732189,3
3,1015,16922,3578732186,3578732190,4
3,1015,16923,3578732186,3578732192,6
3,1015,16924,3578732186,3578732192,6
3,1015,16925,3578732186,3578732192,6
3,1015,16926,3578732186,3578732197,11
3,1015,16927,3578732186,3578732200,14
3,1015,16928,3578732186,3578732204,18
3,1015,16929,3578732186,3578732204,18
3,1015,16930,3578732186,3578732204,18
3,1015,16931,3578732186,3578732204,18
3,1015,16932,3578732186,3578732204,18
3,1015,16933,3578732186,3578732209,23
3,1015,16934,3578732186,3578732209,23
3,1015,16935,3578732186,3578732210,24
3,1015,16936,3578732186,3578732211,25
3,1015,16937,3578732186,3578732212,26
3,1015,16938,3578732186,3578732214,28
3,1015,16939,3578732186,3578732215,29
3,1015,16940,3578732186,3578732216,30
3,1015,16941,3578732186,3578732216,30
3,1015,16942,3578732186,3578732216,30
3,1015,16943,3578732186,3578732217,31
3,1015,16944,3578732186,3578732217,31
3,1015,16945,3578732186,3578732219,33
3,1015,16946,3578732186,3578732221,35
3,1015,16947,3578732186,3578732221,35
3,1015,16948,3578732186,3578732223,37
3,1015,16949,3578732186,3578732226,40
3,1015,16950,3578732186,3578732226,40
3,1015,16951,3578732186,3578732227,41
3,1015,16952,3578732186,3578732227,41
3,1015,16953,3578732186,3578732227,41
3,1015,16954,3578732186,3578732227,41
3,1015,16955,3578732186,3578732228,42
3,1015,16956,3578732186,3578732229,43
3,1015,16957,3578732186,3578732232,46
3,1015,16958,3578732186,3578732232,46
3,1015,16959,3578732186,3578732232,46
3,1015,16960,3578732186,3578732232,46
3,1015,16961,3578732186,3578732233,47
3,1015,16962,3578732186,3578732233,47
3,1015,16963,3578732186,3578732234,48
3,1015,16964,3578732186,3578732235,49
3,1015,16965,3578732186,3578732235,49
3,1015,16966,3578732186,3578732236,50
3,1016,16967,3578732244,3578732244,0
3,1016,16968,3578732244,3578732244,0
3,1016,16969,3578732244,3578732244,0
3,1016,16970,3578732244,3578732244,0
3,1016,16971,3578732244,3578732244,0
3,1016,16972,3578732244,3578732244,0
3,1016,16973,3578732244,3578732245,1
3,1016,16974,3578732244,3578732246,2
3,1016,16975,3578732244,3578732248,4
3,1016,16976,3578732244,3578732251,7
3,1016,16977,3578732244,3578732256,12
3,1016,16978,3578732244,3578732258,14
3,1016,16979,3578732244,3578732264,20
3,1016,16980,3578732244,3578732267,23
3,1016,16981,3578732244,3578732267,23
3,1016,16982,3578732244,3578732268,24
3,1016,16983,3578732244,3578732268,24
3,1016,16984,3578732244,3578732268,24
3,1016,16985,3578732244,3578732271,27
3,1016,16986,3578732244,3578732273,29
3,1016,16987,3578732244,3578732273,29
3,1016,16988,3578732244,3578732275,31
3,1016,16989,3578732244,3578732275,31
3,1016,16990,3578732244,3578732278,34
3,1016,16991,3578732244,3578732279,35
3,1016,16992,3578732244,3578732280,36
3,1016,16993,3578732244,3578732280,36
3,1016,16994,3578732244,3578732280,36
3,1016,16995,3578732244,3578732282,38
3,1016,16996,3578732244,3578732283,39
3,1016,16997,3578732244,3578732283,39
3,1016,16998,3578732244,3578732286,42
3,1016,16999,3578732244,3578732286,42
3,1016,17000,3578732244,3578732287,43
3,1016,17001,3578732244,3578732289,45
3,1016,17002,3578732244,3578732289,45
3,1016,17003,3578732244,3578732290,46
3,1016,17004,3578732244,3578732290,46
3,1017,17005,3578732303,3578732303,0
3,1017,17006,3578732303,3578732303,0
3,1017,17007,3578732303,3578732303,0
3,1017,17008,3578732303,3578732303,0
3,1017,17009,3578732303,3578732303,0
3,1017,17010,3578732303,3578732303,0
3,1017,17011,3578732303,3578732303,0
3,1017,17012,3578732303,3578732304,1
3,1017,17013,3578732303,3578732305,2
3,1017,17014,3578732303,3578732306,3
3,1017,17015,3578732303,3578732309,6
3,1017,17016,3578732303,3578732310,7
3,1017,17017,3578732303,3578732310,7
3,1017,17018,3578732303,3578732314,11
3,1017,17019,3578732303,3578732315,12
3,1017,17020,3578732303,3578732316,13
3,1017,17021,3578732303,3578732318,15
3,1017,17022,3578732303,3578732320,17
3,1017,17023,3578732303,3578732320,17
3,1017,17024,3578732303,3578732321,18
3,1017,17025,3578732303,3578732322,19
3,1017,17026,3578732303,3578732325,22
3,1017,17027,3578732303,3578732326,23
3,1017,17028,3578732303,3578732327,24
3,1017,17029,3578732303,3578732336,33
3,1017,17030,3578732303,3578732338,35
3,1017,17031,3578732303,3578732338,35
3,1017,17032,3578732303,3578732339,36
3,1017,17033,3578732303,3578732339,36
3,1017,17034,3578732303,3578732341,38
3,1017,17035,3578732303,3578732343,40
3,1017,17036,3578732303,3578732344,41
3,1017,17037,3578732303,3578732344,41
3,1017,17038,3578732303,3578732344,41
3,1017,17039,3578732303,3578732345,42
3,1017,17040,3578732303,3578732345,42
3,1017,17041,3578732303,3578732349,46
3,1017,17042,3578732303,3578732351,48
3,1017,17043,3578732303,3578732351,48
3,1017,17044,3578732303,3578732351,48
3,1017,17045,3578732303,3578732352,49
3,1018,17046,3578732362,3578732362,0
3,1018,17047,3578732362,3578732362,0
3,1018,17048,3578732362,3578732362,0
3,1018,17049,3578732362,3578732362,0
3,1018,17050,3578732362,3578732362,0
3,1018,17051,3578732362,3578732362,0
3,1018,17052,3578732362,3578732362,0
3,1018,17053,3578732362,3578732362,0
3,1018,17054,3578732362,3578732362,0
3,1018,17055,3578732362,3578732364,2
3,1018,17056,3578732362,3578732366,4
3,1018,17057,3578732362,3578732366,4
3,1018,17058,3578732362,3578732368,6
3,1018,17059,3578732362,3578732368,6
3,1018,17060,3578732362,3578732368,6
3,1018,17061,3578732362,3578732370,8
3,1018,17062,3578732362,3578732371,9
3,1018,17063,3578732362,3578732371,9
3,1018,17064,3578732362,3578732371,9
3,1018,17065,3578732362,3578732371,9
3,1018,17066,3578732362,3578732372,10
3,1018,17067,3578732362,3578732373,11
3,1018,17068,3578732362,3578732373,11
3,1018,17069,3578732362,3578732374,12
3,1018,17070,3578732362,3578732377,15
3,1018,17071,3578732362,3578732379,17
3,1018,17072,3578732362,3578732379,17
3,1018,17073,3578732362,3578732383,21
3,1018,17074,3578732362,3578732384,22
3,1018,17075,3578732362,3578732384,22
3,1018,17076,3578732362,3578732385,23
3,1018,17077,3578732362,3578732386,24
3,1018,17078,3578732362,3578732386,24
3,1018,17079,3578732362,3578732387,25
3,1018,17080,3578732362,3578732387,25
3,1018,17081,3578732362,3578732387,25
3,1018,17082,3578732362,3578732388,26
3,1018,17083,3578732362,3578732388,26
3,1018,17084,3578732362,3578732389,27
3,1018,17085,3578732362,3578732390,28
3,1018,17086,3578732362,3578732390,28
3,1018,17087,3578732362,3578732391,29
3,1018,17088,3578732362,3578732392,30
3,1018,17089,3578732362,3578732392,30
3,1018,17090,3578732362,3578732392,30
3,1018,17091,3578732362,3578732397,35
3,1018,17092,3578732362,3578732400,38
3,1018,17093,3578732362,3578732401,39
3,1018,17094,3578732362,3578732403,41
3,1018,17095,3578732362,3578732404,42
3,1018,17096,3578732362,3578732404,42
3,1018,17097,3578732362,3578732404,42
3,1018,17098,3578732362,3578732405,43
3,1018,17099,3578732362,3578732406,44
3,1018,17100,3578732362,3578732407,45
3,1018,17101,3578732362,3578732409,47
3,1018,17102,3578732362,3578732409,47
3,1018,17103,3578732362,3578732409,47
3,1018,17104,3578732362,3578732411,49
3,1018,17105,3578732362,3578732412,50
3,1019,17106,3578732421,3578732421,0
3,1019,17107,3578732421,3578732421,0
3,1019,17108,3578732421,3578732421,0
3,1019,17109,3578732421,3578732421,0
3,1019,17110,3578732421,3578732421,0
3,1019,17111,3578732421,3578732421,0
3,1019,17112,3578732421,3578732421,0
3,1019,17113,3578732421,3578732421,0
3,1019,17114,3578732421,3578732422,1
3,1019,17115,3578732421,3578732424,3
3,1019,17116,3578732421,3578732426,5
3,1019,17117,3578732421,3578732427,6
3,1019,17118,3578732421,3578732427,6
3,1019,17119,3578732421,3578732427,6
3,1019,17120,3578732421,3578732428,7
3,1019,17121,3578732421,3578732428,7
3,1019,17122,3578732421,3578732428,7
3,1019,17123,3578732421,3578732430,9
3,1019,17124,3578732421,3578732432,11
3,1019,17125,3578732421,3578732432,11
3,1019,17126,3578732421,3578732432,11
3,1019,17127,3578732421,3578732433,12
3,1019,17128,3578732421,3578732433,12
3,1019,17129,3578732421,3578732433,12
3,1019,17130,3578732421,3578732435,14
3,1019,17131,3578732421,3578732435,14
3,1019,17132,3578732421,3578732435,14
3,1019,17133,3578732421,3578732436,15
3,1019,17134,3578732421,3578732437,16
3,1019,17135,3578732421,3578732439,18
3,1019,17136,3578732421,3578732440,19
3,1019,17137,3578732421,3578732440,19
3,1019,17138,3578732421,3578732440,19
3,1019,17139,3578732421,3578732441,20
3,1019,17140,3578732421,3578732443,22
3,1019,17141,3578732421,3578732443,22
3,1019,17142,3578732421,3578732445,24
3,1019,17143,3578732421,3578732447,26
3,1019,17144,3578732421,3578732447,26
3,1019,17145,3578732421,3578732451,30
3,1019,17146,3578732421,3578732451,30
3,1019,17147,3578732421,3578732457,36
3,1019,17148,3578732421,3578732457,36
3,1019,17149,3578732421,3578732462,41
3,1019,17150,3578732421,3578732465,44
3,1019,17151,3578732421,3578732466,45
3,1019,17152,3578732421,3578732467,46
3,1019,17153,3578732421,3578732467,46
3,1019,17154,3578732421,3578732468,47
3,1019,17155,3578732421,3578732469,48
3,1019,17156,3578732421,3578732470,49
3,1020,17157,3578732479,3578732479,0
3,1020,17158,3578732479,3578732479,0
3,1020,17159,3578732479,3578732479,0
3,1020,17160,3578732479,3578732479,0
3,1020,17161,3578732479,3578732479,0
3,1020,17162,3578732479,3578732479,0
3,1020,17163,3578732479,3578732479,0
3,1020,17164,3578732479,3578732479,0
3,1020,17165,3578732479,3578732480,1
3,1020,17166,3578732479,3578732481,2
3,1020,17167,3578732479,3578732482,3
3,1020,17168,3578732479,3578732485,6
3,1020,17169,3578732479,3578732485,6
3,1020,17170,3578732479,3578732486,7
3,1020,17171,3578732479,3578732487,8
3,1020,17172,3578732479,3578732488,9
3,1020,17173,3578732479,3578732490,11
3,1020,17174,3578732479,3578732490,11
3,1020,17175,3578732479,3578732494,15
3,1020,17176,3578732479,3578732494,15
3,1020,17177,3578732479,3578732495,16
3,1020,17178,3578732479,3578732498,19
3,1020,17179,3578732479,3578732498,19
3,1020,17180,3578732479,3578732499,20
3,1020,17181,3578732479,3578732503,24
3,1020,17182,3578732479,3578732505,26
3,1020,17183,3578732479,3578732506,27
3,1020,17184,3578732479,3578732508,29
3,1020,17185,3578732479,3578732509,30
3,1020,17186,3578732479,3578732514,35
3,1020,17187,3578732479,3578732515,36
3,1020,17188,3578732479,3578732515,36
3,1020,17189,3578732479,3578732517,38
3,1020,17190,3578732479,3578732520,41
3,1020,17191,3578732479,3578732520,41
3,1020,17192,3578732479,3578732521,42
3,1020,17193,3578732479,3578732524,45
3,1020,17194,3578732479,3578732525,46
3,1020,17195,3578732479,3578732526,47
3,1020,17196,3578732479,3578732528,49
3,1021,17197,3578732537,3578732537,0
3,1021,17198,3578732537,3578732538,1
3,1021,17199,3578732537,3578732538,1
3,1021,17200,3578732537,3578732540,3
3,1021,17201,3578732537,3578732541,4
3,1021,17202,3578732537,3578732542,5
3,1021,17203,3578732537,3578732543,6
3,1021,17204,3578732537,3578732544,7
3,1021,17205,3578732537,3578732544,7
3,1021,17206,3578732537,3578732544,7
3,1021,17207,3578732537,3578732549,12
3,1021,17208,3578732537,3578732550,13
3,1021,17209,3578732537,3578732550,13
3,1021,17210,3578732537,3578732551,14
3,1021,17211,3578732537,3578732553,16
3,1021,17212,3578732537,3578732553,16
3,1021,17213,3578732537,3578732554,17
3,1021,17214,3578732537,3578732555,18
3,1021,17215,3578732537,3578732556,19
3,1021,17216,3578732537,3578732557,20
3,1021,17217,3578732537,3578732557,20
3,1021,17218,3578732537,3578732559,22
3,1021,17219,3578732537,3578732564,27
3,1021,17220,3578732537,3578732566,29
3,1021,17221,3578732537,3578732566,29
3,1021,17222,3578732537,3578732567,30
3,1021,17223,3578732537,3578732567,30
3,1021,17224,3578732537,3578732569,32
3,1021,17225,3578732537,3578732570,33
3,1021,17226,3578732537,3578732570,33
3,1021,17227,3578732537,3578732570,33
3,1021,17228,3578732537,3578732571,34
3,1021,17229,3578732537,3578732571,34
3,1021,17230,3578732537,3578732571,34
3,1021,17231,3578732537,3578732572,35
3,1021,17232,3578732537,3578732572,35
3,1021,17233,3578732537,3578732573,36
3,1021,17234,3578732537,3578732576,39
3,1021,17235,3578732537,3578732578,41
3,1021,17236,3578732537,3578732578,41
3,1021,17237,3578732537,3578732582,45
3,1021,17238,3578732537,3578732583,46
3,1021,17239,3578732537,3578732584,47
3,1021,17240,3578732537,3578732584,47
3,1021,17241,3578732537,3578732586,49
3,1021,17242,3578732537,3578732586,49
3,1021,17243,3578732537,3578732586,49
3,1021,17244,3578732537,3578732587,50
3,1022,17245,3578732596,3578732596,0
3,1022,17246,3578732596,3578732596,0
3,1022,17247,3578732596,3578732596,0
3,1022,17248,3578732596,3578732596,0
3,1022,17249,3578732596,3578732596,0
3,1022,17250,3578732596,3578732596,0
3,1022,17251,3578732596,3578732596,0
3,1022,17252,3578732596,3578732596,0
3,1022,17253,3578732596,3578732596,0
3,1022,17254,3578732596,3578732596,0
3,1022,17255,3578732596,3578732599,3
3,1022,17256,3578732596,3578732601,5
3,1022,17257,3578732596,3578732602,6
3,1022,17258,3578732596,3578732603,7
3,1022,17259,3578732596,3578732604,8
3,1022,17260,3578732596,3578732604,8
3,1022,17261,3578732596,3578732605,9
3,1022,17262,3578732596,3578732606,10
3,1022,17263,3578732596,3578732608,12
3,1022,17264,3578732596,3578732609,13
3,1022,17265,3578732596,3578732609,13
3,1022,17266,3578732596,3578732609,13
3,1022,17267,3578732596,3578732610,14
3,1022,17268,3578732596,3578732612,16
3,1022,17269,3578732596,3578732615,19
3,1022,17270,3578732596,3578732615,19
3,1022,17271,3578732596,3578732615,19
3,1022,17272,3578732596,3578732616,20
3,1022,17273,3578732596,3578732617,21
3,1022,17274,3578732596,3578732617,21
3,1022,17275,3578732596,3578732619,23
3,1022,17276,3578732596,3578732620,24
3,1022,17277,3578732596,3578732621,25
3,1022,17278,3578732596,3578732621,25
3,1022,17279,3578732596,3578732622,26
3,1022,17280,3578732596,3578732625,29
3,1022,17281,3578732596,3578732626,30
3,1022,17282,3578732596,3578732627,31
3,1022,17283,3578732596,3578732627,31
3,1022,17284,3578732596,3578732627,31
3,1022,17285,3578732596,3578732628,32
3,1022,17286,3578732596,3578732628,32
3,1022,17287,3578732596,3578732628,32
3,1022,17288,3578732596,3578732631,35
3,1022,17289,3578732596,3578732631,35
3,1022,17290,3578732596,3578732632,36
3,1022,17291,3578732596,3578732632,36
3,1022,17292,3578732596,3578732632,36
3,1022,17293,3578732596,3578732632,36
3,1022,17294,3578732596,3578732634,38
3,1022,17295,3578732596,3578732634,38
3,1022,17296,3578732596,3578732635,39
3,1022,17297,3578732596,3578732636,40
3,1022,17298,3578732596,3578732639,43
3,1022,17299,3578732596,3578732640,44
3,1022,17300,3578732596,3578732641,45
3,1022,17301,3578732596,3578732643,47
3,1022,17302,3578732596,3578732643,47
3,1022,17303,3578732596,3578732644,48
3,1023,17304,3578732656,3578732656,0
3,1023,17305,3578732656,3578732656,0
3,1023,17306,3578732656,3578732656,0
3,1023,17307,3578732656,3578732656,0
3,1023,17308,3578732656,3578732656,0
3,1023,17309,3578732656,3578732656,0
3,1023,17310,3578732656,3578732656,0
3,1023,17311,3578732656,3578732657,1
3,1023,17312,3578732656,3578732661,5
3,1023,17313,3578732656,3578732665,9
3,1023,17314,3578732656,3578732666,10
3,1023,17315,3578732656,3578732666,10
3,1023,17316,3578732656,3578732667,11
3,1023,17317,3578732656,3578732668,12
3,1023,17318,3578732656,3578732669,13
3,1023,17319,3578732656,3578732673,17
3,1023,17320,3578732656,3578732674,18
3,1023,17321,3578732656,3578732675,19
3,1023,17322,3578732656,3578732675,19
3,1023,17323,3578732656,3578732678,22
3,1023,17324,3578732656,3578732678,22
3,1023,17325,3578732656,3578732679,23
3,1023,17326,3578732656,3578732680,24
3,1023,17327,3578732656,3578732680,24
3,1023,17328,3578732656,3578732681,25
3,1023,17329,3578732656,3578732682,26
3,1023,17330,3578732656,3578732685,29
3,1023,17331,3578732656,3578732686,30
3,1023,17332,3578732656,3578732686,30
3,1023,17333,3578732656,3578732687,31
3,1023,17334,3578732656,3578732688,32
3,1023,17335,3578732656,3578732690,34
3,1023,17336,3578732656,3578732690,34
3,1023,17337,3578732656,3578732692,36
3,1023,17338,3578732656,3578732694,38
3,1023,17339,3578732656,3578732695,39
3,1023,17340,3578732656,3578732696,40
3,1023,17341,3578732656,3578732696,40
3,1023,17342,3578732656,3578732698,42
3,1023,17343,3578732656,3578732698,42
3,1023,17344,3578732656,3578732701,45
3,1023,17345,3578732656,3578732703,47
3,1023,17346,3578732656,3578732705,49
3,1024,17347,3578732718,3578732718,0
3,1024,17348,3578732718,3578732718,0
3,1024,17349,3578732718,3578732718,0
3,1024,17350,3578732718,3578732718,0
3,1024,17351,3578732718,3578732718,0
3,1024,17352,3578732718,3578732718,0
3,1024,17353,3578732718,3578732718,0
3,1024,17354,3578732718,3578732718,0
3,1024,17355,3578732718,3578732720,2
3,1024,17356,3578732718,3578732720,2
3,1024,17357,3578732718,3578732721,3
3,1024,17358,3578732718,3578732721,3
3,1024,17359,3578732718,3578732724,6
3,1024,17360,3578732718,3578732725,7
3,1024,17361,3578732718,3578732726,8
3,1024,17362,3578732718,3578732728,10
3,1024,17363,3578732718,3578732732,14
3,1024,17364,3578732718,3578732736,18
3,1024,17365,3578732718,3578732737,19
3,1024,17366,3578732718,3578732737,19
3,1024,17367,3578732718,3578732737,19
3,1024,17368,3578732718,3578732738,20
3,1024,17369,3578732718,3578732741,23
3,1024,17370,3578732718,3578732743,25
3,1024,17371,3578732718,3578732743,25
3,1024,17372,3578732718,3578732743,25
3,1024,17373,3578732718,3578732744,26
3,1024,17374,3578732718,3578732745,27
3,1024,17375,3578732718,3578732749,31
3,1024,17376,3578732718,3578732750,32
3,1024,17377,3578732718,3578732750,32
3,1024,17378,3578732718,3578732751,33
3,1024,17379,3578732718,3578732752,34
3,1024,17380,3578732718,3578732754,36
3,1024,17381,3578732718,3578732754,36
3,1024,17382,3578732718,3578732755,37
3,1024,17383,3578732718,3578732756,38
3,1024,17384,3578732718,3578732756,38
3,1024,17385,3578732718,3578732757,39
3,1024,17386,3578732718,3578732757,39
3,1024,17387,3578732718,3578732757,39
3,1024,17388,3578732718,3578732757,39
3,1024,17389,3578732718,3578732758,40
3,1024,17390,3578732718,3578732760,42
3,1024,17391,3578732718,3578732763,45
3,1024,17392,3578732718,3578732765,47
3,1024,17393,3578732718,3578732766,48
3,1024,17394,3578732718,3578732767,49
3,1024,17395,3578732718,3578732768,50
3,1025,17396,3578732780,3578732780,0
3,1025,17397,3578732780,3578732780,0
3,1025,17398,3578732780,3578732780,0
3,1025,17399,3578732780,3578732780,0
3,1025,17400,3578732780,3578732780,0
3,1025,17401,3578732780,3578732780,0
3,1025,17402,3578732780,3578732780,0
3,1025,17403,3578732780,3578732780,0
3,1025,17404,3578732780,3578732780,0
3,1025,17405,3578732780,3578732780,0
3,1025,17406,3578732780,3578732780,0
3,1025,17407,3578732780,3578732780,0
3,1025,17408,3578732780,3578732780,0
3,1025,17409,3578732780,3578732780,0
3,1025,17410,3578732780,3578732783,3
3,1025,17411,3578732780,3578732783,3
3,1025,17412,3578732780,3578732783,3
3,1025,17413,3578732780,3578732784,4
3,1025,17414,3578732780,3578732785,5
3,1025,17415,3578732780,3578732785,5
3,1025,17416,3578732780,3578732786,6
3,1025,17417,3578732780,3578732786,6
3,1025,17418,3578732780,3578732787,7
3,1025,17419,3578732780,3578732788,8
3,1025,17420,3578732780,3578732789,9
3,1025,17421,3578732780,3578732790,10
3,1025,17422,3578732780,3578732790,10
3,1025,17423,3578732780,3578732790,10
3,1025,17424,3578732780,3578732793,13
3,1025,17425,3578732780,3578732793,13
3,1025,17426,3578732780,3578732797,17
3,1025,17427,3578732780,3578732798,18
3,1025,17428,3578732780,3578732801,21
3,1025,17429,3578732780,3578732803,23
3,1025,17430,3578732780,3578732803,23
3,1025,17431,3578732780,3578732804,24
3,1025,17432,3578732780,3578732804,24
3,1025,17433,3578732780,3578732805,25
3,1025,17434,3578732780,3578732806,26
3,1025,17435,3578732780,3578732809,29
3,1025,17436,3578732780,3578732809,29
3,1025,17437,3578732780,3578732811,31
3,1025,17438,3578732780,3578732813,33
3,1025,17439,3578732780,3578732815,35
3,1025,17440,3578732780,3578732815,35
3,1025,17441,3578732780,3578732815,35
3,1025,17442,3578732780,3578732815,35
3,1025,17443,3578732780,3578732817,37
3,1025,17444,3578732780,3578732817,37
3,1025,17445,3578732780,3578732819,39
3,1025,17446,3578732780,3578732819,39
3,1025,17447,3578732780,3578732821,41
3,1025,17448,3578732780,3578732821,41
3,1025,17449,3578732780,3578732822,42
3,1025,17450,3578732780,3578732825,45
3,1025,17451,3578732780,3578732826,46
3,1025,17452,3578732780,3578732826,46
3,1025,17453,3578732780,3578732827,47
3,1025,17454,3578732780,3578732828,48
3,1025,17455,3578732780,3578732828,48
3,1025,17456,3578732780,3578732828,48
3,1026,17457,3578732838,3578732838,0
3,1026,17458,3578732838,3578732838,0
3,1026,17459,3578732838,3578732838,0
3,1026,17460,3578732838,3578732838,0
3,1026,17461,3578732838,3578732838,0
3,1026,17462,3578732838,3578732838,0
3,1026,17463,3578732838,3578732838,0
3,1026,17464,3578732838,3578732838,0
3,1026,17465,3578732838,3578732838,0
3,1026,17466,3578732838,3578732838,0
3,1026,17467,3578732838,3578732838,0
3,1026,17468,3578732838,3578732839,1
3,1026,17469,3578732838,3578732840,2
3,1026,17470,3578732838,3578732840,2
3,1026,17471,3578732838,3578732841,3
3,1026,17472,3578732838,3578732843,5
3,1026,17473,3578732838,3578732847,9
3,1026,17474,3578732838,3578732847,9
3,1026,17475,3578732838,3578732849,11
3,1026,17476,3578732838,3578732849,11
3,1026,17477,3578732838,3578732851,13
3,1026,17478,3578732838,3578732853,15
3,1026,17479,3578732838,3578732854,16
3,1026,17480,3578732838,3578732856,18
3,1026,17481,3578732838,3578732857,19
3,1026,17482,3578732838,3578732864,26
3,1026,17483,3578732838,3578732866,28
3,1026,17484,3578732838,3578732867,29
3,1026,17485,3578732838,3578732868,30
3,1026,17486,3578732838,3578732869,31
3,1026,17487,3578732838,3578732869,31
3,1026,17488,3578732838,3578732872,34
3,1026,17489,3578732838,3578732874,36
3,1026,17490,3578732838,3578732875,37
3,1026,17491,3578732838,3578732876,38
3,1026,17492,3578732838,3578732878,40
3,1026,17493,3578732838,3578732880,42
3,1026,17494,3578732838,3578732880,42
3,1026,17495,3578732838,3578732880,42
3,1026,17496,3578732838,3578732881,43
3,1026,17497,3578732838,3578732882,44
3,1026,17498,3578732838,3578732885,47
3,1026,17499,3578732838,3578732886,48
3,1026,17500,3578732838,3578732887,49
3,1027,17501,3578732897,3578732897,0
3,1027,17502,3578732897,3578732897,0
3,1027,17503,3578732897,3578732897,0
3,1027,17504,3578732897,3578732897,0
3,1027,17505,3578732897,3578732897,0
3,1027,17506,3578732897,3578732897,0
3,1027,17507,3578732897,3578732898,1
3,1027,17508,3578732897,3578732899,2
3,1027,17509,3578732897,3578732902,5
3,1027,17510,3578732897,3578732903,6
3,1027,17511,3578732897,3578732906,9
3,1027,17512,3578732897,3578732907,10
3,1027,17513,3578732897,3578732909,12
3,1027,17514,3578732897,3578732910,13
3,1027,17515,3578732897,3578732910,13
3,1027,17516,3578732897,3578732915,18
3,1027,17517,3578732897,3578732915,18
3,1027,17518,3578732897,3578732915,18
3,1027,17519,3578732897,3578732917,20
3,1027,17520,3578732897,3578732920,23
3,1027,17521,3578732897,3578732921,24
3,1027,17522,3578732897,3578732922,25
3,1027,17523,3578732897,3578732924,27
3,1027,17524,3578732897,3578732926,29
3,1027,17525,3578732897,3578732928,31
3,1027,17526,3578732897,3578732933,36
3,1027,17527,3578732897,3578732936,39
3,1027,17528,3578732897,3578732937,40
3,1027,17529,3578732897,3578732938,41
3,1027,17530,3578732897,3578732938,41
3,1027,17531,3578732897,3578732938,41
3,1027,17532,3578732897,3578732940,43
3,1027,17533,3578732897,3578732941,44
3,1027,17534,3578732897,3578732942,45
3,1027,17535,3578732897,3578732943,46
3,1027,17536,3578732897,3578732944,47
3,1027,17537,3578732897,3578732944,47
3,1027,17538,3578732897,3578732945,48
3,1028,17539,3578732955,3578732955,0
3,1028,17540,3578732955,3578732955,0
3,1028,17541,3578732955,3578732955,0
3,1028,17542,3578732955,3578732955,0
3,1028,17543,3578732955,3578732955,0
3,1028,17544,3578732955,3578732955,0
3,1028,17545,3578732955,3578732955,0
3,1028,17546,3578732955,3578732955,0
3,1028,17547,3578732955,3578732956,1
3,1028,17548,3578732955,3578732957,2
3,1028,17549,3578732955,3578732957,2
3,1028,17550,3578732955,3578732957,2
3,1028,17551,3578732955,3578732958,3
3,1028,17552,3578732955,3578732958,3
3,1028,17553,3578732955,3578732959,4
3,1028,17554,3578732955,3578732960,5
3,1028,17555,3578732955,3578732963,8
3,1028,17556,3578732955,3578732965,10
3,1028,17557,3578732955,3578732966,11
3,1028,17558,3578732955,3578732967,12
3,1028,17559,3578732955,3578732967,12
3,1028,17560,3578732955,3578732968,13
3,1028,17561,3578732955,3578732969,14
3,1028,17562,3578732955,3578732971,16
3,1028,17563,3578732955,3578732971,16
3,1028,17564,3578732955,3578732972,17
3,1028,17565,3578732955,3578732972,17
3,1028,17566,3578732955,3578732972,17
3,1028,17567,3578732955,3578732973,18
3,1028,17568,3578732955,3578732974,19
3,1028,17569,3578732955,3578732974,19
3,1028,17570,3578732955,3578732977,22
3,1028,17571,3578732955,3578732977,22
3,1028,17572,3578732955,3578732977,22
3,1028,17573,3578732955,3578732979,24
3,1028,17574,3578732955,3578732979,24
3,1028,17575,3578732955,3578732983,28
3,1028,17576,3578732955,3578732983,28
3,1028,17577,3578732955,3578732984,29
3,1028,17578,3578732955,3578732986,31
3,1028,17579,3578732955,3578732986,31
3,1028,17580,3578732955,3578732986,31
3,1028,17581,3578732955,3578732987,32
3,1028,17582,3578732955,3578732987,32
3,1028,17583,3578732955,3578732990,35
3,1028,17584,3578732955,3578732990,35
3,1028,17585,3578732955,3578732990,35
3,1028,17586,3578732955,3578732991,36
3,1028,17587,3578732955,3578732993,38
3,1028,17588,3578732955,3578732993,38
3,1028,17589,3578732955,3578732997,42
3,1028,17590,3578732955,3578732998,43
3,1028,17591,3578732955,3578733001,46
3,1028,17592,3578732955,3578733002,47
3,1028,17593,3578732955,3578733003,48
3,1028,17594,3578732955,3578733003,48
3,1028,17595,3578732955,3578733003,48
3,1028,17596,3578732955,3578733004,49
3,1029,17597,3578733015,3578733015,0
3,1029,17598,3578733015,3578733015,0
3,1029,17599,3578733015,3578733015,0
3,1029,17600,3578733015,3578733015,0
3,1029,17601,3578733015,3578733015,0
3,1029,17602,3578733015,3578733015,0
3,1029,17603,3578733015,3578733015,0
3,1029,17604,3578733015,3578733015,0
3,1029,17605,3578733015,3578733015,0
3,1029,17606,3578733015,3578733015,0
3,1029,17607,3578733015,3578733015,0
3,1029,17608,3578733015,3578733015,0
3,1029,17609,3578733015,3578733016,1
3,1029,17610,3578733015,3578733018,3
3,1029,17611,3578733015,3578733019,4
3,1029,17612,3578733015,3578733020,5
3,1029,17613,3578733015,3578733021,6
3,1029,17614,3578733015,3578733023,8
3,1029,17615,3578733015,3578733026,11
3,1029,17616,3578733015,3578733026,11
3,1029,17617,3578733015,3578733027,12
3,1029,17618,3578733015,3578733027,12
3,1029,17619,3578733015,3578733027,12
3,1029,17620,3578733015,3578733027,12
3,1029,17621,3578733015,3578733027,12
3,1029,17622,3578733015,3578733030,15
3,1029,17623,3578733015,3578733032,17
3,1029,17624,3578733015,3578733032,17
3,1029,17625,3578733015,3578733033,18
3,1029,17626,3578733015,3578733034,19
3,1029,17627,3578733015,3578733034,19
3,1029,17628,3578733015,3578733034,19
3,1029,17629,3578733015,3578733036,21
3,1029,17630,3578733015,3578733036,21
3,1029,17631,3578733015,3578733036,21
3,1029,17632,3578733015,3578733036,21
3,1029,17633,3578733015,3578733040,25
3,1029,17634,3578733015,3578733040,25
3,1029,17635,3578733015,3578733040,25
3,1029,17636,3578733015,3578733042,27
3,1029,17637,3578733015,3578733042,27
3,1029,17638,3578733015,3578733043,28
3,1029,17639,3578733015,3578733044,29
3,1029,17640,3578733015,3578733046,31
3,1029,17641,3578733015,3578733047,32
3,1029,17642,3578733015,3578733048,33
3,1029,17643,3578733015,3578733050,35
3,1029,17644,3578733015,3578733050,35
3,1029,17645,3578733015,3578733052,37
3,1029,17646,3578733015,3578733056,41
3,1029,17647,3578733015,3578733058,43
3,1029,17648,3578733015,3578733060,45
3,1030,17649,3578733075,3578733075,0
3,1030,17650,3578733075,3578733075,0
3,1030,17651,3578733075,3578733075,0
3,1030,17652,3578733075,3578733075,0
3,1030,17653,3578733075,3578733075,0
3,1030,17654,3578733075,3578733075,0
3,1030,17655,3578733075,3578733075,0
3,1030,17656,3578733075,3578733075,0
3,1030,17657,3578733075,3578733075,0
3,1030,17658,3578733075,3578733075,0
3,1030,17659,3578733075,3578733076,1
3,1030,17660,3578733075,3578733078,3
3,1030,17661,3578733075,3578733079,4
3,1030,17662,3578733075,3578733080,5
3,1030,17663,3578733075,3578733081,6
3,1030,17664,3578733075,3578733082,7
3,1030,17665,3578733075,3578733082,7
3,1030,17666,3578733075,3578733082,7
3,1030,17667,3578733075,3578733086,11
3,1030,17668,3578733075,3578733086,11
3,1030,17669,3578733075,3578733087,12
3,1030,17670,3578733075,3578733088,13
3,1030,17671,3578733075,3578733089,14
3,1030,17672,3578733075,3578733089,14
3,1030,17673,3578733075,3578733090,15
3,1030,17674,3578733075,3578733093,18
3,1030,17675,3578733075,3578733094,19
3,1030,17676,3578733075,3578733095,20
3,1030,17677,3578733075,3578733095,20
3,1030,17678,3578733075,3578733096,21
3,1030,17679,3578733075,3578733099,24
3,1030,17680,3578733075,3578733100,25
3,1030,17681,3578733075,3578733100,25
3,1030,17682,3578733075,3578733102,27
3,1030,17683,3578733075,3578733103,28
3,1030,17684,3578733075,3578733106,31
3,1030,17685,3578733075,3578733107,32
3,1030,17686,3578733075,3578733109,34
3,1030,17687,3578733075,3578733110,35
3,1030,17688,3578733075,3578733110,35
3,1030,17689,3578733075,3578733115,40
3,1030,17690,3578733075,3578733115,40
3,1030,17691,3578733075,3578733115,40
3,1030,17692,3578733075,3578733117,42
3,1030,17693,3578733075,3578733120,45
3,1030,17694,3578733075,3578733120,45
3,1030,17695,3578733075,3578733121,46
3,1030,17696,3578733075,3578733122,47
3,1031,17697,3578733136,3578733136,0
3,1031,17698,3578733136,3578733136,0
3,1031,17699,3578733136,3578733136,0
3,1031,17700,3578733136,3578733136,0
3,1031,17701,3578733136,3578733138,2
3,1031,17702,3578733136,3578733138,2
3,1031,17703,3578733136,3578733138,2
3,1031,17704,3578733136,3578733139,3
3,1031,17705,3578733136,3578733141,5
3,1031,17706,3578733136,3578733142,6
3,1031,17707,3578733136,3578733143,7
3,1031,17708,3578733136,3578733143,7
3,1031,17709,3578733136,3578733145,9
3,1031,17710,3578733136,3578733146,10
3,1031,17711,3578733136,3578733149,13
3,1031,17712,3578733136,3578733150,14
3,1031,17713,3578733136,3578733150,14
3,1031,17714,3578733136,3578733151,15
3,1031,17715,3578733136,3578733151,15
3,1031,17716,3578733136,3578733152,16
3,1031,17717,3578733136,3578733153,17
3,1031,17718,3578733136,3578733155,19
3,1031,17719,3578733136,3578733155,19
3,1031,17720,3578733136,3578733156,20
3,1031,17721,3578733136,3578733156,20
3,1031,17722,3578733136,3578733157,21
3,1031,17723,3578733136,3578733157,21
3,1031,17724,3578733136,3578733158,22
3,1031,17725,3578733136,3578733158,22
3,1031,17726,3578733136,3578733159,23
3,1031,17727,3578733136,3578733160,24
3,1031,17728,3578733136,3578733163,27
3,1031,17729,3578733136,3578733166,30
3,1031,17730,3578733136,3578733167,31
3,1031,17731,3578733136,3578733167,31
3,1031,17732,3578733136,3578733167,31
3,1031,17733,3578733136,3578733168,32
3,1031,17734,3578733136,3578733169,33
3,1031,17735,3578733136,3578733171,35
3,1031,17736,3578733136,3578733171,35
3,1031,17737,3578733136,3578733171,35
3,1031,17738,3578733136,3578733171,35
3,1031,17739,3578733136,3578733172,36
3,1031,17740,3578733136,3578733172,36
3,1031,17741,3578733136,3578733173,37
3,1031,17742,3578733136,3578733174,38
3,1031,17743,3578733136,3578733174,38
3,1031,17744,3578733136,3578733177,41
3,1031,17745,3578733136,3578733177,41
3,1031,17746,3578733136,3578733178,42
3,1031,17747,3578733136,3578733179,43
3,1031,17748,3578733136,3578733180,44
3,1031,17749,3578733136,3578733184,48
3,1031,17750,3578733136,3578733184,48
3,1031,17751,3578733136,3578733185,49
3,1031,17752,3578733136,3578733185,49
3,1031,17753,3578733136,3578733186,50
3,1031,17754,3578733136,3578733186,50
3,1032,17755,3578733195,3578733195,0
3,1032,17756,3578733195,3578733195,0
3,1032,17757,3578733195,3578733195,0
3,1032,17758,3578733195,3578733195,0
3,1032,17759,3578733195,3578733195,0
3,1032,17760,3578733195,3578733195,0
3,1032,17761,3578733195,3578733195,0
3,1032,17762,3578733195,3578733195,0
3,1032,17763,3578733195,3578733195,0
3,1032,17764,3578733195,3578733195,0
3,1032,17765,3578733195,3578733197,2
3,1032,17766,3578733195,3578733199,4
3,1032,17767,3578733195,3578733202,7
3,1032,17768,3578733195,3578733203,8
3,1032,17769,3578733195,3578733203,8
3,1032,17770,3578733195,3578733204,9
3,1032,17771,3578733195,3578733204,9
3,1032,17772,3578733195,3578733205,10
3,1032,17773,3578733195,3578733205,10
3,1032,17774,3578733195,3578733206,11
3,1032,17775,3578733195,3578733206,11
3,1032,17776,3578733195,3578733208,13
3,1032,17777,3578733195,3578733209,14
3,1032,17778,3578733195,3578733209,14
3,1032,17779,3578733195,3578733209,14
3,1032,17780,3578733195,3578733210,15
3,1032,17781,3578733195,3578733213,18
3,1032,17782,3578733195,3578733214,19
3,1032,17783,3578733195,3578733214,19
3,1032,17784,3578733195,3578733215,20
3,1032,17785,3578733195,3578733215,20
3,1032,17786,3578733195,3578733216,21
3,1032,17787,3578733195,3578733216,21
3,1032,17788,3578733195,3578733219,24
3,1032,17789,3578733195,3578733220,25
3,1032,17790,3578733195,3578733223,28
3,1032,17791,3578733195,3578733226,31
3,1032,17792,3578733195,3578733227,32
3,1032,17793,3578733195,3578733227,32
3,1032,17794,3578733195,3578733227,32
3,1032,17795,3578733195,3578733228,33
3,1032,17796,3578733195,3578733228,33
3,1032,17797,3578733195,3578733228,33
3,1032,17798,3578733195,3578733228,33
3,1032,17799,3578733195,3578733230,35
3,1032,17800,3578733195,3578733232,37
3,1032,17801,3578733195,3578733233,38
3,1032,17802,3578733195,3578733234,39
3,1032,17803,3578733195,3578733234,39
3,1032,17804,3578733195,3578733234,39
3,1032,17805,3578733195,3578733234,39
3,1032,17806,3578733195,3578733235,40
3,1032,17807,3578733195,3578733236,41
3,1032,17808,3578733195,3578733236,41
3,1032,17809,3578733195,3578733236,41
3,1032,17810,3578733195,3578733239,44
3,1032,17811,3578733195,3578733240,45
3,1032,17812,3578733195,3578733240,45
3,1032,17813,3578733195,3578733241,46
3,1032,17814,3578733195,3578733242,47
3,1032,17815,3578733195,3578733242,47
3,1032,17816,3578733195,3578733243,48
3,1032,17817,3578733195,3578733244,49
3,1032,17818,3578733195,3578733245,50
3,1033,17819,3578733252,3578733252,0
3,1033,17820,3578733252,3578733252,0
3,1033,17821,3578733252,3578733252,0
3,1033,17822,3578733252,3578733252,0
3,1033,17823,3578733252,3578733252,0
3,1033,17824,3578733252,3578733252,0
3,1033,17825,3578733252,3578733256,4
3,1033,17826,3578733252,3578733257,5
3,1033,17827,3578733252,3578733261,9
3,1033,17828,3578733252,3578733262,10
3,1033,17829,3578733252,3578733265,13
3,1033,17830,3578733252,3578733265,13
3,1033,17831,3578733252,3578733265,13
3,1033,17832,3578733252,3578733266,14
3,1033,17833,3578733252,3578733266,14
3,1033,17834,3578733252,3578733268,16
3,1033,17835,3578733252,3578733269,17
3,1033,17836,3578733252,3578733269,17
3,1033,17837,3578733252,3578733273,21
3,1033,17838,3578733252,3578733274,22
3,1033,17839,3578733252,3578733275,23
3,1033,17840,3578733252,3578733277,25
3,1033,17841,3578733252,3578733278,26
3,1033,17842,3578733252,3578733279,27
3,1033,17843,3578733252,3578733279,27
3,1033,17844,3578733252,3578733279,27
3,1033,17845,3578733252,3578733280,28
3,1033,17846,3578733252,3578733281,29
3,1033,17847,3578733252,3578733281,29
3,1033,17848,3578733252,3578733282,30
3,1033,17849,3578733252,3578733285,33
3,1033,17850,3578733252,3578733286,34
3,1033,17851,3578733252,3578733286,34
3,1033,17852,3578733252,3578733287,35
3,1033,17853,3578733252,3578733287,35
3,1033,17854,3578733252,3578733289,37
3,1033,17855,3578733252,3578733290,38
3,1033,17856,3578733252,3578733290,38
3,1033,17857,3578733252,3578733293,41
3,1033,17858,3578733252,3578733295,43
3,1033,17859,3578733252,3578733296,44
3,1033,17860,3578733252,3578733297,45
3,1033,17861,3578733252,3578733299,47
3,1033,17862,3578733252,3578733300,48
3,1033,17863,3578733252,3578733300,48
3,1033,17864,3578733252,3578733301,49
3,1034,17865,3578733311,3578733311,0
3,1034,17866,3578733311,3578733311,0
3,1034,17867,3578733311,3578733311,0
3,1034,17868,3578733311,3578733311,0
3,1034,17869,3578733311,3578733311,0
3,1034,17870,3578733311,3578733315,4
3,1034,17871,3578733311,3578733316,5
3,1034,17872,3578733311,3578733316,5
3,1034,17873,3578733311,3578733317,6
3,1034,17874,3578733311,3578733321,10
3,1034,17875,3578733311,3578733323,12
3,1034,17876,3578733311,3578733325,14
3,1034,17877,3578733311,3578733326,15
3,1034,17878,3578733311,3578733331,20
3,1034,17879,3578733311,3578733336,25
3,1034,17880,3578733311,3578733338,27
3,1034,17881,3578733311,3578733339,28
3,1034,17882,3578733311,3578733339,28
3,1034,17883,3578733311,3578733341,30
3,1034,17884,3578733311,3578733342,31
3,1034,17885,3578733311,3578733344,33
3,1034,17886,3578733311,3578733344,33
3,1034,17887,3578733311,3578733344,33
3,1034,17888,3578733311,3578733344,33
3,1034,17889,3578733311,3578733345,34
3,1034,17890,3578733311,3578733349,38
3,1034,17891,3578733311,3578733351,40
3,1034,17892,3578733311,3578733352,41
3,1034,17893,3578733311,3578733352,41
3,1034,17894,3578733311,3578733354,43
3,1034,17895,3578733311,3578733355,44
3,1034,17896,3578733311,3578733355,44
3,1034,17897,3578733311,3578733356,45
3,1034,17898,3578733311,3578733357,46
3,1034,17899,3578733311,3578733357,46
3,1034,17900,3578733311,3578733358,47
3,1034,17901,3578733311,3578733358,47
3,1034,17902,3578733311,3578733358,47
3,1034,17903,3578733311,3578733359,48
3,1035,17904,3578733371,3578733371,0
3,1035,17905,3578733371,3578733371,0
3,1035,17906,3578733371,3578733371,0
3,1035,17907,3578733371,3578733371,0
3,1035,17908,3578733371,3578733371,0
3,1035,17909,3578733371,3578733371,0
3,1035,17910,3578733371,3578733371,0
3,1035,17911,3578733371,3578733371,0
3,1035,17912,3578733371,3578733371,0
3,1035,17913,3578733371,3578733371,0
3,1035,17914,3578733371,3578733372,1
3,1035,17915,3578733371,3578733372,1
3,1035,17916,3578733371,3578733372,1
3,1035,17917,3578733371,3578733373,2
3,1035,17918,3578733371,3578733374,3
3,1035,17919,3578733371,3578733377,6
3,1035,17920,3578733371,3578733377,6
3,1035,17921,3578733371,3578733379,8
3,1035,17922,3578733371,3578733380,9
3,1035,17923,3578733371,3578733383,12
3,1035,17924,3578733371,3578733384,13
3,1035,17925,3578733371,3578733385,14
3,1035,17926,3578733371,3578733386,15
3,1035,17927,3578733371,3578733386,15
3,1035,17928,3578733371,3578733386,15
3,1035,17929,3578733371,3578733387,16
3,1035,17930,3578733371,3578733388,17
3,1035,17931,3578733371,3578733388,17
3,1035,17932,3578733371,3578733389,18
3,1035,17933,3578733371,3578733389,18
3,1035,17934,3578733371,3578733390,19
3,1035,17935,3578733371,3578733390,19
3,1035,17936,3578733371,3578733390,19
3,1035,17937,3578733371,3578733391,20
3,1035,17938,3578733371,3578733393,22
3,1035,17939,3578733371,3578733393,22
3,1035,17940,3578733371,3578733397,26
3,1035,17941,3578733371,3578733399,28
3,1035,17942,3578733371,3578733402,31
3,1035,17943,3578733371,3578733404,33
3,1035,17944,3578733371,3578733404,33
3,1035,17945,3578733371,3578733404,33
3,1035,17946,3578733371,3578733405,34
3,1035,17947,3578733371,3578733405,34
3,1035,17948,3578733371,3578733406,35
3,1035,17949,3578733371,3578733406,35
3,1035,17950,3578733371,3578733408,37
3,1035,17951,3578733371,3578733409,38
3,1035,17952,3578733371,3578733409,38
3,1035,17953,3578733371,3578733409,38
3,1035,17954,3578733371,3578733410,39
3,1035,17955,3578733371,3578733412,41
3,1035,17956,3578733371,3578733414,43
3,1035,17957,3578733371,3578733415,44
3,1035,17958,3578733371,3578733415,44
3,1035,17959,3578733371,3578733416,45
3,1035,17960,3578733371,3578733416,45
3,1035,17961,3578733371,3578733416,45
3,1035,17962,3578733371,3578733417,46
3,1035,17963,3578733371,3578733419,48
3,1035,17964,3578733371,3578733419,48
3,1035,17965,3578733371,3578733420,49
3,1035,17966,3578733371,3578733421,50
3,1036,17967,3578733431,3578733431,0
3,1036,17968,3578733431,3578733431,0
3,1036,17969,3578733431,3578733431,0
3,1036,17970,3578733431,3578733431,0
3,1036,17971,3578733431,3578733431,0
3,1036,17972,3578733431,3578733431,0
3,1036,17973,3578733431,3578733431,0
3,1036,17974,3578733431,3578733431,0
3,1036,17975,3578733431,3578733431,0
3,1036,17976,3578733431,3578733431,0
3,1036,17977,3578733431,3578733432,1
3,1036,17978,3578733431,3578733433,2
3,1036,17979,3578733431,3578733434,3
3,1036,17980,3578733431,3578733434,3
3,1036,17981,3578733431,3578733434,3
3,1036,17982,3578733431,3578733435,4
3,1036,17983,3578733431,3578733436,5
3,1036,17984,3578733431,3578733436,5
3,1036,17985,3578733431,3578733436,5
3,1036,17986,3578733431,3578733436,5
3,1036,17987,3578733431,3578733438,7
3,1036,17988,3578733431,3578733440,9
3,1036,17989,3578733431,3578733440,9
3,1036,17990,3578733431,3578733440,9
3,1036,17991,3578733431,3578733441,10
3,1036,17992,3578733431,3578733441,10
3,1036,17993,3578733431,3578733442,11
3,1036,17994,3578733431,3578733443,12
3,1036,17995,3578733431,3578733443,12
3,1036,17996,3578733431,3578733444,13
3,1036,17997,3578733431,3578733447,16
3,1036,17998,3578733431,3578733447,16
3,1036,17999,3578733431,3578733449,18
3,1036,18000,3578733431,3578733450,19
3,1036,18001,3578733431,3578733451,20
3,1036,18002,3578733431,3578733453,22
3,1036,18003,3578733431,3578733456,25
3,1036,18004,3578733431,3578733458,27
3,1036,18005,3578733431,3578733458,27
3,1036,18006,3578733431,3578733461,30
3,1036,18007,3578733431,3578733465,34
3,1036,18008,3578733431,3578733465,34
3,1036,18009,3578733431,3578733466,35
3,1036,18010,3578733431,3578733466,35
3,1036,18011,3578733431,3578733466,35
3,1036,18012,3578733431,3578733468,37
3,1036,18013,3578733431,3578733470,39
3,1036,18014,3578733431,3578733470,39
3,1036,18015,3578733431,3578733473,42
3,1036,18016,3578733431,3578733475,44
3,1036,18017,3578733431,3578733476,45
3,1036,18018,3578733431,3578733478,47
3,1036,18019,3578733431,3578733478,47
3,1036,18020,3578733431,3578733479,48
3,1036,18021,3578733431,3578733480,49
3,1036,18022,3578733431,3578733480,49
3,1036,18023,3578733431,3578733481,50
3,1037,18024,3578733492,3578733492,0
3,1037,18025,3578733492,3578733492,0
3,1037,18026,3578733492,3578733492,0
3,1037,18027,3578733492,3578733492,0
3,1037,18028,3578733492,3578733492,0
3,1037,18029,3578733492,3578733492,0
3,1037,18030,3578733492,3578733492,0
3,1037,18031,3578733492,3578733492,0
3,1037,18032,3578733492,3578733492,0
3,1037,18033,3578733492,3578733492,0
3,1037,18034,3578733492,3578733492,0
3,1037,18035,3578733492,3578733493,1
3,1037,18036,3578733492,3578733494,2
3,1037,18037,3578733492,3578733495,3
3,1037,18038,3578733492,3578733499,7
3,1037,18039,3578733492,3578733499,7
3,1037,18040,3578733492,3578733499,7
3,1037,18041,3578733492,3578733501,9
3,1037,18042,3578733492,3578733503,11
3,1037,18043,3578733492,3578733506,14
3,1037,18044,3578733492,3578733509,17
3,1037,18045,3578733492,3578733510,18
3,1037,18046,3578733492,3578733514,22
3,1037,18047,3578733492,3578733515,23
3,1037,18048,3578733492,3578733515,23
3,1037,18049,3578733492,3578733516,24
3,1037,18050,3578733492,3578733517,25
3,1037,18051,3578733492,3578733519,27
3,1037,18052,3578733492,3578733521,29
3,1037,18053,3578733492,3578733521,29
3,1037,18054,3578733492,3578733521,29
3,1037,18055,3578733492,3578733524,32
3,1037,18056,3578733492,3578733525,33
3,1037,18057,3578733492,3578733531,39
3,1037,18058,3578733492,3578733535,43
3,1037,18059,3578733492,3578733538,46
3,1037,18060,3578733492,3578733539,47
3,1037,18061,3578733492,3578733540,48
3,1038,18062,3578733551,3578733551,0
3,1038,18063,3578733551,3578733551,0
3,1038,18064,3578733551,3578733551,0
3,1038,18065,3578733551,3578733551,0
3,1038,18066,3578733551,3578733551,0
3,1038,18067,3578733551,3578733551,0
3,1038,18068,3578733551,3578733551,0
3,1038,18069,3578733551,3578733551,0
3,1038,18070,3578733551,3578733553,2
3,1038,18071,3578733551,3578733554,3
3,1038,18072,3578733551,3578733555,4
3,1038,18073,3578733551,3578733555,4
3,1038,18074,3578733551,3578733556,5
3,1038,18075,3578733551,3578733557,6
3,1038,18076,3578733551,3578733557,6
3,1038,18077,3578733551,3578733557,6
3,1038,18078,3578733551,3578733558,7
3,1038,18079,3578733551,3578733558,7
3,1038,18080,3578733551,3578733559,8
3,1038,18081,3578733551,3578733563,12
3,1038,18082,3578733551,3578733564,13
3,1038,18083,3578733551,3578733565,14
3,1038,18084,3578733551,3578733566,15
3,1038,18085,3578733551,3578733567,16
3,1038,18086,3578733551,3578733568,17
3,1038,18087,3578733551,3578733568,17
3,1038,18088,3578733551,3578733569,18
3,1038,18089,3578733551,3578733570,19
3,1038,18090,3578733551,3578733571,20
3,1038,18091,3578733551,3578733571,20
3,1038,18092,3578733551,3578733571,20
3,1038,18093,3578733551,3578733571,20
3,1038,18094,3578733551,3578733573,22
3,1038,18095,3578733551,3578733577,26
3,1038,18096,3578733551,3578733577,26
3,1038,18097,3578733551,3578733578,27
3,1038,18098,3578733551,3578733579,28
3,1038,18099,3578733551,3578733582,31
3,1038,18100,3578733551,3578733584,33
3,1038,18101,3578733551,3578733585,34
3,1038,18102,3578733551,3578733585,34
3,1038,18103,3578733551,3578733585,34
3,1038,18104,3578733551,3578733586,35
3,1038,18105,3578733551,3578733587,36
3,1038,18106,3578733551,3578733587,36
3,1038,18107,3578733551,3578733588,37
3,1038,18108,3578733551,3578733588,37
3,1038,18109,3578733551,3578733588,37
3,1038,18110,3578733551,3578733588,37
3,1038,18111,3578733551,3578733590,39
3,1038,18112,3578733551,3578733590,39
3,1038,18113,3578733551,3578733590,39
3,1038,18114,3578733551,3578733592,41
3,1038,18115,3578733551,3578733592,41
3,1038,18116,3578733551,3578733596,45
3,1038,18117,3578733551,3578733599,48
3,1038,18118,3578733551,3578733600,49
3,1039,18119,3578733610,3578733610,0
3,1039,18120,3578733610,3578733610,0
3,1039,18121,3578733610,3578733610,0
3,1039,18122,3578733610,3578733610,0
3,1039,18123,3578733610,3578733610,0
3,1039,18124,3578733610,3578733610,0
3,1039,18125,3578733610,3578733610,0
3,1039,18126,3578733610,3578733610,0
3,1039,18127,3578733610,3578733610,0
3,1039,18128,3578733610,3578733610,0
3,1039,18129,3578733610,3578733610,0
3,1039,18130,3578733610,3578733610,0
3,1039,18131,3578733610,3578733612,2
3,1039,18132,3578733610,3578733613,3
3,1039,18133,3578733610,3578733613,3
3,1039,18134,3578733610,3578733615,5
3,1039,18135,3578733610,3578733615,5
3,1039,18136,3578733610,3578733615,5
3,1039,18137,3578733610,3578733616,6
3,1039,18138,3578733610,3578733616,6
3,1039,18139,3578733610,3578733618,8
3,1039,18140,3578733610,3578733618,8
3,1039,18141,3578733610,3578733619,9
3,1039,18142,3578733610,3578733620,10
3,1039,18143,3578733610,3578733621,11
3,1039,18144,3578733610,3578733621,11
3,1039,18145,3578733610,3578733622,12
3,1039,18146,3578733610,3578733625,15
3,1039,18147,3578733610,3578733626,16
3,1039,18148,3578733610,3578733626,16
3,1039,18149,3578733610,3578733627,17
3,1039,18150,3578733610,3578733628,18
3,1039,18151,3578733610,3578733628,18
3,1039,18152,3578733610,3578733629,19
3,1039,18153,3578733610,3578733630,20
3,1039,18154,3578733610,3578733631,21
3,1039,18155,3578733610,3578733634,24
3,1039,18156,3578733610,3578733634,24
3,1039,18157,3578733610,3578733635,25
3,1039,18158,3578733610,3578733635,25
3,1039,18159,3578733610,3578733635,25
3,1039,18160,3578733610,3578733636,26
3,1039,18161,3578733610,3578733636,26
3,1039,18162,3578733610,3578733637,27
3,1039,18163,3578733610,3578733639,29
3,1039,18164,3578733610,3578733640,30
3,1039,18165,3578733610,3578733640,30
3,1039,18166,3578733610,3578733642,32
3,1039,18167,3578733610,3578733643,33
3,1039,18168,3578733610,3578733643,33
3,1039,18169,3578733610,3578733643,33
3,1039,18170,3578733610,3578733646,36
3,1039,18171,3578733610,3578733646,36
3,1039,18172,3578733610,3578733647,37
3,1039,18173,3578733610,3578733650,40
3,1039,18174,3578733610,3578733650,40
3,1039,18175,3578733610,3578733652,42
3,1039,18176,3578733610,3578733653,43
3,1039,18177,3578733610,3578733655,45
3,1039,18178,3578733610,3578733656,46
3,1039,18179,3578733610,3578733658,48
3,1040,18180,3578733669,3578733669,0
3,1040,18181,3578733669,3578733669,0
3,1040,18182,3578733669,3578733669,0
3,1040,18183,3578733669,3578733669,0
3,1040,18184,3578733669,3578733669,0
3,1040,18185,3578733669,3578733669,0
3,1040,18186,3578733669,3578733669,0
3,1040,18187,3578733669,3578733669,0
3,1040,18188,3578733669,3578733669,0
3,1040,18189,3578733669,3578733674,5
3,1040,18190,3578733669,3578733676,7
3,1040,18191,3578733669,3578733676,7
3,1040,18192,3578733669,3578733678,9
3,1040,18193,3578733669,3578733678,9
3,1040,18194,3578733669,3578733679,10
3,1040,18195,3578733669,3578733680,11
3,1040,18196,3578733669,3578733680,11
3,1040,18197,3578733669,3578733681,12
3,1040,18198,3578733669,3578733682,13
3,1040,18199,3578733669,3578733685,16
3,1040,18200,3578733669,3578733685,16
3,1040,18201,3578733669,3578733686,17
3,1040,18202,3578733669,3578733687,18
3,1040,18203,3578733669,3578733689,20
3,1040,18204,3578733669,3578733690,21
3,1040,18205,3578733669,3578733690,21
3,1040,18206,3578733669,3578733692,23
3,1040,18207,3578733669,3578733695,26
3,1040,18208,3578733669,3578733695,26
3,1040,18209,3578733669,3578733698,29
3,1040,18210,3578733669,3578733699,30
3,1040,18211,3578733669,3578733700,31
3,1040,18212,3578733669,3578733700,31
3,1040,18213,3578733669,3578733703,34
3,1040,18214,3578733669,3578733706,37
3,1040,18215,3578733669,3578733708,39
3,1040,18216,3578733669,3578733709,40
3,1040,18217,3578733669,3578733710,41
3,1040,18218,3578733669,3578733714,45
3,1040,18219,3578733669,3578733715,46
3,1040,18220,3578733669,3578733715,46
3,1040,18221,3578733669,3578733716,47
3,1040,18222,3578733669,3578733717,48
3,1041,18223,3578733727,3578733727,0
3,1041,18224,3578733727,3578733727,0
3,1041,18225,3578733727,3578733727,0
3,1041,18226,3578733727,3578733727,0
3,1041,18227,3578733727,3578733731,4
3,1041,18228,3578733727,3578733731,4
3,1041,18229,3578733727,3578733735,8
3,1041,18230,3578733727,3578733738,11
3,1041,18231,3578733727,3578733738,11
3,1041,18232,3578733727,3578733738,11
3,1041,18233,3578733727,3578733740,13
3,1041,18234,3578733727,3578733740,13
3,1041,18235,3578733727,3578733741,14
3,1041,18236,3578733727,3578733743,16
3,1041,18237,3578733727,3578733743,16
3,1041,18238,3578733727,3578733744,17
3,1041,18239,3578733727,3578733744,17
3,1041,18240,3578733727,3578733746,19
3,1041,18241,3578733727,3578733748,21
3,1041,18242,3578733727,3578733749,22
3,1041,18243,3578733727,3578733750,23
3,1041,18244,3578733727,3578733751,24
3,1041,18245,3578733727,3578733751,24
3,1041,18246,3578733727,3578733752,25
3,1041,18247,3578733727,3578733754,27
3,1041,18248,3578733727,3578733754,27
3,1041,18249,3578733727,3578733755,28
3,1041,18250,3578733727,3578733757,30
3,1041,18251,3578733727,3578733757,30
3,1041,18252,3578733727,3578733757,30
3,1041,18253,3578733727,3578733757,30
3,1041,18254,3578733727,3578733758,31
3,1041,18255,3578733727,3578733759,32
3,1041,18256,3578733727,3578733760,33
3,1041,18257,3578733727,3578733762,35
3,1041,18258,3578733727,3578733766,39
3,1041,18259,3578733727,3578733766,39
3,1041,18260,3578733727,3578733767,40
3,1041,18261,3578733727,3578733769,42
3,1041,18262,3578733727,3578733769,42
3,1041,18263,3578733727,3578733770,43
3,1041,18264,3578733727,3578733771,44
3,1041,18265,3578733727,3578733771,44
3,1041,18266,3578733727,3578733771,44
3,1041,18267,3578733727,3578733771,44
3,1041,18268,3578733727,3578733772,45
3,1041,18269,3578733727,3578733773,46
3,1041,18270,3578733727,3578733773,46
3,1041,18271,3578733727,3578733776,49
3,1041,18272,3578733727,3578733776,49
3,1041,18273,3578733727,3578733777,50
3,1042,18274,3578733790,3578733790,0
3,1042,18275,3578733790,3578733790,0
3,1042,18276,3578733790,3578733790,0
3,1042,18277,3578733790,3578733790,0
3,1042,18278,3578733790,3578733790,0
3,1042,18279,3578733790,3578733790,0
3,1042,18280,3578733790,3578733790,0
3,1042,18281,3578733790,3578733790,0
3,1042,18282,3578733790,3578733790,0
3,1042,18283,3578733790,3578733790,0
3,1042,18284,3578733790,3578733790,0
3,1042,18285,3578733790,3578733790,0
3,1042,18286,3578733790,3578733790,0
3,1042,18287,3578733790,3578733790,0
3,1042,18288,3578733790,3578733790,0
3,1042,18289,3578733790,3578733790,0
3,1042,18290,3578733790,3578733790,0
3,1042,18291,3578733790,3578733791,1
3,1042,18292,3578733790,3578733792,2
3,1042,18293,3578733790,3578733793,3
3,1042,18294,3578733790,3578733797,7
3,1042,18295,3578733790,3578733799,9
3,1042,18296,3578733790,3578733800,10
3,1042,18297,3578733790,3578733803,13
3,1042,18298,3578733790,3578733803,13
3,1042,18299,3578733790,3578733804,14
3,1042,18300,3578733790,3578733804,14
3,1042,18301,3578733790,3578733805,15
3,1042,18302,3578733790,3578733806,16
3,1042,18303,3578733790,3578733806,16
3,1042,18304,3578733790,3578733806,16
3,1042,18305,3578733790,3578733808,18
3,1042,18306,3578733790,3578733808,18
3,1042,18307,3578733790,3578733808,18
3,1042,18308,3578733790,3578733808,18
3,1042,18309,3578733790,3578733809,19
3,1042,18310,3578733790,3578733811,21
3,1042,18311,3578733790,3578733813,23
3,1042,18312,3578733790,3578733814,24
3,1042,18313,3578733790,3578733815,25
3,1042,18314,3578733790,3578733815,25
3,1042,18315,3578733790,3578733815,25
3,1042,18316,3578733790,3578733816,26
3,1042,18317,3578733790,3578733818,28
3,1042,18318,3578733790,3578733818,28
3,1042,18319,3578733790,3578733820,30
3,1042,18320,3578733790,3578733821,31
3,1042,18321,3578733790,3578733821,31
3,1042,18322,3578733790,3578733821,31
3,1042,18323,3578733790,3578733823,33
3,1042,18324,3578733790,3578733826,36
3,1042,18325,3578733790,3578733826,36
3,1042,18326,3578733790,3578733826,36
3,1042,18327,3578733790,3578733827,37
3,1042,18328,3578733790,3578733827,37
3,1042,18329,3578733790,3578733828,38
3,1042,18330,3578733790,3578733828,38
3,1042,18331,3578733790,3578733829,39
3,1042,18332,3578733790,3578733830,40
3,1042,18333,3578733790,3578733831,41
3,1042,18334,3578733790,3578733832,42
3,1042,18335,3578733790,3578733833,43
3,1042,18336,3578733790,3578733834,44
3,1042,18337,3578733790,3578733834,44
3,1042,18338,3578733790,3578733835,45
3,1042,18339,3578733790,3578733836,46
3,1042,18340,3578733790,3578733836,46
3,1042,18341,3578733790,3578733836,46
3,1042,18342,3578733790,3578733837,47
3,1042,18343,3578733790,3578733837,47
3,1042,18344,3578733790,3578733839,49
3,1043,18345,3578733853,3578733853,0
3,1043,18346,3578733853,3578733853,0
3,1043,18347,3578733853,3578733853,0
3,1043,18348,3578733853,3578733853,0
3,1043,18349,3578733853,3578733853,0
3,1043,18350,3578733853,3578733853,0
3,1043,18351,3578733853,3578733853,0
3,1043,18352,3578733853,3578733853,0
3,1043,18353,3578733853,3578733853,0
3,1043,18354,3578733853,3578733853,0
3,1043,18355,3578733853,3578733853,0
3,1043,18356,3578733853,3578733853,0
3,1043,18357,3578733853,3578733853,0
3,1043,18358,3578733853,3578733853,0
3,1043,18359,3578733853,3578733853,0
3,1043,18360,3578733853,3578733857,4
3,1043,18361,3578733853,3578733860,7
3,1043,18362,3578733853,3578733864,11
3,1043,18363,3578733853,3578733865,12
3,1043,18364,3578733853,3578733865,12
3,1043,18365,3578733853,3578733867,14
3,1043,18366,3578733853,3578733867,14
3,1043,18367,3578733853,3578733868,15
3,1043,18368,3578733853,3578733869,16
3,1043,18369,3578733853,3578733874,21
3,1043,18370,3578733853,3578733875,22
3,1043,18371,3578733853,3578733878,25
3,1043,18372,3578733853,3578733879,26
3,1043,18373,3578733853,3578733879,26
3,1043,18374,3578733853,3578733879,26
3,1043,18375,3578733853,3578733880,27
3,1043,18376,3578733853,3578733880,27
3,1043,18377,3578733853,3578733882,29
3,1043,18378,3578733853,3578733885,32
3,1043,18379,3578733853,3578733885,32
3,1043,18380,3578733853,3578733886,33
3,1043,18381,3578733853,3578733886,33
3,1043,18382,3578733853,3578733886,33
3,1043,18383,3578733853,3578733887,34
3,1043,18384,3578733853,3578733888,35
3,1043,18385,3578733853,3578733889,36
3,1043,18386,3578733853,3578733890,37
3,1043,18387,3578733853,3578733890,37
3,1043,18388,3578733853,3578733893,40
3,1043,18389,3578733853,3578733895,42
3,1043,18390,3578733853,3578733896,43
3,1043,18391,3578733853,3578733899,46
3,1043,18392,3578733853,3578733899,46
3,1043,18393,3578733853,3578733900,47
3,1043,18394,3578733853,3578733900,47
3,1043,18395,3578733853,3578733903,50
3,1044,18396,3578734010,3578734010,0
3,1044,18397,3578734010,3578734010,0
3,1044,18398,3578734010,3578734010,0
3,1044,18399,3578734010,3578734010,0
3,1044,18400,3578734010,3578734010,0
3,1044,18401,3578734010,3578734010,0
3,1044,18402,3578734010,3578734010,0
3,1044,18403,3578734010,3578734010,0
3,1044,18404,3578734010,3578734010,0
3,1044,18405,3578734010,3578734010,0
3,1044,18406,3578734010,3578734010,0
3,1044,18407,3578734010,3578734010,0
3,1044,18408,3578734010,3578734010,0
3,1044,18409,3578734010,3578734010,0
3,1044,18410,3578734010,3578734010,0
3,1044,18411,3578734010,3578734010,0
3,1044,18412,3578734010,3578734010,0
3,1044,18413,3578734010,3578734010,0
3,1044,18414,3578734010,3578734010,0
3,1044,18415,3578734010,3578734010,0
3,1044,18416,3578734010,3578734011,1
3,1044,18417,3578734010,3578734011,1
3,1044,18418,3578734010,3578734011,1
3,1044,18419,3578734010,3578734011,1
3,1044,18420,3578734010,3578734011,1
3,1044,18421,3578734010,3578734011,1
3,1044,18422,3578734010,3578734011,1
3,1044,18423,3578734010,3578734011,1
3,1044,18424,3578734010,3578734011,1
3,1044,18425,3578734010,3578734011,1
3,1044,18426,3578734010,3578734011,1
3,1044,18427,3578734010,3578734011,1
3,1044,18428,3578734010,3578734011,1
3,1044,18429,3578734010,3578734011,1
3,1044,18430,3578734010,3578734011,1
3,1044,18431,3578734010,3578734011,1
3,1044,18432,3578734010,3578734011,1
3,1044,18433,3578734010,3578734011,1
3,1044,18434,3578734010,3578734011,1
3,1044,18435,3578734010,3578734011,1
3,1044,18436,3578734010,3578734011,1
3,1044,18437,3578734010,3578734011,1
3,1044,18438,3578734010,3578734011,1
3,1044,18439,3578734010,3578734011,1
3,1044,18440,3578734010,3578734011,1
3,1044,18441,3578734010,3578734011,1
3,1044,18442,3578734010,3578734011,1
3,1044,18443,3578734010,3578734011,1
3,1044,18444,3578734010,3578734011,1
3,1044,18445,3578734010,3578734011,1
3,1044,18446,3578734010,3578734011,1
3,1044,18447,3578734010,3578734011,1
3,1044,18448,3578734010,3578734011,1
3,1044,18449,3578734010,3578734011,1
3,1044,18450,3578734010,3578734011,1
3,1044,18451,3578734010,3578734011,1
3,1044,18452,3578734010,3578734011,1
3,1044,18453,3578734010,3578734011,1
3,1044,18454,3578734010,3578734011,1
3,1044,18455,3578734010,3578734011,1
3,1044,18456,3578734010,3578734011,1
3,1044,18457,3578734010,3578734011,1
3,1044,18458,3578734010,3578734011,1
3,1044,18459,3578734010,3578734011,1
3,1044,18460,3578734010,3578734011,1
3,1044,18461,3578734010,3578734011,1
3,1044,18462,3578734010,3578734011,1
3,1044,18463,3578734010,3578734011,1
3,1044,18464,3578734010,3578734011,1
3,1044,18465,3578734010,3578734011,1
3,1044,18466,3578734010,3578734011,1
3,1044,18467,3578734010,3578734011,1
3,1044,18468,3578734010,3578734011,1
3,1044,18469,3578734010,3578734011,1
3,1044,18470,3578734010,3578734011,1
3,1044,18471,3578734010,3578734011,1
3,1044,18472,3578734010,3578734011,1
3,1044,18473,3578734010,3578734011,1
3,1044,18474,3578734010,3578734011,1
3,1044,18475,3578734010,3578734011,1
3,1044,18476,3578734010,3578734011,1
3,1044,18477,3578734010,3578734011,1
3,1044,18478,3578734010,3578734011,1
3,1044,18479,3578734010,3578734011,1
3,1044,18480,3578734010,3578734011,1
3,1044,18481,3578734010,3578734011,1
3,1044,18482,3578734010,3578734011,1
3,1044,18483,3578734010,3578734011,1
3,1044,18484,3578734010,3578734011,1
3,1044,18485,3578734010,3578734011,1
3,1044,18486,3578734010,3578734011,1
3,1044,18487,3578734010,3578734011,1
3,1044,18488,3578734010,3578734011,1
3,1044,18489,3578734010,3578734011,1
3,1044,18490,3578734010,3578734011,1
3,1044,18491,3578734010,3578734011,1
3,1044,18492,3578734010,3578734011,1
3,1044,18493,3578734010,3578734013,3
3,1044,18494,3578734010,3578734013,3
3,1044,18495,3578734010,3578734014,4
3,1044,18496,3578734010,3578734015,5
3,1044,18497,3578734010,3578734016,6
3,1044,18498,3578734010,3578734016,6
3,1044,18499,3578734010,3578734017,7
3,1044,18500,3578734010,3578734018,8
3,1044,18501,3578734010,3578734019,9
3,1044,18502,3578734010,3578734021,11
3,1044,18503,3578734010,3578734021,11
3,1044,18504,3578734010,3578734021,11
3,1044,18505,3578734010,3578734022,12
3,1044,18506,3578734010,3578734022,12
3,1044,18507,3578734010,3578734026,16
3,1044,18508,3578734010,3578734026,16
3,1044,18509,3578734010,3578734027,17
3,1044,18510,3578734010,3578734027,17
3,1044,18511,3578734010,3578734027,17
3,1044,18512,3578734010,3578734028,18
3,1044,18513,3578734010,3578734029,19
3,1044,18514,3578734010,3578734029,19
3,1044,18515,3578734010,3578734031,21
3,1044,18516,3578734010,3578734032,22
3,1044,18517,3578734010,3578734033,23
3,1044,18518,3578734010,3578734034,24
3,1044,18519,3578734010,3578734034,24
3,1044,18520,3578734010,3578734035,25
3,1044,18521,3578734010,3578734036,26
3,1044,18522,3578734010,3578734036,26
3,1044,18523,3578734010,3578734036,26
3,1044,18524,3578734010,3578734037,27
3,1044,18525,3578734010,3578734038,28
3,1044,18526,3578734010,3578734040,30
3,1044,18527,3578734010,3578734040,30
3,1044,18528,3578734010,3578734042,32
3,1044,18529,3578734010,3578734042,32
3,1044,18530,3578734010,3578734043,33
3,1044,18531,3578734010,3578734043,33
3,1044,18532,3578734010,3578734044,34
3,1044,18533,3578734010,3578734044,34
3,1044,18534,3578734010,3578734046,36
3,1044,18535,3578734010,3578734047,37
3,1044,18536,3578734010,3578734050,40
3,1044,18537,3578734010,3578734051,41
3,1044,18538,3578734010,3578734052,42
3,1044,18539,3578734010,3578734053,43
3,1044,18540,3578734010,3578734056,46
3,1044,18541,3578734010,3578734057,47
3,1045,18542,3578734070,3578734070,0
3,1045,18543,3578734070,3578734070,0
3,1045,18544,3578734070,3578734070,0
3,1045,18545,3578734070,3578734070,0
3,1045,18546,3578734070,3578734070,0
3,1045,18547,3578734070,3578734070,0
3,1045,18548,3578734070,3578734070,0
3,1045,18549,3578734070,3578734070,0
3,1045,18550,3578734070,3578734070,0
3,1045,18551,3578734070,3578734070,0
3,1045,18552,3578734070,3578734074,4
3,1045,18553,3578734070,3578734075,5
3,1045,18554,3578734070,3578734076,6
3,1045,18555,3578734070,3578734078,8
3,1045,18556,3578734070,3578734079,9
3,1045,18557,3578734070,3578734079,9
3,1045,18558,3578734070,3578734080,10
3,1045,18559,3578734070,3578734080,10
3,1045,18560,3578734070,3578734081,11
3,1045,18561,3578734070,3578734083,13
3,1045,18562,3578734070,3578734085,15
3,1045,18563,3578734070,3578734086,16
3,1045,18564,3578734070,3578734086,16
3,1045,18565,3578734070,3578734086,16
3,1045,18566,3578734070,3578734087,17
3,1045,18567,3578734070,3578734088,18
3,1045,18568,3578734070,3578734088,18
3,1045,18569,3578734070,3578734089,19
3,1045,18570,3578734070,3578734090,20
3,1045,18571,3578734070,3578734093,23
3,1045,18572,3578734070,3578734095,25
3,1045,18573,3578734070,3578734096,26
3,1045,18574,3578734070,3578734096,26
3,1045,18575,3578734070,3578734099,29
3,1045,18576,3578734070,3578734100,30
3,1045,18577,3578734070,3578734100,30
3,1045,18578,3578734070,3578734101,31
3,1045,18579,3578734070,3578734101,31
3,1045,18580,3578734070,3578734103,33
3,1045,18581,3578734070,3578734106,36
3,1045,18582,3578734070,3578734109,39
3,1045,18583,3578734070,3578734109,39
3,1045,18584,3578734070,3578734111,41
3,1045,18585,3578734070,3578734114,44
3,1045,18586,3578734070,3578734116,46
3,1045,18587,3578734070,3578734117,47
3,1045,18588,3578734070,3578734117,47
3,1046,18589,3578734129,3578734129,0
3,1046,18590,3578734129,3578734129,0
3,1046,18591,3578734129,3578734129,0
3,1046,18592,3578734129,3578734129,0
3,1046,18593,3578734129,3578734129,0
3,1046,18594,3578734129,3578734132,3
3,1046,18595,3578734129,3578734138,9
3,1046,18596,3578734129,3578734139,10
3,1046,18597,3578734129,3578734139,10
3,1046,18598,3578734129,3578734140,11
3,1046,18599,3578734129,3578734140,11
3,1046,18600,3578734129,3578734141,12
3,1046,18601,3578734129,3578734143,14
3,1046,18602,3578734129,3578734144,15
3,1046,18603,3578734129,3578734144,15
3,1046,18604,3578734129,3578734146,17
3,1046,18605,3578734129,3578734148,19
3,1046,18606,3578734129,3578734149,20
3,1046,18607,3578734129,3578734149,20
3,1046,18608,3578734129,3578734151,22
3,1046,18609,3578734129,3578734151,22
3,1046,18610,3578734129,3578734153,24
3,1046,18611,3578734129,3578734155,26
3,1046,18612,3578734129,3578734155,26
3,1046,18613,3578734129,3578734156,27
3,1046,18614,3578734129,3578734157,28
3,1046,18615,3578734129,3578734157,28
3,1046,18616,3578734129,3578734158,29
3,1046,18617,3578734129,3578734158,29
3,1046,18618,3578734129,3578734163,34
3,1046,18619,3578734129,3578734166,37
3,1046,18620,3578734129,3578734166,37
3,1046,18621,3578734129,3578734167,38
3,1046,18622,3578734129,3578734167,38
3,1046,18623,3578734129,3578734169,40
3,1046,18624,3578734129,3578734169,40
3,1046,18625,3578734129,3578734170,41
3,1046,18626,3578734129,3578734171,42
3,1046,18627,3578734129,3578734172,43
3,1046,18628,3578734129,3578734172,43
3,1046,18629,3578734129,3578734172,43
3,1046,18630,3578734129,3578734173,44
3,1046,18631,3578734129,3578734173,44
3,1046,18632,3578734129,3578734174,45
3,1046,18633,3578734129,3578734176,47
3,1046,18634,3578734129,3578734176,47
3,1046,18635,3578734129,3578734178,49
3,1047,18636,3578734187,3578734187,0
3,1047,18637,3578734187,3578734187,0
3,1047,18638,3578734187,3578734187,0
3,1047,18639,3578734187,3578734187,0
3,1047,18640,3578734187,3578734187,0
3,1047,18641,3578734187,3578734187,0
3,1047,18642,3578734187,3578734187,0
3,1047,18643,3578734187,3578734188,1
3,1047,18644,3578734187,3578734188,1
3,1047,18645,3578734187,3578734188,1
3,1047,18646,3578734187,3578734188,1
3,1047,18647,3578734187,3578734189,2
3,1047,18648,3578734187,3578734189,2
3,1047,18649,3578734187,3578734189,2
3,1047,18650,3578734187,3578734192,5
3,1047,18651,3578734187,3578734192,5
3,1047,18652,3578734187,3578734192,5
3,1047,18653,3578734187,3578734193,6
3,1047,18654,3578734187,3578734197,10
3,1047,18655,3578734187,3578734199,12
3,1047,18656,3578734187,3578734203,16
3,1047,18657,3578734187,3578734203,16
3,1047,18658,3578734187,3578734206,19
3,1047,18659,3578734187,3578734207,20
3,1047,18660,3578734187,3578734207,20
3,1047,18661,3578734187,3578734207,20
3,1047,18662,3578734187,3578734208,21
3,1047,18663,3578734187,3578734208,21
3,1047,18664,3578734187,3578734211,24
3,1047,18665,3578734187,3578734213,26
3,1047,18666,3578734187,3578734214,27
3,1047,18667,3578734187,3578734216,29
3,1047,18668,3578734187,3578734216,29
3,1047,18669,3578734187,3578734217,30
3,1047,18670,3578734187,3578734218,31
3,1047,18671,3578734187,3578734219,32
3,1047,18672,3578734187,3578734221,34
3,1047,18673,3578734187,3578734221,34
3,1047,18674,3578734187,3578734221,34
3,1047,18675,3578734187,3578734221,34
3,1047,18676,3578734187,3578734224,37
3,1047,18677,3578734187,3578734226,39
3,1047,18678,3578734187,3578734227,40
3,1047,18679,3578734187,3578734227,40
3,1047,18680,3578734187,3578734227,40
3,1047,18681,3578734187,3578734227,40
3,1047,18682,3578734187,3578734228,41
3,1047,18683,3578734187,3578734229,42
3,1047,18684,3578734187,3578734230,43
3,1047,18685,3578734187,3578734233,46
3,1047,18686,3578734187,3578734233,46
3,1047,18687,3578734187,3578734233,46
3,1047,18688,3578734187,3578734233,46
3,1047,18689,3578734187,3578734235,48
3,1047,18690,3578734187,3578734236,49
3,1047,18691,3578734187,3578734236,49
3,1047,18692,3578734187,3578734237,50
3,1048,18693,3578734245,3578734245,0
3,1048,18694,3578734245,3578734245,0
3,1048,18695,3578734245,3578734245,0
3,1048,18696,3578734245,3578734245,0
3,1048,18697,3578734245,3578734245,0
3,1048,18698,3578734245,3578734245,0
3,1048,18699,3578734245,3578734245,0
3,1048,18700,3578734245,3578734245,0
3,1048,18701,3578734245,3578734245,0
3,1048,18702,3578734245,3578734245,0
3,1048,18703,3578734245,3578734245,0
3,1048,18704,3578734245,3578734246,1
3,1048,18705,3578734245,3578734247,2
3,1048,18706,3578734245,3578734248,3
3,1048,18707,3578734245,3578734250,5
3,1048,18708,3578734245,3578734251,6
3,1048,18709,3578734245,3578734251,6
3,1048,18710,3578734245,3578734254,9
3,1048,18711,3578734245,3578734257,12
3,1048,18712,3578734245,3578734257,12
3,1048,18713,3578734245,3578734257,12
3,1048,18714,3578734245,3578734261,16
3,1048,18715,3578734245,3578734262,17
3,1048,18716,3578734245,3578734264,19
3,1048,18717,3578734245,3578734265,20
3,1048,18718,3578734245,3578734265,20
3,1048,18719,3578734245,3578734266,21
3,1048,18720,3578734245,3578734268,23
3,1048,18721,3578734245,3578734268,23
3,1048,18722,3578734245,3578734269,24
3,1048,18723,3578734245,3578734274,29
3,1048,18724,3578734245,3578734275,30
3,1048,18725,3578734245,3578734277,32
3,1048,18726,3578734245,3578734278,33
3,1048,18727,3578734245,3578734279,34
3,1048,18728,3578734245,3578734279,34
3,1048,18729,3578734245,3578734280,35
3,1048,18730,3578734245,3578734280,35
3,1048,18731,3578734245,3578734282,37
3,1048,18732,3578734245,3578734282,37
3,1048,18733,3578734245,3578734286,41
3,1048,18734,3578734245,3578734286,41
3,1048,18735,3578734245,3578734286,41
3,1048,18736,3578734245,3578734286,41
3,1048,18737,3578734245,3578734288,43
3,1048,18738,3578734245,3578734288,43
3,1048,18739,3578734245,3578734289,44
3,1048,18740,3578734245,3578734290,45
3,1048,18741,3578734245,3578734290,45
3,1048,18742,3578734245,3578734293,48
3,1049,18743,3578734305,3578734305,0
3,1049,18744,3578734305,3578734305,0
3,1049,18745,3578734305,3578734305,0
3,1049,18746,3578734305,3578734305,0
3,1049,18747,3578734305,3578734305,0
3,1049,18748,3578734305,3578734305,0
3,1049,18749,3578734305,3578734305,0
3,1049,18750,3578734305,3578734307,2
3,1049,18751,3578734305,3578734308,3
3,1049,18752,3578734305,3578734310,5
3,1049,18753,3578734305,3578734312,7
3,1049,18754,3578734305,3578734315,10
3,1049,18755,3578734305,3578734315,10
3,1049,18756,3578734305,3578734316,11
3,1049,18757,3578734305,3578734317,12
3,1049,18758,3578734305,3578734317,12
3,1049,18759,3578734305,3578734321,16
3,1049,18760,3578734305,3578734322,17
3,1049,18761,3578734305,3578734323,18
3,1049,18762,3578734305,3578734324,19
3,1049,18763,3578734305,3578734324,19
3,1049,18764,3578734305,3578734326,21
3,1049,18765,3578734305,3578734327,22
3,1049,18766,3578734305,3578734333,28
3,1049,18767,3578734305,3578734336,31
3,1049,18768,3578734305,3578734338,33
3,1049,18769,3578734305,3578734339,34
3,1049,18770,3578734305,3578734340,35
3,1049,18771,3578734305,3578734340,35
3,1049,18772,3578734305,3578734341,36
3,1049,18773,3578734305,3578734343,38
3,1049,18774,3578734305,3578734344,39
3,1049,18775,3578734305,3578734344,39
3,1049,18776,3578734305,3578734345,40
3,1049,18777,3578734305,3578734348,43
3,1049,18778,3578734305,3578734349,44
3,1049,18779,3578734305,3578734351,46
3,1049,18780,3578734305,3578734351,46
3,1049,18781,3578734305,3578734354,49
3,1049,18782,3578734305,3578734355,50
3,1050,18783,3578734363,3578734363,0
3,1050,18784,3578734363,3578734363,0
3,1050,18785,3578734363,3578734363,0
3,1050,18786,3578734363,3578734363,0
3,1050,18787,3578734363,3578734363,0
3,1050,18788,3578734363,3578734363,0
3,1050,18789,3578734363,3578734363,0
3,1050,18790,3578734363,3578734363,0
3,1050,18791,3578734363,3578734363,0
3,1050,18792,3578734363,3578734366,3
3,1050,18793,3578734363,3578734367,4
3,1050,18794,3578734363,3578734368,5
3,1050,18795,3578734363,3578734368,5
3,1050,18796,3578734363,3578734369,6
3,1050,18797,3578734363,3578734369,6
3,1050,18798,3578734363,3578734370,7
3,1050,18799,3578734363,3578734371,8
3,1050,18800,3578734363,3578734371,8
3,1050,18801,3578734363,3578734371,8
3,1050,18802,3578734363,3578734372,9
3,1050,18803,3578734363,3578734373,10
3,1050,18804,3578734363,3578734373,10
3,1050,18805,3578734363,3578734374,11
3,1050,18806,3578734363,3578734376,13
3,1050,18807,3578734363,3578734377,14
3,1050,18808,3578734363,3578734379,16
3,1050,18809,3578734363,3578734384,21
3,1050,18810,3578734363,3578734384,21
3,1050,18811,3578734363,3578734384,21
3,1050,18812,3578734363,3578734385,22
3,1050,18813,3578734363,3578734386,23
3,1050,18814,3578734363,3578734387,24
3,1050,18815,3578734363,3578734388,25
3,1050,18816,3578734363,3578734388,25
3,1050,18817,3578734363,3578734388,25
3,1050,18818,3578734363,3578734388,25
3,1050,18819,3578734363,3578734389,26
3,1050,18820,3578734363,3578734389,26
3,1050,18821,3578734363,3578734389,26
3,1050,18822,3578734363,3578734389,26
3,1050,18823,3578734363,3578734390,27
3,1050,18824,3578734363,3578734391,28
3,1050,18825,3578734363,3578734391,28
3,1050,18826,3578734363,3578734392,29
3,1050,18827,3578734363,3578734392,29
3,1050,18828,3578734363,3578734393,30
3,1050,18829,3578734363,3578734394,31
3,1050,18830,3578734363,3578734397,34
3,1050,18831,3578734363,3578734397,34
3,1050,18832,3578734363,3578734399,36
3,1050,18833,3578734363,3578734402,39
3,1050,18834,3578734363,3578734404,41
3,1050,18835,3578734363,3578734405,42
3,1050,18836,3578734363,3578734405,42
3,1050,18837,3578734363,3578734406,43
3,1050,18838,3578734363,3578734407,44
3,1050,18839,3578734363,3578734407,44
3,1050,18840,3578734363,3578734407,44
3,1050,18841,3578734363,3578734408,45
3,1050,18842,3578734363,3578734408,45
3,1050,18843,3578734363,3578734408,45
3,1050,18844,3578734363,3578734409,46
3,1050,18845,3578734363,3578734411,48
3,1051,18846,3578734425,3578734425,0
3,1051,18847,3578734425,3578734425,0
3,1051,18848,3578734425,3578734425,0
3,1051,18849,3578734425,3578734425,0
3,1051,18850,3578734425,3578734425,0
3,1051,18851,3578734425,3578734425,0
3,1051,18852,3578734425,3578734425,0
3,1051,18853,3578734425,3578734425,0
3,1051,18854,3578734425,3578734425,0
3,1051,18855,3578734425,3578734425,0
3,1051,18856,3578734425,3578734425,0
3,1051,18857,3578734425,3578734425,0
3,1051,18858,3578734425,3578734425,0
3,1051,18859,3578734425,3578734428,3
3,1051,18860,3578734425,3578734428,3
3,1051,18861,3578734425,3578734428,3
3,1051,18862,3578734425,3578734428,3
3,1051,18863,3578734425,3578734429,4
3,1051,18864,3578734425,3578734430,5
3,1051,18865,3578734425,3578734430,5
3,1051,18866,3578734425,3578734432,7
3,1051,18867,3578734425,3578734433,8
3,1051,18868,3578734425,3578734433,8
3,1051,18869,3578734425,3578734434,9
3,1051,18870,3578734425,3578734435,10
3,1051,18871,3578734425,3578734436,11
3,1051,18872,3578734425,3578734436,11
3,1051,18873,3578734425,3578734437,12
3,1051,18874,3578734425,3578734437,12
3,1051,18875,3578734425,3578734439,14
3,1051,18876,3578734425,3578734440,15
3,1051,18877,3578734425,3578734441,16
3,1051,18878,3578734425,3578734441,16
3,1051,18879,3578734425,3578734441,16
3,1051,18880,3578734425,3578734443,18
3,1051,18881,3578734425,3578734443,18
3,1051,18882,3578734425,3578734444,19
3,1051,18883,3578734425,3578734444,19
3,1051,18884,3578734425,3578734446,21
3,1051,18885,3578734425,3578734447,22
3,1051,18886,3578734425,3578734447,22
3,1051,18887,3578734425,3578734448,23
3,1051,18888,3578734425,3578734451,26
3,1051,18889,3578734425,3578734454,29
3,1051,18890,3578734425,3578734456,31
3,1051,18891,3578734425,3578734458,33
3,1051,18892,3578734425,3578734458,33
3,1051,18893,3578734425,3578734460,35
3,1051,18894,3578734425,3578734464,39
3,1051,18895,3578734425,3578734465,40
3,1051,18896,3578734425,3578734466,41
3,1051,18897,3578734425,3578734466,41
3,1051,18898,3578734425,3578734467,42
3,1051,18899,3578734425,3578734469,44
3,1051,18900,3578734425,3578734471,46
3,1051,18901,3578734425,3578734474,49
3,1052,18902,3578734484,3578734484,0
3,1052,18903,3578734484,3578734484,0
3,1052,18904,3578734484,3578734484,0
3,1052,18905,3578734484,3578734484,0
3,1052,18906,3578734484,3578734484,0
3,1052,18907,3578734484,3578734484,0
3,1052,18908,3578734484,3578734484,0
3,1052,18909,3578734484,3578734484,0
3,1052,18910,3578734484,3578734484,0
3,1052,18911,3578734484,3578734484,0
3,1052,18912,3578734484,3578734485,1
3,1052,18913,3578734484,3578734486,2
3,1052,18914,3578734484,3578734486,2
3,1052,18915,3578734484,3578734487,3
3,1052,18916,3578734484,3578734488,4
3,1052,18917,3578734484,3578734489,5
3,1052,18918,3578734484,3578734490,6
3,1052,18919,3578734484,3578734490,6
3,1052,18920,3578734484,3578734491,7
3,1052,18921,3578734484,3578734492,8
3,1052,18922,3578734484,3578734494,10
3,1052,18923,3578734484,3578734495,11
3,1052,18924,3578734484,3578734496,12
3,1052,18925,3578734484,3578734499,15
3,1052,18926,3578734484,3578734499,15
3,1052,18927,3578734484,3578734500,16
3,1052,18928,3578734484,3578734501,17
3,1052,18929,3578734484,3578734503,19
3,1052,18930,3578734484,3578734505,21
3,1052,18931,3578734484,3578734508,24
3,1052,18932,3578734484,3578734509,25
3,1052,18933,3578734484,3578734512,28
3,1052,18934,3578734484,3578734515,31
3,1052,18935,3578734484,3578734515,31
3,1052,18936,3578734484,3578734515,31
3,1052,18937,3578734484,3578734516,32
3,1052,18938,3578734484,3578734518,34
3,1052,18939,3578734484,3578734519,35
3,1052,18940,3578734484,3578734521,37
3,1052,18941,3578734484,3578734523,39
3,1052,18942,3578734484,3578734524,40
3,1052,18943,3578734484,3578734525,41
3,1052,18944,3578734484,3578734531,47
3,1052,18945,3578734484,3578734533,49
3,1053,18946,3578734543,3578734543,0
3,1053,18947,3578734543,3578734543,0
3,1053,18948,3578734543,3578734543,0
3,1053,18949,3578734543,3578734543,0
3,1053,18950,3578734543,3578734543,0
3,1053,18951,3578734543,3578734543,0
3,1053,18952,3578734543,3578734543,0
3,1053,18953,3578734543,3578734543,0
3,1053,18954,3578734543,3578734543,0
3,1053,18955,3578734543,3578734545,2
3,1053,18956,3578734543,3578734545,2
3,1053,18957,3578734543,3578734548,5
3,1053,18958,3578734543,3578734549,6
3,1053,18959,3578734543,3578734549,6
3,1053,18960,3578734543,3578734549,6
3,1053,18961,3578734543,3578734550,7
3,1053,18962,3578734543,3578734550,7
3,1053,18963,3578734543,3578734551,8
3,1053,18964,3578734543,3578734553,10
3,1053,18965,3578734543,3578734554,11
3,1053,18966,3578734543,3578734555,12
3,1053,18967,3578734543,3578734556,13
3,1053,18968,3578734543,3578734558,15
3,1053,18969,3578734543,3578734558,15
3,1053,18970,3578734543,3578734558,15
3,1053,18971,3578734543,3578734558,15
3,1053,18972,3578734543,3578734559,16
3,1053,18973,3578734543,3578734559,16
3,1053,18974,3578734543,3578734565,22
3,1053,18975,3578734543,3578734566,23
3,1053,18976,3578734543,3578734566,23
3,1053,18977,3578734543,3578734567,24
3,1053,18978,3578734543,3578734568,25
3,1053,18979,3578734543,3578734568,25
3,1053,18980,3578734543,3578734569,26
3,1053,18981,3578734543,3578734569,26
3,1053,18982,3578734543,3578734570,27
3,1053,18983,3578734543,3578734571,28
3,1053,18984,3578734543,3578734572,29
3,1053,18985,3578734543,3578734573,30
3,1053,18986,3578734543,3578734573,30
3,1053,18987,3578734543,3578734573,30
3,1053,18988,3578734543,3578734575,32
3,1053,18989,3578734543,3578734576,33
3,1053,18990,3578734543,3578734578,35
3,1053,18991,3578734543,3578734578,35
3,1053,18992,3578734543,3578734582,39
3,1053,18993,3578734543,3578734583,40
3,1053,18994,3578734543,3578734584,41
3,1053,18995,3578734543,3578734584,41
3,1053,18996,3578734543,3578734584,41
3,1053,18997,3578734543,3578734585,42
3,1053,18998,3578734543,3578734587,44
3,1053,18999,3578734543,3578734587,44
3,1053,19000,3578734543,3578734588,45
3,1053,19001,3578734543,3578734588,45
3,1053,19002,3578734543,3578734588,45
3,1053,19003,3578734543,3578734588,45
3,1053,19004,3578734543,3578734588,45
3,1053,19005,3578734543,3578734588,45
3,1053,19006,3578734543,3578734588,45
3,1053,19007,3578734543,3578734588,45
3,1053,19008,3578734543,3578734590,47
3,1053,19009,3578734543,3578734591,48
3,1053,19010,3578734543,3578734592,49
3,1054,19011,3578734602,3578734602,0
3,1054,19012,3578734602,3578734602,0
3,1054,19013,3578734602,3578734602,0
3,1054,19014,3578734602,3578734602,0
3,1054,19015,3578734602,3578734603,1
3,1054,19016,3578734602,3578734603,1
3,1054,19017,3578734602,3578734604,2
3,1054,19018,3578734602,3578734605,3
3,1054,19019,3578734602,3578734606,4
3,1054,19020,3578734602,3578734607,5
3,1054,19021,3578734602,3578734607,5
3,1054,19022,3578734602,3578734607,5
3,1054,19023,3578734602,3578734607,5
3,1054,19024,3578734602,3578734608,6
3,1054,19025,3578734602,3578734611,9
3,1054,19026,3578734602,3578734612,10
3,1054,19027,3578734602,3578734612,10
3,1054,19028,3578734602,3578734613,11
3,1054,19029,3578734602,3578734614,12
3,1054,19030,3578734602,3578734615,13
3,1054,19031,3578734602,3578734615,13
3,1054,19032,3578734602,3578734616,14
3,1054,19033,3578734602,3578734617,15
3,1054,19034,3578734602,3578734617,15
3,1054,19035,3578734602,3578734617,15
3,1054,19036,3578734602,3578734618,16
3,1054,19037,3578734602,3578734620,18
3,1054,19038,3578734602,3578734620,18
3,1054,19039,3578734602,3578734621,19
3,1054,19040,3578734602,3578734621,19
3,1054,19041,3578734602,3578734624,22
3,1054,19042,3578734602,3578734626,24
3,1054,19043,3578734602,3578734626,24
3,1054,19044,3578734602,3578734626,24
3,1054,19045,3578734602,3578734627,25
3,1054,19046,3578734602,3578734628,26
3,1054,19047,3578734602,3578734628,26
3,1054,19048,3578734602,3578734628,26
3,1054,19049,3578734602,3578734629,27
3,1054,19050,3578734602,3578734629,27
3,1054,19051,3578734602,3578734632,30
3,1054,19052,3578734602,3578734632,30
3,1054,19053,3578734602,3578734633,31
3,1054,19054,3578734602,3578734635,33
3,1054,19055,3578734602,3578734635,33
3,1054,19056,3578734602,3578734636,34
3,1054,19057,3578734602,3578734637,35
3,1054,19058,3578734602,3578734638,36
3,1054,19059,3578734602,3578734639,37
3,1054,19060,3578734602,3578734639,37
3,1054,19061,3578734602,3578734640,38
3,1054,19062,3578734602,3578734640,38
3,1054,19063,3578734602,3578734642,40
3,1054,19064,3578734602,3578734643,41
3,1054,19065,3578734602,3578734643,41
3,1054,19066,3578734602,3578734643,41
3,1054,19067,3578734602,3578734644,42
3,1054,19068,3578734602,3578734646,44
3,1054,19069,3578734602,3578734646,44
3,1054,19070,3578734602,3578734647,45
3,1054,19071,3578734602,3578734647,45
3,1054,19072,3578734602,3578734650,48
3,1054,19073,3578734602,3578734650,48
3,1054,19074,3578734602,3578734650,48
3,1055,19075,3578734663,3578734663,0
3,1055,19076,3578734663,3578734663,0
3,1055,19077,3578734663,3578734663,0
3,1055,19078,3578734663,3578734663,0
3,1055,19079,3578734663,3578734663,0
3,1055,19080,3578734663,3578734664,1
3,1055,19081,3578734663,3578734665,2
3,1055,19082,3578734663,3578734666,3
3,1055,19083,3578734663,3578734667,4
3,1055,19084,3578734663,3578734669,6
3,1055,19085,3578734663,3578734669,6
3,1055,19086,3578734663,3578734674,11
3,1055,19087,3578734663,3578734676,13
3,1055,19088,3578734663,3578734679,16
3,1055,19089,3578734663,3578734679,16
3,1055,19090,3578734663,3578734680,17
3,1055,19091,3578734663,3578734680,17
3,1055,19092,3578734663,3578734682,19
3,1055,19093,3578734663,3578734684,21
3,1055,19094,3578734663,3578734685,22
3,1055,19095,3578734663,3578734686,23
3,1055,19096,3578734663,3578734686,23
3,1055,19097,3578734663,3578734687,24
3,1055,19098,3578734663,3578734687,24
3,1055,19099,3578734663,3578734688,25
3,1055,19100,3578734663,3578734688,25
3,1055,19101,3578734663,3578734689,26
3,1055,19102,3578734663,3578734690,27
3,1055,19103,3578734663,3578734694,31
3,1055,19104,3578734663,3578734695,32
3,1055,19105,3578734663,3578734696,33
3,1055,19106,3578734663,3578734699,36
3,1055,19107,3578734663,3578734700,37
3,1055,19108,3578734663,3578734700,37
3,1055,19109,3578734663,3578734701,38
3,1055,19110,3578734663,3578734701,38
3,1055,19111,3578734663,3578734703,40
3,1055,19112,3578734663,3578734705,42
3,1055,19113,3578734663,3578734707,44
3,1055,19114,3578734663,3578734708,45
3,1055,19115,3578734663,3578734709,46
3,1055,19116,3578734663,3578734713,50
3,1056,19117,3578734724,3578734724,0
3,1056,19118,3578734724,3578734724,0
3,1056,19119,3578734724,3578734724,0
3,1056,19120,3578734724,3578734724,0
3,1056,19121,3578734724,3578734724,0
3,1056,19122,3578734724,3578734724,0
3,1056,19123,3578734724,3578734724,0
3,1056,19124,3578734724,3578734724,0
3,1056,19125,3578734724,3578734725,1
3,1056,19126,3578734724,3578734731,7
3,1056,19127,3578734724,3578734734,10
3,1056,19128,3578734724,3578734737,13
3,1056,19129,3578734724,3578734737,13
3,1056,19130,3578734724,3578734738,14
3,1056,19131,3578734724,3578734739,15
3,1056,19132,3578734724,3578734739,15
3,1056,19133,3578734724,3578734740,16
3,1056,19134,3578734724,3578734740,16
3,1056,19135,3578734724,3578734742,18
3,1056,19136,3578734724,3578734743,19
3,1056,19137,3578734724,3578734745,21
3,1056,19138,3578734724,3578734748,24
3,1056,19139,3578734724,3578734749,25
3,1056,19140,3578734724,3578734750,26
3,1056,19141,3578734724,3578734750,26
3,1056,19142,3578734724,3578734750,26
3,1056,19143,3578734724,3578734752,28
3,1056,19144,3578734724,3578734753,29
3,1056,19145,3578734724,3578734755,31
3,1056,19146,3578734724,3578734757,33
3,1056,19147,3578734724,3578734757,33
3,1056,19148,3578734724,3578734758,34
3,1056,19149,3578734724,3578734758,34
3,1056,19150,3578734724,3578734760,36
3,1056,19151,3578734724,3578734760,36
3,1056,19152,3578734724,3578734765,41
3,1056,19153,3578734724,3578734766,42
3,1056,19154,3578734724,3578734767,43
3,1056,19155,3578734724,3578734768,44
3,1056,19156,3578734724,3578734768,44
3,1056,19157,3578734724,3578734768,44
3,1056,19158,3578734724,3578734768,44
3,1056,19159,3578734724,3578734770,46
3,1056,19160,3578734724,3578734770,46
3,1056,19161,3578734724,3578734770,46
3,1056,19162,3578734724,3578734771,47
3,1056,19163,3578734724,3578734772,48
3,1056,19164,3578734724,3578734773,49
3,1056,19165,3578734724,3578734773,49
3,1057,19166,3578734786,3578734786,0
3,1057,19167,3578734786,3578734786,0
3,1057,19168,3578734786,3578734786,0
3,1057,19169,3578734786,3578734786,0
3,1057,19170,3578734786,3578734786,0
3,1057,19171,3578734786,3578734786,0
3,1057,19172,3578734786,3578734786,0
3,1057,19173,3578734786,3578734786,0
3,1057,19174,3578734786,3578734786,0
3,1057,19175,3578734786,3578734787,1
3,1057,19176,3578734786,3578734787,1
3,1057,19177,3578734786,3578734787,1
3,1057,19178,3578734786,3578734788,2
3,1057,19179,3578734786,3578734788,2
3,1057,19180,3578734786,3578734788,2
3,1057,19181,3578734786,3578734788,2
3,1057,19182,3578734786,3578734789,3
3,1057,19183,3578734786,3578734789,3
3,1057,19184,3578734786,3578734790,4
3,1057,19185,3578734786,3578734790,4
3,1057,19186,3578734786,3578734791,5
3,1057,19187,3578734786,3578734792,6
3,1057,19188,3578734786,3578734795,9
3,1057,19189,3578734786,3578734798,12
3,1057,19190,3578734786,3578734799,13
3,1057,19191,3578734786,3578734804,18
3,1057,19192,3578734786,3578734804,18
3,1057,19193,3578734786,3578734805,19
3,1057,19194,3578734786,3578734806,20
3,1057,19195,3578734786,3578734806,20
3,1057,19196,3578734786,3578734806,20
3,1057,19197,3578734786,3578734807,21
3,1057,19198,3578734786,3578734808,22
3,1057,19199,3578734786,3578734808,22
3,1057,19200,3578734786,3578734808,22
3,1057,19201,3578734786,3578734810,24
3,1057,19202,3578734786,3578734812,26
3,1057,19203,3578734786,3578734813,27
3,1057,19204,3578734786,3578734814,28
3,1057,19205,3578734786,3578734814,28
3,1057,19206,3578734786,3578734814,28
3,1057,19207,3578734786,3578734815,29
3,1057,19208,3578734786,3578734816,30
3,1057,19209,3578734786,3578734817,31
3,1057,19210,3578734786,3578734818,32
3,1057,19211,3578734786,3578734818,32
3,1057,19212,3578734786,3578734819,33
3,1057,19213,3578734786,3578734820,34
3,1057,19214,3578734786,3578734820,34
3,1057,19215,3578734786,3578734821,35
3,1057,19216,3578734786,3578734821,35
3,1057,19217,3578734786,3578734825,39
3,1057,19218,3578734786,3578734826,40
3,1057,19219,3578734786,3578734827,41
3,1057,19220,3578734786,3578734827,41
3,1057,19221,3578734786,3578734827,41
3,1057,19222,3578734786,3578734828,42
3,1057,19223,3578734786,3578734829,43
3,1057,19224,3578734786,3578734830,44
3,1057,19225,3578734786,3578734831,45
3,1057,19226,3578734786,3578734831,45
3,1057,19227,3578734786,3578734833,47
3,1057,19228,3578734786,3578734833,47
3,1057,19229,3578734786,3578734833,47
3,1057,19230,3578734786,3578734835,49
3,1058,19231,3578734844,3578734844,0
3,1058,19232,3578734844,3578734844,0
3,1058,19233,3578734844,3578734844,0
3,1058,19234,3578734844,3578734844,0
3,1058,19235,3578734844,3578734844,0
3,1058,19236,3578734844,3578734844,0
3,1058,19237,3578734844,3578734844,0
3,1058,19238,3578734844,3578734844,0
3,1058,19239,3578734844,3578734844,0
3,1058,19240,3578734844,3578734844,0
3,1058,19241,3578734844,3578734844,0
3,1058,19242,3578734844,3578734844,0
3,1058,19243,3578734844,3578734846,2
3,1058,19244,3578734844,3578734846,2
3,1058,19245,3578734844,3578734847,3
3,1058,19246,3578734844,3578734847,3
3,1058,19247,3578734844,3578734849,5
3,1058,19248,3578734844,3578734850,6
3,1058,19249,3578734844,3578734851,7
3,1058,19250,3578734844,3578734855,11
3,1058,19251,3578734844,3578734855,11
3,1058,19252,3578734844,3578734856,12
3,1058,19253,3578734844,3578734858,14
3,1058,19254,3578734844,3578734860,16
3,1058,19255,3578734844,3578734863,19
3,1058,19256,3578734844,3578734864,20
3,1058,19257,3578734844,3578734864,20
3,1058,19258,3578734844,3578734864,20
3,1058,19259,3578734844,3578734867,23
3,1058,19260,3578734844,3578734867,23
3,1058,19261,3578734844,3578734869,25
3,1058,19262,3578734844,3578734870,26
3,1058,19263,3578734844,3578734874,30
3,1058,19264,3578734844,3578734877,33
3,1058,19265,3578734844,3578734879,35
3,1058,19266,3578734844,3578734879,35
3,1058,19267,3578734844,3578734880,36
3,1058,19268,3578734844,3578734885,41
3,1058,19269,3578734844,3578734885,41
3,1058,19270,3578734844,3578734885,41
3,1058,19271,3578734844,3578734886,42
3,1058,19272,3578734844,3578734886,42
3,1058,19273,3578734844,3578734887,43
3,1058,19274,3578734844,3578734888,44
3,1058,19275,3578734844,3578734889,45
3,1058,19276,3578734844,3578734890,46
3,1058,19277,3578734844,3578734890,46
3,1058,19278,3578734844,3578734892,48
3,1058,19279,3578734844,3578734893,49
3,1059,19280,3578734902,3578734902,0
3,1059,19281,3578734902,3578734902,0
3,1059,19282,3578734902,3578734902,0
3,1059,19283,3578734902,3578734902,0
3,1059,19284,3578734902,3578734902,0
3,1059,19285,3578734902,3578734902,0
3,1059,19286,3578734902,3578734902,0
3,1059,19287,3578734902,3578734903,1
3,1059,19288,3578734902,3578734905,3
3,1059,19289,3578734902,3578734907,5
3,1059,19290,3578734902,3578734908,6
3,1059,19291,3578734902,3578734910,8
3,1059,19292,3578734902,3578734913,11
3,1059,19293,3578734902,3578734915,13
3,1059,19294,3578734902,3578734916,14
3,1059,19295,3578734902,3578734916,14
3,1059,19296,3578734902,3578734917,15
3,1059,19297,3578734902,3578734918,16
3,1059,19298,3578734902,3578734921,19
3,1059,19299,3578734902,3578734922,20
3,1059,19300,3578734902,3578734924,22
3,1059,19301,3578734902,3578734925,23
3,1059,19302,3578734902,3578734926,24
3,1059,19303,3578734902,3578734932,30
3,1059,19304,3578734902,3578734934,32
3,1059,19305,3578734902,3578734937,35
3,1059,19306,3578734902,3578734938,36
3,1059,19307,3578734902,3578734938,36
3,1059,19308,3578734902,3578734939,37
3,1059,19309,3578734902,3578734939,37
3,1059,19310,3578734902,3578734940,38
3,1059,19311,3578734902,3578734941,39
3,1059,19312,3578734902,3578734943,41
3,1059,19313,3578734902,3578734943,41
3,1059,19314,3578734902,3578734945,43
3,1059,19315,3578734902,3578734946,44
3,1059,19316,3578734902,3578734949,47
3,1059,19317,3578734902,3578734949,47
3,1059,19318,3578734902,3578734949,47
3,1059,19319,3578734902,3578734951,49
3,1060,19320,3578734961,3578734961,0
3,1060,19321,3578734961,3578734961,0
3,1060,19322,3578734961,3578734961,0
3,1060,19323,3578734961,3578734961,0
3,1060,19324,3578734961,3578734961,0
3,1060,19325,3578734961,3578734961,0
3,1060,19326,3578734961,3578734961,0
3,1060,19327,3578734961,3578734961,0
3,1060,19328,3578734961,3578734961,0
3,1060,19329,3578734961,3578734964,3
3,1060,19330,3578734961,3578734966,5
3,1060,19331,3578734961,3578734967,6
3,1060,19332,3578734961,3578734968,7
3,1060,19333,3578734961,3578734968,7
3,1060,19334,3578734961,3578734968,7
3,1060,19335,3578734961,3578734968,7
3,1060,19336,3578734961,3578734969,8
3,1060,19337,3578734961,3578734971,10
3,1060,19338,3578734961,3578734971,10
3,1060,19339,3578734961,3578734971,10
3,1060,19340,3578734961,3578734973,12
3,1060,19341,3578734961,3578734973,12
3,1060,19342,3578734961,3578734974,13
3,1060,19343,3578734961,3578734975,14
3,1060,19344,3578734961,3578734976,15
3,1060,19345,3578734961,3578734978,17
3,1060,19346,3578734961,3578734979,18
3,1060,19347,3578734961,3578734984,23
3,1060,19348,3578734961,3578734985,24
3,1060,19349,3578734961,3578734985,24
3,1060,19350,3578734961,3578734985,24
3,1060,19351,3578734961,3578734986,25
3,1060,19352,3578734961,3578734987,26
3,1060,19353,3578734961,3578734988,27
3,1060,19354,3578734961,3578734988,27
3,1060,19355,3578734961,3578734988,27
3,1060,19356,3578734961,3578734988,27
3,1060,19357,3578734961,3578734989,28
3,1060,19358,3578734961,3578734989,28
3,1060,19359,3578734961,3578734989,28
3,1060,19360,3578734961,3578734989,28
3,1060,19361,3578734961,3578734990,29
3,1060,19362,3578734961,3578734991,30
3,1060,19363,3578734961,3578734991,30
3,1060,19364,3578734961,3578734992,31
3,1060,19365,3578734961,3578734992,31
3,1060,19366,3578734961,3578734995,34
3,1060,19367,3578734961,3578734997,36
3,1060,19368,3578734961,3578734998,37
3,1060,19369,3578734961,3578734999,38
3,1060,19370,3578734961,3578735003,42
3,1060,19371,3578734961,3578735004,43
3,1060,19372,3578734961,3578735005,44
3,1060,19373,3578734961,3578735005,44
3,1060,19374,3578734961,3578735006,45
3,1060,19375,3578734961,3578735006,45
3,1060,19376,3578734961,3578735007,46
3,1060,19377,3578734961,3578735008,47
3,1060,19378,3578734961,3578735008,47
3,1060,19379,3578734961,3578735009,48
3,1060,19380,3578734961,3578735010,49
3,1061,19381,3578735022,3578735022,0
3,1061,19382,3578735022,3578735022,0
3,1061,19383,3578735022,3578735022,0
3,1061,19384,3578735022,3578735022,0
3,1061,19385,3578735022,3578735022,0
3,1061,19386,3578735022,3578735022,0
3,1061,19387,3578735022,3578735022,0
3,1061,19388,3578735022,3578735022,0
3,1061,19389,3578735022,3578735022,0
3,1061,19390,3578735022,3578735022,0
3,1061,19391,3578735022,3578735022,0
3,1061,19392,3578735022,3578735026,4
3,1061,19393,3578735022,3578735026,4
3,1061,19394,3578735022,3578735027,5
3,1061,19395,3578735022,3578735027,5
3,1061,19396,3578735022,3578735028,6
3,1061,19397,3578735022,3578735029,7
3,1061,19398,3578735022,3578735031,9
3,1061,19399,3578735022,3578735031,9
3,1061,19400,3578735022,3578735033,11
3,1061,19401,3578735022,3578735033,11
3,1061,19402,3578735022,3578735034,12
3,1061,19403,3578735022,3578735036,14
3,1061,19404,3578735022,3578735036,14
3,1061,19405,3578735022,3578735037,15
3,1061,19406,3578735022,3578735040,18
3,1061,19407,3578735022,3578735040,18
3,1061,19408,3578735022,3578735040,18
3,1061,19409,3578735022,3578735041,19
3,1061,19410,3578735022,3578735041,19
3,1061,19411,3578735022,3578735041,19
3,1061,19412,3578735022,3578735042,20
3,1061,19413,3578735022,3578735043,21
3,1061,19414,3578735022,3578735043,21
3,1061,19415,3578735022,3578735044,22
3,1061,19416,3578735022,3578735047,25
3,1061,19417,3578735022,3578735047,25
3,1061,19418,3578735022,3578735047,25
3,1061,19419,3578735022,3578735047,25
3,1061,19420,3578735022,3578735049,27
3,1061,19421,3578735022,3578735050,28
3,1061,19422,3578735022,3578735051,29
3,1061,19423,3578735022,3578735055,33
3,1061,19424,3578735022,3578735056,34
3,1061,19425,3578735022,3578735056,34
3,1061,19426,3578735022,3578735058,36
3,1061,19427,3578735022,3578735059,37
3,1061,19428,3578735022,3578735059,37
3,1061,19429,3578735022,3578735061,39
3,1061,19430,3578735022,3578735063,41
3,1061,19431,3578735022,3578735063,41
3,1061,19432,3578735022,3578735064,42
3,1061,19433,3578735022,3578735064,42
3,1061,19434,3578735022,3578735065,43
3,1061,19435,3578735022,3578735066,44
3,1061,19436,3578735022,3578735067,45
3,1061,19437,3578735022,3578735069,47
3,1061,19438,3578735022,3578735070,48
3,1062,19439,3578735086,3578735086,0
3,1062,19440,3578735086,3578735086,0
3,1062,19441,3578735086,3578735086,0
3,1062,19442,3578735086,3578735086,0
3,1062,19443,3578735086,3578735086,0
3,1062,19444,3578735086,3578735086,0
3,1062,19445,3578735086,3578735087,1
3,1062,19446,3578735086,3578735087,1
3,1062,19447,3578735086,3578735087,1
3,1062,19448,3578735086,3578735087,1
3,1062,19449,3578735086,3578735087,1
3,1062,19450,3578735086,3578735087,1
3,1062,19451,3578735086,3578735089,3
3,1062,19452,3578735086,3578735089,3
3,1062,19453,3578735086,3578735089,3
3,1062,19454,3578735086,3578735090,4
3,1062,19455,3578735086,3578735094,8
3,1062,19456,3578735086,3578735095,9
3,1062,19457,3578735086,3578735097,11
3,1062,19458,3578735086,3578735099,13
3,1062,19459,3578735086,3578735100,14
3,1062,19460,3578735086,3578735101,15
3,1062,19461,3578735086,3578735101,15
3,1062,19462,3578735086,3578735102,16
3,1062,19463,3578735086,3578735103,17
3,1062,19464,3578735086,3578735105,19
3,1062,19465,3578735086,3578735108,22
3,1062,19466,3578735086,3578735108,22
3,1062,19467,3578735086,3578735110,24
3,1062,19468,3578735086,3578735113,27
3,1062,19469,3578735086,3578735115,29
3,1062,19470,3578735086,3578735116,30
3,1062,19471,3578735086,3578735116,30
3,1062,19472,3578735086,3578735118,32
3,1062,19473,3578735086,3578735118,32
3,1062,19474,3578735086,3578735122,36
3,1062,19475,3578735086,3578735123,37
3,1062,19476,3578735086,3578735124,38
3,1062,19477,3578735086,3578735125,39
3,1062,19478,3578735086,3578735127,41
3,1062,19479,3578735086,3578735132,46
3,1062,19480,3578735086,3578735133,47
3,1063,19481,3578735147,3578735147,0
3,1063,19482,3578735147,3578735147,0
3,1063,19483,3578735147,3578735147,0
3,1063,19484,3578735147,3578735147,0
3,1063,19485,3578735147,3578735147,0
3,1063,19486,3578735147,3578735147,0
3,1063,19487,3578735147,3578735147,0
3,1063,19488,3578735147,3578735147,0
3,1063,19489,3578735147,3578735147,0
3,1063,19490,3578735147,3578735148,1
3,1063,19491,3578735147,3578735149,2
3,1063,19492,3578735147,3578735150,3
3,1063,19493,3578735147,3578735150,3
3,1063,19494,3578735147,3578735152,5
3,1063,19495,3578735147,3578735155,8
3,1063,19496,3578735147,3578735155,8
3,1063,19497,3578735147,3578735156,9
3,1063,19498,3578735147,3578735157,10
3,1063,19499,3578735147,3578735157,10
3,1063,19500,3578735147,3578735157,10
3,1063,19501,3578735147,3578735158,11
3,1063,19502,3578735147,3578735158,11
3,1063,19503,3578735147,3578735159,12
3,1063,19504,3578735147,3578735160,13
3,1063,19505,3578735147,3578735161,14
3,1063,19506,3578735147,3578735163,16
3,1063,19507,3578735147,3578735167,20
3,1063,19508,3578735147,3578735168,21
3,1063,19509,3578735147,3578735168,21
3,1063,19510,3578735147,3578735169,22
3,1063,19511,3578735147,3578735170,23
3,1063,19512,3578735147,3578735171,24
3,1063,19513,3578735147,3578735171,24
3,1063,19514,3578735147,3578735171,24
3,1063,19515,3578735147,3578735172,25
3,1063,19516,3578735147,3578735174,27
3,1063,19517,3578735147,3578735174,27
3,1063,19518,3578735147,3578735176,29
3,1063,19519,3578735147,3578735176,29
3,1063,19520,3578735147,3578735178,31
3,1063,19521,3578735147,3578735179,32
3,1063,19522,3578735147,3578735185,38
3,1063,19523,3578735147,3578735186,39
3,1063,19524,3578735147,3578735186,39
3,1063,19525,3578735147,3578735186,39
3,1063,19526,3578735147,3578735186,39
3,1063,19527,3578735147,3578735188,41
3,1063,19528,3578735147,3578735188,41
3,1063,19529,3578735147,3578735188,41
3,1063,19530,3578735147,3578735188,41
3,1063,19531,3578735147,3578735188,41
3,1063,19532,3578735147,3578735188,41
3,1063,19533,3578735147,3578735189,42
3,1063,19534,3578735147,3578735189,42
3,1063,19535,3578735147,3578735189,42
3,1063,19536,3578735147,3578735189,42
3,1063,19537,3578735147,3578735191,44
3,1063,19538,3578735147,3578735191,44
3,1063,19539,3578735147,3578735192,45
3,1063,19540,3578735147,3578735195,48
3,1064,19541,3578735207,3578735207,0
3,1064,19542,3578735207,3578735207,0
3,1064,19543,3578735207,3578735207,0
3,1064,19544,3578735207,3578735207,0
3,1064,19545,3578735207,3578735207,0
3,1064,19546,3578735207,3578735207,0
3,1064,19547,3578735207,3578735207,0
3,1064,19548,3578735207,3578735207,0
3,1064,19549,3578735207,3578735207,0
3,1064,19550,3578735207,3578735207,0
3,1064,19551,3578735207,3578735207,0
3,1064,19552,3578735207,3578735208,1
3,1064,19553,3578735207,3578735209,2
3,1064,19554,3578735207,3578735210,3
3,1064,19555,3578735207,3578735211,4
3,1064,19556,3578735207,3578735214,7
3,1064,19557,3578735207,3578735214,7
3,1064,19558,3578735207,3578735216,9
3,1064,19559,3578735207,3578735217,10
3,1064,19560,3578735207,3578735218,11
3,1064,19561,3578735207,3578735219,12
3,1064,19562,3578735207,3578735219,12
3,1064,19563,3578735207,3578735219,12
3,1064,19564,3578735207,3578735221,14
3,1064,19565,3578735207,3578735221,14
3,1064,19566,3578735207,3578735221,14
3,1064,19567,3578735207,3578735225,18
3,1064,19568,3578735207,3578735225,18
3,1064,19569,3578735207,3578735227,20
3,1064,19570,3578735207,3578735227,20
3,1064,19571,3578735207,3578735228,21
3,1064,19572,3578735207,3578735228,21
3,1064,19573,3578735207,3578735228,21
3,1064,19574,3578735207,3578735229,22
3,1064,19575,3578735207,3578735231,24
3,1064,19576,3578735207,3578735232,25
3,1064,19577,3578735207,3578735232,25
3,1064,19578,3578735207,3578735233,26
3,1064,19579,3578735207,3578735233,26
3,1064,19580,3578735207,3578735233,26
3,1064,19581,3578735207,3578735237,30
3,1064,19582,3578735207,3578735237,30
3,1064,19583,3578735207,3578735237,30
3,1064,19584,3578735207,3578735240,33
3,1064,19585,3578735207,3578735241,34
3,1064,19586,3578735207,3578735242,35
3,1064,19587,3578735207,3578735242,35
3,1064,19588,3578735207,3578735242,35
3,1064,19589,3578735207,3578735243,36
3,1064,19590,3578735207,3578735243,36
3,1064,19591,3578735207,3578735244,37
3,1064,19592,3578735207,3578735246,39
3,1064,19593,3578735207,3578735246,39
3,1064,19594,3578735207,3578735247,40
3,1064,19595,3578735207,3578735247,40
3,1064,19596,3578735207,3578735250,43
3,1064,19597,3578735207,3578735251,44
3,1064,19598,3578735207,3578735251,44
3,1064,19599,3578735207,3578735255,48
3,1064,19600,3578735207,3578735255,48
3,1064,19601,3578735207,3578735256,49
3,1065,19602,3578735266,3578735266,0
3,1065,19603,3578735266,3578735266,0
3,1065,19604,3578735266,3578735266,0
3,1065,19605,3578735266,3578735266,0
3,1065,19606,3578735266,3578735266,0
3,1065,19607,3578735266,3578735266,0
3,1065,19608,3578735266,3578735266,0
3,1065,19609,3578735266,3578735266,0
3,1065,19610,3578735266,3578735266,0
3,1065,19611,3578735266,3578735268,2
3,1065,19612,3578735266,3578735270,4
3,1065,19613,3578735266,3578735270,4
3,1065,19614,3578735266,3578735274,8
3,1065,19615,3578735266,3578735275,9
3,1065,19616,3578735266,3578735278,12
3,1065,19617,3578735266,3578735279,13
3,1065,19618,3578735266,3578735280,14
3,1065,19619,3578735266,3578735280,14
3,1065,19620,3578735266,3578735281,15
3,1065,19621,3578735266,3578735284,18
3,1065,19622,3578735266,3578735285,19
3,1065,19623,3578735266,3578735285,19
3,1065,19624,3578735266,3578735286,20
3,1065,19625,3578735266,3578735287,21
3,1065,19626,3578735266,3578735289,23
3,1065,19627,3578735266,3578735290,24
3,1065,19628,3578735266,3578735290,24
3,1065,19629,3578735266,3578735290,24
3,1065,19630,3578735266,3578735292,26
3,1065,19631,3578735266,3578735292,26
3,1065,19632,3578735266,3578735294,28
3,1065,19633,3578735266,3578735295,29
3,1065,19634,3578735266,3578735297,31
3,1065,19635,3578735266,3578735300,34
3,1065,19636,3578735266,3578735300,34
3,1065,19637,3578735266,3578735301,35
3,1065,19638,3578735266,3578735301,35
3,1065,19639,3578735266,3578735302,36
3,1065,19640,3578735266,3578735304,38
3,1065,19641,3578735266,3578735305,39
3,1065,19642,3578735266,3578735308,42
3,1065,19643,3578735266,3578735308,42
3,1065,19644,3578735266,3578735309,43
3,1065,19645,3578735266,3578735313,47
3,1065,19646,3578735266,3578735315,49
3,1065,19647,3578735266,3578735315,49
3,1065,19648,3578735266,3578735316,50
3,1066,19649,3578735326,3578735326,0
3,1066,19650,3578735326,3578735326,0
3,1066,19651,3578735326,3578735326,0
3,1066,19652,3578735326,3578735326,0
3,1066,19653,3578735326,3578735326,0
3,1066,19654,3578735326,3578735327,1
3,1066,19655,3578735326,3578735331,5
3,1066,19656,3578735326,3578735334,8
3,1066,19657,3578735326,3578735338,12
3,1066,19658,3578735326,3578735338,12
3,1066,19659,3578735326,3578735339,13
3,1066,19660,3578735326,3578735339,13
3,1066,19661,3578735326,3578735340,14
3,1066,19662,3578735326,3578735342,16
3,1066,19663,3578735326,3578735343,17
3,1066,19664,3578735326,3578735344,18
3,1066,19665,3578735326,3578735344,18
3,1066,19666,3578735326,3578735348,22
3,1066,19667,3578735326,3578735349,23
3,1066,19668,3578735326,3578735349,23
3,1066,19669,3578735326,3578735350,24
3,1066,19670,3578735326,3578735351,25
3,1066,19671,3578735326,3578735353,27
3,1066,19672,3578735326,3578735356,30
3,1066,19673,3578735326,3578735356,30
3,1066,19674,3578735326,3578735357,31
3,1066,19675,3578735326,3578735357,31
3,1066,19676,3578735326,3578735358,32
3,1066,19677,3578735326,3578735358,32
3,1066,19678,3578735326,3578735359,33
3,1066,19679,3578735326,3578735360,34
3,1066,19680,3578735326,3578735362,36
3,1066,19681,3578735326,3578735366,40
3,1066,19682,3578735326,3578735367,41
3,1066,19683,3578735326,3578735367,41
3,1066,19684,3578735326,3578735369,43
3,1066,19685,3578735326,3578735369,43
3,1066,19686,3578735326,3578735369,43
3,1066,19687,3578735326,3578735369,43
3,1066,19688,3578735326,3578735370,44
3,1066,19689,3578735326,3578735371,45
3,1066,19690,3578735326,3578735371,45
3,1066,19691,3578735326,3578735371,45
3,1066,19692,3578735326,3578735371,45
3,1066,19693,3578735326,3578735373,47
3,1066,19694,3578735326,3578735374,48
3,1066,19695,3578735326,3578735374,48
3,1066,19696,3578735326,3578735374,48
3,1067,19697,3578735386,3578735386,0
3,1067,19698,3578735386,3578735386,0
3,1067,19699,3578735386,3578735386,0
3,1067,19700,3578735386,3578735386,0
3,1067,19701,3578735386,3578735386,0
3,1067,19702,3578735386,3578735386,0
3,1067,19703,3578735386,3578735386,0
3,1067,19704,3578735386,3578735386,0
3,1067,19705,3578735386,3578735386,0
3,1067,19706,3578735386,3578735387,1
3,1067,19707,3578735386,3578735388,2
3,1067,19708,3578735386,3578735388,2
3,1067,19709,3578735386,3578735388,2
3,1067,19710,3578735386,3578735389,3
3,1067,19711,3578735386,3578735389,3
3,1067,19712,3578735386,3578735389,3
3,1067,19713,3578735386,3578735389,3
3,1067,19714,3578735386,3578735391,5
3,1067,19715,3578735386,3578735391,5
3,1067,19716,3578735386,3578735391,5
3,1067,19717,3578735386,3578735392,6
3,1067,19718,3578735386,3578735392,6
3,1067,19719,3578735386,3578735395,9
3,1067,19720,3578735386,3578735400,14
3,1067,19721,3578735386,3578735405,19
3,1067,19722,3578735386,3578735405,19
3,1067,19723,3578735386,3578735406,20
3,1067,19724,3578735386,3578735406,20
3,1067,19725,3578735386,3578735406,20
3,1067,19726,3578735386,3578735407,21
3,1067,19727,3578735386,3578735408,22
3,1067,19728,3578735386,3578735408,22
3,1067,19729,3578735386,3578735408,22
3,1067,19730,3578735386,3578735408,22
3,1067,19731,3578735386,3578735410,24
3,1067,19732,3578735386,3578735414,28
3,1067,19733,3578735386,3578735415,29
3,1067,19734,3578735386,3578735416,30
3,1067,19735,3578735386,3578735418,32
3,1067,19736,3578735386,3578735418,32
3,1067,19737,3578735386,3578735419,33
3,1067,19738,3578735386,3578735419,33
3,1067,19739,3578735386,3578735419,33
3,1067,19740,3578735386,3578735421,35
3,1067,19741,3578735386,3578735421,35
3,1067,19742,3578735386,3578735421,35
3,1067,19743,3578735386,3578735422,36
3,1067,19744,3578735386,3578735426,40
3,1067,19745,3578735386,3578735426,40
3,1067,19746,3578735386,3578735426,40
3,1067,19747,3578735386,3578735428,42
3,1067,19748,3578735386,3578735428,42
3,1067,19749,3578735386,3578735429,43
3,1067,19750,3578735386,3578735430,44
3,1067,19751,3578735386,3578735431,45
3,1067,19752,3578735386,3578735431,45
3,1067,19753,3578735386,3578735432,46
3,1067,19754,3578735386,3578735433,47
3,1067,19755,3578735386,3578735434,48
3,1067,19756,3578735386,3578735434,48
3,1067,19757,3578735386,3578735435,49
3,1067,19758,3578735386,3578735436,50
3,1068,19759,3578735449,3578735449,0
3,1068,19760,3578735449,3578735449,0
3,1068,19761,3578735449,3578735449,0
3,1068,19762,3578735449,3578735449,0
3,1068,19763,3578735449,3578735449,0
3,1068,19764,3578735449,3578735449,0
3,1068,19765,3578735449,3578735449,0
3,1068,19766,3578735449,3578735449,0
3,1068,19767,3578735449,3578735449,0
3,1068,19768,3578735449,3578735449,0
3,1068,19769,3578735449,3578735449,0
3,1068,19770,3578735449,3578735449,0
3,1068,19771,3578735449,3578735449,0
3,1068,19772,3578735449,3578735449,0
3,1068,19773,3578735449,3578735450,1
3,1068,19774,3578735449,3578735451,2
3,1068,19775,3578735449,3578735452,3
3,1068,19776,3578735449,3578735455,6
3,1068,19777,3578735449,3578735456,7
3,1068,19778,3578735449,3578735456,7
3,1068,19779,3578735449,3578735459,10
3,1068,19780,3578735449,3578735459,10
3,1068,19781,3578735449,3578735464,15
3,1068,19782,3578735449,3578735464,15
3,1068,19783,3578735449,3578735465,16
3,1068,19784,3578735449,3578735467,18
3,1068,19785,3578735449,3578735467,18
3,1068,19786,3578735449,3578735469,20
3,1068,19787,3578735449,3578735470,21
3,1068,19788,3578735449,3578735474,25
3,1068,19789,3578735449,3578735479,30
3,1068,19790,3578735449,3578735480,31
3,1068,19791,3578735449,3578735480,31
3,1068,19792,3578735449,3578735480,31
3,1068,19793,3578735449,3578735481,32
3,1068,19794,3578735449,3578735482,33
3,1068,19795,3578735449,3578735485,36
3,1068,19796,3578735449,3578735485,36
3,1068,19797,3578735449,3578735485,36
3,1068,19798,3578735449,3578735487,38
3,1068,19799,3578735449,3578735487,38
3,1068,19800,3578735449,3578735489,40
3,1068,19801,3578735449,3578735490,41
3,1068,19802,3578735449,3578735490,41
3,1068,19803,3578735449,3578735491,42
3,1068,19804,3578735449,3578735492,43
3,1068,19805,3578735449,3578735494,45
3,1068,19806,3578735449,3578735495,46
3,1068,19807,3578735449,3578735496,47
3,1069,19808,3578735511,3578735511,0
3,1069,19809,3578735511,3578735511,0
3,1069,19810,3578735511,3578735511,0
3,1069,19811,3578735511,3578735511,0
3,1069,19812,3578735511,3578735511,0
3,1069,19813,3578735511,3578735511,0
3,1069,19814,3578735511,3578735511,0
3,1069,19815,3578735511,3578735511,0
3,1069,19816,3578735511,3578735511,0
3,1069,19817,3578735511,3578735511,0
3,1069,19818,3578735511,3578735514,3
3,1069,19819,3578735511,3578735514,3
3,1069,19820,3578735511,3578735514,3
3,1069,19821,3578735511,3578735515,4
3,1069,19822,3578735511,3578735517,6
3,1069,19823,3578735511,3578735519,8
3,1069,19824,3578735511,3578735521,10
3,1069,19825,3578735511,3578735523,12
3,1069,19826,3578735511,3578735523,12
3,1069,19827,3578735511,3578735526,15
3,1069,19828,3578735511,3578735527,16
3,1069,19829,3578735511,3578735530,19
3,1069,19830,3578735511,3578735532,21
3,1069,19831,3578735511,3578735533,22
3,1069,19832,3578735511,3578735537,26
3,1069,19833,3578735511,3578735538,27
3,1069,19834,3578735511,3578735538,27
3,1069,19835,3578735511,3578735539,28
3,1069,19836,3578735511,3578735541,30
3,1069,19837,3578735511,3578735542,31
3,1069,19838,3578735511,3578735543,32
3,1069,19839,3578735511,3578735547,36
3,1069,19840,3578735511,3578735549,38
3,1069,19841,3578735511,3578735549,38
3,1069,19842,3578735511,3578735550,39
3,1069,19843,3578735511,3578735550,39
3,1069,19844,3578735511,3578735551,40
3,1069,19845,3578735511,3578735552,41
3,1069,19846,3578735511,3578735555,44
3,1069,19847,3578735511,3578735556,45
3,1069,19848,3578735511,3578735556,45
3,1069,19849,3578735511,3578735557,46
3,1069,19850,3578735511,3578735557,46
3,1069,19851,3578735511,3578735557,46
3,1069,19852,3578735511,3578735558,47
3,1069,19853,3578735511,3578735559,48
3,1069,19854,3578735511,3578735560,49
3,1070,19855,3578735571,3578735571,0
3,1070,19856,3578735571,3578735571,0
3,1070,19857,3578735571,3578735571,0
3,1070,19858,3578735571,3578735571,0
3,1070,19859,3578735571,3578735571,0
3,1070,19860,3578735571,3578735571,0
3,1070,19861,3578735571,3578735571,0
3,1070,19862,3578735571,3578735571,0
3,1070,19863,3578735571,3578735571,0
3,1070,19864,3578735571,3578735571,0
3,1070,19865,3578735571,3578735571,0
3,1070,19866,3578735571,3578735571,0
3,1070,19867,3578735571,3578735571,0
3,1070,19868,3578735571,3578735572,1
3,1070,19869,3578735571,3578735573,2
3,1070,19870,3578735571,3578735574,3
3,1070,19871,3578735571,3578735575,4
3,1070,19872,3578735571,3578735577,6
3,1070,19873,3578735571,3578735577,6
3,1070,19874,3578735571,3578735577,6
3,1070,19875,3578735571,3578735579,8
3,1070,19876,3578735571,3578735584,13
3,1070,19877,3578735571,3578735585,14
3,1070,19878,3578735571,3578735585,14
3,1070,19879,3578735571,3578735586,15
3,1070,19880,3578735571,3578735587,16
3,1070,19881,3578735571,3578735587,16
3,1070,19882,3578735571,3578735587,16
3,1070,19883,3578735571,3578735588,17
3,1070,19884,3578735571,3578735588,17
3,1070,19885,3578735571,3578735588,17
3,1070,19886,3578735571,3578735588,17
3,1070,19887,3578735571,3578735589,18
3,1070,19888,3578735571,3578735590,19
3,1070,19889,3578735571,3578735590,19
3,1070,19890,3578735571,3578735592,21
3,1070,19891,3578735571,3578735594,23
3,1070,19892,3578735571,3578735597,26
3,1070,19893,3578735571,3578735598,27
3,1070,19894,3578735571,3578735599,28
3,1070,19895,3578735571,3578735601,30
3,1070,19896,3578735571,3578735603,32
3,1070,19897,3578735571,3578735604,33
3,1070,19898,3578735571,3578735605,34
3,1070,19899,3578735571,3578735605,34
3,1070,19900,3578735571,3578735605,34
3,1070,19901,3578735571,3578735605,34
3,1070,19902,3578735571,3578735606,35
3,1070,19903,3578735571,3578735607,36
3,1070,19904,3578735571,3578735607,36
3,1070,19905,3578735571,3578735608,37
3,1070,19906,3578735571,3578735608,37
3,1070,19907,3578735571,3578735611,40
3,1070,19908,3578735571,3578735613,42
3,1070,19909,3578735571,3578735614,43
3,1070,19910,3578735571,3578735614,43
3,1070,19911,3578735571,3578735614,43
3,1070,19912,3578735571,3578735615,44
3,1070,19913,3578735571,3578735617,46
3,1070,19914,3578735571,3578735618,47
3,1070,19915,3578735571,3578735618,47
3,1070,19916,3578735571,3578735618,47
3,1070,19917,3578735571,3578735620,49
3,1070,19918,3578735571,3578735620,49
3,1071,19919,3578735630,3578735630,0
3,1071,19920,3578735630,3578735630,0
3,1071,19921,3578735630,3578735630,0
3,1071,19922,3578735630,3578735630,0
3,1071,19923,3578735630,3578735630,0
3,1071,19924,3578735630,3578735630,0
3,1071,19925,3578735630,3578735630,0
3,1071,19926,3578735630,3578735630,0
3,1071,19927,3578735630,3578735631,1
3,1071,19928,3578735630,3578735632,2
3,1071,19929,3578735630,3578735632,2
3,1071,19930,3578735630,3578735633,3
3,1071,19931,3578735630,3578735635,5
3,1071,19932,3578735630,3578735636,6
3,1071,19933,3578735630,3578735637,7
3,1071,19934,3578735630,3578735639,9
3,1071,19935,3578735630,3578735639,9
3,1071,19936,3578735630,3578735640,10
3,1071,19937,3578735630,3578735640,10
3,1071,19938,3578735630,3578735641,11
3,1071,19939,3578735630,3578735642,12
3,1071,19940,3578735630,3578735642,12
3,1071,19941,3578735630,3578735643,13
3,1071,19942,3578735630,3578735643,13
3,1071,19943,3578735630,3578735646,16
3,1071,19944,3578735630,3578735646,16
3,1071,19945,3578735630,3578735646,16
3,1071,19946,3578735630,3578735646,16
3,1071,19947,3578735630,3578735649,19
3,1071,19948,3578735630,3578735650,20
3,1071,19949,3578735630,3578735651,21
3,1071,19950,3578735630,3578735655,25
3,1071,19951,3578735630,3578735655,25
3,1071,19952,3578735630,3578735656,26
3,1071,19953,3578735630,3578735658,28
3,1071,19954,3578735630,3578735658,28
3,1071,19955,3578735630,3578735659,29
3,1071,19956,3578735630,3578735660,30
3,1071,19957,3578735630,3578735663,33
3,1071,19958,3578735630,3578735663,33
3,1071,19959,3578735630,3578735664,34
3,1071,19960,3578735630,3578735664,34
3,1071,19961,3578735630,3578735666,36
3,1071,19962,3578735630,3578735667,37
3,1071,19963,3578735630,3578735669,39
3,1071,19964,3578735630,3578735669,39
3,1071,19965,3578735630,3578735674,44
3,1071,19966,3578735630,3578735676,46
3,1071,19967,3578735630,3578735678,48
3,1071,19968,3578735630,3578735679,49
3,1071,19969,3578735630,3578735680,50
3,1072,19970,3578735688,3578735688,0
3,1072,19971,3578735688,3578735688,0
3,1072,19972,3578735688,3578735688,0
3,1072,19973,3578735688,3578735688,0
3,1072,19974,3578735688,3578735688,0
3,1072,19975,3578735688,3578735688,0
3,1072,19976,3578735688,3578735688,0
3,1072,19977,3578735688,3578735688,0
3,1072,19978,3578735688,3578735689,1
3,1072,19979,3578735688,3578735690,2
3,1072,19980,3578735688,3578735691,3
3,1072,19981,3578735688,3578735692,4
3,1072,19982,3578735688,3578735693,5
3,1072,19983,3578735688,3578735695,7
3,1072,19984,3578735688,3578735696,8
3,1072,19985,3578735688,3578735697,9
3,1072,19986,3578735688,3578735700,12
3,1072,19987,3578735688,3578735700,12
3,1072,19988,3578735688,3578735701,13
3,1072,19989,3578735688,3578735701,13
3,1072,19990,3578735688,3578735701,13
3,1072,19991,3578735688,3578735703,15
3,1072,19992,3578735688,3578735704,16
3,1072,19993,3578735688,3578735707,19
3,1072,19994,3578735688,3578735708,20
3,1072,19995,3578735688,3578735709,21
3,1072,19996,3578735688,3578735714,26
3,1072,19997,3578735688,3578735715,27
3,1072,19998,3578735688,3578735715,27
3,1072,19999,3578735688,3578735715,27
3,1072,20000,3578735688,3578735717,29
3,1072,20001,3578735688,3578735719,31
3,1072,20002,3578735688,3578735720,32
3,1072,20003,3578735688,3578735721,33
3,1072,20004,3578735688,3578735723,35
3,1072,20005,3578735688,3578735726,38
3,1072,20006,3578735688,3578735727,39
3,1072,20007,3578735688,3578735730,42
3,1072,20008,3578735688,3578735731,43
3,1072,20009,3578735688,3578735734,46
3,1072,20010,3578735688,3578735737,49
3,1072,20011,3578735688,3578735738,50
3,1073,20012,3578735748,3578735749,1
3,1073,20013,3578735748,3578735749,1
3,1073,20014,3578735748,3578735749,1
3,1073,20015,3578735748,3578735749,1
3,1073,20016,3578735748,3578735749,1
3,1073,20017,3578735748,3578735749,1
3,1073,20018,3578735748,3578735749,1
3,1073,20019,3578735748,3578735749,1
3,1073,20020,3578735748,3578735749,1
3,1073,20021,3578735748,3578735749,1
3,1073,20022,3578735748,3578735750,2
3,1073,20023,3578735748,3578735751,3
3,1073,20024,3578735748,3578735751,3
3,1073,20025,3578735748,3578735752,4
3,1073,20026,3578735748,3578735754,6
3,1073,20027,3578735748,3578735755,7
3,1073,20028,3578735748,3578735756,8
3,1073,20029,3578735748,3578735757,9
3,1073,20030,3578735748,3578735757,9
3,1073,20031,3578735748,3578735757,9
3,1073,20032,3578735748,3578735757,9
3,1073,20033,3578735748,3578735758,10
3,1073,20034,3578735748,3578735759,11
3,1073,20035,3578735748,3578735760,12
3,1073,20036,3578735748,3578735761,13
3,1073,20037,3578735748,3578735762,14
3,1073,20038,3578735748,3578735765,17
3,1073,20039,3578735748,3578735767,19
3,1073,20040,3578735748,3578735768,20
3,1073,20041,3578735748,3578735768,20
3,1073,20042,3578735748,3578735769,21
3,1073,20043,3578735748,3578735769,21
3,1073,20044,3578735748,3578735769,21
3,1073,20045,3578735748,3578735770,22
3,1073,20046,3578735748,3578735770,22
3,1073,20047,3578735748,3578735770,22
3,1073,20048,3578735748,3578735771,23
3,1073,20049,3578735748,3578735771,23
3,1073,20050,3578735748,3578735773,25
3,1073,20051,3578735748,3578735773,25
3,1073,20052,3578735748,3578735773,25
3,1073,20053,3578735748,3578735775,27
3,1073,20054,3578735748,3578735776,28
3,1073,20055,3578735748,3578735777,29
3,1073,20056,3578735748,3578735777,29
3,1073,20057,3578735748,3578735778,30
3,1073,20058,3578735748,3578735780,32
3,1073,20059,3578735748,3578735784,36
3,1073,20060,3578735748,3578735785,37
3,1073,20061,3578735748,3578735785,37
3,1073,20062,3578735748,3578735786,38
3,1073,20063,3578735748,3578735786,38
3,1073,20064,3578735748,3578735787,39
3,1073,20065,3578735748,3578735787,39
3,1073,20066,3578735748,3578735787,39
3,1073,20067,3578735748,3578735787,39
3,1073,20068,3578735748,3578735787,39
3,1073,20069,3578735748,3578735788,40
3,1073,20070,3578735748,3578735789,41
3,1073,20071,3578735748,3578735789,41
3,1073,20072,3578735748,3578735790,42
3,1073,20073,3578735748,3578735790,42
3,1073,20074,3578735748,3578735790,42
3,1073,20075,3578735748,3578735792,44
3,1073,20076,3578735748,3578735792,44
3,1073,20077,3578735748,3578735794,46
3,1073,20078,3578735748,3578735797,49
3,1073,20079,3578735748,3578735797,49
3,1074,20080,3578735807,3578735807,0
3,1074,20081,3578735807,3578735807,0
3,1074,20082,3578735807,3578735807,0
3,1074,20083,3578735807,3578735807,0
3,1074,20084,3578735807,3578735807,0
3,1074,20085,3578735807,3578735807,0
3,1074,20086,3578735807,3578735807,0
3,1074,20087,3578735807,3578735807,0
3,1074,20088,3578735807,3578735808,1
3,1074,20089,3578735807,3578735808,1
3,1074,20090,3578735807,3578735808,1
3,1074,20091,3578735807,3578735811,4
3,1074,20092,3578735807,3578735813,6
3,1074,20093,3578735807,3578735814,7
3,1074,20094,3578735807,3578735814,7
3,1074,20095,3578735807,3578735815,8
3,1074,20096,3578735807,3578735816,9
3,1074,20097,3578735807,3578735817,10
3,1074,20098,3578735807,3578735818,11
3,1074,20099,3578735807,3578735818,11
3,1074,20100,3578735807,3578735818,11
3,1074,20101,3578735807,3578735819,12
3,1074,20102,3578735807,3578735820,13
3,1074,20103,3578735807,3578735821,14
3,1074,20104,3578735807,3578735821,14
3,1074,20105,3578735807,3578735825,18
3,1074,20106,3578735807,3578735825,18
3,1074,20107,3578735807,3578735827,20
3,1074,20108,3578735807,3578735827,20
3,1074,20109,3578735807,3578735828,21
3,1074,20110,3578735807,3578735828,21
3,1074,20111,3578735807,3578735830,23
3,1074,20112,3578735807,3578735831,24
3,1074,20113,3578735807,3578735831,24
3,1074,20114,3578735807,3578735831,24
3,1074,20115,3578735807,3578735832,25
3,1074,20116,3578735807,3578735833,26
3,1074,20117,3578735807,3578735834,27
3,1074,20118,3578735807,3578735835,28
3,1074,20119,3578735807,3578735836,29
3,1074,20120,3578735807,3578735837,30
3,1074,20121,3578735807,3578735839,32
3,1074,20122,3578735807,3578735839,32
3,1074,20123,3578735807,3578735840,33
3,1074,20124,3578735807,3578735840,33
3,1074,20125,3578735807,3578735841,34
3,1074,20126,3578735807,3578735842,35
3,1074,20127,3578735807,3578735842,35
3,1074,20128,3578735807,3578735843,36
3,1074,20129,3578735807,3578735844,37
3,1074,20130,3578735807,3578735846,39
3,1074,20131,3578735807,3578735846,39
3,1074,20132,3578735807,3578735846,39
3,1074,20133,3578735807,3578735847,40
3,1074,20134,3578735807,3578735847,40
3,1074,20135,3578735807,3578735850,43
3,1074,20136,3578735807,3578735850,43
3,1074,20137,3578735807,3578735851,44
3,1074,20138,3578735807,3578735855,48
3,1074,20139,3578735807,3578735856,49
3,1074,20140,3578735807,3578735856,49
3,1075,20141,3578735870,3578735870,0
3,1075,20142,3578735870,3578735870,0
3,1075,20143,3578735870,3578735870,0
3,1075,20144,3578735870,3578735870,0
3,1075,20145,3578735870,3578735870,0
3,1075,20146,3578735870,3578735870,0
3,1075,20147,3578735870,3578735870,0
3,1075,20148,3578735870,3578735870,0
3,1075,20149,3578735870,3578735870,0
3,1075,20150,3578735870,3578735870,0
3,1075,20151,3578735870,3578735870,0
3,1075,20152,3578735870,3578735874,4
3,1075,20153,3578735870,3578735876,6
3,1075,20154,3578735870,3578735879,9
3,1075,20155,3578735870,3578735880,10
3,1075,20156,3578735870,3578735881,11
3,1075,20157,3578735870,3578735882,12
3,1075,20158,3578735870,3578735886,16
3,1075,20159,3578735870,3578735886,16
3,1075,20160,3578735870,3578735886,16
3,1075,20161,3578735870,3578735887,17
3,1075,20162,3578735870,3578735889,19
3,1075,20163,3578735870,3578735890,20
3,1075,20164,3578735870,3578735891,21
3,1075,20165,3578735870,3578735891,21
3,1075,20166,3578735870,3578735892,22
3,1075,20167,3578735870,3578735895,25
3,1075,20168,3578735870,3578735896,26
3,1075,20169,3578735870,3578735897,27
3,1075,20170,3578735870,3578735900,30
3,1075,20171,3578735870,3578735900,30
3,1075,20172,3578735870,3578735900,30
3,1075,20173,3578735870,3578735901,31
3,1075,20174,3578735870,3578735903,33
3,1075,20175,3578735870,3578735903,33
3,1075,20176,3578735870,3578735907,37
3,1075,20177,3578735870,3578735908,38
3,1075,20178,3578735870,3578735910,40
3,1075,20179,3578735870,3578735914,44
3,1075,20180,3578735870,3578735914,44
3,1075,20181,3578735870,3578735915,45
3,1075,20182,3578735870,3578735915,45
3,1075,20183,3578735870,3578735918,48
3,1075,20184,3578735870,3578735919,49
3,1076,20185,3578735928,3578735928,0
3,1076,20186,3578735928,3578735928,0
3,1076,20187,3578735928,3578735928,0
3,1076,20188,3578735928,3578735929,1
3,1076,20189,3578735928,3578735930,2
3,1076,20190,3578735928,3578735931,3
3,1076,20191,3578735928,3578735934,6
3,1076,20192,3578735928,3578735937,9
3,1076,20193,3578735928,3578735938,10
3,1076,20194,3578735928,3578735938,10
3,1076,20195,3578735928,3578735939,11
3,1076,20196,3578735928,3578735940,12
3,1076,20197,3578735928,3578735942,14
3,1076,20198,3578735928,3578735942,14
3,1076,20199,3578735928,3578735944,16
3,1076,20200,3578735928,3578735948,20
3,1076,20201,3578735928,3578735948,20
3,1076,20202,3578735928,3578735949,21
3,1076,20203,3578735928,3578735949,21
3,1076,20204,3578735928,3578735950,22
3,1076,20205,3578735928,3578735951,23
3,1076,20206,3578735928,3578735952,24
3,1076,20207,3578735928,3578735952,24
3,1076,20208,3578735928,3578735954,26
3,1076,20209,3578735928,3578735955,27
3,1076,20210,3578735928,3578735957,29
3,1076,20211,3578735928,3578735958,30
3,1076,20212,3578735928,3578735958,30
3,1076,20213,3578735928,3578735958,30
3,1076,20214,3578735928,3578735959,31
3,1076,20215,3578735928,3578735959,31
3,1076,20216,3578735928,3578735960,32
3,1076,20217,3578735928,3578735962,34
3,1076,20218,3578735928,3578735963,35
3,1076,20219,3578735928,3578735965,37
3,1076,20220,3578735928,3578735967,39
3,1076,20221,3578735928,3578735968,40
3,1076,20222,3578735928,3578735968,40
3,1076,20223,3578735928,3578735969,41
3,1076,20224,3578735928,3578735969,41
3,1076,20225,3578735928,3578735969,41
3,1076,20226,3578735928,3578735970,42
3,1076,20227,3578735928,3578735970,42
3,1076,20228,3578735928,3578735971,43
3,1076,20229,3578735928,3578735971,43
3,1076,20230,3578735928,3578735971,43
3,1076,20231,3578735928,3578735974,46
3,1076,20232,3578735928,3578735974,46
3,1076,20233,3578735928,3578735975,47
3,1076,20234,3578735928,3578735975,47
3,1076,20235,3578735928,3578735977,49
3,1076,20236,3578735928,3578735978,50
3,1077,20237,3578735990,3578735990,0
3,1077,20238,3578735990,3578735990,0
3,1077,20239,3578735990,3578735990,0
3,1077,20240,3578735990,3578735990,0
3,1077,20241,3578735990,3578735990,0
3,1077,20242,3578735990,3578735990,0
3,1077,20243,3578735990,3578735990,0
3,1077,20244,3578735990,3578735990,0
3,1077,20245,3578735990,3578735990,0
3,1077,20246,3578735990,3578735990,0
3,1077,20247,3578735990,3578735990,0
3,1077,20248,3578735990,3578735990,0
3,1077,20249,3578735990,3578735991,1
3,1077,20250,3578735990,3578735991,1
3,1077,20251,3578735990,3578735991,1
3,1077,20252,3578735990,3578735991,1
3,1077,20253,3578735990,3578735991,1
3,1077,20254,3578735990,3578735992,2
3,1077,20255,3578735990,3578735994,4
3,1077,20256,3578735990,3578735997,7
3,1077,20257,3578735990,3578735997,7
3,1077,20258,3578735990,3578736000,10
3,1077,20259,3578735990,3578736003,13
3,1077,20260,3578735990,3578736005,15
3,1077,20261,3578735990,3578736005,15
3,1077,20262,3578735990,3578736005,15
3,1077,20263,3578735990,3578736005,15
3,1077,20264,3578735990,3578736006,16
3,1077,20265,3578735990,3578736007,17
3,1077,20266,3578735990,3578736008,18
3,1077,20267,3578735990,3578736009,19
3,1077,20268,3578735990,3578736009,19
3,1077,20269,3578735990,3578736009,19
3,1077,20270,3578735990,3578736011,21
3,1077,20271,3578735990,3578736014,24
3,1077,20272,3578735990,3578736015,25
3,1077,20273,3578735990,3578736017,27
3,1077,20274,3578735990,3578736018,28
3,1077,20275,3578735990,3578736018,28
3,1077,20276,3578735990,3578736018,28
3,1077,20277,3578735990,3578736018,28
3,1077,20278,3578735990,3578736019,29
3,1077,20279,3578735990,3578736020,30
3,1077,20280,3578735990,3578736021,31
3,1077,20281,3578735990,3578736022,32
3,1077,20282,3578735990,3578736024,34
3,1077,20283,3578735990,3578736026,36
3,1077,20284,3578735990,3578736026,36
3,1077,20285,3578735990,3578736027,37
3,1077,20286,3578735990,3578736028,38
3,1077,20287,3578735990,3578736029,39
3,1077,20288,3578735990,3578736030,40
3,1077,20289,3578735990,3578736031,41
3,1077,20290,3578735990,3578736031,41
3,1077,20291,3578735990,3578736032,42
3,1077,20292,3578735990,3578736033,43
3,1077,20293,3578735990,3578736033,43
3,1077,20294,3578735990,3578736036,46
3,1077,20295,3578735990,3578736037,47
3,1077,20296,3578735990,3578736039,49
3,1077,20297,3578735990,3578736040,50
3,1078,20298,3578736051,3578736051,0
3,1078,20299,3578736051,3578736051,0
3,1078,20300,3578736051,3578736051,0
3,1078,20301,3578736051,3578736051,0
3,1078,20302,3578736051,3578736051,0
3,1078,20303,3578736051,3578736051,0
3,1078,20304,3578736051,3578736051,0
3,1078,20305,3578736051,3578736051,0
3,1078,20306,3578736051,3578736051,0
3,1078,20307,3578736051,3578736051,0
3,1078,20308,3578736051,3578736051,0
3,1078,20309,3578736051,3578736051,0
3,1078,20310,3578736051,3578736051,0
3,1078,20311,3578736051,3578736051,0
3,1078,20312,3578736051,3578736051,0
3,1078,20313,3578736051,3578736051,0
3,1078,20314,3578736051,3578736055,4
3,1078,20315,3578736051,3578736056,5
3,1078,20316,3578736051,3578736056,5
3,1078,20317,3578736051,3578736058,7
3,1078,20318,3578736051,3578736061,10
3,1078,20319,3578736051,3578736062,11
3,1078,20320,3578736051,3578736064,13
3,1078,20321,3578736051,3578736064,13
3,1078,20322,3578736051,3578736065,14
3,1078,20323,3578736051,3578736065,14
3,1078,20324,3578736051,3578736066,15
3,1078,20325,3578736051,3578736068,17
3,1078,20326,3578736051,3578736069,18
3,1078,20327,3578736051,3578736074,23
3,1078,20328,3578736051,3578736078,27
3,1078,20329,3578736051,3578736080,29
3,1078,20330,3578736051,3578736081,30
3,1078,20331,3578736051,3578736081,30
3,1078,20332,3578736051,3578736085,34
3,1078,20333,3578736051,3578736086,35
3,1078,20334,3578736051,3578736087,36
3,1078,20335,3578736051,3578736087,36
3,1078,20336,3578736051,3578736088,37
3,1078,20337,3578736051,3578736089,38
3,1078,20338,3578736051,3578736089,38
3,1078,20339,3578736051,3578736090,39
3,1078,20340,3578736051,3578736091,40
3,1078,20341,3578736051,3578736091,40
3,1078,20342,3578736051,3578736092,41
3,1078,20343,3578736051,3578736092,41
3,1078,20344,3578736051,3578736093,42
3,1078,20345,3578736051,3578736095,44
3,1078,20346,3578736051,3578736096,45
3,1078,20347,3578736051,3578736098,47
3,1078,20348,3578736051,3578736100,49
3,1078,20349,3578736051,3578736100,49
3,1078,20350,3578736051,3578736100,49
3,1079,20351,3578736111,3578736111,0
3,1079,20352,3578736111,3578736111,0
3,1079,20353,3578736111,3578736111,0
3,1079,20354,3578736111,3578736111,0
3,1079,20355,3578736111,3578736111,0
3,1079,20356,3578736111,3578736111,0
3,1079,20357,3578736111,3578736111,0
3,1079,20358,3578736111,3578736111,0
3,1079,20359,3578736111,3578736114,3
3,1079,20360,3578736111,3578736115,4
3,1079,20361,3578736111,3578736115,4
3,1079,20362,3578736111,3578736116,5
3,1079,20363,3578736111,3578736118,7
3,1079,20364,3578736111,3578736119,8
3,1079,20365,3578736111,3578736121,10
3,1079,20366,3578736111,3578736123,12
3,1079,20367,3578736111,3578736124,13
3,1079,20368,3578736111,3578736128,17
3,1079,20369,3578736111,3578736128,17
3,1079,20370,3578736111,3578736130,19
3,1079,20371,3578736111,3578736131,20
3,1079,20372,3578736111,3578736134,23
3,1079,20373,3578736111,3578736138,27
3,1079,20374,3578736111,3578736139,28
3,1079,20375,3578736111,3578736139,28
3,1079,20376,3578736111,3578736139,28
3,1079,20377,3578736111,3578736142,31
3,1079,20378,3578736111,3578736142,31
3,1079,20379,3578736111,3578736144,33
3,1079,20380,3578736111,3578736147,36
3,1079,20381,3578736111,3578736149,38
3,1079,20382,3578736111,3578736149,38
3,1079,20383,3578736111,3578736150,39
3,1079,20384,3578736111,3578736150,39
3,1079,20385,3578736111,3578736151,40
3,1079,20386,3578736111,3578736152,41
3,1079,20387,3578736111,3578736152,41
3,1079,20388,3578736111,3578736153,42
3,1079,20389,3578736111,3578736155,44
3,1079,20390,3578736111,3578736155,44
3,1079,20391,3578736111,3578736156,45
3,1079,20392,3578736111,3578736157,46
3,1079,20393,3578736111,3578736157,46
3,1079,20394,3578736111,3578736158,47
3,1079,20395,3578736111,3578736158,47
3,1079,20396,3578736111,3578736159,48
3,1079,20397,3578736111,3578736160,49
3,1080,20398,3578736172,3578736172,0
3,1080,20399,3578736172,3578736172,0
3,1080,20400,3578736172,3578736172,0
3,1080,20401,3578736172,3578736172,0
3,1080,20402,3578736172,3578736172,0
3,1080,20403,3578736172,3578736172,0
3,1080,20404,3578736172,3578736172,0
3,1080,20405,3578736172,3578736172,0
3,1080,20406,3578736172,3578736172,0
3,1080,20407,3578736172,3578736172,0
3,1080,20408,3578736172,3578736172,0
3,1080,20409,3578736172,3578736172,0
3,1080,20410,3578736172,3578736172,0
3,1080,20411,3578736172,3578736172,0
3,1080,20412,3578736172,3578736172,0
3,1080,20413,3578736172,3578736174,2
3,1080,20414,3578736172,3578736174,2
3,1080,20415,3578736172,3578736175,3
3,1080,20416,3578736172,3578736176,4
3,1080,20417,3578736172,3578736176,4
3,1080,20418,3578736172,3578736177,5
3,1080,20419,3578736172,3578736178,6
3,1080,20420,3578736172,3578736179,7
3,1080,20421,3578736172,3578736181,9
3,1080,20422,3578736172,3578736185,13
3,1080,20423,3578736172,3578736186,14
3,1080,20424,3578736172,3578736187,15
3,1080,20425,3578736172,3578736187,15
3,1080,20426,3578736172,3578736187,15
3,1080,20427,3578736172,3578736188,16
3,1080,20428,3578736172,3578736188,16
3,1080,20429,3578736172,3578736188,16
3,1080,20430,3578736172,3578736188,16
3,1080,20431,3578736172,3578736189,17
3,1080,20432,3578736172,3578736189,17
3,1080,20433,3578736172,3578736190,18
3,1080,20434,3578736172,3578736190,18
3,1080,20435,3578736172,3578736191,19
3,1080,20436,3578736172,3578736191,19
3,1080,20437,3578736172,3578736192,20
3,1080,20438,3578736172,3578736193,21
3,1080,20439,3578736172,3578736194,22
3,1080,20440,3578736172,3578736200,28
3,1080,20441,3578736172,3578736203,31
3,1080,20442,3578736172,3578736203,31
3,1080,20443,3578736172,3578736205,33
3,1080,20444,3578736172,3578736205,33
3,1080,20445,3578736172,3578736206,34
3,1080,20446,3578736172,3578736206,34
3,1080,20447,3578736172,3578736207,35
3,1080,20448,3578736172,3578736208,36
3,1080,20449,3578736172,3578736208,36
3,1080,20450,3578736172,3578736209,37
3,1080,20451,3578736172,3578736209,37
3,1080,20452,3578736172,3578736214,42
3,1080,20453,3578736172,3578736214,42
3,1080,20454,3578736172,3578736215,43
3,1080,20455,3578736172,3578736216,44
3,1080,20456,3578736172,3578736217,45
3,1080,20457,3578736172,3578736218,46
3,1080,20458,3578736172,3578736218,46
3,1080,20459,3578736172,3578736219,47
3,1080,20460,3578736172,3578736219,47
3,1080,20461,3578736172,3578736219,47
3,1080,20462,3578736172,3578736220,48
3,1080,20463,3578736172,3578736221,49
3,1080,20464,3578736172,3578736222,50
3,1081,20465,3578736233,3578736233,0
3,1081,20466,3578736233,3578736233,0
3,1081,20467,3578736233,3578736233,0
3,1081,20468,3578736233,3578736233,0
3,1081,20469,3578736233,3578736233,0
3,1081,20470,3578736233,3578736233,0
3,1081,20471,3578736233,3578736233,0
3,1081,20472,3578736233,3578736233,0
3,1081,20473,3578736233,3578736233,0
3,1081,20474,3578736233,3578736233,0
3,1081,20475,3578736233,3578736236,3
3,1081,20476,3578736233,3578736236,3
3,1081,20477,3578736233,3578736236,3
3,1081,20478,3578736233,3578736237,4
3,1081,20479,3578736233,3578736239,6
3,1081,20480,3578736233,3578736239,6
3,1081,20481,3578736233,3578736240,7
3,1081,20482,3578736233,3578736241,8
3,1081,20483,3578736233,3578736241,8
3,1081,20484,3578736233,3578736243,10
3,1081,20485,3578736233,3578736243,10
3,1081,20486,3578736233,3578736243,10
3,1081,20487,3578736233,3578736243,10
3,1081,20488,3578736233,3578736244,11
3,1081,20489,3578736233,3578736245,12
3,1081,20490,3578736233,3578736246,13
3,1081,20491,3578736233,3578736247,14
3,1081,20492,3578736233,3578736247,14
3,1081,20493,3578736233,3578736247,14
3,1081,20494,3578736233,3578736247,14
3,1081,20495,3578736233,3578736250,17
3,1081,20496,3578736233,3578736250,17
3,1081,20497,3578736233,3578736255,22
3,1081,20498,3578736233,3578736256,23
3,1081,20499,3578736233,3578736256,23
3,1081,20500,3578736233,3578736258,25
3,1081,20501,3578736233,3578736262,29
3,1081,20502,3578736233,3578736263,30
3,1081,20503,3578736233,3578736263,30
3,1081,20504,3578736233,3578736264,31
3,1081,20505,3578736233,3578736264,31
3,1081,20506,3578736233,3578736266,33
3,1081,20507,3578736233,3578736266,33
3,1081,20508,3578736233,3578736268,35
3,1081,20509,3578736233,3578736269,36
3,1081,20510,3578736233,3578736274,41
3,1081,20511,3578736233,3578736277,44
3,1081,20512,3578736233,3578736280,47
3,1081,20513,3578736233,3578736280,47
3,1081,20514,3578736233,3578736281,48
3,1081,20515,3578736233,3578736282,49
3,1081,20516,3578736233,3578736282,49
3,1082,20517,3578736292,3578736292,0
3,1082,20518,3578736292,3578736292,0
3,1082,20519,3578736292,3578736292,0
3,1082,20520,3578736292,3578736292,0
3,1082,20521,3578736292,3578736292,0
3,1082,20522,3578736292,3578736292,0
3,1082,20523,3578736292,3578736292,0
3,1082,20524,3578736292,3578736292,0
3,1082,20525,3578736292,3578736292,0
3,1082,20526,3578736292,3578736292,0
3,1082,20527,3578736292,3578736295,3
3,1082,20528,3578736292,3578736297,5
3,1082,20529,3578736292,3578736298,6
3,1082,20530,3578736292,3578736300,8
3,1082,20531,3578736292,3578736300,8
3,1082,20532,3578736292,3578736304,12
3,1082,20533,3578736292,3578736304,12
3,1082,20534,3578736292,3578736308,16
3,1082,20535,3578736292,3578736308,16
3,1082,20536,3578736292,3578736311,19
3,1082,20537,3578736292,3578736315,23
3,1082,20538,3578736292,3578736316,24
3,1082,20539,3578736292,3578736316,24
3,1082,20540,3578736292,3578736317,25
3,1082,20541,3578736292,3578736318,26
3,1082,20542,3578736292,3578736320,28
3,1082,20543,3578736292,3578736323,31
3,1082,20544,3578736292,3578736323,31
3,1082,20545,3578736292,3578736328,36
3,1082,20546,3578736292,3578736329,37
3,1082,20547,3578736292,3578736331,39
3,1082,20548,3578736292,3578736332,40
3,1082,20549,3578736292,3578736335,43
3,1082,20550,3578736292,3578736336,44
3,1082,20551,3578736292,3578736339,47
3,1082,20552,3578736292,3578736339,47
3,1082,20553,3578736292,3578736340,48
3,1082,20554,3578736292,3578736342,50
3,1083,20555,3578736352,3578736352,0
3,1083,20556,3578736352,3578736352,0
3,1083,20557,3578736352,3578736352,0
3,1083,20558,3578736352,3578736352,0
3,1083,20559,3578736352,3578736352,0
3,1083,20560,3578736352,3578736352,0
3,1083,20561,3578736352,3578736352,0
3,1083,20562,3578736352,3578736352,0
3,1083,20563,3578736352,3578736352,0
3,1083,20564,3578736352,3578736352,0
3,1083,20565,3578736352,3578736353,1
3,1083,20566,3578736352,3578736353,1
3,1083,20567,3578736352,3578736356,4
3,1083,20568,3578736352,3578736358,6
3,1083,20569,3578736352,3578736358,6
3,1083,20570,3578736352,3578736359,7
3,1083,20571,3578736352,3578736359,7
3,1083,20572,3578736352,3578736360,8
3,1083,20573,3578736352,3578736360,8
3,1083,20574,3578736352,3578736362,10
3,1083,20575,3578736352,3578736366,14
3,1083,20576,3578736352,3578736367,15
3,1083,20577,3578736352,3578736367,15
3,1083,20578,3578736352,3578736368,16
3,1083,20579,3578736352,3578736368,16
3,1083,20580,3578736352,3578736369,17
3,1083,20581,3578736352,3578736369,17
3,1083,20582,3578736352,3578736369,17
3,1083,20583,3578736352,3578736370,18
3,1083,20584,3578736352,3578736371,19
3,1083,20585,3578736352,3578736371,19
3,1083,20586,3578736352,3578736372,20
3,1083,20587,3578736352,3578736374,22
3,1083,20588,3578736352,3578736374,22
3,1083,20589,3578736352,3578736375,23
3,1083,20590,3578736352,3578736376,24
3,1083,20591,3578736352,3578736377,25
3,1083,20592,3578736352,3578736377,25
3,1083,20593,3578736352,3578736378,26
3,1083,20594,3578736352,3578736379,27
3,1083,20595,3578736352,3578736381,29
3,1083,20596,3578736352,3578736385,33
3,1083,20597,3578736352,3578736386,34
3,1083,20598,3578736352,3578736387,35
3,1083,20599,3578736352,3578736387,35
3,1083,20600,3578736352,3578736387,35
3,1083,20601,3578736352,3578736387,35
3,1083,20602,3578736352,3578736388,36
3,1083,20603,3578736352,3578736388,36
3,1083,20604,3578736352,3578736388,36
3,1083,20605,3578736352,3578736388,36
3,1083,20606,3578736352,3578736389,37
3,1083,20607,3578736352,3578736390,38
3,1083,20608,3578736352,3578736390,38
3,1083,20609,3578736352,3578736391,39
3,1083,20610,3578736352,3578736392,40
3,1083,20611,3578736352,3578736392,40
3,1083,20612,3578736352,3578736394,42
3,1083,20613,3578736352,3578736397,45
3,1083,20614,3578736352,3578736400,48
3,1083,20615,3578736352,3578736401,49
3,1084,20616,3578736414,3578736414,0
3,1084,20617,3578736414,3578736414,0
3,1084,20618,3578736414,3578736414,0
3,1084,20619,3578736414,3578736414,0
3,1084,20620,3578736414,3578736414,0
3,1084,20621,3578736414,3578736414,0
3,1084,20622,3578736414,3578736414,0
3,1084,20623,3578736414,3578736414,0
3,1084,20624,3578736414,3578736414,0
3,1084,20625,3578736414,3578736414,0
3,1084,20626,3578736414,3578736414,0
3,1084,20627,3578736414,3578736414,0
3,1084,20628,3578736414,3578736414,0
3,1084,20629,3578736414,3578736417,3
3,1084,20630,3578736414,3578736417,3
3,1084,20631,3578736414,3578736418,4
3,1084,20632,3578736414,3578736418,4
3,1084,20633,3578736414,3578736419,5
3,1084,20634,3578736414,3578736419,5
3,1084,20635,3578736414,3578736420,6
3,1084,20636,3578736414,3578736421,7
3,1084,20637,3578736414,3578736422,8
3,1084,20638,3578736414,3578736425,11
3,1084,20639,3578736414,3578736426,12
3,1084,20640,3578736414,3578736426,12
3,1084,20641,3578736414,3578736427,13
3,1084,20642,3578736414,3578736428,14
3,1084,20643,3578736414,3578736429,15
3,1084,20644,3578736414,3578736431,17
3,1084,20645,3578736414,3578736431,17
3,1084,20646,3578736414,3578736432,18
3,1084,20647,3578736414,3578736433,19
3,1084,20648,3578736414,3578736433,19
3,1084,20649,3578736414,3578736433,19
3,1084,20650,3578736414,3578736434,20
3,1084,20651,3578736414,3578736436,22
3,1084,20652,3578736414,3578736436,22
3,1084,20653,3578736414,3578736437,23
3,1084,20654,3578736414,3578736439,25
3,1084,20655,3578736414,3578736439,25
3,1084,20656,3578736414,3578736441,27
3,1084,20657,3578736414,3578736442,28
3,1084,20658,3578736414,3578736442,28
3,1084,20659,3578736414,3578736443,29
3,1084,20660,3578736414,3578736443,29
3,1084,20661,3578736414,3578736443,29
3,1084,20662,3578736414,3578736444,30
3,1084,20663,3578736414,3578736445,31
3,1084,20664,3578736414,3578736446,32
3,1084,20665,3578736414,3578736447,33
3,1084,20666,3578736414,3578736447,33
3,1084,20667,3578736414,3578736447,33
3,1084,20668,3578736414,3578736450,36
3,1084,20669,3578736414,3578736451,37
3,1084,20670,3578736414,3578736455,41
3,1084,20671,3578736414,3578736456,42
3,1084,20672,3578736414,3578736458,44
3,1084,20673,3578736414,3578736458,44
3,1084,20674,3578736414,3578736462,48
3,1084,20675,3578736414,3578736463,49
3,1084,20676,3578736414,3578736463,49
3,1084,20677,3578736414,3578736464,50
3,1085,20678,3578736476,3578736476,0
3,1085,20679,3578736476,3578736476,0
3,1085,20680,3578736476,3578736476,0
3,1085,20681,3578736476,3578736476,0
3,1085,20682,3578736476,3578736476,0
3,1085,20683,3578736476,3578736476,0
3,1085,20684,3578736476,3578736476,0
3,1085,20685,3578736476,3578736480,4
3,1085,20686,3578736476,3578736482,6
3,1085,20687,3578736476,3578736482,6
3,1085,20688,3578736476,3578736485,9
3,1085,20689,3578736476,3578736486,10
3,1085,20690,3578736476,3578736487,11
3,1085,20691,3578736476,3578736487,11
3,1085,20692,3578736476,3578736488,12
3,1085,20693,3578736476,3578736490,14
3,1085,20694,3578736476,3578736490,14
3,1085,20695,3578736476,3578736491,15
3,1085,20696,3578736476,3578736491,15
3,1085,20697,3578736476,3578736492,16
3,1085,20698,3578736476,3578736492,16
3,1085,20699,3578736476,3578736492,16
3,1085,20700,3578736476,3578736492,16
3,1085,20701,3578736476,3578736496,20
3,1085,20702,3578736476,3578736497,21
3,1085,20703,3578736476,3578736498,22
3,1085,20704,3578736476,3578736500,24
3,1085,20705,3578736476,3578736501,25
3,1085,20706,3578736476,3578736501,25
3,1085,20707,3578736476,3578736502,26
3,1085,20708,3578736476,3578736505,29
3,1085,20709,3578736476,3578736507,31
3,1085,20710,3578736476,3578736508,32
3,1085,20711,3578736476,3578736508,32
3,1085,20712,3578736476,3578736511,35
3,1085,20713,3578736476,3578736515,39
3,1085,20714,3578736476,3578736515,39
3,1085,20715,3578736476,3578736516,40
3,1085,20716,3578736476,3578736517,41
3,1085,20717,3578736476,3578736518,42
3,1085,20718,3578736476,3578736519,43
3,1085,20719,3578736476,3578736522,46
3,1085,20720,3578736476,3578736523,47
3,1085,20721,3578736476,3578736523,47
3,1085,20722,3578736476,3578736523,47
3,1086,20723,3578736537,3578736537,0
3,1086,20724,3578736537,3578736537,0
3,1086,20725,3578736537,3578736537,0
3,1086,20726,3578736537,3578736537,0
3,1086,20727,3578736537,3578736537,0
3,1086,20728,3578736537,3578736537,0
3,1086,20729,3578736537,3578736537,0
3,1086,20730,3578736537,3578736538,1
3,1086,20731,3578736537,3578736539,2
3,1086,20732,3578736537,3578736540,3
3,1086,20733,3578736537,3578736541,4
3,1086,20734,3578736537,3578736544,7
3,1086,20735,3578736537,3578736545,8
3,1086,20736,3578736537,3578736548,11
3,1086,20737,3578736537,3578736549,12
3,1086,20738,3578736537,3578736549,12
3,1086,20739,3578736537,3578736551,14
3,1086,20740,3578736537,3578736552,15
3,1086,20741,3578736537,3578736552,15
3,1086,20742,3578736537,3578736553,16
3,1086,20743,3578736537,3578736555,18
3,1086,20744,3578736537,3578736556,19
3,1086,20745,3578736537,3578736557,20
3,1086,20746,3578736537,3578736557,20
3,1086,20747,3578736537,3578736558,21
3,1086,20748,3578736537,3578736558,21
3,1086,20749,3578736537,3578736558,21
3,1086,20750,3578736537,3578736559,22
3,1086,20751,3578736537,3578736559,22
3,1086,20752,3578736537,3578736562,25
3,1086,20753,3578736537,3578736563,26
3,1086,20754,3578736537,3578736566,29
3,1086,20755,3578736537,3578736566,29
3,1086,20756,3578736537,3578736567,30
3,1086,20757,3578736537,3578736568,31
3,1086,20758,3578736537,3578736568,31
3,1086,20759,3578736537,3578736569,32
3,1086,20760,3578736537,3578736570,33
3,1086,20761,3578736537,3578736570,33
3,1086,20762,3578736537,3578736570,33
3,1086,20763,3578736537,3578736571,34
3,1086,20764,3578736537,3578736573,36
3,1086,20765,3578736537,3578736573,36
3,1086,20766,3578736537,3578736575,38
3,1086,20767,3578736537,3578736576,39
3,1086,20768,3578736537,3578736576,39
3,1086,20769,3578736537,3578736577,40
3,1086,20770,3578736537,3578736580,43
3,1086,20771,3578736537,3578736584,47
3,1086,20772,3578736537,3578736586,49
3,1086,20773,3578736537,3578736586,49
3,1086,20774,3578736537,3578736587,50
3,1087,20775,3578736597,3578736597,0
3,1087,20776,3578736597,3578736597,0
3,1087,20777,3578736597,3578736597,0
3,1087,20778,3578736597,3578736597,0
3,1087,20779,3578736597,3578736597,0
3,1087,20780,3578736597,3578736597,0
3,1087,20781,3578736597,3578736597,0
3,1087,20782,3578736597,3578736597,0
3,1087,20783,3578736597,3578736597,0
3,1087,20784,3578736597,3578736597,0
3,1087,20785,3578736597,3578736597,0
3,1087,20786,3578736597,3578736597,0
3,1087,20787,3578736597,3578736597,0
3,1087,20788,3578736597,3578736597,0
3,1087,20789,3578736597,3578736599,2
3,1087,20790,3578736597,3578736601,4
3,1087,20791,3578736597,3578736603,6
3,1087,20792,3578736597,3578736604,7
3,1087,20793,3578736597,3578736604,7
3,1087,20794,3578736597,3578736604,7
3,1087,20795,3578736597,3578736605,8
3,1087,20796,3578736597,3578736605,8
3,1087,20797,3578736597,3578736606,9
3,1087,20798,3578736597,3578736607,10
3,1087,20799,3578736597,3578736607,10
3,1087,20800,3578736597,3578736607,10
3,1087,20801,3578736597,3578736608,11
3,1087,20802,3578736597,3578736610,13
3,1087,20803,3578736597,3578736613,16
3,1087,20804,3578736597,3578736613,16
3,1087,20805,3578736597,3578736614,17
3,1087,20806,3578736597,3578736616,19
3,1087,20807,3578736597,3578736617,20
3,1087,20808,3578736597,3578736617,20
3,1087,20809,3578736597,3578736618,21
3,1087,20810,3578736597,3578736619,22
3,1087,20811,3578736597,3578736619,22
3,1087,20812,3578736597,3578736619,22
3,1087,20813,3578736597,3578736621,24
3,1087,20814,3578736597,3578736621,24
3,1087,20815,3578736597,3578736621,24
3,1087,20816,3578736597,3578736624,27
3,1087,20817,3578736597,3578736625,28
3,1087,20818,3578736597,3578736625,28
3,1087,20819,3578736597,3578736626,29
3,1087,20820,3578736597,3578736627,30
3,1087,20821,3578736597,3578736627,30
3,1087,20822,3578736597,3578736630,33
3,1087,20823,3578736597,3578736630,33
3,1087,20824,3578736597,3578736631,34
3,1087,20825,3578736597,3578736631,34
3,1087,20826,3578736597,3578736635,38
3,1087,20827,3578736597,3578736635,38
3,1087,20828,3578736597,3578736636,39
3,1087,20829,3578736597,3578736636,39
3,1087,20830,3578736597,3578736638,41
3,1087,20831,3578736597,3578736639,42
3,1087,20832,3578736597,3578736640,43
3,1087,20833,3578736597,3578736640,43
3,1087,20834,3578736597,3578736641,44
3,1087,20835,3578736597,3578736642,45
3,1087,20836,3578736597,3578736643,46
3,1087,20837,3578736597,3578736644,47
3,1087,20838,3578736597,3578736644,47
3,1087,20839,3578736597,3578736644,47
3,1087,20840,3578736597,3578736645,48
3,1087,20841,3578736597,3578736646,49
3,1087,20842,3578736597,3578736646,49
3,1087,20843,3578736597,3578736646,49
3,1088,20844,3578736658,3578736658,0
3,1088,20845,3578736658,3578736658,0
3,1088,20846,3578736658,3578736658,0
3,1088,20847,3578736658,3578736658,0
3,1088,20848,3578736658,3578736658,0
3,1088,20849,3578736658,3578736658,0
3,1088,20850,3578736658,3578736658,0
3,1088,20851,3578736658,3578736658,0
3,1088,20852,3578736658,3578736658,0
3,1088,20853,3578736658,3578736661,3
3,1088,20854,3578736658,3578736662,4
3,1088,20855,3578736658,3578736663,5
3,1088,20856,3578736658,3578736663,5
3,1088,20857,3578736658,3578736663,5
3,1088,20858,3578736658,3578736665,7
3,1088,20859,3578736658,3578736667,9
3,1088,20860,3578736658,3578736668,10
3,1088,20861,3578736658,3578736669,11
3,1088,20862,3578736658,3578736670,12
3,1088,20863,3578736658,3578736675,17
3,1088,20864,3578736658,3578736680,22
3,1088,20865,3578736658,3578736680,22
3,1088,20866,3578736658,3578736682,24
3,1088,20867,3578736658,3578736682,24
3,1088,20868,3578736658,3578736682,24
3,1088,20869,3578736658,3578736685,27
3,1088,20870,3578736658,3578736686,28
3,1088,20871,3578736658,3578736687,29
3,1088,20872,3578736658,3578736687,29
3,1088,20873,3578736658,3578736687,29
3,1088,20874,3578736658,3578736688,30
3,1088,20875,3578736658,3578736690,32
3,1088,20876,3578736658,3578736691,33
3,1088,20877,3578736658,3578736692,34
3,1088,20878,3578736658,3578736692,34
3,1088,20879,3578736658,3578736693,35
3,1088,20880,3578736658,3578736696,38
3,1088,20881,3578736658,3578736697,39
3,1088,20882,3578736658,3578736698,40
3,1088,20883,3578736658,3578736700,42
3,1088,20884,3578736658,3578736700,42
3,1088,20885,3578736658,3578736701,43
3,1088,20886,3578736658,3578736702,44
3,1088,20887,3578736658,3578736704,46
3,1088,20888,3578736658,3578736705,47
3,1089,20889,3578736720,3578736720,0
3,1089,20890,3578736720,3578736720,0
3,1089,20891,3578736720,3578736720,0
3,1089,20892,3578736720,3578736720,0
3,1089,20893,3578736720,3578736720,0
3,1089,20894,3578736720,3578736720,0
3,1089,20895,3578736720,3578736720,0
3,1089,20896,3578736720,3578736720,0
3,1089,20897,3578736720,3578736720,0
3,1089,20898,3578736720,3578736722,2
3,1089,20899,3578736720,3578736723,3
3,1089,20900,3578736720,3578736723,3
3,1089,20901,3578736720,3578736729,9
3,1089,20902,3578736720,3578736729,9
3,1089,20903,3578736720,3578736729,9
3,1089,20904,3578736720,3578736731,11
3,1089,20905,3578736720,3578736735,15
3,1089,20906,3578736720,3578736736,16
3,1089,20907,3578736720,3578736737,17
3,1089,20908,3578736720,3578736739,19
3,1089,20909,3578736720,3578736740,20
3,1089,20910,3578736720,3578736742,22
3,1089,20911,3578736720,3578736744,24
3,1089,20912,3578736720,3578736744,24
3,1089,20913,3578736720,3578736745,25
3,1089,20914,3578736720,3578736747,27
3,1089,20915,3578736720,3578736748,28
3,1089,20916,3578736720,3578736749,29
3,1089,20917,3578736720,3578736750,30
3,1089,20918,3578736720,3578736750,30
3,1089,20919,3578736720,3578736752,32
3,1089,20920,3578736720,3578736752,32
3,1089,20921,3578736720,3578736752,32
3,1089,20922,3578736720,3578736753,33
3,1089,20923,3578736720,3578736754,34
3,1089,20924,3578736720,3578736755,35
3,1089,20925,3578736720,3578736757,37
3,1089,20926,3578736720,3578736758,38
3,1089,20927,3578736720,3578736758,38
3,1089,20928,3578736720,3578736759,39
3,1089,20929,3578736720,3578736759,39
3,1089,20930,3578736720,3578736759,39
3,1089,20931,3578736720,3578736760,40
3,1089,20932,3578736720,3578736762,42
3,1089,20933,3578736720,3578736763,43
3,1089,20934,3578736720,3578736766,46
3,1089,20935,3578736720,3578736766,46
3,1089,20936,3578736720,3578736767,47
3,1089,20937,3578736720,3578736768,48
3,1089,20938,3578736720,3578736768,48
3,1089,20939,3578736720,3578736769,49
3,1089,20940,3578736720,3578736769,49
3,1089,20941,3578736720,3578736770,50
3,1090,20942,3578736783,3578736783,0
3,1090,20943,3578736783,3578736783,0
3,1090,20944,3578736783,3578736783,0
3,1090,20945,3578736783,3578736783,0
3,1090,20946,3578736783,3578736783,0
3,1090,20947,3578736783,3578736783,0
3,1090,20948,3578736783,3578736783,0
3,1090,20949,3578736783,3578736783,0
3,1090,20950,3578736783,3578736783,0
3,1090,20951,3578736783,3578736784,1
3,1090,20952,3578736783,3578736786,3
3,1090,20953,3578736783,3578736786,3
3,1090,20954,3578736783,3578736787,4
3,1090,20955,3578736783,3578736787,4
3,1090,20956,3578736783,3578736788,5
3,1090,20957,3578736783,3578736788,5
3,1090,20958,3578736783,3578736788,5
3,1090,20959,3578736783,3578736788,5
3,1090,20960,3578736783,3578736788,5
3,1090,20961,3578736783,3578736789,6
3,1090,20962,3578736783,3578736789,6
3,1090,20963,3578736783,3578736790,7
3,1090,20964,3578736783,3578736790,7
3,1090,20965,3578736783,3578736793,10
3,1090,20966,3578736783,3578736795,12
3,1090,20967,3578736783,3578736797,14
3,1090,20968,3578736783,3578736797,14
3,1090,20969,3578736783,3578736798,15
3,1090,20970,3578736783,3578736801,18
3,1090,20971,3578736783,3578736802,19
3,1090,20972,3578736783,3578736803,20
3,1090,20973,3578736783,3578736804,21
3,1090,20974,3578736783,3578736804,21
3,1090,20975,3578736783,3578736804,21
3,1090,20976,3578736783,3578736805,22
3,1090,20977,3578736783,3578736805,22
3,1090,20978,3578736783,3578736805,22
3,1090,20979,3578736783,3578736807,24
3,1090,20980,3578736783,3578736808,25
3,1090,20981,3578736783,3578736808,25
3,1090,20982,3578736783,3578736809,26
3,1090,20983,3578736783,3578736811,28
3,1090,20984,3578736783,3578736813,30
3,1090,20985,3578736783,3578736814,31
3,1090,20986,3578736783,3578736815,32
3,1090,20987,3578736783,3578736816,33
3,1090,20988,3578736783,3578736816,33
3,1090,20989,3578736783,3578736817,34
3,1090,20990,3578736783,3578736819,36
3,1090,20991,3578736783,3578736819,36
3,1090,20992,3578736783,3578736819,36
3,1090,20993,3578736783,3578736821,38
3,1090,20994,3578736783,3578736821,38
3,1090,20995,3578736783,3578736822,39
3,1090,20996,3578736783,3578736825,42
3,1090,20997,3578736783,3578736825,42
3,1090,20998,3578736783,3578736826,43
3,1090,20999,3578736783,3578736827,44
3,1090,21000,3578736783,3578736827,44
3,1090,21001,3578736783,3578736828,45
3,1090,21002,3578736783,3578736830,47
3,1090,21003,3578736783,3578736831,48
3,1090,21004,3578736783,3578736831,48
3,1090,21005,3578736783,3578736832,49
3,1090,21006,3578736783,3578736832,49
3,1090,21007,3578736783,3578736832,49
3,1090,21008,3578736783,3578736833,50
3,1091,21009,3578736845,3578736845,0
3,1091,21010,3578736845,3578736845,0
3,1091,21011,3578736845,3578736845,0
3,1091,21012,3578736845,3578736845,0
3,1091,21013,3578736845,3578736845,0
3,1091,21014,3578736845,3578736845,0
3,1091,21015,3578736845,3578736845,0
3,1091,21016,3578736845,3578736845,0
3,1091,21017,3578736845,3578736845,0
3,1091,21018,3578736845,3578736845,0
3,1091,21019,3578736845,3578736845,0
3,1091,21020,3578736845,3578736845,0
3,1091,21021,3578736845,3578736845,0
3,1091,21022,3578736845,3578736847,2
3,1091,21023,3578736845,3578736847,2
3,1091,21024,3578736845,3578736847,2
3,1091,21025,3578736845,3578736850,5
3,1091,21026,3578736845,3578736850,5
3,1091,21027,3578736845,3578736851,6
3,1091,21028,3578736845,3578736853,8
3,1091,21029,3578736845,3578736857,12
3,1091,21030,3578736845,3578736858,13
3,1091,21031,3578736845,3578736862,17
3,1091,21032,3578736845,3578736863,18
3,1091,21033,3578736845,3578736863,18
3,1091,21034,3578736845,3578736864,19
3,1091,21035,3578736845,3578736865,20
3,1091,21036,3578736845,3578736865,20
3,1091,21037,3578736845,3578736868,23
3,1091,21038,3578736845,3578736869,24
3,1091,21039,3578736845,3578736870,25
3,1091,21040,3578736845,3578736875,30
3,1091,21041,3578736845,3578736877,32
3,1091,21042,3578736845,3578736878,33
3,1091,21043,3578736845,3578736880,35
3,1091,21044,3578736845,3578736882,37
3,1091,21045,3578736845,3578736883,38
3,1091,21046,3578736845,3578736885,40
3,1091,21047,3578736845,3578736886,41
3,1091,21048,3578736845,3578736886,41
3,1091,21049,3578736845,3578736888,43
3,1091,21050,3578736845,3578736889,44
3,1091,21051,3578736845,3578736889,44
3,1091,21052,3578736845,3578736891,46
3,1091,21053,3578736845,3578736892,47
3,1091,21054,3578736845,3578736893,48
3,1091,21055,3578736845,3578736893,48
3,1091,21056,3578736845,3578736893,48
3,1091,21057,3578736845,3578736893,48
3,1092,21058,3578736905,3578736905,0
3,1092,21059,3578736905,3578736905,0
3,1092,21060,3578736905,3578736905,0
3,1092,21061,3578736905,3578736905,0
3,1092,21062,3578736905,3578736905,0
3,1092,21063,3578736905,3578736905,0
3,1092,21064,3578736905,3578736905,0
3,1092,21065,3578736905,3578736905,0
3,1092,21066,3578736905,3578736908,3
3,1092,21067,3578736905,3578736908,3
3,1092,21068,3578736905,3578736908,3
3,1092,21069,3578736905,3578736913,8
3,1092,21070,3578736905,3578736915,10
3,1092,21071,3578736905,3578736916,11
3,1092,21072,3578736905,3578736917,12
3,1092,21073,3578736905,3578736918,13
3,1092,21074,3578736905,3578736918,13
3,1092,21075,3578736905,3578736919,14
3,1092,21076,3578736905,3578736922,17
3,1092,21077,3578736905,3578736923,18
3,1092,21078,3578736905,3578736923,18
3,1092,21079,3578736905,3578736929,24
3,1092,21080,3578736905,3578736929,24
3,1092,21081,3578736905,3578736929,24
3,1092,21082,3578736905,3578736932,27
3,1092,21083,3578736905,3578736936,31
3,1092,21084,3578736905,3578736936,31
3,1092,21085,3578736905,3578736937,32
3,1092,21086,3578736905,3578736939,34
3,1092,21087,3578736905,3578736940,35
3,1092,21088,3578736905,3578736941,36
3,1092,21089,3578736905,3578736941,36
3,1092,21090,3578736905,3578736943,38
3,1092,21091,3578736905,3578736944,39
3,1092,21092,3578736905,3578736945,40
3,1092,21093,3578736905,3578736946,41
3,1092,21094,3578736905,3578736948,43
3,1092,21095,3578736905,3578736949,44
3,1092,21096,3578736905,3578736950,45
3,1092,21097,3578736905,3578736950,45
3,1092,21098,3578736905,3578736952,47
3,1092,21099,3578736905,3578736952,47
3,1092,21100,3578736905,3578736952,47
3,1092,21101,3578736905,3578736953,48
3,1092,21102,3578736905,3578736954,49
3,1093,21103,3578736966,3578736966,0
3,1093,21104,3578736966,3578736966,0
3,1093,21105,3578736966,3578736966,0
3,1093,21106,3578736966,3578736966,0
3,1093,21107,3578736966,3578736966,0
3,1093,21108,3578736966,3578736966,0
3,1093,21109,3578736966,3578736966,0
3,1093,21110,3578736966,3578736966,0
3,1093,21111,3578736966,3578736966,0
3,1093,21112,3578736966,3578736966,0
3,1093,21113,3578736966,3578736966,0
3,1093,21114,3578736966,3578736967,1
3,1093,21115,3578736966,3578736967,1
3,1093,21116,3578736966,3578736968,2
3,1093,21117,3578736966,3578736968,2
3,1093,21118,3578736966,3578736968,2
3,1093,21119,3578736966,3578736970,4
3,1093,21120,3578736966,3578736970,4
3,1093,21121,3578736966,3578736970,4
3,1093,21122,3578736966,3578736971,5
3,1093,21123,3578736966,3578736971,5
3,1093,21124,3578736966,3578736974,8
3,1093,21125,3578736966,3578736974,8
3,1093,21126,3578736966,3578736974,8
3,1093,21127,3578736966,3578736976,10
3,1093,21128,3578736966,3578736976,10
3,1093,21129,3578736966,3578736976,10
3,1093,21130,3578736966,3578736978,12
3,1093,21131,3578736966,3578736979,13
3,1093,21132,3578736966,3578736979,13
3,1093,21133,3578736966,3578736984,18
3,1093,21134,3578736966,3578736986,20
3,1093,21135,3578736966,3578736986,20
3,1093,21136,3578736966,3578736986,20
3,1093,21137,3578736966,3578736987,21
3,1093,21138,3578736966,3578736987,21
3,1093,21139,3578736966,3578736988,22
3,1093,21140,3578736966,3578736988,22
3,1093,21141,3578736966,3578736989,23
3,1093,21142,3578736966,3578736989,23
3,1093,21143,3578736966,3578736990,24
3,1093,21144,3578736966,3578736991,25
3,1093,21145,3578736966,3578736991,25
3,1093,21146,3578736966,3578736992,26
3,1093,21147,3578736966,3578736992,26
3,1093,21148,3578736966,3578736993,27
3,1093,21149,3578736966,3578736995,29
3,1093,21150,3578736966,3578736997,31
3,1093,21151,3578736966,3578736997,31
3,1093,21152,3578736966,3578736999,33
3,1093,21153,3578736966,3578737001,35
3,1093,21154,3578736966,3578737003,37
3,1093,21155,3578736966,3578737004,38
3,1093,21156,3578736966,3578737004,38
3,1093,21157,3578736966,3578737004,38
3,1093,21158,3578736966,3578737005,39
3,1093,21159,3578736966,3578737007,41
3,1093,21160,3578736966,3578737007,41
3,1093,21161,3578736966,3578737008,42
3,1093,21162,3578736966,3578737009,43
3,1093,21163,3578736966,3578737011,45
3,1093,21164,3578736966,3578737013,47
3,1093,21165,3578736966,3578737015,49
3,1093,21166,3578736966,3578737015,49
3,1094,21167,3578737028,3578737028,0
3,1094,21168,3578737028,3578737028,0
3,1094,21169,3578737028,3578737028,0
3,1094,21170,3578737028,3578737028,0
3,1094,21171,3578737028,3578737028,0
3,1094,21172,3578737028,3578737028,0
3,1094,21173,3578737028,3578737028,0
3,1094,21174,3578737028,3578737028,0
3,1094,21175,3578737028,3578737028,0
3,1094,21176,3578737028,3578737028,0
3,1094,21177,3578737028,3578737028,0
3,1094,21178,3578737028,3578737028,0
3,1094,21179,3578737028,3578737028,0
3,1094,21180,3578737028,3578737030,2
3,1094,21181,3578737028,3578737031,3
3,1094,21182,3578737028,3578737032,4
3,1094,21183,3578737028,3578737034,6
3,1094,21184,3578737028,3578737035,7
3,1094,21185,3578737028,3578737036,8
3,1094,21186,3578737028,3578737037,9
3,1094,21187,3578737028,3578737038,10
3,1094,21188,3578737028,3578737039,11
3,1094,21189,3578737028,3578737040,12
3,1094,21190,3578737028,3578737040,12
3,1094,21191,3578737028,3578737042,14
3,1094,21192,3578737028,3578737042,14
3,1094,21193,3578737028,3578737043,15
3,1094,21194,3578737028,3578737043,15
3,1094,21195,3578737028,3578737044,16
3,1094,21196,3578737028,3578737044,16
3,1094,21197,3578737028,3578737045,17
3,1094,21198,3578737028,3578737046,18
3,1094,21199,3578737028,3578737046,18
3,1094,21200,3578737028,3578737047,19
3,1094,21201,3578737028,3578737047,19
3,1094,21202,3578737028,3578737047,19
3,1094,21203,3578737028,3578737050,22
3,1094,21204,3578737028,3578737051,23
3,1094,21205,3578737028,3578737051,23
3,1094,21206,3578737028,3578737055,27
3,1094,21207,3578737028,3578737055,27
3,1094,21208,3578737028,3578737057,29
3,1094,21209,3578737028,3578737058,30
3,1094,21210,3578737028,3578737058,30
3,1094,21211,3578737028,3578737062,34
3,1094,21212,3578737028,3578737063,35
3,1094,21213,3578737028,3578737064,36
3,1094,21214,3578737028,3578737064,36
3,1094,21215,3578737028,3578737064,36
3,1094,21216,3578737028,3578737065,37
3,1094,21217,3578737028,3578737066,38
3,1094,21218,3578737028,3578737067,39
3,1094,21219,3578737028,3578737067,39
3,1094,21220,3578737028,3578737068,40
3,1094,21221,3578737028,3578737068,40
3,1094,21222,3578737028,3578737070,42
3,1094,21223,3578737028,3578737075,47
3,1094,21224,3578737028,3578737076,48
3,1095,21225,3578737089,3578737089,0
3,1095,21226,3578737089,3578737089,0
3,1095,21227,3578737089,3578737089,0
3,1095,21228,3578737089,3578737089,0
3,1095,21229,3578737089,3578737089,0
3,1095,21230,3578737089,3578737089,0
3,1095,21231,3578737089,3578737089,0
3,1095,21232,3578737089,3578737089,0
3,1095,21233,3578737089,3578737091,2
3,1095,21234,3578737089,3578737092,3
3,1095,21235,3578737089,3578737093,4
3,1095,21236,3578737089,3578737093,4
3,1095,21237,3578737089,3578737094,5
3,1095,21238,3578737089,3578737096,7
3,1095,21239,3578737089,3578737098,9
3,1095,21240,3578737089,3578737099,10
3,1095,21241,3578737089,3578737100,11
3,1095,21242,3578737089,3578737100,11
3,1095,21243,3578737089,3578737100,11
3,1095,21244,3578737089,3578737102,13
3,1095,21245,3578737089,3578737102,13
3,1095,21246,3578737089,3578737104,15
3,1095,21247,3578737089,3578737104,15
3,1095,21248,3578737089,3578737107,18
3,1095,21249,3578737089,3578737108,19
3,1095,21250,3578737089,3578737109,20
3,1095,21251,3578737089,3578737113,24
3,1095,21252,3578737089,3578737115,26
3,1095,21253,3578737089,3578737116,27
3,1095,21254,3578737089,3578737118,29
3,1095,21255,3578737089,3578737118,29
3,1095,21256,3578737089,3578737118,29
3,1095,21257,3578737089,3578737120,31
3,1095,21258,3578737089,3578737122,33
3,1095,21259,3578737089,3578737123,34
3,1095,21260,3578737089,3578737129,40
3,1095,21261,3578737089,3578737129,40
3,1095,21262,3578737089,3578737129,40
3,1095,21263,3578737089,3578737133,44
3,1095,21264,3578737089,3578737136,47
3,1095,21265,3578737089,3578737137,48
3,1095,21266,3578737089,3578737138,49
3,1095,21267,3578737089,3578737139,50
3,1096,21268,3578737152,3578737152,0
3,1096,21269,3578737152,3578737152,0
3,1096,21270,3578737152,3578737152,0
3,1096,21271,3578737152,3578737152,0
3,1096,21272,3578737152,3578737152,0
3,1096,21273,3578737152,3578737152,0
3,1096,21274,3578737152,3578737152,0
3,1096,21275,3578737152,3578737152,0
3,1096,21276,3578737152,3578737152,0
3,1096,21277,3578737152,3578737152,0
3,1096,21278,3578737152,3578737152,0
3,1096,21279,3578737152,3578737152,0
3,1096,21280,3578737152,3578737152,0
3,1096,21281,3578737152,3578737153,1
3,1096,21282,3578737152,3578737155,3
3,1096,21283,3578737152,3578737155,3
3,1096,21284,3578737152,3578737158,6
3,1096,21285,3578737152,3578737158,6
3,1096,21286,3578737152,3578737159,7
3,1096,21287,3578737152,3578737159,7
3,1096,21288,3578737152,3578737159,7
3,1096,21289,3578737152,3578737159,7
3,1096,21290,3578737152,3578737160,8
3,1096,21291,3578737152,3578737163,11
3,1096,21292,3578737152,3578737163,11
3,1096,21293,3578737152,3578737166,14
3,1096,21294,3578737152,3578737167,15
3,1096,21295,3578737152,3578737167,15
3,1096,21296,3578737152,3578737168,16
3,1096,21297,3578737152,3578737168,16
3,1096,21298,3578737152,3578737168,16
3,1096,21299,3578737152,3578737170,18
3,1096,21300,3578737152,3578737170,18
3,1096,21301,3578737152,3578737171,19
3,1096,21302,3578737152,3578737172,20
3,1096,21303,3578737152,3578737174,22
3,1096,21304,3578737152,3578737174,22
3,1096,21305,3578737152,3578737174,22
3,1096,21306,3578737152,3578737174,22
3,1096,21307,3578737152,3578737175,23
3,1096,21308,3578737152,3578737176,24
3,1096,21309,3578737152,3578737176,24
3,1096,21310,3578737152,3578737178,26
3,1096,21311,3578737152,3578737179,27
3,1096,21312,3578737152,3578737184,32
3,1096,21313,3578737152,3578737186,34
3,1096,21314,3578737152,3578737186,34
3,1096,21315,3578737152,3578737187,35
3,1096,21316,3578737152,3578737188,36
3,1096,21317,3578737152,3578737188,36
3,1096,21318,3578737152,3578737188,36
3,1096,21319,3578737152,3578737188,36
3,1096,21320,3578737152,3578737188,36
3,1096,21321,3578737152,3578737188,36
3,1096,21322,3578737152,3578737189,37
3,1096,21323,3578737152,3578737191,39
3,1096,21324,3578737152,3578737191,39
3,1096,21325,3578737152,3578737192,40
3,1096,21326,3578737152,3578737192,40
3,1096,21327,3578737152,3578737193,41
3,1096,21328,3578737152,3578737196,44
3,1096,21329,3578737152,3578737197,45
3,1096,21330,3578737152,3578737200,48
3,1096,21331,3578737152,3578737201,49
3,1096,21332,3578737152,3578737202,50
3,1097,21333,3578737212,3578737212,0
3,1097,21334,3578737212,3578737212,0
3,1097,21335,3578737212,3578737212,0
3,1097,21336,3578737212,3578737212,0
3,1097,21337,3578737212,3578737212,0
3,1097,21338,3578737212,3578737212,0
3,1097,21339,3578737212,3578737212,0
3,1097,21340,3578737212,3578737212,0
3,1097,21341,3578737212,3578737212,0
3,1097,21342,3578737212,3578737212,0
3,1097,21343,3578737212,3578737212,0
3,1097,21344,3578737212,3578737212,0
3,1097,21345,3578737212,3578737212,0
3,1097,21346,3578737212,3578737215,3
3,1097,21347,3578737212,3578737217,5
3,1097,21348,3578737212,3578737219,7
3,1097,21349,3578737212,3578737219,7
3,1097,21350,3578737212,3578737220,8
3,1097,21351,3578737212,3578737220,8
3,1097,21352,3578737212,3578737220,8
3,1097,21353,3578737212,3578737220,8
3,1097,21354,3578737212,3578737220,8
3,1097,21355,3578737212,3578737221,9
3,1097,21356,3578737212,3578737221,9
3,1097,21357,3578737212,3578737224,12
3,1097,21358,3578737212,3578737225,13
3,1097,21359,3578737212,3578737227,15
3,1097,21360,3578737212,3578737227,15
3,1097,21361,3578737212,3578737227,15
3,1097,21362,3578737212,3578737227,15
3,1097,21363,3578737212,3578737229,17
3,1097,21364,3578737212,3578737229,17
3,1097,21365,3578737212,3578737231,19
3,1097,21366,3578737212,3578737232,20
3,1097,21367,3578737212,3578737232,20
3,1097,21368,3578737212,3578737233,21
3,1097,21369,3578737212,3578737233,21
3,1097,21370,3578737212,3578737235,23
3,1097,21371,3578737212,3578737236,24
3,1097,21372,3578737212,3578737236,24
3,1097,21373,3578737212,3578737238,26
3,1097,21374,3578737212,3578737239,27
3,1097,21375,3578737212,3578737240,28
3,1097,21376,3578737212,3578737240,28
3,1097,21377,3578737212,3578737243,31
3,1097,21378,3578737212,3578737243,31
3,1097,21379,3578737212,3578737244,32
3,1097,21380,3578737212,3578737244,32
3,1097,21381,3578737212,3578737247,35
3,1097,21382,3578737212,3578737247,35
3,1097,21383,3578737212,3578737247,35
3,1097,21384,3578737212,3578737247,35
3,1097,21385,3578737212,3578737251,39
3,1097,21386,3578737212,3578737251,39
3,1097,21387,3578737212,3578737252,40
3,1097,21388,3578737212,3578737255,43
3,1097,21389,3578737212,3578737257,45
3,1097,21390,3578737212,3578737258,46
3,1097,21391,3578737212,3578737262,50
3,1098,21392,3578737272,3578737272,0
3,1098,21393,3578737272,3578737272,0
3,1098,21394,3578737272,3578737272,0
3,1098,21395,3578737272,3578737272,0
3,1098,21396,3578737272,3578737272,0
3,1098,21397,3578737272,3578737272,0
3,1098,21398,3578737272,3578737272,0
3,1098,21399,3578737272,3578737272,0
3,1098,21400,3578737272,3578737272,0
3,1098,21401,3578737272,3578737275,3
3,1098,21402,3578737272,3578737277,5
3,1098,21403,3578737272,3578737279,7
3,1098,21404,3578737272,3578737280,8
3,1098,21405,3578737272,3578737281,9
3,1098,21406,3578737272,3578737281,9
3,1098,21407,3578737272,3578737282,10
3,1098,21408,3578737272,3578737284,12
3,1098,21409,3578737272,3578737286,14
3,1098,21410,3578737272,3578737286,14
3,1098,21411,3578737272,3578737287,15
3,1098,21412,3578737272,3578737288,16
3,1098,21413,3578737272,3578737288,16
3,1098,21414,3578737272,3578737289,17
3,1098,21415,3578737272,3578737291,19
3,1098,21416,3578737272,3578737291,19
3,1098,21417,3578737272,3578737293,21
3,1098,21418,3578737272,3578737293,21
3,1098,21419,3578737272,3578737293,21
3,1098,21420,3578737272,3578737294,22
3,1098,21421,3578737272,3578737296,24
3,1098,21422,3578737272,3578737299,27
3,1098,21423,3578737272,3578737299,27
3,1098,21424,3578737272,3578737300,28
3,1098,21425,3578737272,3578737300,28
3,1098,21426,3578737272,3578737301,29
3,1098,21427,3578737272,3578737302,30
3,1098,21428,3578737272,3578737302,30
3,1098,21429,3578737272,3578737304,32
3,1098,21430,3578737272,3578737304,32
3,1098,21431,3578737272,3578737308,36
3,1098,21432,3578737272,3578737308,36
3,1098,21433,3578737272,3578737309,37
3,1098,21434,3578737272,3578737313,41
3,1098,21435,3578737272,3578737315,43
3,1098,21436,3578737272,3578737317,45
3,1098,21437,3578737272,3578737318,46
3,1098,21438,3578737272,3578737318,46
3,1098,21439,3578737272,3578737319,47
3,1098,21440,3578737272,3578737320,48
3,1098,21441,3578737272,3578737322,50
3,1099,21442,3578737333,3578737333,0
3,1099,21443,3578737333,3578737333,0
3,1099,21444,3578737333,3578737333,0
3,1099,21445,3578737333,3578737333,0
3,1099,21446,3578737333,3578737334,1
3,1099,21447,3578737333,3578737334,1
3,1099,21448,3578737333,3578737337,4
3,1099,21449,3578737333,3578737338,5
3,1099,21450,3578737333,3578737339,6
3,1099,21451,3578737333,3578737340,7
3,1099,21452,3578737333,3578737341,8
3,1099,21453,3578737333,3578737342,9
3,1099,21454,3578737333,3578737343,10
3,1099,21455,3578737333,3578737344,11
3,1099,21456,3578737333,3578737347,14
3,1099,21457,3578737333,3578737350,17
3,1099,21458,3578737333,3578737350,17
3,1099,21459,3578737333,3578737350,17
3,1099,21460,3578737333,3578737352,19
3,1099,21461,3578737333,3578737352,19
3,1099,21462,3578737333,3578737354,21
3,1099,21463,3578737333,3578737354,21
3,1099,21464,3578737333,3578737355,22
3,1099,21465,3578737333,3578737358,25
3,1099,21466,3578737333,3578737358,25
3,1099,21467,3578737333,3578737359,26
3,1099,21468,3578737333,3578737359,26
3,1099,21469,3578737333,3578737360,27
3,1099,21470,3578737333,3578737360,27
3,1099,21471,3578737333,3578737363,30
3,1099,21472,3578737333,3578737363,30
3,1099,21473,3578737333,3578737365,32
3,1099,21474,3578737333,3578737367,34
3,1099,21475,3578737333,3578737367,34
3,1099,21476,3578737333,3578737369,36
3,1099,21477,3578737333,3578737369,36
3,1099,21478,3578737333,3578737369,36
3,1099,21479,3578737333,3578737371,38
3,1099,21480,3578737333,3578737371,38
3,1099,21481,3578737333,3578737373,40
3,1099,21482,3578737333,3578737374,41
3,1099,21483,3578737333,3578737374,41
3,1099,21484,3578737333,3578737376,43
3,1099,21485,3578737333,3578737376,43
3,1099,21486,3578737333,3578737376,43
3,1099,21487,3578737333,3578737378,45
3,1099,21488,3578737333,3578737379,46
3,1100,21489,3578737396,3578737396,0
3,1100,21490,3578737396,3578737396,0
3,1100,21491,3578737396,3578737396,0
3,1100,21492,3578737396,3578737396,0
3,1100,21493,3578737396,3578737396,0
3,1100,21494,3578737396,3578737396,0
3,1100,21495,3578737396,3578737396,0
3,1100,21496,3578737396,3578737396,0
3,1100,21497,3578737396,3578737396,0
3,1100,21498,3578737396,3578737396,0
3,1100,21499,3578737396,3578737396,0
3,1100,21500,3578737396,3578737396,0
3,1100,21501,3578737396,3578737396,0
3,1100,21502,3578737396,3578737396,0
3,1100,21503,3578737396,3578737396,0
3,1100,21504,3578737396,3578737396,0
3,1100,21505,3578737396,3578737398,2
3,1100,21506,3578737396,3578737398,2
3,1100,21507,3578737396,3578737400,4
3,1100,21508,3578737396,3578737402,6
3,1100,21509,3578737396,3578737402,6
3,1100,21510,3578737396,3578737405,9
3,1100,21511,3578737396,3578737405,9
3,1100,21512,3578737396,3578737406,10
3,1100,21513,3578737396,3578737408,12
3,1100,21514,3578737396,3578737409,13
3,1100,21515,3578737396,3578737409,13
3,1100,21516,3578737396,3578737409,13
3,1100,21517,3578737396,3578737413,17
3,1100,21518,3578737396,3578737416,20
3,1100,21519,3578737396,3578737418,22
3,1100,21520,3578737396,3578737419,23
3,1100,21521,3578737396,3578737420,24
3,1100,21522,3578737396,3578737420,24
3,1100,21523,3578737396,3578737420,24
3,1100,21524,3578737396,3578737420,24
3,1100,21525,3578737396,3578737420,24
3,1100,21526,3578737396,3578737421,25
3,1100,21527,3578737396,3578737421,25
3,1100,21528,3578737396,3578737425,29
3,1100,21529,3578737396,3578737427,31
3,1100,21530,3578737396,3578737428,32
3,1100,21531,3578737396,3578737428,32
3,1100,21532,3578737396,3578737429,33
3,1100,21533,3578737396,3578737429,33
3,1100,21534,3578737396,3578737432,36
3,1100,21535,3578737396,3578737432,36
3,1100,21536,3578737396,3578737433,37
3,1100,21537,3578737396,3578737434,38
3,1100,21538,3578737396,3578737435,39
3,1100,21539,3578737396,3578737436,40
3,1100,21540,3578737396,3578737436,40
3,1100,21541,3578737396,3578737438,42
3,1100,21542,3578737396,3578737440,44
3,1100,21543,3578737396,3578737440,44
3,1100,21544,3578737396,3578737441,45
3,1100,21545,3578737396,3578737443,47
3,1100,21546,3578737396,3578737444,48
3,1100,21547,3578737396,3578737444,48
3,1100,21548,3578737396,3578737444,48
3,1100,21549,3578737396,3578737444,48
3,1100,21550,3578737396,3578737445,49
3,1101,21551,3578737456,3578737456,0
3,1101,21552,3578737456,3578737456,0
3,1101,21553,3578737456,3578737456,0
3,1101,21554,3578737456,3578737456,0
3,1101,21555,3578737456,3578737456,0
3,1101,21556,3578737456,3578737456,0
3,1101,21557,3578737456,3578737456,0
3,1101,21558,3578737456,3578737456,0
3,1101,21559,3578737456,3578737456,0
3,1101,21560,3578737456,3578737458,2
3,1101,21561,3578737456,3578737458,2
3,1101,21562,3578737456,3578737459,3
3,1101,21563,3578737456,3578737462,6
3,1101,21564,3578737456,3578737463,7
3,1101,21565,3578737456,3578737464,8
3,1101,21566,3578737456,3578737466,10
3,1101,21567,3578737456,3578737467,11
3,1101,21568,3578737456,3578737468,12
3,1101,21569,3578737456,3578737468,12
3,1101,21570,3578737456,3578737469,13
3,1101,21571,3578737456,3578737469,13
3,1101,21572,3578737456,3578737471,15
3,1101,21573,3578737456,3578737475,19
3,1101,21574,3578737456,3578737480,24
3,1101,21575,3578737456,3578737480,24
3,1101,21576,3578737456,3578737482,26
3,1101,21577,3578737456,3578737482,26
3,1101,21578,3578737456,3578737484,28
3,1101,21579,3578737456,3578737486,30
3,1101,21580,3578737456,3578737488,32
3,1101,21581,3578737456,3578737488,32
3,1101,21582,3578737456,3578737488,32
3,1101,21583,3578737456,3578737490,34
3,1101,21584,3578737456,3578737491,35
3,1101,21585,3578737456,3578737491,35
3,1101,21586,3578737456,3578737493,37
3,1101,21587,3578737456,3578737493,37
3,1101,21588,3578737456,3578737494,38
3,1101,21589,3578737456,3578737494,38
3,1101,21590,3578737456,3578737496,40
3,1101,21591,3578737456,3578737499,43
3,1101,21592,3578737456,3578737500,44
3,1101,21593,3578737456,3578737500,44
3,1101,21594,3578737456,3578737501,45
3,1101,21595,3578737456,3578737502,46
3,1101,21596,3578737456,3578737504,48
3,1101,21597,3578737456,3578737505,49
3,1102,21598,3578737515,3578737515,0
3,1102,21599,3578737515,3578737515,0
3,1102,21600,3578737515,3578737515,0
3,1102,21601,3578737515,3578737515,0
3,1102,21602,3578737515,3578737515,0
3,1102,21603,3578737515,3578737516,1
3,1102,21604,3578737515,3578737517,2
3,1102,21605,3578737515,3578737517,2
3,1102,21606,3578737515,3578737519,4
3,1102,21607,3578737515,3578737520,5
3,1102,21608,3578737515,3578737521,6
3,1102,21609,3578737515,3578737522,7
3,1102,21610,3578737515,3578737524,9
3,1102,21611,3578737515,3578737528,13
3,1102,21612,3578737515,3578737530,15
3,1102,21613,3578737515,3578737532,17
3,1102,21614,3578737515,3578737536,21
3,1102,21615,3578737515,3578737538,23
3,1102,21616,3578737515,3578737540,25
3,1102,21617,3578737515,3578737540,25
3,1102,21618,3578737515,3578737541,26
3,1102,21619,3578737515,3578737542,27
3,1102,21620,3578737515,3578737543,28
3,1102,21621,3578737515,3578737544,29
3,1102,21622,3578737515,3578737544,29
3,1102,21623,3578737515,3578737546,31
3,1102,21624,3578737515,3578737549,34
3,1102,21625,3578737515,3578737549,34
3,1102,21626,3578737515,3578737551,36
3,1102,21627,3578737515,3578737551,36
3,1102,21628,3578737515,3578737552,37
3,1102,21629,3578737515,3578737554,39
3,1102,21630,3578737515,3578737554,39
3,1102,21631,3578737515,3578737557,42
3,1102,21632,3578737515,3578737557,42
3,1102,21633,3578737515,3578737558,43
3,1102,21634,3578737515,3578737558,43
3,1102,21635,3578737515,3578737559,44
3,1102,21636,3578737515,3578737559,44
3,1102,21637,3578737515,3578737560,45
3,1102,21638,3578737515,3578737560,45
3,1102,21639,3578737515,3578737562,47
3,1102,21640,3578737515,3578737563,48
3,1103,21641,3578737574,3578737574,0
3,1103,21642,3578737574,3578737574,0
3,1103,21643,3578737574,3578737574,0
3,1103,21644,3578737574,3578737574,0
3,1103,21645,3578737574,3578737574,0
3,1103,21646,3578737574,3578737574,0
3,1103,21647,3578737574,3578737574,0
3,1103,21648,3578737574,3578737574,0
3,1103,21649,3578737574,3578737574,0
3,1103,21650,3578737574,3578737574,0
3,1103,21651,3578737574,3578737574,0
3,1103,21652,3578737574,3578737574,0
3,1103,21653,3578737574,3578737574,0
3,1103,21654,3578737574,3578737574,0
3,1103,21655,3578737574,3578737575,1
3,1103,21656,3578737574,3578737575,1
3,1103,21657,3578737574,3578737576,2
3,1103,21658,3578737574,3578737577,3
3,1103,21659,3578737574,3578737583,9
3,1103,21660,3578737574,3578737586,12
3,1103,21661,3578737574,3578737586,12
3,1103,21662,3578737574,3578737586,12
3,1103,21663,3578737574,3578737587,13
3,1103,21664,3578737574,3578737588,14
3,1103,21665,3578737574,3578737588,14
3,1103,21666,3578737574,3578737588,14
3,1103,21667,3578737574,3578737588,14
3,1103,21668,3578737574,3578737589,15
3,1103,21669,3578737574,3578737591,17
3,1103,21670,3578737574,3578737591,17
3,1103,21671,3578737574,3578737591,17
3,1103,21672,3578737574,3578737595,21
3,1103,21673,3578737574,3578737597,23
3,1103,21674,3578737574,3578737597,23
3,1103,21675,3578737574,3578737599,25
3,1103,21676,3578737574,3578737603,29
3,1103,21677,3578737574,3578737603,29
3,1103,21678,3578737574,3578737604,30
3,1103,21679,3578737574,3578737604,30
3,1103,21680,3578737574,3578737604,30
3,1103,21681,3578737574,3578737604,30
3,1103,21682,3578737574,3578737606,32
3,1103,21683,3578737574,3578737608,34
3,1103,21684,3578737574,3578737608,34
3,1103,21685,3578737574,3578737611,37
3,1103,21686,3578737574,3578737612,38
3,1103,21687,3578737574,3578737614,40
3,1103,21688,3578737574,3578737614,40
3,1103,21689,3578737574,3578737617,43
3,1103,21690,3578737574,3578737617,43
3,1103,21691,3578737574,3578737618,44
3,1103,21692,3578737574,3578737619,45
3,1103,21693,3578737574,3578737619,45
3,1103,21694,3578737574,3578737619,45
3,1103,21695,3578737574,3578737620,46
3,1103,21696,3578737574,3578737620,46
3,1103,21697,3578737574,3578737620,46
3,1103,21698,3578737574,3578737621,47
3,1103,21699,3578737574,3578737624,50
3,1104,21700,3578737636,3578737636,0
3,1104,21701,3578737636,3578737636,0
3,1104,21702,3578737636,3578737636,0
3,1104,21703,3578737636,3578737636,0
3,1104,21704,3578737636,3578737636,0
3,1104,21705,3578737636,3578737636,0
3,1104,21706,3578737636,3578737636,0
3,1104,21707,3578737636,3578737636,0
3,1104,21708,3578737636,3578737636,0
3,1104,21709,3578737636,3578737636,0
3,1104,21710,3578737636,3578737636,0
3,1104,21711,3578737636,3578737636,0
3,1104,21712,3578737636,3578737636,0
3,1104,21713,3578737636,3578737636,0
3,1104,21714,3578737636,3578737637,1
3,1104,21715,3578737636,3578737637,1
3,1104,21716,3578737636,3578737638,2
3,1104,21717,3578737636,3578737639,3
3,1104,21718,3578737636,3578737641,5
3,1104,21719,3578737636,3578737642,6
3,1104,21720,3578737636,3578737643,7
3,1104,21721,3578737636,3578737643,7
3,1104,21722,3578737636,3578737644,8
3,1104,21723,3578737636,3578737644,8
3,1104,21724,3578737636,3578737644,8
3,1104,21725,3578737636,3578737646,10
3,1104,21726,3578737636,3578737646,10
3,1104,21727,3578737636,3578737646,10
3,1104,21728,3578737636,3578737646,10
3,1104,21729,3578737636,3578737651,15
3,1104,21730,3578737636,3578737651,15
3,1104,21731,3578737636,3578737653,17
3,1104,21732,3578737636,3578737656,20
3,1104,21733,3578737636,3578737657,21
3,1104,21734,3578737636,3578737658,22
3,1104,21735,3578737636,3578737661,25
3,1104,21736,3578737636,3578737662,26
3,1104,21737,3578737636,3578737663,27
3,1104,21738,3578737636,3578737664,28
3,1104,21739,3578737636,3578737666,30
3,1104,21740,3578737636,3578737666,30
3,1104,21741,3578737636,3578737666,30
3,1104,21742,3578737636,3578737667,31
3,1104,21743,3578737636,3578737668,32
3,1104,21744,3578737636,3578737675,39
3,1104,21745,3578737636,3578737676,40
3,1104,21746,3578737636,3578737679,43
3,1104,21747,3578737636,3578737680,44
3,1104,21748,3578737636,3578737681,45
3,1104,21749,3578737636,3578737682,46
3,1104,21750,3578737636,3578737682,46
3,1104,21751,3578737636,3578737685,49
3,1104,21752,3578737636,3578737686,50
3,1105,21753,3578737698,3578737698,0
3,1105,21754,3578737698,3578737698,0
3,1105,21755,3578737698,3578737698,0
3,1105,21756,3578737698,3578737698,0
3,1105,21757,3578737698,3578737698,0
3,1105,21758,3578737698,3578737698,0
3,1105,21759,3578737698,3578737698,0
3,1105,21760,3578737698,3578737698,0
3,1105,21761,3578737698,3578737698,0
3,1105,21762,3578737698,3578737699,1
3,1105,21763,3578737698,3578737700,2
3,1105,21764,3578737698,3578737701,3
3,1105,21765,3578737698,3578737701,3
3,1105,21766,3578737698,3578737703,5
3,1105,21767,3578737698,3578737704,6
3,1105,21768,3578737698,3578737707,9
3,1105,21769,3578737698,3578737712,14
3,1105,21770,3578737698,3578737712,14
3,1105,21771,3578737698,3578737712,14
3,1105,21772,3578737698,3578737715,17
3,1105,21773,3578737698,3578737716,18
3,1105,21774,3578737698,3578737717,19
3,1105,21775,3578737698,3578737717,19
3,1105,21776,3578737698,3578737719,21
3,1105,21777,3578737698,3578737721,23
3,1105,21778,3578737698,3578737721,23
3,1105,21779,3578737698,3578737721,23
3,1105,21780,3578737698,3578737723,25
3,1105,21781,3578737698,3578737728,30
3,1105,21782,3578737698,3578737729,31
3,1105,21783,3578737698,3578737731,33
3,1105,21784,3578737698,3578737732,34
3,1105,21785,3578737698,3578737736,38
3,1105,21786,3578737698,3578737737,39
3,1105,21787,3578737698,3578737737,39
3,1105,21788,3578737698,3578737738,40
3,1105,21789,3578737698,3578737739,41
3,1105,21790,3578737698,3578737740,42
3,1105,21791,3578737698,3578737740,42
3,1105,21792,3578737698,3578737742,44
3,1105,21793,3578737698,3578737743,45
3,1105,21794,3578737698,3578737744,46
3,1105,21795,3578737698,3578737745,47
3,1106,21796,3578737759,3578737759,0
3,1106,21797,3578737759,3578737759,0
3,1106,21798,3578737759,3578737759,0
3,1106,21799,3578737759,3578737759,0
3,1106,21800,3578737759,3578737759,0
3,1106,21801,3578737759,3578737759,0
3,1106,21802,3578737759,3578737759,0
3,1106,21803,3578737759,3578737759,0
3,1106,21804,3578737759,3578737759,0
3,1106,21805,3578737759,3578737759,0
3,1106,21806,3578737759,3578737759,0
3,1106,21807,3578737759,3578737759,0
3,1106,21808,3578737759,3578737759,0
3,1106,21809,3578737759,3578737759,0
3,1106,21810,3578737759,3578737760,1
3,1106,21811,3578737759,3578737760,1
3,1106,21812,3578737759,3578737762,3
3,1106,21813,3578737759,3578737764,5
3,1106,21814,3578737759,3578737764,5
3,1106,21815,3578737759,3578737766,7
3,1106,21816,3578737759,3578737767,8
3,1106,21817,3578737759,3578737768,9
3,1106,21818,3578737759,3578737769,10
3,1106,21819,3578737759,3578737769,10
3,1106,21820,3578737759,3578737769,10
3,1106,21821,3578737759,3578737769,10
3,1106,21822,3578737759,3578737769,10
3,1106,21823,3578737759,3578737770,11
3,1106,21824,3578737759,3578737771,12
3,1106,21825,3578737759,3578737771,12
3,1106,21826,3578737759,3578737772,13
3,1106,21827,3578737759,3578737773,14
3,1106,21828,3578737759,3578737773,14
3,1106,21829,3578737759,3578737775,16
3,1106,21830,3578737759,3578737775,16
3,1106,21831,3578737759,3578737778,19
3,1106,21832,3578737759,3578737783,24
3,1106,21833,3578737759,3578737786,27
3,1106,21834,3578737759,3578737786,27
3,1106,21835,3578737759,3578737787,28
3,1106,21836,3578737759,3578737787,28
3,1106,21837,3578737759,3578737788,29
3,1106,21838,3578737759,3578737789,30
3,1106,21839,3578737759,3578737789,30
3,1106,21840,3578737759,3578737789,30
3,1106,21841,3578737759,3578737790,31
3,1106,21842,3578737759,3578737790,31
3,1106,21843,3578737759,3578737790,31
3,1106,21844,3578737759,3578737791,32
3,1106,21845,3578737759,3578737791,32
3,1106,21846,3578737759,3578737792,33
3,1106,21847,3578737759,3578737793,34
3,1106,21848,3578737759,3578737795,36
3,1106,21849,3578737759,3578737799,40
3,1106,21850,3578737759,3578737800,41
3,1106,21851,3578737759,3578737801,42
3,1106,21852,3578737759,3578737804,45
3,1106,21853,3578737759,3578737804,45
3,1106,21854,3578737759,3578737804,45
3,1106,21855,3578737759,3578737804,45
3,1106,21856,3578737759,3578737805,46
3,1106,21857,3578737759,3578737805,46
3,1106,21858,3578737759,3578737807,48
3,1106,21859,3578737759,3578737808,49
3,1106,21860,3578737759,3578737809,50
3,1106,21861,3578737759,3578737809,50
3,1107,21862,3578737821,3578737821,0
3,1107,21863,3578737821,3578737821,0
3,1107,21864,3578737821,3578737821,0
3,1107,21865,3578737821,3578737821,0
3,1107,21866,3578737821,3578737821,0
3,1107,21867,3578737821,3578737821,0
3,1107,21868,3578737821,3578737821,0
3,1107,21869,3578737821,3578737821,0
3,1107,21870,3578737821,3578737821,0
3,1107,21871,3578737821,3578737821,0
3,1107,21872,3578737821,3578737821,0
3,1107,21873,3578737821,3578737821,0
3,1107,21874,3578737821,3578737821,0
3,1107,21875,3578737821,3578737824,3
3,1107,21876,3578737821,3578737825,4
3,1107,21877,3578737821,3578737826,5
3,1107,21878,3578737821,3578737827,6
3,1107,21879,3578737821,3578737828,7
3,1107,21880,3578737821,3578737828,7
3,1107,21881,3578737821,3578737830,9
3,1107,21882,3578737821,3578737830,9
3,1107,21883,3578737821,3578737830,9
3,1107,21884,3578737821,3578737832,11
3,1107,21885,3578737821,3578737832,11
3,1107,21886,3578737821,3578737832,11
3,1107,21887,3578737821,3578737833,12
3,1107,21888,3578737821,3578737834,13
3,1107,21889,3578737821,3578737835,14
3,1107,21890,3578737821,3578737836,15
3,1107,21891,3578737821,3578737838,17
3,1107,21892,3578737821,3578737839,18
3,1107,21893,3578737821,3578737839,18
3,1107,21894,3578737821,3578737843,22
3,1107,21895,3578737821,3578737843,22
3,1107,21896,3578737821,3578737844,23
3,1107,21897,3578737821,3578737844,23
3,1107,21898,3578737821,3578737844,23
3,1107,21899,3578737821,3578737844,23
3,1107,21900,3578737821,3578737844,23
3,1107,21901,3578737821,3578737846,25
3,1107,21902,3578737821,3578737846,25
3,1107,21903,3578737821,3578737846,25
3,1107,21904,3578737821,3578737847,26
3,1107,21905,3578737821,3578737850,29
3,1107,21906,3578737821,3578737851,30
3,1107,21907,3578737821,3578737851,30
3,1107,21908,3578737821,3578737854,33
3,1107,21909,3578737821,3578737856,35
3,1107,21910,3578737821,3578737856,35
3,1107,21911,3578737821,3578737857,36
3,1107,21912,3578737821,3578737858,37
3,1107,21913,3578737821,3578737858,37
3,1107,21914,3578737821,3578737861,40
3,1107,21915,3578737821,3578737862,41
3,1107,21916,3578737821,3578737863,42
3,1107,21917,3578737821,3578737863,42
3,1107,21918,3578737821,3578737866,45
3,1107,21919,3578737821,3578737866,45
3,1107,21920,3578737821,3578737866,45
3,1107,21921,3578737821,3578737867,46
3,1107,21922,3578737821,3578737868,47
3,1107,21923,3578737821,3578737868,47
3,1107,21924,3578737821,3578737870,49
3,1108,21925,3578737882,3578737882,0
3,1108,21926,3578737882,3578737882,0
3,1108,21927,3578737882,3578737882,0
3,1108,21928,3578737882,3578737882,0
3,1108,21929,3578737882,3578737882,0
3,1108,21930,3578737882,3578737882,0
3,1108,21931,3578737882,3578737885,3
3,1108,21932,3578737882,3578737886,4
3,1108,21933,3578737882,3578737886,4
3,1108,21934,3578737882,3578737887,5
3,1108,21935,3578737882,3578737888,6
3,1108,21936,3578737882,3578737891,9
3,1108,21937,3578737882,3578737892,10
3,1108,21938,3578737882,3578737893,11
3,1108,21939,3578737882,3578737893,11
3,1108,21940,3578737882,3578737893,11
3,1108,21941,3578737882,3578737894,12
3,1108,21942,3578737882,3578737894,12
3,1108,21943,3578737882,3578737894,12
3,1108,21944,3578737882,3578737896,14
3,1108,21945,3578737882,3578737900,18
3,1108,21946,3578737882,3578737900,18
3,1108,21947,3578737882,3578737901,19
3,1108,21948,3578737882,3578737902,20
3,1108,21949,3578737882,3578737904,22
3,1108,21950,3578737882,3578737904,22
3,1108,21951,3578737882,3578737904,22
3,1108,21952,3578737882,3578737907,25
3,1108,21953,3578737882,3578737911,29
3,1108,21954,3578737882,3578737912,30
3,1108,21955,3578737882,3578737912,30
3,1108,21956,3578737882,3578737915,33
3,1108,21957,3578737882,3578737917,35
3,1108,21958,3578737882,3578737917,35
3,1108,21959,3578737882,3578737918,36
3,1108,21960,3578737882,3578737920,38
3,1108,21961,3578737882,3578737921,39
3,1108,21962,3578737882,3578737921,39
3,1108,21963,3578737882,3578737922,40
3,1108,21964,3578737882,3578737924,42
3,1108,21965,3578737882,3578737928,46
3,1108,21966,3578737882,3578737929,47
3,1108,21967,3578737882,3578737931,49
3,1108,21968,3578737882,3578737932,50
3,1109,21969,3578737942,3578737942,0
3,1109,21970,3578737942,3578737942,0
3,1109,21971,3578737942,3578737942,0
3,1109,21972,3578737942,3578737942,0
3,1109,21973,3578737942,3578737942,0
3,1109,21974,3578737942,3578737943,1
3,1109,21975,3578737942,3578737944,2
3,1109,21976,3578737942,3578737945,3
3,1109,21977,3578737942,3578737945,3
3,1109,21978,3578737942,3578737949,7
3,1109,21979,3578737942,3578737950,8
3,1109,21980,3578737942,3578737951,9
3,1109,21981,3578737942,3578737954,12
3,1109,21982,3578737942,3578737954,12
3,1109,21983,3578737942,3578737955,13
3,1109,21984,3578737942,3578737956,14
3,1109,21985,3578737942,3578737957,15
3,1109,21986,3578737942,3578737959,17
3,1109,21987,3578737942,3578737960,18
3,1109,21988,3578737942,3578737960,18
3,1109,21989,3578737942,3578737960,18
3,1109,21990,3578737942,3578737963,21
3,1109,21991,3578737942,3578737964,22
3,1109,21992,3578737942,3578737966,24
3,1109,21993,3578737942,3578737967,25
3,1109,21994,3578737942,3578737968,26
3,1109,21995,3578737942,3578737968,26
3,1109,21996,3578737942,3578737969,27
3,1109,21997,3578737942,3578737969,27
3,1109,21998,3578737942,3578737969,27
3,1109,21999,3578737942,3578737970,28
3,1109,22000,3578737942,3578737970,28
3,1109,22001,3578737942,3578737971,29
3,1109,22002,3578737942,3578737971,29
3,1109,22003,3578737942,3578737973,31
3,1109,22004,3578737942,3578737973,31
3,1109,22005,3578737942,3578737973,31
3,1109,22006,3578737942,3578737975,33
3,1109,22007,3578737942,3578737976,34
3,1109,22008,3578737942,3578737978,36
3,1109,22009,3578737942,3578737983,41
3,1109,22010,3578737942,3578737986,44
3,1109,22011,3578737942,3578737987,45
3,1109,22012,3578737942,3578737987,45
3,1109,22013,3578737942,3578737987,45
3,1109,22014,3578737942,3578737987,45
3,1109,22015,3578737942,3578737988,46
3,1109,22016,3578737942,3578737988,46
3,1109,22017,3578737942,3578737989,47
3,1109,22018,3578737942,3578737989,47
3,1109,22019,3578737942,3578737989,47
3,1109,22020,3578737942,3578737989,47
3,1109,22021,3578737942,3578737990,48
3,1109,22022,3578737942,3578737991,49
3,1109,22023,3578737942,3578737991,49
3,1109,22024,3578737942,3578737991,49
3,1109,22025,3578737942,3578737992,50
3,1110,22026,3578738003,3578738003,0
3,1110,22027,3578738003,3578738003,0
3,1110,22028,3578738003,3578738003,0
3,1110,22029,3578738003,3578738003,0
3,1110,22030,3578738003,3578738003,0
3,1110,22031,3578738003,3578738003,0
3,1110,22032,3578738003,3578738004,1
3,1110,22033,3578738003,3578738004,1
3,1110,22034,3578738003,3578738004,1
3,1110,22035,3578738003,3578738005,2
3,1110,22036,3578738003,3578738005,2
3,1110,22037,3578738003,3578738006,3
3,1110,22038,3578738003,3578738007,4
3,1110,22039,3578738003,3578738008,5
3,1110,22040,3578738003,3578738009,6
3,1110,22041,3578738003,3578738009,6
3,1110,22042,3578738003,3578738009,6
3,1110,22043,3578738003,3578738013,10
3,1110,22044,3578738003,3578738014,11
3,1110,22045,3578738003,3578738016,13
3,1110,22046,3578738003,3578738019,16
3,1110,22047,3578738003,3578738019,16
3,1110,22048,3578738003,3578738019,16
3,1110,22049,3578738003,3578738020,17
3,1110,22050,3578738003,3578738020,17
3,1110,22051,3578738003,3578738020,17
3,1110,22052,3578738003,3578738021,18
3,1110,22053,3578738003,3578738021,18
3,1110,22054,3578738003,3578738021,18
3,1110,22055,3578738003,3578738022,19
3,1110,22056,3578738003,3578738023,20
3,1110,22057,3578738003,3578738026,23
3,1110,22058,3578738003,3578738026,23
3,1110,22059,3578738003,3578738027,24
3,1110,22060,3578738003,3578738027,24
3,1110,22061,3578738003,3578738028,25
3,1110,22062,3578738003,3578738030,27
3,1110,22063,3578738003,3578738031,28
3,1110,22064,3578738003,3578738031,28
3,1110,22065,3578738003,3578738031,28
3,1110,22066,3578738003,3578738031,28
3,1110,22067,3578738003,3578738033,30
3,1110,22068,3578738003,3578738033,30
3,1110,22069,3578738003,3578738034,31
3,1110,22070,3578738003,3578738036,33
3,1110,22071,3578738003,3578738037,34
3,1110,22072,3578738003,3578738037,34
3,1110,22073,3578738003,3578738038,35
3,1110,22074,3578738003,3578738038,35
3,1110,22075,3578738003,3578738039,36
3,1110,22076,3578738003,3578738039,36
3,1110,22077,3578738003,3578738039,36
3,1110,22078,3578738003,3578738042,39
3,1110,22079,3578738003,3578738043,40
3,1110,22080,3578738003,3578738044,41
3,1110,22081,3578738003,3578738044,41
3,1110,22082,3578738003,3578738044,41
3,1110,22083,3578738003,3578738044,41
3,1110,22084,3578738003,3578738044,41
3,1110,22085,3578738003,3578738046,43
3,1110,22086,3578738003,3578738046,43
3,1110,22087,3578738003,3578738046,43
3,1110,22088,3578738003,3578738047,44
3,1110,22089,3578738003,3578738050,47
3,1110,22090,3578738003,3578738050,47
3,1110,22091,3578738003,3578738051,48
3,1111,22092,3578738062,3578738062,0
3,1111,22093,3578738062,3578738062,0
3,1111,22094,3578738062,3578738062,0
3,1111,22095,3578738062,3578738063,1
3,1111,22096,3578738062,3578738064,2
3,1111,22097,3578738062,3578738065,3
3,1111,22098,3578738062,3578738067,5
3,1111,22099,3578738062,3578738067,5
3,1111,22100,3578738062,3578738067,5
3,1111,22101,3578738062,3578738069,7
3,1111,22102,3578738062,3578738071,9
3,1111,22103,3578738062,3578738075,13
3,1111,22104,3578738062,3578738076,14
3,1111,22105,3578738062,3578738080,18
3,1111,22106,3578738062,3578738081,19
3,1111,22107,3578738062,3578738081,19
3,1111,22108,3578738062,3578738082,20
3,1111,22109,3578738062,3578738082,20
3,1111,22110,3578738062,3578738085,23
3,1111,22111,3578738062,3578738086,24
3,1111,22112,3578738062,3578738086,24
3,1111,22113,3578738062,3578738088,26
3,1111,22114,3578738062,3578738088,26
3,1111,22115,3578738062,3578738091,29
3,1111,22116,3578738062,3578738093,31
3,1111,22117,3578738062,3578738093,31
3,1111,22118,3578738062,3578738093,31
3,1111,22119,3578738062,3578738093,31
3,1111,22120,3578738062,3578738094,32
3,1111,22121,3578738062,3578738094,32
3,1111,22122,3578738062,3578738095,33
3,1111,22123,3578738062,3578738096,34
3,1111,22124,3578738062,3578738098,36
3,1111,22125,3578738062,3578738100,38
3,1111,22126,3578738062,3578738100,38
3,1111,22127,3578738062,3578738100,38
3,1111,22128,3578738062,3578738101,39
3,1111,22129,3578738062,3578738101,39
3,1111,22130,3578738062,3578738102,40
3,1111,22131,3578738062,3578738104,42
3,1111,22132,3578738062,3578738104,42
3,1111,22133,3578738062,3578738104,42
3,1111,22134,3578738062,3578738107,45
3,1111,22135,3578738062,3578738112,50
3,1112,22136,3578738127,3578738127,0
3,1112,22137,3578738127,3578738127,0
3,1112,22138,3578738127,3578738127,0
3,1112,22139,3578738127,3578738127,0
3,1112,22140,3578738127,3578738127,0
3,1112,22141,3578738127,3578738127,0
3,1112,22142,3578738127,3578738127,0
3,1112,22143,3578738127,3578738127,0
3,1112,22144,3578738127,3578738127,0
3,1112,22145,3578738127,3578738127,0
3,1112,22146,3578738127,3578738127,0
3,1112,22147,3578738127,3578738128,1
3,1112,22148,3578738127,3578738129,2
3,1112,22149,3578738127,3578738132,5
3,1112,22150,3578738127,3578738132,5
3,1112,22151,3578738127,3578738137,10
3,1112,22152,3578738127,3578738137,10
3,1112,22153,3578738127,3578738138,11
3,1112,22154,3578738127,3578738138,11
3,1112,22155,3578738127,3578738139,12
3,1112,22156,3578738127,3578738141,14
3,1112,22157,3578738127,3578738141,14
3,1112,22158,3578738127,3578738144,17
3,1112,22159,3578738127,3578738144,17
3,1112,22160,3578738127,3578738145,18
3,1112,22161,3578738127,3578738150,23
3,1112,22162,3578738127,3578738151,24
3,1112,22163,3578738127,3578738151,24
3,1112,22164,3578738127,3578738151,24
3,1112,22165,3578738127,3578738152,25
3,1112,22166,3578738127,3578738154,27
3,1112,22167,3578738127,3578738155,28
3,1112,22168,3578738127,3578738157,30
3,1112,22169,3578738127,3578738158,31
3,1112,22170,3578738127,3578738159,32
3,1112,22171,3578738127,3578738160,33
3,1112,22172,3578738127,3578738160,33
3,1112,22173,3578738127,3578738160,33
3,1112,22174,3578738127,3578738161,34
3,1112,22175,3578738127,3578738164,37
3,1112,22176,3578738127,3578738164,37
3,1112,22177,3578738127,3578738166,39
3,1112,22178,3578738127,3578738166,39
3,1112,22179,3578738127,3578738167,40
3,1112,22180,3578738127,3578738169,42
3,1112,22181,3578738127,3578738169,42
3,1112,22182,3578738127,3578738169,42
3,1112,22183,3578738127,3578738169,42
3,1112,22184,3578738127,3578738170,43
3,1112,22185,3578738127,3578738170,43
3,1112,22186,3578738127,3578738171,44
3,1112,22187,3578738127,3578738174,47
3,1112,22188,3578738127,3578738174,47
3,1112,22189,3578738127,3578738174,47
3,1112,22190,3578738127,3578738175,48
3,1112,22191,3578738127,3578738177,50
3,1113,22192,3578738188,3578738188,0
3,1113,22193,3578738188,3578738188,0
3,1113,22194,3578738188,3578738188,0
3,1113,22195,3578738188,3578738188,0
3,1113,22196,3578738188,3578738188,0
3,1113,22197,3578738188,3578738188,0
3,1113,22198,3578738188,3578738189,1
3,1113,22199,3578738188,3578738189,1
3,1113,22200,3578738188,3578738189,1
3,1113,22201,3578738188,3578738189,1
3,1113,22202,3578738188,3578738189,1
3,1113,22203,3578738188,3578738190,2
3,1113,22204,3578738188,3578738191,3
3,1113,22205,3578738188,3578738191,3
3,1113,22206,3578738188,3578738191,3
3,1113,22207,3578738188,3578738192,4
3,1113,22208,3578738188,3578738192,4
3,1113,22209,3578738188,3578738193,5
3,1113,22210,3578738188,3578738199,11
3,1113,22211,3578738188,3578738201,13
3,1113,22212,3578738188,3578738204,16
3,1113,22213,3578738188,3578738204,16
3,1113,22214,3578738188,3578738204,16
3,1113,22215,3578738188,3578738204,16
3,1113,22216,3578738188,3578738205,17
3,1113,22217,3578738188,3578738206,18
3,1113,22218,3578738188,3578738207,19
3,1113,22219,3578738188,3578738209,21
3,1113,22220,3578738188,3578738209,21
3,1113,22221,3578738188,3578738209,21
3,1113,22222,3578738188,3578738210,22
3,1113,22223,3578738188,3578738213,25
3,1113,22224,3578738188,3578738214,26
3,1113,22225,3578738188,3578738216,28
3,1113,22226,3578738188,3578738220,32
3,1113,22227,3578738188,3578738220,32
3,1113,22228,3578738188,3578738220,32
3,1113,22229,3578738188,3578738220,32
3,1113,22230,3578738188,3578738220,32
3,1113,22231,3578738188,3578738220,32
3,1113,22232,3578738188,3578738221,33
3,1113,22233,3578738188,3578738221,33
3,1113,22234,3578738188,3578738222,34
3,1113,22235,3578738188,3578738224,36
3,1113,22236,3578738188,3578738226,38
3,1113,22237,3578738188,3578738227,39
3,1113,22238,3578738188,3578738227,39
3,1113,22239,3578738188,3578738227,39
3,1113,22240,3578738188,3578738231,43
3,1113,22241,3578738188,3578738232,44
3,1113,22242,3578738188,3578738233,45
3,1113,22243,3578738188,3578738233,45
3,1113,22244,3578738188,3578738235,47
3,1113,22245,3578738188,3578738237,49
3,1114,22246,3578738250,3578738250,0
3,1114,22247,3578738250,3578738250,0
3,1114,22248,3578738250,3578738250,0
3,1114,22249,3578738250,3578738250,0
3,1114,22250,3578738250,3578738250,0
3,1114,22251,3578738250,3578738250,0
3,1114,22252,3578738250,3578738250,0
3,1114,22253,3578738250,3578738250,0
3,1114,22254,3578738250,3578738250,0
3,1114,22255,3578738250,3578738250,0
3,1114,22256,3578738250,3578738250,0
3,1114,22257,3578738250,3578738250,0
3,1114,22258,3578738250,3578738250,0
3,1114,22259,3578738250,3578738250,0
3,1114,22260,3578738250,3578738250,0
3,1114,22261,3578738250,3578738250,0
3,1114,22262,3578738250,3578738250,0
3,1114,22263,3578738250,3578738250,0
3,1114,22264,3578738250,3578738251,1
3,1114,22265,3578738250,3578738251,1
3,1114,22266,3578738250,3578738251,1
3,1114,22267,3578738250,3578738257,7
3,1114,22268,3578738250,3578738257,7
3,1114,22269,3578738250,3578738257,7
3,1114,22270,3578738250,3578738258,8
3,1114,22271,3578738250,3578738262,12
3,1114,22272,3578738250,3578738263,13
3,1114,22273,3578738250,3578738263,13
3,1114,22274,3578738250,3578738264,14
3,1114,22275,3578738250,3578738265,15
3,1114,22276,3578738250,3578738267,17
3,1114,22277,3578738250,3578738267,17
3,1114,22278,3578738250,3578738268,18
3,1114,22279,3578738250,3578738270,20
3,1114,22280,3578738250,3578738272,22
3,1114,22281,3578738250,3578738275,25
3,1114,22282,3578738250,3578738280,30
3,1114,22283,3578738250,3578738281,31
3,1114,22284,3578738250,3578738281,31
3,1114,22285,3578738250,3578738282,32
3,1114,22286,3578738250,3578738285,35
3,1114,22287,3578738250,3578738286,36
3,1114,22288,3578738250,3578738286,36
3,1114,22289,3578738250,3578738288,38
3,1114,22290,3578738250,3578738288,38
3,1114,22291,3578738250,3578738291,41
3,1114,22292,3578738250,3578738292,42
3,1114,22293,3578738250,3578738293,43
3,1114,22294,3578738250,3578738294,44
3,1114,22295,3578738250,3578738294,44
3,1114,22296,3578738250,3578738294,44
3,1114,22297,3578738250,3578738295,45
3,1114,22298,3578738250,3578738296,46
3,1114,22299,3578738250,3578738297,47
3,1114,22300,3578738250,3578738300,50
3,1115,22301,3578738309,3578738309,0
3,1115,22302,3578738309,3578738309,0
3,1115,22303,3578738309,3578738309,0
3,1115,22304,3578738309,3578738309,0
3,1115,22305,3578738309,3578738309,0
3,1115,22306,3578738309,3578738309,0
3,1115,22307,3578738309,3578738309,0
3,1115,22308,3578738309,3578738309,0
3,1115,22309,3578738309,3578738311,2
3,1115,22310,3578738309,3578738313,4
3,1115,22311,3578738309,3578738313,4
3,1115,22312,3578738309,3578738317,8
3,1115,22313,3578738309,3578738318,9
3,1115,22314,3578738309,3578738319,10
3,1115,22315,3578738309,3578738319,10
3,1115,22316,3578738309,3578738320,11
3,1115,22317,3578738309,3578738321,12
3,1115,22318,3578738309,3578738322,13
3,1115,22319,3578738309,3578738326,17
3,1115,22320,3578738309,3578738328,19
3,1115,22321,3578738309,3578738329,20
3,1115,22322,3578738309,3578738332,23
3,1115,22323,3578738309,3578738333,24
3,1115,22324,3578738309,3578738336,27
3,1115,22325,3578738309,3578738337,28
3,1115,22326,3578738309,3578738338,29
3,1115,22327,3578738309,3578738339,30
3,1115,22328,3578738309,3578738341,32
3,1115,22329,3578738309,3578738341,32
3,1115,22330,3578738309,3578738341,32
3,1115,22331,3578738309,3578738344,35
3,1115,22332,3578738309,3578738344,35
3,1115,22333,3578738309,3578738344,35
3,1115,22334,3578738309,3578738346,37
3,1115,22335,3578738309,3578738350,41
3,1115,22336,3578738309,3578738351,42
3,1115,22337,3578738309,3578738352,43
3,1115,22338,3578738309,3578738353,44
3,1115,22339,3578738309,3578738354,45
3,1115,22340,3578738309,3578738355,46
3,1115,22341,3578738309,3578738356,47
3,1115,22342,3578738309,3578738357,48
3,1115,22343,3578738309,3578738357,48
3,1116,22344,3578738372,3578738372,0
3,1116,22345,3578738372,3578738372,0
3,1116,22346,3578738372,3578738372,0
3,1116,22347,3578738372,3578738372,0
3,1116,22348,3578738372,3578738372,0
3,1116,22349,3578738372,3578738372,0
3,1116,22350,3578738372,3578738372,0
3,1116,22351,3578738372,3578738372,0
3,1116,22352,3578738372,3578738372,0
3,1116,22353,3578738372,3578738372,0
3,1116,22354,3578738372,3578738372,0
3,1116,22355,3578738372,3578738372,0
3,1116,22356,3578738372,3578738372,0
3,1116,22357,3578738372,3578738372,0
3,1116,22358,3578738372,3578738372,0
3,1116,22359,3578738372,3578738372,0
3,1116,22360,3578738372,3578738372,0
3,1116,22361,3578738372,3578738375,3
3,1116,22362,3578738372,3578738375,3
3,1116,22363,3578738372,3578738375,3
3,1116,22364,3578738372,3578738376,4
3,1116,22365,3578738372,3578738377,5
3,1116,22366,3578738372,3578738379,7
3,1116,22367,3578738372,3578738384,12
3,1116,22368,3578738372,3578738386,14
3,1116,22369,3578738372,3578738387,15
3,1116,22370,3578738372,3578738388,16
3,1116,22371,3578738372,3578738388,16
3,1116,22372,3578738372,3578738388,16
3,1116,22373,3578738372,3578738388,16
3,1116,22374,3578738372,3578738388,16
3,1116,22375,3578738372,3578738389,17
3,1116,22376,3578738372,3578738389,17
3,1116,22377,3578738372,3578738389,17
3,1116,22378,3578738372,3578738390,18
3,1116,22379,3578738372,3578738390,18
3,1116,22380,3578738372,3578738391,19
3,1116,22381,3578738372,3578738391,19
3,1116,22382,3578738372,3578738391,19
3,1116,22383,3578738372,3578738391,19
3,1116,22384,3578738372,3578738394,22
3,1116,22385,3578738372,3578738395,23
3,1116,22386,3578738372,3578738398,26
3,1116,22387,3578738372,3578738399,27
3,1116,22388,3578738372,3578738401,29
3,1116,22389,3578738372,3578738404,32
3,1116,22390,3578738372,3578738404,32
3,1116,22391,3578738372,3578738404,32
3,1116,22392,3578738372,3578738405,33
3,1116,22393,3578738372,3578738405,33
3,1116,22394,3578738372,3578738406,34
3,1116,22395,3578738372,3578738406,34
3,1116,22396,3578738372,3578738408,36
3,1116,22397,3578738372,3578738408,36
3,1116,22398,3578738372,3578738409,37
3,1116,22399,3578738372,3578738409,37
3,1116,22400,3578738372,3578738410,38
3,1116,22401,3578738372,3578738411,39
3,1116,22402,3578738372,3578738412,40
3,1116,22403,3578738372,3578738415,43
3,1116,22404,3578738372,3578738416,44
3,1116,22405,3578738372,3578738420,48
3,1116,22406,3578738372,3578738420,48
3,1116,22407,3578738372,3578738420,48
3,1116,22408,3578738372,3578738421,49
3,1116,22409,3578738372,3578738421,49
3,1116,22410,3578738372,3578738421,49
3,1116,22411,3578738372,3578738421,49
3,1116,22412,3578738372,3578738422,50
3,1117,22413,3578738433,3578738433,0
3,1117,22414,3578738433,3578738433,0
3,1117,22415,3578738433,3578738433,0
3,1117,22416,3578738433,3578738433,0
3,1117,22417,3578738433,3578738433,0
3,1117,22418,3578738433,3578738433,0
3,1117,22419,3578738433,3578738433,0
3,1117,22420,3578738433,3578738433,0
3,1117,22421,3578738433,3578738433,0
3,1117,22422,3578738433,3578738433,0
3,1117,22423,3578738433,3578738433,0
3,1117,22424,3578738433,3578738433,0
3,1117,22425,3578738433,3578738434,1
3,1117,22426,3578738433,3578738434,1
3,1117,22427,3578738433,3578738435,2
3,1117,22428,3578738433,3578738437,4
3,1117,22429,3578738433,3578738437,4
3,1117,22430,3578738433,3578738437,4
3,1117,22431,3578738433,3578738440,7
3,1117,22432,3578738433,3578738441,8
3,1117,22433,3578738433,3578738441,8
3,1117,22434,3578738433,3578738443,10
3,1117,22435,3578738433,3578738444,11
3,1117,22436,3578738433,3578738444,11
3,1117,22437,3578738433,3578738444,11
3,1117,22438,3578738433,3578738444,11
3,1117,22439,3578738433,3578738445,12
3,1117,22440,3578738433,3578738446,13
3,1117,22441,3578738433,3578738446,13
3,1117,22442,3578738433,3578738447,14
3,1117,22443,3578738433,3578738447,14
3,1117,22444,3578738433,3578738450,17
3,1117,22445,3578738433,3578738451,18
3,1117,22446,3578738433,3578738452,19
3,1117,22447,3578738433,3578738457,24
3,1117,22448,3578738433,3578738458,25
3,1117,22449,3578738433,3578738462,29
3,1117,22450,3578738433,3578738464,31
3,1117,22451,3578738433,3578738464,31
3,1117,22452,3578738433,3578738464,31
3,1117,22453,3578738433,3578738466,33
3,1117,22454,3578738433,3578738467,34
3,1117,22455,3578738433,3578738468,35
3,1117,22456,3578738433,3578738471,38
3,1117,22457,3578738433,3578738475,42
3,1117,22458,3578738433,3578738476,43
3,1117,22459,3578738433,3578738480,47
3,1117,22460,3578738433,3578738481,48
3,1117,22461,3578738433,3578738481,48
3,1117,22462,3578738433,3578738482,49
3,1118,22463,3578738492,3578738492,0
3,1118,22464,3578738492,3578738492,0
3,1118,22465,3578738492,3578738492,0
3,1118,22466,3578738492,3578738492,0
3,1118,22467,3578738492,3578738492,0
3,1118,22468,3578738492,3578738492,0
3,1118,22469,3578738492,3578738492,0
3,1118,22470,3578738492,3578738492,0
3,1118,22471,3578738492,3578738493,1
3,1118,22472,3578738492,3578738493,1
3,1118,22473,3578738492,3578738494,2
3,1118,22474,3578738492,3578738494,2
3,1118,22475,3578738492,3578738495,3
3,1118,22476,3578738492,3578738495,3
3,1118,22477,3578738492,3578738495,3
3,1118,22478,3578738492,3578738497,5
3,1118,22479,3578738492,3578738500,8
3,1118,22480,3578738492,3578738501,9
3,1118,22481,3578738492,3578738501,9
3,1118,22482,3578738492,3578738503,11
3,1118,22483,3578738492,3578738503,11
3,1118,22484,3578738492,3578738503,11
3,1118,22485,3578738492,3578738503,11
3,1118,22486,3578738492,3578738507,15
3,1118,22487,3578738492,3578738511,19
3,1118,22488,3578738492,3578738512,20
3,1118,22489,3578738492,3578738513,21
3,1118,22490,3578738492,3578738517,25
3,1118,22491,3578738492,3578738518,26
3,1118,22492,3578738492,3578738518,26
3,1118,22493,3578738492,3578738519,27
3,1118,22494,3578738492,3578738519,27
3,1118,22495,3578738492,3578738520,28
3,1118,22496,3578738492,3578738521,29
3,1118,22497,3578738492,3578738521,29
3,1118,22498,3578738492,3578738523,31
3,1118,22499,3578738492,3578738526,34
3,1118,22500,3578738492,3578738529,37
3,1118,22501,3578738492,3578738531,39
3,1118,22502,3578738492,3578738532,40
3,1118,22503,3578738492,3578738536,44
3,1118,22504,3578738492,3578738537,45
3,1118,22505,3578738492,3578738537,45
3,1118,22506,3578738492,3578738538,46
3,1118,22507,3578738492,3578738540,48
3,1118,22508,3578738492,3578738541,49
3,1118,22509,3578738492,3578738541,49
3,1118,22510,3578738492,3578738541,49
3,1119,22511,3578738553,3578738553,0
3,1119,22512,3578738553,3578738553,0
3,1119,22513,3578738553,3578738553,0
3,1119,22514,3578738553,3578738553,0
3,1119,22515,3578738553,3578738553,0
3,1119,22516,3578738553,3578738553,0
3,1119,22517,3578738553,3578738553,0
3,1119,22518,3578738553,3578738553,0
3,1119,22519,3578738553,3578738553,0
3,1119,22520,3578738553,3578738553,0
3,1119,22521,3578738553,3578738555,2
3,1119,22522,3578738553,3578738555,2
3,1119,22523,3578738553,3578738556,3
3,1119,22524,3578738553,3578738558,5
3,1119,22525,3578738553,3578738559,6
3,1119,22526,3578738553,3578738559,6
3,1119,22527,3578738553,3578738561,8
3,1119,22528,3578738553,3578738561,8
3,1119,22529,3578738553,3578738565,12
3,1119,22530,3578738553,3578738566,13
3,1119,22531,3578738553,3578738566,13
3,1119,22532,3578738553,3578738568,15
3,1119,22533,3578738553,3578738568,15
3,1119,22534,3578738553,3578738569,16
3,1119,22535,3578738553,3578738569,16
3,1119,22536,3578738553,3578738570,17
3,1119,22537,3578738553,3578738571,18
3,1119,22538,3578738553,3578738571,18
3,1119,22539,3578738553,3578738573,20
3,1119,22540,3578738553,3578738573,20
3,1119,22541,3578738553,3578738574,21
3,1119,22542,3578738553,3578738574,21
3,1119,22543,3578738553,3578738575,22
3,1119,22544,3578738553,3578738575,22
3,1119,22545,3578738553,3578738576,23
3,1119,22546,3578738553,3578738578,25
3,1119,22547,3578738553,3578738583,30
3,1119,22548,3578738553,3578738585,32
3,1119,22549,3578738553,3578738586,33
3,1119,22550,3578738553,3578738588,35
3,1119,22551,3578738553,3578738588,35
3,1119,22552,3578738553,3578738588,35
3,1119,22553,3578738553,3578738588,35
3,1119,22554,3578738553,3578738588,35
3,1119,22555,3578738553,3578738588,35
3,1119,22556,3578738553,3578738588,35
3,1119,22557,3578738553,3578738589,36
3,1119,22558,3578738553,3578738590,37
3,1119,22559,3578738553,3578738590,37
3,1119,22560,3578738553,3578738590,37
3,1119,22561,3578738553,3578738591,38
3,1119,22562,3578738553,3578738592,39
3,1119,22563,3578738553,3578738593,40
3,1119,22564,3578738553,3578738595,42
3,1119,22565,3578738553,3578738596,43
3,1119,22566,3578738553,3578738598,45
3,1119,22567,3578738553,3578738601,48
3,1120,22568,3578738613,3578738613,0
3,1120,22569,3578738613,3578738613,0
3,1120,22570,3578738613,3578738613,0
3,1120,22571,3578738613,3578738613,0
3,1120,22572,3578738613,3578738613,0
3,1120,22573,3578738613,3578738613,0
3,1120,22574,3578738613,3578738613,0
3,1120,22575,3578738613,3578738613,0
3,1120,22576,3578738613,3578738613,0
3,1120,22577,3578738613,3578738613,0
3,1120,22578,3578738613,3578738613,0
3,1120,22579,3578738613,3578738613,0
3,1120,22580,3578738613,3578738613,0
3,1120,22581,3578738613,3578738614,1
3,1120,22582,3578738613,3578738615,2
3,1120,22583,3578738613,3578738619,6
3,1120,22584,3578738613,3578738619,6
3,1120,22585,3578738613,3578738619,6
3,1120,22586,3578738613,3578738619,6
3,1120,22587,3578738613,3578738620,7
3,1120,22588,3578738613,3578738621,8
3,1120,22589,3578738613,3578738622,9
3,1120,22590,3578738613,3578738622,9
3,1120,22591,3578738613,3578738625,12
3,1120,22592,3578738613,3578738626,13
3,1120,22593,3578738613,3578738627,14
3,1120,22594,3578738613,3578738627,14
3,1120,22595,3578738613,3578738628,15
3,1120,22596,3578738613,3578738629,16
3,1120,22597,3578738613,3578738629,16
3,1120,22598,3578738613,3578738631,18
3,1120,22599,3578738613,3578738632,19
3,1120,22600,3578738613,3578738632,19
3,1120,22601,3578738613,3578738632,19
3,1120,22602,3578738613,3578738633,20
3,1120,22603,3578738613,3578738635,22
3,1120,22604,3578738613,3578738635,22
3,1120,22605,3578738613,3578738636,23
3,1120,22606,3578738613,3578738637,24
3,1120,22607,3578738613,3578738639,26
3,1120,22608,3578738613,3578738640,27
3,1120,22609,3578738613,3578738640,27
3,1120,22610,3578738613,3578738642,29
3,1120,22611,3578738613,3578738643,30
3,1120,22612,3578738613,3578738643,30
3,1120,22613,3578738613,3578738643,30
3,1120,22614,3578738613,3578738644,31
3,1120,22615,3578738613,3578738644,31
3,1120,22616,3578738613,3578738645,32
3,1120,22617,3578738613,3578738645,32
3,1120,22618,3578738613,3578738645,32
3,1120,22619,3578738613,3578738645,32
3,1120,22620,3578738613,3578738646,33
3,1120,22621,3578738613,3578738647,34
3,1120,22622,3578738613,3578738647,34
3,1120,22623,3578738613,3578738650,37
3,1120,22624,3578738613,3578738650,37
3,1120,22625,3578738613,3578738652,39
3,1120,22626,3578738613,3578738656,43
3,1120,22627,3578738613,3578738656,43
3,1120,22628,3578738613,3578738656,43
3,1120,22629,3578738613,3578738657,44
3,1120,22630,3578738613,3578738657,44
3,1120,22631,3578738613,3578738657,44
3,1120,22632,3578738613,3578738662,49
3,1120,22633,3578738613,3578738663,50
3,1121,22634,3578738673,3578738673,0
3,1121,22635,3578738673,3578738673,0
3,1121,22636,3578738673,3578738673,0
3,1121,22637,3578738673,3578738673,0
3,1121,22638,3578738673,3578738673,0
3,1121,22639,3578738673,3578738673,0
3,1121,22640,3578738673,3578738673,0
3,1121,22641,3578738673,3578738676,3
3,1121,22642,3578738673,3578738680,7
3,1121,22643,3578738673,3578738680,7
3,1121,22644,3578738673,3578738682,9
3,1121,22645,3578738673,3578738682,9
3,1121,22646,3578738673,3578738685,12
3,1121,22647,3578738673,3578738685,12
3,1121,22648,3578738673,3578738688,15
3,1121,22649,3578738673,3578738688,15
3,1121,22650,3578738673,3578738690,17
3,1121,22651,3578738673,3578738694,21
3,1121,22652,3578738673,3578738694,21
3,1121,22653,3578738673,3578738695,22
3,1121,22654,3578738673,3578738695,22
3,1121,22655,3578738673,3578738695,22
3,1121,22656,3578738673,3578738696,23
3,1121,22657,3578738673,3578738696,23
3,1121,22658,3578738673,3578738698,25
3,1121,22659,3578738673,3578738699,26
3,1121,22660,3578738673,3578738700,27
3,1121,22661,3578738673,3578738700,27
3,1121,22662,3578738673,3578738701,28
3,1121,22663,3578738673,3578738703,30
3,1121,22664,3578738673,3578738703,30
3,1121,22665,3578738673,3578738703,30
3,1121,22666,3578738673,3578738703,30
3,1121,22667,3578738673,3578738707,34
3,1121,22668,3578738673,3578738711,38
3,1121,22669,3578738673,3578738712,39
3,1121,22670,3578738673,3578738713,40
3,1121,22671,3578738673,3578738716,43
3,1121,22672,3578738673,3578738718,45
3,1121,22673,3578738673,3578738718,45
3,1121,22674,3578738673,3578738719,46
3,1121,22675,3578738673,3578738720,47
3,1121,22676,3578738673,3578738721,48
3,1121,22677,3578738673,3578738722,49
3,1122,22678,3578738735,3578738735,0
3,1122,22679,3578738735,3578738735,0
3,1122,22680,3578738735,3578738735,0
3,1122,22681,3578738735,3578738735,0
3,1122,22682,3578738735,3578738735,0
3,1122,22683,3578738735,3578738735,0
3,1122,22684,3578738735,3578738737,2
3,1122,22685,3578738735,3578738737,2
3,1122,22686,3578738735,3578738738,3
3,1122,22687,3578738735,3578738739,4
3,1122,22688,3578738735,3578738740,5
3,1122,22689,3578738735,3578738741,6
3,1122,22690,3578738735,3578738741,6
3,1122,22691,3578738735,3578738744,9
3,1122,22692,3578738735,3578738744,9
3,1122,22693,3578738735,3578738745,10
3,1122,22694,3578738735,3578738746,11
3,1122,22695,3578738735,3578738749,14
3,1122,22696,3578738735,3578738749,14
3,1122,22697,3578738735,3578738752,17
3,1122,22698,3578738735,3578738753,18
3,1122,22699,3578738735,3578738754,19
3,1122,22700,3578738735,3578738755,20
3,1122,22701,3578738735,3578738756,21
3,1122,22702,3578738735,3578738758,23
3,1122,22703,3578738735,3578738758,23
3,1122,22704,3578738735,3578738759,24
3,1122,22705,3578738735,3578738760,25
3,1122,22706,3578738735,3578738761,26
3,1122,22707,3578738735,3578738762,27
3,1122,22708,3578738735,3578738763,28
3,1122,22709,3578738735,3578738765,30
3,1122,22710,3578738735,3578738767,32
3,1122,22711,3578738735,3578738768,33
3,1122,22712,3578738735,3578738768,33
3,1122,22713,3578738735,3578738768,33
3,1122,22714,3578738735,3578738769,34
3,1122,22715,3578738735,3578738769,34
3,1122,22716,3578738735,3578738769,34
3,1122,22717,3578738735,3578738771,36
3,1122,22718,3578738735,3578738771,36
3,1122,22719,3578738735,3578738774,39
3,1122,22720,3578738735,3578738774,39
3,1122,22721,3578738735,3578738774,39
3,1122,22722,3578738735,3578738774,39
3,1122,22723,3578738735,3578738775,40
3,1122,22724,3578738735,3578738777,42
3,1122,22725,3578738735,3578738779,44
3,1122,22726,3578738735,3578738783,48
3,1123,22727,3578738799,3578738799,0
3,1123,22728,3578738799,3578738799,0
3,1123,22729,3578738799,3578738799,0
3,1123,22730,3578738799,3578738799,0
3,1123,22731,3578738799,3578738799,0
3,1123,22732,3578738799,3578738799,0
3,1123,22733,3578738799,3578738799,0
3,1123,22734,3578738799,3578738799,0
3,1123,22735,3578738799,3578738799,0
3,1123,22736,3578738799,3578738799,0
3,1123,22737,3578738799,3578738800,1
3,1123,22738,3578738799,3578738800,1
3,1123,22739,3578738799,3578738800,1
3,1123,22740,3578738799,3578738800,1
3,1123,22741,3578738799,3578738800,1
3,1123,22742,3578738799,3578738800,1
3,1123,22743,3578738799,3578738800,1
3,1123,22744,3578738799,3578738800,1
3,1123,22745,3578738799,3578738800,1
3,1123,22746,3578738799,3578738801,2
3,1123,22747,3578738799,3578738804,5
3,1123,22748,3578738799,3578738804,5
3,1123,22749,3578738799,3578738805,6
3,1123,22750,3578738799,3578738805,6
3,1123,22751,3578738799,3578738805,6
3,1123,22752,3578738799,3578738805,6
3,1123,22753,3578738799,3578738807,8
3,1123,22754,3578738799,3578738807,8
3,1123,22755,3578738799,3578738808,9
3,1123,22756,3578738799,3578738808,9
3,1123,22757,3578738799,3578738808,9
3,1123,22758,3578738799,3578738811,12
3,1123,22759,3578738799,3578738815,16
3,1123,22760,3578738799,3578738819,20
3,1123,22761,3578738799,3578738819,20
3,1123,22762,3578738799,3578738819,20
3,1123,22763,3578738799,3578738819,20
3,1123,22764,3578738799,3578738820,21
3,1123,22765,3578738799,3578738820,21
3,1123,22766,3578738799,3578738821,22
3,1123,22767,3578738799,3578738821,22
3,1123,22768,3578738799,3578738821,22
3,1123,22769,3578738799,3578738822,23
3,1123,22770,3578738799,3578738826,27
3,1123,22771,3578738799,3578738826,27
3,1123,22772,3578738799,3578738826,27
3,1123,22773,3578738799,3578738828,29
3,1123,22774,3578738799,3578738829,30
3,1123,22775,3578738799,3578738830,31
3,1123,22776,3578738799,3578738831,32
3,1123,22777,3578738799,3578738831,32
3,1123,22778,3578738799,3578738832,33
3,1123,22779,3578738799,3578738833,34
3,1123,22780,3578738799,3578738833,34
3,1123,22781,3578738799,3578738834,35
3,1123,22782,3578738799,3578738835,36
3,1123,22783,3578738799,3578738836,37
3,1123,22784,3578738799,3578738836,37
3,1123,22785,3578738799,3578738837,38
3,1123,22786,3578738799,3578738839,40
3,1123,22787,3578738799,3578738840,41
3,1123,22788,3578738799,3578738842,43
3,1123,22789,3578738799,3578738843,44
3,1123,22790,3578738799,3578738843,44
3,1123,22791,3578738799,3578738843,44
3,1123,22792,3578738799,3578738843,44
3,1123,22793,3578738799,3578738844,45
3,1123,22794,3578738799,3578738845,46
3,1123,22795,3578738799,3578738845,46
3,1123,22796,3578738799,3578738845,46
3,1123,22797,3578738799,3578738846,47
3,1123,22798,3578738799,3578738847,48
3,1123,22799,3578738799,3578738847,48
3,1123,22800,3578738799,3578738847,48
3,1124,22801,3578738861,3578738861,0
3,1124,22802,3578738861,3578738861,0
3,1124,22803,3578738861,3578738861,0
3,1124,22804,3578738861,3578738861,0
3,1124,22805,3578738861,3578738861,0
3,1124,22806,3578738861,3578738861,0
3,1124,22807,3578738861,3578738862,1
3,1124,22808,3578738861,3578738863,2
3,1124,22809,3578738861,3578738864,3
3,1124,22810,3578738861,3578738865,4
3,1124,22811,3578738861,3578738866,5
3,1124,22812,3578738861,3578738867,6
3,1124,22813,3578738861,3578738871,10
3,1124,22814,3578738861,3578738875,14
3,1124,22815,3578738861,3578738876,15
3,1124,22816,3578738861,3578738880,19
3,1124,22817,3578738861,3578738881,20
3,1124,22818,3578738861,3578738881,20
3,1124,22819,3578738861,3578738882,21
3,1124,22820,3578738861,3578738883,22
3,1124,22821,3578738861,3578738883,22
3,1124,22822,3578738861,3578738885,24
3,1124,22823,3578738861,3578738885,24
3,1124,22824,3578738861,3578738888,27
3,1124,22825,3578738861,3578738888,27
3,1124,22826,3578738861,3578738892,31
3,1124,22827,3578738861,3578738894,33
3,1124,22828,3578738861,3578738894,33
3,1124,22829,3578738861,3578738895,34
3,1124,22830,3578738861,3578738895,34
3,1124,22831,3578738861,3578738895,34
3,1124,22832,3578738861,3578738896,35
3,1124,22833,3578738861,3578738897,36
3,1124,22834,3578738861,3578738899,38
3,1124,22835,3578738861,3578738900,39
3,1124,22836,3578738861,3578738901,40
3,1124,22837,3578738861,3578738901,40
3,1124,22838,3578738861,3578738901,40
3,1124,22839,3578738861,3578738902,41
3,1124,22840,3578738861,3578738903,42
3,1124,22841,3578738861,3578738903,42
3,1124,22842,3578738861,3578738903,42
3,1124,22843,3578738861,3578738903,42
3,1124,22844,3578738861,3578738910,49
3,1125,22845,3578738923,3578738923,0
3,1125,22846,3578738923,3578738923,0
3,1125,22847,3578738923,3578738923,0
3,1125,22848,3578738923,3578738923,0
3,1125,22849,3578738923,3578738923,0
3,1125,22850,3578738923,3578738923,0
3,1125,22851,3578738923,3578738923,0
3,1125,22852,3578738923,3578738923,0
3,1125,22853,3578738923,3578738923,0
3,1125,22854,3578738923,3578738923,0
3,1125,22855,3578738923,3578738923,0
3,1125,22856,3578738923,3578738926,3
3,1125,22857,3578738923,3578738927,4
3,1125,22858,3578738923,3578738933,10
3,1125,22859,3578738923,3578738937,14
3,1125,22860,3578738923,3578738938,15
3,1125,22861,3578738923,3578738938,15
3,1125,22862,3578738923,3578738940,17
3,1125,22863,3578738923,3578738940,17
3,1125,22864,3578738923,3578738941,18
3,1125,22865,3578738923,3578738941,18
3,1125,22866,3578738923,3578738941,18
3,1125,22867,3578738923,3578738943,20
3,1125,22868,3578738923,3578738945,22
3,1125,22869,3578738923,3578738946,23
3,1125,22870,3578738923,3578738948,25
3,1125,22871,3578738923,3578738950,27
3,1125,22872,3578738923,3578738951,28
3,1125,22873,3578738923,3578738953,30
3,1125,22874,3578738923,3578738953,30
3,1125,22875,3578738923,3578738954,31
3,1125,22876,3578738923,3578738955,32
3,1125,22877,3578738923,3578738955,32
3,1125,22878,3578738923,3578738957,34
3,1125,22879,3578738923,3578738958,35
3,1125,22880,3578738923,3578738959,36
3,1125,22881,3578738923,3578738960,37
3,1125,22882,3578738923,3578738961,38
3,1125,22883,3578738923,3578738961,38
3,1125,22884,3578738923,3578738962,39
3,1125,22885,3578738923,3578738963,40
3,1125,22886,3578738923,3578738965,42
3,1125,22887,3578738923,3578738966,43
3,1125,22888,3578738923,3578738966,43
3,1125,22889,3578738923,3578738967,44
3,1125,22890,3578738923,3578738968,45
3,1125,22891,3578738923,3578738968,45
3,1125,22892,3578738923,3578738968,45
3,1125,22893,3578738923,3578738969,46
3,1125,22894,3578738923,3578738969,46
3,1125,22895,3578738923,3578738969,46
3,1125,22896,3578738923,3578738971,48
3,1125,22897,3578738923,3578738972,49
3,1126,22898,3578738986,3578738986,0
3,1126,22899,3578738986,3578738986,0
3,1126,22900,3578738986,3578738986,0
3,1126,22901,3578738986,3578738986,0
3,1126,22902,3578738986,3578738986,0
3,1126,22903,3578738986,3578738986,0
3,1126,22904,3578738986,3578738986,0
3,1126,22905,3578738986,3578738986,0
3,1126,22906,3578738986,3578738986,0
3,1126,22907,3578738986,3578738986,0
3,1126,22908,3578738986,3578738986,0
3,1126,22909,3578738986,3578738986,0
3,1126,22910,3578738986,3578738988,2
3,1126,22911,3578738986,3578738988,2
3,1126,22912,3578738986,3578738989,3
3,1126,22913,3578738986,3578738989,3
3,1126,22914,3578738986,3578738990,4
3,1126,22915,3578738986,3578738990,4
3,1126,22916,3578738986,3578738990,4
3,1126,22917,3578738986,3578738990,4
3,1126,22918,3578738986,3578738990,4
3,1126,22919,3578738986,3578738991,5
3,1126,22920,3578738986,3578738992,6
3,1126,22921,3578738986,3578738993,7
3,1126,22922,3578738986,3578738993,7
3,1126,22923,3578738986,3578738996,10
3,1126,22924,3578738986,3578738997,11
3,1126,22925,3578738986,3578738998,12
3,1126,22926,3578738986,3578739000,14
3,1126,22927,3578738986,3578739000,14
3,1126,22928,3578738986,3578739001,15
3,1126,22929,3578738986,3578739003,17
3,1126,22930,3578738986,3578739004,18
3,1126,22931,3578738986,3578739004,18
3,1126,22932,3578738986,3578739005,19
3,1126,22933,3578738986,3578739006,20
3,1126,22934,3578738986,3578739007,21
3,1126,22935,3578738986,3578739008,22
3,1126,22936,3578738986,3578739008,22
3,1126,22937,3578738986,3578739008,22
3,1126,22938,3578738986,3578739008,22
3,1126,22939,3578738986,3578739009,23
3,1126,22940,3578738986,3578739012,26
3,1126,22941,3578738986,3578739013,27
3,1126,22942,3578738986,3578739015,29
3,1126,22943,3578738986,3578739015,29
3,1126,22944,3578738986,3578739019,33
3,1126,22945,3578738986,3578739019,33
3,1126,22946,3578738986,3578739020,34
3,1126,22947,3578738986,3578739020,34
3,1126,22948,3578738986,3578739021,35
3,1126,22949,3578738986,3578739021,35
3,1126,22950,3578738986,3578739021,35
3,1126,22951,3578738986,3578739022,36
3,1126,22952,3578738986,3578739026,40
3,1126,22953,3578738986,3578739026,40
3,1126,22954,3578738986,3578739026,40
3,1126,22955,3578738986,3578739026,40
3,1126,22956,3578738986,3578739028,42
3,1126,22957,3578738986,3578739030,44
3,1126,22958,3578738986,3578739030,44
3,1126,22959,3578738986,3578739031,45
3,1126,22960,3578738986,3578739031,45
3,1126,22961,3578738986,3578739032,46
3,1126,22962,3578738986,3578739033,47
3,1126,22963,3578738986,3578739033,47
3,1126,22964,3578738986,3578739034,48
3,1127,22965,3578739048,3578739048,0
3,1127,22966,3578739048,3578739048,0
3,1127,22967,3578739048,3578739048,0
3,1127,22968,3578739048,3578739048,0
3,1127,22969,3578739048,3578739048,0
3,1127,22970,3578739048,3578739048,0
3,1127,22971,3578739048,3578739048,0
3,1127,22972,3578739048,3578739048,0
3,1127,22973,3578739048,3578739048,0
3,1127,22974,3578739048,3578739048,0
3,1127,22975,3578739048,3578739048,0
3,1127,22976,3578739048,3578739048,0
3,1127,22977,3578739048,3578739048,0
3,1127,22978,3578739048,3578739048,0
3,1127,22979,3578739048,3578739048,0
3,1127,22980,3578739048,3578739048,0
3,1127,22981,3578739048,3578739048,0
3,1127,22982,3578739048,3578739051,3
3,1127,22983,3578739048,3578739052,4
3,1127,22984,3578739048,3578739053,5
3,1127,22985,3578739048,3578739056,8
3,1127,22986,3578739048,3578739057,9
3,1127,22987,3578739048,3578739057,9
3,1127,22988,3578739048,3578739057,9
3,1127,22989,3578739048,3578739058,10
3,1127,22990,3578739048,3578739059,11
3,1127,22991,3578739048,3578739061,13
3,1127,22992,3578739048,3578739062,14
3,1127,22993,3578739048,3578739064,16
3,1127,22994,3578739048,3578739064,16
3,1127,22995,3578739048,3578739065,17
3,1127,22996,3578739048,3578739066,18
3,1127,22997,3578739048,3578739068,20
3,1127,22998,3578739048,3578739068,20
3,1127,22999,3578739048,3578739068,20
3,1127,23000,3578739048,3578739070,22
3,1127,23001,3578739048,3578739072,24
3,1127,23002,3578739048,3578739075,27
3,1127,23003,3578739048,3578739076,28
3,1127,23004,3578739048,3578739080,32
3,1127,23005,3578739048,3578739082,34
3,1127,23006,3578739048,3578739082,34
3,1127,23007,3578739048,3578739083,35
3,1127,23008,3578739048,3578739083,35
3,1127,23009,3578739048,3578739085,37
3,1127,23010,3578739048,3578739086,38
3,1127,23011,3578739048,3578739088,40
3,1127,23012,3578739048,3578739088,40
3,1127,23013,3578739048,3578739088,40
3,1127,23014,3578739048,3578739090,42
3,1127,23015,3578739048,3578739095,47
3,1127,23016,3578739048,3578739095,47
3,1127,23017,3578739048,3578739095,47
3,1127,23018,3578739048,3578739096,48
3,1127,23019,3578739048,3578739097,49
3,1127,23020,3578739048,3578739097,49
3,1128,23021,3578739114,3578739114,0
3,1128,23022,3578739114,3578739114,0
3,1128,23023,3578739114,3578739114,0
3,1128,23024,3578739114,3578739114,0
3,1128,23025,3578739114,3578739114,0
3,1128,23026,3578739114,3578739114,0
3,1128,23027,3578739114,3578739114,0
3,1128,23028,3578739114,3578739114,0
3,1128,23029,3578739114,3578739114,0
3,1128,23030,3578739114,3578739114,0
3,1128,23031,3578739114,3578739115,1
3,1128,23032,3578739114,3578739116,2
3,1128,23033,3578739114,3578739119,5
3,1128,23034,3578739114,3578739120,6
3,1128,23035,3578739114,3578739120,6
3,1128,23036,3578739114,3578739121,7
3,1128,23037,3578739114,3578739122,8
3,1128,23038,3578739114,3578739124,10
3,1128,23039,3578739114,3578739126,12
3,1128,23040,3578739114,3578739127,13
3,1128,23041,3578739114,3578739129,15
3,1128,23042,3578739114,3578739131,17
3,1128,23043,3578739114,3578739133,19
3,1128,23044,3578739114,3578739138,24
3,1128,23045,3578739114,3578739139,25
3,1128,23046,3578739114,3578739139,25
3,1128,23047,3578739114,3578739139,25
3,1128,23048,3578739114,3578739140,26
3,1128,23049,3578739114,3578739141,27
3,1128,23050,3578739114,3578739143,29
3,1128,23051,3578739114,3578739145,31
3,1128,23052,3578739114,3578739145,31
3,1128,23053,3578739114,3578739146,32
3,1128,23054,3578739114,3578739150,36
3,1128,23055,3578739114,3578739150,36
3,1128,23056,3578739114,3578739153,39
3,1128,23057,3578739114,3578739153,39
3,1128,23058,3578739114,3578739153,39
3,1128,23059,3578739114,3578739154,40
3,1128,23060,3578739114,3578739155,41
3,1128,23061,3578739114,3578739157,43
3,1128,23062,3578739114,3578739158,44
3,1128,23063,3578739114,3578739158,44
3,1128,23064,3578739114,3578739160,46
3,1128,23065,3578739114,3578739160,46
3,1128,23066,3578739114,3578739161,47
3,1128,23067,3578739114,3578739162,48
3,1128,23068,3578739114,3578739164,50
3,1129,23069,3578739178,3578739178,0
3,1129,23070,3578739178,3578739178,0
3,1129,23071,3578739178,3578739178,0
3,1129,23072,3578739178,3578739178,0
3,1129,23073,3578739178,3578739178,0
3,1129,23074,3578739178,3578739178,0
3,1129,23075,3578739178,3578739178,0
3,1129,23076,3578739178,3578739178,0
3,1129,23077,3578739178,3578739178,0
3,1129,23078,3578739178,3578739178,0
3,1129,23079,3578739178,3578739178,0
3,1129,23080,3578739178,3578739178,0
3,1129,23081,3578739178,3578739178,0
3,1129,23082,3578739178,3578739178,0
3,1129,23083,3578739178,3578739178,0
3,1129,23084,3578739178,3578739178,0
3,1129,23085,3578739178,3578739179,1
3,1129,23086,3578739178,3578739179,1
3,1129,23087,3578739178,3578739184,6
3,1129,23088,3578739178,3578739186,8
3,1129,23089,3578739178,3578739188,10
3,1129,23090,3578739178,3578739188,10
3,1129,23091,3578739178,3578739188,10
3,1129,23092,3578739178,3578739188,10
3,1129,23093,3578739178,3578739189,11
3,1129,23094,3578739178,3578739189,11
3,1129,23095,3578739178,3578739190,12
3,1129,23096,3578739178,3578739190,12
3,1129,23097,3578739178,3578739190,12
3,1129,23098,3578739178,3578739190,12
3,1129,23099,3578739178,3578739191,13
3,1129,23100,3578739178,3578739191,13
3,1129,23101,3578739178,3578739192,14
3,1129,23102,3578739178,3578739192,14
3,1129,23103,3578739178,3578739193,15
3,1129,23104,3578739178,3578739196,18
3,1129,23105,3578739178,3578739197,19
3,1129,23106,3578739178,3578739198,20
3,1129,23107,3578739178,3578739200,22
3,1129,23108,3578739178,3578739202,24
3,1129,23109,3578739178,3578739202,24
3,1129,23110,3578739178,3578739204,26
3,1129,23111,3578739178,3578739204,26
3,1129,23112,3578739178,3578739205,27
3,1129,23113,3578739178,3578739205,27
3,1129,23114,3578739178,3578739205,27
3,1129,23115,3578739178,3578739206,28
3,1129,23116,3578739178,3578739207,29
3,1129,23117,3578739178,3578739208,30
3,1129,23118,3578739178,3578739208,30
3,1129,23119,3578739178,3578739209,31
3,1129,23120,3578739178,3578739209,31
3,1129,23121,3578739178,3578739212,34
3,1129,23122,3578739178,3578739213,35
3,1129,23123,3578739178,3578739215,37
3,1129,23124,3578739178,3578739215,37
3,1129,23125,3578739178,3578739219,41
3,1129,23126,3578739178,3578739219,41
3,1129,23127,3578739178,3578739220,42
3,1129,23128,3578739178,3578739220,42
3,1129,23129,3578739178,3578739221,43
3,1129,23130,3578739178,3578739221,43
3,1129,23131,3578739178,3578739221,43
3,1129,23132,3578739178,3578739221,43
3,1129,23133,3578739178,3578739222,44
3,1129,23134,3578739178,3578739226,48
3,1129,23135,3578739178,3578739226,48
3,1129,23136,3578739178,3578739227,49
3,1129,23137,3578739178,3578739227,49
3,1129,23138,3578739178,3578739227,49
3,1129,23139,3578739178,3578739228,50
3,1130,23140,3578739238,3578739238,0
3,1130,23141,3578739238,3578739238,0
3,1130,23142,3578739238,3578739238,0
3,1130,23143,3578739238,3578739238,0
3,1130,23144,3578739238,3578739238,0
3,1130,23145,3578739238,3578739238,0
3,1130,23146,3578739238,3578739238,0
3,1130,23147,3578739238,3578739238,0
3,1130,23148,3578739238,3578739238,0
3,1130,23149,3578739238,3578739238,0
3,1130,23150,3578739238,3578739238,0
3,1130,23151,3578739238,3578739239,1
3,1130,23152,3578739238,3578739239,1
3,1130,23153,3578739238,3578739242,4
3,1130,23154,3578739238,3578739243,5
3,1130,23155,3578739238,3578739243,5
3,1130,23156,3578739238,3578739243,5
3,1130,23157,3578739238,3578739243,5
3,1130,23158,3578739238,3578739244,6
3,1130,23159,3578739238,3578739245,7
3,1130,23160,3578739238,3578739245,7
3,1130,23161,3578739238,3578739246,8
3,1130,23162,3578739238,3578739246,8
3,1130,23163,3578739238,3578739247,9
3,1130,23164,3578739238,3578739247,9
3,1130,23165,3578739238,3578739249,11
3,1130,23166,3578739238,3578739251,13
3,1130,23167,3578739238,3578739252,14
3,1130,23168,3578739238,3578739253,15
3,1130,23169,3578739238,3578739255,17
3,1130,23170,3578739238,3578739257,19
3,1130,23171,3578739238,3578739258,20
3,1130,23172,3578739238,3578739259,21
3,1130,23173,3578739238,3578739261,23
3,1130,23174,3578739238,3578739262,24
3,1130,23175,3578739238,3578739264,26
3,1130,23176,3578739238,3578739264,26
3,1130,23177,3578739238,3578739266,28
3,1130,23178,3578739238,3578739266,28
3,1130,23179,3578739238,3578739269,31
3,1130,23180,3578739238,3578739269,31
3,1130,23181,3578739238,3578739269,31
3,1130,23182,3578739238,3578739273,35
3,1130,23183,3578739238,3578739275,37
3,1130,23184,3578739238,3578739280,42
3,1130,23185,3578739238,3578739281,43
3,1130,23186,3578739238,3578739282,44
3,1130,23187,3578739238,3578739282,44
3,1130,23188,3578739238,3578739283,45
3,1130,23189,3578739238,3578739283,45
3,1130,23190,3578739238,3578739285,47
3,1130,23191,3578739238,3578739286,48
3,1131,23192,3578739298,3578739298,0
3,1131,23193,3578739298,3578739298,0
3,1131,23194,3578739298,3578739298,0
3,1131,23195,3578739298,3578739298,0
3,1131,23196,3578739298,3578739298,0
3,1131,23197,3578739298,3578739298,0
3,1131,23198,3578739298,3578739298,0
3,1131,23199,3578739298,3578739298,0
3,1131,23200,3578739298,3578739298,0
3,1131,23201,3578739298,3578739298,0
3,1131,23202,3578739298,3578739298,0
3,1131,23203,3578739298,3578739298,0
3,1131,23204,3578739298,3578739298,0
3,1131,23205,3578739298,3578739299,1
3,1131,23206,3578739298,3578739301,3
3,1131,23207,3578739298,3578739301,3
3,1131,23208,3578739298,3578739301,3
3,1131,23209,3578739298,3578739302,4
3,1131,23210,3578739298,3578739303,5
3,1131,23211,3578739298,3578739303,5
3,1131,23212,3578739298,3578739304,6
3,1131,23213,3578739298,3578739304,6
3,1131,23214,3578739298,3578739304,6
3,1131,23215,3578739298,3578739311,13
3,1131,23216,3578739298,3578739316,18
3,1131,23217,3578739298,3578739316,18
3,1131,23218,3578739298,3578739319,21
3,1131,23219,3578739298,3578739320,22
3,1131,23220,3578739298,3578739321,23
3,1131,23221,3578739298,3578739321,23
3,1131,23222,3578739298,3578739321,23
3,1131,23223,3578739298,3578739321,23
3,1131,23224,3578739298,3578739321,23
3,1131,23225,3578739298,3578739322,24
3,1131,23226,3578739298,3578739323,25
3,1131,23227,3578739298,3578739326,28
3,1131,23228,3578739298,3578739327,29
3,1131,23229,3578739298,3578739330,32
3,1131,23230,3578739298,3578739332,34
3,1131,23231,3578739298,3578739334,36
3,1131,23232,3578739298,3578739338,40
3,1131,23233,3578739298,3578739338,40
3,1131,23234,3578739298,3578739340,42
3,1131,23235,3578739298,3578739340,42
3,1131,23236,3578739298,3578739340,42
3,1131,23237,3578739298,3578739341,43
3,1131,23238,3578739298,3578739341,43
3,1131,23239,3578739298,3578739341,43
3,1131,23240,3578739298,3578739342,44
3,1131,23241,3578739298,3578739345,47
3,1131,23242,3578739298,3578739347,49
3,1132,23243,3578739360,3578739360,0
3,1132,23244,3578739360,3578739360,0
3,1132,23245,3578739360,3578739360,0
3,1132,23246,3578739360,3578739360,0
3,1132,23247,3578739360,3578739360,0
3,1132,23248,3578739360,3578739360,0
3,1132,23249,3578739360,3578739360,0
3,1132,23250,3578739360,3578739360,0
3,1132,23251,3578739360,3578739360,0
3,1132,23252,3578739360,3578739360,0
3,1132,23253,3578739360,3578739360,0
3,1132,23254,3578739360,3578739360,0
3,1132,23255,3578739360,3578739361,1
3,1132,23256,3578739360,3578739361,1
3,1132,23257,3578739360,3578739362,2
3,1132,23258,3578739360,3578739363,3
3,1132,23259,3578739360,3578739365,5
3,1132,23260,3578739360,3578739366,6
3,1132,23261,3578739360,3578739368,8
3,1132,23262,3578739360,3578739368,8
3,1132,23263,3578739360,3578739369,9
3,1132,23264,3578739360,3578739369,9
3,1132,23265,3578739360,3578739371,11
3,1132,23266,3578739360,3578739371,11
3,1132,23267,3578739360,3578739371,11
3,1132,23268,3578739360,3578739372,12
3,1132,23269,3578739360,3578739374,14
3,1132,23270,3578739360,3578739374,14
3,1132,23271,3578739360,3578739374,14
3,1132,23272,3578739360,3578739375,15
3,1132,23273,3578739360,3578739375,15
3,1132,23274,3578739360,3578739376,16
3,1132,23275,3578739360,3578739377,17
3,1132,23276,3578739360,3578739379,19
3,1132,23277,3578739360,3578739379,19
3,1132,23278,3578739360,3578739384,24
3,1132,23279,3578739360,3578739386,26
3,1132,23280,3578739360,3578739387,27
3,1132,23281,3578739360,3578739388,28
3,1132,23282,3578739360,3578739388,28
3,1132,23283,3578739360,3578739389,29
3,1132,23284,3578739360,3578739389,29
3,1132,23285,3578739360,3578739389,29
3,1132,23286,3578739360,3578739389,29
3,1132,23287,3578739360,3578739390,30
3,1132,23288,3578739360,3578739390,30
3,1132,23289,3578739360,3578739391,31
3,1132,23290,3578739360,3578739391,31
3,1132,23291,3578739360,3578739392,32
3,1132,23292,3578739360,3578739393,33
3,1132,23293,3578739360,3578739394,34
3,1132,23294,3578739360,3578739395,35
3,1132,23295,3578739360,3578739396,36
3,1132,23296,3578739360,3578739397,37
3,1132,23297,3578739360,3578739400,40
3,1132,23298,3578739360,3578739402,42
3,1132,23299,3578739360,3578739402,42
3,1132,23300,3578739360,3578739404,44
3,1132,23301,3578739360,3578739405,45
3,1132,23302,3578739360,3578739405,45
3,1132,23303,3578739360,3578739405,45
3,1132,23304,3578739360,3578739406,46
3,1132,23305,3578739360,3578739407,47
3,1132,23306,3578739360,3578739408,48
3,1132,23307,3578739360,3578739408,48
3,1132,23308,3578739360,3578739409,49
3,1132,23309,3578739360,3578739409,49
3,1133,23310,3578739427,3578739427,0
3,1133,23311,3578739427,3578739427,0
3,1133,23312,3578739427,3578739427,0
3,1133,23313,3578739427,3578739427,0
3,1133,23314,3578739427,3578739427,0
3,1133,23315,3578739427,3578739427,0
3,1133,23316,3578739427,3578739427,0
3,1133,23317,3578739427,3578739427,0
3,1133,23318,3578739427,3578739427,0
3,1133,23319,3578739427,3578739427,0
3,1133,23320,3578739427,3578739427,0
3,1133,23321,3578739427,3578739427,0
3,1133,23322,3578739427,3578739427,0
3,1133,23323,3578739427,3578739427,0
3,1133,23324,3578739427,3578739428,1
3,1133,23325,3578739427,3578739428,1
3,1133,23326,3578739427,3578739430,3
3,1133,23327,3578739427,3578739431,4
3,1133,23328,3578739427,3578739431,4
3,1133,23329,3578739427,3578739432,5
3,1133,23330,3578739427,3578739433,6
3,1133,23331,3578739427,3578739433,6
3,1133,23332,3578739427,3578739436,9
3,1133,23333,3578739427,3578739436,9
3,1133,23334,3578739427,3578739436,9
3,1133,23335,3578739427,3578739436,9
3,1133,23336,3578739427,3578739438,11
3,1133,23337,3578739427,3578739440,13
3,1133,23338,3578739427,3578739441,14
3,1133,23339,3578739427,3578739442,15
3,1133,23340,3578739427,3578739442,15
3,1133,23341,3578739427,3578739443,16
3,1133,23342,3578739427,3578739444,17
3,1133,23343,3578739427,3578739444,17
3,1133,23344,3578739427,3578739444,17
3,1133,23345,3578739427,3578739445,18
3,1133,23346,3578739427,3578739445,18
3,1133,23347,3578739427,3578739445,18
3,1133,23348,3578739427,3578739446,19
3,1133,23349,3578739427,3578739446,19
3,1133,23350,3578739427,3578739447,20
3,1133,23351,3578739427,3578739447,20
3,1133,23352,3578739427,3578739449,22
3,1133,23353,3578739427,3578739451,24
3,1133,23354,3578739427,3578739452,25
3,1133,23355,3578739427,3578739452,25
3,1133,23356,3578739427,3578739456,29
3,1133,23357,3578739427,3578739457,30
3,1133,23358,3578739427,3578739458,31
3,1133,23359,3578739427,3578739458,31
3,1133,23360,3578739427,3578739459,32
3,1133,23361,3578739427,3578739462,35
3,1133,23362,3578739427,3578739464,37
3,1133,23363,3578739427,3578739466,39
3,1133,23364,3578739427,3578739469,42
3,1133,23365,3578739427,3578739470,43
3,1133,23366,3578739427,3578739470,43
3,1133,23367,3578739427,3578739471,44
3,1133,23368,3578739427,3578739473,46
3,1133,23369,3578739427,3578739475,48
3,1133,23370,3578739427,3578739476,49
3,1134,23371,3578739490,3578739490,0
3,1134,23372,3578739490,3578739490,0
3,1134,23373,3578739490,3578739490,0
3,1134,23374,3578739490,3578739490,0
3,1134,23375,3578739490,3578739490,0
3,1134,23376,3578739490,3578739490,0
3,1134,23377,3578739490,3578739490,0
3,1134,23378,3578739490,3578739490,0
3,1134,23379,3578739490,3578739490,0
3,1134,23380,3578739490,3578739494,4
3,1134,23381,3578739490,3578739494,4
3,1134,23382,3578739490,3578739495,5
3,1134,23383,3578739490,3578739495,5
3,1134,23384,3578739490,3578739496,6
3,1134,23385,3578739490,3578739496,6
3,1134,23386,3578739490,3578739497,7
3,1134,23387,3578739490,3578739500,10
3,1134,23388,3578739490,3578739500,10
3,1134,23389,3578739490,3578739500,10
3,1134,23390,3578739490,3578739501,11
3,1134,23391,3578739490,3578739502,12
3,1134,23392,3578739490,3578739503,13
3,1134,23393,3578739490,3578739503,13
3,1134,23394,3578739490,3578739504,14
3,1134,23395,3578739490,3578739507,17
3,1134,23396,3578739490,3578739510,20
3,1134,23397,3578739490,3578739515,25
3,1134,23398,3578739490,3578739516,26
3,1134,23399,3578739490,3578739518,28
3,1134,23400,3578739490,3578739518,28
3,1134,23401,3578739490,3578739519,29
3,1134,23402,3578739490,3578739520,30
3,1134,23403,3578739490,3578739521,31
3,1134,23404,3578739490,3578739521,31
3,1134,23405,3578739490,3578739522,32
3,1134,23406,3578739490,3578739522,32
3,1134,23407,3578739490,3578739525,35
3,1134,23408,3578739490,3578739526,36
3,1134,23409,3578739490,3578739529,39
3,1134,23410,3578739490,3578739532,42
3,1134,23411,3578739490,3578739534,44
3,1134,23412,3578739490,3578739537,47
3,1134,23413,3578739490,3578739539,49
3,1134,23414,3578739490,3578739539,49
3,1134,23415,3578739490,3578739539,49
3,1134,23416,3578739490,3578739540,50
3,1135,23417,3578739551,3578739551,0
3,1135,23418,3578739551,3578739551,0
3,1135,23419,3578739551,3578739551,0
3,1135,23420,3578739551,3578739551,0
3,1135,23421,3578739551,3578739551,0
3,1135,23422,3578739551,3578739551,0
3,1135,23423,3578739551,3578739551,0
3,1135,23424,3578739551,3578739552,1
3,1135,23425,3578739551,3578739553,2
3,1135,23426,3578739551,3578739553,2
3,1135,23427,3578739551,3578739553,2
3,1135,23428,3578739551,3578739553,2
3,1135,23429,3578739551,3578739556,5
3,1135,23430,3578739551,3578739557,6
3,1135,23431,3578739551,3578739557,6
3,1135,23432,3578739551,3578739557,6
3,1135,23433,3578739551,3578739559,8
3,1135,23434,3578739551,3578739560,9
3,1135,23435,3578739551,3578739562,11
3,1135,23436,3578739551,3578739562,11
3,1135,23437,3578739551,3578739564,13
3,1135,23438,3578739551,3578739565,14
3,1135,23439,3578739551,3578739567,16
3,1135,23440,3578739551,3578739567,16
3,1135,23441,3578739551,3578739568,17
3,1135,23442,3578739551,3578739568,17
3,1135,23443,3578739551,3578739570,19
3,1135,23444,3578739551,3578739570,19
3,1135,23445,3578739551,3578739571,20
3,1135,23446,3578739551,3578739571,20
3,1135,23447,3578739551,3578739571,20
3,1135,23448,3578739551,3578739572,21
3,1135,23449,3578739551,3578739573,22
3,1135,23450,3578739551,3578739573,22
3,1135,23451,3578739551,3578739573,22
3,1135,23452,3578739551,3578739574,23
3,1135,23453,3578739551,3578739575,24
3,1135,23454,3578739551,3578739576,25
3,1135,23455,3578739551,3578739579,28
3,1135,23456,3578739551,3578739583,32
3,1135,23457,3578739551,3578739585,34
3,1135,23458,3578739551,3578739587,36
3,1135,23459,3578739551,3578739587,36
3,1135,23460,3578739551,3578739587,36
3,1135,23461,3578739551,3578739587,36
3,1135,23462,3578739551,3578739588,37
3,1135,23463,3578739551,3578739589,38
3,1135,23464,3578739551,3578739589,38
3,1135,23465,3578739551,3578739589,38
3,1135,23466,3578739551,3578739589,38
3,1135,23467,3578739551,3578739589,38
3,1135,23468,3578739551,3578739589,38
3,1135,23469,3578739551,3578739590,39
3,1135,23470,3578739551,3578739591,40
3,1135,23471,3578739551,3578739594,43
3,1135,23472,3578739551,3578739594,43
3,1135,23473,3578739551,3578739595,44
3,1135,23474,3578739551,3578739596,45
3,1135,23475,3578739551,3578739597,46
3,1135,23476,3578739551,3578739599,48
3,1135,23477,3578739551,3578739600,49
3,1136,23478,3578739613,3578739613,0
3,1136,23479,3578739613,3578739613,0
3,1136,23480,3578739613,3578739613,0
3,1136,23481,3578739613,3578739613,0
3,1136,23482,3578739613,3578739613,0
3,1136,23483,3578739613,3578739613,0
3,1136,23484,3578739613,3578739613,0
3,1136,23485,3578739613,3578739613,0
3,1136,23486,3578739613,3578739613,0
3,1136,23487,3578739613,3578739613,0
3,1136,23488,3578739613,3578739613,0
3,1136,23489,3578739613,3578739613,0
3,1136,23490,3578739613,3578739613,0
3,1136,23491,3578739613,3578739613,0
3,1136,23492,3578739613,3578739614,1
3,1136,23493,3578739613,3578739614,1
3,1136,23494,3578739613,3578739618,5
3,1136,23495,3578739613,3578739619,6
3,1136,23496,3578739613,3578739619,6
3,1136,23497,3578739613,3578739620,7
3,1136,23498,3578739613,3578739620,7
3,1136,23499,3578739613,3578739620,7
3,1136,23500,3578739613,3578739621,8
3,1136,23501,3578739613,3578739622,9
3,1136,23502,3578739613,3578739622,9
3,1136,23503,3578739613,3578739622,9
3,1136,23504,3578739613,3578739626,13
3,1136,23505,3578739613,3578739626,13
3,1136,23506,3578739613,3578739626,13
3,1136,23507,3578739613,3578739626,13
3,1136,23508,3578739613,3578739626,13
3,1136,23509,3578739613,3578739627,14
3,1136,23510,3578739613,3578739629,16
3,1136,23511,3578739613,3578739630,17
3,1136,23512,3578739613,3578739632,19
3,1136,23513,3578739613,3578739632,19
3,1136,23514,3578739613,3578739632,19
3,1136,23515,3578739613,3578739632,19
3,1136,23516,3578739613,3578739633,20
3,1136,23517,3578739613,3578739633,20
3,1136,23518,3578739613,3578739634,21
3,1136,23519,3578739613,3578739635,22
3,1136,23520,3578739613,3578739636,23
3,1136,23521,3578739613,3578739637,24
3,1136,23522,3578739613,3578739639,26
3,1136,23523,3578739613,3578739640,27
3,1136,23524,3578739613,3578739641,28
3,1136,23525,3578739613,3578739643,30
3,1136,23526,3578739613,3578739643,30
3,1136,23527,3578739613,3578739643,30
3,1136,23528,3578739613,3578739644,31
3,1136,23529,3578739613,3578739644,31
3,1136,23530,3578739613,3578739644,31
3,1136,23531,3578739613,3578739645,32
3,1136,23532,3578739613,3578739645,32
3,1136,23533,3578739613,3578739646,33
3,1136,23534,3578739613,3578739647,34
3,1136,23535,3578739613,3578739648,35
3,1136,23536,3578739613,3578739651,38
3,1136,23537,3578739613,3578739652,39
3,1136,23538,3578739613,3578739652,39
3,1136,23539,3578739613,3578739655,42
3,1136,23540,3578739613,3578739657,44
3,1136,23541,3578739613,3578739658,45
3,1136,23542,3578739613,3578739659,46
3,1136,23543,3578739613,3578739662,49
3,1136,23544,3578739613,3578739662,49
3,1137,23545,3578739675,3578739675,0
3,1137,23546,3578739675,3578739675,0
3,1137,23547,3578739675,3578739675,0
3,1137,23548,3578739675,3578739675,0
3,1137,23549,3578739675,3578739675,0
3,1137,23550,3578739675,3578739675,0
3,1137,23551,3578739675,3578739675,0
3,1137,23552,3578739675,3578739675,0
3,1137,23553,3578739675,3578739676,1
3,1137,23554,3578739675,3578739679,4
3,1137,23555,3578739675,3578739680,5
3,1137,23556,3578739675,3578739681,6
3,1137,23557,3578739675,3578739681,6
3,1137,23558,3578739675,3578739683,8
3,1137,23559,3578739675,3578739683,8
3,1137,23560,3578739675,3578739684,9
3,1137,23561,3578739675,3578739684,9
3,1137,23562,3578739675,3578739687,12
3,1137,23563,3578739675,3578739688,13
3,1137,23564,3578739675,3578739688,13
3,1137,23565,3578739675,3578739691,16
3,1137,23566,3578739675,3578739692,17
3,1137,23567,3578739675,3578739695,20
3,1137,23568,3578739675,3578739695,20
3,1137,23569,3578739675,3578739695,20
3,1137,23570,3578739675,3578739697,22
3,1137,23571,3578739675,3578739697,22
3,1137,23572,3578739675,3578739697,22
3,1137,23573,3578739675,3578739698,23
3,1137,23574,3578739675,3578739701,26
3,1137,23575,3578739675,3578739701,26
3,1137,23576,3578739675,3578739701,26
3,1137,23577,3578739675,3578739702,27
3,1137,23578,3578739675,3578739703,28
3,1137,23579,3578739675,3578739703,28
3,1137,23580,3578739675,3578739703,28
3,1137,23581,3578739675,3578739703,28
3,1137,23582,3578739675,3578739708,33
3,1137,23583,3578739675,3578739710,35
3,1137,23584,3578739675,3578739715,40
3,1137,23585,3578739675,3578739715,40
3,1137,23586,3578739675,3578739718,43
3,1137,23587,3578739675,3578739719,44
3,1137,23588,3578739675,3578739719,44
3,1137,23589,3578739675,3578739720,45
3,1137,23590,3578739675,3578739721,46
3,1137,23591,3578739675,3578739721,46
3,1137,23592,3578739675,3578739722,47
3,1137,23593,3578739675,3578739722,47
3,1137,23594,3578739675,3578739723,48
3,1138,23595,3578739737,3578739737,0
3,1138,23596,3578739737,3578739737,0
3,1138,23597,3578739737,3578739737,0
3,1138,23598,3578739737,3578739737,0
3,1138,23599,3578739737,3578739737,0
3,1138,23600,3578739737,3578739737,0
3,1138,23601,3578739737,3578739738,1
3,1138,23602,3578739737,3578739739,2
3,1138,23603,3578739737,3578739739,2
3,1138,23604,3578739737,3578739740,3
3,1138,23605,3578739737,3578739740,3
3,1138,23606,3578739737,3578739740,3
3,1138,23607,3578739737,3578739742,5
3,1138,23608,3578739737,3578739742,5
3,1138,23609,3578739737,3578739744,7
3,1138,23610,3578739737,3578739746,9
3,1138,23611,3578739737,3578739750,13
3,1138,23612,3578739737,3578739750,13
3,1138,23613,3578739737,3578739751,14
3,1138,23614,3578739737,3578739752,15
3,1138,23615,3578739737,3578739753,16
3,1138,23616,3578739737,3578739754,17
3,1138,23617,3578739737,3578739754,17
3,1138,23618,3578739737,3578739755,18
3,1138,23619,3578739737,3578739756,19
3,1138,23620,3578739737,3578739757,20
3,1138,23621,3578739737,3578739758,21
3,1138,23622,3578739737,3578739760,23
3,1138,23623,3578739737,3578739761,24
3,1138,23624,3578739737,3578739763,26
3,1138,23625,3578739737,3578739765,28
3,1138,23626,3578739737,3578739765,28
3,1138,23627,3578739737,3578739766,29
3,1138,23628,3578739737,3578739767,30
3,1138,23629,3578739737,3578739767,30
3,1138,23630,3578739737,3578739768,31
3,1138,23631,3578739737,3578739768,31
3,1138,23632,3578739737,3578739769,32
3,1138,23633,3578739737,3578739770,33
3,1138,23634,3578739737,3578739771,34
3,1138,23635,3578739737,3578739771,34
3,1138,23636,3578739737,3578739771,34
3,1138,23637,3578739737,3578739773,36
3,1138,23638,3578739737,3578739773,36
3,1138,23639,3578739737,3578739773,36
3,1138,23640,3578739737,3578739773,36
3,1138,23641,3578739737,3578739774,37
3,1138,23642,3578739737,3578739776,39
3,1138,23643,3578739737,3578739776,39
3,1138,23644,3578739737,3578739778,41
3,1138,23645,3578739737,3578739779,42
3,1138,23646,3578739737,3578739784,47
3,1138,23647,3578739737,3578739786,49
3,1139,23648,3578739799,3578739799,0
3,1139,23649,3578739799,3578739799,0
3,1139,23650,3578739799,3578739799,0
3,1139,23651,3578739799,3578739799,0
3,1139,23652,3578739799,3578739799,0
3,1139,23653,3578739799,3578739799,0
3,1139,23654,3578739799,3578739799,0
3,1139,23655,3578739799,3578739799,0
3,1139,23656,3578739799,3578739799,0
3,1139,23657,3578739799,3578739799,0
3,1139,23658,3578739799,3578739799,0
3,1139,23659,3578739799,3578739799,0
3,1139,23660,3578739799,3578739799,0
3,1139,23661,3578739799,3578739799,0
3,1139,23662,3578739799,3578739799,0
3,1139,23663,3578739799,3578739799,0
3,1139,23664,3578739799,3578739799,0
3,1139,23665,3578739799,3578739799,0
3,1139,23666,3578739799,3578739799,0
3,1139,23667,3578739799,3578739800,1
3,1139,23668,3578739799,3578739801,2
3,1139,23669,3578739799,3578739803,4
3,1139,23670,3578739799,3578739804,5
3,1139,23671,3578739799,3578739804,5
3,1139,23672,3578739799,3578739804,5
3,1139,23673,3578739799,3578739805,6
3,1139,23674,3578739799,3578739806,7
3,1139,23675,3578739799,3578739807,8
3,1139,23676,3578739799,3578739807,8
3,1139,23677,3578739799,3578739808,9
3,1139,23678,3578739799,3578739808,9
3,1139,23679,3578739799,3578739809,10
3,1139,23680,3578739799,3578739811,12
3,1139,23681,3578739799,3578739812,13
3,1139,23682,3578739799,3578739814,15
3,1139,23683,3578739799,3578739814,15
3,1139,23684,3578739799,3578739819,20
3,1139,23685,3578739799,3578739819,20
3,1139,23686,3578739799,3578739819,20
3,1139,23687,3578739799,3578739820,21
3,1139,23688,3578739799,3578739820,21
3,1139,23689,3578739799,3578739821,22
3,1139,23690,3578739799,3578739822,23
3,1139,23691,3578739799,3578739822,23
3,1139,23692,3578739799,3578739823,24
3,1139,23693,3578739799,3578739825,26
3,1139,23694,3578739799,3578739826,27
3,1139,23695,3578739799,3578739826,27
3,1139,23696,3578739799,3578739827,28
3,1139,23697,3578739799,3578739828,29
3,1139,23698,3578739799,3578739829,30
3,1139,23699,3578739799,3578739830,31
3,1139,23700,3578739799,3578739832,33
3,1139,23701,3578739799,3578739832,33
3,1139,23702,3578739799,3578739833,34
3,1139,23703,3578739799,3578739834,35
3,1139,23704,3578739799,3578739834,35
3,1139,23705,3578739799,3578739835,36
3,1139,23706,3578739799,3578739837,38
3,1139,23707,3578739799,3578739840,41
3,1139,23708,3578739799,3578739840,41
3,1139,23709,3578739799,3578739840,41
3,1139,23710,3578739799,3578739841,42
3,1139,23711,3578739799,3578739843,44
3,1139,23712,3578739799,3578739843,44
3,1139,23713,3578739799,3578739843,44
3,1139,23714,3578739799,3578739844,45
3,1139,23715,3578739799,3578739844,45
3,1139,23716,3578739799,3578739844,45
3,1139,23717,3578739799,3578739845,46
3,1139,23718,3578739799,3578739845,46
3,1139,23719,3578739799,3578739845,46
3,1139,23720,3578739799,3578739846,47
3,1139,23721,3578739799,3578739847,48
3,1139,23722,3578739799,3578739848,49
3,1140,23723,3578739861,3578739861,0
3,1140,23724,3578739861,3578739861,0
3,1140,23725,3578739861,3578739861,0
3,1140,23726,3578739861,3578739861,0
3,1140,23727,3578739861,3578739861,0
3,1140,23728,3578739861,3578739861,0
3,1140,23729,3578739861,3578739861,0
3,1140,23730,3578739861,3578739862,1
3,1140,23731,3578739861,3578739863,2
3,1140,23732,3578739861,3578739863,2
3,1140,23733,3578739861,3578739866,5
3,1140,23734,3578739861,3578739868,7
3,1140,23735,3578739861,3578739870,9
3,1140,23736,3578739861,3578739871,10
3,1140,23737,3578739861,3578739874,13
3,1140,23738,3578739861,3578739875,14
3,1140,23739,3578739861,3578739876,15
3,1140,23740,3578739861,3578739881,20
3,1140,23741,3578739861,3578739881,20
3,1140,23742,3578739861,3578739882,21
3,1140,23743,3578739861,3578739883,22
3,1140,23744,3578739861,3578739884,23
3,1140,23745,3578739861,3578739884,23
3,1140,23746,3578739861,3578739886,25
3,1140,23747,3578739861,3578739888,27
3,1140,23748,3578739861,3578739890,29
3,1140,23749,3578739861,3578739893,32
3,1140,23750,3578739861,3578739894,33
3,1140,23751,3578739861,3578739895,34
3,1140,23752,3578739861,3578739896,35
3,1140,23753,3578739861,3578739896,35
3,1140,23754,3578739861,3578739897,36
3,1140,23755,3578739861,3578739897,36
3,1140,23756,3578739861,3578739898,37
3,1140,23757,3578739861,3578739898,37
3,1140,23758,3578739861,3578739900,39
3,1140,23759,3578739861,3578739901,40
3,1140,23760,3578739861,3578739901,40
3,1140,23761,3578739861,3578739901,40
3,1140,23762,3578739861,3578739903,42
3,1140,23763,3578739861,3578739903,42
3,1140,23764,3578739861,3578739903,42
3,1140,23765,3578739861,3578739908,47
3,1141,23766,3578739922,3578739922,0
3,1141,23767,3578739922,3578739922,0
3,1141,23768,3578739922,3578739922,0
3,1141,23769,3578739922,3578739922,0
3,1141,23770,3578739922,3578739922,0
3,1141,23771,3578739922,3578739922,0
3,1141,23772,3578739922,3578739922,0
3,1141,23773,3578739922,3578739922,0
3,1141,23774,3578739922,3578739922,0
3,1141,23775,3578739922,3578739922,0
3,1141,23776,3578739922,3578739922,0
3,1141,23777,3578739922,3578739925,3
3,1141,23778,3578739922,3578739926,4
3,1141,23779,3578739922,3578739929,7
3,1141,23780,3578739922,3578739935,13
3,1141,23781,3578739922,3578739937,15
3,1141,23782,3578739922,3578739937,15
3,1141,23783,3578739922,3578739938,16
3,1141,23784,3578739922,3578739940,18
3,1141,23785,3578739922,3578739940,18
3,1141,23786,3578739922,3578739940,18
3,1141,23787,3578739922,3578739941,19
3,1141,23788,3578739922,3578739943,21
3,1141,23789,3578739922,3578739944,22
3,1141,23790,3578739922,3578739944,22
3,1141,23791,3578739922,3578739946,24
3,1141,23792,3578739922,3578739951,29
3,1141,23793,3578739922,3578739951,29
3,1141,23794,3578739922,3578739953,31
3,1141,23795,3578739922,3578739953,31
3,1141,23796,3578739922,3578739953,31
3,1141,23797,3578739922,3578739954,32
3,1141,23798,3578739922,3578739954,32
3,1141,23799,3578739922,3578739957,35
3,1141,23800,3578739922,3578739957,35
3,1141,23801,3578739922,3578739958,36
3,1141,23802,3578739922,3578739958,36
3,1141,23803,3578739922,3578739960,38
3,1141,23804,3578739922,3578739961,39
3,1141,23805,3578739922,3578739963,41
3,1141,23806,3578739922,3578739965,43
3,1141,23807,3578739922,3578739965,43
3,1141,23808,3578739922,3578739966,44
3,1141,23809,3578739922,3578739967,45
3,1141,23810,3578739922,3578739968,46
3,1141,23811,3578739922,3578739970,48
3,1141,23812,3578739922,3578739971,49
3,1141,23813,3578739922,3578739971,49
3,1141,23814,3578739922,3578739971,49
3,1141,23815,3578739922,3578739972,50
3,1142,23816,3578739984,3578739984,0
3,1142,23817,3578739984,3578739984,0
3,1142,23818,3578739984,3578739984,0
3,1142,23819,3578739984,3578739984,0
3,1142,23820,3578739984,3578739984,0
3,1142,23821,3578739984,3578739984,0
3,1142,23822,3578739984,3578739984,0
3,1142,23823,3578739984,3578739984,0
3,1142,23824,3578739984,3578739985,1
3,1142,23825,3578739984,3578739986,2
3,1142,23826,3578739984,3578739987,3
3,1142,23827,3578739984,3578739987,3
3,1142,23828,3578739984,3578739987,3
3,1142,23829,3578739984,3578739987,3
3,1142,23830,3578739984,3578739988,4
3,1142,23831,3578739984,3578739989,5
3,1142,23832,3578739984,3578739990,6
3,1142,23833,3578739984,3578739990,6
3,1142,23834,3578739984,3578739990,6
3,1142,23835,3578739984,3578739991,7
3,1142,23836,3578739984,3578739991,7
3,1142,23837,3578739984,3578739992,8
3,1142,23838,3578739984,3578739992,8
3,1142,23839,3578739984,3578739992,8
3,1142,23840,3578739984,3578739994,10
3,1142,23841,3578739984,3578739995,11
3,1142,23842,3578739984,3578739995,11
3,1142,23843,3578739984,3578739998,14
3,1142,23844,3578739984,3578739999,15
3,1142,23845,3578739984,3578740000,16
3,1142,23846,3578739984,3578740002,18
3,1142,23847,3578739984,3578740003,19
3,1142,23848,3578739984,3578740004,20
3,1142,23849,3578739984,3578740004,20
3,1142,23850,3578739984,3578740005,21
3,1142,23851,3578739984,3578740005,21
3,1142,23852,3578739984,3578740007,23
3,1142,23853,3578739984,3578740007,23
3,1142,23854,3578739984,3578740007,23
3,1142,23855,3578739984,3578740009,25
3,1142,23856,3578739984,3578740009,25
3,1142,23857,3578739984,3578740011,27
3,1142,23858,3578739984,3578740013,29
3,1142,23859,3578739984,3578740014,30
3,1142,23860,3578739984,3578740018,34
3,1142,23861,3578739984,3578740019,35
3,1142,23862,3578739984,3578740019,35
3,1142,23863,3578739984,3578740020,36
3,1142,23864,3578739984,3578740021,37
3,1142,23865,3578739984,3578740021,37
3,1142,23866,3578739984,3578740022,38
3,1142,23867,3578739984,3578740022,38
3,1142,23868,3578739984,3578740024,40
3,1142,23869,3578739984,3578740025,41
3,1142,23870,3578739984,3578740025,41
3,1142,23871,3578739984,3578740026,42
3,1142,23872,3578739984,3578740027,43
3,1142,23873,3578739984,3578740027,43
3,1142,23874,3578739984,3578740027,43
3,1142,23875,3578739984,3578740030,46
3,1142,23876,3578739984,3578740031,47
3,1142,23877,3578739984,3578740031,47
3,1142,23878,3578739984,3578740032,48
3,1142,23879,3578739984,3578740032,48
3,1142,23880,3578739984,3578740033,49
3,1142,23881,3578739984,3578740033,49
3,1143,23882,3578740048,3578740048,0
3,1143,23883,3578740048,3578740048,0
3,1143,23884,3578740048,3578740048,0
3,1143,23885,3578740048,3578740048,0
3,1143,23886,3578740048,3578740048,0
3,1143,23887,3578740048,3578740048,0
3,1143,23888,3578740048,3578740048,0
3,1143,23889,3578740048,3578740048,0
3,1143,23890,3578740048,3578740048,0
3,1143,23891,3578740048,3578740048,0
3,1143,23892,3578740048,3578740048,0
3,1143,23893,3578740048,3578740048,0
3,1143,23894,3578740048,3578740048,0
3,1143,23895,3578740048,3578740048,0
3,1143,23896,3578740048,3578740048,0
3,1143,23897,3578740048,3578740048,0
3,1143,23898,3578740048,3578740048,0
3,1143,23899,3578740048,3578740048,0
3,1143,23900,3578740048,3578740048,0
3,1143,23901,3578740048,3578740049,1
3,1143,23902,3578740048,3578740051,3
3,1143,23903,3578740048,3578740052,4
3,1143,23904,3578740048,3578740055,7
3,1143,23905,3578740048,3578740057,9
3,1143,23906,3578740048,3578740058,10
3,1143,23907,3578740048,3578740058,10
3,1143,23908,3578740048,3578740059,11
3,1143,23909,3578740048,3578740059,11
3,1143,23910,3578740048,3578740062,14
3,1143,23911,3578740048,3578740063,15
3,1143,23912,3578740048,3578740063,15
3,1143,23913,3578740048,3578740064,16
3,1143,23914,3578740048,3578740067,19
3,1143,23915,3578740048,3578740068,20
3,1143,23916,3578740048,3578740071,23
3,1143,23917,3578740048,3578740074,26
3,1143,23918,3578740048,3578740075,27
3,1143,23919,3578740048,3578740076,28
3,1143,23920,3578740048,3578740079,31
3,1143,23921,3578740048,3578740081,33
3,1143,23922,3578740048,3578740081,33
3,1143,23923,3578740048,3578740081,33
3,1143,23924,3578740048,3578740082,34
3,1143,23925,3578740048,3578740084,36
3,1143,23926,3578740048,3578740084,36
3,1143,23927,3578740048,3578740085,37
3,1143,23928,3578740048,3578740087,39
3,1143,23929,3578740048,3578740088,40
3,1143,23930,3578740048,3578740089,41
3,1143,23931,3578740048,3578740090,42
3,1143,23932,3578740048,3578740090,42
3,1143,23933,3578740048,3578740093,45
3,1143,23934,3578740048,3578740095,47
3,1143,23935,3578740048,3578740096,48
3,1143,23936,3578740048,3578740097,49
3,1143,23937,3578740048,3578740097,49
3,1143,23938,3578740048,3578740097,49
3,1144,23939,3578740111,3578740111,0
3,1144,23940,3578740111,3578740111,0
3,1144,23941,3578740111,3578740111,0
3,1144,23942,3578740111,3578740111,0
3,1144,23943,3578740111,3578740111,0
3,1144,23944,3578740111,3578740111,0
3,1144,23945,3578740111,3578740111,0
3,1144,23946,3578740111,3578740111,0
3,1144,23947,3578740111,3578740111,0
3,1144,23948,3578740111,3578740111,0
3,1144,23949,3578740111,3578740111,0
3,1144,23950,3578740111,3578740111,0
3,1144,23951,3578740111,3578740115,4
3,1144,23952,3578740111,3578740116,5
3,1144,23953,3578740111,3578740120,9
3,1144,23954,3578740111,3578740120,9
3,1144,23955,3578740111,3578740121,10
3,1144,23956,3578740111,3578740121,10
3,1144,23957,3578740111,3578740122,11
3,1144,23958,3578740111,3578740122,11
3,1144,23959,3578740111,3578740122,11
3,1144,23960,3578740111,3578740123,12
3,1144,23961,3578740111,3578740125,14
3,1144,23962,3578740111,3578740129,18
3,1144,23963,3578740111,3578740131,20
3,1144,23964,3578740111,3578740136,25
3,1144,23965,3578740111,3578740137,26
3,1144,23966,3578740111,3578740139,28
3,1144,23967,3578740111,3578740139,28
3,1144,23968,3578740111,3578740140,29
3,1144,23969,3578740111,3578740140,29
3,1144,23970,3578740111,3578740140,29
3,1144,23971,3578740111,3578740141,30
3,1144,23972,3578740111,3578740141,30
3,1144,23973,3578740111,3578740144,33
3,1144,23974,3578740111,3578740144,33
3,1144,23975,3578740111,3578740145,34
3,1144,23976,3578740111,3578740146,35
3,1144,23977,3578740111,3578740149,38
3,1144,23978,3578740111,3578740151,40
3,1144,23979,3578740111,3578740151,40
3,1144,23980,3578740111,3578740153,42
3,1144,23981,3578740111,3578740153,42
3,1144,23982,3578740111,3578740153,42
3,1144,23983,3578740111,3578740154,43
3,1144,23984,3578740111,3578740154,43
3,1144,23985,3578740111,3578740155,44
3,1144,23986,3578740111,3578740157,46
3,1144,23987,3578740111,3578740158,47
3,1144,23988,3578740111,3578740158,47
3,1144,23989,3578740111,3578740161,50
3,1145,23990,3578740172,3578740172,0
3,1145,23991,3578740172,3578740172,0
3,1145,23992,3578740172,3578740172,0
3,1145,23993,3578740172,3578740172,0
3,1145,23994,3578740172,3578740172,0
3,1145,23995,3578740172,3578740172,0
3,1145,23996,3578740172,3578740172,0
3,1145,23997,3578740172,3578740172,0
3,1145,23998,3578740172,3578740172,0
3,1145,23999,3578740172,3578740172,0
3,1145,24000,3578740172,3578740172,0
3,1145,24001,3578740172,3578740172,0
3,1145,24002,3578740172,3578740172,0
3,1145,24003,3578740172,3578740173,1
3,1145,24004,3578740172,3578740173,1
3,1145,24005,3578740172,3578740174,2
3,1145,24006,3578740172,3578740174,2
3,1145,24007,3578740172,3578740175,3
3,1145,24008,3578740172,3578740176,4
3,1145,24009,3578740172,3578740177,5
3,1145,24010,3578740172,3578740178,6
3,1145,24011,3578740172,3578740179,7
3,1145,24012,3578740172,3578740181,9
3,1145,24013,3578740172,3578740184,12
3,1145,24014,3578740172,3578740185,13
3,1145,24015,3578740172,3578740187,15
3,1145,24016,3578740172,3578740187,15
3,1145,24017,3578740172,3578740188,16
3,1145,24018,3578740172,3578740188,16
3,1145,24019,3578740172,3578740188,16
3,1145,24020,3578740172,3578740189,17
3,1145,24021,3578740172,3578740189,17
3,1145,24022,3578740172,3578740190,18
3,1145,24023,3578740172,3578740191,19
3,1145,24024,3578740172,3578740192,20
3,1145,24025,3578740172,3578740192,20
3,1145,24026,3578740172,3578740192,20
3,1145,24027,3578740172,3578740193,21
3,1145,24028,3578740172,3578740194,22
3,1145,24029,3578740172,3578740196,24
3,1145,24030,3578740172,3578740198,26
3,1145,24031,3578740172,3578740198,26
3,1145,24032,3578740172,3578740198,26
3,1145,24033,3578740172,3578740200,28
3,1145,24034,3578740172,3578740202,30
3,1145,24035,3578740172,3578740203,31
3,1145,24036,3578740172,3578740203,31
3,1145,24037,3578740172,3578740204,32
3,1145,24038,3578740172,3578740204,32
3,1145,24039,3578740172,3578740204,32
3,1145,24040,3578740172,3578740205,33
3,1145,24041,3578740172,3578740206,34
3,1145,24042,3578740172,3578740208,36
3,1145,24043,3578740172,3578740208,36
3,1145,24044,3578740172,3578740209,37
3,1145,24045,3578740172,3578740211,39
3,1145,24046,3578740172,3578740213,41
3,1145,24047,3578740172,3578740213,41
3,1145,24048,3578740172,3578740214,42
3,1145,24049,3578740172,3578740218,46
3,1145,24050,3578740172,3578740219,47
3,1145,24051,3578740172,3578740219,47
3,1145,24052,3578740172,3578740220,48
3,1145,24053,3578740172,3578740221,49
3,1145,24054,3578740172,3578740221,49
3,1145,24055,3578740172,3578740222,50
3,1146,24056,3578740236,3578740236,0
3,1146,24057,3578740236,3578740236,0
3,1146,24058,3578740236,3578740236,0
3,1146,24059,3578740236,3578740236,0
3,1146,24060,3578740236,3578740236,0
3,1146,24061,3578740236,3578740236,0
3,1146,24062,3578740236,3578740236,0
3,1146,24063,3578740236,3578740236,0
3,1146,24064,3578740236,3578740236,0
3,1146,24065,3578740236,3578740236,0
3,1146,24066,3578740236,3578740236,0
3,1146,24067,3578740236,3578740236,0
3,1146,24068,3578740236,3578740236,0
3,1146,24069,3578740236,3578740236,0
3,1146,24070,3578740236,3578740236,0
3,1146,24071,3578740236,3578740236,0
3,1146,24072,3578740236,3578740236,0
3,1146,24073,3578740236,3578740236,0
3,1146,24074,3578740236,3578740239,3
3,1146,24075,3578740236,3578740240,4
3,1146,24076,3578740236,3578740240,4
3,1146,24077,3578740236,3578740240,4
3,1146,24078,3578740236,3578740241,5
3,1146,24079,3578740236,3578740242,6
3,1146,24080,3578740236,3578740244,8
3,1146,24081,3578740236,3578740245,9
3,1146,24082,3578740236,3578740245,9
3,1146,24083,3578740236,3578740245,9
3,1146,24084,3578740236,3578740246,10
3,1146,24085,3578740236,3578740246,10
3,1146,24086,3578740236,3578740247,11
3,1146,24087,3578740236,3578740250,14
3,1146,24088,3578740236,3578740251,15
3,1146,24089,3578740236,3578740252,16
3,1146,24090,3578740236,3578740253,17
3,1146,24091,3578740236,3578740258,22
3,1146,24092,3578740236,3578740260,24
3,1146,24093,3578740236,3578740261,25
3,1146,24094,3578740236,3578740262,26
3,1146,24095,3578740236,3578740263,27
3,1146,24096,3578740236,3578740264,28
3,1146,24097,3578740236,3578740266,30
3,1146,24098,3578740236,3578740267,31
3,1146,24099,3578740236,3578740268,32
3,1146,24100,3578740236,3578740270,34
3,1146,24101,3578740236,3578740271,35
3,1146,24102,3578740236,3578740274,38
3,1146,24103,3578740236,3578740275,39
3,1146,24104,3578740236,3578740281,45
3,1146,24105,3578740236,3578740281,45
3,1146,24106,3578740236,3578740282,46
3,1146,24107,3578740236,3578740283,47
3,1146,24108,3578740236,3578740284,48
3,1146,24109,3578740236,3578740285,49
3,1147,24110,3578740298,3578740298,0
3,1147,24111,3578740298,3578740298,0
3,1147,24112,3578740298,3578740298,0
3,1147,24113,3578740298,3578740298,0
3,1147,24114,3578740298,3578740298,0
3,1147,24115,3578740298,3578740298,0
3,1147,24116,3578740298,3578740298,0
3,1147,24117,3578740298,3578740298,0
3,1147,24118,3578740298,3578740298,0
3,1147,24119,3578740298,3578740299,1
3,1147,24120,3578740298,3578740299,1
3,1147,24121,3578740298,3578740300,2
3,1147,24122,3578740298,3578740302,4
3,1147,24123,3578740298,3578740302,4
3,1147,24124,3578740298,3578740303,5
3,1147,24125,3578740298,3578740303,5
3,1147,24126,3578740298,3578740303,5
3,1147,24127,3578740298,3578740303,5
3,1147,24128,3578740298,3578740304,6
3,1147,24129,3578740298,3578740308,10
3,1147,24130,3578740298,3578740310,12
3,1147,24131,3578740298,3578740315,17
3,1147,24132,3578740298,3578740316,18
3,1147,24133,3578740298,3578740319,21
3,1147,24134,3578740298,3578740319,21
3,1147,24135,3578740298,3578740320,22
3,1147,24136,3578740298,3578740321,23
3,1147,24137,3578740298,3578740321,23
3,1147,24138,3578740298,3578740322,24
3,1147,24139,3578740298,3578740323,25
3,1147,24140,3578740298,3578740323,25
3,1147,24141,3578740298,3578740325,27
3,1147,24142,3578740298,3578740326,28
3,1147,24143,3578740298,3578740331,33
3,1147,24144,3578740298,3578740336,38
3,1147,24145,3578740298,3578740338,40
3,1147,24146,3578740298,3578740339,41
3,1147,24147,3578740298,3578740340,42
3,1147,24148,3578740298,3578740340,42
3,1147,24149,3578740298,3578740341,43
3,1147,24150,3578740298,3578740344,46
3,1147,24151,3578740298,3578740344,46
3,1147,24152,3578740298,3578740346,48
3,1147,24153,3578740298,3578740346,48
3,1148,24154,3578740363,3578740363,0
3,1148,24155,3578740363,3578740363,0
3,1148,24156,3578740363,3578740363,0
3,1148,24157,3578740363,3578740363,0
3,1148,24158,3578740363,3578740363,0
3,1148,24159,3578740363,3578740363,0
3,1148,24160,3578740363,3578740363,0
3,1148,24161,3578740363,3578740363,0
3,1148,24162,3578740363,3578740363,0
3,1148,24163,3578740363,3578740363,0
3,1148,24164,3578740363,3578740363,0
3,1148,24165,3578740363,3578740363,0
3,1148,24166,3578740363,3578740363,0
3,1148,24167,3578740363,3578740363,0
3,1148,24168,3578740363,3578740364,1
3,1148,24169,3578740363,3578740365,2
3,1148,24170,3578740363,3578740365,2
3,1148,24171,3578740363,3578740368,5
3,1148,24172,3578740363,3578740368,5
3,1148,24173,3578740363,3578740368,5
3,1148,24174,3578740363,3578740369,6
3,1148,24175,3578740363,3578740369,6
3,1148,24176,3578740363,3578740370,7
3,1148,24177,3578740363,3578740371,8
3,1148,24178,3578740363,3578740372,9
3,1148,24179,3578740363,3578740372,9
3,1148,24180,3578740363,3578740373,10
3,1148,24181,3578740363,3578740374,11
3,1148,24182,3578740363,3578740376,13
3,1148,24183,3578740363,3578740376,13
3,1148,24184,3578740363,3578740377,14
3,1148,24185,3578740363,3578740377,14
3,1148,24186,3578740363,3578740379,16
3,1148,24187,3578740363,3578740381,18
3,1148,24188,3578740363,3578740384,21
3,1148,24189,3578740363,3578740385,22
3,1148,24190,3578740363,3578740387,24
3,1148,24191,3578740363,3578740388,25
3,1148,24192,3578740363,3578740388,25
3,1148,24193,3578740363,3578740388,25
3,1148,24194,3578740363,3578740388,25
3,1148,24195,3578740363,3578740389,26
3,1148,24196,3578740363,3578740389,26
3,1148,24197,3578740363,3578740392,29
3,1148,24198,3578740363,3578740392,29
3,1148,24199,3578740363,3578740393,30
3,1148,24200,3578740363,3578740394,31
3,1148,24201,3578740363,3578740394,31
3,1148,24202,3578740363,3578740396,33
3,1148,24203,3578740363,3578740396,33
3,1148,24204,3578740363,3578740398,35
3,1148,24205,3578740363,3578740400,37
3,1148,24206,3578740363,3578740401,38
3,1148,24207,3578740363,3578740403,40
3,1148,24208,3578740363,3578740404,41
3,1148,24209,3578740363,3578740404,41
3,1148,24210,3578740363,3578740405,42
3,1148,24211,3578740363,3578740405,42
3,1148,24212,3578740363,3578740406,43
3,1148,24213,3578740363,3578740406,43
3,1148,24214,3578740363,3578740406,43
3,1148,24215,3578740363,3578740407,44
3,1148,24216,3578740363,3578740408,45
3,1148,24217,3578740363,3578740408,45
3,1148,24218,3578740363,3578740409,46
3,1148,24219,3578740363,3578740409,46
3,1148,24220,3578740363,3578740411,48
3,1149,24221,3578740426,3578740426,0
3,1149,24222,3578740426,3578740426,0
3,1149,24223,3578740426,3578740426,0
3,1149,24224,3578740426,3578740426,0
3,1149,24225,3578740426,3578740426,0
3,1149,24226,3578740426,3578740426,0
3,1149,24227,3578740426,3578740426,0
3,1149,24228,3578740426,3578740426,0
3,1149,24229,3578740426,3578740426,0
3,1149,24230,3578740426,3578740426,0
3,1149,24231,3578740426,3578740426,0
3,1149,24232,3578740426,3578740426,0
3,1149,24233,3578740426,3578740426,0
3,1149,24234,3578740426,3578740426,0
3,1149,24235,3578740426,3578740428,2
3,1149,24236,3578740426,3578740428,2
3,1149,24237,3578740426,3578740428,2
3,1149,24238,3578740426,3578740430,4
3,1149,24239,3578740426,3578740431,5
3,1149,24240,3578740426,3578740431,5
3,1149,24241,3578740426,3578740432,6
3,1149,24242,3578740426,3578740433,7
3,1149,24243,3578740426,3578740433,7
3,1149,24244,3578740426,3578740435,9
3,1149,24245,3578740426,3578740436,10
3,1149,24246,3578740426,3578740436,10
3,1149,24247,3578740426,3578740440,14
3,1149,24248,3578740426,3578740441,15
3,1149,24249,3578740426,3578740441,15
3,1149,24250,3578740426,3578740442,16
3,1149,24251,3578740426,3578740443,17
3,1149,24252,3578740426,3578740445,19
3,1149,24253,3578740426,3578740445,19
3,1149,24254,3578740426,3578740445,19
3,1149,24255,3578740426,3578740446,20
3,1149,24256,3578740426,3578740446,20
3,1149,24257,3578740426,3578740446,20
3,1149,24258,3578740426,3578740447,21
3,1149,24259,3578740426,3578740448,22
3,1149,24260,3578740426,3578740450,24
3,1149,24261,3578740426,3578740451,25
3,1149,24262,3578740426,3578740453,27
3,1149,24263,3578740426,3578740454,28
3,1149,24264,3578740426,3578740455,29
3,1149,24265,3578740426,3578740457,31
3,1149,24266,3578740426,3578740458,32
3,1149,24267,3578740426,3578740459,33
3,1149,24268,3578740426,3578740460,34
3,1149,24269,3578740426,3578740462,36
3,1149,24270,3578740426,3578740463,37
3,1149,24271,3578740426,3578740466,40
3,1149,24272,3578740426,3578740471,45
3,1149,24273,3578740426,3578740475,49
3,1149,24274,3578740426,3578740475,49
3,1150,24275,3578740489,3578740489,0
3,1150,24276,3578740489,3578740489,0
3,1150,24277,3578740489,3578740489,0
3,1150,24278,3578740489,3578740489,0
3,1150,24279,3578740489,3578740489,0
3,1150,24280,3578740489,3578740489,0
3,1150,24281,3578740489,3578740489,0
3,1150,24282,3578740489,3578740489,0
3,1150,24283,3578740489,3578740489,0
3,1150,24284,3578740489,3578740489,0
3,1150,24285,3578740489,3578740489,0
3,1150,24286,3578740489,3578740490,1
3,1150,24287,3578740489,3578740490,1
3,1150,24288,3578740489,3578740490,1
3,1150,24289,3578740489,3578740492,3
3,1150,24290,3578740489,3578740493,4
3,1150,24291,3578740489,3578740493,4
3,1150,24292,3578740489,3578740495,6
3,1150,24293,3578740489,3578740496,7
3,1150,24294,3578740489,3578740496,7
3,1150,24295,3578740489,3578740496,7
3,1150,24296,3578740489,3578740497,8
3,1150,24297,3578740489,3578740499,10
3,1150,24298,3578740489,3578740499,10
3,1150,24299,3578740489,3578740501,12
3,1150,24300,3578740489,3578740501,12
3,1150,24301,3578740489,3578740501,12
3,1150,24302,3578740489,3578740502,13
3,1150,24303,3578740489,3578740502,13
3,1150,24304,3578740489,3578740503,14
3,1150,24305,3578740489,3578740503,14
3,1150,24306,3578740489,3578740508,19
3,1150,24307,3578740489,3578740510,21
3,1150,24308,3578740489,3578740514,25
3,1150,24309,3578740489,3578740516,27
3,1150,24310,3578740489,3578740518,29
3,1150,24311,3578740489,3578740519,30
3,1150,24312,3578740489,3578740519,30
3,1150,24313,3578740489,3578740521,32
3,1150,24314,3578740489,3578740521,32
3,1150,24315,3578740489,3578740522,33
3,1150,24316,3578740489,3578740522,33
3,1150,24317,3578740489,3578740524,35
3,1150,24318,3578740489,3578740525,36
3,1150,24319,3578740489,3578740529,40
3,1150,24320,3578740489,3578740531,42
3,1150,24321,3578740489,3578740535,46
3,1150,24322,3578740489,3578740538,49
3,1150,24323,3578740489,3578740538,49
3,1150,24324,3578740489,3578740539,50
3,1151,24325,3578740554,3578740554,0
3,1151,24326,3578740554,3578740554,0
3,1151,24327,3578740554,3578740554,0
3,1151,24328,3578740554,3578740554,0
3,1151,24329,3578740554,3578740554,0
3,1151,24330,3578740554,3578740554,0
3,1151,24331,3578740554,3578740554,0
3,1151,24332,3578740554,3578740554,0
3,1151,24333,3578740554,3578740554,0
3,1151,24334,3578740554,3578740554,0
3,1151,24335,3578740554,3578740554,0
3,1151,24336,3578740554,3578740554,0
3,1151,24337,3578740554,3578740554,0
3,1151,24338,3578740554,3578740555,1
3,1151,24339,3578740554,3578740558,4
3,1151,24340,3578740554,3578740558,4
3,1151,24341,3578740554,3578740558,4
3,1151,24342,3578740554,3578740558,4
3,1151,24343,3578740554,3578740560,6
3,1151,24344,3578740554,3578740562,8
3,1151,24345,3578740554,3578740564,10
3,1151,24346,3578740554,3578740564,10
3,1151,24347,3578740554,3578740565,11
3,1151,24348,3578740554,3578740566,12
3,1151,24349,3578740554,3578740568,14
3,1151,24350,3578740554,3578740568,14
3,1151,24351,3578740554,3578740568,14
3,1151,24352,3578740554,3578740569,15
3,1151,24353,3578740554,3578740569,15
3,1151,24354,3578740554,3578740570,16
3,1151,24355,3578740554,3578740571,17
3,1151,24356,3578740554,3578740571,17
3,1151,24357,3578740554,3578740572,18
3,1151,24358,3578740554,3578740572,18
3,1151,24359,3578740554,3578740572,18
3,1151,24360,3578740554,3578740573,19
3,1151,24361,3578740554,3578740575,21
3,1151,24362,3578740554,3578740576,22
3,1151,24363,3578740554,3578740576,22
3,1151,24364,3578740554,3578740577,23
3,1151,24365,3578740554,3578740577,23
3,1151,24366,3578740554,3578740581,27
3,1151,24367,3578740554,3578740583,29
3,1151,24368,3578740554,3578740585,31
3,1151,24369,3578740554,3578740586,32
3,1151,24370,3578740554,3578740587,33
3,1151,24371,3578740554,3578740587,33
3,1151,24372,3578740554,3578740588,34
3,1151,24373,3578740554,3578740588,34
3,1151,24374,3578740554,3578740588,34
3,1151,24375,3578740554,3578740589,35
3,1151,24376,3578740554,3578740589,35
3,1151,24377,3578740554,3578740590,36
3,1151,24378,3578740554,3578740591,37
3,1151,24379,3578740554,3578740592,38
3,1151,24380,3578740554,3578740592,38
3,1151,24381,3578740554,3578740592,38
3,1151,24382,3578740554,3578740593,39
3,1151,24383,3578740554,3578740594,40
3,1151,24384,3578740554,3578740595,41
3,1151,24385,3578740554,3578740596,42
3,1151,24386,3578740554,3578740596,42
3,1151,24387,3578740554,3578740597,43
3,1151,24388,3578740554,3578740600,46
3,1151,24389,3578740554,3578740601,47
3,1151,24390,3578740554,3578740602,48
3,1151,24391,3578740554,3578740603,49
3,1151,24392,3578740554,3578740604,50
3,1152,24393,3578740615,3578740615,0
3,1152,24394,3578740615,3578740615,0
3,1152,24395,3578740615,3578740615,0
3,1152,24396,3578740615,3578740615,0
3,1152,24397,3578740615,3578740615,0
3,1152,24398,3578740615,3578740615,0
3,1152,24399,3578740615,3578740615,0
3,1152,24400,3578740615,3578740615,0
3,1152,24401,3578740615,3578740615,0
3,1152,24402,3578740615,3578740615,0
3,1152,24403,3578740615,3578740615,0
3,1152,24404,3578740615,3578740615,0
3,1152,24405,3578740615,3578740615,0
3,1152,24406,3578740615,3578740615,0
3,1152,24407,3578740615,3578740617,2
3,1152,24408,3578740615,3578740618,3
3,1152,24409,3578740615,3578740618,3
3,1152,24410,3578740615,3578740619,4
3,1152,24411,3578740615,3578740620,5
3,1152,24412,3578740615,3578740620,5
3,1152,24413,3578740615,3578740624,9
3,1152,24414,3578740615,3578740625,10
3,1152,24415,3578740615,3578740625,10
3,1152,24416,3578740615,3578740626,11
3,1152,24417,3578740615,3578740627,12
3,1152,24418,3578740615,3578740628,13
3,1152,24419,3578740615,3578740628,13
3,1152,24420,3578740615,3578740629,14
3,1152,24421,3578740615,3578740630,15
3,1152,24422,3578740615,3578740631,16
3,1152,24423,3578740615,3578740632,17
3,1152,24424,3578740615,3578740632,17
3,1152,24425,3578740615,3578740634,19
3,1152,24426,3578740615,3578740635,20
3,1152,24427,3578740615,3578740639,24
3,1152,24428,3578740615,3578740639,24
3,1152,24429,3578740615,3578740639,24
3,1152,24430,3578740615,3578740640,25
3,1152,24431,3578740615,3578740641,26
3,1152,24432,3578740615,3578740641,26
3,1152,24433,3578740615,3578740642,27
3,1152,24434,3578740615,3578740644,29
3,1152,24435,3578740615,3578740644,29
3,1152,24436,3578740615,3578740644,29
3,1152,24437,3578740615,3578740644,29
3,1152,24438,3578740615,3578740645,30
3,1152,24439,3578740615,3578740645,30
3,1152,24440,3578740615,3578740645,30
3,1152,24441,3578740615,3578740646,31
3,1152,24442,3578740615,3578740648,33
3,1152,24443,3578740615,3578740651,36
3,1152,24444,3578740615,3578740651,36
3,1152,24445,3578740615,3578740652,37
3,1152,24446,3578740615,3578740653,38
3,1152,24447,3578740615,3578740655,40
3,1152,24448,3578740615,3578740656,41
3,1152,24449,3578740615,3578740658,43
3,1152,24450,3578740615,3578740658,43
3,1152,24451,3578740615,3578740658,43
3,1152,24452,3578740615,3578740659,44
3,1152,24453,3578740615,3578740660,45
3,1152,24454,3578740615,3578740662,47
3,1152,24455,3578740615,3578740662,47
3,1152,24456,3578740615,3578740663,48
3,1152,24457,3578740615,3578740665,50
3,1153,24458,3578740677,3578740677,0
3,1153,24459,3578740677,3578740677,0
3,1153,24460,3578740677,3578740677,0
3,1153,24461,3578740677,3578740677,0
3,1153,24462,3578740677,3578740677,0
3,1153,24463,3578740677,3578740677,0
3,1153,24464,3578740677,3578740680,3
3,1153,24465,3578740677,3578740680,3
3,1153,24466,3578740677,3578740683,6
3,1153,24467,3578740677,3578740683,6
3,1153,24468,3578740677,3578740683,6
3,1153,24469,3578740677,3578740686,9
3,1153,24470,3578740677,3578740687,10
3,1153,24471,3578740677,3578740690,13
3,1153,24472,3578740677,3578740692,15
3,1153,24473,3578740677,3578740693,16
3,1153,24474,3578740677,3578740695,18
3,1153,24475,3578740677,3578740696,19
3,1153,24476,3578740677,3578740696,19
3,1153,24477,3578740677,3578740696,19
3,1153,24478,3578740677,3578740697,20
3,1153,24479,3578740677,3578740697,20
3,1153,24480,3578740677,3578740699,22
3,1153,24481,3578740677,3578740700,23
3,1153,24482,3578740677,3578740701,24
3,1153,24483,3578740677,3578740702,25
3,1153,24484,3578740677,3578740703,26
3,1153,24485,3578740677,3578740703,26
3,1153,24486,3578740677,3578740703,26
3,1153,24487,3578740677,3578740703,26
3,1153,24488,3578740677,3578740709,32
3,1153,24489,3578740677,3578740710,33
3,1153,24490,3578740677,3578740714,37
3,1153,24491,3578740677,3578740715,38
3,1153,24492,3578740677,3578740718,41
3,1153,24493,3578740677,3578740718,41
3,1153,24494,3578740677,3578740719,42
3,1153,24495,3578740677,3578740721,44
3,1153,24496,3578740677,3578740721,44
3,1153,24497,3578740677,3578740721,44
3,1153,24498,3578740677,3578740722,45
3,1153,24499,3578740677,3578740722,45
3,1153,24500,3578740677,3578740723,46
3,1153,24501,3578740677,3578740724,47
3,1153,24502,3578740677,3578740725,48
3,1154,24503,3578740744,3578740744,0
3,1154,24504,3578740744,3578740744,0
3,1154,24505,3578740744,3578740744,0
3,1154,24506,3578740744,3578740744,0
3,1154,24507,3578740744,3578740744,0
3,1154,24508,3578740744,3578740744,0
3,1154,24509,3578740744,3578740744,0
3,1154,24510,3578740744,3578740744,0
3,1154,24511,3578740744,3578740744,0
3,1154,24512,3578740744,3578740744,0
3,1154,24513,3578740744,3578740744,0
3,1154,24514,3578740744,3578740745,1
3,1154,24515,3578740744,3578740745,1
3,1154,24516,3578740744,3578740746,2
3,1154,24517,3578740744,3578740749,5
3,1154,24518,3578740744,3578740750,6
3,1154,24519,3578740744,3578740752,8
3,1154,24520,3578740744,3578740753,9
3,1154,24521,3578740744,3578740753,9
3,1154,24522,3578740744,3578740753,9
3,1154,24523,3578740744,3578740753,9
3,1154,24524,3578740744,3578740756,12
3,1154,24525,3578740744,3578740758,14
3,1154,24526,3578740744,3578740758,14
3,1154,24527,3578740744,3578740758,14
3,1154,24528,3578740744,3578740761,17
3,1154,24529,3578740744,3578740763,19
3,1154,24530,3578740744,3578740764,20
3,1154,24531,3578740744,3578740765,21
3,1154,24532,3578740744,3578740766,22
3,1154,24533,3578740744,3578740766,22
3,1154,24534,3578740744,3578740767,23
3,1154,24535,3578740744,3578740768,24
3,1154,24536,3578740744,3578740768,24
3,1154,24537,3578740744,3578740769,25
3,1154,24538,3578740744,3578740770,26
3,1154,24539,3578740744,3578740771,27
3,1154,24540,3578740744,3578740772,28
3,1154,24541,3578740744,3578740772,28
3,1154,24542,3578740744,3578740773,29
3,1154,24543,3578740744,3578740774,30
3,1154,24544,3578740744,3578740774,30
3,1154,24545,3578740744,3578740775,31
3,1154,24546,3578740744,3578740777,33
3,1154,24547,3578740744,3578740778,34
3,1154,24548,3578740744,3578740778,34
3,1154,24549,3578740744,3578740781,37
3,1154,24550,3578740744,3578740784,40
3,1154,24551,3578740744,3578740787,43
3,1154,24552,3578740744,3578740787,43
3,1154,24553,3578740744,3578740787,43
3,1154,24554,3578740744,3578740787,43
3,1154,24555,3578740744,3578740787,43
3,1154,24556,3578740744,3578740788,44
3,1154,24557,3578740744,3578740790,46
3,1154,24558,3578740744,3578740790,46
3,1154,24559,3578740744,3578740790,46
3,1154,24560,3578740744,3578740791,47
3,1154,24561,3578740744,3578740792,48
3,1154,24562,3578740744,3578740792,48
3,1154,24563,3578740744,3578740793,49
3,1154,24564,3578740744,3578740793,49
3,1154,24565,3578740744,3578740794,50
3,1155,24566,3578740805,3578740805,0
3,1155,24567,3578740805,3578740805,0
3,1155,24568,3578740805,3578740805,0
3,1155,24569,3578740805,3578740805,0
3,1155,24570,3578740805,3578740805,0
3,1155,24571,3578740805,3578740805,0
3,1155,24572,3578740805,3578740805,0
3,1155,24573,3578740805,3578740805,0
3,1155,24574,3578740805,3578740805,0
3,1155,24575,3578740805,3578740805,0
3,1155,24576,3578740805,3578740805,0
3,1155,24577,3578740805,3578740807,2
3,1155,24578,3578740805,3578740808,3
3,1155,24579,3578740805,3578740808,3
3,1155,24580,3578740805,3578740808,3
3,1155,24581,3578740805,3578740809,4
3,1155,24582,3578740805,3578740811,6
3,1155,24583,3578740805,3578740813,8
3,1155,24584,3578740805,3578740818,13
3,1155,24585,3578740805,3578740818,13
3,1155,24586,3578740805,3578740819,14
3,1155,24587,3578740805,3578740820,15
3,1155,24588,3578740805,3578740821,16
3,1155,24589,3578740805,3578740821,16
3,1155,24590,3578740805,3578740821,16
3,1155,24591,3578740805,3578740821,16
3,1155,24592,3578740805,3578740821,16
3,1155,24593,3578740805,3578740825,20
3,1155,24594,3578740805,3578740825,20
3,1155,24595,3578740805,3578740825,20
3,1155,24596,3578740805,3578740826,21
3,1155,24597,3578740805,3578740827,22
3,1155,24598,3578740805,3578740828,23
3,1155,24599,3578740805,3578740828,23
3,1155,24600,3578740805,3578740829,24
3,1155,24601,3578740805,3578740830,25
3,1155,24602,3578740805,3578740831,26
3,1155,24603,3578740805,3578740831,26
3,1155,24604,3578740805,3578740833,28
3,1155,24605,3578740805,3578740834,29
3,1155,24606,3578740805,3578740835,30
3,1155,24607,3578740805,3578740835,30
3,1155,24608,3578740805,3578740839,34
3,1155,24609,3578740805,3578740839,34
3,1155,24610,3578740805,3578740840,35
3,1155,24611,3578740805,3578740841,36
3,1155,24612,3578740805,3578740842,37
3,1155,24613,3578740805,3578740843,38
3,1155,24614,3578740805,3578740843,38
3,1155,24615,3578740805,3578740844,39
3,1155,24616,3578740805,3578740844,39
3,1155,24617,3578740805,3578740844,39
3,1155,24618,3578740805,3578740845,40
3,1155,24619,3578740805,3578740847,42
3,1155,24620,3578740805,3578740847,42
3,1155,24621,3578740805,3578740848,43
3,1155,24622,3578740805,3578740851,46
3,1155,24623,3578740805,3578740852,47
3,1155,24624,3578740805,3578740852,47
3,1155,24625,3578740805,3578740853,48
3,1155,24626,3578740805,3578740854,49
3,1156,24627,3578740870,3578740870,0
3,1156,24628,3578740870,3578740870,0
3,1156,24629,3578740870,3578740870,0
3,1156,24630,3578740870,3578740870,0
3,1156,24631,3578740870,3578740870,0
3,1156,24632,3578740870,3578740870,0
3,1156,24633,3578740870,3578740870,0
3,1156,24634,3578740870,3578740870,0
3,1156,24635,3578740870,3578740870,0
3,1156,24636,3578740870,3578740870,0
3,1156,24637,3578740870,3578740870,0
3,1156,24638,3578740870,3578740871,1
3,1156,24639,3578740870,3578740872,2
3,1156,24640,3578740870,3578740875,5
3,1156,24641,3578740870,3578740875,5
3,1156,24642,3578740870,3578740876,6
3,1156,24643,3578740870,3578740878,8
3,1156,24644,3578740870,3578740880,10
3,1156,24645,3578740870,3578740880,10
3,1156,24646,3578740870,3578740880,10
3,1156,24647,3578740870,3578740882,12
3,1156,24648,3578740870,3578740882,12
3,1156,24649,3578740870,3578740883,13
3,1156,24650,3578740870,3578740886,16
3,1156,24651,3578740870,3578740887,17
3,1156,24652,3578740870,3578740890,20
3,1156,24653,3578740870,3578740890,20
3,1156,24654,3578740870,3578740890,20
3,1156,24655,3578740870,3578740893,23
3,1156,24656,3578740870,3578740893,23
3,1156,24657,3578740870,3578740895,25
3,1156,24658,3578740870,3578740896,26
3,1156,24659,3578740870,3578740896,26
3,1156,24660,3578740870,3578740897,27
3,1156,24661,3578740870,3578740897,27
3,1156,24662,3578740870,3578740898,28
3,1156,24663,3578740870,3578740900,30
3,1156,24664,3578740870,3578740900,30
3,1156,24665,3578740870,3578740900,30
3,1156,24666,3578740870,3578740901,31
3,1156,24667,3578740870,3578740902,32
3,1156,24668,3578740870,3578740902,32
3,1156,24669,3578740870,3578740902,32
3,1156,24670,3578740870,3578740903,33
3,1156,24671,3578740870,3578740903,33
3,1156,24672,3578740870,3578740904,34
3,1156,24673,3578740870,3578740909,39
3,1156,24674,3578740870,3578740909,39
3,1156,24675,3578740870,3578740914,44
3,1156,24676,3578740870,3578740916,46
3,1156,24677,3578740870,3578740919,49
3,1156,24678,3578740870,3578740919,49
3,1156,24679,3578740870,3578740920,50
3,1157,24680,3578740931,3578740931,0
3,1157,24681,3578740931,3578740931,0
3,1157,24682,3578740931,3578740931,0
3,1157,24683,3578740931,3578740931,0
3,1157,24684,3578740931,3578740931,0
3,1157,24685,3578740931,3578740931,0
3,1157,24686,3578740931,3578740932,1
3,1157,24687,3578740931,3578740935,4
3,1157,24688,3578740931,3578740937,6
3,1157,24689,3578740931,3578740937,6
3,1157,24690,3578740931,3578740939,8
3,1157,24691,3578740931,3578740939,8
3,1157,24692,3578740931,3578740939,8
3,1157,24693,3578740931,3578740940,9
3,1157,24694,3578740931,3578740940,9
3,1157,24695,3578740931,3578740940,9
3,1157,24696,3578740931,3578740944,13
3,1157,24697,3578740931,3578740944,13
3,1157,24698,3578740931,3578740945,14
3,1157,24699,3578740931,3578740945,14
3,1157,24700,3578740931,3578740946,15
3,1157,24701,3578740931,3578740950,19
3,1157,24702,3578740931,3578740951,20
3,1157,24703,3578740931,3578740952,21
3,1157,24704,3578740931,3578740953,22
3,1157,24705,3578740931,3578740953,22
3,1157,24706,3578740931,3578740954,23
3,1157,24707,3578740931,3578740955,24
3,1157,24708,3578740931,3578740957,26
3,1157,24709,3578740931,3578740958,27
3,1157,24710,3578740931,3578740959,28
3,1157,24711,3578740931,3578740963,32
3,1157,24712,3578740931,3578740964,33
3,1157,24713,3578740931,3578740965,34
3,1157,24714,3578740931,3578740967,36
3,1157,24715,3578740931,3578740967,36
3,1157,24716,3578740931,3578740968,37
3,1157,24717,3578740931,3578740968,37
3,1157,24718,3578740931,3578740968,37
3,1157,24719,3578740931,3578740970,39
3,1157,24720,3578740931,3578740971,40
3,1157,24721,3578740931,3578740971,40
3,1157,24722,3578740931,3578740972,41
3,1157,24723,3578740931,3578740973,42
3,1157,24724,3578740931,3578740974,43
3,1157,24725,3578740931,3578740974,43
3,1157,24726,3578740931,3578740974,43
3,1157,24727,3578740931,3578740975,44
3,1157,24728,3578740931,3578740977,46
3,1157,24729,3578740931,3578740977,46
3,1158,24730,3578740992,3578740992,0
3,1158,24731,3578740992,3578740992,0
3,1158,24732,3578740992,3578740992,0
3,1158,24733,3578740992,3578740992,0
3,1158,24734,3578740992,3578740992,0
3,1158,24735,3578740992,3578740992,0
3,1158,24736,3578740992,3578740992,0
3,1158,24737,3578740992,3578740992,0
3,1158,24738,3578740992,3578740992,0
3,1158,24739,3578740992,3578740992,0
3,1158,24740,3578740992,3578740992,0
3,1158,24741,3578740992,3578740992,0
3,1158,24742,3578740992,3578740992,0
3,1158,24743,3578740992,3578740993,1
3,1158,24744,3578740992,3578740993,1
3,1158,24745,3578740992,3578740993,1
3,1158,24746,3578740992,3578740993,1
3,1158,24747,3578740992,3578740995,3
3,1158,24748,3578740992,3578740995,3
3,1158,24749,3578740992,3578740997,5
3,1158,24750,3578740992,3578741000,8
3,1158,24751,3578740992,3578741000,8
3,1158,24752,3578740992,3578741002,10
3,1158,24753,3578740992,3578741003,11
3,1158,24754,3578740992,3578741003,11
3,1158,24755,3578740992,3578741004,12
3,1158,24756,3578740992,3578741004,12
3,1158,24757,3578740992,3578741005,13
3,1158,24758,3578740992,3578741005,13
3,1158,24759,3578740992,3578741005,13
3,1158,24760,3578740992,3578741007,15
3,1158,24761,3578740992,3578741008,16
3,1158,24762,3578740992,3578741008,16
3,1158,24763,3578740992,3578741009,17
3,1158,24764,3578740992,3578741009,17
3,1158,24765,3578740992,3578741011,19
3,1158,24766,3578740992,3578741013,21
3,1158,24767,3578740992,3578741014,22
3,1158,24768,3578740992,3578741017,25
3,1158,24769,3578740992,3578741018,26
3,1158,24770,3578740992,3578741019,27
3,1158,24771,3578740992,3578741020,28
3,1158,24772,3578740992,3578741021,29
3,1158,24773,3578740992,3578741021,29
3,1158,24774,3578740992,3578741021,29
3,1158,24775,3578740992,3578741021,29
3,1158,24776,3578740992,3578741024,32
3,1158,24777,3578740992,3578741025,33
3,1158,24778,3578740992,3578741026,34
3,1158,24779,3578740992,3578741026,34
3,1158,24780,3578740992,3578741027,35
3,1158,24781,3578740992,3578741027,35
3,1158,24782,3578740992,3578741028,36
3,1158,24783,3578740992,3578741029,37
3,1158,24784,3578740992,3578741030,38
3,1158,24785,3578740992,3578741031,39
3,1158,24786,3578740992,3578741031,39
3,1158,24787,3578740992,3578741034,42
3,1158,24788,3578740992,3578741034,42
3,1158,24789,3578740992,3578741035,43
3,1158,24790,3578740992,3578741035,43
3,1158,24791,3578740992,3578741036,44
3,1158,24792,3578740992,3578741036,44
3,1158,24793,3578740992,3578741039,47
3,1158,24794,3578740992,3578741040,48
3,1158,24795,3578740992,3578741041,49
3,1158,24796,3578740992,3578741041,49
3,1158,24797,3578740992,3578741042,50
3,1159,24798,3578741054,3578741054,0
3,1159,24799,3578741054,3578741054,0
3,1159,24800,3578741054,3578741054,0
3,1159,24801,3578741054,3578741054,0
3,1159,24802,3578741054,3578741054,0
3,1159,24803,3578741054,3578741054,0
3,1159,24804,3578741054,3578741054,0
3,1159,24805,3578741054,3578741054,0
3,1159,24806,3578741054,3578741054,0
3,1159,24807,3578741054,3578741054,0
3,1159,24808,3578741054,3578741054,0
3,1159,24809,3578741054,3578741054,0
3,1159,24810,3578741054,3578741054,0
3,1159,24811,3578741054,3578741054,0
3,1159,24812,3578741054,3578741055,1
3,1159,24813,3578741054,3578741056,2
3,1159,24814,3578741054,3578741058,4
3,1159,24815,3578741054,3578741059,5
3,1159,24816,3578741054,3578741060,6
3,1159,24817,3578741054,3578741062,8
3,1159,24818,3578741054,3578741062,8
3,1159,24819,3578741054,3578741064,10
3,1159,24820,3578741054,3578741064,10
3,1159,24821,3578741054,3578741066,12
3,1159,24822,3578741054,3578741069,15
3,1159,24823,3578741054,3578741072,18
3,1159,24824,3578741054,3578741072,18
3,1159,24825,3578741054,3578741075,21
3,1159,24826,3578741054,3578741076,22
3,1159,24827,3578741054,3578741076,22
3,1159,24828,3578741054,3578741078,24
3,1159,24829,3578741054,3578741080,26
3,1159,24830,3578741054,3578741080,26
3,1159,24831,3578741054,3578741082,28
3,1159,24832,3578741054,3578741083,29
3,1159,24833,3578741054,3578741084,30
3,1159,24834,3578741054,3578741086,32
3,1159,24835,3578741054,3578741086,32
3,1159,24836,3578741054,3578741087,33
3,1159,24837,3578741054,3578741089,35
3,1159,24838,3578741054,3578741090,36
3,1159,24839,3578741054,3578741090,36
3,1159,24840,3578741054,3578741092,38
3,1159,24841,3578741054,3578741093,39
3,1159,24842,3578741054,3578741093,39
3,1159,24843,3578741054,3578741095,41
3,1159,24844,3578741054,3578741096,42
3,1159,24845,3578741054,3578741097,43
3,1159,24846,3578741054,3578741097,43
3,1159,24847,3578741054,3578741100,46
3,1159,24848,3578741054,3578741100,46
3,1159,24849,3578741054,3578741100,46
3,1159,24850,3578741054,3578741101,47
3,1159,24851,3578741054,3578741102,48
3,1159,24852,3578741054,3578741103,49
3,1159,24853,3578741054,3578741103,49
3,1159,24854,3578741054,3578741103,49
3,1159,24855,3578741054,3578741103,49
3,1159,24856,3578741054,3578741103,49
3,1160,24857,3578741117,3578741117,0
3,1160,24858,3578741117,3578741117,0
3,1160,24859,3578741117,3578741117,0
3,1160,24860,3578741117,3578741117,0
3,1160,24861,3578741117,3578741118,1
3,1160,24862,3578741117,3578741118,1
3,1160,24863,3578741117,3578741119,2
3,1160,24864,3578741117,3578741121,4
3,1160,24865,3578741117,3578741121,4
3,1160,24866,3578741117,3578741121,4
3,1160,24867,3578741117,3578741121,4
3,1160,24868,3578741117,3578741122,5
3,1160,24869,3578741117,3578741122,5
3,1160,24870,3578741117,3578741122,5
3,1160,24871,3578741117,3578741124,7
3,1160,24872,3578741117,3578741126,9
3,1160,24873,3578741117,3578741129,12
3,1160,24874,3578741117,3578741132,15
3,1160,24875,3578741117,3578741136,19
3,1160,24876,3578741117,3578741137,20
3,1160,24877,3578741117,3578741139,22
3,1160,24878,3578741117,3578741139,22
3,1160,24879,3578741117,3578741139,22
3,1160,24880,3578741117,3578741140,23
3,1160,24881,3578741117,3578741140,23
3,1160,24882,3578741117,3578741140,23
3,1160,24883,3578741117,3578741141,24
3,1160,24884,3578741117,3578741143,26
3,1160,24885,3578741117,3578741145,28
3,1160,24886,3578741117,3578741145,28
3,1160,24887,3578741117,3578741145,28
3,1160,24888,3578741117,3578741147,30
3,1160,24889,3578741117,3578741149,32
3,1160,24890,3578741117,3578741150,33
3,1160,24891,3578741117,3578741150,33
3,1160,24892,3578741117,3578741152,35
3,1160,24893,3578741117,3578741153,36
3,1160,24894,3578741117,3578741153,36
3,1160,24895,3578741117,3578741154,37
3,1160,24896,3578741117,3578741156,39
3,1160,24897,3578741117,3578741157,40
3,1160,24898,3578741117,3578741158,41
3,1160,24899,3578741117,3578741158,41
3,1160,24900,3578741117,3578741160,43
3,1160,24901,3578741117,3578741161,44
3,1160,24902,3578741117,3578741163,46
3,1160,24903,3578741117,3578741164,47
3,1160,24904,3578741117,3578741165,48
3,1160,24905,3578741117,3578741166,49
3,1160,24906,3578741117,3578741166,49
3,1161,24907,3578741181,3578741181,0
3,1161,24908,3578741181,3578741181,0
3,1161,24909,3578741181,3578741181,0
3,1161,24910,3578741181,3578741181,0
3,1161,24911,3578741181,3578741181,0
3,1161,24912,3578741181,3578741181,0
3,1161,24913,3578741181,3578741181,0
3,1161,24914,3578741181,3578741181,0
3,1161,24915,3578741181,3578741181,0
3,1161,24916,3578741181,3578741181,0
3,1161,24917,3578741181,3578741181,0
3,1161,24918,3578741181,3578741181,0
3,1161,24919,3578741181,3578741181,0
3,1161,24920,3578741181,3578741181,0
3,1161,24921,3578741181,3578741181,0
3,1161,24922,3578741181,3578741181,0
3,1161,24923,3578741181,3578741181,0
3,1161,24924,3578741181,3578741184,3
3,1161,24925,3578741181,3578741186,5
3,1161,24926,3578741181,3578741187,6
3,1161,24927,3578741181,3578741188,7
3,1161,24928,3578741181,3578741188,7
3,1161,24929,3578741181,3578741188,7
3,1161,24930,3578741181,3578741189,8
3,1161,24931,3578741181,3578741190,9
3,1161,24932,3578741181,3578741190,9
3,1161,24933,3578741181,3578741190,9
3,1161,24934,3578741181,3578741191,10
3,1161,24935,3578741181,3578741191,10
3,1161,24936,3578741181,3578741192,11
3,1161,24937,3578741181,3578741193,12
3,1161,24938,3578741181,3578741193,12
3,1161,24939,3578741181,3578741193,12
3,1161,24940,3578741181,3578741194,13
3,1161,24941,3578741181,3578741195,14
3,1161,24942,3578741181,3578741196,15
3,1161,24943,3578741181,3578741198,17
3,1161,24944,3578741181,3578741199,18
3,1161,24945,3578741181,3578741201,20
3,1161,24946,3578741181,3578741202,21
3,1161,24947,3578741181,3578741203,22
3,1161,24948,3578741181,3578741203,22
3,1161,24949,3578741181,3578741204,23
3,1161,24950,3578741181,3578741204,23
3,1161,24951,3578741181,3578741205,24
3,1161,24952,3578741181,3578741205,24
3,1161,24953,3578741181,3578741206,25
3,1161,24954,3578741181,3578741206,25
3,1161,24955,3578741181,3578741207,26
3,1161,24956,3578741181,3578741208,27
3,1161,24957,3578741181,3578741208,27
3,1161,24958,3578741181,3578741209,28
3,1161,24959,3578741181,3578741209,28
3,1161,24960,3578741181,3578741212,31
3,1161,24961,3578741181,3578741213,32
3,1161,24962,3578741181,3578741214,33
3,1161,24963,3578741181,3578741217,36
3,1161,24964,3578741181,3578741218,37
3,1161,24965,3578741181,3578741219,38
3,1161,24966,3578741181,3578741220,39
3,1161,24967,3578741181,3578741220,39
3,1161,24968,3578741181,3578741221,40
3,1161,24969,3578741181,3578741223,42
3,1161,24970,3578741181,3578741223,42
3,1161,24971,3578741181,3578741224,43
3,1161,24972,3578741181,3578741226,45
3,1161,24973,3578741181,3578741226,45
3,1161,24974,3578741181,3578741226,45
3,1161,24975,3578741181,3578741227,46
3,1161,24976,3578741181,3578741228,47
3,1161,24977,3578741181,3578741229,48
3,1161,24978,3578741181,3578741230,49
3,1161,24979,3578741181,3578741230,49
3,1162,24980,3578741242,3578741242,0
3,1162,24981,3578741242,3578741242,0
3,1162,24982,3578741242,3578741242,0
3,1162,24983,3578741242,3578741242,0
3,1162,24984,3578741242,3578741242,0
3,1162,24985,3578741242,3578741242,0
3,1162,24986,3578741242,3578741242,0
3,1162,24987,3578741242,3578741242,0
3,1162,24988,3578741242,3578741242,0
3,1162,24989,3578741242,3578741242,0
3,1162,24990,3578741242,3578741242,0
3,1162,24991,3578741242,3578741242,0
3,1162,24992,3578741242,3578741242,0
3,1162,24993,3578741242,3578741244,2
3,1162,24994,3578741242,3578741244,2
3,1162,24995,3578741242,3578741244,2
3,1162,24996,3578741242,3578741244,2
3,1162,24997,3578741242,3578741245,3
3,1162,24998,3578741242,3578741246,4
3,1162,24999,3578741242,3578741246,4
3,1162,25000,3578741242,3578741246,4
3,1162,25001,3578741242,3578741247,5
3,1162,25002,3578741242,3578741248,6
3,1162,25003,3578741242,3578741251,9
3,1162,25004,3578741242,3578741252,10
3,1162,25005,3578741242,3578741252,10
3,1162,25006,3578741242,3578741254,12
3,1162,25007,3578741242,3578741256,14
3,1162,25008,3578741242,3578741258,16
3,1162,25009,3578741242,3578741258,16
3,1162,25010,3578741242,3578741260,18
3,1162,25011,3578741242,3578741262,20
3,1162,25012,3578741242,3578741262,20
3,1162,25013,3578741242,3578741264,22
3,1162,25014,3578741242,3578741264,22
3,1162,25015,3578741242,3578741266,24
3,1162,25016,3578741242,3578741270,28
3,1162,25017,3578741242,3578741270,28
3,1162,25018,3578741242,3578741271,29
3,1162,25019,3578741242,3578741272,30
3,1162,25020,3578741242,3578741275,33
3,1162,25021,3578741242,3578741275,33
3,1162,25022,3578741242,3578741276,34
3,1162,25023,3578741242,3578741278,36
3,1162,25024,3578741242,3578741280,38
3,1162,25025,3578741242,3578741280,38
3,1162,25026,3578741242,3578741280,38
3,1162,25027,3578741242,3578741283,41
3,1162,25028,3578741242,3578741283,41
3,1162,25029,3578741242,3578741284,42
3,1162,25030,3578741242,3578741286,44
3,1162,25031,3578741242,3578741286,44
3,1162,25032,3578741242,3578741287,45
3,1162,25033,3578741242,3578741289,47
3,1162,25034,3578741242,3578741290,48
3,1162,25035,3578741242,3578741290,48
3,1163,25036,3578741302,3578741302,0
3,1163,25037,3578741302,3578741302,0
3,1163,25038,3578741302,3578741302,0
3,1163,25039,3578741302,3578741302,0
3,1163,25040,3578741302,3578741302,0
3,1163,25041,3578741302,3578741302,0
3,1163,25042,3578741302,3578741302,0
3,1163,25043,3578741302,3578741302,0
3,1163,25044,3578741302,3578741302,0
3,1163,25045,3578741302,3578741302,0
3,1163,25046,3578741302,3578741302,0
3,1163,25047,3578741302,3578741302,0
3,1163,25048,3578741302,3578741303,1
3,1163,25049,3578741302,3578741303,1
3,1163,25050,3578741302,3578741303,1
3,1163,25051,3578741302,3578741303,1
3,1163,25052,3578741302,3578741304,2
3,1163,25053,3578741302,3578741309,7
3,1163,25054,3578741302,3578741310,8
3,1163,25055,3578741302,3578741314,12
3,1163,25056,3578741302,3578741319,17
3,1163,25057,3578741302,3578741319,17
3,1163,25058,3578741302,3578741320,18
3,1163,25059,3578741302,3578741320,18
3,1163,25060,3578741302,3578741321,19
3,1163,25061,3578741302,3578741322,20
3,1163,25062,3578741302,3578741322,20
3,1163,25063,3578741302,3578741322,20
3,1163,25064,3578741302,3578741323,21
3,1163,25065,3578741302,3578741325,23
3,1163,25066,3578741302,3578741329,27
3,1163,25067,3578741302,3578741336,34
3,1163,25068,3578741302,3578741337,35
3,1163,25069,3578741302,3578741339,37
3,1163,25070,3578741302,3578741339,37
3,1163,25071,3578741302,3578741340,38
3,1163,25072,3578741302,3578741340,38
3,1163,25073,3578741302,3578741340,38
3,1163,25074,3578741302,3578741341,39
3,1163,25075,3578741302,3578741342,40
3,1163,25076,3578741302,3578741344,42
3,1163,25077,3578741302,3578741345,43
3,1163,25078,3578741302,3578741345,43
3,1163,25079,3578741302,3578741345,43
3,1163,25080,3578741302,3578741346,44
3,1163,25081,3578741302,3578741349,47
3,1163,25082,3578741302,3578741350,48
3,1163,25083,3578741302,3578741352,50
3,1164,25084,3578741366,3578741366,0
3,1164,25085,3578741366,3578741367,1
3,1164,25086,3578741366,3578741367,1
3,1164,25087,3578741366,3578741367,1
3,1164,25088,3578741366,3578741367,1
3,1164,25089,3578741366,3578741367,1
3,1164,25090,3578741366,3578741367,1
3,1164,25091,3578741366,3578741367,1
3,1164,25092,3578741366,3578741367,1
3,1164,25093,3578741366,3578741367,1
3,1164,25094,3578741366,3578741367,1
3,1164,25095,3578741366,3578741367,1
3,1164,25096,3578741366,3578741367,1
3,1164,25097,3578741366,3578741367,1
3,1164,25098,3578741366,3578741367,1
3,1164,25099,3578741366,3578741368,2
3,1164,25100,3578741366,3578741370,4
3,1164,25101,3578741366,3578741370,4
3,1164,25102,3578741366,3578741370,4
3,1164,25103,3578741366,3578741371,5
3,1164,25104,3578741366,3578741371,5
3,1164,25105,3578741366,3578741372,6
3,1164,25106,3578741366,3578741374,8
3,1164,25107,3578741366,3578741374,8
3,1164,25108,3578741366,3578741375,9
3,1164,25109,3578741366,3578741375,9
3,1164,25110,3578741366,3578741376,10
3,1164,25111,3578741366,3578741376,10
3,1164,25112,3578741366,3578741378,12
3,1164,25113,3578741366,3578741378,12
3,1164,25114,3578741366,3578741385,19
3,1164,25115,3578741366,3578741385,19
3,1164,25116,3578741366,3578741387,21
3,1164,25117,3578741366,3578741387,21
3,1164,25118,3578741366,3578741388,22
3,1164,25119,3578741366,3578741389,23
3,1164,25120,3578741366,3578741389,23
3,1164,25121,3578741366,3578741390,24
3,1164,25122,3578741366,3578741390,24
3,1164,25123,3578741366,3578741390,24
3,1164,25124,3578741366,3578741391,25
3,1164,25125,3578741366,3578741392,26
3,1164,25126,3578741366,3578741392,26
3,1164,25127,3578741366,3578741393,27
3,1164,25128,3578741366,3578741393,27
3,1164,25129,3578741366,3578741394,28
3,1164,25130,3578741366,3578741395,29
3,1164,25131,3578741366,3578741396,30
3,1164,25132,3578741366,3578741398,32
3,1164,25133,3578741366,3578741398,32
3,1164,25134,3578741366,3578741401,35
3,1164,25135,3578741366,3578741401,35
3,1164,25136,3578741366,3578741402,36
3,1164,25137,3578741366,3578741404,38
3,1164,25138,3578741366,3578741405,39
3,1164,25139,3578741366,3578741406,40
3,1164,25140,3578741366,3578741406,40
3,1164,25141,3578741366,3578741407,41
3,1164,25142,3578741366,3578741408,42
3,1164,25143,3578741366,3578741408,42
3,1164,25144,3578741366,3578741409,43
3,1164,25145,3578741366,3578741409,43
3,1164,25146,3578741366,3578741412,46
3,1164,25147,3578741366,3578741413,47
3,1164,25148,3578741366,3578741414,48
3,1165,25149,3578741427,3578741427,0
3,1165,25150,3578741427,3578741427,0
3,1165,25151,3578741427,3578741427,0
3,1165,25152,3578741427,3578741427,0
3,1165,25153,3578741427,3578741427,0
3,1165,25154,3578741427,3578741427,0
3,1165,25155,3578741427,3578741427,0
3,1165,25156,3578741427,3578741427,0
3,1165,25157,3578741427,3578741427,0
3,1165,25158,3578741427,3578741427,0
3,1165,25159,3578741427,3578741427,0
3,1165,25160,3578741427,3578741427,0
3,1165,25161,3578741427,3578741427,0
3,1165,25162,3578741427,3578741428,1
3,1165,25163,3578741427,3578741428,1
3,1165,25164,3578741427,3578741429,2
3,1165,25165,3578741427,3578741430,3
3,1165,25166,3578741427,3578741430,3
3,1165,25167,3578741427,3578741432,5
3,1165,25168,3578741427,3578741434,7
3,1165,25169,3578741427,3578741435,8
3,1165,25170,3578741427,3578741435,8
3,1165,25171,3578741427,3578741436,9
3,1165,25172,3578741427,3578741436,9
3,1165,25173,3578741427,3578741440,13
3,1165,25174,3578741427,3578741441,14
3,1165,25175,3578741427,3578741441,14
3,1165,25176,3578741427,3578741442,15
3,1165,25177,3578741427,3578741443,16
3,1165,25178,3578741427,3578741443,16
3,1165,25179,3578741427,3578741444,17
3,1165,25180,3578741427,3578741444,17
3,1165,25181,3578741427,3578741444,17
3,1165,25182,3578741427,3578741444,17
3,1165,25183,3578741427,3578741445,18
3,1165,25184,3578741427,3578741446,19
3,1165,25185,3578741427,3578741446,19
3,1165,25186,3578741427,3578741447,20
3,1165,25187,3578741427,3578741447,20
3,1165,25188,3578741427,3578741448,21
3,1165,25189,3578741427,3578741452,25
3,1165,25190,3578741427,3578741452,25
3,1165,25191,3578741427,3578741452,25
3,1165,25192,3578741427,3578741454,27
3,1165,25193,3578741427,3578741457,30
3,1165,25194,3578741427,3578741457,30
3,1165,25195,3578741427,3578741458,31
3,1165,25196,3578741427,3578741458,31
3,1165,25197,3578741427,3578741459,32
3,1165,25198,3578741427,3578741461,34
3,1165,25199,3578741427,3578741461,34
3,1165,25200,3578741427,3578741464,37
3,1165,25201,3578741427,3578741465,38
3,1165,25202,3578741427,3578741467,40
3,1165,25203,3578741427,3578741471,44
3,1165,25204,3578741427,3578741472,45
3,1165,25205,3578741427,3578741472,45
3,1165,25206,3578741427,3578741475,48
3,1165,25207,3578741427,3578741476,49
3,1165,25208,3578741427,3578741476,49
3,1166,25209,3578741489,3578741489,0
3,1166,25210,3578741489,3578741489,0
3,1166,25211,3578741489,3578741489,0
3,1166,25212,3578741489,3578741489,0
3,1166,25213,3578741489,3578741489,0
3,1166,25214,3578741489,3578741489,0
3,1166,25215,3578741489,3578741489,0
3,1166,25216,3578741489,3578741489,0
3,1166,25217,3578741489,3578741489,0
3,1166,25218,3578741489,3578741489,0
3,1166,25219,3578741489,3578741489,0
3,1166,25220,3578741489,3578741491,2
3,1166,25221,3578741489,3578741492,3
3,1166,25222,3578741489,3578741492,3
3,1166,25223,3578741489,3578741493,4
3,1166,25224,3578741489,3578741494,5
3,1166,25225,3578741489,3578741495,6
3,1166,25226,3578741489,3578741496,7
3,1166,25227,3578741489,3578741498,9
3,1166,25228,3578741489,3578741499,10
3,1166,25229,3578741489,3578741500,11
3,1166,25230,3578741489,3578741500,11
3,1166,25231,3578741489,3578741500,11
3,1166,25232,3578741489,3578741501,12
3,1166,25233,3578741489,3578741501,12
3,1166,25234,3578741489,3578741502,13
3,1166,25235,3578741489,3578741502,13
3,1166,25236,3578741489,3578741502,13
3,1166,25237,3578741489,3578741503,14
3,1166,25238,3578741489,3578741509,20
3,1166,25239,3578741489,3578741510,21
3,1166,25240,3578741489,3578741513,24
3,1166,25241,3578741489,3578741517,28
3,1166,25242,3578741489,3578741518,29
3,1166,25243,3578741489,3578741518,29
3,1166,25244,3578741489,3578741519,30
3,1166,25245,3578741489,3578741519,30
3,1166,25246,3578741489,3578741519,30
3,1166,25247,3578741489,3578741520,31
3,1166,25248,3578741489,3578741521,32
3,1166,25249,3578741489,3578741522,33
3,1166,25250,3578741489,3578741522,33
3,1166,25251,3578741489,3578741525,36
3,1166,25252,3578741489,3578741529,40
3,1166,25253,3578741489,3578741532,43
3,1166,25254,3578741489,3578741534,45
3,1166,25255,3578741489,3578741536,47
3,1166,25256,3578741489,3578741538,49
3,1166,25257,3578741489,3578741538,49
3,1166,25258,3578741489,3578741538,49
3,1166,25259,3578741489,3578741539,50
3,1167,25260,3578741552,3578741552,0
3,1167,25261,3578741552,3578741552,0
3,1167,25262,3578741552,3578741552,0
3,1167,25263,3578741552,3578741552,0
3,1167,25264,3578741552,3578741552,0
3,1167,25265,3578741552,3578741552,0
3,1167,25266,3578741552,3578741552,0
3,1167,25267,3578741552,3578741552,0
3,1167,25268,3578741552,3578741552,0
3,1167,25269,3578741552,3578741552,0
3,1167,25270,3578741552,3578741552,0
3,1167,25271,3578741552,3578741552,0
3,1167,25272,3578741552,3578741552,0
3,1167,25273,3578741552,3578741553,1
3,1167,25274,3578741552,3578741553,1
3,1167,25275,3578741552,3578741554,2
3,1167,25276,3578741552,3578741555,3
3,1167,25277,3578741552,3578741557,5
3,1167,25278,3578741552,3578741557,5
3,1167,25279,3578741552,3578741557,5
3,1167,25280,3578741552,3578741558,6
3,1167,25281,3578741552,3578741560,8
3,1167,25282,3578741552,3578741560,8
3,1167,25283,3578741552,3578741563,11
3,1167,25284,3578741552,3578741565,13
3,1167,25285,3578741552,3578741565,13
3,1167,25286,3578741552,3578741566,14
3,1167,25287,3578741552,3578741568,16
3,1167,25288,3578741552,3578741568,16
3,1167,25289,3578741552,3578741568,16
3,1167,25290,3578741552,3578741569,17
3,1167,25291,3578741552,3578741569,17
3,1167,25292,3578741552,3578741570,18
3,1167,25293,3578741552,3578741571,19
3,1167,25294,3578741552,3578741571,19
3,1167,25295,3578741552,3578741572,20
3,1167,25296,3578741552,3578741573,21
3,1167,25297,3578741552,3578741574,22
3,1167,25298,3578741552,3578741574,22
3,1167,25299,3578741552,3578741574,22
3,1167,25300,3578741552,3578741576,24
3,1167,25301,3578741552,3578741576,24
3,1167,25302,3578741552,3578741578,26
3,1167,25303,3578741552,3578741584,32
3,1167,25304,3578741552,3578741585,33
3,1167,25305,3578741552,3578741586,34
3,1167,25306,3578741552,3578741586,34
3,1167,25307,3578741552,3578741587,35
3,1167,25308,3578741552,3578741587,35
3,1167,25309,3578741552,3578741588,36
3,1167,25310,3578741552,3578741588,36
3,1167,25311,3578741552,3578741589,37
3,1167,25312,3578741552,3578741589,37
3,1167,25313,3578741552,3578741589,37
3,1167,25314,3578741552,3578741590,38
3,1167,25315,3578741552,3578741591,39
3,1167,25316,3578741552,3578741592,40
3,1167,25317,3578741552,3578741592,40
3,1167,25318,3578741552,3578741592,40
3,1167,25319,3578741552,3578741594,42
3,1167,25320,3578741552,3578741594,42
3,1167,25321,3578741552,3578741595,43
3,1167,25322,3578741552,3578741596,44
3,1167,25323,3578741552,3578741597,45
3,1167,25324,3578741552,3578741597,45
3,1167,25325,3578741552,3578741599,47
3,1167,25326,3578741552,3578741600,48
3,1167,25327,3578741552,3578741601,49
3,1168,25328,3578741615,3578741615,0
3,1168,25329,3578741615,3578741615,0
3,1168,25330,3578741615,3578741615,0
3,1168,25331,3578741615,3578741615,0
3,1168,25332,3578741615,3578741615,0
3,1168,25333,3578741615,3578741615,0
3,1168,25334,3578741615,3578741615,0
3,1168,25335,3578741615,3578741616,1
3,1168,25336,3578741615,3578741616,1
3,1168,25337,3578741615,3578741616,1
3,1168,25338,3578741615,3578741616,1
3,1168,25339,3578741615,3578741616,1
3,1168,25340,3578741615,3578741616,1
3,1168,25341,3578741615,3578741616,1
3,1168,25342,3578741615,3578741616,1
3,1168,25343,3578741615,3578741617,2
3,1168,25344,3578741615,3578741618,3
3,1168,25345,3578741615,3578741618,3
3,1168,25346,3578741615,3578741619,4
3,1168,25347,3578741615,3578741620,5
3,1168,25348,3578741615,3578741620,5
3,1168,25349,3578741615,3578741620,5
3,1168,25350,3578741615,3578741621,6
3,1168,25351,3578741615,3578741622,7
3,1168,25352,3578741615,3578741624,9
3,1168,25353,3578741615,3578741625,10
3,1168,25354,3578741615,3578741626,11
3,1168,25355,3578741615,3578741626,11
3,1168,25356,3578741615,3578741627,12
3,1168,25357,3578741615,3578741627,12
3,1168,25358,3578741615,3578741629,14
3,1168,25359,3578741615,3578741629,14
3,1168,25360,3578741615,3578741630,15
3,1168,25361,3578741615,3578741631,16
3,1168,25362,3578741615,3578741632,17
3,1168,25363,3578741615,3578741632,17
3,1168,25364,3578741615,3578741634,19
3,1168,25365,3578741615,3578741634,19
3,1168,25366,3578741615,3578741635,20
3,1168,25367,3578741615,3578741635,20
3,1168,25368,3578741615,3578741638,23
3,1168,25369,3578741615,3578741639,24
3,1168,25370,3578741615,3578741639,24
3,1168,25371,3578741615,3578741640,25
3,1168,25372,3578741615,3578741641,26
3,1168,25373,3578741615,3578741642,27
3,1168,25374,3578741615,3578741643,28
3,1168,25375,3578741615,3578741643,28
3,1168,25376,3578741615,3578741643,28
3,1168,25377,3578741615,3578741644,29
3,1168,25378,3578741615,3578741644,29
3,1168,25379,3578741615,3578741644,29
3,1168,25380,3578741615,3578741645,30
3,1168,25381,3578741615,3578741646,31
3,1168,25382,3578741615,3578741646,31
3,1168,25383,3578741615,3578741646,31
3,1168,25384,3578741615,3578741646,31
3,1168,25385,3578741615,3578741650,35
3,1168,25386,3578741615,3578741650,35
3,1168,25387,3578741615,3578741651,36
3,1168,25388,3578741615,3578741653,38
3,1168,25389,3578741615,3578741653,38
3,1168,25390,3578741615,3578741656,41
3,1168,25391,3578741615,3578741656,41
3,1168,25392,3578741615,3578741657,42
3,1168,25393,3578741615,3578741658,43
3,1168,25394,3578741615,3578741658,43
3,1168,25395,3578741615,3578741659,44
3,1168,25396,3578741615,3578741660,45
3,1168,25397,3578741615,3578741660,45
3,1168,25398,3578741615,3578741661,46
3,1168,25399,3578741615,3578741663,48
3,1168,25400,3578741615,3578741663,48
3,1169,25401,3578741677,3578741677,0
3,1169,25402,3578741677,3578741677,0
3,1169,25403,3578741677,3578741677,0
3,1169,25404,3578741677,3578741677,0
3,1169,25405,3578741677,3578741677,0
3,1169,25406,3578741677,3578741677,0
3,1169,25407,3578741677,3578741677,0
3,1169,25408,3578741677,3578741679,2
3,1169,25409,3578741677,3578741680,3
3,1169,25410,3578741677,3578741680,3
3,1169,25411,3578741677,3578741682,5
3,1169,25412,3578741677,3578741683,6
3,1169,25413,3578741677,3578741683,6
3,1169,25414,3578741677,3578741685,8
3,1169,25415,3578741677,3578741685,8
3,1169,25416,3578741677,3578741686,9
3,1169,25417,3578741677,3578741689,12
3,1169,25418,3578741677,3578741691,14
3,1169,25419,3578741677,3578741692,15
3,1169,25420,3578741677,3578741692,15
3,1169,25421,3578741677,3578741693,16
3,1169,25422,3578741677,3578741694,17
3,1169,25423,3578741677,3578741694,17
3,1169,25424,3578741677,3578741695,18
3,1169,25425,3578741677,3578741696,19
3,1169,25426,3578741677,3578741697,20
3,1169,25427,3578741677,3578741699,22
3,1169,25428,3578741677,3578741699,22
3,1169,25429,3578741677,3578741700,23
3,1169,25430,3578741677,3578741700,23
3,1169,25431,3578741677,3578741701,24
3,1169,25432,3578741677,3578741702,25
3,1169,25433,3578741677,3578741702,25
3,1169,25434,3578741677,3578741703,26
3,1169,25435,3578741677,3578741703,26
3,1169,25436,3578741677,3578741709,32
3,1169,25437,3578741677,3578741710,33
3,1169,25438,3578741677,3578741713,36
3,1169,25439,3578741677,3578741718,41
3,1169,25440,3578741677,3578741718,41
3,1169,25441,3578741677,3578741718,41
3,1169,25442,3578741677,3578741719,42
3,1169,25443,3578741677,3578741720,43
3,1169,25444,3578741677,3578741720,43
3,1169,25445,3578741677,3578741721,44
3,1169,25446,3578741677,3578741722,45
3,1169,25447,3578741677,3578741723,46
3,1169,25448,3578741677,3578741723,46
3,1169,25449,3578741677,3578741724,47
3,1170,25450,3578741738,3578741738,0
3,1170,25451,3578741738,3578741738,0
3,1170,25452,3578741738,3578741738,0
3,1170,25453,3578741738,3578741738,0
3,1170,25454,3578741738,3578741738,0
3,1170,25455,3578741738,3578741738,0
3,1170,25456,3578741738,3578741738,0
3,1170,25457,3578741738,3578741739,1
3,1170,25458,3578741738,3578741739,1
3,1170,25459,3578741738,3578741740,2
3,1170,25460,3578741738,3578741742,4
3,1170,25461,3578741738,3578741743,5
3,1170,25462,3578741738,3578741744,6
3,1170,25463,3578741738,3578741744,6
3,1170,25464,3578741738,3578741745,7
3,1170,25465,3578741738,3578741749,11
3,1170,25466,3578741738,3578741750,12
3,1170,25467,3578741738,3578741751,13
3,1170,25468,3578741738,3578741752,14
3,1170,25469,3578741738,3578741753,15
3,1170,25470,3578741738,3578741755,17
3,1170,25471,3578741738,3578741755,17
3,1170,25472,3578741738,3578741757,19
3,1170,25473,3578741738,3578741757,19
3,1170,25474,3578741738,3578741758,20
3,1170,25475,3578741738,3578741758,20
3,1170,25476,3578741738,3578741760,22
3,1170,25477,3578741738,3578741760,22
3,1170,25478,3578741738,3578741763,25
3,1170,25479,3578741738,3578741764,26
3,1170,25480,3578741738,3578741765,27
3,1170,25481,3578741738,3578741765,27
3,1170,25482,3578741738,3578741766,28
3,1170,25483,3578741738,3578741768,30
3,1170,25484,3578741738,3578741768,30
3,1170,25485,3578741738,3578741769,31
3,1170,25486,3578741738,3578741769,31
3,1170,25487,3578741738,3578741769,31
3,1170,25488,3578741738,3578741770,32
3,1170,25489,3578741738,3578741771,33
3,1170,25490,3578741738,3578741771,33
3,1170,25491,3578741738,3578741772,34
3,1170,25492,3578741738,3578741774,36
3,1170,25493,3578741738,3578741774,36
3,1170,25494,3578741738,3578741774,36
3,1170,25495,3578741738,3578741774,36
3,1170,25496,3578741738,3578741775,37
3,1170,25497,3578741738,3578741776,38
3,1170,25498,3578741738,3578741776,38
3,1170,25499,3578741738,3578741778,40
3,1170,25500,3578741738,3578741784,46
3,1170,25501,3578741738,3578741785,47
3,1170,25502,3578741738,3578741786,48
3,1170,25503,3578741738,3578741787,49
3,1170,25504,3578741738,3578741787,49
3,1170,25505,3578741738,3578741787,49
3,1170,25506,3578741738,3578741788,50
3,1170,25507,3578741738,3578741788,50
3,1171,25508,3578741799,3578741800,1
3,1171,25509,3578741799,3578741800,1
3,1171,25510,3578741799,3578741800,1
3,1171,25511,3578741799,3578741800,1
3,1171,25512,3578741799,3578741800,1
3,1171,25513,3578741799,3578741800,1
3,1171,25514,3578741799,3578741800,1
3,1171,25515,3578741799,3578741800,1
3,1171,25516,3578741799,3578741800,1
3,1171,25517,3578741799,3578741800,1
3,1171,25518,3578741799,3578741800,1
3,1171,25519,3578741799,3578741800,1
3,1171,25520,3578741799,3578741801,2
3,1171,25521,3578741799,3578741802,3
3,1171,25522,3578741799,3578741802,3
3,1171,25523,3578741799,3578741803,4
3,1171,25524,3578741799,3578741804,5
3,1171,25525,3578741799,3578741804,5
3,1171,25526,3578741799,3578741805,6
3,1171,25527,3578741799,3578741805,6
3,1171,25528,3578741799,3578741805,6
3,1171,25529,3578741799,3578741807,8
3,1171,25530,3578741799,3578741807,8
3,1171,25531,3578741799,3578741807,8
3,1171,25532,3578741799,3578741808,9
3,1171,25533,3578741799,3578741808,9
3,1171,25534,3578741799,3578741809,10
3,1171,25535,3578741799,3578741811,12
3,1171,25536,3578741799,3578741812,13
3,1171,25537,3578741799,3578741813,14
3,1171,25538,3578741799,3578741817,18
3,1171,25539,3578741799,3578741818,19
3,1171,25540,3578741799,3578741819,20
3,1171,25541,3578741799,3578741820,21
3,1171,25542,3578741799,3578741820,21
3,1171,25543,3578741799,3578741820,21
3,1171,25544,3578741799,3578741820,21
3,1171,25545,3578741799,3578741822,23
3,1171,25546,3578741799,3578741822,23
3,1171,25547,3578741799,3578741824,25
3,1171,25548,3578741799,3578741825,26
3,1171,25549,3578741799,3578741825,26
3,1171,25550,3578741799,3578741826,27
3,1171,25551,3578741799,3578741827,28
3,1171,25552,3578741799,3578741827,28
3,1171,25553,3578741799,3578741827,28
3,1171,25554,3578741799,3578741828,29
3,1171,25555,3578741799,3578741831,32
3,1171,25556,3578741799,3578741831,32
3,1171,25557,3578741799,3578741831,32
3,1171,25558,3578741799,3578741832,33
3,1171,25559,3578741799,3578741832,33
3,1171,25560,3578741799,3578741834,35
3,1171,25561,3578741799,3578741835,36
3,1171,25562,3578741799,3578741835,36
3,1171,25563,3578741799,3578741835,36
3,1171,25564,3578741799,3578741835,36
3,1171,25565,3578741799,3578741838,39
3,1171,25566,3578741799,3578741838,39
3,1171,25567,3578741799,3578741839,40
3,1171,25568,3578741799,3578741840,41
3,1171,25569,3578741799,3578741841,42
3,1171,25570,3578741799,3578741842,43
3,1171,25571,3578741799,3578741843,44
3,1171,25572,3578741799,3578741843,44
3,1171,25573,3578741799,3578741843,44
3,1171,25574,3578741799,3578741843,44
3,1171,25575,3578741799,3578741844,45
3,1171,25576,3578741799,3578741845,46
3,1171,25577,3578741799,3578741846,47
3,1171,25578,3578741799,3578741846,47
3,1171,25579,3578741799,3578741846,47
3,1171,25580,3578741799,3578741847,48
3,1172,25581,3578741861,3578741861,0
3,1172,25582,3578741861,3578741861,0
3,1172,25583,3578741861,3578741861,0
3,1172,25584,3578741861,3578741861,0
3,1172,25585,3578741861,3578741861,0
3,1172,25586,3578741861,3578741861,0
3,1172,25587,3578741861,3578741861,0
3,1172,25588,3578741861,3578741861,0
3,1172,25589,3578741861,3578741861,0
3,1172,25590,3578741861,3578741861,0
3,1172,25591,3578741861,3578741861,0
3,1172,25592,3578741861,3578741861,0
3,1172,25593,3578741861,3578741862,1
3,1172,25594,3578741861,3578741863,2
3,1172,25595,3578741861,3578741864,3
3,1172,25596,3578741861,3578741866,5
3,1172,25597,3578741861,3578741869,8
3,1172,25598,3578741861,3578741869,8
3,1172,25599,3578741861,3578741871,10
3,1172,25600,3578741861,3578741872,11
3,1172,25601,3578741861,3578741875,14
3,1172,25602,3578741861,3578741875,14
3,1172,25603,3578741861,3578741876,15
3,1172,25604,3578741861,3578741879,18
3,1172,25605,3578741861,3578741880,19
3,1172,25606,3578741861,3578741880,19
3,1172,25607,3578741861,3578741882,21
3,1172,25608,3578741861,3578741882,21
3,1172,25609,3578741861,3578741883,22
3,1172,25610,3578741861,3578741884,23
3,1172,25611,3578741861,3578741885,24
3,1172,25612,3578741861,3578741886,25
3,1172,25613,3578741861,3578741886,25
3,1172,25614,3578741861,3578741889,28
3,1172,25615,3578741861,3578741892,31
3,1172,25616,3578741861,3578741892,31
3,1172,25617,3578741861,3578741893,32
3,1172,25618,3578741861,3578741893,32
3,1172,25619,3578741861,3578741894,33
3,1172,25620,3578741861,3578741895,34
3,1172,25621,3578741861,3578741896,35
3,1172,25622,3578741861,3578741896,35
3,1172,25623,3578741861,3578741898,37
3,1172,25624,3578741861,3578741898,37
3,1172,25625,3578741861,3578741899,38
3,1172,25626,3578741861,3578741900,39
3,1172,25627,3578741861,3578741900,39
3,1172,25628,3578741861,3578741900,39
3,1172,25629,3578741861,3578741901,40
3,1172,25630,3578741861,3578741901,40
3,1172,25631,3578741861,3578741902,41
3,1172,25632,3578741861,3578741902,41
3,1172,25633,3578741861,3578741903,42
3,1172,25634,3578741861,3578741903,42
3,1172,25635,3578741861,3578741908,47
3,1172,25636,3578741861,3578741910,49
3,1173,25637,3578741924,3578741924,0
3,1173,25638,3578741924,3578741924,0
3,1173,25639,3578741924,3578741924,0
3,1173,25640,3578741924,3578741924,0
3,1173,25641,3578741924,3578741924,0
3,1173,25642,3578741924,3578741924,0
3,1173,25643,3578741924,3578741924,0
3,1173,25644,3578741924,3578741924,0
3,1173,25645,3578741924,3578741924,0
3,1173,25646,3578741924,3578741924,0
3,1173,25647,3578741924,3578741924,0
3,1173,25648,3578741924,3578741924,0
3,1173,25649,3578741924,3578741924,0
3,1173,25650,3578741924,3578741925,1
3,1173,25651,3578741924,3578741932,8
3,1173,25652,3578741924,3578741932,8
3,1173,25653,3578741924,3578741936,12
3,1173,25654,3578741924,3578741936,12
3,1173,25655,3578741924,3578741938,14
3,1173,25656,3578741924,3578741938,14
3,1173,25657,3578741924,3578741938,14
3,1173,25658,3578741924,3578741939,15
3,1173,25659,3578741924,3578741940,16
3,1173,25660,3578741924,3578741940,16
3,1173,25661,3578741924,3578741942,18
3,1173,25662,3578741924,3578741942,18
3,1173,25663,3578741924,3578741944,20
3,1173,25664,3578741924,3578741944,20
3,1173,25665,3578741924,3578741945,21
3,1173,25666,3578741924,3578741949,25
3,1173,25667,3578741924,3578741951,27
3,1173,25668,3578741924,3578741951,27
3,1173,25669,3578741924,3578741952,28
3,1173,25670,3578741924,3578741953,29
3,1173,25671,3578741924,3578741953,29
3,1173,25672,3578741924,3578741954,30
3,1173,25673,3578741924,3578741955,31
3,1173,25674,3578741924,3578741957,33
3,1173,25675,3578741924,3578741957,33
3,1173,25676,3578741924,3578741958,34
3,1173,25677,3578741924,3578741958,34
3,1173,25678,3578741924,3578741960,36
3,1173,25679,3578741924,3578741961,37
3,1173,25680,3578741924,3578741963,39
3,1173,25681,3578741924,3578741963,39
3,1173,25682,3578741924,3578741965,41
3,1173,25683,3578741924,3578741965,41
3,1173,25684,3578741924,3578741965,41
3,1173,25685,3578741924,3578741967,43
3,1173,25686,3578741924,3578741967,43
3,1173,25687,3578741924,3578741968,44
3,1173,25688,3578741924,3578741968,44
3,1173,25689,3578741924,3578741968,44
3,1173,25690,3578741924,3578741969,45
3,1173,25691,3578741924,3578741969,45
3,1173,25692,3578741924,3578741969,45
3,1173,25693,3578741924,3578741970,46
3,1173,25694,3578741924,3578741971,47
3,1173,25695,3578741924,3578741972,48
3,1173,25696,3578741924,3578741973,49
3,1173,25697,3578741924,3578741973,49
3,1173,25698,3578741924,3578741973,49
3,1173,25699,3578741924,3578741974,50
3,1174,25700,3578741987,3578741987,0
3,1174,25701,3578741987,3578741987,0
3,1174,25702,3578741987,3578741987,0
3,1174,25703,3578741987,3578741987,0
3,1174,25704,3578741987,3578741987,0
3,1174,25705,3578741987,3578741987,0
3,1174,25706,3578741987,3578741987,0
3,1174,25707,3578741987,3578741987,0
3,1174,25708,3578741987,3578741987,0
3,1174,25709,3578741987,3578741987,0
3,1174,25710,3578741987,3578741987,0
3,1174,25711,3578741987,3578741988,1
3,1174,25712,3578741987,3578741988,1
3,1174,25713,3578741987,3578741988,1
3,1174,25714,3578741987,3578741989,2
3,1174,25715,3578741987,3578741989,2
3,1174,25716,3578741987,3578741990,3
3,1174,25717,3578741987,3578741991,4
3,1174,25718,3578741987,3578741991,4
3,1174,25719,3578741987,3578741992,5
3,1174,25720,3578741987,3578741993,6
3,1174,25721,3578741987,3578741993,6
3,1174,25722,3578741987,3578741993,6
3,1174,25723,3578741987,3578741995,8
3,1174,25724,3578741987,3578741997,10
3,1174,25725,3578741987,3578741997,10
3,1174,25726,3578741987,3578741999,12
3,1174,25727,3578741987,3578742000,13
3,1174,25728,3578741987,3578742002,15
3,1174,25729,3578741987,3578742004,17
3,1174,25730,3578741987,3578742004,17
3,1174,25731,3578741987,3578742004,17
3,1174,25732,3578741987,3578742005,18
3,1174,25733,3578741987,3578742005,18
3,1174,25734,3578741987,3578742006,19
3,1174,25735,3578741987,3578742006,19
3,1174,25736,3578741987,3578742007,20
3,1174,25737,3578741987,3578742007,20
3,1174,25738,3578741987,3578742008,21
3,1174,25739,3578741987,3578742009,22
3,1174,25740,3578741987,3578742013,26
3,1174,25741,3578741987,3578742015,28
3,1174,25742,3578741987,3578742017,30
3,1174,25743,3578741987,3578742018,31
3,1174,25744,3578741987,3578742018,31
3,1174,25745,3578741987,3578742019,32
3,1174,25746,3578741987,3578742020,33
3,1174,25747,3578741987,3578742020,33
3,1174,25748,3578741987,3578742020,33
3,1174,25749,3578741987,3578742021,34
3,1174,25750,3578741987,3578742022,35
3,1174,25751,3578741987,3578742024,37
3,1174,25752,3578741987,3578742025,38
3,1174,25753,3578741987,3578742025,38
3,1174,25754,3578741987,3578742026,39
3,1174,25755,3578741987,3578742027,40
3,1174,25756,3578741987,3578742027,40
3,1174,25757,3578741987,3578742028,41
3,1174,25758,3578741987,3578742030,43
3,1174,25759,3578741987,3578742031,44
3,1174,25760,3578741987,3578742031,44
3,1174,25761,3578741987,3578742032,45
3,1174,25762,3578741987,3578742033,46
3,1174,25763,3578741987,3578742034,47
3,1174,25764,3578741987,3578742034,47
3,1174,25765,3578741987,3578742035,48
3,1174,25766,3578741987,3578742036,49
3,1174,25767,3578741987,3578742036,49
3,1175,25768,3578742051,3578742051,0
3,1175,25769,3578742051,3578742051,0
3,1175,25770,3578742051,3578742051,0
3,1175,25771,3578742051,3578742051,0
3,1175,25772,3578742051,3578742051,0
3,1175,25773,3578742051,3578742051,0
3,1175,25774,3578742051,3578742051,0
3,1175,25775,3578742051,3578742051,0
3,1175,25776,3578742051,3578742051,0
3,1175,25777,3578742051,3578742051,0
3,1175,25778,3578742051,3578742051,0
3,1175,25779,3578742051,3578742051,0
3,1175,25780,3578742051,3578742051,0
3,1175,25781,3578742051,3578742051,0
3,1175,25782,3578742051,3578742051,0
3,1175,25783,3578742051,3578742051,0
3,1175,25784,3578742051,3578742052,1
3,1175,25785,3578742051,3578742053,2
3,1175,25786,3578742051,3578742056,5
3,1175,25787,3578742051,3578742057,6
3,1175,25788,3578742051,3578742057,6
3,1175,25789,3578742051,3578742057,6
3,1175,25790,3578742051,3578742058,7
3,1175,25791,3578742051,3578742059,8
3,1175,25792,3578742051,3578742060,9
3,1175,25793,3578742051,3578742061,10
3,1175,25794,3578742051,3578742062,11
3,1175,25795,3578742051,3578742064,13
3,1175,25796,3578742051,3578742064,13
3,1175,25797,3578742051,3578742065,14
3,1175,25798,3578742051,3578742069,18
3,1175,25799,3578742051,3578742070,19
3,1175,25800,3578742051,3578742071,20
3,1175,25801,3578742051,3578742072,21
3,1175,25802,3578742051,3578742075,24
3,1175,25803,3578742051,3578742075,24
3,1175,25804,3578742051,3578742076,25
3,1175,25805,3578742051,3578742079,28
3,1175,25806,3578742051,3578742080,29
3,1175,25807,3578742051,3578742080,29
3,1175,25808,3578742051,3578742082,31
3,1175,25809,3578742051,3578742082,31
3,1175,25810,3578742051,3578742083,32
3,1175,25811,3578742051,3578742084,33
3,1175,25812,3578742051,3578742085,34
3,1175,25813,3578742051,3578742086,35
3,1175,25814,3578742051,3578742086,35
3,1175,25815,3578742051,3578742088,37
3,1175,25816,3578742051,3578742089,38
3,1175,25817,3578742051,3578742090,39
3,1175,25818,3578742051,3578742092,41
3,1175,25819,3578742051,3578742092,41
3,1175,25820,3578742051,3578742093,42
3,1175,25821,3578742051,3578742094,43
3,1175,25822,3578742051,3578742095,44
3,1175,25823,3578742051,3578742096,45
3,1175,25824,3578742051,3578742096,45
3,1175,25825,3578742051,3578742098,47
3,1175,25826,3578742051,3578742098,47
3,1175,25827,3578742051,3578742099,48
3,1175,25828,3578742051,3578742099,48
3,1175,25829,3578742051,3578742100,49
3,1175,25830,3578742051,3578742100,49
3,1175,25831,3578742051,3578742101,50
3,1176,25832,3578742114,3578742114,0
3,1176,25833,3578742114,3578742114,0
3,1176,25834,3578742114,3578742114,0
3,1176,25835,3578742114,3578742114,0
3,1176,25836,3578742114,3578742114,0
3,1176,25837,3578742114,3578742114,0
3,1176,25838,3578742114,3578742114,0
3,1176,25839,3578742114,3578742114,0
3,1176,25840,3578742114,3578742116,2
3,1176,25841,3578742114,3578742116,2
3,1176,25842,3578742114,3578742117,3
3,1176,25843,3578742114,3578742118,4
3,1176,25844,3578742114,3578742118,4
3,1176,25845,3578742114,3578742119,5
3,1176,25846,3578742114,3578742119,5
3,1176,25847,3578742114,3578742120,6
3,1176,25848,3578742114,3578742121,7
3,1176,25849,3578742114,3578742121,7
3,1176,25850,3578742114,3578742122,8
3,1176,25851,3578742114,3578742123,9
3,1176,25852,3578742114,3578742123,9
3,1176,25853,3578742114,3578742126,12
3,1176,25854,3578742114,3578742132,18
3,1176,25855,3578742114,3578742132,18
3,1176,25856,3578742114,3578742135,21
3,1176,25857,3578742114,3578742136,22
3,1176,25858,3578742114,3578742138,24
3,1176,25859,3578742114,3578742138,24
3,1176,25860,3578742114,3578742138,24
3,1176,25861,3578742114,3578742139,25
3,1176,25862,3578742114,3578742139,25
3,1176,25863,3578742114,3578742139,25
3,1176,25864,3578742114,3578742140,26
3,1176,25865,3578742114,3578742142,28
3,1176,25866,3578742114,3578742143,29
3,1176,25867,3578742114,3578742144,30
3,1176,25868,3578742114,3578742144,30
3,1176,25869,3578742114,3578742145,31
3,1176,25870,3578742114,3578742149,35
3,1176,25871,3578742114,3578742151,37
3,1176,25872,3578742114,3578742151,37
3,1176,25873,3578742114,3578742152,38
3,1176,25874,3578742114,3578742153,39
3,1176,25875,3578742114,3578742153,39
3,1176,25876,3578742114,3578742154,40
3,1176,25877,3578742114,3578742156,42
3,1176,25878,3578742114,3578742157,43
3,1176,25879,3578742114,3578742158,44
3,1176,25880,3578742114,3578742158,44
3,1176,25881,3578742114,3578742158,44
3,1176,25882,3578742114,3578742160,46
3,1176,25883,3578742114,3578742161,47
3,1176,25884,3578742114,3578742163,49
3,1176,25885,3578742114,3578742163,49
3,1176,25886,3578742114,3578742164,50
3,1177,25887,3578742176,3578742176,0
3,1177,25888,3578742176,3578742176,0
3,1177,25889,3578742176,3578742176,0
3,1177,25890,3578742176,3578742176,0
3,1177,25891,3578742176,3578742176,0
3,1177,25892,3578742176,3578742176,0
3,1177,25893,3578742176,3578742176,0
3,1177,25894,3578742176,3578742176,0
3,1177,25895,3578742176,3578742176,0
3,1177,25896,3578742176,3578742176,0
3,1177,25897,3578742176,3578742176,0
3,1177,25898,3578742176,3578742176,0
3,1177,25899,3578742176,3578742176,0
3,1177,25900,3578742176,3578742176,0
3,1177,25901,3578742176,3578742176,0
3,1177,25902,3578742176,3578742176,0
3,1177,25903,3578742176,3578742176,0
3,1177,25904,3578742176,3578742176,0
3,1177,25905,3578742176,3578742176,0
3,1177,25906,3578742176,3578742177,1
3,1177,25907,3578742176,3578742179,3
3,1177,25908,3578742176,3578742184,8
3,1177,25909,3578742176,3578742185,9
3,1177,25910,3578742176,3578742186,10
3,1177,25911,3578742176,3578742186,10
3,1177,25912,3578742176,3578742187,11
3,1177,25913,3578742176,3578742188,12
3,1177,25914,3578742176,3578742188,12
3,1177,25915,3578742176,3578742188,12
3,1177,25916,3578742176,3578742189,13
3,1177,25917,3578742176,3578742189,13
3,1177,25918,3578742176,3578742189,13
3,1177,25919,3578742176,3578742191,15
3,1177,25920,3578742176,3578742191,15
3,1177,25921,3578742176,3578742191,15
3,1177,25922,3578742176,3578742191,15
3,1177,25923,3578742176,3578742192,16
3,1177,25924,3578742176,3578742192,16
3,1177,25925,3578742176,3578742194,18
3,1177,25926,3578742176,3578742194,18
3,1177,25927,3578742176,3578742196,20
3,1177,25928,3578742176,3578742197,21
3,1177,25929,3578742176,3578742197,21
3,1177,25930,3578742176,3578742200,24
3,1177,25931,3578742176,3578742201,25
3,1177,25932,3578742176,3578742203,27
3,1177,25933,3578742176,3578742203,27
3,1177,25934,3578742176,3578742203,27
3,1177,25935,3578742176,3578742204,28
3,1177,25936,3578742176,3578742205,29
3,1177,25937,3578742176,3578742205,29
3,1177,25938,3578742176,3578742205,29
3,1177,25939,3578742176,3578742205,29
3,1177,25940,3578742176,3578742206,30
3,1177,25941,3578742176,3578742207,31
3,1177,25942,3578742176,3578742208,32
3,1177,25943,3578742176,3578742208,32
3,1177,25944,3578742176,3578742209,33
3,1177,25945,3578742176,3578742209,33
3,1177,25946,3578742176,3578742214,38
3,1177,25947,3578742176,3578742215,39
3,1177,25948,3578742176,3578742218,42
3,1177,25949,3578742176,3578742218,42
3,1177,25950,3578742176,3578742219,43
3,1177,25951,3578742176,3578742219,43
3,1177,25952,3578742176,3578742219,43
3,1177,25953,3578742176,3578742220,44
3,1177,25954,3578742176,3578742221,45
3,1177,25955,3578742176,3578742221,45
3,1177,25956,3578742176,3578742222,46
3,1177,25957,3578742176,3578742222,46
3,1177,25958,3578742176,3578742224,48
3,1177,25959,3578742176,3578742225,49
3,1177,25960,3578742176,3578742226,50
3,1178,25961,3578742240,3578742240,0
3,1178,25962,3578742240,3578742240,0
3,1178,25963,3578742240,3578742240,0
3,1178,25964,3578742240,3578742240,0
3,1178,25965,3578742240,3578742240,0
3,1178,25966,3578742240,3578742240,0
3,1178,25967,3578742240,3578742240,0
3,1178,25968,3578742240,3578742240,0
3,1178,25969,3578742240,3578742240,0
3,1178,25970,3578742240,3578742240,0
3,1178,25971,3578742240,3578742240,0
3,1178,25972,3578742240,3578742240,0
3,1178,25973,3578742240,3578742240,0
3,1178,25974,3578742240,3578742240,0
3,1178,25975,3578742240,3578742240,0
3,1178,25976,3578742240,3578742240,0
3,1178,25977,3578742240,3578742240,0
3,1178,25978,3578742240,3578742241,1
3,1178,25979,3578742240,3578742242,2
3,1178,25980,3578742240,3578742243,3
3,1178,25981,3578742240,3578742243,3
3,1178,25982,3578742240,3578742243,3
3,1178,25983,3578742240,3578742244,4
3,1178,25984,3578742240,3578742244,4
3,1178,25985,3578742240,3578742246,6
3,1178,25986,3578742240,3578742246,6
3,1178,25987,3578742240,3578742246,6
3,1178,25988,3578742240,3578742246,6
3,1178,25989,3578742240,3578742247,7
3,1178,25990,3578742240,3578742250,10
3,1178,25991,3578742240,3578742252,12
3,1178,25992,3578742240,3578742253,13
3,1178,25993,3578742240,3578742256,16
3,1178,25994,3578742240,3578742257,17
3,1178,25995,3578742240,3578742257,17
3,1178,25996,3578742240,3578742257,17
3,1178,25997,3578742240,3578742258,18
3,1178,25998,3578742240,3578742259,19
3,1178,25999,3578742240,3578742260,20
3,1178,26000,3578742240,3578742261,21
3,1178,26001,3578742240,3578742262,22
3,1178,26002,3578742240,3578742264,24
3,1178,26003,3578742240,3578742266,26
3,1178,26004,3578742240,3578742269,29
3,1178,26005,3578742240,3578742270,30
3,1178,26006,3578742240,3578742272,32
3,1178,26007,3578742240,3578742272,32
3,1178,26008,3578742240,3578742275,35
3,1178,26009,3578742240,3578742275,35
3,1178,26010,3578742240,3578742276,36
3,1178,26011,3578742240,3578742279,39
3,1178,26012,3578742240,3578742280,40
3,1178,26013,3578742240,3578742281,41
3,1178,26014,3578742240,3578742282,42
3,1178,26015,3578742240,3578742282,42
3,1178,26016,3578742240,3578742283,43
3,1178,26017,3578742240,3578742284,44
3,1178,26018,3578742240,3578742284,44
3,1178,26019,3578742240,3578742285,45
3,1178,26020,3578742240,3578742286,46
3,1178,26021,3578742240,3578742288,48
3,1178,26022,3578742240,3578742289,49
3,1179,26023,3578742302,3578742302,0
3,1179,26024,3578742302,3578742302,0
3,1179,26025,3578742302,3578742302,0
3,1179,26026,3578742302,3578742302,0
3,1179,26027,3578742302,3578742302,0
3,1179,26028,3578742302,3578742302,0
3,1179,26029,3578742302,3578742302,0
3,1179,26030,3578742302,3578742302,0
3,1179,26031,3578742302,3578742302,0
3,1179,26032,3578742302,3578742302,0
3,1179,26033,3578742302,3578742302,0
3,1179,26034,3578742302,3578742302,0
3,1179,26035,3578742302,3578742302,0
3,1179,26036,3578742302,3578742302,0
3,1179,26037,3578742302,3578742302,0
3,1179,26038,3578742302,3578742302,0
3,1179,26039,3578742302,3578742303,1
3,1179,26040,3578742302,3578742304,2
3,1179,26041,3578742302,3578742304,2
3,1179,26042,3578742302,3578742305,3
3,1179,26043,3578742302,3578742309,7
3,1179,26044,3578742302,3578742310,8
3,1179,26045,3578742302,3578742313,11
3,1179,26046,3578742302,3578742315,13
3,1179,26047,3578742302,3578742316,14
3,1179,26048,3578742302,3578742317,15
3,1179,26049,3578742302,3578742318,16
3,1179,26050,3578742302,3578742318,16
3,1179,26051,3578742302,3578742319,17
3,1179,26052,3578742302,3578742320,18
3,1179,26053,3578742302,3578742320,18
3,1179,26054,3578742302,3578742322,20
3,1179,26055,3578742302,3578742322,20
3,1179,26056,3578742302,3578742322,20
3,1179,26057,3578742302,3578742322,20
3,1179,26058,3578742302,3578742323,21
3,1179,26059,3578742302,3578742326,24
3,1179,26060,3578742302,3578742332,30
3,1179,26061,3578742302,3578742332,30
3,1179,26062,3578742302,3578742336,34
3,1179,26063,3578742302,3578742336,34
3,1179,26064,3578742302,3578742338,36
3,1179,26065,3578742302,3578742338,36
3,1179,26066,3578742302,3578742338,36
3,1179,26067,3578742302,3578742339,37
3,1179,26068,3578742302,3578742339,37
3,1179,26069,3578742302,3578742340,38
3,1179,26070,3578742302,3578742340,38
3,1179,26071,3578742302,3578742343,41
3,1179,26072,3578742302,3578742344,42
3,1179,26073,3578742302,3578742344,42
3,1179,26074,3578742302,3578742345,43
3,1179,26075,3578742302,3578742349,47
3,1179,26076,3578742302,3578742349,47
3,1179,26077,3578742302,3578742350,48
3,1179,26078,3578742302,3578742351,49
3,1180,26079,3578742364,3578742364,0
3,1180,26080,3578742364,3578742364,0
3,1180,26081,3578742364,3578742364,0
3,1180,26082,3578742364,3578742364,0
3,1180,26083,3578742364,3578742364,0
3,1180,26084,3578742364,3578742364,0
3,1180,26085,3578742364,3578742364,0
3,1180,26086,3578742364,3578742364,0
3,1180,26087,3578742364,3578742364,0
3,1180,26088,3578742364,3578742364,0
3,1180,26089,3578742364,3578742364,0
3,1180,26090,3578742364,3578742364,0
3,1180,26091,3578742364,3578742364,0
3,1180,26092,3578742364,3578742364,0
3,1180,26093,3578742364,3578742366,2
3,1180,26094,3578742364,3578742366,2
3,1180,26095,3578742364,3578742367,3
3,1180,26096,3578742364,3578742367,3
3,1180,26097,3578742364,3578742368,4
3,1180,26098,3578742364,3578742369,5
3,1180,26099,3578742364,3578742369,5
3,1180,26100,3578742364,3578742369,5
3,1180,26101,3578742364,3578742370,6
3,1180,26102,3578742364,3578742370,6
3,1180,26103,3578742364,3578742370,6
3,1180,26104,3578742364,3578742371,7
3,1180,26105,3578742364,3578742372,8
3,1180,26106,3578742364,3578742372,8
3,1180,26107,3578742364,3578742374,10
3,1180,26108,3578742364,3578742374,10
3,1180,26109,3578742364,3578742374,10
3,1180,26110,3578742364,3578742376,12
3,1180,26111,3578742364,3578742378,14
3,1180,26112,3578742364,3578742379,15
3,1180,26113,3578742364,3578742384,20
3,1180,26114,3578742364,3578742385,21
3,1180,26115,3578742364,3578742386,22
3,1180,26116,3578742364,3578742387,23
3,1180,26117,3578742364,3578742387,23
3,1180,26118,3578742364,3578742388,24
3,1180,26119,3578742364,3578742388,24
3,1180,26120,3578742364,3578742388,24
3,1180,26121,3578742364,3578742389,25
3,1180,26122,3578742364,3578742389,25
3,1180,26123,3578742364,3578742390,26
3,1180,26124,3578742364,3578742391,27
3,1180,26125,3578742364,3578742391,27
3,1180,26126,3578742364,3578742391,27
3,1180,26127,3578742364,3578742391,27
3,1180,26128,3578742364,3578742392,28
3,1180,26129,3578742364,3578742393,29
3,1180,26130,3578742364,3578742393,29
3,1180,26131,3578742364,3578742394,30
3,1180,26132,3578742364,3578742397,33
3,1180,26133,3578742364,3578742397,33
3,1180,26134,3578742364,3578742397,33
3,1180,26135,3578742364,3578742400,36
3,1180,26136,3578742364,3578742401,37
3,1180,26137,3578742364,3578742403,39
3,1180,26138,3578742364,3578742403,39
3,1180,26139,3578742364,3578742404,40
3,1180,26140,3578742364,3578742404,40
3,1180,26141,3578742364,3578742405,41
3,1180,26142,3578742364,3578742405,41
3,1180,26143,3578742364,3578742406,42
3,1180,26144,3578742364,3578742406,42
3,1180,26145,3578742364,3578742407,43
3,1180,26146,3578742364,3578742408,44
3,1180,26147,3578742364,3578742408,44
3,1180,26148,3578742364,3578742409,45
3,1180,26149,3578742364,3578742409,45
3,1180,26150,3578742364,3578742414,50
3,1181,26151,3578742426,3578742426,0
3,1181,26152,3578742426,3578742426,0
3,1181,26153,3578742426,3578742426,0
3,1181,26154,3578742426,3578742426,0
3,1181,26155,3578742426,3578742426,0
3,1181,26156,3578742426,3578742426,0
3,1181,26157,3578742426,3578742426,0
3,1181,26158,3578742426,3578742426,0
3,1181,26159,3578742426,3578742426,0
3,1181,26160,3578742426,3578742426,0
3,1181,26161,3578742426,3578742426,0
3,1181,26162,3578742426,3578742426,0
3,1181,26163,3578742426,3578742427,1
3,1181,26164,3578742426,3578742428,2
3,1181,26165,3578742426,3578742428,2
3,1181,26166,3578742426,3578742430,4
3,1181,26167,3578742426,3578742431,5
3,1181,26168,3578742426,3578742431,5
3,1181,26169,3578742426,3578742431,5
3,1181,26170,3578742426,3578742432,6
3,1181,26171,3578742426,3578742432,6
3,1181,26172,3578742426,3578742433,7
3,1181,26173,3578742426,3578742435,9
3,1181,26174,3578742426,3578742435,9
3,1181,26175,3578742426,3578742435,9
3,1181,26176,3578742426,3578742436,10
3,1181,26177,3578742426,3578742436,10
3,1181,26178,3578742426,3578742439,13
3,1181,26179,3578742426,3578742440,14
3,1181,26180,3578742426,3578742441,15
3,1181,26181,3578742426,3578742441,15
3,1181,26182,3578742426,3578742442,16
3,1181,26183,3578742426,3578742443,17
3,1181,26184,3578742426,3578742443,17
3,1181,26185,3578742426,3578742444,18
3,1181,26186,3578742426,3578742444,18
3,1181,26187,3578742426,3578742444,18
3,1181,26188,3578742426,3578742444,18
3,1181,26189,3578742426,3578742446,20
3,1181,26190,3578742426,3578742446,20
3,1181,26191,3578742426,3578742447,21
3,1181,26192,3578742426,3578742447,21
3,1181,26193,3578742426,3578742450,24
3,1181,26194,3578742426,3578742451,25
3,1181,26195,3578742426,3578742453,27
3,1181,26196,3578742426,3578742457,31
3,1181,26197,3578742426,3578742457,31
3,1181,26198,3578742426,3578742457,31
3,1181,26199,3578742426,3578742457,31
3,1181,26200,3578742426,3578742458,32
3,1181,26201,3578742426,3578742459,33
3,1181,26202,3578742426,3578742460,34
3,1181,26203,3578742426,3578742462,36
3,1181,26204,3578742426,3578742464,38
3,1181,26205,3578742426,3578742465,39
3,1181,26206,3578742426,3578742465,39
3,1181,26207,3578742426,3578742469,43
3,1181,26208,3578742426,3578742470,44
3,1181,26209,3578742426,3578742471,45
3,1181,26210,3578742426,3578742472,46
3,1181,26211,3578742426,3578742475,49
3,1181,26212,3578742426,3578742475,49
3,1181,26213,3578742426,3578742476,50
3,1182,26214,3578742490,3578742490,0
3,1182,26215,3578742490,3578742490,0
3,1182,26216,3578742490,3578742490,0
3,1182,26217,3578742490,3578742490,0
3,1182,26218,3578742490,3578742490,0
3,1182,26219,3578742490,3578742490,0
3,1182,26220,3578742490,3578742490,0
3,1182,26221,3578742490,3578742490,0
3,1182,26222,3578742490,3578742490,0
3,1182,26223,3578742490,3578742490,0
3,1182,26224,3578742490,3578742490,0
3,1182,26225,3578742490,3578742490,0
3,1182,26226,3578742490,3578742490,0
3,1182,26227,3578742490,3578742491,1
3,1182,26228,3578742490,3578742491,1
3,1182,26229,3578742490,3578742493,3
3,1182,26230,3578742490,3578742494,4
3,1182,26231,3578742490,3578742495,5
3,1182,26232,3578742490,3578742495,5
3,1182,26233,3578742490,3578742498,8
3,1182,26234,3578742490,3578742498,8
3,1182,26235,3578742490,3578742498,8
3,1182,26236,3578742490,3578742499,9
3,1182,26237,3578742490,3578742499,9
3,1182,26238,3578742490,3578742499,9
3,1182,26239,3578742490,3578742500,10
3,1182,26240,3578742490,3578742501,11
3,1182,26241,3578742490,3578742502,12
3,1182,26242,3578742490,3578742503,13
3,1182,26243,3578742490,3578742503,13
3,1182,26244,3578742490,3578742505,15
3,1182,26245,3578742490,3578742509,19
3,1182,26246,3578742490,3578742509,19
3,1182,26247,3578742490,3578742512,22
3,1182,26248,3578742490,3578742515,25
3,1182,26249,3578742490,3578742516,26
3,1182,26250,3578742490,3578742516,26
3,1182,26251,3578742490,3578742517,27
3,1182,26252,3578742490,3578742517,27
3,1182,26253,3578742490,3578742519,29
3,1182,26254,3578742490,3578742519,29
3,1182,26255,3578742490,3578742519,29
3,1182,26256,3578742490,3578742520,30
3,1182,26257,3578742490,3578742521,31
3,1182,26258,3578742490,3578742521,31
3,1182,26259,3578742490,3578742522,32
3,1182,26260,3578742490,3578742522,32
3,1182,26261,3578742490,3578742525,35
3,1182,26262,3578742490,3578742531,41
3,1182,26263,3578742490,3578742532,42
3,1182,26264,3578742490,3578742535,45
3,1182,26265,3578742490,3578742535,45
3,1182,26266,3578742490,3578742537,47
3,1182,26267,3578742490,3578742538,48
3,1182,26268,3578742490,3578742538,48
3,1182,26269,3578742490,3578742538,48
3,1182,26270,3578742490,3578742539,49
3,1182,26271,3578742490,3578742539,49
3,1183,26272,3578742552,3578742552,0
3,1183,26273,3578742552,3578742552,0
3,1183,26274,3578742552,3578742552,0
3,1183,26275,3578742552,3578742552,0
3,1183,26276,3578742552,3578742552,0
3,1183,26277,3578742552,3578742552,0
3,1183,26278,3578742552,3578742552,0
3,1183,26279,3578742552,3578742552,0
3,1183,26280,3578742552,3578742552,0
3,1183,26281,3578742552,3578742552,0
3,1183,26282,3578742552,3578742552,0
3,1183,26283,3578742552,3578742554,2
3,1183,26284,3578742552,3578742554,2
3,1183,26285,3578742552,3578742555,3
3,1183,26286,3578742552,3578742557,5
3,1183,26287,3578742552,3578742557,5
3,1183,26288,3578742552,3578742558,6
3,1183,26289,3578742552,3578742558,6
3,1183,26290,3578742552,3578742559,7
3,1183,26291,3578742552,3578742560,8
3,1183,26292,3578742552,3578742562,10
3,1183,26293,3578742552,3578742562,10
3,1183,26294,3578742552,3578742563,11
3,1183,26295,3578742552,3578742564,12
3,1183,26296,3578742552,3578742566,14
3,1183,26297,3578742552,3578742566,14
3,1183,26298,3578742552,3578742567,15
3,1183,26299,3578742552,3578742567,15
3,1183,26300,3578742552,3578742568,16
3,1183,26301,3578742552,3578742568,16
3,1183,26302,3578742552,3578742569,17
3,1183,26303,3578742552,3578742569,17
3,1183,26304,3578742552,3578742570,18
3,1183,26305,3578742552,3578742570,18
3,1183,26306,3578742552,3578742570,18
3,1183,26307,3578742552,3578742571,19
3,1183,26308,3578742552,3578742571,19
3,1183,26309,3578742552,3578742573,21
3,1183,26310,3578742552,3578742573,21
3,1183,26311,3578742552,3578742574,22
3,1183,26312,3578742552,3578742575,23
3,1183,26313,3578742552,3578742576,24
3,1183,26314,3578742552,3578742578,26
3,1183,26315,3578742552,3578742583,31
3,1183,26316,3578742552,3578742584,32
3,1183,26317,3578742552,3578742586,34
3,1183,26318,3578742552,3578742586,34
3,1183,26319,3578742552,3578742587,35
3,1183,26320,3578742552,3578742587,35
3,1183,26321,3578742552,3578742588,36
3,1183,26322,3578742552,3578742588,36
3,1183,26323,3578742552,3578742589,37
3,1183,26324,3578742552,3578742590,38
3,1183,26325,3578742552,3578742590,38
3,1183,26326,3578742552,3578742591,39
3,1183,26327,3578742552,3578742591,39
3,1183,26328,3578742552,3578742592,40
3,1183,26329,3578742552,3578742593,41
3,1183,26330,3578742552,3578742593,41
3,1183,26331,3578742552,3578742593,41
3,1183,26332,3578742552,3578742593,41
3,1183,26333,3578742552,3578742596,44
3,1183,26334,3578742552,3578742596,44
3,1183,26335,3578742552,3578742596,44
3,1183,26336,3578742552,3578742599,47
3,1183,26337,3578742552,3578742601,49
3,1183,26338,3578742552,3578742601,49
3,1184,26339,3578742617,3578742617,0
3,1184,26340,3578742617,3578742617,0
3,1184,26341,3578742617,3578742617,0
3,1184,26342,3578742617,3578742617,0
3,1184,26343,3578742617,3578742617,0
3,1184,26344,3578742617,3578742617,0
3,1184,26345,3578742617,3578742617,0
3,1184,26346,3578742617,3578742617,0
3,1184,26347,3578742617,3578742617,0
3,1184,26348,3578742617,3578742617,0
3,1184,26349,3578742617,3578742617,0
3,1184,26350,3578742617,3578742617,0
3,1184,26351,3578742617,3578742617,0
3,1184,26352,3578742617,3578742617,0
3,1184,26353,3578742617,3578742617,0
3,1184,26354,3578742617,3578742617,0
3,1184,26355,3578742617,3578742618,1
3,1184,26356,3578742617,3578742618,1
3,1184,26357,3578742617,3578742618,1
3,1184,26358,3578742617,3578742619,2
3,1184,26359,3578742617,3578742620,3
3,1184,26360,3578742617,3578742620,3
3,1184,26361,3578742617,3578742622,5
3,1184,26362,3578742617,3578742623,6
3,1184,26363,3578742617,3578742625,8
3,1184,26364,3578742617,3578742626,9
3,1184,26365,3578742617,3578742627,10
3,1184,26366,3578742617,3578742627,10
3,1184,26367,3578742617,3578742629,12
3,1184,26368,3578742617,3578742630,13
3,1184,26369,3578742617,3578742630,13
3,1184,26370,3578742617,3578742631,14
3,1184,26371,3578742617,3578742632,15
3,1184,26372,3578742617,3578742632,15
3,1184,26373,3578742617,3578742632,15
3,1184,26374,3578742617,3578742634,17
3,1184,26375,3578742617,3578742634,17
3,1184,26376,3578742617,3578742635,18
3,1184,26377,3578742617,3578742635,18
3,1184,26378,3578742617,3578742638,21
3,1184,26379,3578742617,3578742639,22
3,1184,26380,3578742617,3578742639,22
3,1184,26381,3578742617,3578742640,23
3,1184,26382,3578742617,3578742641,24
3,1184,26383,3578742617,3578742641,24
3,1184,26384,3578742617,3578742643,26
3,1184,26385,3578742617,3578742643,26
3,1184,26386,3578742617,3578742643,26
3,1184,26387,3578742617,3578742644,27
3,1184,26388,3578742617,3578742645,28
3,1184,26389,3578742617,3578742645,28
3,1184,26390,3578742617,3578742645,28
3,1184,26391,3578742617,3578742646,29
3,1184,26392,3578742617,3578742647,30
3,1184,26393,3578742617,3578742650,33
3,1184,26394,3578742617,3578742651,34
3,1184,26395,3578742617,3578742651,34
3,1184,26396,3578742617,3578742654,37
3,1184,26397,3578742617,3578742654,37
3,1184,26398,3578742617,3578742656,39
3,1184,26399,3578742617,3578742656,39
3,1184,26400,3578742617,3578742656,39
3,1184,26401,3578742617,3578742657,40
3,1184,26402,3578742617,3578742658,41
3,1184,26403,3578742617,3578742658,41
3,1184,26404,3578742617,3578742659,42
3,1184,26405,3578742617,3578742660,43
3,1184,26406,3578742617,3578742661,44
3,1184,26407,3578742617,3578742663,46
3,1184,26408,3578742617,3578742663,46
3,1184,26409,3578742617,3578742665,48
3,1185,26410,3578742679,3578742679,0
3,1185,26411,3578742679,3578742679,0
3,1185,26412,3578742679,3578742679,0
3,1185,26413,3578742679,3578742679,0
3,1185,26414,3578742679,3578742679,0
3,1185,26415,3578742679,3578742679,0
3,1185,26416,3578742679,3578742679,0
3,1185,26417,3578742679,3578742680,1
3,1185,26418,3578742679,3578742682,3
3,1185,26419,3578742679,3578742682,3
3,1185,26420,3578742679,3578742682,3
3,1185,26421,3578742679,3578742684,5
3,1185,26422,3578742679,3578742685,6
3,1185,26423,3578742679,3578742685,6
3,1185,26424,3578742679,3578742687,8
3,1185,26425,3578742679,3578742688,9
3,1185,26426,3578742679,3578742690,11
3,1185,26427,3578742679,3578742690,11
3,1185,26428,3578742679,3578742692,13
3,1185,26429,3578742679,3578742693,14
3,1185,26430,3578742679,3578742693,14
3,1185,26431,3578742679,3578742694,15
3,1185,26432,3578742679,3578742695,16
3,1185,26433,3578742679,3578742695,16
3,1185,26434,3578742679,3578742696,17
3,1185,26435,3578742679,3578742697,18
3,1185,26436,3578742679,3578742698,19
3,1185,26437,3578742679,3578742698,19
3,1185,26438,3578742679,3578742698,19
3,1185,26439,3578742679,3578742699,20
3,1185,26440,3578742679,3578742700,21
3,1185,26441,3578742679,3578742700,21
3,1185,26442,3578742679,3578742700,21
3,1185,26443,3578742679,3578742702,23
3,1185,26444,3578742679,3578742703,24
3,1185,26445,3578742679,3578742704,25
3,1185,26446,3578742679,3578742705,26
3,1185,26447,3578742679,3578742708,29
3,1185,26448,3578742679,3578742709,30
3,1185,26449,3578742679,3578742712,33
3,1185,26450,3578742679,3578742715,36
3,1185,26451,3578742679,3578742716,37
3,1185,26452,3578742679,3578742717,38
3,1185,26453,3578742679,3578742717,38
3,1185,26454,3578742679,3578742717,38
3,1185,26455,3578742679,3578742718,39
3,1185,26456,3578742679,3578742718,39
3,1185,26457,3578742679,3578742720,41
3,1185,26458,3578742679,3578742721,42
3,1185,26459,3578742679,3578742721,42
3,1185,26460,3578742679,3578742722,43
3,1185,26461,3578742679,3578742722,43
3,1185,26462,3578742679,3578742725,46
3,1186,26463,3578742741,3578742741,0
3,1186,26464,3578742741,3578742741,0
3,1186,26465,3578742741,3578742741,0
3,1186,26466,3578742741,3578742741,0
3,1186,26467,3578742741,3578742741,0
3,1186,26468,3578742741,3578742741,0
3,1186,26469,3578742741,3578742741,0
3,1186,26470,3578742741,3578742741,0
3,1186,26471,3578742741,3578742741,0
3,1186,26472,3578742741,3578742741,0
3,1186,26473,3578742741,3578742743,2
3,1186,26474,3578742741,3578742743,2
3,1186,26475,3578742741,3578742744,3
3,1186,26476,3578742741,3578742748,7
3,1186,26477,3578742741,3578742748,7
3,1186,26478,3578742741,3578742749,8
3,1186,26479,3578742741,3578742751,10
3,1186,26480,3578742741,3578742752,11
3,1186,26481,3578742741,3578742753,12
3,1186,26482,3578742741,3578742754,13
3,1186,26483,3578742741,3578742754,13
3,1186,26484,3578742741,3578742756,15
3,1186,26485,3578742741,3578742757,16
3,1186,26486,3578742741,3578742757,16
3,1186,26487,3578742741,3578742758,17
3,1186,26488,3578742741,3578742758,17
3,1186,26489,3578742741,3578742760,19
3,1186,26490,3578742741,3578742760,19
3,1186,26491,3578742741,3578742762,21
3,1186,26492,3578742741,3578742763,22
3,1186,26493,3578742741,3578742763,22
3,1186,26494,3578742741,3578742765,24
3,1186,26495,3578742741,3578742766,25
3,1186,26496,3578742741,3578742768,27
3,1186,26497,3578742741,3578742768,27
3,1186,26498,3578742741,3578742768,27
3,1186,26499,3578742741,3578742768,27
3,1186,26500,3578742741,3578742768,27
3,1186,26501,3578742741,3578742770,29
3,1186,26502,3578742741,3578742770,29
3,1186,26503,3578742741,3578742771,30
3,1186,26504,3578742741,3578742771,30
3,1186,26505,3578742741,3578742771,30
3,1186,26506,3578742741,3578742773,32
3,1186,26507,3578742741,3578742773,32
3,1186,26508,3578742741,3578742773,32
3,1186,26509,3578742741,3578742775,34
3,1186,26510,3578742741,3578742776,35
3,1186,26511,3578742741,3578742783,42
3,1186,26512,3578742741,3578742784,43
3,1186,26513,3578742741,3578742786,45
3,1186,26514,3578742741,3578742786,45
3,1186,26515,3578742741,3578742787,46
3,1186,26516,3578742741,3578742787,46
3,1186,26517,3578742741,3578742787,46
3,1186,26518,3578742741,3578742788,47
3,1186,26519,3578742741,3578742789,48
3,1186,26520,3578742741,3578742789,48
3,1186,26521,3578742741,3578742790,49
3,1186,26522,3578742741,3578742790,49
3,1186,26523,3578742741,3578742791,50
3,1187,26524,3578742804,3578742804,0
3,1187,26525,3578742804,3578742804,0
3,1187,26526,3578742804,3578742804,0
3,1187,26527,3578742804,3578742804,0
3,1187,26528,3578742804,3578742804,0
3,1187,26529,3578742804,3578742804,0
3,1187,26530,3578742804,3578742804,0
3,1187,26531,3578742804,3578742804,0
3,1187,26532,3578742804,3578742804,0
3,1187,26533,3578742804,3578742804,0
3,1187,26534,3578742804,3578742804,0
3,1187,26535,3578742804,3578742804,0
3,1187,26536,3578742804,3578742804,0
3,1187,26537,3578742804,3578742804,0
3,1187,26538,3578742804,3578742804,0
3,1187,26539,3578742804,3578742804,0
3,1187,26540,3578742804,3578742806,2
3,1187,26541,3578742804,3578742806,2
3,1187,26542,3578742804,3578742807,3
3,1187,26543,3578742804,3578742807,3
3,1187,26544,3578742804,3578742808,4
3,1187,26545,3578742804,3578742808,4
3,1187,26546,3578742804,3578742809,5
3,1187,26547,3578742804,3578742811,7
3,1187,26548,3578742804,3578742813,9
3,1187,26549,3578742804,3578742814,10
3,1187,26550,3578742804,3578742816,12
3,1187,26551,3578742804,3578742817,13
3,1187,26552,3578742804,3578742818,14
3,1187,26553,3578742804,3578742819,15
3,1187,26554,3578742804,3578742819,15
3,1187,26555,3578742804,3578742819,15
3,1187,26556,3578742804,3578742820,16
3,1187,26557,3578742804,3578742820,16
3,1187,26558,3578742804,3578742821,17
3,1187,26559,3578742804,3578742821,17
3,1187,26560,3578742804,3578742823,19
3,1187,26561,3578742804,3578742825,21
3,1187,26562,3578742804,3578742826,22
3,1187,26563,3578742804,3578742827,23
3,1187,26564,3578742804,3578742827,23
3,1187,26565,3578742804,3578742827,23
3,1187,26566,3578742804,3578742829,25
3,1187,26567,3578742804,3578742830,26
3,1187,26568,3578742804,3578742830,26
3,1187,26569,3578742804,3578742831,27
3,1187,26570,3578742804,3578742831,27
3,1187,26571,3578742804,3578742831,27
3,1187,26572,3578742804,3578742833,29
3,1187,26573,3578742804,3578742834,30
3,1187,26574,3578742804,3578742834,30
3,1187,26575,3578742804,3578742835,31
3,1187,26576,3578742804,3578742835,31
3,1187,26577,3578742804,3578742836,32
3,1187,26578,3578742804,3578742839,35
3,1187,26579,3578742804,3578742839,35
3,1187,26580,3578742804,3578742839,35
3,1187,26581,3578742804,3578742840,36
3,1187,26582,3578742804,3578742840,36
3,1187,26583,3578742804,3578742842,38
3,1187,26584,3578742804,3578742842,38
3,1187,26585,3578742804,3578742843,39
3,1187,26586,3578742804,3578742843,39
3,1187,26587,3578742804,3578742844,40
3,1187,26588,3578742804,3578742844,40
3,1187,26589,3578742804,3578742844,40
3,1187,26590,3578742804,3578742845,41
3,1187,26591,3578742804,3578742845,41
3,1187,26592,3578742804,3578742845,41
3,1187,26593,3578742804,3578742847,43
3,1187,26594,3578742804,3578742847,43
3,1187,26595,3578742804,3578742850,46
3,1187,26596,3578742804,3578742850,46
3,1187,26597,3578742804,3578742852,48
3,1187,26598,3578742804,3578742853,49
3,1188,26599,3578742866,3578742866,0
3,1188,26600,3578742866,3578742866,0
3,1188,26601,3578742866,3578742866,0
3,1188,26602,3578742866,3578742866,0
3,1188,26603,3578742866,3578742866,0
3,1188,26604,3578742866,3578742866,0
3,1188,26605,3578742866,3578742866,0
3,1188,26606,3578742866,3578742866,0
3,1188,26607,3578742866,3578742866,0
3,1188,26608,3578742866,3578742866,0
3,1188,26609,3578742866,3578742866,0
3,1188,26610,3578742866,3578742866,0
3,1188,26611,3578742866,3578742866,0
3,1188,26612,3578742866,3578742868,2
3,1188,26613,3578742866,3578742868,2
3,1188,26614,3578742866,3578742870,4
3,1188,26615,3578742866,3578742873,7
3,1188,26616,3578742866,3578742875,9
3,1188,26617,3578742866,3578742877,11
3,1188,26618,3578742866,3578742878,12
3,1188,26619,3578742866,3578742880,14
3,1188,26620,3578742866,3578742880,14
3,1188,26621,3578742866,3578742881,15
3,1188,26622,3578742866,3578742882,16
3,1188,26623,3578742866,3578742882,16
3,1188,26624,3578742866,3578742883,17
3,1188,26625,3578742866,3578742884,18
3,1188,26626,3578742866,3578742885,19
3,1188,26627,3578742866,3578742885,19
3,1188,26628,3578742866,3578742886,20
3,1188,26629,3578742866,3578742888,22
3,1188,26630,3578742866,3578742890,24
3,1188,26631,3578742866,3578742890,24
3,1188,26632,3578742866,3578742891,25
3,1188,26633,3578742866,3578742893,27
3,1188,26634,3578742866,3578742893,27
3,1188,26635,3578742866,3578742896,30
3,1188,26636,3578742866,3578742896,30
3,1188,26637,3578742866,3578742896,30
3,1188,26638,3578742866,3578742898,32
3,1188,26639,3578742866,3578742898,32
3,1188,26640,3578742866,3578742899,33
3,1188,26641,3578742866,3578742899,33
3,1188,26642,3578742866,3578742900,34
3,1188,26643,3578742866,3578742901,35
3,1188,26644,3578742866,3578742901,35
3,1188,26645,3578742866,3578742901,35
3,1188,26646,3578742866,3578742902,36
3,1188,26647,3578742866,3578742903,37
3,1188,26648,3578742866,3578742903,37
3,1188,26649,3578742866,3578742904,38
3,1188,26650,3578742866,3578742909,43
3,1188,26651,3578742866,3578742909,43
3,1188,26652,3578742866,3578742912,46
3,1188,26653,3578742866,3578742915,49
3,1188,26654,3578742866,3578742916,50
3,1189,26655,3578742928,3578742928,0
3,1189,26656,3578742928,3578742928,0
3,1189,26657,3578742928,3578742928,0
3,1189,26658,3578742928,3578742928,0
3,1189,26659,3578742928,3578742928,0
3,1189,26660,3578742928,3578742928,0
3,1189,26661,3578742928,3578742928,0
3,1189,26662,3578742928,3578742928,0
3,1189,26663,3578742928,3578742928,0
3,1189,26664,3578742928,3578742928,0
3,1189,26665,3578742928,3578742928,0
3,1189,26666,3578742928,3578742928,0
3,1189,26667,3578742928,3578742931,3
3,1189,26668,3578742928,3578742935,7
3,1189,26669,3578742928,3578742935,7
3,1189,26670,3578742928,3578742937,9
3,1189,26671,3578742928,3578742937,9
3,1189,26672,3578742928,3578742939,11
3,1189,26673,3578742928,3578742939,11
3,1189,26674,3578742928,3578742940,12
3,1189,26675,3578742928,3578742940,12
3,1189,26676,3578742928,3578742942,14
3,1189,26677,3578742928,3578742944,16
3,1189,26678,3578742928,3578742944,16
3,1189,26679,3578742928,3578742944,16
3,1189,26680,3578742928,3578742948,20
3,1189,26681,3578742928,3578742948,20
3,1189,26682,3578742928,3578742949,21
3,1189,26683,3578742928,3578742951,23
3,1189,26684,3578742928,3578742951,23
3,1189,26685,3578742928,3578742951,23
3,1189,26686,3578742928,3578742953,25
3,1189,26687,3578742928,3578742954,26
3,1189,26688,3578742928,3578742954,26
3,1189,26689,3578742928,3578742956,28
3,1189,26690,3578742928,3578742957,29
3,1189,26691,3578742928,3578742958,30
3,1189,26692,3578742928,3578742958,30
3,1189,26693,3578742928,3578742960,32
3,1189,26694,3578742928,3578742960,32
3,1189,26695,3578742928,3578742962,34
3,1189,26696,3578742928,3578742963,35
3,1189,26697,3578742928,3578742963,35
3,1189,26698,3578742928,3578742965,37
3,1189,26699,3578742928,3578742966,38
3,1189,26700,3578742928,3578742966,38
3,1189,26701,3578742928,3578742967,39
3,1189,26702,3578742928,3578742968,40
3,1189,26703,3578742928,3578742968,40
3,1189,26704,3578742928,3578742968,40
3,1189,26705,3578742928,3578742970,42
3,1189,26706,3578742928,3578742970,42
3,1189,26707,3578742928,3578742971,43
3,1189,26708,3578742928,3578742971,43
3,1189,26709,3578742928,3578742971,43
3,1189,26710,3578742928,3578742972,44
3,1189,26711,3578742928,3578742973,45
3,1189,26712,3578742928,3578742973,45
3,1189,26713,3578742928,3578742973,45
3,1189,26714,3578742928,3578742973,45
3,1189,26715,3578742928,3578742974,46
3,1189,26716,3578742928,3578742975,47
3,1189,26717,3578742928,3578742976,48
3,1190,26718,3578742990,3578742990,0
3,1190,26719,3578742990,3578742990,0
3,1190,26720,3578742990,3578742990,0
3,1190,26721,3578742990,3578742990,0
3,1190,26722,3578742990,3578742990,0
3,1190,26723,3578742990,3578742990,0
3,1190,26724,3578742990,3578742990,0
3,1190,26725,3578742990,3578742990,0
3,1190,26726,3578742990,3578742990,0
3,1190,26727,3578742990,3578742990,0
3,1190,26728,3578742990,3578742990,0
3,1190,26729,3578742990,3578742990,0
3,1190,26730,3578742990,3578742991,1
3,1190,26731,3578742990,3578742992,2
3,1190,26732,3578742990,3578742993,3
3,1190,26733,3578742990,3578742993,3
3,1190,26734,3578742990,3578742994,4
3,1190,26735,3578742990,3578742994,4
3,1190,26736,3578742990,3578742995,5
3,1190,26737,3578742990,3578742995,5
3,1190,26738,3578742990,3578742996,6
3,1190,26739,3578742990,3578742998,8
3,1190,26740,3578742990,3578742998,8
3,1190,26741,3578742990,3578743001,11
3,1190,26742,3578742990,3578743002,12
3,1190,26743,3578742990,3578743002,12
3,1190,26744,3578742990,3578743004,14
3,1190,26745,3578742990,3578743004,14
3,1190,26746,3578742990,3578743004,14
3,1190,26747,3578742990,3578743006,16
3,1190,26748,3578742990,3578743006,16
3,1190,26749,3578742990,3578743007,17
3,1190,26750,3578742990,3578743007,17
3,1190,26751,3578742990,3578743009,19
3,1190,26752,3578742990,3578743009,19
3,1190,26753,3578742990,3578743009,19
3,1190,26754,3578742990,3578743011,21
3,1190,26755,3578742990,3578743013,23
3,1190,26756,3578742990,3578743014,24
3,1190,26757,3578742990,3578743016,26
3,1190,26758,3578742990,3578743018,28
3,1190,26759,3578742990,3578743018,28
3,1190,26760,3578742990,3578743019,29
3,1190,26761,3578742990,3578743019,29
3,1190,26762,3578742990,3578743020,30
3,1190,26763,3578742990,3578743020,30
3,1190,26764,3578742990,3578743020,30
3,1190,26765,3578742990,3578743021,31
3,1190,26766,3578742990,3578743021,31
3,1190,26767,3578742990,3578743024,34
3,1190,26768,3578742990,3578743025,35
3,1190,26769,3578742990,3578743026,36
3,1190,26770,3578742990,3578743027,37
3,1190,26771,3578742990,3578743027,37
3,1190,26772,3578742990,3578743027,37
3,1190,26773,3578742990,3578743029,39
3,1190,26774,3578742990,3578743030,40
3,1190,26775,3578742990,3578743030,40
3,1190,26776,3578742990,3578743031,41
3,1190,26777,3578742990,3578743031,41
3,1190,26778,3578742990,3578743032,42
3,1190,26779,3578742990,3578743033,43
3,1190,26780,3578742990,3578743034,44
3,1190,26781,3578742990,3578743034,44
3,1190,26782,3578742990,3578743035,45
3,1190,26783,3578742990,3578743036,46
3,1190,26784,3578742990,3578743036,46
3,1190,26785,3578742990,3578743039,49
3,1190,26786,3578742990,3578743039,49
3,1190,26787,3578742990,3578743040,50
3,1191,26788,3578743053,3578743053,0
3,1191,26789,3578743053,3578743053,0
3,1191,26790,3578743053,3578743053,0
3,1191,26791,3578743053,3578743053,0
3,1191,26792,3578743053,3578743053,0
3,1191,26793,3578743053,3578743053,0
3,1191,26794,3578743053,3578743053,0
3,1191,26795,3578743053,3578743053,0
3,1191,26796,3578743053,3578743053,0
3,1191,26797,3578743053,3578743053,0
3,1191,26798,3578743053,3578743053,0
3,1191,26799,3578743053,3578743053,0
3,1191,26800,3578743053,3578743053,0
3,1191,26801,3578743053,3578743053,0
3,1191,26802,3578743053,3578743053,0
3,1191,26803,3578743053,3578743054,1
3,1191,26804,3578743053,3578743054,1
3,1191,26805,3578743053,3578743056,3
3,1191,26806,3578743053,3578743056,3
3,1191,26807,3578743053,3578743056,3
3,1191,26808,3578743053,3578743057,4
3,1191,26809,3578743053,3578743059,6
3,1191,26810,3578743053,3578743061,8
3,1191,26811,3578743053,3578743062,9
3,1191,26812,3578743053,3578743064,11
3,1191,26813,3578743053,3578743065,12
3,1191,26814,3578743053,3578743065,12
3,1191,26815,3578743053,3578743069,16
3,1191,26816,3578743053,3578743069,16
3,1191,26817,3578743053,3578743071,18
3,1191,26818,3578743053,3578743073,20
3,1191,26819,3578743053,3578743075,22
3,1191,26820,3578743053,3578743076,23
3,1191,26821,3578743053,3578743078,25
3,1191,26822,3578743053,3578743080,27
3,1191,26823,3578743053,3578743080,27
3,1191,26824,3578743053,3578743081,28
3,1191,26825,3578743053,3578743081,28
3,1191,26826,3578743053,3578743083,30
3,1191,26827,3578743053,3578743084,31
3,1191,26828,3578743053,3578743085,32
3,1191,26829,3578743053,3578743086,33
3,1191,26830,3578743053,3578743086,33
3,1191,26831,3578743053,3578743088,35
3,1191,26832,3578743053,3578743090,37
3,1191,26833,3578743053,3578743090,37
3,1191,26834,3578743053,3578743091,38
3,1191,26835,3578743053,3578743093,40
3,1191,26836,3578743053,3578743093,40
3,1191,26837,3578743053,3578743096,43
3,1191,26838,3578743053,3578743096,43
3,1191,26839,3578743053,3578743097,44
3,1191,26840,3578743053,3578743097,44
3,1191,26841,3578743053,3578743098,45
3,1191,26842,3578743053,3578743098,45
3,1191,26843,3578743053,3578743099,46
3,1191,26844,3578743053,3578743100,47
3,1191,26845,3578743053,3578743100,47
3,1191,26846,3578743053,3578743100,47
3,1191,26847,3578743053,3578743102,49
3,1191,26848,3578743053,3578743102,49
3,1192,26849,3578743114,3578743114,0
3,1192,26850,3578743114,3578743114,0
3,1192,26851,3578743114,3578743114,0
3,1192,26852,3578743114,3578743114,0
3,1192,26853,3578743114,3578743114,0
3,1192,26854,3578743114,3578743116,2
3,1192,26855,3578743114,3578743117,3
3,1192,26856,3578743114,3578743117,3
3,1192,26857,3578743114,3578743118,4
3,1192,26858,3578743114,3578743119,5
3,1192,26859,3578743114,3578743120,6
3,1192,26860,3578743114,3578743120,6
3,1192,26861,3578743114,3578743121,7
3,1192,26862,3578743114,3578743121,7
3,1192,26863,3578743114,3578743122,8
3,1192,26864,3578743114,3578743122,8
3,1192,26865,3578743114,3578743123,9
3,1192,26866,3578743114,3578743125,11
3,1192,26867,3578743114,3578743132,18
3,1192,26868,3578743114,3578743136,22
3,1192,26869,3578743114,3578743136,22
3,1192,26870,3578743114,3578743138,24
3,1192,26871,3578743114,3578743138,24
3,1192,26872,3578743114,3578743138,24
3,1192,26873,3578743114,3578743138,24
3,1192,26874,3578743114,3578743139,25
3,1192,26875,3578743114,3578743140,26
3,1192,26876,3578743114,3578743141,27
3,1192,26877,3578743114,3578743143,29
3,1192,26878,3578743114,3578743144,30
3,1192,26879,3578743114,3578743144,30
3,1192,26880,3578743114,3578743144,30
3,1192,26881,3578743114,3578743149,35
3,1192,26882,3578743114,3578743149,35
3,1192,26883,3578743114,3578743150,36
3,1192,26884,3578743114,3578743150,36
3,1192,26885,3578743114,3578743151,37
3,1192,26886,3578743114,3578743151,37
3,1192,26887,3578743114,3578743153,39
3,1192,26888,3578743114,3578743154,40
3,1192,26889,3578743114,3578743154,40
3,1192,26890,3578743114,3578743156,42
3,1192,26891,3578743114,3578743157,43
3,1192,26892,3578743114,3578743158,44
3,1192,26893,3578743114,3578743158,44
3,1192,26894,3578743114,3578743158,44
3,1192,26895,3578743114,3578743160,46
3,1192,26896,3578743114,3578743160,46
3,1192,26897,3578743114,3578743162,48
3,1192,26898,3578743114,3578743164,50
3,1193,26899,3578743175,3578743175,0
3,1193,26900,3578743175,3578743175,0
3,1193,26901,3578743175,3578743175,0
3,1193,26902,3578743175,3578743175,0
3,1193,26903,3578743175,3578743175,0
3,1193,26904,3578743175,3578743175,0
3,1193,26905,3578743175,3578743175,0
3,1193,26906,3578743175,3578743175,0
3,1193,26907,3578743175,3578743175,0
3,1193,26908,3578743175,3578743175,0
3,1193,26909,3578743175,3578743175,0
3,1193,26910,3578743175,3578743175,0
3,1193,26911,3578743175,3578743175,0
3,1193,26912,3578743175,3578743175,0
3,1193,26913,3578743175,3578743175,0
3,1193,26914,3578743175,3578743175,0
3,1193,26915,3578743175,3578743175,0
3,1193,26916,3578743175,3578743175,0
3,1193,26917,3578743175,3578743175,0
3,1193,26918,3578743175,3578743175,0
3,1193,26919,3578743175,3578743175,0
3,1193,26920,3578743175,3578743176,1
3,1193,26921,3578743175,3578743183,8
3,1193,26922,3578743175,3578743184,9
3,1193,26923,3578743175,3578743186,11
3,1193,26924,3578743175,3578743187,12
3,1193,26925,3578743175,3578743187,12
3,1193,26926,3578743175,3578743188,13
3,1193,26927,3578743175,3578743188,13
3,1193,26928,3578743175,3578743188,13
3,1193,26929,3578743175,3578743188,13
3,1193,26930,3578743175,3578743189,14
3,1193,26931,3578743175,3578743189,14
3,1193,26932,3578743175,3578743189,14
3,1193,26933,3578743175,3578743191,16
3,1193,26934,3578743175,3578743191,16
3,1193,26935,3578743175,3578743192,17
3,1193,26936,3578743175,3578743194,19
3,1193,26937,3578743175,3578743194,19
3,1193,26938,3578743175,3578743194,19
3,1193,26939,3578743175,3578743194,19
3,1193,26940,3578743175,3578743195,20
3,1193,26941,3578743175,3578743196,21
3,1193,26942,3578743175,3578743197,22
3,1193,26943,3578743175,3578743198,23
3,1193,26944,3578743175,3578743198,23
3,1193,26945,3578743175,3578743201,26
3,1193,26946,3578743175,3578743202,27
3,1193,26947,3578743175,3578743203,28
3,1193,26948,3578743175,3578743203,28
3,1193,26949,3578743175,3578743204,29
3,1193,26950,3578743175,3578743204,29
3,1193,26951,3578743175,3578743204,29
3,1193,26952,3578743175,3578743206,31
3,1193,26953,3578743175,3578743207,32
3,1193,26954,3578743175,3578743208,33
3,1193,26955,3578743175,3578743208,33
3,1193,26956,3578743175,3578743208,33
3,1193,26957,3578743175,3578743209,34
3,1193,26958,3578743175,3578743209,34
3,1193,26959,3578743175,3578743211,36
3,1193,26960,3578743175,3578743213,38
3,1193,26961,3578743175,3578743214,39
3,1193,26962,3578743175,3578743216,41
3,1193,26963,3578743175,3578743218,43
3,1193,26964,3578743175,3578743219,44
3,1193,26965,3578743175,3578743219,44
3,1193,26966,3578743175,3578743219,44
3,1193,26967,3578743175,3578743220,45
3,1193,26968,3578743175,3578743220,45
3,1193,26969,3578743175,3578743221,46
3,1193,26970,3578743175,3578743221,46
3,1193,26971,3578743175,3578743221,46
3,1193,26972,3578743175,3578743225,50
3,1194,26973,3578743237,3578743237,0
3,1194,26974,3578743237,3578743237,0
3,1194,26975,3578743237,3578743237,0
3,1194,26976,3578743237,3578743237,0
3,1194,26977,3578743237,3578743237,0
3,1194,26978,3578743237,3578743237,0
3,1194,26979,3578743237,3578743237,0
3,1194,26980,3578743237,3578743237,0
3,1194,26981,3578743237,3578743237,0
3,1194,26982,3578743237,3578743237,0
3,1194,26983,3578743237,3578743237,0
3,1194,26984,3578743237,3578743237,0
3,1194,26985,3578743237,3578743237,0
3,1194,26986,3578743237,3578743237,0
3,1194,26987,3578743237,3578743237,0
3,1194,26988,3578743237,3578743237,0
3,1194,26989,3578743237,3578743237,0
3,1194,26990,3578743237,3578743237,0
3,1194,26991,3578743237,3578743239,2
3,1194,26992,3578743237,3578743240,3
3,1194,26993,3578743237,3578743240,3
3,1194,26994,3578743237,3578743240,3
3,1194,26995,3578743237,3578743240,3
3,1194,26996,3578743237,3578743242,5
3,1194,26997,3578743237,3578743243,6
3,1194,26998,3578743237,3578743243,6
3,1194,26999,3578743237,3578743243,6
3,1194,27000,3578743237,3578743243,6
3,1194,27001,3578743237,3578743244,7
3,1194,27002,3578743237,3578743245,8
3,1194,27003,3578743237,3578743245,8
3,1194,27004,3578743237,3578743246,9
3,1194,27005,3578743237,3578743247,10
3,1194,27006,3578743237,3578743247,10
3,1194,27007,3578743237,3578743250,13
3,1194,27008,3578743237,3578743251,14
3,1194,27009,3578743237,3578743252,15
3,1194,27010,3578743237,3578743254,17
3,1194,27011,3578743237,3578743255,18
3,1194,27012,3578743237,3578743256,19
3,1194,27013,3578743237,3578743256,19
3,1194,27014,3578743237,3578743256,19
3,1194,27015,3578743237,3578743257,20
3,1194,27016,3578743237,3578743259,22
3,1194,27017,3578743237,3578743259,22
3,1194,27018,3578743237,3578743261,24
3,1194,27019,3578743237,3578743262,25
3,1194,27020,3578743237,3578743264,27
3,1194,27021,3578743237,3578743264,27
3,1194,27022,3578743237,3578743266,29
3,1194,27023,3578743237,3578743269,32
3,1194,27024,3578743237,3578743269,32
3,1194,27025,3578743237,3578743271,34
3,1194,27026,3578743237,3578743274,37
3,1194,27027,3578743237,3578743275,38
3,1194,27028,3578743237,3578743276,39
3,1194,27029,3578743237,3578743278,41
3,1194,27030,3578743237,3578743279,42
3,1194,27031,3578743237,3578743280,43
3,1194,27032,3578743237,3578743281,44
3,1194,27033,3578743237,3578743282,45
3,1194,27034,3578743237,3578743282,45
3,1194,27035,3578743237,3578743284,47
3,1194,27036,3578743237,3578743284,47
3,1194,27037,3578743237,3578743285,48
3,1194,27038,3578743237,3578743286,49
3,1194,27039,3578743237,3578743287,50
3,1195,27040,3578743298,3578743298,0
3,1195,27041,3578743298,3578743298,0
3,1195,27042,3578743298,3578743298,0
3,1195,27043,3578743298,3578743298,0
3,1195,27044,3578743298,3578743298,0
3,1195,27045,3578743298,3578743298,0
3,1195,27046,3578743298,3578743298,0
3,1195,27047,3578743298,3578743298,0
3,1195,27048,3578743298,3578743298,0
3,1195,27049,3578743298,3578743298,0
3,1195,27050,3578743298,3578743298,0
3,1195,27051,3578743298,3578743298,0
3,1195,27052,3578743298,3578743299,1
3,1195,27053,3578743298,3578743300,2
3,1195,27054,3578743298,3578743300,2
3,1195,27055,3578743298,3578743300,2
3,1195,27056,3578743298,3578743301,3
3,1195,27057,3578743298,3578743302,4
3,1195,27058,3578743298,3578743304,6
3,1195,27059,3578743298,3578743304,6
3,1195,27060,3578743298,3578743304,6
3,1195,27061,3578743298,3578743309,11
3,1195,27062,3578743298,3578743312,14
3,1195,27063,3578743298,3578743315,17
3,1195,27064,3578743298,3578743316,18
3,1195,27065,3578743298,3578743316,18
3,1195,27066,3578743298,3578743317,19
3,1195,27067,3578743298,3578743318,20
3,1195,27068,3578743298,3578743319,21
3,1195,27069,3578743298,3578743319,21
3,1195,27070,3578743298,3578743320,22
3,1195,27071,3578743298,3578743321,23
3,1195,27072,3578743298,3578743321,23
3,1195,27073,3578743298,3578743322,24
3,1195,27074,3578743298,3578743322,24
3,1195,27075,3578743298,3578743322,24
3,1195,27076,3578743298,3578743326,28
3,1195,27077,3578743298,3578743331,33
3,1195,27078,3578743298,3578743335,37
3,1195,27079,3578743298,3578743336,38
3,1195,27080,3578743298,3578743337,39
3,1195,27081,3578743298,3578743338,40
3,1195,27082,3578743298,3578743338,40
3,1195,27083,3578743298,3578743339,41
3,1195,27084,3578743298,3578743339,41
3,1195,27085,3578743298,3578743339,41
3,1195,27086,3578743298,3578743341,43
3,1195,27087,3578743298,3578743341,43
3,1195,27088,3578743298,3578743343,45
3,1195,27089,3578743298,3578743344,46
3,1195,27090,3578743298,3578743344,46
3,1195,27091,3578743298,3578743344,46
3,1196,27092,3578743361,3578743361,0
3,1196,27093,3578743361,3578743361,0
3,1196,27094,3578743361,3578743361,0
3,1196,27095,3578743361,3578743361,0
3,1196,27096,3578743361,3578743361,0
3,1196,27097,3578743361,3578743361,0
3,1196,27098,3578743361,3578743361,0
3,1196,27099,3578743361,3578743361,0
3,1196,27100,3578743361,3578743361,0
3,1196,27101,3578743361,3578743361,0
3,1196,27102,3578743361,3578743361,0
3,1196,27103,3578743361,3578743361,0
3,1196,27104,3578743361,3578743361,0
3,1196,27105,3578743361,3578743361,0
3,1196,27106,3578743361,3578743361,0
3,1196,27107,3578743361,3578743361,0
3,1196,27108,3578743361,3578743362,1
3,1196,27109,3578743361,3578743364,3
3,1196,27110,3578743361,3578743366,5
3,1196,27111,3578743361,3578743367,6
3,1196,27112,3578743361,3578743367,6
3,1196,27113,3578743361,3578743369,8
3,1196,27114,3578743361,3578743369,8
3,1196,27115,3578743361,3578743369,8
3,1196,27116,3578743361,3578743369,8
3,1196,27117,3578743361,3578743370,9
3,1196,27118,3578743361,3578743370,9
3,1196,27119,3578743361,3578743370,9
3,1196,27120,3578743361,3578743370,9
3,1196,27121,3578743361,3578743371,10
3,1196,27122,3578743361,3578743371,10
3,1196,27123,3578743361,3578743373,12
3,1196,27124,3578743361,3578743373,12
3,1196,27125,3578743361,3578743374,13
3,1196,27126,3578743361,3578743374,13
3,1196,27127,3578743361,3578743374,13
3,1196,27128,3578743361,3578743375,14
3,1196,27129,3578743361,3578743376,15
3,1196,27130,3578743361,3578743379,18
3,1196,27131,3578743361,3578743383,22
3,1196,27132,3578743361,3578743384,23
3,1196,27133,3578743361,3578743386,25
3,1196,27134,3578743361,3578743387,26
3,1196,27135,3578743361,3578743388,27
3,1196,27136,3578743361,3578743388,27
3,1196,27137,3578743361,3578743388,27
3,1196,27138,3578743361,3578743388,27
3,1196,27139,3578743361,3578743389,28
3,1196,27140,3578743361,3578743389,28
3,1196,27141,3578743361,3578743391,30
3,1196,27142,3578743361,3578743391,30
3,1196,27143,3578743361,3578743392,31
3,1196,27144,3578743361,3578743393,32
3,1196,27145,3578743361,3578743394,33
3,1196,27146,3578743361,3578743394,33
3,1196,27147,3578743361,3578743395,34
3,1196,27148,3578743361,3578743395,34
3,1196,27149,3578743361,3578743395,34
3,1196,27150,3578743361,3578743397,36
3,1196,27151,3578743361,3578743398,37
3,1196,27152,3578743361,3578743399,38
3,1196,27153,3578743361,3578743401,40
3,1196,27154,3578743361,3578743402,41
3,1196,27155,3578743361,3578743403,42
3,1196,27156,3578743361,3578743403,42
3,1196,27157,3578743361,3578743404,43
3,1196,27158,3578743361,3578743404,43
3,1196,27159,3578743361,3578743407,46
3,1196,27160,3578743361,3578743407,46
3,1196,27161,3578743361,3578743408,47
3,1196,27162,3578743361,3578743408,47
3,1196,27163,3578743361,3578743408,47
3,1196,27164,3578743361,3578743409,48
3,1196,27165,3578743361,3578743410,49
3,1197,27166,3578743423,3578743424,1
3,1197,27167,3578743423,3578743424,1
3,1197,27168,3578743423,3578743424,1
3,1197,27169,3578743423,3578743424,1
3,1197,27170,3578743423,3578743424,1
3,1197,27171,3578743423,3578743424,1
3,1197,27172,3578743423,3578743424,1
3,1197,27173,3578743423,3578743424,1
3,1197,27174,3578743423,3578743424,1
3,1197,27175,3578743423,3578743424,1
3,1197,27176,3578743423,3578743424,1
3,1197,27177,3578743423,3578743424,1
3,1197,27178,3578743423,3578743425,2
3,1197,27179,3578743423,3578743426,3
3,1197,27180,3578743423,3578743426,3
3,1197,27181,3578743423,3578743427,4
3,1197,27182,3578743423,3578743427,4
3,1197,27183,3578743423,3578743428,5
3,1197,27184,3578743423,3578743428,5
3,1197,27185,3578743423,3578743429,6
3,1197,27186,3578743423,3578743430,7
3,1197,27187,3578743423,3578743431,8
3,1197,27188,3578743423,3578743432,9
3,1197,27189,3578743423,3578743432,9
3,1197,27190,3578743423,3578743433,10
3,1197,27191,3578743423,3578743435,12
3,1197,27192,3578743423,3578743435,12
3,1197,27193,3578743423,3578743436,13
3,1197,27194,3578743423,3578743436,13
3,1197,27195,3578743423,3578743440,17
3,1197,27196,3578743423,3578743440,17
3,1197,27197,3578743423,3578743440,17
3,1197,27198,3578743423,3578743440,17
3,1197,27199,3578743423,3578743441,18
3,1197,27200,3578743423,3578743442,19
3,1197,27201,3578743423,3578743443,20
3,1197,27202,3578743423,3578743443,20
3,1197,27203,3578743423,3578743443,20
3,1197,27204,3578743423,3578743443,20
3,1197,27205,3578743423,3578743445,22
3,1197,27206,3578743423,3578743445,22
3,1197,27207,3578743423,3578743445,22
3,1197,27208,3578743423,3578743445,22
3,1197,27209,3578743423,3578743446,23
3,1197,27210,3578743423,3578743447,24
3,1197,27211,3578743423,3578743447,24
3,1197,27212,3578743423,3578743451,28
3,1197,27213,3578743423,3578743451,28
3,1197,27214,3578743423,3578743452,29
3,1197,27215,3578743423,3578743454,31
3,1197,27216,3578743423,3578743455,32
3,1197,27217,3578743423,3578743455,32
3,1197,27218,3578743423,3578743456,33
3,1197,27219,3578743423,3578743456,33
3,1197,27220,3578743423,3578743457,34
3,1197,27221,3578743423,3578743459,36
3,1197,27222,3578743423,3578743460,37
3,1197,27223,3578743423,3578743461,38
3,1197,27224,3578743423,3578743461,38
3,1197,27225,3578743423,3578743464,41
3,1197,27226,3578743423,3578743465,42
3,1197,27227,3578743423,3578743465,42
3,1197,27228,3578743423,3578743469,46
3,1197,27229,3578743423,3578743469,46
3,1197,27230,3578743423,3578743471,48
3,1197,27231,3578743423,3578743473,50
3,1198,27232,3578743486,3578743486,0
3,1198,27233,3578743486,3578743486,0
3,1198,27234,3578743486,3578743486,0
3,1198,27235,3578743486,3578743486,0
3,1198,27236,3578743486,3578743486,0
3,1198,27237,3578743486,3578743486,0
3,1198,27238,3578743486,3578743486,0
3,1198,27239,3578743486,3578743486,0
3,1198,27240,3578743486,3578743486,0
3,1198,27241,3578743486,3578743486,0
3,1198,27242,3578743486,3578743486,0
3,1198,27243,3578743486,3578743486,0
3,1198,27244,3578743486,3578743486,0
3,1198,27245,3578743486,3578743487,1
3,1198,27246,3578743486,3578743490,4
3,1198,27247,3578743486,3578743490,4
3,1198,27248,3578743486,3578743490,4
3,1198,27249,3578743486,3578743492,6
3,1198,27250,3578743486,3578743492,6
3,1198,27251,3578743486,3578743493,7
3,1198,27252,3578743486,3578743495,9
3,1198,27253,3578743486,3578743495,9
3,1198,27254,3578743486,3578743495,9
3,1198,27255,3578743486,3578743497,11
3,1198,27256,3578743486,3578743497,11
3,1198,27257,3578743486,3578743498,12
3,1198,27258,3578743486,3578743499,13
3,1198,27259,3578743486,3578743499,13
3,1198,27260,3578743486,3578743499,13
3,1198,27261,3578743486,3578743499,13
3,1198,27262,3578743486,3578743500,14
3,1198,27263,3578743486,3578743501,15
3,1198,27264,3578743486,3578743503,17
3,1198,27265,3578743486,3578743503,17
3,1198,27266,3578743486,3578743504,18
3,1198,27267,3578743486,3578743508,22
3,1198,27268,3578743486,3578743508,22
3,1198,27269,3578743486,3578743511,25
3,1198,27270,3578743486,3578743515,29
3,1198,27271,3578743486,3578743515,29
3,1198,27272,3578743486,3578743516,30
3,1198,27273,3578743486,3578743516,30
3,1198,27274,3578743486,3578743518,32
3,1198,27275,3578743486,3578743518,32
3,1198,27276,3578743486,3578743518,32
3,1198,27277,3578743486,3578743519,33
3,1198,27278,3578743486,3578743519,33
3,1198,27279,3578743486,3578743521,35
3,1198,27280,3578743486,3578743521,35
3,1198,27281,3578743486,3578743521,35
3,1198,27282,3578743486,3578743522,36
3,1198,27283,3578743486,3578743525,39
3,1198,27284,3578743486,3578743531,45
3,1198,27285,3578743486,3578743531,45
3,1198,27286,3578743486,3578743534,48
3,1198,27287,3578743486,3578743535,49
3,1199,27288,3578743548,3578743548,0
3,1199,27289,3578743548,3578743548,0
3,1199,27290,3578743548,3578743548,0
3,1199,27291,3578743548,3578743548,0
3,1199,27292,3578743548,3578743548,0
3,1199,27293,3578743548,3578743548,0
3,1199,27294,3578743548,3578743548,0
3,1199,27295,3578743548,3578743548,0
3,1199,27296,3578743548,3578743548,0
3,1199,27297,3578743548,3578743548,0
3,1199,27298,3578743548,3578743548,0
3,1199,27299,3578743548,3578743548,0
3,1199,27300,3578743548,3578743548,0
3,1199,27301,3578743548,3578743548,0
3,1199,27302,3578743548,3578743549,1
3,1199,27303,3578743548,3578743551,3
3,1199,27304,3578743548,3578743552,4
3,1199,27305,3578743548,3578743553,5
3,1199,27306,3578743548,3578743554,6
3,1199,27307,3578743548,3578743554,6
3,1199,27308,3578743548,3578743556,8
3,1199,27309,3578743548,3578743557,9
3,1199,27310,3578743548,3578743557,9
3,1199,27311,3578743548,3578743558,10
3,1199,27312,3578743548,3578743558,10
3,1199,27313,3578743548,3578743559,11
3,1199,27314,3578743548,3578743560,12
3,1199,27315,3578743548,3578743561,13
3,1199,27316,3578743548,3578743563,15
3,1199,27317,3578743548,3578743565,17
3,1199,27318,3578743548,3578743566,18
3,1199,27319,3578743548,3578743566,18
3,1199,27320,3578743548,3578743567,19
3,1199,27321,3578743548,3578743568,20
3,1199,27322,3578743548,3578743568,20
3,1199,27323,3578743548,3578743569,21
3,1199,27324,3578743548,3578743570,22
3,1199,27325,3578743548,3578743570,22
3,1199,27326,3578743548,3578743570,22
3,1199,27327,3578743548,3578743571,23
3,1199,27328,3578743548,3578743571,23
3,1199,27329,3578743548,3578743572,24
3,1199,27330,3578743548,3578743573,25
3,1199,27331,3578743548,3578743573,25
3,1199,27332,3578743548,3578743574,26
3,1199,27333,3578743548,3578743574,26
3,1199,27334,3578743548,3578743576,28
3,1199,27335,3578743548,3578743579,31
3,1199,27336,3578743548,3578743582,34
3,1199,27337,3578743548,3578743583,35
3,1199,27338,3578743548,3578743585,37
3,1199,27339,3578743548,3578743586,38
3,1199,27340,3578743548,3578743587,39
3,1199,27341,3578743548,3578743587,39
3,1199,27342,3578743548,3578743587,39
3,1199,27343,3578743548,3578743587,39
3,1199,27344,3578743548,3578743587,39
3,1199,27345,3578743548,3578743588,40
3,1199,27346,3578743548,3578743588,40
3,1199,27347,3578743548,3578743589,41
3,1199,27348,3578743548,3578743590,42
3,1199,27349,3578743548,3578743591,43
3,1199,27350,3578743548,3578743591,43
3,1199,27351,3578743548,3578743592,44
3,1199,27352,3578743548,3578743593,45
3,1199,27353,3578743548,3578743593,45
3,1199,27354,3578743548,3578743593,45
3,1199,27355,3578743548,3578743593,45
3,1199,27356,3578743548,3578743595,47
3,1199,27357,3578743548,3578743595,47
3,1199,27358,3578743548,3578743598,50
3,1200,27359,3578743610,3578743610,0
3,1200,27360,3578743610,3578743610,0
3,1200,27361,3578743610,3578743610,0
3,1200,27362,3578743610,3578743610,0
3,1200,27363,3578743610,3578743610,0
3,1200,27364,3578743610,3578743610,0
3,1200,27365,3578743610,3578743610,0
3,1200,27366,3578743610,3578743610,0
3,1200,27367,3578743610,3578743610,0
3,1200,27368,3578743610,3578743610,0
3,1200,27369,3578743610,3578743610,0
3,1200,27370,3578743610,3578743610,0
3,1200,27371,3578743610,3578743610,0
3,1200,27372,3578743610,3578743610,0
3,1200,27373,3578743610,3578743613,3
3,1200,27374,3578743610,3578743613,3
3,1200,27375,3578743610,3578743615,5
3,1200,27376,3578743610,3578743617,7
3,1200,27377,3578743610,3578743617,7
3,1200,27378,3578743610,3578743618,8
3,1200,27379,3578743610,3578743619,9
3,1200,27380,3578743610,3578743619,9
3,1200,27381,3578743610,3578743619,9
3,1200,27382,3578743610,3578743619,9
3,1200,27383,3578743610,3578743620,10
3,1200,27384,3578743610,3578743621,11
3,1200,27385,3578743610,3578743624,14
3,1200,27386,3578743610,3578743625,15
3,1200,27387,3578743610,3578743625,15
3,1200,27388,3578743610,3578743626,16
3,1200,27389,3578743610,3578743626,16
3,1200,27390,3578743610,3578743627,17
3,1200,27391,3578743610,3578743628,18
3,1200,27392,3578743610,3578743628,18
3,1200,27393,3578743610,3578743630,20
3,1200,27394,3578743610,3578743631,21
3,1200,27395,3578743610,3578743631,21
3,1200,27396,3578743610,3578743632,22
3,1200,27397,3578743610,3578743634,24
3,1200,27398,3578743610,3578743634,24
3,1200,27399,3578743610,3578743635,25
3,1200,27400,3578743610,3578743635,25
3,1200,27401,3578743610,3578743638,28
3,1200,27402,3578743610,3578743639,29
3,1200,27403,3578743610,3578743639,29
3,1200,27404,3578743610,3578743639,29
3,1200,27405,3578743610,3578743640,30
3,1200,27406,3578743610,3578743641,31
3,1200,27407,3578743610,3578743641,31
3,1200,27408,3578743610,3578743643,33
3,1200,27409,3578743610,3578743643,33
3,1200,27410,3578743610,3578743643,33
3,1200,27411,3578743610,3578743643,33
3,1200,27412,3578743610,3578743644,34
3,1200,27413,3578743610,3578743644,34
3,1200,27414,3578743610,3578743644,34
3,1200,27415,3578743610,3578743645,35
3,1200,27416,3578743610,3578743646,36
3,1200,27417,3578743610,3578743646,36
3,1200,27418,3578743610,3578743649,39
3,1200,27419,3578743610,3578743650,40
3,1200,27420,3578743610,3578743651,41
3,1200,27421,3578743610,3578743654,44
3,1200,27422,3578743610,3578743654,44
3,1200,27423,3578743610,3578743655,45
3,1200,27424,3578743610,3578743655,45
3,1200,27425,3578743610,3578743655,45
3,1200,27426,3578743610,3578743657,47
3,1200,27427,3578743610,3578743658,48
3,1200,27428,3578743610,3578743658,48
3,1200,27429,3578743610,3578743658,48
3,1201,27430,3578743672,3578743672,0
3,1201,27431,3578743672,3578743672,0
3,1201,27432,3578743672,3578743672,0
3,1201,27433,3578743672,3578743672,0
3,1201,27434,3578743672,3578743672,0
3,1201,27435,3578743672,3578743672,0
3,1201,27436,3578743672,3578743672,0
3,1201,27437,3578743672,3578743672,0
3,1201,27438,3578743672,3578743673,1
3,1201,27439,3578743672,3578743675,3
3,1201,27440,3578743672,3578743676,4
3,1201,27441,3578743672,3578743676,4
3,1201,27442,3578743672,3578743677,5
3,1201,27443,3578743672,3578743679,7
3,1201,27444,3578743672,3578743680,8
3,1201,27445,3578743672,3578743681,9
3,1201,27446,3578743672,3578743681,9
3,1201,27447,3578743672,3578743682,10
3,1201,27448,3578743672,3578743683,11
3,1201,27449,3578743672,3578743685,13
3,1201,27450,3578743672,3578743685,13
3,1201,27451,3578743672,3578743685,13
3,1201,27452,3578743672,3578743686,14
3,1201,27453,3578743672,3578743687,15
3,1201,27454,3578743672,3578743690,18
3,1201,27455,3578743672,3578743690,18
3,1201,27456,3578743672,3578743690,18
3,1201,27457,3578743672,3578743692,20
3,1201,27458,3578743672,3578743692,20
3,1201,27459,3578743672,3578743695,23
3,1201,27460,3578743672,3578743695,23
3,1201,27461,3578743672,3578743696,24
3,1201,27462,3578743672,3578743697,25
3,1201,27463,3578743672,3578743697,25
3,1201,27464,3578743672,3578743698,26
3,1201,27465,3578743672,3578743698,26
3,1201,27466,3578743672,3578743699,27
3,1201,27467,3578743672,3578743699,27
3,1201,27468,3578743672,3578743699,27
3,1201,27469,3578743672,3578743701,29
3,1201,27470,3578743672,3578743701,29
3,1201,27471,3578743672,3578743704,32
3,1201,27472,3578743672,3578743704,32
3,1201,27473,3578743672,3578743704,32
3,1201,27474,3578743672,3578743709,37
3,1201,27475,3578743672,3578743711,39
3,1201,27476,3578743672,3578743715,43
3,1201,27477,3578743672,3578743715,43
3,1201,27478,3578743672,3578743715,43
3,1201,27479,3578743672,3578743716,44
3,1201,27480,3578743672,3578743718,46
3,1201,27481,3578743672,3578743718,46
3,1201,27482,3578743672,3578743718,46
3,1201,27483,3578743672,3578743719,47
3,1201,27484,3578743672,3578743721,49
3,1201,27485,3578743672,3578743721,49
3,1201,27486,3578743672,3578743721,49
3,1201,27487,3578743672,3578743722,50
3,1202,27488,3578743733,3578743733,0
3,1202,27489,3578743733,3578743733,0
3,1202,27490,3578743733,3578743733,0
3,1202,27491,3578743733,3578743733,0
3,1202,27492,3578743733,3578743735,2
3,1202,27493,3578743733,3578743736,3
3,1202,27494,3578743733,3578743737,4
3,1202,27495,3578743733,3578743737,4
3,1202,27496,3578743733,3578743737,4
3,1202,27497,3578743733,3578743737,4
3,1202,27498,3578743733,3578743737,4
3,1202,27499,3578743733,3578743738,5
3,1202,27500,3578743733,3578743740,7
3,1202,27501,3578743733,3578743741,8
3,1202,27502,3578743733,3578743742,9
3,1202,27503,3578743733,3578743742,9
3,1202,27504,3578743733,3578743743,10
3,1202,27505,3578743733,3578743744,11
3,1202,27506,3578743733,3578743748,15
3,1202,27507,3578743733,3578743750,17
3,1202,27508,3578743733,3578743751,18
3,1202,27509,3578743733,3578743753,20
3,1202,27510,3578743733,3578743753,20
3,1202,27511,3578743733,3578743753,20
3,1202,27512,3578743733,3578743753,20
3,1202,27513,3578743733,3578743755,22
3,1202,27514,3578743733,3578743756,23
3,1202,27515,3578743733,3578743757,24
3,1202,27516,3578743733,3578743758,25
3,1202,27517,3578743733,3578743759,26
3,1202,27518,3578743733,3578743760,27
3,1202,27519,3578743733,3578743761,28
3,1202,27520,3578743733,3578743762,29
3,1202,27521,3578743733,3578743763,30
3,1202,27522,3578743733,3578743765,32
3,1202,27523,3578743733,3578743767,34
3,1202,27524,3578743733,3578743768,35
3,1202,27525,3578743733,3578743768,35
3,1202,27526,3578743733,3578743768,35
3,1202,27527,3578743733,3578743769,36
3,1202,27528,3578743733,3578743769,36
3,1202,27529,3578743733,3578743769,36
3,1202,27530,3578743733,3578743771,38
3,1202,27531,3578743733,3578743771,38
3,1202,27532,3578743733,3578743771,38
3,1202,27533,3578743733,3578743773,40
3,1202,27534,3578743733,3578743773,40
3,1202,27535,3578743733,3578743773,40
3,1202,27536,3578743733,3578743773,40
3,1202,27537,3578743733,3578743774,41
3,1202,27538,3578743733,3578743776,43
3,1202,27539,3578743733,3578743780,47
3,1202,27540,3578743733,3578743782,49
3,1203,27541,3578743795,3578743795,0
3,1203,27542,3578743795,3578743795,0
3,1203,27543,3578743795,3578743795,0
3,1203,27544,3578743795,3578743795,0
3,1203,27545,3578743795,3578743795,0
3,1203,27546,3578743795,3578743795,0
3,1203,27547,3578743795,3578743795,0
3,1203,27548,3578743795,3578743795,0
3,1203,27549,3578743795,3578743795,0
3,1203,27550,3578743795,3578743795,0
3,1203,27551,3578743795,3578743795,0
3,1203,27552,3578743795,3578743795,0
3,1203,27553,3578743795,3578743795,0
3,1203,27554,3578743795,3578743795,0
3,1203,27555,3578743795,3578743795,0
3,1203,27556,3578743795,3578743795,0
3,1203,27557,3578743795,3578743795,0
3,1203,27558,3578743795,3578743795,0
3,1203,27559,3578743795,3578743795,0
3,1203,27560,3578743795,3578743798,3
3,1203,27561,3578743795,3578743799,4
3,1203,27562,3578743795,3578743801,6
3,1203,27563,3578743795,3578743801,6
3,1203,27564,3578743795,3578743803,8
3,1203,27565,3578743795,3578743803,8
3,1203,27566,3578743795,3578743804,9
3,1203,27567,3578743795,3578743804,9
3,1203,27568,3578743795,3578743805,10
3,1203,27569,3578743795,3578743807,12
3,1203,27570,3578743795,3578743807,12
3,1203,27571,3578743795,3578743807,12
3,1203,27572,3578743795,3578743809,14
3,1203,27573,3578743795,3578743813,18
3,1203,27574,3578743795,3578743813,18
3,1203,27575,3578743795,3578743815,20
3,1203,27576,3578743795,3578743816,21
3,1203,27577,3578743795,3578743817,22
3,1203,27578,3578743795,3578743818,23
3,1203,27579,3578743795,3578743819,24
3,1203,27580,3578743795,3578743820,25
3,1203,27581,3578743795,3578743820,25
3,1203,27582,3578743795,3578743820,25
3,1203,27583,3578743795,3578743821,26
3,1203,27584,3578743795,3578743823,28
3,1203,27585,3578743795,3578743826,31
3,1203,27586,3578743795,3578743826,31
3,1203,27587,3578743795,3578743827,32
3,1203,27588,3578743795,3578743827,32
3,1203,27589,3578743795,3578743828,33
3,1203,27590,3578743795,3578743828,33
3,1203,27591,3578743795,3578743829,34
3,1203,27592,3578743795,3578743830,35
3,1203,27593,3578743795,3578743831,36
3,1203,27594,3578743795,3578743832,37
3,1203,27595,3578743795,3578743832,37
3,1203,27596,3578743795,3578743834,39
3,1203,27597,3578743795,3578743835,40
3,1203,27598,3578743795,3578743835,40
3,1203,27599,3578743795,3578743835,40
3,1203,27600,3578743795,3578743839,44
3,1203,27601,3578743795,3578743839,44
3,1203,27602,3578743795,3578743839,44
3,1203,27603,3578743795,3578743840,45
3,1203,27604,3578743795,3578743841,46
3,1203,27605,3578743795,3578743842,47
3,1203,27606,3578743795,3578743842,47
3,1203,27607,3578743795,3578743843,48
3,1203,27608,3578743795,3578743843,48
3,1203,27609,3578743795,3578743843,48
3,1203,27610,3578743795,3578743844,49
3,1203,27611,3578743795,3578743844,49
3,1203,27612,3578743795,3578743844,49
3,1204,27613,3578743858,3578743858,0
3,1204,27614,3578743858,3578743858,0
3,1204,27615,3578743858,3578743858,0
3,1204,27616,3578743858,3578743858,0
3,1204,27617,3578743858,3578743858,0
3,1204,27618,3578743858,3578743858,0
3,1204,27619,3578743858,3578743858,0
3,1204,27620,3578743858,3578743858,0
3,1204,27621,3578743858,3578743858,0
3,1204,27622,3578743858,3578743858,0
3,1204,27623,3578743858,3578743858,0
3,1204,27624,3578743858,3578743858,0
3,1204,27625,3578743858,3578743858,0
3,1204,27626,3578743858,3578743861,3
3,1204,27627,3578743858,3578743862,4
3,1204,27628,3578743858,3578743863,5
3,1204,27629,3578743858,3578743863,5
3,1204,27630,3578743858,3578743865,7
3,1204,27631,3578743858,3578743867,9
3,1204,27632,3578743858,3578743868,10
3,1204,27633,3578743858,3578743873,15
3,1204,27634,3578743858,3578743875,17
3,1204,27635,3578743858,3578743875,17
3,1204,27636,3578743858,3578743876,18
3,1204,27637,3578743858,3578743877,19
3,1204,27638,3578743858,3578743879,21
3,1204,27639,3578743858,3578743880,22
3,1204,27640,3578743858,3578743881,23
3,1204,27641,3578743858,3578743881,23
3,1204,27642,3578743858,3578743882,24
3,1204,27643,3578743858,3578743883,25
3,1204,27644,3578743858,3578743885,27
3,1204,27645,3578743858,3578743885,27
3,1204,27646,3578743858,3578743885,27
3,1204,27647,3578743858,3578743886,28
3,1204,27648,3578743858,3578743888,30
3,1204,27649,3578743858,3578743890,32
3,1204,27650,3578743858,3578743890,32
3,1204,27651,3578743858,3578743890,32
3,1204,27652,3578743858,3578743892,34
3,1204,27653,3578743858,3578743893,35
3,1204,27654,3578743858,3578743893,35
3,1204,27655,3578743858,3578743895,37
3,1204,27656,3578743858,3578743896,38
3,1204,27657,3578743858,3578743897,39
3,1204,27658,3578743858,3578743897,39
3,1204,27659,3578743858,3578743897,39
3,1204,27660,3578743858,3578743898,40
3,1204,27661,3578743858,3578743900,42
3,1204,27662,3578743858,3578743900,42
3,1204,27663,3578743858,3578743901,43
3,1204,27664,3578743858,3578743901,43
3,1204,27665,3578743858,3578743901,43
3,1204,27666,3578743858,3578743903,45
3,1204,27667,3578743858,3578743904,46
3,1205,27668,3578743919,3578743919,0
3,1205,27669,3578743919,3578743919,0
3,1205,27670,3578743919,3578743919,0
3,1205,27671,3578743919,3578743919,0
3,1205,27672,3578743919,3578743919,0
3,1205,27673,3578743919,3578743919,0
3,1205,27674,3578743919,3578743919,0
3,1205,27675,3578743919,3578743919,0
3,1205,27676,3578743919,3578743920,1
3,1205,27677,3578743919,3578743921,2
3,1205,27678,3578743919,3578743921,2
3,1205,27679,3578743919,3578743922,3
3,1205,27680,3578743919,3578743923,4
3,1205,27681,3578743919,3578743925,6
3,1205,27682,3578743919,3578743931,12
3,1205,27683,3578743919,3578743932,13
3,1205,27684,3578743919,3578743935,16
3,1205,27685,3578743919,3578743935,16
3,1205,27686,3578743919,3578743937,18
3,1205,27687,3578743919,3578743937,18
3,1205,27688,3578743919,3578743938,19
3,1205,27689,3578743919,3578743938,19
3,1205,27690,3578743919,3578743939,20
3,1205,27691,3578743919,3578743940,21
3,1205,27692,3578743919,3578743941,22
3,1205,27693,3578743919,3578743942,23
3,1205,27694,3578743919,3578743943,24
3,1205,27695,3578743919,3578743943,24
3,1205,27696,3578743919,3578743944,25
3,1205,27697,3578743919,3578743948,29
3,1205,27698,3578743919,3578743953,34
3,1205,27699,3578743919,3578743953,34
3,1205,27700,3578743919,3578743953,34
3,1205,27701,3578743919,3578743953,34
3,1205,27702,3578743919,3578743956,37
3,1205,27703,3578743919,3578743957,38
3,1205,27704,3578743919,3578743957,38
3,1205,27705,3578743919,3578743958,39
3,1205,27706,3578743919,3578743959,40
3,1205,27707,3578743919,3578743960,41
3,1205,27708,3578743919,3578743960,41
3,1205,27709,3578743919,3578743964,45
3,1205,27710,3578743919,3578743965,46
3,1205,27711,3578743919,3578743966,47
3,1205,27712,3578743919,3578743966,47
3,1205,27713,3578743919,3578743967,48
3,1205,27714,3578743919,3578743967,48
3,1205,27715,3578743919,3578743968,49
3,1205,27716,3578743919,3578743969,50
3,1206,27717,3578743981,3578743981,0
3,1206,27718,3578743981,3578743981,0
3,1206,27719,3578743981,3578743981,0
3,1206,27720,3578743981,3578743981,0
3,1206,27721,3578743981,3578743981,0
3,1206,27722,3578743981,3578743981,0
3,1206,27723,3578743981,3578743981,0
3,1206,27724,3578743981,3578743981,0
3,1206,27725,3578743981,3578743981,0
3,1206,27726,3578743981,3578743981,0
3,1206,27727,3578743981,3578743981,0
3,1206,27728,3578743981,3578743981,0
3,1206,27729,3578743981,3578743983,2
3,1206,27730,3578743981,3578743985,4
3,1206,27731,3578743981,3578743986,5
3,1206,27732,3578743981,3578743987,6
3,1206,27733,3578743981,3578743987,6
3,1206,27734,3578743981,3578743987,6
3,1206,27735,3578743981,3578743988,7
3,1206,27736,3578743981,3578743988,7
3,1206,27737,3578743981,3578743989,8
3,1206,27738,3578743981,3578743989,8
3,1206,27739,3578743981,3578743990,9
3,1206,27740,3578743981,3578743991,10
3,1206,27741,3578743981,3578743992,11
3,1206,27742,3578743981,3578743992,11
3,1206,27743,3578743981,3578743993,12
3,1206,27744,3578743981,3578743993,12
3,1206,27745,3578743981,3578743994,13
3,1206,27746,3578743981,3578743994,13
3,1206,27747,3578743981,3578743995,14
3,1206,27748,3578743981,3578743996,15
3,1206,27749,3578743981,3578743998,17
3,1206,27750,3578743981,3578744001,20
3,1206,27751,3578743981,3578744001,20
3,1206,27752,3578743981,3578744002,21
3,1206,27753,3578743981,3578744003,22
3,1206,27754,3578743981,3578744003,22
3,1206,27755,3578743981,3578744004,23
3,1206,27756,3578743981,3578744005,24
3,1206,27757,3578743981,3578744006,25
3,1206,27758,3578743981,3578744007,26
3,1206,27759,3578743981,3578744007,26
3,1206,27760,3578743981,3578744007,26
3,1206,27761,3578743981,3578744008,27
3,1206,27762,3578743981,3578744008,27
3,1206,27763,3578743981,3578744009,28
3,1206,27764,3578743981,3578744013,32
3,1206,27765,3578743981,3578744014,33
3,1206,27766,3578743981,3578744016,35
3,1206,27767,3578743981,3578744017,36
3,1206,27768,3578743981,3578744017,36
3,1206,27769,3578743981,3578744018,37
3,1206,27770,3578743981,3578744019,38
3,1206,27771,3578743981,3578744020,39
3,1206,27772,3578743981,3578744021,40
3,1206,27773,3578743981,3578744022,41
3,1206,27774,3578743981,3578744024,43
3,1206,27775,3578743981,3578744025,44
3,1206,27776,3578743981,3578744025,44
3,1206,27777,3578743981,3578744028,47
3,1206,27778,3578743981,3578744028,47
3,1206,27779,3578743981,3578744028,47
3,1206,27780,3578743981,3578744028,47
3,1206,27781,3578743981,3578744029,48
3,1206,27782,3578743981,3578744030,49
3,1206,27783,3578743981,3578744031,50
3,1207,27784,3578744043,3578744043,0
3,1207,27785,3578744043,3578744043,0
3,1207,27786,3578744043,3578744043,0
3,1207,27787,3578744043,3578744043,0
3,1207,27788,3578744043,3578744043,0
3,1207,27789,3578744043,3578744043,0
3,1207,27790,3578744043,3578744043,0
3,1207,27791,3578744043,3578744043,0
3,1207,27792,3578744043,3578744043,0
3,1207,27793,3578744043,3578744043,0
3,1207,27794,3578744043,3578744043,0
3,1207,27795,3578744043,3578744043,0
3,1207,27796,3578744043,3578744043,0
3,1207,27797,3578744043,3578744043,0
3,1207,27798,3578744043,3578744043,0
3,1207,27799,3578744043,3578744043,0
3,1207,27800,3578744043,3578744044,1
3,1207,27801,3578744043,3578744044,1
3,1207,27802,3578744043,3578744044,1
3,1207,27803,3578744043,3578744044,1
3,1207,27804,3578744043,3578744047,4
3,1207,27805,3578744043,3578744047,4
3,1207,27806,3578744043,3578744047,4
3,1207,27807,3578744043,3578744049,6
3,1207,27808,3578744043,3578744050,7
3,1207,27809,3578744043,3578744051,8
3,1207,27810,3578744043,3578744054,11
3,1207,27811,3578744043,3578744055,12
3,1207,27812,3578744043,3578744055,12
3,1207,27813,3578744043,3578744055,12
3,1207,27814,3578744043,3578744055,12
3,1207,27815,3578744043,3578744057,14
3,1207,27816,3578744043,3578744058,15
3,1207,27817,3578744043,3578744058,15
3,1207,27818,3578744043,3578744059,16
3,1207,27819,3578744043,3578744062,19
3,1207,27820,3578744043,3578744062,19
3,1207,27821,3578744043,3578744063,20
3,1207,27822,3578744043,3578744064,21
3,1207,27823,3578744043,3578744064,21
3,1207,27824,3578744043,3578744068,25
3,1207,27825,3578744043,3578744069,26
3,1207,27826,3578744043,3578744070,27
3,1207,27827,3578744043,3578744074,31
3,1207,27828,3578744043,3578744075,32
3,1207,27829,3578744043,3578744076,33
3,1207,27830,3578744043,3578744077,34
3,1207,27831,3578744043,3578744078,35
3,1207,27832,3578744043,3578744079,36
3,1207,27833,3578744043,3578744081,38
3,1207,27834,3578744043,3578744081,38
3,1207,27835,3578744043,3578744081,38
3,1207,27836,3578744043,3578744083,40
3,1207,27837,3578744043,3578744085,42
3,1207,27838,3578744043,3578744086,43
3,1207,27839,3578744043,3578744086,43
3,1207,27840,3578744043,3578744086,43
3,1207,27841,3578744043,3578744088,45
3,1207,27842,3578744043,3578744089,46
3,1207,27843,3578744043,3578744090,47
3,1207,27844,3578744043,3578744090,47
3,1207,27845,3578744043,3578744092,49
3,1207,27846,3578744043,3578744093,50
3,1208,27847,3578744106,3578744106,0
3,1208,27848,3578744106,3578744106,0
3,1208,27849,3578744106,3578744106,0
3,1208,27850,3578744106,3578744106,0
3,1208,27851,3578744106,3578744106,0
3,1208,27852,3578744106,3578744106,0
3,1208,27853,3578744106,3578744106,0
3,1208,27854,3578744106,3578744106,0
3,1208,27855,3578744106,3578744106,0
3,1208,27856,3578744106,3578744106,0
3,1208,27857,3578744106,3578744106,0
3,1208,27858,3578744106,3578744106,0
3,1208,27859,3578744106,3578744106,0
3,1208,27860,3578744106,3578744106,0
3,1208,27861,3578744106,3578744106,0
3,1208,27862,3578744106,3578744108,2
3,1208,27863,3578744106,3578744111,5
3,1208,27864,3578744106,3578744114,8
3,1208,27865,3578744106,3578744115,9
3,1208,27866,3578744106,3578744115,9
3,1208,27867,3578744106,3578744116,10
3,1208,27868,3578744106,3578744118,12
3,1208,27869,3578744106,3578744118,12
3,1208,27870,3578744106,3578744118,12
3,1208,27871,3578744106,3578744119,13
3,1208,27872,3578744106,3578744120,14
3,1208,27873,3578744106,3578744121,15
3,1208,27874,3578744106,3578744121,15
3,1208,27875,3578744106,3578744122,16
3,1208,27876,3578744106,3578744123,17
3,1208,27877,3578744106,3578744126,20
3,1208,27878,3578744106,3578744131,25
3,1208,27879,3578744106,3578744132,26
3,1208,27880,3578744106,3578744136,30
3,1208,27881,3578744106,3578744136,30
3,1208,27882,3578744106,3578744136,30
3,1208,27883,3578744106,3578744138,32
3,1208,27884,3578744106,3578744138,32
3,1208,27885,3578744106,3578744138,32
3,1208,27886,3578744106,3578744138,32
3,1208,27887,3578744106,3578744139,33
3,1208,27888,3578744106,3578744140,34
3,1208,27889,3578744106,3578744140,34
3,1208,27890,3578744106,3578744142,36
3,1208,27891,3578744106,3578744142,36
3,1208,27892,3578744106,3578744143,37
3,1208,27893,3578744106,3578744144,38
3,1208,27894,3578744106,3578744148,42
3,1208,27895,3578744106,3578744150,44
3,1208,27896,3578744106,3578744152,46
3,1208,27897,3578744106,3578744153,47
3,1208,27898,3578744106,3578744153,47
3,1208,27899,3578744106,3578744153,47
3,1208,27900,3578744106,3578744156,50
3,1209,27901,3578744169,3578744169,0
3,1209,27902,3578744169,3578744169,0
3,1209,27903,3578744169,3578744169,0
3,1209,27904,3578744169,3578744169,0
3,1209,27905,3578744169,3578744169,0
3,1209,27906,3578744169,3578744169,0
3,1209,27907,3578744169,3578744169,0
3,1209,27908,3578744169,3578744169,0
3,1209,27909,3578744169,3578744169,0
3,1209,27910,3578744169,3578744169,0
3,1209,27911,3578744169,3578744169,0
3,1209,27912,3578744169,3578744169,0
3,1209,27913,3578744169,3578744169,0
3,1209,27914,3578744169,3578744169,0
3,1209,27915,3578744169,3578744169,0
3,1209,27916,3578744169,3578744170,1
3,1209,27917,3578744169,3578744170,1
3,1209,27918,3578744169,3578744172,3
3,1209,27919,3578744169,3578744172,3
3,1209,27920,3578744169,3578744173,4
3,1209,27921,3578744169,3578744173,4
3,1209,27922,3578744169,3578744174,5
3,1209,27923,3578744169,3578744174,5
3,1209,27924,3578744169,3578744175,6
3,1209,27925,3578744169,3578744176,7
3,1209,27926,3578744169,3578744180,11
3,1209,27927,3578744169,3578744183,14
3,1209,27928,3578744169,3578744186,17
3,1209,27929,3578744169,3578744186,17
3,1209,27930,3578744169,3578744187,18
3,1209,27931,3578744169,3578744188,19
3,1209,27932,3578744169,3578744188,19
3,1209,27933,3578744169,3578744188,19
3,1209,27934,3578744169,3578744188,19
3,1209,27935,3578744169,3578744190,21
3,1209,27936,3578744169,3578744190,21
3,1209,27937,3578744169,3578744191,22
3,1209,27938,3578744169,3578744192,23
3,1209,27939,3578744169,3578744193,24
3,1209,27940,3578744169,3578744193,24
3,1209,27941,3578744169,3578744194,25
3,1209,27942,3578744169,3578744194,25
3,1209,27943,3578744169,3578744194,25
3,1209,27944,3578744169,3578744194,25
3,1209,27945,3578744169,3578744197,28
3,1209,27946,3578744169,3578744198,29
3,1209,27947,3578744169,3578744199,30
3,1209,27948,3578744169,3578744202,33
3,1209,27949,3578744169,3578744202,33
3,1209,27950,3578744169,3578744203,34
3,1209,27951,3578744169,3578744204,35
3,1209,27952,3578744169,3578744205,36
3,1209,27953,3578744169,3578744205,36
3,1209,27954,3578744169,3578744206,37
3,1209,27955,3578744169,3578744207,38
3,1209,27956,3578744169,3578744207,38
3,1209,27957,3578744169,3578744208,39
3,1209,27958,3578744169,3578744208,39
3,1209,27959,3578744169,3578744208,39
3,1209,27960,3578744169,3578744209,40
3,1209,27961,3578744169,3578744211,42
3,1209,27962,3578744169,3578744213,44
3,1209,27963,3578744169,3578744215,46
3,1209,27964,3578744169,3578744216,47
3,1209,27965,3578744169,3578744217,48
3,1209,27966,3578744169,3578744218,49
3,1209,27967,3578744169,3578744218,49
3,1209,27968,3578744169,3578744219,50
3,1210,27969,3578744231,3578744231,0
3,1210,27970,3578744231,3578744231,0
3,1210,27971,3578744231,3578744231,0
3,1210,27972,3578744231,3578744231,0
3,1210,27973,3578744231,3578744231,0
3,1210,27974,3578744231,3578744231,0
3,1210,27975,3578744231,3578744231,0
3,1210,27976,3578744231,3578744231,0
3,1210,27977,3578744231,3578744231,0
3,1210,27978,3578744231,3578744231,0
3,1210,27979,3578744231,3578744231,0
3,1210,27980,3578744231,3578744231,0
3,1210,27981,3578744231,3578744231,0
3,1210,27982,3578744231,3578744231,0
3,1210,27983,3578744231,3578744232,1
3,1210,27984,3578744231,3578744232,1
3,1210,27985,3578744231,3578744233,2
3,1210,27986,3578744231,3578744234,3
3,1210,27987,3578744231,3578744234,3
3,1210,27988,3578744231,3578744236,5
3,1210,27989,3578744231,3578744236,5
3,1210,27990,3578744231,3578744239,8
3,1210,27991,3578744231,3578744239,8
3,1210,27992,3578744231,3578744239,8
3,1210,27993,3578744231,3578744239,8
3,1210,27994,3578744231,3578744241,10
3,1210,27995,3578744231,3578744241,10
3,1210,27996,3578744231,3578744243,12
3,1210,27997,3578744231,3578744243,12
3,1210,27998,3578744231,3578744243,12
3,1210,27999,3578744231,3578744244,13
3,1210,28000,3578744231,3578744244,13
3,1210,28001,3578744231,3578744244,13
3,1210,28002,3578744231,3578744244,13
3,1210,28003,3578744231,3578744245,14
3,1210,28004,3578744231,3578744247,16
3,1210,28005,3578744231,3578744247,16
3,1210,28006,3578744231,3578744247,16
3,1210,28007,3578744231,3578744249,18
3,1210,28008,3578744231,3578744250,19
3,1210,28009,3578744231,3578744251,20
3,1210,28010,3578744231,3578744255,24
3,1210,28011,3578744231,3578744255,24
3,1210,28012,3578744231,3578744255,24
3,1210,28013,3578744231,3578744255,24
3,1210,28014,3578744231,3578744256,25
3,1210,28015,3578744231,3578744257,26
3,1210,28016,3578744231,3578744258,27
3,1210,28017,3578744231,3578744258,27
3,1210,28018,3578744231,3578744258,27
3,1210,28019,3578744231,3578744262,31
3,1210,28020,3578744231,3578744262,31
3,1210,28021,3578744231,3578744263,32
3,1210,28022,3578744231,3578744264,33
3,1210,28023,3578744231,3578744264,33
3,1210,28024,3578744231,3578744268,37
3,1210,28025,3578744231,3578744269,38
3,1210,28026,3578744231,3578744270,39
3,1210,28027,3578744231,3578744275,44
3,1210,28028,3578744231,3578744275,44
3,1210,28029,3578744231,3578744276,45
3,1210,28030,3578744231,3578744278,47
3,1210,28031,3578744231,3578744279,48
3,1210,28032,3578744231,3578744280,49
3,1210,28033,3578744231,3578744281,50
3,1211,28034,3578744292,3578744292,0
3,1211,28035,3578744292,3578744292,0
3,1211,28036,3578744292,3578744292,0
3,1211,28037,3578744292,3578744292,0
3,1211,28038,3578744292,3578744292,0
3,1211,28039,3578744292,3578744292,0
3,1211,28040,3578744292,3578744292,0
3,1211,28041,3578744292,3578744292,0
3,1211,28042,3578744292,3578744292,0
3,1211,28043,3578744292,3578744292,0
3,1211,28044,3578744292,3578744293,1
3,1211,28045,3578744292,3578744293,1
3,1211,28046,3578744292,3578744295,3
3,1211,28047,3578744292,3578744295,3
3,1211,28048,3578744292,3578744297,5
3,1211,28049,3578744292,3578744297,5
3,1211,28050,3578744292,3578744297,5
3,1211,28051,3578744292,3578744298,6
3,1211,28052,3578744292,3578744300,8
3,1211,28053,3578744292,3578744300,8
3,1211,28054,3578744292,3578744301,9
3,1211,28055,3578744292,3578744301,9
3,1211,28056,3578744292,3578744301,9
3,1211,28057,3578744292,3578744304,12
3,1211,28058,3578744292,3578744304,12
3,1211,28059,3578744292,3578744304,12
3,1211,28060,3578744292,3578744308,16
3,1211,28061,3578744292,3578744308,16
3,1211,28062,3578744292,3578744311,19
3,1211,28063,3578744292,3578744315,23
3,1211,28064,3578744292,3578744315,23
3,1211,28065,3578744292,3578744316,24
3,1211,28066,3578744292,3578744316,24
3,1211,28067,3578744292,3578744318,26
3,1211,28068,3578744292,3578744318,26
3,1211,28069,3578744292,3578744318,26
3,1211,28070,3578744292,3578744319,27
3,1211,28071,3578744292,3578744321,29
3,1211,28072,3578744292,3578744321,29
3,1211,28073,3578744292,3578744321,29
3,1211,28074,3578744292,3578744322,30
3,1211,28075,3578744292,3578744322,30
3,1211,28076,3578744292,3578744326,34
3,1211,28077,3578744292,3578744330,38
3,1211,28078,3578744292,3578744332,40
3,1211,28079,3578744292,3578744336,44
3,1211,28080,3578744292,3578744336,44
3,1211,28081,3578744292,3578744337,45
3,1211,28082,3578744292,3578744338,46
3,1211,28083,3578744292,3578744338,46
3,1211,28084,3578744292,3578744338,46
3,1211,28085,3578744292,3578744339,47
3,1211,28086,3578744292,3578744339,47
3,1211,28087,3578744292,3578744340,48
3,1211,28088,3578744292,3578744342,50
3,1212,28089,3578744354,3578744354,0
3,1212,28090,3578744354,3578744354,0
3,1212,28091,3578744354,3578744354,0
3,1212,28092,3578744354,3578744354,0
3,1212,28093,3578744354,3578744354,0
3,1212,28094,3578744354,3578744354,0
3,1212,28095,3578744354,3578744354,0
3,1212,28096,3578744354,3578744354,0
3,1212,28097,3578744354,3578744354,0
3,1212,28098,3578744354,3578744357,3
3,1212,28099,3578744354,3578744357,3
3,1212,28100,3578744354,3578744358,4
3,1212,28101,3578744354,3578744359,5
3,1212,28102,3578744354,3578744360,6
3,1212,28103,3578744354,3578744361,7
3,1212,28104,3578744354,3578744362,8
3,1212,28105,3578744354,3578744363,9
3,1212,28106,3578744354,3578744364,10
3,1212,28107,3578744354,3578744367,13
3,1212,28108,3578744354,3578744367,13
3,1212,28109,3578744354,3578744368,14
3,1212,28110,3578744354,3578744369,15
3,1212,28111,3578744354,3578744369,15
3,1212,28112,3578744354,3578744370,16
3,1212,28113,3578744354,3578744370,16
3,1212,28114,3578744354,3578744370,16
3,1212,28115,3578744354,3578744371,17
3,1212,28116,3578744354,3578744372,18
3,1212,28117,3578744354,3578744372,18
3,1212,28118,3578744354,3578744373,19
3,1212,28119,3578744354,3578744373,19
3,1212,28120,3578744354,3578744374,20
3,1212,28121,3578744354,3578744374,20
3,1212,28122,3578744354,3578744375,21
3,1212,28123,3578744354,3578744376,22
3,1212,28124,3578744354,3578744380,26
3,1212,28125,3578744354,3578744384,30
3,1212,28126,3578744354,3578744385,31
3,1212,28127,3578744354,3578744385,31
3,1212,28128,3578744354,3578744387,33
3,1212,28129,3578744354,3578744387,33
3,1212,28130,3578744354,3578744388,34
3,1212,28131,3578744354,3578744388,34
3,1212,28132,3578744354,3578744388,34
3,1212,28133,3578744354,3578744389,35
3,1212,28134,3578744354,3578744389,35
3,1212,28135,3578744354,3578744390,36
3,1212,28136,3578744354,3578744390,36
3,1212,28137,3578744354,3578744391,37
3,1212,28138,3578744354,3578744391,37
3,1212,28139,3578744354,3578744392,38
3,1212,28140,3578744354,3578744394,40
3,1212,28141,3578744354,3578744394,40
3,1212,28142,3578744354,3578744394,40
3,1212,28143,3578744354,3578744395,41
3,1212,28144,3578744354,3578744395,41
3,1212,28145,3578744354,3578744397,43
3,1212,28146,3578744354,3578744398,44
3,1212,28147,3578744354,3578744399,45
3,1212,28148,3578744354,3578744401,47
3,1212,28149,3578744354,3578744401,47
3,1212,28150,3578744354,3578744403,49
3,1212,28151,3578744354,3578744403,49
3,1212,28152,3578744354,3578744403,49
3,1213,28153,3578744415,3578744415,0
3,1213,28154,3578744415,3578744415,0
3,1213,28155,3578744415,3578744415,0
3,1213,28156,3578744415,3578744415,0
3,1213,28157,3578744415,3578744415,0
3,1213,28158,3578744415,3578744415,0
3,1213,28159,3578744415,3578744415,0
3,1213,28160,3578744415,3578744415,0
3,1213,28161,3578744415,3578744415,0
3,1213,28162,3578744415,3578744415,0
3,1213,28163,3578744415,3578744415,0
3,1213,28164,3578744415,3578744415,0
3,1213,28165,3578744415,3578744416,1
3,1213,28166,3578744415,3578744417,2
3,1213,28167,3578744415,3578744418,3
3,1213,28168,3578744415,3578744419,4
3,1213,28169,3578744415,3578744419,4
3,1213,28170,3578744415,3578744419,4
3,1213,28171,3578744415,3578744420,5
3,1213,28172,3578744415,3578744421,6
3,1213,28173,3578744415,3578744421,6
3,1213,28174,3578744415,3578744422,7
3,1213,28175,3578744415,3578744424,9
3,1213,28176,3578744415,3578744426,11
3,1213,28177,3578744415,3578744426,11
3,1213,28178,3578744415,3578744427,12
3,1213,28179,3578744415,3578744427,12
3,1213,28180,3578744415,3578744428,13
3,1213,28181,3578744415,3578744428,13
3,1213,28182,3578744415,3578744428,13
3,1213,28183,3578744415,3578744429,14
3,1213,28184,3578744415,3578744431,16
3,1213,28185,3578744415,3578744432,17
3,1213,28186,3578744415,3578744433,18
3,1213,28187,3578744415,3578744433,18
3,1213,28188,3578744415,3578744434,19
3,1213,28189,3578744415,3578744434,19
3,1213,28190,3578744415,3578744436,21
3,1213,28191,3578744415,3578744439,24
3,1213,28192,3578744415,3578744439,24
3,1213,28193,3578744415,3578744440,25
3,1213,28194,3578744415,3578744440,25
3,1213,28195,3578744415,3578744440,25
3,1213,28196,3578744415,3578744443,28
3,1213,28197,3578744415,3578744443,28
3,1213,28198,3578744415,3578744443,28
3,1213,28199,3578744415,3578744444,29
3,1213,28200,3578744415,3578744444,29
3,1213,28201,3578744415,3578744445,30
3,1213,28202,3578744415,3578744445,30
3,1213,28203,3578744415,3578744447,32
3,1213,28204,3578744415,3578744447,32
3,1213,28205,3578744415,3578744448,33
3,1213,28206,3578744415,3578744450,35
3,1213,28207,3578744415,3578744451,36
3,1213,28208,3578744415,3578744452,37
3,1213,28209,3578744415,3578744455,40
3,1213,28210,3578744415,3578744455,40
3,1213,28211,3578744415,3578744455,40
3,1213,28212,3578744415,3578744456,41
3,1213,28213,3578744415,3578744457,42
3,1213,28214,3578744415,3578744458,43
3,1213,28215,3578744415,3578744458,43
3,1213,28216,3578744415,3578744459,44
3,1213,28217,3578744415,3578744461,46
3,1213,28218,3578744415,3578744462,47
3,1213,28219,3578744415,3578744463,48
3,1213,28220,3578744415,3578744463,48
3,1213,28221,3578744415,3578744465,50
3,1214,28222,3578744476,3578744476,0
3,1214,28223,3578744476,3578744476,0
3,1214,28224,3578744476,3578744476,0
3,1214,28225,3578744476,3578744476,0
3,1214,28226,3578744476,3578744476,0
3,1214,28227,3578744476,3578744476,0
3,1214,28228,3578744476,3578744476,0
3,1214,28229,3578744476,3578744478,2
3,1214,28230,3578744476,3578744479,3
3,1214,28231,3578744476,3578744480,4
3,1214,28232,3578744476,3578744481,5
3,1214,28233,3578744476,3578744481,5
3,1214,28234,3578744476,3578744482,6
3,1214,28235,3578744476,3578744483,7
3,1214,28236,3578744476,3578744484,8
3,1214,28237,3578744476,3578744485,9
3,1214,28238,3578744476,3578744486,10
3,1214,28239,3578744476,3578744488,12
3,1214,28240,3578744476,3578744490,14
3,1214,28241,3578744476,3578744490,14
3,1214,28242,3578744476,3578744491,15
3,1214,28243,3578744476,3578744492,16
3,1214,28244,3578744476,3578744494,18
3,1214,28245,3578744476,3578744495,19
3,1214,28246,3578744476,3578744496,20
3,1214,28247,3578744476,3578744497,21
3,1214,28248,3578744476,3578744497,21
3,1214,28249,3578744476,3578744498,22
3,1214,28250,3578744476,3578744498,22
3,1214,28251,3578744476,3578744499,23
3,1214,28252,3578744476,3578744500,24
3,1214,28253,3578744476,3578744500,24
3,1214,28254,3578744476,3578744501,25
3,1214,28255,3578744476,3578744501,25
3,1214,28256,3578744476,3578744501,25
3,1214,28257,3578744476,3578744502,26
3,1214,28258,3578744476,3578744503,27
3,1214,28259,3578744476,3578744504,28
3,1214,28260,3578744476,3578744507,31
3,1214,28261,3578744476,3578744508,32
3,1214,28262,3578744476,3578744510,34
3,1214,28263,3578744476,3578744514,38
3,1214,28264,3578744476,3578744516,40
3,1214,28265,3578744476,3578744516,40
3,1214,28266,3578744476,3578744517,41
3,1214,28267,3578744476,3578744518,42
3,1214,28268,3578744476,3578744518,42
3,1214,28269,3578744476,3578744518,42
3,1214,28270,3578744476,3578744519,43
3,1214,28271,3578744476,3578744520,44
3,1214,28272,3578744476,3578744521,45
3,1214,28273,3578744476,3578744522,46
3,1214,28274,3578744476,3578744523,47
3,1214,28275,3578744476,3578744526,50
3,1215,28276,3578744539,3578744539,0
3,1215,28277,3578744539,3578744539,0
3,1215,28278,3578744539,3578744539,0
3,1215,28279,3578744539,3578744539,0
3,1215,28280,3578744539,3578744539,0
3,1215,28281,3578744539,3578744539,0
3,1215,28282,3578744539,3578744539,0
3,1215,28283,3578744539,3578744539,0
3,1215,28284,3578744539,3578744539,0
3,1215,28285,3578744539,3578744539,0
3,1215,28286,3578744539,3578744540,1
3,1215,28287,3578744539,3578744541,2
3,1215,28288,3578744539,3578744541,2
3,1215,28289,3578744539,3578744542,3
3,1215,28290,3578744539,3578744542,3
3,1215,28291,3578744539,3578744545,6
3,1215,28292,3578744539,3578744547,8
3,1215,28293,3578744539,3578744548,9
3,1215,28294,3578744539,3578744549,10
3,1215,28295,3578744539,3578744549,10
3,1215,28296,3578744539,3578744550,11
3,1215,28297,3578744539,3578744552,13
3,1215,28298,3578744539,3578744552,13
3,1215,28299,3578744539,3578744553,14
3,1215,28300,3578744539,3578744553,14
3,1215,28301,3578744539,3578744557,18
3,1215,28302,3578744539,3578744557,18
3,1215,28303,3578744539,3578744557,18
3,1215,28304,3578744539,3578744557,18
3,1215,28305,3578744539,3578744559,20
3,1215,28306,3578744539,3578744561,22
3,1215,28307,3578744539,3578744562,23
3,1215,28308,3578744539,3578744564,25
3,1215,28309,3578744539,3578744565,26
3,1215,28310,3578744539,3578744567,28
3,1215,28311,3578744539,3578744567,28
3,1215,28312,3578744539,3578744568,29
3,1215,28313,3578744539,3578744568,29
3,1215,28314,3578744539,3578744568,29
3,1215,28315,3578744539,3578744569,30
3,1215,28316,3578744539,3578744569,30
3,1215,28317,3578744539,3578744569,30
3,1215,28318,3578744539,3578744571,32
3,1215,28319,3578744539,3578744571,32
3,1215,28320,3578744539,3578744572,33
3,1215,28321,3578744539,3578744572,33
3,1215,28322,3578744539,3578744572,33
3,1215,28323,3578744539,3578744573,34
3,1215,28324,3578744539,3578744573,34
3,1215,28325,3578744539,3578744574,35
3,1215,28326,3578744539,3578744575,36
3,1215,28327,3578744539,3578744579,40
3,1215,28328,3578744539,3578744582,43
3,1215,28329,3578744539,3578744584,45
3,1215,28330,3578744539,3578744584,45
3,1215,28331,3578744539,3578744586,47
3,1215,28332,3578744539,3578744587,48
3,1215,28333,3578744539,3578744587,48
3,1215,28334,3578744539,3578744587,48
3,1215,28335,3578744539,3578744587,48
3,1215,28336,3578744539,3578744587,48
3,1215,28337,3578744539,3578744587,48
3,1215,28338,3578744539,3578744588,49
3,1216,28339,3578744600,3578744600,0
3,1216,28340,3578744600,3578744600,0
3,1216,28341,3578744600,3578744600,0
3,1216,28342,3578744600,3578744600,0
3,1216,28343,3578744600,3578744600,0
3,1216,28344,3578744600,3578744600,0
3,1216,28345,3578744600,3578744600,0
3,1216,28346,3578744600,3578744600,0
3,1216,28347,3578744600,3578744600,0
3,1216,28348,3578744600,3578744600,0
3,1216,28349,3578744600,3578744600,0
3,1216,28350,3578744600,3578744600,0
3,1216,28351,3578744600,3578744600,0
3,1216,28352,3578744600,3578744601,1
3,1216,28353,3578744600,3578744602,2
3,1216,28354,3578744600,3578744603,3
3,1216,28355,3578744600,3578744603,3
3,1216,28356,3578744600,3578744604,4
3,1216,28357,3578744600,3578744604,4
3,1216,28358,3578744600,3578744605,5
3,1216,28359,3578744600,3578744605,5
3,1216,28360,3578744600,3578744606,6
3,1216,28361,3578744600,3578744607,7
3,1216,28362,3578744600,3578744607,7
3,1216,28363,3578744600,3578744607,7
3,1216,28364,3578744600,3578744608,8
3,1216,28365,3578744600,3578744608,8
3,1216,28366,3578744600,3578744610,10
3,1216,28367,3578744600,3578744612,12
3,1216,28368,3578744600,3578744614,14
3,1216,28369,3578744600,3578744615,15
3,1216,28370,3578744600,3578744616,16
3,1216,28371,3578744600,3578744617,17
3,1216,28372,3578744600,3578744618,18
3,1216,28373,3578744600,3578744619,19
3,1216,28374,3578744600,3578744619,19
3,1216,28375,3578744600,3578744619,19
3,1216,28376,3578744600,3578744619,19
3,1216,28377,3578744600,3578744621,21
3,1216,28378,3578744600,3578744624,24
3,1216,28379,3578744600,3578744625,25
3,1216,28380,3578744600,3578744626,26
3,1216,28381,3578744600,3578744626,26
3,1216,28382,3578744600,3578744627,27
3,1216,28383,3578744600,3578744627,27
3,1216,28384,3578744600,3578744627,27
3,1216,28385,3578744600,3578744628,28
3,1216,28386,3578744600,3578744628,28
3,1216,28387,3578744600,3578744629,29
3,1216,28388,3578744600,3578744630,30
3,1216,28389,3578744600,3578744631,31
3,1216,28390,3578744600,3578744631,31
3,1216,28391,3578744600,3578744632,32
3,1216,28392,3578744600,3578744633,33
3,1216,28393,3578744600,3578744633,33
3,1216,28394,3578744600,3578744635,35
3,1216,28395,3578744600,3578744638,38
3,1216,28396,3578744600,3578744638,38
3,1216,28397,3578744600,3578744639,39
3,1216,28398,3578744600,3578744639,39
3,1216,28399,3578744600,3578744640,40
3,1216,28400,3578744600,3578744642,42
3,1216,28401,3578744600,3578744643,43
3,1216,28402,3578744600,3578744643,43
3,1216,28403,3578744600,3578744643,43
3,1216,28404,3578744600,3578744643,43
3,1216,28405,3578744600,3578744644,44
3,1216,28406,3578744600,3578744644,44
3,1216,28407,3578744600,3578744646,46
3,1216,28408,3578744600,3578744646,46
3,1216,28409,3578744600,3578744646,46
3,1216,28410,3578744600,3578744650,50
3,1217,28411,3578744663,3578744663,0
3,1217,28412,3578744663,3578744663,0
3,1217,28413,3578744663,3578744663,0
3,1217,28414,3578744663,3578744663,0
3,1217,28415,3578744663,3578744663,0
3,1217,28416,3578744663,3578744663,0
3,1217,28417,3578744663,3578744663,0
3,1217,28418,3578744663,3578744663,0
3,1217,28419,3578744663,3578744663,0
3,1217,28420,3578744663,3578744663,0
3,1217,28421,3578744663,3578744663,0
3,1217,28422,3578744663,3578744663,0
3,1217,28423,3578744663,3578744663,0
3,1217,28424,3578744663,3578744663,0
3,1217,28425,3578744663,3578744666,3
3,1217,28426,3578744663,3578744668,5
3,1217,28427,3578744663,3578744669,6
3,1217,28428,3578744663,3578744673,10
3,1217,28429,3578744663,3578744674,11
3,1217,28430,3578744663,3578744676,13
3,1217,28431,3578744663,3578744678,15
3,1217,28432,3578744663,3578744679,16
3,1217,28433,3578744663,3578744680,17
3,1217,28434,3578744663,3578744681,18
3,1217,28435,3578744663,3578744681,18
3,1217,28436,3578744663,3578744683,20
3,1217,28437,3578744663,3578744684,21
3,1217,28438,3578744663,3578744684,21
3,1217,28439,3578744663,3578744686,23
3,1217,28440,3578744663,3578744687,24
3,1217,28441,3578744663,3578744690,27
3,1217,28442,3578744663,3578744690,27
3,1217,28443,3578744663,3578744691,28
3,1217,28444,3578744663,3578744692,29
3,1217,28445,3578744663,3578744695,32
3,1217,28446,3578744663,3578744695,32
3,1217,28447,3578744663,3578744695,32
3,1217,28448,3578744663,3578744696,33
3,1217,28449,3578744663,3578744697,34
3,1217,28450,3578744663,3578744697,34
3,1217,28451,3578744663,3578744698,35
3,1217,28452,3578744663,3578744700,37
3,1217,28453,3578744663,3578744700,37
3,1217,28454,3578744663,3578744701,38
3,1217,28455,3578744663,3578744701,38
3,1217,28456,3578744663,3578744701,38
3,1217,28457,3578744663,3578744702,39
3,1217,28458,3578744663,3578744703,40
3,1217,28459,3578744663,3578744704,41
3,1217,28460,3578744663,3578744708,45
3,1217,28461,3578744663,3578744710,47
3,1218,28462,3578744726,3578744726,0
3,1218,28463,3578744726,3578744726,0
3,1218,28464,3578744726,3578744726,0
3,1218,28465,3578744726,3578744726,0
3,1218,28466,3578744726,3578744726,0
3,1218,28467,3578744726,3578744726,0
3,1218,28468,3578744726,3578744726,0
3,1218,28469,3578744726,3578744726,0
3,1218,28470,3578744726,3578744726,0
3,1218,28471,3578744726,3578744726,0
3,1218,28472,3578744726,3578744726,0
3,1218,28473,3578744726,3578744726,0
3,1218,28474,3578744726,3578744726,0
3,1218,28475,3578744726,3578744729,3
3,1218,28476,3578744726,3578744731,5
3,1218,28477,3578744726,3578744735,9
3,1218,28478,3578744726,3578744736,10
3,1218,28479,3578744726,3578744737,11
3,1218,28480,3578744726,3578744737,11
3,1218,28481,3578744726,3578744737,11
3,1218,28482,3578744726,3578744737,11
3,1218,28483,3578744726,3578744738,12
3,1218,28484,3578744726,3578744738,12
3,1218,28485,3578744726,3578744741,15
3,1218,28486,3578744726,3578744741,15
3,1218,28487,3578744726,3578744742,16
3,1218,28488,3578744726,3578744742,16
3,1218,28489,3578744726,3578744743,17
3,1218,28490,3578744726,3578744745,19
3,1218,28491,3578744726,3578744747,21
3,1218,28492,3578744726,3578744748,22
3,1218,28493,3578744726,3578744749,23
3,1218,28494,3578744726,3578744749,23
3,1218,28495,3578744726,3578744750,24
3,1218,28496,3578744726,3578744752,26
3,1218,28497,3578744726,3578744753,27
3,1218,28498,3578744726,3578744753,27
3,1218,28499,3578744726,3578744754,28
3,1218,28500,3578744726,3578744756,30
3,1218,28501,3578744726,3578744757,31
3,1218,28502,3578744726,3578744757,31
3,1218,28503,3578744726,3578744757,31
3,1218,28504,3578744726,3578744757,31
3,1218,28505,3578744726,3578744759,33
3,1218,28506,3578744726,3578744761,35
3,1218,28507,3578744726,3578744763,37
3,1218,28508,3578744726,3578744763,37
3,1218,28509,3578744726,3578744765,39
3,1218,28510,3578744726,3578744767,41
3,1218,28511,3578744726,3578744767,41
3,1218,28512,3578744726,3578744767,41
3,1218,28513,3578744726,3578744767,41
3,1218,28514,3578744726,3578744768,42
3,1218,28515,3578744726,3578744769,43
3,1218,28516,3578744726,3578744769,43
3,1218,28517,3578744726,3578744770,44
3,1218,28518,3578744726,3578744771,45
3,1218,28519,3578744726,3578744771,45
3,1218,28520,3578744726,3578744771,45
3,1218,28521,3578744726,3578744772,46
3,1218,28522,3578744726,3578744773,47
3,1218,28523,3578744726,3578744774,48
3,1218,28524,3578744726,3578744774,48
3,1218,28525,3578744726,3578744775,49
3,1219,28526,3578744788,3578744788,0
3,1219,28527,3578744788,3578744788,0
3,1219,28528,3578744788,3578744788,0
3,1219,28529,3578744788,3578744788,0
3,1219,28530,3578744788,3578744788,0
3,1219,28531,3578744788,3578744788,0
3,1219,28532,3578744788,3578744788,0
3,1219,28533,3578744788,3578744788,0
3,1219,28534,3578744788,3578744788,0
3,1219,28535,3578744788,3578744788,0
3,1219,28536,3578744788,3578744788,0
3,1219,28537,3578744788,3578744789,1
3,1219,28538,3578744788,3578744789,1
3,1219,28539,3578744788,3578744790,2
3,1219,28540,3578744788,3578744790,2
3,1219,28541,3578744788,3578744792,4
3,1219,28542,3578744788,3578744793,5
3,1219,28543,3578744788,3578744793,5
3,1219,28544,3578744788,3578744793,5
3,1219,28545,3578744788,3578744794,6
3,1219,28546,3578744788,3578744795,7
3,1219,28547,3578744788,3578744796,8
3,1219,28548,3578744788,3578744797,9
3,1219,28549,3578744788,3578744799,11
3,1219,28550,3578744788,3578744801,13
3,1219,28551,3578744788,3578744801,13
3,1219,28552,3578744788,3578744802,14
3,1219,28553,3578744788,3578744802,14
3,1219,28554,3578744788,3578744803,15
3,1219,28555,3578744788,3578744804,16
3,1219,28556,3578744788,3578744804,16
3,1219,28557,3578744788,3578744805,17
3,1219,28558,3578744788,3578744806,18
3,1219,28559,3578744788,3578744806,18
3,1219,28560,3578744788,3578744807,19
3,1219,28561,3578744788,3578744807,19
3,1219,28562,3578744788,3578744808,20
3,1219,28563,3578744788,3578744808,20
3,1219,28564,3578744788,3578744809,21
3,1219,28565,3578744788,3578744811,23
3,1219,28566,3578744788,3578744812,24
3,1219,28567,3578744788,3578744814,26
3,1219,28568,3578744788,3578744815,27
3,1219,28569,3578744788,3578744816,28
3,1219,28570,3578744788,3578744817,29
3,1219,28571,3578744788,3578744818,30
3,1219,28572,3578744788,3578744818,30
3,1219,28573,3578744788,3578744819,31
3,1219,28574,3578744788,3578744819,31
3,1219,28575,3578744788,3578744821,33
3,1219,28576,3578744788,3578744821,33
3,1219,28577,3578744788,3578744824,36
3,1219,28578,3578744788,3578744826,38
3,1219,28579,3578744788,3578744826,38
3,1219,28580,3578744788,3578744827,39
3,1219,28581,3578744788,3578744827,39
3,1219,28582,3578744788,3578744827,39
3,1219,28583,3578744788,3578744827,39
3,1219,28584,3578744788,3578744828,40
3,1219,28585,3578744788,3578744829,41
3,1219,28586,3578744788,3578744831,43
3,1219,28587,3578744788,3578744831,43
3,1219,28588,3578744788,3578744831,43
3,1219,28589,3578744788,3578744832,44
3,1219,28590,3578744788,3578744833,45
3,1219,28591,3578744788,3578744833,45
3,1219,28592,3578744788,3578744834,46
3,1219,28593,3578744788,3578744835,47
3,1220,28594,3578744852,3578744852,0
3,1220,28595,3578744852,3578744852,0
3,1220,28596,3578744852,3578744852,0
3,1220,28597,3578744852,3578744852,0
3,1220,28598,3578744852,3578744852,0
3,1220,28599,3578744852,3578744852,0
3,1220,28600,3578744852,3578744852,0
3,1220,28601,3578744852,3578744852,0
3,1220,28602,3578744852,3578744852,0
3,1220,28603,3578744852,3578744852,0
3,1220,28604,3578744852,3578744852,0
3,1220,28605,3578744852,3578744852,0
3,1220,28606,3578744852,3578744852,0
3,1220,28607,3578744852,3578744852,0
3,1220,28608,3578744852,3578744852,0
3,1220,28609,3578744852,3578744852,0
3,1220,28610,3578744852,3578744852,0
3,1220,28611,3578744852,3578744852,0
3,1220,28612,3578744852,3578744852,0
3,1220,28613,3578744852,3578744854,2
3,1220,28614,3578744852,3578744855,3
3,1220,28615,3578744852,3578744855,3
3,1220,28616,3578744852,3578744856,4
3,1220,28617,3578744852,3578744857,5
3,1220,28618,3578744852,3578744857,5
3,1220,28619,3578744852,3578744858,6
3,1220,28620,3578744852,3578744862,10
3,1220,28621,3578744852,3578744862,10
3,1220,28622,3578744852,3578744863,11
3,1220,28623,3578744852,3578744863,11
3,1220,28624,3578744852,3578744864,12
3,1220,28625,3578744852,3578744867,15
3,1220,28626,3578744852,3578744868,16
3,1220,28627,3578744852,3578744870,18
3,1220,28628,3578744852,3578744873,21
3,1220,28629,3578744852,3578744874,22
3,1220,28630,3578744852,3578744875,23
3,1220,28631,3578744852,3578744879,27
3,1220,28632,3578744852,3578744879,27
3,1220,28633,3578744852,3578744880,28
3,1220,28634,3578744852,3578744881,29
3,1220,28635,3578744852,3578744881,29
3,1220,28636,3578744852,3578744883,31
3,1220,28637,3578744852,3578744885,33
3,1220,28638,3578744852,3578744885,33
3,1220,28639,3578744852,3578744886,34
3,1220,28640,3578744852,3578744887,35
3,1220,28641,3578744852,3578744890,38
3,1220,28642,3578744852,3578744891,39
3,1220,28643,3578744852,3578744891,39
3,1220,28644,3578744852,3578744892,40
3,1220,28645,3578744852,3578744892,40
3,1220,28646,3578744852,3578744894,42
3,1220,28647,3578744852,3578744895,43
3,1220,28648,3578744852,3578744896,44
3,1220,28649,3578744852,3578744896,44
3,1220,28650,3578744852,3578744897,45
3,1220,28651,3578744852,3578744897,45
3,1220,28652,3578744852,3578744898,46
3,1220,28653,3578744852,3578744900,48
3,1220,28654,3578744852,3578744900,48
3,1220,28655,3578744852,3578744900,48
3,1220,28656,3578744852,3578744901,49
3,1220,28657,3578744852,3578744901,49
3,1220,28658,3578744852,3578744902,50
3,1221,28659,3578744914,3578744914,0
3,1221,28660,3578744914,3578744914,0
3,1221,28661,3578744914,3578744914,0
3,1221,28662,3578744914,3578744914,0
3,1221,28663,3578744914,3578744914,0
3,1221,28664,3578744914,3578744915,1
3,1221,28665,3578744914,3578744915,1
3,1221,28666,3578744914,3578744916,2
3,1221,28667,3578744914,3578744917,3
3,1221,28668,3578744914,3578744917,3
3,1221,28669,3578744914,3578744918,4
3,1221,28670,3578744914,3578744919,5
3,1221,28671,3578744914,3578744919,5
3,1221,28672,3578744914,3578744920,6
3,1221,28673,3578744914,3578744920,6
3,1221,28674,3578744914,3578744921,7
3,1221,28675,3578744914,3578744922,8
3,1221,28676,3578744914,3578744923,9
3,1221,28677,3578744914,3578744926,12
3,1221,28678,3578744914,3578744932,18
3,1221,28679,3578744914,3578744935,21
3,1221,28680,3578744914,3578744936,22
3,1221,28681,3578744914,3578744937,23
3,1221,28682,3578744914,3578744937,23
3,1221,28683,3578744914,3578744938,24
3,1221,28684,3578744914,3578744938,24
3,1221,28685,3578744914,3578744938,24
3,1221,28686,3578744914,3578744939,25
3,1221,28687,3578744914,3578744940,26
3,1221,28688,3578744914,3578744941,27
3,1221,28689,3578744914,3578744942,28
3,1221,28690,3578744914,3578744942,28
3,1221,28691,3578744914,3578744943,29
3,1221,28692,3578744914,3578744945,31
3,1221,28693,3578744914,3578744947,33
3,1221,28694,3578744914,3578744949,35
3,1221,28695,3578744914,3578744949,35
3,1221,28696,3578744914,3578744950,36
3,1221,28697,3578744914,3578744950,36
3,1221,28698,3578744914,3578744952,38
3,1221,28699,3578744914,3578744953,39
3,1221,28700,3578744914,3578744953,39
3,1221,28701,3578744914,3578744953,39
3,1221,28702,3578744914,3578744956,42
3,1221,28703,3578744914,3578744956,42
3,1221,28704,3578744914,3578744957,43
3,1221,28705,3578744914,3578744957,43
3,1221,28706,3578744914,3578744958,44
3,1221,28707,3578744914,3578744960,46
3,1221,28708,3578744914,3578744960,46
3,1221,28709,3578744914,3578744961,47
3,1221,28710,3578744914,3578744963,49
3,1221,28711,3578744914,3578744964,50
3,1222,28712,3578744977,3578744977,0
3,1222,28713,3578744977,3578744977,0
3,1222,28714,3578744977,3578744977,0
3,1222,28715,3578744977,3578744977,0
3,1222,28716,3578744977,3578744977,0
3,1222,28717,3578744977,3578744977,0
3,1222,28718,3578744977,3578744977,0
3,1222,28719,3578744977,3578744977,0
3,1222,28720,3578744977,3578744977,0
3,1222,28721,3578744977,3578744977,0
3,1222,28722,3578744977,3578744977,0
3,1222,28723,3578744977,3578744977,0
3,1222,28724,3578744977,3578744977,0
3,1222,28725,3578744977,3578744977,0
3,1222,28726,3578744977,3578744977,0
3,1222,28727,3578744977,3578744977,0
3,1222,28728,3578744977,3578744977,0
3,1222,28729,3578744977,3578744980,3
3,1222,28730,3578744977,3578744983,6
3,1222,28731,3578744977,3578744984,7
3,1222,28732,3578744977,3578744985,8
3,1222,28733,3578744977,3578744986,9
3,1222,28734,3578744977,3578744987,10
3,1222,28735,3578744977,3578744987,10
3,1222,28736,3578744977,3578744987,10
3,1222,28737,3578744977,3578744987,10
3,1222,28738,3578744977,3578744987,10
3,1222,28739,3578744977,3578744988,11
3,1222,28740,3578744977,3578744988,11
3,1222,28741,3578744977,3578744989,12
3,1222,28742,3578744977,3578744990,13
3,1222,28743,3578744977,3578744991,14
3,1222,28744,3578744977,3578744993,16
3,1222,28745,3578744977,3578744993,16
3,1222,28746,3578744977,3578744993,16
3,1222,28747,3578744977,3578744994,17
3,1222,28748,3578744977,3578744994,17
3,1222,28749,3578744977,3578744995,18
3,1222,28750,3578744977,3578744997,20
3,1222,28751,3578744977,3578744998,21
3,1222,28752,3578744977,3578744999,22
3,1222,28753,3578744977,3578745000,23
3,1222,28754,3578744977,3578745001,24
3,1222,28755,3578744977,3578745002,25
3,1222,28756,3578744977,3578745002,25
3,1222,28757,3578744977,3578745002,25
3,1222,28758,3578744977,3578745004,27
3,1222,28759,3578744977,3578745004,27
3,1222,28760,3578744977,3578745005,28
3,1222,28761,3578744977,3578745006,29
3,1222,28762,3578744977,3578745006,29
3,1222,28763,3578744977,3578745007,30
3,1222,28764,3578744977,3578745008,31
3,1222,28765,3578744977,3578745008,31
3,1222,28766,3578744977,3578745008,31
3,1222,28767,3578744977,3578745009,32
3,1222,28768,3578744977,3578745011,34
3,1222,28769,3578744977,3578745013,36
3,1222,28770,3578744977,3578745015,38
3,1222,28771,3578744977,3578745016,39
3,1222,28772,3578744977,3578745017,40
3,1222,28773,3578744977,3578745018,41
3,1222,28774,3578744977,3578745019,42
3,1222,28775,3578744977,3578745019,42
3,1222,28776,3578744977,3578745019,42
3,1222,28777,3578744977,3578745020,43
3,1222,28778,3578744977,3578745021,44
3,1222,28779,3578744977,3578745021,44
3,1222,28780,3578744977,3578745024,47
3,1222,28781,3578744977,3578745026,49
3,1222,28782,3578744977,3578745026,49
3,1222,28783,3578744977,3578745027,50
3,1223,28784,3578745039,3578745039,0
3,1223,28785,3578745039,3578745039,0
3,1223,28786,3578745039,3578745039,0
3,1223,28787,3578745039,3578745039,0
3,1223,28788,3578745039,3578745039,0
3,1223,28789,3578745039,3578745039,0
3,1223,28790,3578745039,3578745039,0
3,1223,28791,3578745039,3578745039,0
3,1223,28792,3578745039,3578745039,0
3,1223,28793,3578745039,3578745039,0
3,1223,28794,3578745039,3578745039,0
3,1223,28795,3578745039,3578745039,0
3,1223,28796,3578745039,3578745039,0
3,1223,28797,3578745039,3578745039,0
3,1223,28798,3578745039,3578745040,1
3,1223,28799,3578745039,3578745040,1
3,1223,28800,3578745039,3578745042,3
3,1223,28801,3578745039,3578745042,3
3,1223,28802,3578745039,3578745043,4
3,1223,28803,3578745039,3578745043,4
3,1223,28804,3578745039,3578745043,4
3,1223,28805,3578745039,3578745043,4
3,1223,28806,3578745039,3578745044,5
3,1223,28807,3578745039,3578745045,6
3,1223,28808,3578745039,3578745046,7
3,1223,28809,3578745039,3578745047,8
3,1223,28810,3578745039,3578745047,8
3,1223,28811,3578745039,3578745049,10
3,1223,28812,3578745039,3578745050,11
3,1223,28813,3578745039,3578745050,11
3,1223,28814,3578745039,3578745054,15
3,1223,28815,3578745039,3578745055,16
3,1223,28816,3578745039,3578745055,16
3,1223,28817,3578745039,3578745056,17
3,1223,28818,3578745039,3578745058,19
3,1223,28819,3578745039,3578745062,23
3,1223,28820,3578745039,3578745062,23
3,1223,28821,3578745039,3578745063,24
3,1223,28822,3578745039,3578745063,24
3,1223,28823,3578745039,3578745064,25
3,1223,28824,3578745039,3578745066,27
3,1223,28825,3578745039,3578745068,29
3,1223,28826,3578745039,3578745070,31
3,1223,28827,3578745039,3578745073,34
3,1223,28828,3578745039,3578745074,35
3,1223,28829,3578745039,3578745075,36
3,1223,28830,3578745039,3578745078,39
3,1223,28831,3578745039,3578745080,41
3,1223,28832,3578745039,3578745080,41
3,1223,28833,3578745039,3578745081,42
3,1223,28834,3578745039,3578745082,43
3,1223,28835,3578745039,3578745083,44
3,1223,28836,3578745039,3578745084,45
3,1223,28837,3578745039,3578745085,46
3,1223,28838,3578745039,3578745086,47
3,1223,28839,3578745039,3578745087,48
3,1224,28840,3578745100,3578745100,0
3,1224,28841,3578745100,3578745100,0
3,1224,28842,3578745100,3578745100,0
3,1224,28843,3578745100,3578745100,0
3,1224,28844,3578745100,3578745100,0
3,1224,28845,3578745100,3578745100,0
3,1224,28846,3578745100,3578745100,0
3,1224,28847,3578745100,3578745100,0
3,1224,28848,3578745100,3578745100,0
3,1224,28849,3578745100,3578745100,0
3,1224,28850,3578745100,3578745100,0
3,1224,28851,3578745100,3578745100,0
3,1224,28852,3578745100,3578745100,0
3,1224,28853,3578745100,3578745101,1
3,1224,28854,3578745100,3578745101,1
3,1224,28855,3578745100,3578745102,2
3,1224,28856,3578745100,3578745104,4
3,1224,28857,3578745100,3578745104,4
3,1224,28858,3578745100,3578745108,8
3,1224,28859,3578745100,3578745108,8
3,1224,28860,3578745100,3578745109,9
3,1224,28861,3578745100,3578745115,15
3,1224,28862,3578745100,3578745115,15
3,1224,28863,3578745100,3578745116,16
3,1224,28864,3578745100,3578745117,17
3,1224,28865,3578745100,3578745118,18
3,1224,28866,3578745100,3578745118,18
3,1224,28867,3578745100,3578745119,19
3,1224,28868,3578745100,3578745119,19
3,1224,28869,3578745100,3578745121,21
3,1224,28870,3578745100,3578745121,21
3,1224,28871,3578745100,3578745121,21
3,1224,28872,3578745100,3578745122,22
3,1224,28873,3578745100,3578745124,24
3,1224,28874,3578745100,3578745127,27
3,1224,28875,3578745100,3578745130,30
3,1224,28876,3578745100,3578745131,31
3,1224,28877,3578745100,3578745136,36
3,1224,28878,3578745100,3578745136,36
3,1224,28879,3578745100,3578745136,36
3,1224,28880,3578745100,3578745137,37
3,1224,28881,3578745100,3578745138,38
3,1224,28882,3578745100,3578745138,38
3,1224,28883,3578745100,3578745139,39
3,1224,28884,3578745100,3578745139,39
3,1224,28885,3578745100,3578745140,40
3,1224,28886,3578745100,3578745141,41
3,1224,28887,3578745100,3578745142,42
3,1224,28888,3578745100,3578745144,44
3,1224,28889,3578745100,3578745145,45
3,1224,28890,3578745100,3578745147,47
3,1224,28891,3578745100,3578745148,48
3,1224,28892,3578745100,3578745149,49
3,1224,28893,3578745100,3578745150,50
3,1225,28894,3578745161,3578745161,0
3,1225,28895,3578745161,3578745161,0
3,1225,28896,3578745161,3578745161,0
3,1225,28897,3578745161,3578745161,0
3,1225,28898,3578745161,3578745161,0
3,1225,28899,3578745161,3578745161,0
3,1225,28900,3578745161,3578745161,0
3,1225,28901,3578745161,3578745161,0
3,1225,28902,3578745161,3578745161,0
3,1225,28903,3578745161,3578745161,0
3,1225,28904,3578745161,3578745161,0
3,1225,28905,3578745161,3578745161,0
3,1225,28906,3578745161,3578745163,2
3,1225,28907,3578745161,3578745164,3
3,1225,28908,3578745161,3578745165,4
3,1225,28909,3578745161,3578745166,5
3,1225,28910,3578745161,3578745167,6
3,1225,28911,3578745161,3578745167,6
3,1225,28912,3578745161,3578745168,7
3,1225,28913,3578745161,3578745168,7
3,1225,28914,3578745161,3578745169,8
3,1225,28915,3578745161,3578745170,9
3,1225,28916,3578745161,3578745170,9
3,1225,28917,3578745161,3578745171,10
3,1225,28918,3578745161,3578745171,10
3,1225,28919,3578745161,3578745171,10
3,1225,28920,3578745161,3578745174,13
3,1225,28921,3578745161,3578745174,13
3,1225,28922,3578745161,3578745174,13
3,1225,28923,3578745161,3578745174,13
3,1225,28924,3578745161,3578745175,14
3,1225,28925,3578745161,3578745176,15
3,1225,28926,3578745161,3578745179,18
3,1225,28927,3578745161,3578745183,22
3,1225,28928,3578745161,3578745184,23
3,1225,28929,3578745161,3578745186,25
3,1225,28930,3578745161,3578745187,26
3,1225,28931,3578745161,3578745187,26
3,1225,28932,3578745161,3578745187,26
3,1225,28933,3578745161,3578745188,27
3,1225,28934,3578745161,3578745188,27
3,1225,28935,3578745161,3578745188,27
3,1225,28936,3578745161,3578745189,28
3,1225,28937,3578745161,3578745189,28
3,1225,28938,3578745161,3578745189,28
3,1225,28939,3578745161,3578745189,28
3,1225,28940,3578745161,3578745191,30
3,1225,28941,3578745161,3578745192,31
3,1225,28942,3578745161,3578745192,31
3,1225,28943,3578745161,3578745193,32
3,1225,28944,3578745161,3578745194,33
3,1225,28945,3578745161,3578745194,33
3,1225,28946,3578745161,3578745194,33
3,1225,28947,3578745161,3578745195,34
3,1225,28948,3578745161,3578745196,35
3,1225,28949,3578745161,3578745198,37
3,1225,28950,3578745161,3578745199,38
3,1225,28951,3578745161,3578745201,40
3,1225,28952,3578745161,3578745202,41
3,1225,28953,3578745161,3578745203,42
3,1225,28954,3578745161,3578745203,42
3,1225,28955,3578745161,3578745204,43
3,1225,28956,3578745161,3578745204,43
3,1225,28957,3578745161,3578745204,43
3,1225,28958,3578745161,3578745205,44
3,1225,28959,3578745161,3578745206,45
3,1225,28960,3578745161,3578745206,45
3,1225,28961,3578745161,3578745207,46
3,1225,28962,3578745161,3578745207,46
3,1225,28963,3578745161,3578745208,47
3,1225,28964,3578745161,3578745208,47
3,1225,28965,3578745161,3578745209,48
3,1226,28966,3578745222,3578745222,0
3,1226,28967,3578745222,3578745222,0
3,1226,28968,3578745222,3578745222,0
3,1226,28969,3578745222,3578745222,0
3,1226,28970,3578745222,3578745222,0
3,1226,28971,3578745222,3578745222,0
3,1226,28972,3578745222,3578745222,0
3,1226,28973,3578745222,3578745222,0
3,1226,28974,3578745222,3578745222,0
3,1226,28975,3578745222,3578745222,0
3,1226,28976,3578745222,3578745222,0
3,1226,28977,3578745222,3578745222,0
3,1226,28978,3578745222,3578745222,0
3,1226,28979,3578745222,3578745224,2
3,1226,28980,3578745222,3578745225,3
3,1226,28981,3578745222,3578745227,5
3,1226,28982,3578745222,3578745227,5
3,1226,28983,3578745222,3578745227,5
3,1226,28984,3578745222,3578745228,6
3,1226,28985,3578745222,3578745228,6
3,1226,28986,3578745222,3578745230,8
3,1226,28987,3578745222,3578745231,9
3,1226,28988,3578745222,3578745232,10
3,1226,28989,3578745222,3578745232,10
3,1226,28990,3578745222,3578745233,11
3,1226,28991,3578745222,3578745233,11
3,1226,28992,3578745222,3578745234,12
3,1226,28993,3578745222,3578745235,13
3,1226,28994,3578745222,3578745236,14
3,1226,28995,3578745222,3578745238,16
3,1226,28996,3578745222,3578745238,16
3,1226,28997,3578745222,3578745239,17
3,1226,28998,3578745222,3578745239,17
3,1226,28999,3578745222,3578745241,19
3,1226,29000,3578745222,3578745242,20
3,1226,29001,3578745222,3578745243,21
3,1226,29002,3578745222,3578745243,21
3,1226,29003,3578745222,3578745244,22
3,1226,29004,3578745222,3578745244,22
3,1226,29005,3578745222,3578745245,23
3,1226,29006,3578745222,3578745245,23
3,1226,29007,3578745222,3578745246,24
3,1226,29008,3578745222,3578745246,24
3,1226,29009,3578745222,3578745247,25
3,1226,29010,3578745222,3578745249,27
3,1226,29011,3578745222,3578745250,28
3,1226,29012,3578745222,3578745251,29
3,1226,29013,3578745222,3578745254,32
3,1226,29014,3578745222,3578745256,34
3,1226,29015,3578745222,3578745256,34
3,1226,29016,3578745222,3578745258,36
3,1226,29017,3578745222,3578745258,36
3,1226,29018,3578745222,3578745262,40
3,1226,29019,3578745222,3578745262,40
3,1226,29020,3578745222,3578745263,41
3,1226,29021,3578745222,3578745263,41
3,1226,29022,3578745222,3578745264,42
3,1226,29023,3578745222,3578745267,45
3,1226,29024,3578745222,3578745268,46
3,1226,29025,3578745222,3578745270,48
3,1227,29026,3578745285,3578745285,0
3,1227,29027,3578745285,3578745285,0
3,1227,29028,3578745285,3578745285,0
3,1227,29029,3578745285,3578745285,0
3,1227,29030,3578745285,3578745285,0
3,1227,29031,3578745285,3578745285,0
3,1227,29032,3578745285,3578745285,0
3,1227,29033,3578745285,3578745285,0
3,1227,29034,3578745285,3578745285,0
3,1227,29035,3578745285,3578745285,0
3,1227,29036,3578745285,3578745285,0
3,1227,29037,3578745285,3578745285,0
3,1227,29038,3578745285,3578745286,1
3,1227,29039,3578745285,3578745287,2
3,1227,29040,3578745285,3578745290,5
3,1227,29041,3578745285,3578745291,6
3,1227,29042,3578745285,3578745291,6
3,1227,29043,3578745285,3578745291,6
3,1227,29044,3578745285,3578745293,8
3,1227,29045,3578745285,3578745294,9
3,1227,29046,3578745285,3578745295,10
3,1227,29047,3578745285,3578745296,11
3,1227,29048,3578745285,3578745297,12
3,1227,29049,3578745285,3578745297,12
3,1227,29050,3578745285,3578745297,12
3,1227,29051,3578745285,3578745298,13
3,1227,29052,3578745285,3578745300,15
3,1227,29053,3578745285,3578745300,15
3,1227,29054,3578745285,3578745300,15
3,1227,29055,3578745285,3578745301,16
3,1227,29056,3578745285,3578745303,18
3,1227,29057,3578745285,3578745304,19
3,1227,29058,3578745285,3578745304,19
3,1227,29059,3578745285,3578745307,22
3,1227,29060,3578745285,3578745308,23
3,1227,29061,3578745285,3578745310,25
3,1227,29062,3578745285,3578745315,30
3,1227,29063,3578745285,3578745316,31
3,1227,29064,3578745285,3578745316,31
3,1227,29065,3578745285,3578745318,33
3,1227,29066,3578745285,3578745318,33
3,1227,29067,3578745285,3578745319,34
3,1227,29068,3578745285,3578745319,34
3,1227,29069,3578745285,3578745319,34
3,1227,29070,3578745285,3578745321,36
3,1227,29071,3578745285,3578745321,36
3,1227,29072,3578745285,3578745321,36
3,1227,29073,3578745285,3578745322,37
3,1227,29074,3578745285,3578745327,42
3,1227,29075,3578745285,3578745329,44
3,1227,29076,3578745285,3578745332,47
3,1228,29077,3578745346,3578745346,0
3,1228,29078,3578745346,3578745346,0
3,1228,29079,3578745346,3578745346,0
3,1228,29080,3578745346,3578745346,0
3,1228,29081,3578745346,3578745346,0
3,1228,29082,3578745346,3578745346,0
3,1228,29083,3578745346,3578745346,0
3,1228,29084,3578745346,3578745346,0
3,1228,29085,3578745346,3578745346,0
3,1228,29086,3578745346,3578745346,0
3,1228,29087,3578745346,3578745346,0
3,1228,29088,3578745346,3578745346,0
3,1228,29089,3578745346,3578745346,0
3,1228,29090,3578745346,3578745347,1
3,1228,29091,3578745346,3578745349,3
3,1228,29092,3578745346,3578745350,4
3,1228,29093,3578745346,3578745350,4
3,1228,29094,3578745346,3578745350,4
3,1228,29095,3578745346,3578745352,6
3,1228,29096,3578745346,3578745353,7
3,1228,29097,3578745346,3578745354,8
3,1228,29098,3578745346,3578745354,8
3,1228,29099,3578745346,3578745355,9
3,1228,29100,3578745346,3578745357,11
3,1228,29101,3578745346,3578745357,11
3,1228,29102,3578745346,3578745358,12
3,1228,29103,3578745346,3578745358,12
3,1228,29104,3578745346,3578745359,13
3,1228,29105,3578745346,3578745360,14
3,1228,29106,3578745346,3578745361,15
3,1228,29107,3578745346,3578745364,18
3,1228,29108,3578745346,3578745364,18
3,1228,29109,3578745346,3578745366,20
3,1228,29110,3578745346,3578745366,20
3,1228,29111,3578745346,3578745367,21
3,1228,29112,3578745346,3578745368,22
3,1228,29113,3578745346,3578745368,22
3,1228,29114,3578745346,3578745369,23
3,1228,29115,3578745346,3578745369,23
3,1228,29116,3578745346,3578745370,24
3,1228,29117,3578745346,3578745370,24
3,1228,29118,3578745346,3578745371,25
3,1228,29119,3578745346,3578745371,25
3,1228,29120,3578745346,3578745372,26
3,1228,29121,3578745346,3578745373,27
3,1228,29122,3578745346,3578745374,28
3,1228,29123,3578745346,3578745374,28
3,1228,29124,3578745346,3578745375,29
3,1228,29125,3578745346,3578745377,31
3,1228,29126,3578745346,3578745379,33
3,1228,29127,3578745346,3578745385,39
3,1228,29128,3578745346,3578745386,40
3,1228,29129,3578745346,3578745387,41
3,1228,29130,3578745346,3578745388,42
3,1228,29131,3578745346,3578745388,42
3,1228,29132,3578745346,3578745388,42
3,1228,29133,3578745346,3578745388,42
3,1228,29134,3578745346,3578745389,43
3,1228,29135,3578745346,3578745389,43
3,1228,29136,3578745346,3578745389,43
3,1228,29137,3578745346,3578745390,44
3,1228,29138,3578745346,3578745391,45
3,1228,29139,3578745346,3578745392,46
3,1228,29140,3578745346,3578745393,47
3,1228,29141,3578745346,3578745393,47
3,1228,29142,3578745346,3578745394,48
3,1228,29143,3578745346,3578745394,48
3,1228,29144,3578745346,3578745394,48
3,1228,29145,3578745346,3578745395,49
3,1228,29146,3578745346,3578745396,50
3,1229,29147,3578745407,3578745407,0
3,1229,29148,3578745407,3578745407,0
3,1229,29149,3578745407,3578745407,0
3,1229,29150,3578745407,3578745407,0
3,1229,29151,3578745407,3578745407,0
3,1229,29152,3578745407,3578745407,0
3,1229,29153,3578745407,3578745407,0
3,1229,29154,3578745407,3578745407,0
3,1229,29155,3578745407,3578745407,0
3,1229,29156,3578745407,3578745407,0
3,1229,29157,3578745407,3578745407,0
3,1229,29158,3578745407,3578745407,0
3,1229,29159,3578745407,3578745407,0
3,1229,29160,3578745407,3578745408,1
3,1229,29161,3578745407,3578745408,1
3,1229,29162,3578745407,3578745408,1
3,1229,29163,3578745407,3578745409,2
3,1229,29164,3578745407,3578745411,4
3,1229,29165,3578745407,3578745413,6
3,1229,29166,3578745407,3578745414,7
3,1229,29167,3578745407,3578745416,9
3,1229,29168,3578745407,3578745416,9
3,1229,29169,3578745407,3578745416,9
3,1229,29170,3578745407,3578745418,11
3,1229,29171,3578745407,3578745419,12
3,1229,29172,3578745407,3578745420,13
3,1229,29173,3578745407,3578745420,13
3,1229,29174,3578745407,3578745421,14
3,1229,29175,3578745407,3578745421,14
3,1229,29176,3578745407,3578745421,14
3,1229,29177,3578745407,3578745425,18
3,1229,29178,3578745407,3578745426,19
3,1229,29179,3578745407,3578745427,20
3,1229,29180,3578745407,3578745428,21
3,1229,29181,3578745407,3578745428,21
3,1229,29182,3578745407,3578745428,21
3,1229,29183,3578745407,3578745429,22
3,1229,29184,3578745407,3578745429,22
3,1229,29185,3578745407,3578745431,24
3,1229,29186,3578745407,3578745432,25
3,1229,29187,3578745407,3578745433,26
3,1229,29188,3578745407,3578745433,26
3,1229,29189,3578745407,3578745433,26
3,1229,29190,3578745407,3578745434,27
3,1229,29191,3578745407,3578745436,29
3,1229,29192,3578745407,3578745437,30
3,1229,29193,3578745407,3578745439,32
3,1229,29194,3578745407,3578745439,32
3,1229,29195,3578745407,3578745440,33
3,1229,29196,3578745407,3578745441,34
3,1229,29197,3578745407,3578745442,35
3,1229,29198,3578745407,3578745443,36
3,1229,29199,3578745407,3578745443,36
3,1229,29200,3578745407,3578745443,36
3,1229,29201,3578745407,3578745444,37
3,1229,29202,3578745407,3578745444,37
3,1229,29203,3578745407,3578745444,37
3,1229,29204,3578745407,3578745444,37
3,1229,29205,3578745407,3578745447,40
3,1229,29206,3578745407,3578745448,41
3,1229,29207,3578745407,3578745449,42
3,1229,29208,3578745407,3578745450,43
3,1229,29209,3578745407,3578745450,43
3,1229,29210,3578745407,3578745455,48
3,1229,29211,3578745407,3578745455,48
3,1229,29212,3578745407,3578745457,50
3,1230,29213,3578745470,3578745470,0
3,1230,29214,3578745470,3578745470,0
3,1230,29215,3578745470,3578745470,0
3,1230,29216,3578745470,3578745470,0
3,1230,29217,3578745470,3578745470,0
3,1230,29218,3578745470,3578745470,0
3,1230,29219,3578745470,3578745470,0
3,1230,29220,3578745470,3578745470,0
3,1230,29221,3578745470,3578745470,0
3,1230,29222,3578745470,3578745470,0
3,1230,29223,3578745470,3578745470,0
3,1230,29224,3578745470,3578745473,3
3,1230,29225,3578745470,3578745474,4
3,1230,29226,3578745470,3578745475,5
3,1230,29227,3578745470,3578745479,9
3,1230,29228,3578745470,3578745480,10
3,1230,29229,3578745470,3578745480,10
3,1230,29230,3578745470,3578745481,11
3,1230,29231,3578745470,3578745482,12
3,1230,29232,3578745470,3578745482,12
3,1230,29233,3578745470,3578745484,14
3,1230,29234,3578745470,3578745485,15
3,1230,29235,3578745470,3578745485,15
3,1230,29236,3578745470,3578745487,17
3,1230,29237,3578745470,3578745487,17
3,1230,29238,3578745470,3578745490,20
3,1230,29239,3578745470,3578745491,21
3,1230,29240,3578745470,3578745491,21
3,1230,29241,3578745470,3578745491,21
3,1230,29242,3578745470,3578745493,23
3,1230,29243,3578745470,3578745495,25
3,1230,29244,3578745470,3578745495,25
3,1230,29245,3578745470,3578745495,25
3,1230,29246,3578745470,3578745496,26
3,1230,29247,3578745470,3578745497,27
3,1230,29248,3578745470,3578745498,28
3,1230,29249,3578745470,3578745498,28
3,1230,29250,3578745470,3578745500,30
3,1230,29251,3578745470,3578745501,31
3,1230,29252,3578745470,3578745501,31
3,1230,29253,3578745470,3578745501,31
3,1230,29254,3578745470,3578745502,32
3,1230,29255,3578745470,3578745504,34
3,1230,29256,3578745470,3578745504,34
3,1230,29257,3578745470,3578745508,38
3,1230,29258,3578745470,3578745508,38
3,1230,29259,3578745470,3578745515,45
3,1230,29260,3578745470,3578745515,45
3,1230,29261,3578745470,3578745517,47
3,1230,29262,3578745470,3578745518,48
3,1230,29263,3578745470,3578745518,48
3,1230,29264,3578745470,3578745518,48
3,1230,29265,3578745470,3578745518,48
3,1230,29266,3578745470,3578745519,49
3,1230,29267,3578745470,3578745520,50
3,1231,29268,3578745534,3578745534,0
3,1231,29269,3578745534,3578745534,0
3,1231,29270,3578745534,3578745534,0
3,1231,29271,3578745534,3578745534,0
3,1231,29272,3578745534,3578745534,0
3,1231,29273,3578745534,3578745534,0
3,1231,29274,3578745534,3578745534,0
3,1231,29275,3578745534,3578745535,1
3,1231,29276,3578745534,3578745536,2
3,1231,29277,3578745534,3578745536,2
3,1231,29278,3578745534,3578745536,2
3,1231,29279,3578745534,3578745537,3
3,1231,29280,3578745534,3578745538,4
3,1231,29281,3578745534,3578745538,4
3,1231,29282,3578745534,3578745539,5
3,1231,29283,3578745534,3578745540,6
3,1231,29284,3578745534,3578745540,6
3,1231,29285,3578745534,3578745541,7
3,1231,29286,3578745534,3578745542,8
3,1231,29287,3578745534,3578745544,10
3,1231,29288,3578745534,3578745548,14
3,1231,29289,3578745534,3578745549,15
3,1231,29290,3578745534,3578745550,16
3,1231,29291,3578745534,3578745551,17
3,1231,29292,3578745534,3578745551,17
3,1231,29293,3578745534,3578745553,19
3,1231,29294,3578745534,3578745553,19
3,1231,29295,3578745534,3578745556,22
3,1231,29296,3578745534,3578745556,22
3,1231,29297,3578745534,3578745556,22
3,1231,29298,3578745534,3578745557,23
3,1231,29299,3578745534,3578745557,23
3,1231,29300,3578745534,3578745558,24
3,1231,29301,3578745534,3578745559,25
3,1231,29302,3578745534,3578745560,26
3,1231,29303,3578745534,3578745562,28
3,1231,29304,3578745534,3578745563,29
3,1231,29305,3578745534,3578745565,31
3,1231,29306,3578745534,3578745566,32
3,1231,29307,3578745534,3578745566,32
3,1231,29308,3578745534,3578745566,32
3,1231,29309,3578745534,3578745568,34
3,1231,29310,3578745534,3578745568,34
3,1231,29311,3578745534,3578745568,34
3,1231,29312,3578745534,3578745569,35
3,1231,29313,3578745534,3578745569,35
3,1231,29314,3578745534,3578745570,36
3,1231,29315,3578745534,3578745570,36
3,1231,29316,3578745534,3578745571,37
3,1231,29317,3578745534,3578745573,39
3,1231,29318,3578745534,3578745573,39
3,1231,29319,3578745534,3578745574,40
3,1231,29320,3578745534,3578745575,41
3,1231,29321,3578745534,3578745579,45
3,1231,29322,3578745534,3578745583,49
3,1232,29323,3578745597,3578745597,0
3,1232,29324,3578745597,3578745597,0
3,1232,29325,3578745597,3578745597,0
3,1232,29326,3578745597,3578745597,0
3,1232,29327,3578745597,3578745597,0
3,1232,29328,3578745597,3578745597,0
3,1232,29329,3578745597,3578745597,0
3,1232,29330,3578745597,3578745597,0
3,1232,29331,3578745597,3578745597,0
3,1232,29332,3578745597,3578745597,0
3,1232,29333,3578745597,3578745597,0
3,1232,29334,3578745597,3578745597,0
3,1232,29335,3578745597,3578745597,0
3,1232,29336,3578745597,3578745597,0
3,1232,29337,3578745597,3578745597,0
3,1232,29338,3578745597,3578745597,0
3,1232,29339,3578745597,3578745597,0
3,1232,29340,3578745597,3578745597,0
3,1232,29341,3578745597,3578745597,0
3,1232,29342,3578745597,3578745597,0
3,1232,29343,3578745597,3578745597,0
3,1232,29344,3578745597,3578745599,2
3,1232,29345,3578745597,3578745600,3
3,1232,29346,3578745597,3578745602,5
3,1232,29347,3578745597,3578745602,5
3,1232,29348,3578745597,3578745602,5
3,1232,29349,3578745597,3578745602,5
3,1232,29350,3578745597,3578745603,6
3,1232,29351,3578745597,3578745603,6
3,1232,29352,3578745597,3578745604,7
3,1232,29353,3578745597,3578745605,8
3,1232,29354,3578745597,3578745606,9
3,1232,29355,3578745597,3578745607,10
3,1232,29356,3578745597,3578745607,10
3,1232,29357,3578745597,3578745608,11
3,1232,29358,3578745597,3578745608,11
3,1232,29359,3578745597,3578745610,13
3,1232,29360,3578745597,3578745612,15
3,1232,29361,3578745597,3578745613,16
3,1232,29362,3578745597,3578745615,18
3,1232,29363,3578745597,3578745616,19
3,1232,29364,3578745597,3578745616,19
3,1232,29365,3578745597,3578745618,21
3,1232,29366,3578745597,3578745618,21
3,1232,29367,3578745597,3578745618,21
3,1232,29368,3578745597,3578745620,23
3,1232,29369,3578745597,3578745620,23
3,1232,29370,3578745597,3578745620,23
3,1232,29371,3578745597,3578745621,24
3,1232,29372,3578745597,3578745623,26
3,1232,29373,3578745597,3578745626,29
3,1232,29374,3578745597,3578745626,29
3,1232,29375,3578745597,3578745626,29
3,1232,29376,3578745597,3578745626,29
3,1232,29377,3578745597,3578745627,30
3,1232,29378,3578745597,3578745627,30
3,1232,29379,3578745597,3578745627,30
3,1232,29380,3578745597,3578745627,30
3,1232,29381,3578745597,3578745629,32
3,1232,29382,3578745597,3578745630,33
3,1232,29383,3578745597,3578745631,34
3,1232,29384,3578745597,3578745631,34
3,1232,29385,3578745597,3578745633,36
3,1232,29386,3578745597,3578745633,36
3,1232,29387,3578745597,3578745633,36
3,1232,29388,3578745597,3578745634,37
3,1232,29389,3578745597,3578745636,39
3,1232,29390,3578745597,3578745638,41
3,1232,29391,3578745597,3578745639,42
3,1232,29392,3578745597,3578745641,44
3,1232,29393,3578745597,3578745641,44
3,1232,29394,3578745597,3578745642,45
3,1232,29395,3578745597,3578745643,46
3,1232,29396,3578745597,3578745643,46
3,1232,29397,3578745597,3578745643,46
3,1232,29398,3578745597,3578745643,46
3,1232,29399,3578745597,3578745644,47
3,1232,29400,3578745597,3578745645,48
3,1232,29401,3578745597,3578745647,50
3,1233,29402,3578745658,3578745658,0
3,1233,29403,3578745658,3578745658,0
3,1233,29404,3578745658,3578745658,0
3,1233,29405,3578745658,3578745658,0
3,1233,29406,3578745658,3578745658,0
3,1233,29407,3578745658,3578745658,0
3,1233,29408,3578745658,3578745658,0
3,1233,29409,3578745658,3578745658,0
3,1233,29410,3578745658,3578745661,3
3,1233,29411,3578745658,3578745661,3
3,1233,29412,3578745658,3578745662,4
3,1233,29413,3578745658,3578745662,4
3,1233,29414,3578745658,3578745664,6
3,1233,29415,3578745658,3578745666,8
3,1233,29416,3578745658,3578745668,10
3,1233,29417,3578745658,3578745668,10
3,1233,29418,3578745658,3578745673,15
3,1233,29419,3578745658,3578745674,16
3,1233,29420,3578745658,3578745675,17
3,1233,29421,3578745658,3578745679,21
3,1233,29422,3578745658,3578745680,22
3,1233,29423,3578745658,3578745680,22
3,1233,29424,3578745658,3578745681,23
3,1233,29425,3578745658,3578745682,24
3,1233,29426,3578745658,3578745682,24
3,1233,29427,3578745658,3578745684,26
3,1233,29428,3578745658,3578745685,27
3,1233,29429,3578745658,3578745685,27
3,1233,29430,3578745658,3578745687,29
3,1233,29431,3578745658,3578745687,29
3,1233,29432,3578745658,3578745690,32
3,1233,29433,3578745658,3578745691,33
3,1233,29434,3578745658,3578745691,33
3,1233,29435,3578745658,3578745692,34
3,1233,29436,3578745658,3578745693,35
3,1233,29437,3578745658,3578745695,37
3,1233,29438,3578745658,3578745695,37
3,1233,29439,3578745658,3578745696,38
3,1233,29440,3578745658,3578745696,38
3,1233,29441,3578745658,3578745697,39
3,1233,29442,3578745658,3578745698,40
3,1233,29443,3578745658,3578745698,40
3,1233,29444,3578745658,3578745700,42
3,1233,29445,3578745658,3578745700,42
3,1233,29446,3578745658,3578745701,43
3,1233,29447,3578745658,3578745702,44
3,1233,29448,3578745658,3578745703,45
3,1233,29449,3578745658,3578745703,45
3,1233,29450,3578745658,3578745704,46
3,1233,29451,3578745658,3578745708,50
3,1234,29452,3578745720,3578745720,0
3,1234,29453,3578745720,3578745720,0
3,1234,29454,3578745720,3578745720,0
3,1234,29455,3578745720,3578745720,0
3,1234,29456,3578745720,3578745720,0
3,1234,29457,3578745720,3578745720,0
3,1234,29458,3578745720,3578745720,0
3,1234,29459,3578745720,3578745720,0
3,1234,29460,3578745720,3578745720,0
3,1234,29461,3578745720,3578745720,0
3,1234,29462,3578745720,3578745720,0
3,1234,29463,3578745720,3578745721,1
3,1234,29464,3578745720,3578745721,1
3,1234,29465,3578745720,3578745721,1
3,1234,29466,3578745720,3578745723,3
3,1234,29467,3578745720,3578745726,6
3,1234,29468,3578745720,3578745729,9
3,1234,29469,3578745720,3578745731,11
3,1234,29470,3578745720,3578745734,14
3,1234,29471,3578745720,3578745736,16
3,1234,29472,3578745720,3578745737,17
3,1234,29473,3578745720,3578745737,17
3,1234,29474,3578745720,3578745737,17
3,1234,29475,3578745720,3578745738,18
3,1234,29476,3578745720,3578745740,20
3,1234,29477,3578745720,3578745740,20
3,1234,29478,3578745720,3578745740,20
3,1234,29479,3578745720,3578745741,21
3,1234,29480,3578745720,3578745741,21
3,1234,29481,3578745720,3578745744,24
3,1234,29482,3578745720,3578745744,24
3,1234,29483,3578745720,3578745748,28
3,1234,29484,3578745720,3578745749,29
3,1234,29485,3578745720,3578745749,29
3,1234,29486,3578745720,3578745749,29
3,1234,29487,3578745720,3578745751,31
3,1234,29488,3578745720,3578745752,32
3,1234,29489,3578745720,3578745753,33
3,1234,29490,3578745720,3578745754,34
3,1234,29491,3578745720,3578745755,35
3,1234,29492,3578745720,3578745756,36
3,1234,29493,3578745720,3578745757,37
3,1234,29494,3578745720,3578745757,37
3,1234,29495,3578745720,3578745757,37
3,1234,29496,3578745720,3578745758,38
3,1234,29497,3578745720,3578745760,40
3,1234,29498,3578745720,3578745760,40
3,1234,29499,3578745720,3578745763,43
3,1234,29500,3578745720,3578745763,43
3,1234,29501,3578745720,3578745765,45
3,1234,29502,3578745720,3578745765,45
3,1234,29503,3578745720,3578745767,47
3,1234,29504,3578745720,3578745768,48
3,1234,29505,3578745720,3578745769,49
3,1234,29506,3578745720,3578745769,49
3,1234,29507,3578745720,3578745769,49
3,1234,29508,3578745720,3578745770,50
3,1235,29509,3578745782,3578745782,0
3,1235,29510,3578745782,3578745782,0
3,1235,29511,3578745782,3578745782,0
3,1235,29512,3578745782,3578745782,0
3,1235,29513,3578745782,3578745782,0
3,1235,29514,3578745782,3578745782,0
3,1235,29515,3578745782,3578745782,0
3,1235,29516,3578745782,3578745782,0
3,1235,29517,3578745782,3578745783,1
3,1235,29518,3578745782,3578745784,2
3,1235,29519,3578745782,3578745785,3
3,1235,29520,3578745782,3578745786,4
3,1235,29521,3578745782,3578745787,5
3,1235,29522,3578745782,3578745787,5
3,1235,29523,3578745782,3578745787,5
3,1235,29524,3578745782,3578745787,5
3,1235,29525,3578745782,3578745788,6
3,1235,29526,3578745782,3578745788,6
3,1235,29527,3578745782,3578745788,6
3,1235,29528,3578745782,3578745789,7
3,1235,29529,3578745782,3578745790,8
3,1235,29530,3578745782,3578745791,9
3,1235,29531,3578745782,3578745791,9
3,1235,29532,3578745782,3578745792,10
3,1235,29533,3578745782,3578745793,11
3,1235,29534,3578745782,3578745793,11
3,1235,29535,3578745782,3578745794,12
3,1235,29536,3578745782,3578745795,13
3,1235,29537,3578745782,3578745796,14
3,1235,29538,3578745782,3578745797,15
3,1235,29539,3578745782,3578745799,17
3,1235,29540,3578745782,3578745800,18
3,1235,29541,3578745782,3578745801,19
3,1235,29542,3578745782,3578745802,20
3,1235,29543,3578745782,3578745802,20
3,1235,29544,3578745782,3578745803,21
3,1235,29545,3578745782,3578745803,21
3,1235,29546,3578745782,3578745804,22
3,1235,29547,3578745782,3578745805,23
3,1235,29548,3578745782,3578745805,23
3,1235,29549,3578745782,3578745806,24
3,1235,29550,3578745782,3578745807,25
3,1235,29551,3578745782,3578745808,26
3,1235,29552,3578745782,3578745808,26
3,1235,29553,3578745782,3578745808,26
3,1235,29554,3578745782,3578745808,26
3,1235,29555,3578745782,3578745811,29
3,1235,29556,3578745782,3578745813,31
3,1235,29557,3578745782,3578745813,31
3,1235,29558,3578745782,3578745815,33
3,1235,29559,3578745782,3578745815,33
3,1235,29560,3578745782,3578745815,33
3,1235,29561,3578745782,3578745818,36
3,1235,29562,3578745782,3578745818,36
3,1235,29563,3578745782,3578745818,36
3,1235,29564,3578745782,3578745820,38
3,1235,29565,3578745782,3578745820,38
3,1235,29566,3578745782,3578745821,39
3,1235,29567,3578745782,3578745822,40
3,1235,29568,3578745782,3578745824,42
3,1235,29569,3578745782,3578745825,43
3,1235,29570,3578745782,3578745825,43
3,1235,29571,3578745782,3578745826,44
3,1235,29572,3578745782,3578745826,44
3,1235,29573,3578745782,3578745827,45
3,1235,29574,3578745782,3578745828,46
3,1235,29575,3578745782,3578745828,46
3,1235,29576,3578745782,3578745828,46
3,1235,29577,3578745782,3578745829,47
3,1235,29578,3578745782,3578745830,48
3,1235,29579,3578745782,3578745831,49
3,1235,29580,3578745782,3578745832,50
3,1236,29581,3578745843,3578745843,0
3,1236,29582,3578745843,3578745843,0
3,1236,29583,3578745843,3578745843,0
3,1236,29584,3578745843,3578745843,0
3,1236,29585,3578745843,3578745843,0
3,1236,29586,3578745843,3578745843,0
3,1236,29587,3578745843,3578745843,0
3,1236,29588,3578745843,3578745843,0
3,1236,29589,3578745843,3578745843,0
3,1236,29590,3578745843,3578745843,0
3,1236,29591,3578745843,3578745843,0
3,1236,29592,3578745843,3578745843,0
3,1236,29593,3578745843,3578745843,0
3,1236,29594,3578745843,3578745843,0
3,1236,29595,3578745843,3578745844,1
3,1236,29596,3578745843,3578745844,1
3,1236,29597,3578745843,3578745844,1
3,1236,29598,3578745843,3578745845,2
3,1236,29599,3578745843,3578745847,4
3,1236,29600,3578745843,3578745847,4
3,1236,29601,3578745843,3578745849,6
3,1236,29602,3578745843,3578745852,9
3,1236,29603,3578745843,3578745853,10
3,1236,29604,3578745843,3578745854,11
3,1236,29605,3578745843,3578745855,12
3,1236,29606,3578745843,3578745857,14
3,1236,29607,3578745843,3578745858,15
3,1236,29608,3578745843,3578745858,15
3,1236,29609,3578745843,3578745861,18
3,1236,29610,3578745843,3578745862,19
3,1236,29611,3578745843,3578745862,19
3,1236,29612,3578745843,3578745863,20
3,1236,29613,3578745843,3578745864,21
3,1236,29614,3578745843,3578745865,22
3,1236,29615,3578745843,3578745869,26
3,1236,29616,3578745843,3578745869,26
3,1236,29617,3578745843,3578745873,30
3,1236,29618,3578745843,3578745875,32
3,1236,29619,3578745843,3578745879,36
3,1236,29620,3578745843,3578745880,37
3,1236,29621,3578745843,3578745881,38
3,1236,29622,3578745843,3578745882,39
3,1236,29623,3578745843,3578745882,39
3,1236,29624,3578745843,3578745882,39
3,1236,29625,3578745843,3578745884,41
3,1236,29626,3578745843,3578745884,41
3,1236,29627,3578745843,3578745885,42
3,1236,29628,3578745843,3578745887,44
3,1236,29629,3578745843,3578745890,47
3,1236,29630,3578745843,3578745891,48
3,1236,29631,3578745843,3578745891,48
3,1236,29632,3578745843,3578745891,48
3,1236,29633,3578745843,3578745892,49
3,1237,29634,3578745905,3578745905,0
3,1237,29635,3578745905,3578745905,0
3,1237,29636,3578745905,3578745905,0
3,1237,29637,3578745905,3578745905,0
3,1237,29638,3578745905,3578745905,0
3,1237,29639,3578745905,3578745905,0
3,1237,29640,3578745905,3578745905,0
3,1237,29641,3578745905,3578745905,0
3,1237,29642,3578745905,3578745905,0
3,1237,29643,3578745905,3578745905,0
3,1237,29644,3578745905,3578745905,0
3,1237,29645,3578745905,3578745905,0
3,1237,29646,3578745905,3578745905,0
3,1237,29647,3578745905,3578745908,3
3,1237,29648,3578745905,3578745908,3
3,1237,29649,3578745905,3578745910,5
3,1237,29650,3578745905,3578745914,9
3,1237,29651,3578745905,3578745916,11
3,1237,29652,3578745905,3578745917,12
3,1237,29653,3578745905,3578745918,13
3,1237,29654,3578745905,3578745919,14
3,1237,29655,3578745905,3578745919,14
3,1237,29656,3578745905,3578745919,14
3,1237,29657,3578745905,3578745919,14
3,1237,29658,3578745905,3578745921,16
3,1237,29659,3578745905,3578745921,16
3,1237,29660,3578745905,3578745921,16
3,1237,29661,3578745905,3578745922,17
3,1237,29662,3578745905,3578745924,19
3,1237,29663,3578745905,3578745927,22
3,1237,29664,3578745905,3578745929,24
3,1237,29665,3578745905,3578745932,27
3,1237,29666,3578745905,3578745935,30
3,1237,29667,3578745905,3578745935,30
3,1237,29668,3578745905,3578745937,32
3,1237,29669,3578745905,3578745937,32
3,1237,29670,3578745905,3578745937,32
3,1237,29671,3578745905,3578745938,33
3,1237,29672,3578745905,3578745938,33
3,1237,29673,3578745905,3578745940,35
3,1237,29674,3578745905,3578745940,35
3,1237,29675,3578745905,3578745940,35
3,1237,29676,3578745905,3578745941,36
3,1237,29677,3578745905,3578745942,37
3,1237,29678,3578745905,3578745944,39
3,1237,29679,3578745905,3578745944,39
3,1237,29680,3578745905,3578745947,42
3,1237,29681,3578745905,3578745948,43
3,1237,29682,3578745905,3578745949,44
3,1237,29683,3578745905,3578745950,45
3,1237,29684,3578745905,3578745950,45
3,1237,29685,3578745905,3578745951,46
3,1237,29686,3578745905,3578745952,47
3,1237,29687,3578745905,3578745953,48
3,1237,29688,3578745905,3578745954,49
3,1238,29689,3578745968,3578745968,0
3,1238,29690,3578745968,3578745968,0
3,1238,29691,3578745968,3578745968,0
3,1238,29692,3578745968,3578745968,0
3,1238,29693,3578745968,3578745968,0
3,1238,29694,3578745968,3578745968,0
3,1238,29695,3578745968,3578745968,0
3,1238,29696,3578745968,3578745968,0
3,1238,29697,3578745968,3578745968,0
3,1238,29698,3578745968,3578745968,0
3,1238,29699,3578745968,3578745968,0
3,1238,29700,3578745968,3578745968,0
3,1238,29701,3578745968,3578745968,0
3,1238,29702,3578745968,3578745968,0
3,1238,29703,3578745968,3578745969,1
3,1238,29704,3578745968,3578745969,1
3,1238,29705,3578745968,3578745970,2
3,1238,29706,3578745968,3578745970,2
3,1238,29707,3578745968,3578745971,3
3,1238,29708,3578745968,3578745972,4
3,1238,29709,3578745968,3578745973,5
3,1238,29710,3578745968,3578745974,6
3,1238,29711,3578745968,3578745974,6
3,1238,29712,3578745968,3578745975,7
3,1238,29713,3578745968,3578745976,8
3,1238,29714,3578745968,3578745978,10
3,1238,29715,3578745968,3578745984,16
3,1238,29716,3578745968,3578745984,16
3,1238,29717,3578745968,3578745986,18
3,1238,29718,3578745968,3578745986,18
3,1238,29719,3578745968,3578745987,19
3,1238,29720,3578745968,3578745987,19
3,1238,29721,3578745968,3578745987,19
3,1238,29722,3578745968,3578745987,19
3,1238,29723,3578745968,3578745987,19
3,1238,29724,3578745968,3578745988,20
3,1238,29725,3578745968,3578745988,20
3,1238,29726,3578745968,3578745989,21
3,1238,29727,3578745968,3578745989,21
3,1238,29728,3578745968,3578745991,23
3,1238,29729,3578745968,3578745992,24
3,1238,29730,3578745968,3578745992,24
3,1238,29731,3578745968,3578745993,25
3,1238,29732,3578745968,3578745993,25
3,1238,29733,3578745968,3578745994,26
3,1238,29734,3578745968,3578745996,28
3,1238,29735,3578745968,3578745996,28
3,1238,29736,3578745968,3578745997,29
3,1238,29737,3578745968,3578745999,31
3,1238,29738,3578745968,3578746001,33
3,1238,29739,3578745968,3578746002,34
3,1238,29740,3578745968,3578746002,34
3,1238,29741,3578745968,3578746003,35
3,1238,29742,3578745968,3578746004,36
3,1238,29743,3578745968,3578746005,37
3,1238,29744,3578745968,3578746005,37
3,1238,29745,3578745968,3578746006,38
3,1238,29746,3578745968,3578746007,39
3,1238,29747,3578745968,3578746007,39
3,1238,29748,3578745968,3578746008,40
3,1238,29749,3578745968,3578746008,40
3,1238,29750,3578745968,3578746009,41
3,1238,29751,3578745968,3578746012,44
3,1238,29752,3578745968,3578746013,45
3,1238,29753,3578745968,3578746014,46
3,1238,29754,3578745968,3578746015,47
3,1238,29755,3578745968,3578746015,47
3,1238,29756,3578745968,3578746016,48
3,1238,29757,3578745968,3578746018,50
3,1239,29758,3578746030,3578746030,0
3,1239,29759,3578746030,3578746030,0
3,1239,29760,3578746030,3578746030,0
3,1239,29761,3578746030,3578746030,0
3,1239,29762,3578746030,3578746030,0
3,1239,29763,3578746030,3578746030,0
3,1239,29764,3578746030,3578746030,0
3,1239,29765,3578746030,3578746030,0
3,1239,29766,3578746030,3578746030,0
3,1239,29767,3578746030,3578746030,0
3,1239,29768,3578746030,3578746030,0
3,1239,29769,3578746030,3578746030,0
3,1239,29770,3578746030,3578746030,0
3,1239,29771,3578746030,3578746030,0
3,1239,29772,3578746030,3578746030,0
3,1239,29773,3578746030,3578746031,1
3,1239,29774,3578746030,3578746031,1
3,1239,29775,3578746030,3578746031,1
3,1239,29776,3578746030,3578746032,2
3,1239,29777,3578746030,3578746033,3
3,1239,29778,3578746030,3578746034,4
3,1239,29779,3578746030,3578746034,4
3,1239,29780,3578746030,3578746036,6
3,1239,29781,3578746030,3578746038,8
3,1239,29782,3578746030,3578746038,8
3,1239,29783,3578746030,3578746038,8
3,1239,29784,3578746030,3578746040,10
3,1239,29785,3578746030,3578746041,11
3,1239,29786,3578746030,3578746041,11
3,1239,29787,3578746030,3578746042,12
3,1239,29788,3578746030,3578746043,13
3,1239,29789,3578746030,3578746043,13
3,1239,29790,3578746030,3578746043,13
3,1239,29791,3578746030,3578746044,14
3,1239,29792,3578746030,3578746044,14
3,1239,29793,3578746030,3578746044,14
3,1239,29794,3578746030,3578746045,15
3,1239,29795,3578746030,3578746047,17
3,1239,29796,3578746030,3578746048,18
3,1239,29797,3578746030,3578746048,18
3,1239,29798,3578746030,3578746050,20
3,1239,29799,3578746030,3578746051,21
3,1239,29800,3578746030,3578746054,24
3,1239,29801,3578746030,3578746054,24
3,1239,29802,3578746030,3578746055,25
3,1239,29803,3578746030,3578746057,27
3,1239,29804,3578746030,3578746058,28
3,1239,29805,3578746030,3578746058,28
3,1239,29806,3578746030,3578746062,32
3,1239,29807,3578746030,3578746062,32
3,1239,29808,3578746030,3578746062,32
3,1239,29809,3578746030,3578746063,33
3,1239,29810,3578746030,3578746063,33
3,1239,29811,3578746030,3578746065,35
3,1239,29812,3578746030,3578746068,38
3,1239,29813,3578746030,3578746069,39
3,1239,29814,3578746030,3578746074,44
3,1239,29815,3578746030,3578746074,44
3,1239,29816,3578746030,3578746075,45
3,1239,29817,3578746030,3578746080,50
3,1240,29818,3578746092,3578746092,0
3,1240,29819,3578746092,3578746092,0
3,1240,29820,3578746092,3578746092,0
3,1240,29821,3578746092,3578746092,0
3,1240,29822,3578746092,3578746092,0
3,1240,29823,3578746092,3578746092,0
3,1240,29824,3578746092,3578746092,0
3,1240,29825,3578746092,3578746092,0
3,1240,29826,3578746092,3578746092,0
3,1240,29827,3578746092,3578746092,0
3,1240,29828,3578746092,3578746092,0
3,1240,29829,3578746092,3578746092,0
3,1240,29830,3578746092,3578746092,0
3,1240,29831,3578746092,3578746093,1
3,1240,29832,3578746092,3578746095,3
3,1240,29833,3578746092,3578746096,4
3,1240,29834,3578746092,3578746098,6
3,1240,29835,3578746092,3578746098,6
3,1240,29836,3578746092,3578746099,7
3,1240,29837,3578746092,3578746100,8
3,1240,29838,3578746092,3578746101,9
3,1240,29839,3578746092,3578746102,10
3,1240,29840,3578746092,3578746103,11
3,1240,29841,3578746092,3578746103,11
3,1240,29842,3578746092,3578746104,12
3,1240,29843,3578746092,3578746108,16
3,1240,29844,3578746092,3578746108,16
3,1240,29845,3578746092,3578746114,22
3,1240,29846,3578746092,3578746116,24
3,1240,29847,3578746092,3578746117,25
3,1240,29848,3578746092,3578746118,26
3,1240,29849,3578746092,3578746119,27
3,1240,29850,3578746092,3578746119,27
3,1240,29851,3578746092,3578746119,27
3,1240,29852,3578746092,3578746119,27
3,1240,29853,3578746092,3578746121,29
3,1240,29854,3578746092,3578746121,29
3,1240,29855,3578746092,3578746121,29
3,1240,29856,3578746092,3578746122,30
3,1240,29857,3578746092,3578746124,32
3,1240,29858,3578746092,3578746128,36
3,1240,29859,3578746092,3578746129,37
3,1240,29860,3578746092,3578746131,39
3,1240,29861,3578746092,3578746135,43
3,1240,29862,3578746092,3578746136,44
3,1240,29863,3578746092,3578746137,45
3,1240,29864,3578746092,3578746137,45
3,1240,29865,3578746092,3578746138,46
3,1240,29866,3578746092,3578746138,46
3,1240,29867,3578746092,3578746139,47
3,1240,29868,3578746092,3578746139,47
3,1240,29869,3578746092,3578746141,49
3,1241,29870,3578746154,3578746154,0
3,1241,29871,3578746154,3578746154,0
3,1241,29872,3578746154,3578746154,0
3,1241,29873,3578746154,3578746154,0
3,1241,29874,3578746154,3578746154,0
3,1241,29875,3578746154,3578746154,0
3,1241,29876,3578746154,3578746154,0
3,1241,29877,3578746154,3578746154,0
3,1241,29878,3578746154,3578746154,0
3,1241,29879,3578746154,3578746154,0
3,1241,29880,3578746154,3578746154,0
3,1241,29881,3578746154,3578746155,1
3,1241,29882,3578746154,3578746157,3
3,1241,29883,3578746154,3578746157,3
3,1241,29884,3578746154,3578746158,4
3,1241,29885,3578746154,3578746158,4
3,1241,29886,3578746154,3578746159,5
3,1241,29887,3578746154,3578746160,6
3,1241,29888,3578746154,3578746160,6
3,1241,29889,3578746154,3578746163,9
3,1241,29890,3578746154,3578746164,10
3,1241,29891,3578746154,3578746167,13
3,1241,29892,3578746154,3578746167,13
3,1241,29893,3578746154,3578746168,14
3,1241,29894,3578746154,3578746169,15
3,1241,29895,3578746154,3578746169,15
3,1241,29896,3578746154,3578746170,16
3,1241,29897,3578746154,3578746170,16
3,1241,29898,3578746154,3578746171,17
3,1241,29899,3578746154,3578746171,17
3,1241,29900,3578746154,3578746171,17
3,1241,29901,3578746154,3578746173,19
3,1241,29902,3578746154,3578746174,20
3,1241,29903,3578746154,3578746175,21
3,1241,29904,3578746154,3578746175,21
3,1241,29905,3578746154,3578746176,22
3,1241,29906,3578746154,3578746179,25
3,1241,29907,3578746154,3578746183,29
3,1241,29908,3578746154,3578746184,30
3,1241,29909,3578746154,3578746186,32
3,1241,29910,3578746154,3578746187,33
3,1241,29911,3578746154,3578746187,33
3,1241,29912,3578746154,3578746188,34
3,1241,29913,3578746154,3578746188,34
3,1241,29914,3578746154,3578746188,34
3,1241,29915,3578746154,3578746188,34
3,1241,29916,3578746154,3578746189,35
3,1241,29917,3578746154,3578746189,35
3,1241,29918,3578746154,3578746191,37
3,1241,29919,3578746154,3578746191,37
3,1241,29920,3578746154,3578746191,37
3,1241,29921,3578746154,3578746192,38
3,1241,29922,3578746154,3578746194,40
3,1241,29923,3578746154,3578746194,40
3,1241,29924,3578746154,3578746194,40
3,1241,29925,3578746154,3578746196,42
3,1241,29926,3578746154,3578746198,44
3,1241,29927,3578746154,3578746199,45
3,1241,29928,3578746154,3578746201,47
3,1241,29929,3578746154,3578746202,48
3,1241,29930,3578746154,3578746202,48
3,1241,29931,3578746154,3578746203,49
3,1241,29932,3578746154,3578746203,49
3,1241,29933,3578746154,3578746204,50
3,1242,29934,3578746215,3578746215,0
3,1242,29935,3578746215,3578746215,0
3,1242,29936,3578746215,3578746215,0
3,1242,29937,3578746215,3578746215,0
3,1242,29938,3578746215,3578746215,0
3,1242,29939,3578746215,3578746215,0
3,1242,29940,3578746215,3578746215,0
3,1242,29941,3578746215,3578746215,0
3,1242,29942,3578746215,3578746215,0
3,1242,29943,3578746215,3578746215,0
3,1242,29944,3578746215,3578746215,0
3,1242,29945,3578746215,3578746215,0
3,1242,29946,3578746215,3578746216,1
3,1242,29947,3578746215,3578746216,1
3,1242,29948,3578746215,3578746218,3
3,1242,29949,3578746215,3578746218,3
3,1242,29950,3578746215,3578746218,3
3,1242,29951,3578746215,3578746220,5
3,1242,29952,3578746215,3578746221,6
3,1242,29953,3578746215,3578746221,6
3,1242,29954,3578746215,3578746222,7
3,1242,29955,3578746215,3578746224,9
3,1242,29956,3578746215,3578746225,10
3,1242,29957,3578746215,3578746227,12
3,1242,29958,3578746215,3578746227,12
3,1242,29959,3578746215,3578746227,12
3,1242,29960,3578746215,3578746228,13
3,1242,29961,3578746215,3578746228,13
3,1242,29962,3578746215,3578746228,13
3,1242,29963,3578746215,3578746230,15
3,1242,29964,3578746215,3578746231,16
3,1242,29965,3578746215,3578746231,16
3,1242,29966,3578746215,3578746232,17
3,1242,29967,3578746215,3578746232,17
3,1242,29968,3578746215,3578746233,18
3,1242,29969,3578746215,3578746234,19
3,1242,29970,3578746215,3578746235,20
3,1242,29971,3578746215,3578746236,21
3,1242,29972,3578746215,3578746238,23
3,1242,29973,3578746215,3578746238,23
3,1242,29974,3578746215,3578746239,24
3,1242,29975,3578746215,3578746242,27
3,1242,29976,3578746215,3578746242,27
3,1242,29977,3578746215,3578746242,27
3,1242,29978,3578746215,3578746243,28
3,1242,29979,3578746215,3578746243,28
3,1242,29980,3578746215,3578746243,28
3,1242,29981,3578746215,3578746244,29
3,1242,29982,3578746215,3578746244,29
3,1242,29983,3578746215,3578746245,30
3,1242,29984,3578746215,3578746246,31
3,1242,29985,3578746215,3578746248,33
3,1242,29986,3578746215,3578746248,33
3,1242,29987,3578746215,3578746250,35
3,1242,29988,3578746215,3578746252,37
3,1242,29989,3578746215,3578746253,38
3,1242,29990,3578746215,3578746255,40
3,1242,29991,3578746215,3578746256,41
3,1242,29992,3578746215,3578746257,42
3,1242,29993,3578746215,3578746261,46
3,1242,29994,3578746215,3578746261,46
3,1242,29995,3578746215,3578746262,47
3,1242,29996,3578746215,3578746264,49
3,1242,29997,3578746215,3578746264,49
3,1242,29998,3578746215,3578746265,50
3,1243,29999,3578746276,3578746276,0
3,1243,30000,3578746276,3578746276,0
3,1243,30001,3578746276,3578746276,0
3,1243,30002,3578746276,3578746276,0
3,1243,30003,3578746276,3578746276,0
3,1243,30004,3578746276,3578746279,3
3,1243,30005,3578746276,3578746280,4
3,1243,30006,3578746276,3578746281,5
3,1243,30007,3578746276,3578746281,5
3,1243,30008,3578746276,3578746281,5
3,1243,30009,3578746276,3578746283,7
3,1243,30010,3578746276,3578746284,8
3,1243,30011,3578746276,3578746284,8
3,1243,30012,3578746276,3578746285,9
3,1243,30013,3578746276,3578746288,12
3,1243,30014,3578746276,3578746290,14
3,1243,30015,3578746276,3578746290,14
3,1243,30016,3578746276,3578746291,15
3,1243,30017,3578746276,3578746291,15
3,1243,30018,3578746276,3578746292,16
3,1243,30019,3578746276,3578746293,17
3,1243,30020,3578746276,3578746294,18
3,1243,30021,3578746276,3578746295,19
3,1243,30022,3578746276,3578746297,21
3,1243,30023,3578746276,3578746297,21
3,1243,30024,3578746276,3578746298,22
3,1243,30025,3578746276,3578746299,23
3,1243,30026,3578746276,3578746300,24
3,1243,30027,3578746276,3578746301,25
3,1243,30028,3578746276,3578746302,26
3,1243,30029,3578746276,3578746303,27
3,1243,30030,3578746276,3578746304,28
3,1243,30031,3578746276,3578746304,28
3,1243,30032,3578746276,3578746307,31
3,1243,30033,3578746276,3578746308,32
3,1243,30034,3578746276,3578746315,39
3,1243,30035,3578746276,3578746316,40
3,1243,30036,3578746276,3578746317,41
3,1243,30037,3578746276,3578746318,42
3,1243,30038,3578746276,3578746319,43
3,1243,30039,3578746276,3578746319,43
3,1243,30040,3578746276,3578746319,43
3,1243,30041,3578746276,3578746319,43
3,1243,30042,3578746276,3578746321,45
3,1243,30043,3578746276,3578746321,45
3,1243,30044,3578746276,3578746321,45
3,1243,30045,3578746276,3578746322,46
3,1243,30046,3578746276,3578746324,48
3,1244,30047,3578746339,3578746339,0
3,1244,30048,3578746339,3578746339,0
3,1244,30049,3578746339,3578746339,0
3,1244,30050,3578746339,3578746339,0
3,1244,30051,3578746339,3578746339,0
3,1244,30052,3578746339,3578746339,0
3,1244,30053,3578746339,3578746339,0
3,1244,30054,3578746339,3578746339,0
3,1244,30055,3578746339,3578746339,0
3,1244,30056,3578746339,3578746339,0
3,1244,30057,3578746339,3578746341,2
3,1244,30058,3578746339,3578746342,3
3,1244,30059,3578746339,3578746343,4
3,1244,30060,3578746339,3578746344,5
3,1244,30061,3578746339,3578746348,9
3,1244,30062,3578746339,3578746349,10
3,1244,30063,3578746339,3578746350,11
3,1244,30064,3578746339,3578746350,11
3,1244,30065,3578746339,3578746352,13
3,1244,30066,3578746339,3578746354,15
3,1244,30067,3578746339,3578746354,15
3,1244,30068,3578746339,3578746355,16
3,1244,30069,3578746339,3578746357,18
3,1244,30070,3578746339,3578746357,18
3,1244,30071,3578746339,3578746357,18
3,1244,30072,3578746339,3578746358,19
3,1244,30073,3578746339,3578746359,20
3,1244,30074,3578746339,3578746360,21
3,1244,30075,3578746339,3578746360,21
3,1244,30076,3578746339,3578746363,24
3,1244,30077,3578746339,3578746364,25
3,1244,30078,3578746339,3578746365,26
3,1244,30079,3578746339,3578746367,28
3,1244,30080,3578746339,3578746367,28
3,1244,30081,3578746339,3578746367,28
3,1244,30082,3578746339,3578746368,29
3,1244,30083,3578746339,3578746369,30
3,1244,30084,3578746339,3578746369,30
3,1244,30085,3578746339,3578746369,30
3,1244,30086,3578746339,3578746370,31
3,1244,30087,3578746339,3578746370,31
3,1244,30088,3578746339,3578746372,33
3,1244,30089,3578746339,3578746372,33
3,1244,30090,3578746339,3578746373,34
3,1244,30091,3578746339,3578746374,35
3,1244,30092,3578746339,3578746375,36
3,1244,30093,3578746339,3578746375,36
3,1244,30094,3578746339,3578746376,37
3,1244,30095,3578746339,3578746379,40
3,1244,30096,3578746339,3578746384,45
3,1244,30097,3578746339,3578746384,45
3,1244,30098,3578746339,3578746386,47
3,1244,30099,3578746339,3578746387,48
3,1244,30100,3578746339,3578746387,48
3,1244,30101,3578746339,3578746388,49
3,1244,30102,3578746339,3578746388,49
3,1244,30103,3578746339,3578746388,49
3,1244,30104,3578746339,3578746388,49
3,1244,30105,3578746339,3578746389,50
3,1245,30106,3578746402,3578746402,0
3,1245,30107,3578746402,3578746402,0
3,1245,30108,3578746402,3578746402,0
3,1245,30109,3578746402,3578746402,0
3,1245,30110,3578746402,3578746402,0
3,1245,30111,3578746402,3578746402,0
3,1245,30112,3578746402,3578746402,0
3,1245,30113,3578746402,3578746402,0
3,1245,30114,3578746402,3578746402,0
3,1245,30115,3578746402,3578746402,0
3,1245,30116,3578746402,3578746402,0
3,1245,30117,3578746402,3578746402,0
3,1245,30118,3578746402,3578746402,0
3,1245,30119,3578746402,3578746402,0
3,1245,30120,3578746402,3578746402,0
3,1245,30121,3578746402,3578746403,1
3,1245,30122,3578746402,3578746405,3
3,1245,30123,3578746402,3578746405,3
3,1245,30124,3578746402,3578746405,3
3,1245,30125,3578746402,3578746405,3
3,1245,30126,3578746402,3578746406,4
3,1245,30127,3578746402,3578746407,5
3,1245,30128,3578746402,3578746408,6
3,1245,30129,3578746402,3578746408,6
3,1245,30130,3578746402,3578746409,7
3,1245,30131,3578746402,3578746409,7
3,1245,30132,3578746402,3578746409,7
3,1245,30133,3578746402,3578746413,11
3,1245,30134,3578746402,3578746414,12
3,1245,30135,3578746402,3578746415,13
3,1245,30136,3578746402,3578746415,13
3,1245,30137,3578746402,3578746417,15
3,1245,30138,3578746402,3578746418,16
3,1245,30139,3578746402,3578746418,16
3,1245,30140,3578746402,3578746420,18
3,1245,30141,3578746402,3578746420,18
3,1245,30142,3578746402,3578746421,19
3,1245,30143,3578746402,3578746421,19
3,1245,30144,3578746402,3578746421,19
3,1245,30145,3578746402,3578746425,23
3,1245,30146,3578746402,3578746425,23
3,1245,30147,3578746402,3578746426,24
3,1245,30148,3578746402,3578746426,24
3,1245,30149,3578746402,3578746426,24
3,1245,30150,3578746402,3578746427,25
3,1245,30151,3578746402,3578746428,26
3,1245,30152,3578746402,3578746428,26
3,1245,30153,3578746402,3578746429,27
3,1245,30154,3578746402,3578746430,28
3,1245,30155,3578746402,3578746432,30
3,1245,30156,3578746402,3578746432,30
3,1245,30157,3578746402,3578746434,32
3,1245,30158,3578746402,3578746434,32
3,1245,30159,3578746402,3578746436,34
3,1245,30160,3578746402,3578746438,36
3,1245,30161,3578746402,3578746438,36
3,1245,30162,3578746402,3578746438,36
3,1245,30163,3578746402,3578746441,39
3,1245,30164,3578746402,3578746441,39
3,1245,30165,3578746402,3578746442,40
3,1245,30166,3578746402,3578746443,41
3,1245,30167,3578746402,3578746443,41
3,1245,30168,3578746402,3578746444,42
3,1245,30169,3578746402,3578746444,42
3,1245,30170,3578746402,3578746444,42
3,1245,30171,3578746402,3578746445,43
3,1245,30172,3578746402,3578746446,44
3,1245,30173,3578746402,3578746448,46
3,1245,30174,3578746402,3578746449,47
3,1245,30175,3578746402,3578746450,48
3,1245,30176,3578746402,3578746452,50
3,1246,30177,3578746464,3578746464,0
3,1246,30178,3578746464,3578746464,0
3,1246,30179,3578746464,3578746464,0
3,1246,30180,3578746464,3578746464,0
3,1246,30181,3578746464,3578746464,0
3,1246,30182,3578746464,3578746464,0
3,1246,30183,3578746464,3578746464,0
3,1246,30184,3578746464,3578746464,0
3,1246,30185,3578746464,3578746464,0
3,1246,30186,3578746464,3578746464,0
3,1246,30187,3578746464,3578746465,1
3,1246,30188,3578746464,3578746469,5
3,1246,30189,3578746464,3578746469,5
3,1246,30190,3578746464,3578746474,10
3,1246,30191,3578746464,3578746475,11
3,1246,30192,3578746464,3578746476,12
3,1246,30193,3578746464,3578746479,15
3,1246,30194,3578746464,3578746480,16
3,1246,30195,3578746464,3578746481,17
3,1246,30196,3578746464,3578746481,17
3,1246,30197,3578746464,3578746481,17
3,1246,30198,3578746464,3578746482,18
3,1246,30199,3578746464,3578746482,18
3,1246,30200,3578746464,3578746484,20
3,1246,30201,3578746464,3578746485,21
3,1246,30202,3578746464,3578746485,21
3,1246,30203,3578746464,3578746487,23
3,1246,30204,3578746464,3578746490,26
3,1246,30205,3578746464,3578746491,27
3,1246,30206,3578746464,3578746491,27
3,1246,30207,3578746464,3578746492,28
3,1246,30208,3578746464,3578746493,29
3,1246,30209,3578746464,3578746494,30
3,1246,30210,3578746464,3578746495,31
3,1246,30211,3578746464,3578746497,33
3,1246,30212,3578746464,3578746497,33
3,1246,30213,3578746464,3578746498,34
3,1246,30214,3578746464,3578746498,34
3,1246,30215,3578746464,3578746499,35
3,1246,30216,3578746464,3578746501,37
3,1246,30217,3578746464,3578746501,37
3,1246,30218,3578746464,3578746502,38
3,1246,30219,3578746464,3578746503,39
3,1246,30220,3578746464,3578746503,39
3,1246,30221,3578746464,3578746504,40
3,1246,30222,3578746464,3578746507,43
3,1246,30223,3578746464,3578746508,44
3,1246,30224,3578746464,3578746510,46
3,1246,30225,3578746464,3578746514,50
3,1247,30226,3578746527,3578746527,0
3,1247,30227,3578746527,3578746527,0
3,1247,30228,3578746527,3578746527,0
3,1247,30229,3578746527,3578746527,0
3,1247,30230,3578746527,3578746527,0
3,1247,30231,3578746527,3578746527,0
3,1247,30232,3578746527,3578746527,0
3,1247,30233,3578746527,3578746527,0
3,1247,30234,3578746527,3578746527,0
3,1247,30235,3578746527,3578746527,0
3,1247,30236,3578746527,3578746529,2
3,1247,30237,3578746527,3578746532,5
3,1247,30238,3578746527,3578746535,8
3,1247,30239,3578746527,3578746535,8
3,1247,30240,3578746527,3578746536,9
3,1247,30241,3578746527,3578746537,10
3,1247,30242,3578746527,3578746537,10
3,1247,30243,3578746527,3578746538,11
3,1247,30244,3578746527,3578746538,11
3,1247,30245,3578746527,3578746539,12
3,1247,30246,3578746527,3578746542,15
3,1247,30247,3578746527,3578746544,17
3,1247,30248,3578746527,3578746547,20
3,1247,30249,3578746527,3578746548,21
3,1247,30250,3578746527,3578746549,22
3,1247,30251,3578746527,3578746549,22
3,1247,30252,3578746527,3578746551,24
3,1247,30253,3578746527,3578746553,26
3,1247,30254,3578746527,3578746554,27
3,1247,30255,3578746527,3578746556,29
3,1247,30256,3578746527,3578746556,29
3,1247,30257,3578746527,3578746556,29
3,1247,30258,3578746527,3578746557,30
3,1247,30259,3578746527,3578746557,30
3,1247,30260,3578746527,3578746557,30
3,1247,30261,3578746527,3578746559,32
3,1247,30262,3578746527,3578746559,32
3,1247,30263,3578746527,3578746562,35
3,1247,30264,3578746527,3578746563,36
3,1247,30265,3578746527,3578746565,38
3,1247,30266,3578746527,3578746565,38
3,1247,30267,3578746527,3578746566,39
3,1247,30268,3578746527,3578746567,40
3,1247,30269,3578746527,3578746568,41
3,1247,30270,3578746527,3578746569,42
3,1247,30271,3578746527,3578746569,42
3,1247,30272,3578746527,3578746570,43
3,1247,30273,3578746527,3578746570,43
3,1247,30274,3578746527,3578746570,43
3,1247,30275,3578746527,3578746572,45
3,1247,30276,3578746527,3578746572,45
3,1247,30277,3578746527,3578746573,46
3,1247,30278,3578746527,3578746574,47
3,1247,30279,3578746527,3578746574,47
3,1247,30280,3578746527,3578746575,48
3,1248,30281,3578746589,3578746589,0
3,1248,30282,3578746589,3578746589,0
3,1248,30283,3578746589,3578746589,0
3,1248,30284,3578746589,3578746589,0
3,1248,30285,3578746589,3578746589,0
3,1248,30286,3578746589,3578746589,0
3,1248,30287,3578746589,3578746589,0
3,1248,30288,3578746589,3578746589,0
3,1248,30289,3578746589,3578746589,0
3,1248,30290,3578746589,3578746589,0
3,1248,30291,3578746589,3578746589,0
3,1248,30292,3578746589,3578746589,0
3,1248,30293,3578746589,3578746589,0
3,1248,30294,3578746589,3578746589,0
3,1248,30295,3578746589,3578746590,1
3,1248,30296,3578746589,3578746590,1
3,1248,30297,3578746589,3578746592,3
3,1248,30298,3578746589,3578746593,4
3,1248,30299,3578746589,3578746593,4
3,1248,30300,3578746589,3578746594,5
3,1248,30301,3578746589,3578746596,7
3,1248,30302,3578746589,3578746596,7
3,1248,30303,3578746589,3578746597,8
3,1248,30304,3578746589,3578746599,10
3,1248,30305,3578746589,3578746601,12
3,1248,30306,3578746589,3578746601,12
3,1248,30307,3578746589,3578746601,12
3,1248,30308,3578746589,3578746602,13
3,1248,30309,3578746589,3578746603,14
3,1248,30310,3578746589,3578746603,14
3,1248,30311,3578746589,3578746604,15
3,1248,30312,3578746589,3578746604,15
3,1248,30313,3578746589,3578746604,15
3,1248,30314,3578746589,3578746605,16
3,1248,30315,3578746589,3578746606,17
3,1248,30316,3578746589,3578746607,18
3,1248,30317,3578746589,3578746607,18
3,1248,30318,3578746589,3578746608,19
3,1248,30319,3578746589,3578746608,19
3,1248,30320,3578746589,3578746608,19
3,1248,30321,3578746589,3578746612,23
3,1248,30322,3578746589,3578746613,24
3,1248,30323,3578746589,3578746615,26
3,1248,30324,3578746589,3578746615,26
3,1248,30325,3578746589,3578746616,27
3,1248,30326,3578746589,3578746617,28
3,1248,30327,3578746589,3578746617,28
3,1248,30328,3578746589,3578746618,29
3,1248,30329,3578746589,3578746619,30
3,1248,30330,3578746589,3578746619,30
3,1248,30331,3578746589,3578746620,31
3,1248,30332,3578746589,3578746621,32
3,1248,30333,3578746589,3578746624,35
3,1248,30334,3578746589,3578746625,36
3,1248,30335,3578746589,3578746625,36
3,1248,30336,3578746589,3578746626,37
3,1248,30337,3578746589,3578746626,37
3,1248,30338,3578746589,3578746626,37
3,1248,30339,3578746589,3578746627,38
3,1248,30340,3578746589,3578746627,38
3,1248,30341,3578746589,3578746628,39
3,1248,30342,3578746589,3578746628,39
3,1248,30343,3578746589,3578746630,41
3,1248,30344,3578746589,3578746631,42
3,1248,30345,3578746589,3578746631,42
3,1248,30346,3578746589,3578746632,43
3,1248,30347,3578746589,3578746633,44
3,1248,30348,3578746589,3578746633,44
3,1248,30349,3578746589,3578746634,45
3,1248,30350,3578746589,3578746635,46
3,1248,30351,3578746589,3578746637,48
3,1248,30352,3578746589,3578746637,48
3,1249,30353,3578746651,3578746651,0
3,1249,30354,3578746651,3578746651,0
3,1249,30355,3578746651,3578746651,0
3,1249,30356,3578746651,3578746651,0
3,1249,30357,3578746651,3578746651,0
3,1249,30358,3578746651,3578746651,0
3,1249,30359,3578746651,3578746651,0
3,1249,30360,3578746651,3578746651,0
3,1249,30361,3578746651,3578746651,0
3,1249,30362,3578746651,3578746651,0
3,1249,30363,3578746651,3578746651,0
3,1249,30364,3578746651,3578746651,0
3,1249,30365,3578746651,3578746651,0
3,1249,30366,3578746651,3578746654,3
3,1249,30367,3578746651,3578746655,4
3,1249,30368,3578746651,3578746656,5
3,1249,30369,3578746651,3578746657,6
3,1249,30370,3578746651,3578746658,7
3,1249,30371,3578746651,3578746660,9
3,1249,30372,3578746651,3578746660,9
3,1249,30373,3578746651,3578746662,11
3,1249,30374,3578746651,3578746663,12
3,1249,30375,3578746651,3578746664,13
3,1249,30376,3578746651,3578746665,14
3,1249,30377,3578746651,3578746668,17
3,1249,30378,3578746651,3578746669,18
3,1249,30379,3578746651,3578746673,22
3,1249,30380,3578746651,3578746675,24
3,1249,30381,3578746651,3578746677,26
3,1249,30382,3578746651,3578746679,28
3,1249,30383,3578746651,3578746680,29
3,1249,30384,3578746651,3578746681,30
3,1249,30385,3578746651,3578746681,30
3,1249,30386,3578746651,3578746681,30
3,1249,30387,3578746651,3578746682,31
3,1249,30388,3578746651,3578746683,32
3,1249,30389,3578746651,3578746685,34
3,1249,30390,3578746651,3578746685,34
3,1249,30391,3578746651,3578746686,35
3,1249,30392,3578746651,3578746688,37
3,1249,30393,3578746651,3578746689,38
3,1249,30394,3578746651,3578746690,39
3,1249,30395,3578746651,3578746691,40
3,1249,30396,3578746651,3578746691,40
3,1249,30397,3578746651,3578746692,41
3,1249,30398,3578746651,3578746693,42
3,1249,30399,3578746651,3578746695,44
3,1249,30400,3578746651,3578746695,44
3,1249,30401,3578746651,3578746696,45
3,1249,30402,3578746651,3578746697,46
3,1249,30403,3578746651,3578746698,47
3,1249,30404,3578746651,3578746698,47
3,1249,30405,3578746651,3578746700,49
3,1249,30406,3578746651,3578746700,49
3,1249,30407,3578746651,3578746701,50
3,1250,30408,3578746714,3578746714,0
3,1250,30409,3578746714,3578746714,0
3,1250,30410,3578746714,3578746714,0
3,1250,30411,3578746714,3578746714,0
3,1250,30412,3578746714,3578746714,0
3,1250,30413,3578746714,3578746714,0
3,1250,30414,3578746714,3578746714,0
3,1250,30415,3578746714,3578746715,1
3,1250,30416,3578746714,3578746716,2
3,1250,30417,3578746714,3578746717,3
3,1250,30418,3578746714,3578746717,3
3,1250,30419,3578746714,3578746718,4
3,1250,30420,3578746714,3578746718,4
3,1250,30421,3578746714,3578746719,5
3,1250,30422,3578746714,3578746720,6
3,1250,30423,3578746714,3578746720,6
3,1250,30424,3578746714,3578746721,7
3,1250,30425,3578746714,3578746721,7
3,1250,30426,3578746714,3578746722,8
3,1250,30427,3578746714,3578746723,9
3,1250,30428,3578746714,3578746727,13
3,1250,30429,3578746714,3578746728,14
3,1250,30430,3578746714,3578746731,17
3,1250,30431,3578746714,3578746735,21
3,1250,30432,3578746714,3578746735,21
3,1250,30433,3578746714,3578746737,23
3,1250,30434,3578746714,3578746737,23
3,1250,30435,3578746714,3578746737,23
3,1250,30436,3578746714,3578746738,24
3,1250,30437,3578746714,3578746738,24
3,1250,30438,3578746714,3578746739,25
3,1250,30439,3578746714,3578746740,26
3,1250,30440,3578746714,3578746741,27
3,1250,30441,3578746714,3578746742,28
3,1250,30442,3578746714,3578746744,30
3,1250,30443,3578746714,3578746747,33
3,1250,30444,3578746714,3578746748,34
3,1250,30445,3578746714,3578746748,34
3,1250,30446,3578746714,3578746749,35
3,1250,30447,3578746714,3578746750,36
3,1250,30448,3578746714,3578746751,37
3,1250,30449,3578746714,3578746753,39
3,1250,30450,3578746714,3578746754,40
3,1250,30451,3578746714,3578746756,42
3,1250,30452,3578746714,3578746756,42
3,1250,30453,3578746714,3578746757,43
3,1250,30454,3578746714,3578746757,43
3,1250,30455,3578746714,3578746759,45
3,1250,30456,3578746714,3578746760,46
3,1250,30457,3578746714,3578746762,48
3,1251,30458,3578746776,3578746776,0
3,1251,30459,3578746776,3578746776,0
3,1251,30460,3578746776,3578746776,0
3,1251,30461,3578746776,3578746776,0
3,1251,30462,3578746776,3578746776,0
3,1251,30463,3578746776,3578746776,0
3,1251,30464,3578746776,3578746776,0
3,1251,30465,3578746776,3578746776,0
3,1251,30466,3578746776,3578746776,0
3,1251,30467,3578746776,3578746776,0
3,1251,30468,3578746776,3578746776,0
3,1251,30469,3578746776,3578746776,0
3,1251,30470,3578746776,3578746776,0
3,1251,30471,3578746776,3578746776,0
3,1251,30472,3578746776,3578746776,0
3,1251,30473,3578746776,3578746782,6
3,1251,30474,3578746776,3578746783,7
3,1251,30475,3578746776,3578746785,9
3,1251,30476,3578746776,3578746785,9
3,1251,30477,3578746776,3578746786,10
3,1251,30478,3578746776,3578746787,11
3,1251,30479,3578746776,3578746787,11
3,1251,30480,3578746776,3578746787,11
3,1251,30481,3578746776,3578746787,11
3,1251,30482,3578746776,3578746787,11
3,1251,30483,3578746776,3578746787,11
3,1251,30484,3578746776,3578746788,12
3,1251,30485,3578746776,3578746788,12
3,1251,30486,3578746776,3578746788,12
3,1251,30487,3578746776,3578746790,14
3,1251,30488,3578746776,3578746791,15
3,1251,30489,3578746776,3578746792,16
3,1251,30490,3578746776,3578746792,16
3,1251,30491,3578746776,3578746793,17
3,1251,30492,3578746776,3578746794,18
3,1251,30493,3578746776,3578746795,19
3,1251,30494,3578746776,3578746796,20
3,1251,30495,3578746776,3578746797,21
3,1251,30496,3578746776,3578746799,23
3,1251,30497,3578746776,3578746801,25
3,1251,30498,3578746776,3578746801,25
3,1251,30499,3578746776,3578746802,26
3,1251,30500,3578746776,3578746803,27
3,1251,30501,3578746776,3578746804,28
3,1251,30502,3578746776,3578746804,28
3,1251,30503,3578746776,3578746804,28
3,1251,30504,3578746776,3578746804,28
3,1251,30505,3578746776,3578746805,29
3,1251,30506,3578746776,3578746805,29
3,1251,30507,3578746776,3578746807,31
3,1251,30508,3578746776,3578746807,31
3,1251,30509,3578746776,3578746808,32
3,1251,30510,3578746776,3578746808,32
3,1251,30511,3578746776,3578746808,32
3,1251,30512,3578746776,3578746812,36
3,1251,30513,3578746776,3578746813,37
3,1251,30514,3578746776,3578746815,39
3,1251,30515,3578746776,3578746815,39
3,1251,30516,3578746776,3578746815,39
3,1251,30517,3578746776,3578746817,41
3,1251,30518,3578746776,3578746818,42
3,1251,30519,3578746776,3578746818,42
3,1251,30520,3578746776,3578746819,43
3,1251,30521,3578746776,3578746820,44
3,1251,30522,3578746776,3578746820,44
3,1251,30523,3578746776,3578746822,46
3,1251,30524,3578746776,3578746823,47
3,1251,30525,3578746776,3578746825,49
3,1251,30526,3578746776,3578746825,49
3,1251,30527,3578746776,3578746826,50
3,1251,30528,3578746776,3578746826,50
3,1252,30529,3578746838,3578746838,0
3,1252,30530,3578746838,3578746838,0
3,1252,30531,3578746838,3578746838,0
3,1252,30532,3578746838,3578746838,0
3,1252,30533,3578746838,3578746838,0
3,1252,30534,3578746838,3578746838,0
3,1252,30535,3578746838,3578746838,0
3,1252,30536,3578746838,3578746838,0
3,1252,30537,3578746838,3578746838,0
3,1252,30538,3578746838,3578746838,0
3,1252,30539,3578746838,3578746838,0
3,1252,30540,3578746838,3578746838,0
3,1252,30541,3578746838,3578746838,0
3,1252,30542,3578746838,3578746838,0
3,1252,30543,3578746838,3578746838,0
3,1252,30544,3578746838,3578746840,2
3,1252,30545,3578746838,3578746840,2
3,1252,30546,3578746838,3578746842,4
3,1252,30547,3578746838,3578746842,4
3,1252,30548,3578746838,3578746843,5
3,1252,30549,3578746838,3578746843,5
3,1252,30550,3578746838,3578746843,5
3,1252,30551,3578746838,3578746844,6
3,1252,30552,3578746838,3578746844,6
3,1252,30553,3578746838,3578746846,8
3,1252,30554,3578746838,3578746847,9
3,1252,30555,3578746838,3578746848,10
3,1252,30556,3578746838,3578746850,12
3,1252,30557,3578746838,3578746851,13
3,1252,30558,3578746838,3578746854,16
3,1252,30559,3578746838,3578746854,16
3,1252,30560,3578746838,3578746855,17
3,1252,30561,3578746838,3578746856,18
3,1252,30562,3578746838,3578746858,20
3,1252,30563,3578746838,3578746858,20
3,1252,30564,3578746838,3578746861,23
3,1252,30565,3578746838,3578746862,24
3,1252,30566,3578746838,3578746862,24
3,1252,30567,3578746838,3578746863,25
3,1252,30568,3578746838,3578746863,25
3,1252,30569,3578746838,3578746864,26
3,1252,30570,3578746838,3578746868,30
3,1252,30571,3578746838,3578746868,30
3,1252,30572,3578746838,3578746873,35
3,1252,30573,3578746838,3578746876,38
3,1252,30574,3578746838,3578746876,38
3,1252,30575,3578746838,3578746879,41
3,1252,30576,3578746838,3578746880,42
3,1252,30577,3578746838,3578746881,43
3,1252,30578,3578746838,3578746881,43
3,1252,30579,3578746838,3578746881,43
3,1252,30580,3578746838,3578746882,44
3,1252,30581,3578746838,3578746882,44
3,1252,30582,3578746838,3578746885,47
3,1252,30583,3578746838,3578746886,48
3,1252,30584,3578746838,3578746887,49
3,1253,30585,3578746899,3578746899,0
3,1253,30586,3578746899,3578746899,0
3,1253,30587,3578746899,3578746899,0
3,1253,30588,3578746899,3578746899,0
3,1253,30589,3578746899,3578746899,0
3,1253,30590,3578746899,3578746899,0
3,1253,30591,3578746899,3578746899,0
3,1253,30592,3578746899,3578746899,0
3,1253,30593,3578746899,3578746899,0
3,1253,30594,3578746899,3578746899,0
3,1253,30595,3578746899,3578746899,0
3,1253,30596,3578746899,3578746899,0
3,1253,30597,3578746899,3578746901,2
3,1253,30598,3578746899,3578746901,2
3,1253,30599,3578746899,3578746902,3
3,1253,30600,3578746899,3578746902,3
3,1253,30601,3578746899,3578746903,4
3,1253,30602,3578746899,3578746904,5
3,1253,30603,3578746899,3578746904,5
3,1253,30604,3578746899,3578746904,5
3,1253,30605,3578746899,3578746907,8
3,1253,30606,3578746899,3578746908,9
3,1253,30607,3578746899,3578746915,16
3,1253,30608,3578746899,3578746916,17
3,1253,30609,3578746899,3578746917,18
3,1253,30610,3578746899,3578746918,19
3,1253,30611,3578746899,3578746918,19
3,1253,30612,3578746899,3578746920,21
3,1253,30613,3578746899,3578746920,21
3,1253,30614,3578746899,3578746920,21
3,1253,30615,3578746899,3578746921,22
3,1253,30616,3578746899,3578746922,23
3,1253,30617,3578746899,3578746922,23
3,1253,30618,3578746899,3578746922,23
3,1253,30619,3578746899,3578746927,28
3,1253,30620,3578746899,3578746928,29
3,1253,30621,3578746899,3578746932,33
3,1253,30622,3578746899,3578746935,36
3,1253,30623,3578746899,3578746937,38
3,1253,30624,3578746899,3578746937,38
3,1253,30625,3578746899,3578746937,38
3,1253,30626,3578746899,3578746938,39
3,1253,30627,3578746899,3578746939,40
3,1253,30628,3578746899,3578746940,41
3,1253,30629,3578746899,3578746942,43
3,1253,30630,3578746899,3578746944,45
3,1253,30631,3578746899,3578746947,48
3,1253,30632,3578746899,3578746948,49
3,1253,30633,3578746899,3578746948,49
3,1253,30634,3578746899,3578746949,50
3,1254,30635,3578746961,3578746961,0
3,1254,30636,3578746961,3578746961,0
3,1254,30637,3578746961,3578746961,0
3,1254,30638,3578746961,3578746961,0
3,1254,30639,3578746961,3578746961,0
3,1254,30640,3578746961,3578746961,0
3,1254,30641,3578746961,3578746961,0
3,1254,30642,3578746961,3578746961,0
3,1254,30643,3578746961,3578746961,0
3,1254,30644,3578746961,3578746961,0
3,1254,30645,3578746961,3578746961,0
3,1254,30646,3578746961,3578746963,2
3,1254,30647,3578746961,3578746964,3
3,1254,30648,3578746961,3578746965,4
3,1254,30649,3578746961,3578746965,4
3,1254,30650,3578746961,3578746966,5
3,1254,30651,3578746961,3578746968,7
3,1254,30652,3578746961,3578746969,8
3,1254,30653,3578746961,3578746969,8
3,1254,30654,3578746961,3578746969,8
3,1254,30655,3578746961,3578746970,9
3,1254,30656,3578746961,3578746971,10
3,1254,30657,3578746961,3578746971,10
3,1254,30658,3578746961,3578746973,12
3,1254,30659,3578746961,3578746974,13
3,1254,30660,3578746961,3578746974,13
3,1254,30661,3578746961,3578746975,14
3,1254,30662,3578746961,3578746979,18
3,1254,30663,3578746961,3578746983,22
3,1254,30664,3578746961,3578746984,23
3,1254,30665,3578746961,3578746985,24
3,1254,30666,3578746961,3578746986,25
3,1254,30667,3578746961,3578746987,26
3,1254,30668,3578746961,3578746987,26
3,1254,30669,3578746961,3578746987,26
3,1254,30670,3578746961,3578746987,26
3,1254,30671,3578746961,3578746987,26
3,1254,30672,3578746961,3578746988,27
3,1254,30673,3578746961,3578746988,27
3,1254,30674,3578746961,3578746988,27
3,1254,30675,3578746961,3578746988,27
3,1254,30676,3578746961,3578746990,29
3,1254,30677,3578746961,3578746990,29
3,1254,30678,3578746961,3578746993,32
3,1254,30679,3578746961,3578746993,32
3,1254,30680,3578746961,3578746994,33
3,1254,30681,3578746961,3578746996,35
3,1254,30682,3578746961,3578746997,36
3,1254,30683,3578746961,3578746997,36
3,1254,30684,3578746961,3578746999,38
3,1254,30685,3578746961,3578747001,40
3,1254,30686,3578746961,3578747002,41
3,1254,30687,3578746961,3578747002,41
3,1254,30688,3578746961,3578747003,42
3,1254,30689,3578746961,3578747004,43
3,1254,30690,3578746961,3578747004,43
3,1254,30691,3578746961,3578747004,43
3,1254,30692,3578746961,3578747004,43
3,1254,30693,3578746961,3578747005,44
3,1254,30694,3578746961,3578747007,46
3,1254,30695,3578746961,3578747008,47
3,1254,30696,3578746961,3578747008,47
3,1254,30697,3578746961,3578747009,48
3,1254,30698,3578746961,3578747009,48
3,1255,30699,3578747024,3578747024,0
3,1255,30700,3578747024,3578747024,0
3,1255,30701,3578747024,3578747024,0
3,1255,30702,3578747024,3578747024,0
3,1255,30703,3578747024,3578747024,0
3,1255,30704,3578747024,3578747024,0
3,1255,30705,3578747024,3578747024,0
3,1255,30706,3578747024,3578747024,0
3,1255,30707,3578747024,3578747024,0
3,1255,30708,3578747024,3578747024,0
3,1255,30709,3578747024,3578747024,0
3,1255,30710,3578747024,3578747024,0
3,1255,30711,3578747024,3578747025,1
3,1255,30712,3578747024,3578747025,1
3,1255,30713,3578747024,3578747026,2
3,1255,30714,3578747024,3578747026,2
3,1255,30715,3578747024,3578747026,2
3,1255,30716,3578747024,3578747027,3
3,1255,30717,3578747024,3578747027,3
3,1255,30718,3578747024,3578747028,4
3,1255,30719,3578747024,3578747029,5
3,1255,30720,3578747024,3578747031,7
3,1255,30721,3578747024,3578747031,7
3,1255,30722,3578747024,3578747032,8
3,1255,30723,3578747024,3578747032,8
3,1255,30724,3578747024,3578747033,9
3,1255,30725,3578747024,3578747033,9
3,1255,30726,3578747024,3578747034,10
3,1255,30727,3578747024,3578747036,12
3,1255,30728,3578747024,3578747038,14
3,1255,30729,3578747024,3578747039,15
3,1255,30730,3578747024,3578747040,16
3,1255,30731,3578747024,3578747041,17
3,1255,30732,3578747024,3578747042,18
3,1255,30733,3578747024,3578747042,18
3,1255,30734,3578747024,3578747043,19
3,1255,30735,3578747024,3578747044,20
3,1255,30736,3578747024,3578747044,20
3,1255,30737,3578747024,3578747044,20
3,1255,30738,3578747024,3578747045,21
3,1255,30739,3578747024,3578747046,22
3,1255,30740,3578747024,3578747047,23
3,1255,30741,3578747024,3578747048,24
3,1255,30742,3578747024,3578747049,25
3,1255,30743,3578747024,3578747050,26
3,1255,30744,3578747024,3578747053,29
3,1255,30745,3578747024,3578747054,30
3,1255,30746,3578747024,3578747055,31
3,1255,30747,3578747024,3578747056,32
3,1255,30748,3578747024,3578747058,34
3,1255,30749,3578747024,3578747058,34
3,1255,30750,3578747024,3578747061,37
3,1255,30751,3578747024,3578747062,38
3,1255,30752,3578747024,3578747062,38
3,1255,30753,3578747024,3578747064,40
3,1255,30754,3578747024,3578747064,40
3,1255,30755,3578747024,3578747064,40
3,1255,30756,3578747024,3578747068,44
3,1255,30757,3578747024,3578747069,45
3,1255,30758,3578747024,3578747073,49
3,1256,30759,3578747086,3578747086,0
3,1256,30760,3578747086,3578747086,0
3,1256,30761,3578747086,3578747086,0
3,1256,30762,3578747086,3578747086,0
3,1256,30763,3578747086,3578747086,0
3,1256,30764,3578747086,3578747086,0
3,1256,30765,3578747086,3578747086,0
3,1256,30766,3578747086,3578747086,0
3,1256,30767,3578747086,3578747086,0
3,1256,30768,3578747086,3578747086,0
3,1256,30769,3578747086,3578747086,0
3,1256,30770,3578747086,3578747087,1
3,1256,30771,3578747086,3578747089,3
3,1256,30772,3578747086,3578747090,4
3,1256,30773,3578747086,3578747091,5
3,1256,30774,3578747086,3578747092,6
3,1256,30775,3578747086,3578747094,8
3,1256,30776,3578747086,3578747095,9
3,1256,30777,3578747086,3578747095,9
3,1256,30778,3578747086,3578747097,11
3,1256,30779,3578747086,3578747097,11
3,1256,30780,3578747086,3578747097,11
3,1256,30781,3578747086,3578747098,12
3,1256,30782,3578747086,3578747100,14
3,1256,30783,3578747086,3578747101,15
3,1256,30784,3578747086,3578747101,15
3,1256,30785,3578747086,3578747102,16
3,1256,30786,3578747086,3578747102,16
3,1256,30787,3578747086,3578747103,17
3,1256,30788,3578747086,3578747104,18
3,1256,30789,3578747086,3578747105,19
3,1256,30790,3578747086,3578747107,21
3,1256,30791,3578747086,3578747109,23
3,1256,30792,3578747086,3578747117,31
3,1256,30793,3578747086,3578747117,31
3,1256,30794,3578747086,3578747117,31
3,1256,30795,3578747086,3578747118,32
3,1256,30796,3578747086,3578747118,32
3,1256,30797,3578747086,3578747120,34
3,1256,30798,3578747086,3578747120,34
3,1256,30799,3578747086,3578747121,35
3,1256,30800,3578747086,3578747121,35
3,1256,30801,3578747086,3578747122,36
3,1256,30802,3578747086,3578747123,37
3,1256,30803,3578747086,3578747127,41
3,1256,30804,3578747086,3578747128,42
3,1256,30805,3578747086,3578747132,46
3,1256,30806,3578747086,3578747135,49
3,1257,30807,3578747148,3578747148,0
3,1257,30808,3578747148,3578747148,0
3,1257,30809,3578747148,3578747148,0
3,1257,30810,3578747148,3578747148,0
3,1257,30811,3578747148,3578747148,0
3,1257,30812,3578747148,3578747148,0
3,1257,30813,3578747148,3578747148,0
3,1257,30814,3578747148,3578747148,0
3,1257,30815,3578747148,3578747148,0
3,1257,30816,3578747148,3578747148,0
3,1257,30817,3578747148,3578747148,0
3,1257,30818,3578747148,3578747148,0
3,1257,30819,3578747148,3578747148,0
3,1257,30820,3578747148,3578747150,2
3,1257,30821,3578747148,3578747152,4
3,1257,30822,3578747148,3578747152,4
3,1257,30823,3578747148,3578747153,5
3,1257,30824,3578747148,3578747154,6
3,1257,30825,3578747148,3578747156,8
3,1257,30826,3578747148,3578747156,8
3,1257,30827,3578747148,3578747157,9
3,1257,30828,3578747148,3578747157,9
3,1257,30829,3578747148,3578747158,10
3,1257,30830,3578747148,3578747160,12
3,1257,30831,3578747148,3578747160,12
3,1257,30832,3578747148,3578747164,16
3,1257,30833,3578747148,3578747164,16
3,1257,30834,3578747148,3578747165,17
3,1257,30835,3578747148,3578747166,18
3,1257,30836,3578747148,3578747166,18
3,1257,30837,3578747148,3578747167,19
3,1257,30838,3578747148,3578747168,20
3,1257,30839,3578747148,3578747169,21
3,1257,30840,3578747148,3578747169,21
3,1257,30841,3578747148,3578747169,21
3,1257,30842,3578747148,3578747170,22
3,1257,30843,3578747148,3578747171,23
3,1257,30844,3578747148,3578747172,24
3,1257,30845,3578747148,3578747173,25
3,1257,30846,3578747148,3578747174,26
3,1257,30847,3578747148,3578747174,26
3,1257,30848,3578747148,3578747177,29
3,1257,30849,3578747148,3578747179,31
3,1257,30850,3578747148,3578747184,36
3,1257,30851,3578747148,3578747184,36
3,1257,30852,3578747148,3578747186,38
3,1257,30853,3578747148,3578747187,39
3,1257,30854,3578747148,3578747187,39
3,1257,30855,3578747148,3578747187,39
3,1257,30856,3578747148,3578747188,40
3,1257,30857,3578747148,3578747188,40
3,1257,30858,3578747148,3578747188,40
3,1257,30859,3578747148,3578747189,41
3,1257,30860,3578747148,3578747189,41
3,1257,30861,3578747148,3578747189,41
3,1257,30862,3578747148,3578747191,43
3,1257,30863,3578747148,3578747191,43
3,1257,30864,3578747148,3578747191,43
3,1257,30865,3578747148,3578747192,44
3,1257,30866,3578747148,3578747193,45
3,1257,30867,3578747148,3578747194,46
3,1257,30868,3578747148,3578747197,49
3,1257,30869,3578747148,3578747197,49
3,1258,30870,3578747210,3578747210,0
3,1258,30871,3578747210,3578747210,0
3,1258,30872,3578747210,3578747210,0
3,1258,30873,3578747210,3578747210,0
3,1258,30874,3578747210,3578747210,0
3,1258,30875,3578747210,3578747210,0
3,1258,30876,3578747210,3578747210,0
3,1258,30877,3578747210,3578747210,0
3,1258,30878,3578747210,3578747210,0
3,1258,30879,3578747210,3578747210,0
3,1258,30880,3578747210,3578747210,0
3,1258,30881,3578747210,3578747210,0
3,1258,30882,3578747210,3578747210,0
3,1258,30883,3578747210,3578747213,3
3,1258,30884,3578747210,3578747214,4
3,1258,30885,3578747210,3578747215,5
3,1258,30886,3578747210,3578747215,5
3,1258,30887,3578747210,3578747216,6
3,1258,30888,3578747210,3578747217,7
3,1258,30889,3578747210,3578747219,9
3,1258,30890,3578747210,3578747219,9
3,1258,30891,3578747210,3578747219,9
3,1258,30892,3578747210,3578747220,10
3,1258,30893,3578747210,3578747225,15
3,1258,30894,3578747210,3578747226,16
3,1258,30895,3578747210,3578747226,16
3,1258,30896,3578747210,3578747227,17
3,1258,30897,3578747210,3578747227,17
3,1258,30898,3578747210,3578747227,17
3,1258,30899,3578747210,3578747227,17
3,1258,30900,3578747210,3578747229,19
3,1258,30901,3578747210,3578747231,21
3,1258,30902,3578747210,3578747231,21
3,1258,30903,3578747210,3578747232,22
3,1258,30904,3578747210,3578747232,22
3,1258,30905,3578747210,3578747233,23
3,1258,30906,3578747210,3578747233,23
3,1258,30907,3578747210,3578747235,25
3,1258,30908,3578747210,3578747236,26
3,1258,30909,3578747210,3578747238,28
3,1258,30910,3578747210,3578747238,28
3,1258,30911,3578747210,3578747239,29
3,1258,30912,3578747210,3578747241,31
3,1258,30913,3578747210,3578747241,31
3,1258,30914,3578747210,3578747242,32
3,1258,30915,3578747210,3578747242,32
3,1258,30916,3578747210,3578747243,33
3,1258,30917,3578747210,3578747244,34
3,1258,30918,3578747210,3578747244,34
3,1258,30919,3578747210,3578747244,34
3,1258,30920,3578747210,3578747244,34
3,1258,30921,3578747210,3578747250,40
3,1258,30922,3578747210,3578747253,43
3,1258,30923,3578747210,3578747254,44
3,1258,30924,3578747210,3578747256,46
3,1258,30925,3578747210,3578747256,46
3,1258,30926,3578747210,3578747258,48
3,1258,30927,3578747210,3578747258,48
3,1259,30928,3578747272,3578747272,0
3,1259,30929,3578747272,3578747272,0
3,1259,30930,3578747272,3578747272,0
3,1259,30931,3578747272,3578747272,0
3,1259,30932,3578747272,3578747272,0
3,1259,30933,3578747272,3578747272,0
3,1259,30934,3578747272,3578747272,0
3,1259,30935,3578747272,3578747275,3
3,1259,30936,3578747272,3578747276,4
3,1259,30937,3578747272,3578747279,7
3,1259,30938,3578747272,3578747281,9
3,1259,30939,3578747272,3578747281,9
3,1259,30940,3578747272,3578747281,9
3,1259,30941,3578747272,3578747282,10
3,1259,30942,3578747272,3578747282,10
3,1259,30943,3578747272,3578747283,11
3,1259,30944,3578747272,3578747285,13
3,1259,30945,3578747272,3578747286,14
3,1259,30946,3578747272,3578747286,14
3,1259,30947,3578747272,3578747287,15
3,1259,30948,3578747272,3578747290,18
3,1259,30949,3578747272,3578747290,18
3,1259,30950,3578747272,3578747291,19
3,1259,30951,3578747272,3578747291,19
3,1259,30952,3578747272,3578747292,20
3,1259,30953,3578747272,3578747294,22
3,1259,30954,3578747272,3578747295,23
3,1259,30955,3578747272,3578747295,23
3,1259,30956,3578747272,3578747297,25
3,1259,30957,3578747272,3578747298,26
3,1259,30958,3578747272,3578747298,26
3,1259,30959,3578747272,3578747298,26
3,1259,30960,3578747272,3578747300,28
3,1259,30961,3578747272,3578747301,29
3,1259,30962,3578747272,3578747301,29
3,1259,30963,3578747272,3578747302,30
3,1259,30964,3578747272,3578747303,31
3,1259,30965,3578747272,3578747304,32
3,1259,30966,3578747272,3578747304,32
3,1259,30967,3578747272,3578747304,32
3,1259,30968,3578747272,3578747308,36
3,1259,30969,3578747272,3578747309,37
3,1259,30970,3578747272,3578747310,38
3,1259,30971,3578747272,3578747316,44
3,1259,30972,3578747272,3578747317,45
3,1259,30973,3578747272,3578747318,46
3,1259,30974,3578747272,3578747318,46
3,1259,30975,3578747272,3578747318,46
3,1259,30976,3578747272,3578747319,47
3,1259,30977,3578747272,3578747320,48
3,1259,30978,3578747272,3578747320,48
3,1259,30979,3578747272,3578747320,48
3,1259,30980,3578747272,3578747321,49
3,1260,30981,3578747334,3578747334,0
3,1260,30982,3578747334,3578747334,0
3,1260,30983,3578747334,3578747334,0
3,1260,30984,3578747334,3578747334,0
3,1260,30985,3578747334,3578747336,2
3,1260,30986,3578747334,3578747337,3
3,1260,30987,3578747334,3578747337,3
3,1260,30988,3578747334,3578747337,3
3,1260,30989,3578747334,3578747339,5
3,1260,30990,3578747334,3578747339,5
3,1260,30991,3578747334,3578747340,6
3,1260,30992,3578747334,3578747341,7
3,1260,30993,3578747334,3578747341,7
3,1260,30994,3578747334,3578747341,7
3,1260,30995,3578747334,3578747343,9
3,1260,30996,3578747334,3578747344,10
3,1260,30997,3578747334,3578747346,12
3,1260,30998,3578747334,3578747348,14
3,1260,30999,3578747334,3578747348,14
3,1260,31000,3578747334,3578747350,16
3,1260,31001,3578747334,3578747351,17
3,1260,31002,3578747334,3578747352,18
3,1260,31003,3578747334,3578747352,18
3,1260,31004,3578747334,3578747354,20
3,1260,31005,3578747334,3578747354,20
3,1260,31006,3578747334,3578747356,22
3,1260,31007,3578747334,3578747357,23
3,1260,31008,3578747334,3578747357,23
3,1260,31009,3578747334,3578747357,23
3,1260,31010,3578747334,3578747358,24
3,1260,31011,3578747334,3578747359,25
3,1260,31012,3578747334,3578747359,25
3,1260,31013,3578747334,3578747363,29
3,1260,31014,3578747334,3578747365,31
3,1260,31015,3578747334,3578747365,31
3,1260,31016,3578747334,3578747366,32
3,1260,31017,3578747334,3578747367,33
3,1260,31018,3578747334,3578747368,34
3,1260,31019,3578747334,3578747369,35
3,1260,31020,3578747334,3578747369,35
3,1260,31021,3578747334,3578747370,36
3,1260,31022,3578747334,3578747370,36
3,1260,31023,3578747334,3578747371,37
3,1260,31024,3578747334,3578747372,38
3,1260,31025,3578747334,3578747373,39
3,1260,31026,3578747334,3578747374,40
3,1260,31027,3578747334,3578747374,40
3,1260,31028,3578747334,3578747374,40
3,1260,31029,3578747334,3578747376,42
3,1260,31030,3578747334,3578747380,46
3,1261,31031,3578747396,3578747396,0
3,1261,31032,3578747396,3578747396,0
3,1261,31033,3578747396,3578747396,0
3,1261,31034,3578747396,3578747396,0
3,1261,31035,3578747396,3578747396,0
3,1261,31036,3578747396,3578747396,0
3,1261,31037,3578747396,3578747396,0
3,1261,31038,3578747396,3578747396,0
3,1261,31039,3578747396,3578747396,0
3,1261,31040,3578747396,3578747396,0
3,1261,31041,3578747396,3578747396,0
3,1261,31042,3578747396,3578747396,0
3,1261,31043,3578747396,3578747396,0
3,1261,31044,3578747396,3578747396,0
3,1261,31045,3578747396,3578747396,0
3,1261,31046,3578747396,3578747396,0
3,1261,31047,3578747396,3578747396,0
3,1261,31048,3578747396,3578747396,0
3,1261,31049,3578747396,3578747396,0
3,1261,31050,3578747396,3578747397,1
3,1261,31051,3578747396,3578747397,1
3,1261,31052,3578747396,3578747400,4
3,1261,31053,3578747396,3578747401,5
3,1261,31054,3578747396,3578747402,6
3,1261,31055,3578747396,3578747402,6
3,1261,31056,3578747396,3578747402,6
3,1261,31057,3578747396,3578747404,8
3,1261,31058,3578747396,3578747404,8
3,1261,31059,3578747396,3578747404,8
3,1261,31060,3578747396,3578747405,9
3,1261,31061,3578747396,3578747406,10
3,1261,31062,3578747396,3578747406,10
3,1261,31063,3578747396,3578747407,11
3,1261,31064,3578747396,3578747407,11
3,1261,31065,3578747396,3578747408,12
3,1261,31066,3578747396,3578747408,12
3,1261,31067,3578747396,3578747408,12
3,1261,31068,3578747396,3578747409,13
3,1261,31069,3578747396,3578747413,17
3,1261,31070,3578747396,3578747415,19
3,1261,31071,3578747396,3578747415,19
3,1261,31072,3578747396,3578747415,19
3,1261,31073,3578747396,3578747416,20
3,1261,31074,3578747396,3578747417,21
3,1261,31075,3578747396,3578747419,23
3,1261,31076,3578747396,3578747419,23
3,1261,31077,3578747396,3578747419,23
3,1261,31078,3578747396,3578747421,25
3,1261,31079,3578747396,3578747424,28
3,1261,31080,3578747396,3578747426,30
3,1261,31081,3578747396,3578747426,30
3,1261,31082,3578747396,3578747427,31
3,1261,31083,3578747396,3578747427,31
3,1261,31084,3578747396,3578747427,31
3,1261,31085,3578747396,3578747427,31
3,1261,31086,3578747396,3578747428,32
3,1261,31087,3578747396,3578747429,33
3,1261,31088,3578747396,3578747431,35
3,1261,31089,3578747396,3578747432,36
3,1261,31090,3578747396,3578747432,36
3,1261,31091,3578747396,3578747433,37
3,1261,31092,3578747396,3578747433,37
3,1261,31093,3578747396,3578747435,39
3,1261,31094,3578747396,3578747437,41
3,1261,31095,3578747396,3578747437,41
3,1261,31096,3578747396,3578747438,42
3,1261,31097,3578747396,3578747439,43
3,1261,31098,3578747396,3578747440,44
3,1261,31099,3578747396,3578747441,45
3,1261,31100,3578747396,3578747442,46
3,1261,31101,3578747396,3578747443,47
3,1261,31102,3578747396,3578747443,47
3,1261,31103,3578747396,3578747444,48
3,1261,31104,3578747396,3578747445,49
3,1261,31105,3578747396,3578747445,49
3,1262,31106,3578747459,3578747459,0
3,1262,31107,3578747459,3578747459,0
3,1262,31108,3578747459,3578747459,0
3,1262,31109,3578747459,3578747459,0
3,1262,31110,3578747459,3578747459,0
3,1262,31111,3578747459,3578747459,0
3,1262,31112,3578747459,3578747459,0
3,1262,31113,3578747459,3578747459,0
3,1262,31114,3578747459,3578747459,0
3,1262,31115,3578747459,3578747459,0
3,1262,31116,3578747459,3578747461,2
3,1262,31117,3578747459,3578747462,3
3,1262,31118,3578747459,3578747462,3
3,1262,31119,3578747459,3578747464,5
3,1262,31120,3578747459,3578747464,5
3,1262,31121,3578747459,3578747465,6
3,1262,31122,3578747459,3578747468,9
3,1262,31123,3578747459,3578747470,11
3,1262,31124,3578747459,3578747473,14
3,1262,31125,3578747459,3578747475,16
3,1262,31126,3578747459,3578747476,17
3,1262,31127,3578747459,3578747479,20
3,1262,31128,3578747459,3578747481,22
3,1262,31129,3578747459,3578747481,22
3,1262,31130,3578747459,3578747482,23
3,1262,31131,3578747459,3578747483,24
3,1262,31132,3578747459,3578747483,24
3,1262,31133,3578747459,3578747485,26
3,1262,31134,3578747459,3578747486,27
3,1262,31135,3578747459,3578747486,27
3,1262,31136,3578747459,3578747487,28
3,1262,31137,3578747459,3578747490,31
3,1262,31138,3578747459,3578747491,32
3,1262,31139,3578747459,3578747491,32
3,1262,31140,3578747459,3578747491,32
3,1262,31141,3578747459,3578747492,33
3,1262,31142,3578747459,3578747494,35
3,1262,31143,3578747459,3578747494,35
3,1262,31144,3578747459,3578747495,36
3,1262,31145,3578747459,3578747497,38
3,1262,31146,3578747459,3578747498,39
3,1262,31147,3578747459,3578747498,39
3,1262,31148,3578747459,3578747498,39
3,1262,31149,3578747459,3578747500,41
3,1262,31150,3578747459,3578747501,42
3,1262,31151,3578747459,3578747501,42
3,1262,31152,3578747459,3578747501,42
3,1262,31153,3578747459,3578747503,44
3,1262,31154,3578747459,3578747504,45
3,1262,31155,3578747459,3578747504,45
3,1262,31156,3578747459,3578747504,45
3,1262,31157,3578747459,3578747505,46
3,1262,31158,3578747459,3578747508,49
3,1263,31159,3578747523,3578747523,0
3,1263,31160,3578747523,3578747523,0
3,1263,31161,3578747523,3578747523,0
3,1263,31162,3578747523,3578747523,0
3,1263,31163,3578747523,3578747523,0
3,1263,31164,3578747523,3578747523,0
3,1263,31165,3578747523,3578747523,0
3,1263,31166,3578747523,3578747523,0
3,1263,31167,3578747523,3578747523,0
3,1263,31168,3578747523,3578747523,0
3,1263,31169,3578747523,3578747523,0
3,1263,31170,3578747523,3578747523,0
3,1263,31171,3578747523,3578747528,5
3,1263,31172,3578747523,3578747532,9
3,1263,31173,3578747523,3578747534,11
3,1263,31174,3578747523,3578747536,13
3,1263,31175,3578747523,3578747536,13
3,1263,31176,3578747523,3578747537,14
3,1263,31177,3578747523,3578747537,14
3,1263,31178,3578747523,3578747538,15
3,1263,31179,3578747523,3578747538,15
3,1263,31180,3578747523,3578747539,16
3,1263,31181,3578747523,3578747540,17
3,1263,31182,3578747523,3578747541,18
3,1263,31183,3578747523,3578747542,19
3,1263,31184,3578747523,3578747544,21
3,1263,31185,3578747523,3578747546,23
3,1263,31186,3578747523,3578747547,24
3,1263,31187,3578747523,3578747549,26
3,1263,31188,3578747523,3578747551,28
3,1263,31189,3578747523,3578747551,28
3,1263,31190,3578747523,3578747551,28
3,1263,31191,3578747523,3578747553,30
3,1263,31192,3578747523,3578747553,30
3,1263,31193,3578747523,3578747555,32
3,1263,31194,3578747523,3578747555,32
3,1263,31195,3578747523,3578747556,33
3,1263,31196,3578747523,3578747557,34
3,1263,31197,3578747523,3578747558,35
3,1263,31198,3578747523,3578747558,35
3,1263,31199,3578747523,3578747558,35
3,1263,31200,3578747523,3578747562,39
3,1263,31201,3578747523,3578747564,41
3,1263,31202,3578747523,3578747565,42
3,1263,31203,3578747523,3578747566,43
3,1263,31204,3578747523,3578747568,45
3,1263,31205,3578747523,3578747568,45
3,1263,31206,3578747523,3578747569,46
3,1263,31207,3578747523,3578747569,46
3,1263,31208,3578747523,3578747569,46
3,1263,31209,3578747523,3578747569,46
3,1263,31210,3578747523,3578747570,47
3,1263,31211,3578747523,3578747571,48
3,1263,31212,3578747523,3578747572,49
3,1263,31213,3578747523,3578747573,50
3,1264,31214,3578747585,3578747585,0
3,1264,31215,3578747585,3578747585,0
3,1264,31216,3578747585,3578747585,0
3,1264,31217,3578747585,3578747585,0
3,1264,31218,3578747585,3578747585,0
3,1264,31219,3578747585,3578747585,0
3,1264,31220,3578747585,3578747586,1
3,1264,31221,3578747585,3578747587,2
3,1264,31222,3578747585,3578747587,2
3,1264,31223,3578747585,3578747587,2
3,1264,31224,3578747585,3578747587,2
3,1264,31225,3578747585,3578747587,2
3,1264,31226,3578747585,3578747587,2
3,1264,31227,3578747585,3578747588,3
3,1264,31228,3578747585,3578747589,4
3,1264,31229,3578747585,3578747590,5
3,1264,31230,3578747585,3578747591,6
3,1264,31231,3578747585,3578747593,8
3,1264,31232,3578747585,3578747594,9
3,1264,31233,3578747585,3578747595,10
3,1264,31234,3578747585,3578747596,11
3,1264,31235,3578747585,3578747596,11
3,1264,31236,3578747585,3578747599,14
3,1264,31237,3578747585,3578747600,15
3,1264,31238,3578747585,3578747601,16
3,1264,31239,3578747585,3578747602,17
3,1264,31240,3578747585,3578747602,17
3,1264,31241,3578747585,3578747602,17
3,1264,31242,3578747585,3578747603,18
3,1264,31243,3578747585,3578747603,18
3,1264,31244,3578747585,3578747604,19
3,1264,31245,3578747585,3578747605,20
3,1264,31246,3578747585,3578747605,20
3,1264,31247,3578747585,3578747606,21
3,1264,31248,3578747585,3578747606,21
3,1264,31249,3578747585,3578747608,23
3,1264,31250,3578747585,3578747608,23
3,1264,31251,3578747585,3578747608,23
3,1264,31252,3578747585,3578747608,23
3,1264,31253,3578747585,3578747613,28
3,1264,31254,3578747585,3578747613,28
3,1264,31255,3578747585,3578747614,29
3,1264,31256,3578747585,3578747614,29
3,1264,31257,3578747585,3578747616,31
3,1264,31258,3578747585,3578747618,33
3,1264,31259,3578747585,3578747618,33
3,1264,31260,3578747585,3578747619,34
3,1264,31261,3578747585,3578747619,34
3,1264,31262,3578747585,3578747622,37
3,1264,31263,3578747585,3578747624,39
3,1264,31264,3578747585,3578747625,40
3,1264,31265,3578747585,3578747626,41
3,1264,31266,3578747585,3578747626,41
3,1264,31267,3578747585,3578747626,41
3,1264,31268,3578747585,3578747626,41
3,1264,31269,3578747585,3578747627,42
3,1264,31270,3578747585,3578747628,43
3,1264,31271,3578747585,3578747629,44
3,1264,31272,3578747585,3578747631,46
3,1264,31273,3578747585,3578747631,46
3,1264,31274,3578747585,3578747631,46
3,1264,31275,3578747585,3578747632,47
3,1264,31276,3578747585,3578747635,50
3,1265,31277,3578747646,3578747646,0
3,1265,31278,3578747646,3578747646,0
3,1265,31279,3578747646,3578747646,0
3,1265,31280,3578747646,3578747646,0
3,1265,31281,3578747646,3578747646,0
3,1265,31282,3578747646,3578747646,0
3,1265,31283,3578747646,3578747646,0
3,1265,31284,3578747646,3578747646,0
3,1265,31285,3578747646,3578747646,0
3,1265,31286,3578747646,3578747646,0
3,1265,31287,3578747646,3578747646,0
3,1265,31288,3578747646,3578747646,0
3,1265,31289,3578747646,3578747646,0
3,1265,31290,3578747646,3578747647,1
3,1265,31291,3578747646,3578747650,4
3,1265,31292,3578747646,3578747650,4
3,1265,31293,3578747646,3578747653,7
3,1265,31294,3578747646,3578747653,7
3,1265,31295,3578747646,3578747655,9
3,1265,31296,3578747646,3578747656,10
3,1265,31297,3578747646,3578747658,12
3,1265,31298,3578747646,3578747658,12
3,1265,31299,3578747646,3578747660,14
3,1265,31300,3578747646,3578747661,15
3,1265,31301,3578747646,3578747662,16
3,1265,31302,3578747646,3578747663,17
3,1265,31303,3578747646,3578747663,17
3,1265,31304,3578747646,3578747663,17
3,1265,31305,3578747646,3578747666,20
3,1265,31306,3578747646,3578747669,23
3,1265,31307,3578747646,3578747673,27
3,1265,31308,3578747646,3578747675,29
3,1265,31309,3578747646,3578747676,30
3,1265,31310,3578747646,3578747679,33
3,1265,31311,3578747646,3578747680,34
3,1265,31312,3578747646,3578747681,35
3,1265,31313,3578747646,3578747682,36
3,1265,31314,3578747646,3578747683,37
3,1265,31315,3578747646,3578747683,37
3,1265,31316,3578747646,3578747685,39
3,1265,31317,3578747646,3578747686,40
3,1265,31318,3578747646,3578747687,41
3,1265,31319,3578747646,3578747691,45
3,1265,31320,3578747646,3578747691,45
3,1265,31321,3578747646,3578747691,45
3,1265,31322,3578747646,3578747692,46
3,1265,31323,3578747646,3578747694,48
3,1265,31324,3578747646,3578747695,49
3,1265,31325,3578747646,3578747695,49
3,1266,31326,3578747710,3578747710,0
3,1266,31327,3578747710,3578747710,0
3,1266,31328,3578747710,3578747710,0
3,1266,31329,3578747710,3578747710,0
3,1266,31330,3578747710,3578747710,0
3,1266,31331,3578747710,3578747710,0
3,1266,31332,3578747710,3578747710,0
3,1266,31333,3578747710,3578747710,0
3,1266,31334,3578747710,3578747710,0
3,1266,31335,3578747710,3578747710,0
3,1266,31336,3578747710,3578747710,0
3,1266,31337,3578747710,3578747710,0
3,1266,31338,3578747710,3578747710,0
3,1266,31339,3578747710,3578747710,0
3,1266,31340,3578747710,3578747716,6
3,1266,31341,3578747710,3578747717,7
3,1266,31342,3578747710,3578747717,7
3,1266,31343,3578747710,3578747717,7
3,1266,31344,3578747710,3578747718,8
3,1266,31345,3578747710,3578747719,9
3,1266,31346,3578747710,3578747720,10
3,1266,31347,3578747710,3578747721,11
3,1266,31348,3578747710,3578747721,11
3,1266,31349,3578747710,3578747721,11
3,1266,31350,3578747710,3578747722,12
3,1266,31351,3578747710,3578747726,16
3,1266,31352,3578747710,3578747728,18
3,1266,31353,3578747710,3578747732,22
3,1266,31354,3578747710,3578747735,25
3,1266,31355,3578747710,3578747736,26
3,1266,31356,3578747710,3578747737,27
3,1266,31357,3578747710,3578747737,27
3,1266,31358,3578747710,3578747738,28
3,1266,31359,3578747710,3578747739,29
3,1266,31360,3578747710,3578747740,30
3,1266,31361,3578747710,3578747741,31
3,1266,31362,3578747710,3578747742,32
3,1266,31363,3578747710,3578747744,34
3,1266,31364,3578747710,3578747746,36
3,1266,31365,3578747710,3578747748,38
3,1266,31366,3578747710,3578747749,39
3,1266,31367,3578747710,3578747749,39
3,1266,31368,3578747710,3578747751,41
3,1266,31369,3578747710,3578747752,42
3,1266,31370,3578747710,3578747752,42
3,1266,31371,3578747710,3578747753,43
3,1266,31372,3578747710,3578747753,43
3,1266,31373,3578747710,3578747755,45
3,1266,31374,3578747710,3578747755,45
3,1266,31375,3578747710,3578747756,46
3,1266,31376,3578747710,3578747757,47
3,1266,31377,3578747710,3578747758,48
3,1266,31378,3578747710,3578747758,48
3,1266,31379,3578747710,3578747758,48
3,1267,31380,3578747772,3578747772,0
3,1267,31381,3578747772,3578747772,0
3,1267,31382,3578747772,3578747772,0
3,1267,31383,3578747772,3578747772,0
3,1267,31384,3578747772,3578747772,0
3,1267,31385,3578747772,3578747772,0
3,1267,31386,3578747772,3578747772,0
3,1267,31387,3578747772,3578747772,0
3,1267,31388,3578747772,3578747772,0
3,1267,31389,3578747772,3578747772,0
3,1267,31390,3578747772,3578747772,0
3,1267,31391,3578747772,3578747772,0
3,1267,31392,3578747772,3578747772,0
3,1267,31393,3578747772,3578747772,0
3,1267,31394,3578747772,3578747772,0
3,1267,31395,3578747772,3578747773,1
3,1267,31396,3578747772,3578747773,1
3,1267,31397,3578747772,3578747774,2
3,1267,31398,3578747772,3578747774,2
3,1267,31399,3578747772,3578747775,3
3,1267,31400,3578747772,3578747779,7
3,1267,31401,3578747772,3578747783,11
3,1267,31402,3578747772,3578747785,13
3,1267,31403,3578747772,3578747786,14
3,1267,31404,3578747772,3578747787,15
3,1267,31405,3578747772,3578747787,15
3,1267,31406,3578747772,3578747787,15
3,1267,31407,3578747772,3578747787,15
3,1267,31408,3578747772,3578747787,15
3,1267,31409,3578747772,3578747788,16
3,1267,31410,3578747772,3578747789,17
3,1267,31411,3578747772,3578747789,17
3,1267,31412,3578747772,3578747791,19
3,1267,31413,3578747772,3578747791,19
3,1267,31414,3578747772,3578747794,22
3,1267,31415,3578747772,3578747795,23
3,1267,31416,3578747772,3578747796,24
3,1267,31417,3578747772,3578747799,27
3,1267,31418,3578747772,3578747800,28
3,1267,31419,3578747772,3578747802,30
3,1267,31420,3578747772,3578747802,30
3,1267,31421,3578747772,3578747802,30
3,1267,31422,3578747772,3578747803,31
3,1267,31423,3578747772,3578747803,31
3,1267,31424,3578747772,3578747804,32
3,1267,31425,3578747772,3578747805,33
3,1267,31426,3578747772,3578747805,33
3,1267,31427,3578747772,3578747806,34
3,1267,31428,3578747772,3578747807,35
3,1267,31429,3578747772,3578747808,36
3,1267,31430,3578747772,3578747808,36
3,1267,31431,3578747772,3578747808,36
3,1267,31432,3578747772,3578747808,36
3,1267,31433,3578747772,3578747812,40
3,1267,31434,3578747772,3578747813,41
3,1267,31435,3578747772,3578747814,42
3,1267,31436,3578747772,3578747814,42
3,1267,31437,3578747772,3578747815,43
3,1267,31438,3578747772,3578747818,46
3,1267,31439,3578747772,3578747819,47
3,1267,31440,3578747772,3578747820,48
3,1267,31441,3578747772,3578747820,48
3,1267,31442,3578747772,3578747822,50
3,1268,31443,3578747834,3578747834,0
3,1268,31444,3578747834,3578747834,0
3,1268,31445,3578747834,3578747834,0
3,1268,31446,3578747834,3578747834,0
3,1268,31447,3578747834,3578747834,0
3,1268,31448,3578747834,3578747834,0
3,1268,31449,3578747834,3578747834,0
3,1268,31450,3578747834,3578747834,0
3,1268,31451,3578747834,3578747834,0
3,1268,31452,3578747834,3578747834,0
3,1268,31453,3578747834,3578747834,0
3,1268,31454,3578747834,3578747834,0
3,1268,31455,3578747834,3578747834,0
3,1268,31456,3578747834,3578747834,0
3,1268,31457,3578747834,3578747835,1
3,1268,31458,3578747834,3578747836,2
3,1268,31459,3578747834,3578747837,3
3,1268,31460,3578747834,3578747838,4
3,1268,31461,3578747834,3578747839,5
3,1268,31462,3578747834,3578747839,5
3,1268,31463,3578747834,3578747842,8
3,1268,31464,3578747834,3578747842,8
3,1268,31465,3578747834,3578747843,9
3,1268,31466,3578747834,3578747843,9
3,1268,31467,3578747834,3578747843,9
3,1268,31468,3578747834,3578747844,10
3,1268,31469,3578747834,3578747844,10
3,1268,31470,3578747834,3578747845,11
3,1268,31471,3578747834,3578747847,13
3,1268,31472,3578747834,3578747847,13
3,1268,31473,3578747834,3578747850,16
3,1268,31474,3578747834,3578747851,17
3,1268,31475,3578747834,3578747853,19
3,1268,31476,3578747834,3578747853,19
3,1268,31477,3578747834,3578747854,20
3,1268,31478,3578747834,3578747855,21
3,1268,31479,3578747834,3578747856,22
3,1268,31480,3578747834,3578747857,23
3,1268,31481,3578747834,3578747857,23
3,1268,31482,3578747834,3578747861,27
3,1268,31483,3578747834,3578747861,27
3,1268,31484,3578747834,3578747862,28
3,1268,31485,3578747834,3578747863,29
3,1268,31486,3578747834,3578747863,29
3,1268,31487,3578747834,3578747863,29
3,1268,31488,3578747834,3578747867,33
3,1268,31489,3578747834,3578747869,35
3,1268,31490,3578747834,3578747873,39
3,1268,31491,3578747834,3578747875,41
3,1268,31492,3578747834,3578747876,42
3,1268,31493,3578747834,3578747880,46
3,1268,31494,3578747834,3578747881,47
3,1268,31495,3578747834,3578747881,47
3,1268,31496,3578747834,3578747881,47
3,1268,31497,3578747834,3578747882,48
3,1269,31498,3578747896,3578747897,1
3,1269,31499,3578747896,3578747897,1
3,1269,31500,3578747896,3578747897,1
3,1269,31501,3578747896,3578747897,1
3,1269,31502,3578747896,3578747897,1
3,1269,31503,3578747896,3578747897,1
3,1269,31504,3578747896,3578747897,1
3,1269,31505,3578747896,3578747897,1
3,1269,31506,3578747896,3578747897,1
3,1269,31507,3578747896,3578747898,2
3,1269,31508,3578747896,3578747898,2
3,1269,31509,3578747896,3578747898,2
3,1269,31510,3578747896,3578747900,4
3,1269,31511,3578747896,3578747901,5
3,1269,31512,3578747896,3578747901,5
3,1269,31513,3578747896,3578747902,6
3,1269,31514,3578747896,3578747902,6
3,1269,31515,3578747896,3578747904,8
3,1269,31516,3578747896,3578747905,9
3,1269,31517,3578747896,3578747906,10
3,1269,31518,3578747896,3578747908,12
3,1269,31519,3578747896,3578747909,13
3,1269,31520,3578747896,3578747909,13
3,1269,31521,3578747896,3578747916,20
3,1269,31522,3578747896,3578747917,21
3,1269,31523,3578747896,3578747917,21
3,1269,31524,3578747896,3578747918,22
3,1269,31525,3578747896,3578747918,22
3,1269,31526,3578747896,3578747918,22
3,1269,31527,3578747896,3578747919,23
3,1269,31528,3578747896,3578747920,24
3,1269,31529,3578747896,3578747920,24
3,1269,31530,3578747896,3578747922,26
3,1269,31531,3578747896,3578747922,26
3,1269,31532,3578747896,3578747926,30
3,1269,31533,3578747896,3578747929,33
3,1269,31534,3578747896,3578747931,35
3,1269,31535,3578747896,3578747935,39
3,1269,31536,3578747896,3578747937,41
3,1269,31537,3578747896,3578747937,41
3,1269,31538,3578747896,3578747939,43
3,1269,31539,3578747896,3578747939,43
3,1269,31540,3578747896,3578747942,46
3,1269,31541,3578747896,3578747944,48
3,1270,31542,3578747959,3578747959,0
3,1270,31543,3578747959,3578747959,0
3,1270,31544,3578747959,3578747959,0
3,1270,31545,3578747959,3578747959,0
3,1270,31546,3578747959,3578747959,0
3,1270,31547,3578747959,3578747959,0
3,1270,31548,3578747959,3578747959,0
3,1270,31549,3578747959,3578747959,0
3,1270,31550,3578747959,3578747959,0
3,1270,31551,3578747959,3578747959,0
3,1270,31552,3578747959,3578747959,0
3,1270,31553,3578747959,3578747959,0
3,1270,31554,3578747959,3578747959,0
3,1270,31555,3578747959,3578747961,2
3,1270,31556,3578747959,3578747963,4
3,1270,31557,3578747959,3578747964,5
3,1270,31558,3578747959,3578747965,6
3,1270,31559,3578747959,3578747966,7
3,1270,31560,3578747959,3578747967,8
3,1270,31561,3578747959,3578747968,9
3,1270,31562,3578747959,3578747968,9
3,1270,31563,3578747959,3578747969,10
3,1270,31564,3578747959,3578747969,10
3,1270,31565,3578747959,3578747970,11
3,1270,31566,3578747959,3578747971,12
3,1270,31567,3578747959,3578747972,13
3,1270,31568,3578747959,3578747973,14
3,1270,31569,3578747959,3578747974,15
3,1270,31570,3578747959,3578747974,15
3,1270,31571,3578747959,3578747974,15
3,1270,31572,3578747959,3578747975,16
3,1270,31573,3578747959,3578747983,24
3,1270,31574,3578747959,3578747984,25
3,1270,31575,3578747959,3578747986,27
3,1270,31576,3578747959,3578747986,27
3,1270,31577,3578747959,3578747986,27
3,1270,31578,3578747959,3578747987,28
3,1270,31579,3578747959,3578747987,28
3,1270,31580,3578747959,3578747987,28
3,1270,31581,3578747959,3578747987,28
3,1270,31582,3578747959,3578747987,28
3,1270,31583,3578747959,3578747988,29
3,1270,31584,3578747959,3578747988,29
3,1270,31585,3578747959,3578747989,30
3,1270,31586,3578747959,3578747990,31
3,1270,31587,3578747959,3578747991,32
3,1270,31588,3578747959,3578747991,32
3,1270,31589,3578747959,3578747991,32
3,1270,31590,3578747959,3578747994,35
3,1270,31591,3578747959,3578747995,36
3,1270,31592,3578747959,3578747996,37
3,1270,31593,3578747959,3578747999,40
3,1270,31594,3578747959,3578748000,41
3,1270,31595,3578747959,3578748002,43
3,1270,31596,3578747959,3578748003,44
3,1270,31597,3578747959,3578748003,44
3,1270,31598,3578747959,3578748003,44
3,1270,31599,3578747959,3578748004,45
3,1270,31600,3578747959,3578748005,46
3,1270,31601,3578747959,3578748005,46
3,1270,31602,3578747959,3578748006,47
3,1270,31603,3578747959,3578748007,48
3,1270,31604,3578747959,3578748007,48
3,1270,31605,3578747959,3578748008,49
3,1270,31606,3578747959,3578748009,50
3,1271,31607,3578748022,3578748022,0
3,1271,31608,3578748022,3578748022,0
3,1271,31609,3578748022,3578748022,0
3,1271,31610,3578748022,3578748022,0
3,1271,31611,3578748022,3578748022,0
3,1271,31612,3578748022,3578748022,0
3,1271,31613,3578748022,3578748022,0
3,1271,31614,3578748022,3578748022,0
3,1271,31615,3578748022,3578748022,0
3,1271,31616,3578748022,3578748024,2
3,1271,31617,3578748022,3578748025,3
3,1271,31618,3578748022,3578748025,3
3,1271,31619,3578748022,3578748025,3
3,1271,31620,3578748022,3578748026,4
3,1271,31621,3578748022,3578748026,4
3,1271,31622,3578748022,3578748028,6
3,1271,31623,3578748022,3578748028,6
3,1271,31624,3578748022,3578748029,7
3,1271,31625,3578748022,3578748029,7
3,1271,31626,3578748022,3578748031,9
3,1271,31627,3578748022,3578748033,11
3,1271,31628,3578748022,3578748033,11
3,1271,31629,3578748022,3578748034,12
3,1271,31630,3578748022,3578748035,13
3,1271,31631,3578748022,3578748036,14
3,1271,31632,3578748022,3578748037,15
3,1271,31633,3578748022,3578748038,16
3,1271,31634,3578748022,3578748040,18
3,1271,31635,3578748022,3578748040,18
3,1271,31636,3578748022,3578748043,21
3,1271,31637,3578748022,3578748043,21
3,1271,31638,3578748022,3578748043,21
3,1271,31639,3578748022,3578748043,21
3,1271,31640,3578748022,3578748044,22
3,1271,31641,3578748022,3578748044,22
3,1271,31642,3578748022,3578748045,23
3,1271,31643,3578748022,3578748047,25
3,1271,31644,3578748022,3578748047,25
3,1271,31645,3578748022,3578748049,27
3,1271,31646,3578748022,3578748051,29
3,1271,31647,3578748022,3578748052,30
3,1271,31648,3578748022,3578748053,31
3,1271,31649,3578748022,3578748054,32
3,1271,31650,3578748022,3578748055,33
3,1271,31651,3578748022,3578748056,34
3,1271,31652,3578748022,3578748058,36
3,1271,31653,3578748022,3578748058,36
3,1271,31654,3578748022,3578748061,39
3,1271,31655,3578748022,3578748062,40
3,1271,31656,3578748022,3578748062,40
3,1271,31657,3578748022,3578748063,41
3,1271,31658,3578748022,3578748064,42
3,1271,31659,3578748022,3578748067,45
3,1271,31660,3578748022,3578748070,48
3,1272,31661,3578748083,3578748083,0
3,1272,31662,3578748083,3578748083,0
3,1272,31663,3578748083,3578748083,0
3,1272,31664,3578748083,3578748083,0
3,1272,31665,3578748083,3578748083,0
3,1272,31666,3578748083,3578748083,0
3,1272,31667,3578748083,3578748083,0
3,1272,31668,3578748083,3578748083,0
3,1272,31669,3578748083,3578748084,1
3,1272,31670,3578748083,3578748086,3
3,1272,31671,3578748083,3578748087,4
3,1272,31672,3578748083,3578748087,4
3,1272,31673,3578748083,3578748091,8
3,1272,31674,3578748083,3578748091,8
3,1272,31675,3578748083,3578748091,8
3,1272,31676,3578748083,3578748094,11
3,1272,31677,3578748083,3578748095,12
3,1272,31678,3578748083,3578748095,12
3,1272,31679,3578748083,3578748098,15
3,1272,31680,3578748083,3578748098,15
3,1272,31681,3578748083,3578748098,15
3,1272,31682,3578748083,3578748098,15
3,1272,31683,3578748083,3578748101,18
3,1272,31684,3578748083,3578748101,18
3,1272,31685,3578748083,3578748102,19
3,1272,31686,3578748083,3578748102,19
3,1272,31687,3578748083,3578748102,19
3,1272,31688,3578748083,3578748104,21
3,1272,31689,3578748083,3578748104,21
3,1272,31690,3578748083,3578748104,21
3,1272,31691,3578748083,3578748106,23
3,1272,31692,3578748083,3578748106,23
3,1272,31693,3578748083,3578748108,25
3,1272,31694,3578748083,3578748109,26
3,1272,31695,3578748083,3578748109,26
3,1272,31696,3578748083,3578748116,33
3,1272,31697,3578748083,3578748117,34
3,1272,31698,3578748083,3578748117,34
3,1272,31699,3578748083,3578748118,35
3,1272,31700,3578748083,3578748119,36
3,1272,31701,3578748083,3578748119,36
3,1272,31702,3578748083,3578748120,37
3,1272,31703,3578748083,3578748120,37
3,1272,31704,3578748083,3578748122,39
3,1272,31705,3578748083,3578748125,42
3,1272,31706,3578748083,3578748129,46
3,1272,31707,3578748083,3578748132,49
3,1273,31708,3578748146,3578748146,0
3,1273,31709,3578748146,3578748146,0
3,1273,31710,3578748146,3578748146,0
3,1273,31711,3578748146,3578748146,0
3,1273,31712,3578748146,3578748146,0
3,1273,31713,3578748146,3578748146,0
3,1273,31714,3578748146,3578748146,0
3,1273,31715,3578748146,3578748146,0
3,1273,31716,3578748146,3578748146,0
3,1273,31717,3578748146,3578748146,0
3,1273,31718,3578748146,3578748146,0
3,1273,31719,3578748146,3578748146,0
3,1273,31720,3578748146,3578748148,2
3,1273,31721,3578748146,3578748149,3
3,1273,31722,3578748146,3578748150,4
3,1273,31723,3578748146,3578748152,6
3,1273,31724,3578748146,3578748152,6
3,1273,31725,3578748146,3578748153,7
3,1273,31726,3578748146,3578748153,7
3,1273,31727,3578748146,3578748154,8
3,1273,31728,3578748146,3578748155,9
3,1273,31729,3578748146,3578748156,10
3,1273,31730,3578748146,3578748157,11
3,1273,31731,3578748146,3578748158,12
3,1273,31732,3578748146,3578748158,12
3,1273,31733,3578748146,3578748158,12
3,1273,31734,3578748146,3578748158,12
3,1273,31735,3578748146,3578748162,16
3,1273,31736,3578748146,3578748164,18
3,1273,31737,3578748146,3578748164,18
3,1273,31738,3578748146,3578748165,19
3,1273,31739,3578748146,3578748166,20
3,1273,31740,3578748146,3578748166,20
3,1273,31741,3578748146,3578748168,22
3,1273,31742,3578748146,3578748169,23
3,1273,31743,3578748146,3578748169,23
3,1273,31744,3578748146,3578748169,23
3,1273,31745,3578748146,3578748170,24
3,1273,31746,3578748146,3578748170,24
3,1273,31747,3578748146,3578748171,25
3,1273,31748,3578748146,3578748171,25
3,1273,31749,3578748146,3578748173,27
3,1273,31750,3578748146,3578748173,27
3,1273,31751,3578748146,3578748173,27
3,1273,31752,3578748146,3578748174,28
3,1273,31753,3578748146,3578748177,31
3,1273,31754,3578748146,3578748180,34
3,1273,31755,3578748146,3578748184,38
3,1273,31756,3578748146,3578748184,38
3,1273,31757,3578748146,3578748186,40
3,1273,31758,3578748146,3578748186,40
3,1273,31759,3578748146,3578748187,41
3,1273,31760,3578748146,3578748187,41
3,1273,31761,3578748146,3578748188,42
3,1273,31762,3578748146,3578748189,43
3,1273,31763,3578748146,3578748189,43
3,1273,31764,3578748146,3578748189,43
3,1273,31765,3578748146,3578748190,44
3,1273,31766,3578748146,3578748191,45
3,1273,31767,3578748146,3578748192,46
3,1273,31768,3578748146,3578748192,46
3,1273,31769,3578748146,3578748192,46
3,1273,31770,3578748146,3578748194,48
3,1273,31771,3578748146,3578748195,49
3,1273,31772,3578748146,3578748196,50
3,1274,31773,3578748208,3578748208,0
3,1274,31774,3578748208,3578748208,0
3,1274,31775,3578748208,3578748208,0
3,1274,31776,3578748208,3578748208,0
3,1274,31777,3578748208,3578748208,0
3,1274,31778,3578748208,3578748208,0
3,1274,31779,3578748208,3578748208,0
3,1274,31780,3578748208,3578748208,0
3,1274,31781,3578748208,3578748208,0
3,1274,31782,3578748208,3578748208,0
3,1274,31783,3578748208,3578748208,0
3,1274,31784,3578748208,3578748208,0
3,1274,31785,3578748208,3578748209,1
3,1274,31786,3578748208,3578748213,5
3,1274,31787,3578748208,3578748214,6
3,1274,31788,3578748208,3578748215,7
3,1274,31789,3578748208,3578748216,8
3,1274,31790,3578748208,3578748216,8
3,1274,31791,3578748208,3578748218,10
3,1274,31792,3578748208,3578748219,11
3,1274,31793,3578748208,3578748221,13
3,1274,31794,3578748208,3578748222,14
3,1274,31795,3578748208,3578748225,17
3,1274,31796,3578748208,3578748225,17
3,1274,31797,3578748208,3578748225,17
3,1274,31798,3578748208,3578748225,17
3,1274,31799,3578748208,3578748226,18
3,1274,31800,3578748208,3578748227,19
3,1274,31801,3578748208,3578748228,20
3,1274,31802,3578748208,3578748228,20
3,1274,31803,3578748208,3578748228,20
3,1274,31804,3578748208,3578748230,22
3,1274,31805,3578748208,3578748231,23
3,1274,31806,3578748208,3578748232,24
3,1274,31807,3578748208,3578748233,25
3,1274,31808,3578748208,3578748234,26
3,1274,31809,3578748208,3578748235,27
3,1274,31810,3578748208,3578748236,28
3,1274,31811,3578748208,3578748238,30
3,1274,31812,3578748208,3578748239,31
3,1274,31813,3578748208,3578748239,31
3,1274,31814,3578748208,3578748240,32
3,1274,31815,3578748208,3578748242,34
3,1274,31816,3578748208,3578748243,35
3,1274,31817,3578748208,3578748243,35
3,1274,31818,3578748208,3578748243,35
3,1274,31819,3578748208,3578748243,35
3,1274,31820,3578748208,3578748245,37
3,1274,31821,3578748208,3578748245,37
3,1274,31822,3578748208,3578748246,38
3,1274,31823,3578748208,3578748246,38
3,1274,31824,3578748208,3578748247,39
3,1274,31825,3578748208,3578748247,39
3,1274,31826,3578748208,3578748250,42
3,1274,31827,3578748208,3578748251,43
3,1274,31828,3578748208,3578748252,44
3,1274,31829,3578748208,3578748255,47
3,1274,31830,3578748208,3578748256,48
3,1274,31831,3578748208,3578748256,48
3,1274,31832,3578748208,3578748258,50
3,1275,31833,3578748271,3578748271,0
3,1275,31834,3578748271,3578748271,0
3,1275,31835,3578748271,3578748271,0
3,1275,31836,3578748271,3578748271,0
3,1275,31837,3578748271,3578748271,0
3,1275,31838,3578748271,3578748271,0
3,1275,31839,3578748271,3578748271,0
3,1275,31840,3578748271,3578748271,0
3,1275,31841,3578748271,3578748271,0
3,1275,31842,3578748271,3578748273,2
3,1275,31843,3578748271,3578748276,5
3,1275,31844,3578748271,3578748276,5
3,1275,31845,3578748271,3578748279,8
3,1275,31846,3578748271,3578748281,10
3,1275,31847,3578748271,3578748282,11
3,1275,31848,3578748271,3578748282,11
3,1275,31849,3578748271,3578748282,11
3,1275,31850,3578748271,3578748284,13
3,1275,31851,3578748271,3578748286,15
3,1275,31852,3578748271,3578748287,16
3,1275,31853,3578748271,3578748287,16
3,1275,31854,3578748271,3578748291,20
3,1275,31855,3578748271,3578748291,20
3,1275,31856,3578748271,3578748291,20
3,1275,31857,3578748271,3578748292,21
3,1275,31858,3578748271,3578748292,21
3,1275,31859,3578748271,3578748294,23
3,1275,31860,3578748271,3578748295,24
3,1275,31861,3578748271,3578748295,24
3,1275,31862,3578748271,3578748297,26
3,1275,31863,3578748271,3578748298,27
3,1275,31864,3578748271,3578748298,27
3,1275,31865,3578748271,3578748298,27
3,1275,31866,3578748271,3578748300,29
3,1275,31867,3578748271,3578748301,30
3,1275,31868,3578748271,3578748301,30
3,1275,31869,3578748271,3578748303,32
3,1275,31870,3578748271,3578748303,32
3,1275,31871,3578748271,3578748304,33
3,1275,31872,3578748271,3578748304,33
3,1275,31873,3578748271,3578748304,33
3,1275,31874,3578748271,3578748306,35
3,1275,31875,3578748271,3578748306,35
3,1275,31876,3578748271,3578748308,37
3,1275,31877,3578748271,3578748309,38
3,1275,31878,3578748271,3578748309,38
3,1275,31879,3578748271,3578748316,45
3,1275,31880,3578748271,3578748316,45
3,1275,31881,3578748271,3578748317,46
3,1275,31882,3578748271,3578748319,48
3,1275,31883,3578748271,3578748319,48
3,1275,31884,3578748271,3578748319,48
3,1275,31885,3578748271,3578748320,49
3,1275,31886,3578748271,3578748320,49
3,1276,31887,3578748334,3578748334,0
3,1276,31888,3578748334,3578748334,0
3,1276,31889,3578748334,3578748334,0
3,1276,31890,3578748334,3578748334,0
3,1276,31891,3578748334,3578748336,2
3,1276,31892,3578748334,3578748337,3
3,1276,31893,3578748334,3578748337,3
3,1276,31894,3578748334,3578748339,5
3,1276,31895,3578748334,3578748339,5
3,1276,31896,3578748334,3578748339,5
3,1276,31897,3578748334,3578748339,5
3,1276,31898,3578748334,3578748340,6
3,1276,31899,3578748334,3578748340,6
3,1276,31900,3578748334,3578748342,8
3,1276,31901,3578748334,3578748344,10
3,1276,31902,3578748334,3578748345,11
3,1276,31903,3578748334,3578748348,14
3,1276,31904,3578748334,3578748350,16
3,1276,31905,3578748334,3578748352,18
3,1276,31906,3578748334,3578748352,18
3,1276,31907,3578748334,3578748353,19
3,1276,31908,3578748334,3578748354,20
3,1276,31909,3578748334,3578748355,21
3,1276,31910,3578748334,3578748356,22
3,1276,31911,3578748334,3578748357,23
3,1276,31912,3578748334,3578748357,23
3,1276,31913,3578748334,3578748358,24
3,1276,31914,3578748334,3578748358,24
3,1276,31915,3578748334,3578748358,24
3,1276,31916,3578748334,3578748361,27
3,1276,31917,3578748334,3578748363,29
3,1276,31918,3578748334,3578748364,30
3,1276,31919,3578748334,3578748366,32
3,1276,31920,3578748334,3578748366,32
3,1276,31921,3578748334,3578748367,33
3,1276,31922,3578748334,3578748367,33
3,1276,31923,3578748334,3578748369,35
3,1276,31924,3578748334,3578748369,35
3,1276,31925,3578748334,3578748370,36
3,1276,31926,3578748334,3578748370,36
3,1276,31927,3578748334,3578748370,36
3,1276,31928,3578748334,3578748371,37
3,1276,31929,3578748334,3578748371,37
3,1276,31930,3578748334,3578748373,39
3,1276,31931,3578748334,3578748374,40
3,1276,31932,3578748334,3578748374,40
3,1276,31933,3578748334,3578748376,42
3,1276,31934,3578748334,3578748380,46
3,1276,31935,3578748334,3578748384,50
3,1277,31936,3578748396,3578748396,0
3,1277,31937,3578748396,3578748396,0
3,1277,31938,3578748396,3578748396,0
3,1277,31939,3578748396,3578748396,0
3,1277,31940,3578748396,3578748396,0
3,1277,31941,3578748396,3578748396,0
3,1277,31942,3578748396,3578748396,0
3,1277,31943,3578748396,3578748396,0
3,1277,31944,3578748396,3578748396,0
3,1277,31945,3578748396,3578748396,0
3,1277,31946,3578748396,3578748396,0
3,1277,31947,3578748396,3578748396,0
3,1277,31948,3578748396,3578748396,0
3,1277,31949,3578748396,3578748396,0
3,1277,31950,3578748396,3578748396,0
3,1277,31951,3578748396,3578748396,0
3,1277,31952,3578748396,3578748396,0
3,1277,31953,3578748396,3578748396,0
3,1277,31954,3578748396,3578748397,1
3,1277,31955,3578748396,3578748397,1
3,1277,31956,3578748396,3578748399,3
3,1277,31957,3578748396,3578748401,5
3,1277,31958,3578748396,3578748402,6
3,1277,31959,3578748396,3578748403,7
3,1277,31960,3578748396,3578748404,8
3,1277,31961,3578748396,3578748404,8
3,1277,31962,3578748396,3578748404,8
3,1277,31963,3578748396,3578748404,8
3,1277,31964,3578748396,3578748405,9
3,1277,31965,3578748396,3578748406,10
3,1277,31966,3578748396,3578748406,10
3,1277,31967,3578748396,3578748407,11
3,1277,31968,3578748396,3578748408,12
3,1277,31969,3578748396,3578748408,12
3,1277,31970,3578748396,3578748408,12
3,1277,31971,3578748396,3578748409,13
3,1277,31972,3578748396,3578748413,17
3,1277,31973,3578748396,3578748414,18
3,1277,31974,3578748396,3578748415,19
3,1277,31975,3578748396,3578748416,20
3,1277,31976,3578748396,3578748416,20
3,1277,31977,3578748396,3578748418,22
3,1277,31978,3578748396,3578748418,22
3,1277,31979,3578748396,3578748421,25
3,1277,31980,3578748396,3578748421,25
3,1277,31981,3578748396,3578748421,25
3,1277,31982,3578748396,3578748425,29
3,1277,31983,3578748396,3578748425,29
3,1277,31984,3578748396,3578748425,29
3,1277,31985,3578748396,3578748426,30
3,1277,31986,3578748396,3578748427,31
3,1277,31987,3578748396,3578748427,31
3,1277,31988,3578748396,3578748428,32
3,1277,31989,3578748396,3578748429,33
3,1277,31990,3578748396,3578748430,34
3,1277,31991,3578748396,3578748430,34
3,1277,31992,3578748396,3578748431,35
3,1277,31993,3578748396,3578748433,37
3,1277,31994,3578748396,3578748433,37
3,1277,31995,3578748396,3578748434,38
3,1277,31996,3578748396,3578748435,39
3,1277,31997,3578748396,3578748437,41
3,1277,31998,3578748396,3578748437,41
3,1277,31999,3578748396,3578748439,43
3,1277,32000,3578748396,3578748440,44
3,1277,32001,3578748396,3578748440,44
3,1277,32002,3578748396,3578748442,46
3,1277,32003,3578748396,3578748442,46
3,1277,32004,3578748396,3578748443,47
3,1277,32005,3578748396,3578748443,47
3,1277,32006,3578748396,3578748444,48
3,1277,32007,3578748396,3578748444,48
3,1277,32008,3578748396,3578748445,49
3,1277,32009,3578748396,3578748446,50
3,1278,32010,3578748461,3578748461,0
3,1278,32011,3578748461,3578748461,0
3,1278,32012,3578748461,3578748461,0
3,1278,32013,3578748461,3578748461,0
3,1278,32014,3578748461,3578748461,0
3,1278,32015,3578748461,3578748461,0
3,1278,32016,3578748461,3578748461,0
3,1278,32017,3578748461,3578748461,0
3,1278,32018,3578748461,3578748461,0
3,1278,32019,3578748461,3578748461,0
3,1278,32020,3578748461,3578748461,0
3,1278,32021,3578748461,3578748461,0
3,1278,32022,3578748461,3578748462,1
3,1278,32023,3578748461,3578748463,2
3,1278,32024,3578748461,3578748464,3
3,1278,32025,3578748461,3578748465,4
3,1278,32026,3578748461,3578748468,7
3,1278,32027,3578748461,3578748469,8
3,1278,32028,3578748461,3578748473,12
3,1278,32029,3578748461,3578748475,14
3,1278,32030,3578748461,3578748476,15
3,1278,32031,3578748461,3578748479,18
3,1278,32032,3578748461,3578748481,20
3,1278,32033,3578748461,3578748481,20
3,1278,32034,3578748461,3578748482,21
3,1278,32035,3578748461,3578748484,23
3,1278,32036,3578748461,3578748486,25
3,1278,32037,3578748461,3578748487,26
3,1278,32038,3578748461,3578748487,26
3,1278,32039,3578748461,3578748491,30
3,1278,32040,3578748461,3578748491,30
3,1278,32041,3578748461,3578748491,30
3,1278,32042,3578748461,3578748493,32
3,1278,32043,3578748461,3578748493,32
3,1278,32044,3578748461,3578748495,34
3,1278,32045,3578748461,3578748495,34
3,1278,32046,3578748461,3578748495,34
3,1278,32047,3578748461,3578748497,36
3,1278,32048,3578748461,3578748498,37
3,1278,32049,3578748461,3578748498,37
3,1278,32050,3578748461,3578748498,37
3,1278,32051,3578748461,3578748500,39
3,1278,32052,3578748461,3578748501,40
3,1278,32053,3578748461,3578748501,40
3,1278,32054,3578748461,3578748503,42
3,1278,32055,3578748461,3578748503,42
3,1278,32056,3578748461,3578748504,43
3,1278,32057,3578748461,3578748504,43
3,1278,32058,3578748461,3578748507,46
3,1278,32059,3578748461,3578748507,46
3,1278,32060,3578748461,3578748507,46
3,1278,32061,3578748461,3578748509,48
3,1278,32062,3578748461,3578748510,49
3,1279,32063,3578748524,3578748524,0
3,1279,32064,3578748524,3578748524,0
3,1279,32065,3578748524,3578748524,0
3,1279,32066,3578748524,3578748524,0
3,1279,32067,3578748524,3578748524,0
3,1279,32068,3578748524,3578748524,0
3,1279,32069,3578748524,3578748524,0
3,1279,32070,3578748524,3578748524,0
3,1279,32071,3578748524,3578748524,0
3,1279,32072,3578748524,3578748524,0
3,1279,32073,3578748524,3578748524,0
3,1279,32074,3578748524,3578748525,1
3,1279,32075,3578748524,3578748528,4
3,1279,32076,3578748524,3578748531,7
3,1279,32077,3578748524,3578748535,11
3,1279,32078,3578748524,3578748536,12
3,1279,32079,3578748524,3578748537,13
3,1279,32080,3578748524,3578748537,13
3,1279,32081,3578748524,3578748538,14
3,1279,32082,3578748524,3578748538,14
3,1279,32083,3578748524,3578748538,14
3,1279,32084,3578748524,3578748539,15
3,1279,32085,3578748524,3578748539,15
3,1279,32086,3578748524,3578748541,17
3,1279,32087,3578748524,3578748544,20
3,1279,32088,3578748524,3578748544,20
3,1279,32089,3578748524,3578748547,23
3,1279,32090,3578748524,3578748549,25
3,1279,32091,3578748524,3578748549,25
3,1279,32092,3578748524,3578748551,27
3,1279,32093,3578748524,3578748551,27
3,1279,32094,3578748524,3578748553,29
3,1279,32095,3578748524,3578748553,29
3,1279,32096,3578748524,3578748555,31
3,1279,32097,3578748524,3578748556,32
3,1279,32098,3578748524,3578748557,33
3,1279,32099,3578748524,3578748558,34
3,1279,32100,3578748524,3578748558,34
3,1279,32101,3578748524,3578748558,34
3,1279,32102,3578748524,3578748563,39
3,1279,32103,3578748524,3578748563,39
3,1279,32104,3578748524,3578748565,41
3,1279,32105,3578748524,3578748565,41
3,1279,32106,3578748524,3578748567,43
3,1279,32107,3578748524,3578748568,44
3,1279,32108,3578748524,3578748568,44
3,1279,32109,3578748524,3578748568,44
3,1279,32110,3578748524,3578748569,45
3,1279,32111,3578748524,3578748569,45
3,1279,32112,3578748524,3578748570,46
3,1279,32113,3578748524,3578748571,47
3,1279,32114,3578748524,3578748572,48
3,1279,32115,3578748524,3578748573,49
3,1279,32116,3578748524,3578748573,49
3,1279,32117,3578748524,3578748574,50
3,1280,32118,3578748587,3578748587,0
3,1280,32119,3578748587,3578748587,0
3,1280,32120,3578748587,3578748587,0
3,1280,32121,3578748587,3578748587,0
3,1280,32122,3578748587,3578748587,0
3,1280,32123,3578748587,3578748587,0
3,1280,32124,3578748587,3578748587,0
3,1280,32125,3578748587,3578748587,0
3,1280,32126,3578748587,3578748587,0
3,1280,32127,3578748587,3578748587,0
3,1280,32128,3578748587,3578748587,0
3,1280,32129,3578748587,3578748587,0
3,1280,32130,3578748587,3578748588,1
3,1280,32131,3578748587,3578748588,1
3,1280,32132,3578748587,3578748589,2
3,1280,32133,3578748587,3578748590,3
3,1280,32134,3578748587,3578748591,4
3,1280,32135,3578748587,3578748592,5
3,1280,32136,3578748587,3578748592,5
3,1280,32137,3578748587,3578748593,6
3,1280,32138,3578748587,3578748595,8
3,1280,32139,3578748587,3578748596,9
3,1280,32140,3578748587,3578748596,9
3,1280,32141,3578748587,3578748597,10
3,1280,32142,3578748587,3578748599,12
3,1280,32143,3578748587,3578748600,13
3,1280,32144,3578748587,3578748601,14
3,1280,32145,3578748587,3578748602,15
3,1280,32146,3578748587,3578748603,16
3,1280,32147,3578748587,3578748603,16
3,1280,32148,3578748587,3578748603,16
3,1280,32149,3578748587,3578748604,17
3,1280,32150,3578748587,3578748604,17
3,1280,32151,3578748587,3578748607,20
3,1280,32152,3578748587,3578748607,20
3,1280,32153,3578748587,3578748607,20
3,1280,32154,3578748587,3578748607,20
3,1280,32155,3578748587,3578748608,21
3,1280,32156,3578748587,3578748612,25
3,1280,32157,3578748587,3578748613,26
3,1280,32158,3578748587,3578748614,27
3,1280,32159,3578748587,3578748614,27
3,1280,32160,3578748587,3578748615,28
3,1280,32161,3578748587,3578748616,29
3,1280,32162,3578748587,3578748617,30
3,1280,32163,3578748587,3578748617,30
3,1280,32164,3578748587,3578748620,33
3,1280,32165,3578748587,3578748622,35
3,1280,32166,3578748587,3578748624,37
3,1280,32167,3578748587,3578748625,38
3,1280,32168,3578748587,3578748625,38
3,1280,32169,3578748587,3578748626,39
3,1280,32170,3578748587,3578748626,39
3,1280,32171,3578748587,3578748627,40
3,1280,32172,3578748587,3578748627,40
3,1280,32173,3578748587,3578748628,41
3,1280,32174,3578748587,3578748629,42
3,1280,32175,3578748587,3578748629,42
3,1280,32176,3578748587,3578748630,43
3,1280,32177,3578748587,3578748631,44
3,1280,32178,3578748587,3578748632,45
3,1280,32179,3578748587,3578748632,45
3,1280,32180,3578748587,3578748633,46
3,1280,32181,3578748587,3578748634,47
3,1280,32182,3578748587,3578748636,49
3,1280,32183,3578748587,3578748636,49
3,1280,32184,3578748587,3578748637,50
3,1281,32185,3578748650,3578748650,0
3,1281,32186,3578748650,3578748650,0
3,1281,32187,3578748650,3578748650,0
3,1281,32188,3578748650,3578748650,0
3,1281,32189,3578748650,3578748650,0
3,1281,32190,3578748650,3578748650,0
3,1281,32191,3578748650,3578748650,0
3,1281,32192,3578748650,3578748650,0
3,1281,32193,3578748650,3578748650,0
3,1281,32194,3578748650,3578748650,0
3,1281,32195,3578748650,3578748650,0
3,1281,32196,3578748650,3578748650,0
3,1281,32197,3578748650,3578748652,2
3,1281,32198,3578748650,3578748653,3
3,1281,32199,3578748650,3578748654,4
3,1281,32200,3578748650,3578748657,7
3,1281,32201,3578748650,3578748658,8
3,1281,32202,3578748650,3578748660,10
3,1281,32203,3578748650,3578748661,11
3,1281,32204,3578748650,3578748661,11
3,1281,32205,3578748650,3578748663,13
3,1281,32206,3578748650,3578748663,13
3,1281,32207,3578748650,3578748664,14
3,1281,32208,3578748650,3578748667,17
3,1281,32209,3578748650,3578748669,19
3,1281,32210,3578748650,3578748673,23
3,1281,32211,3578748650,3578748676,26
3,1281,32212,3578748650,3578748676,26
3,1281,32213,3578748650,3578748679,29
3,1281,32214,3578748650,3578748681,31
3,1281,32215,3578748650,3578748681,31
3,1281,32216,3578748650,3578748682,32
3,1281,32217,3578748650,3578748684,34
3,1281,32218,3578748650,3578748687,37
3,1281,32219,3578748650,3578748687,37
3,1281,32220,3578748650,3578748691,41
3,1281,32221,3578748650,3578748691,41
3,1281,32222,3578748650,3578748691,41
3,1281,32223,3578748650,3578748693,43
3,1281,32224,3578748650,3578748693,43
3,1281,32225,3578748650,3578748694,44
3,1281,32226,3578748650,3578748695,45
3,1281,32227,3578748650,3578748695,45
3,1281,32228,3578748650,3578748697,47
3,1281,32229,3578748650,3578748698,48
3,1281,32230,3578748650,3578748698,48
3,1281,32231,3578748650,3578748699,49
3,1282,32232,3578748712,3578748712,0
3,1282,32233,3578748712,3578748712,0
3,1282,32234,3578748712,3578748712,0
3,1282,32235,3578748712,3578748712,0
3,1282,32236,3578748712,3578748712,0
3,1282,32237,3578748712,3578748712,0
3,1282,32238,3578748712,3578748712,0
3,1282,32239,3578748712,3578748712,0
3,1282,32240,3578748712,3578748712,0
3,1282,32241,3578748712,3578748712,0
3,1282,32242,3578748712,3578748712,0
3,1282,32243,3578748712,3578748715,3
3,1282,32244,3578748712,3578748717,5
3,1282,32245,3578748712,3578748717,5
3,1282,32246,3578748712,3578748718,6
3,1282,32247,3578748712,3578748718,6
3,1282,32248,3578748712,3578748718,6
3,1282,32249,3578748712,3578748720,8
3,1282,32250,3578748712,3578748720,8
3,1282,32251,3578748712,3578748721,9
3,1282,32252,3578748712,3578748721,9
3,1282,32253,3578748712,3578748722,10
3,1282,32254,3578748712,3578748725,13
3,1282,32255,3578748712,3578748729,17
3,1282,32256,3578748712,3578748731,19
3,1282,32257,3578748712,3578748734,22
3,1282,32258,3578748712,3578748736,24
3,1282,32259,3578748712,3578748737,25
3,1282,32260,3578748712,3578748737,25
3,1282,32261,3578748712,3578748737,25
3,1282,32262,3578748712,3578748737,25
3,1282,32263,3578748712,3578748738,26
3,1282,32264,3578748712,3578748739,27
3,1282,32265,3578748712,3578748739,27
3,1282,32266,3578748712,3578748741,29
3,1282,32267,3578748712,3578748745,33
3,1282,32268,3578748712,3578748745,33
3,1282,32269,3578748712,3578748747,35
3,1282,32270,3578748712,3578748749,37
3,1282,32271,3578748712,3578748749,37
3,1282,32272,3578748712,3578748752,40
3,1282,32273,3578748712,3578748752,40
3,1282,32274,3578748712,3578748752,40
3,1282,32275,3578748712,3578748753,41
3,1282,32276,3578748712,3578748753,41
3,1282,32277,3578748712,3578748755,43
3,1282,32278,3578748712,3578748755,43
3,1282,32279,3578748712,3578748757,45
3,1282,32280,3578748712,3578748757,45
3,1282,32281,3578748712,3578748757,45
3,1282,32282,3578748712,3578748758,46
3,1283,32283,3578748775,3578748775,0
3,1283,32284,3578748775,3578748775,0
3,1283,32285,3578748775,3578748775,0
3,1283,32286,3578748775,3578748775,0
3,1283,32287,3578748775,3578748775,0
3,1283,32288,3578748775,3578748775,0
3,1283,32289,3578748775,3578748775,0
3,1283,32290,3578748775,3578748775,0
3,1283,32291,3578748775,3578748775,0
3,1283,32292,3578748775,3578748775,0
3,1283,32293,3578748775,3578748775,0
3,1283,32294,3578748775,3578748775,0
3,1283,32295,3578748775,3578748775,0
3,1283,32296,3578748775,3578748775,0
3,1283,32297,3578748775,3578748775,0
3,1283,32298,3578748775,3578748775,0
3,1283,32299,3578748775,3578748775,0
3,1283,32300,3578748775,3578748780,5
3,1283,32301,3578748775,3578748783,8
3,1283,32302,3578748775,3578748783,8
3,1283,32303,3578748775,3578748785,10
3,1283,32304,3578748775,3578748786,11
3,1283,32305,3578748775,3578748786,11
3,1283,32306,3578748775,3578748787,12
3,1283,32307,3578748775,3578748787,12
3,1283,32308,3578748775,3578748787,12
3,1283,32309,3578748775,3578748788,13
3,1283,32310,3578748775,3578748788,13
3,1283,32311,3578748775,3578748789,14
3,1283,32312,3578748775,3578748789,14
3,1283,32313,3578748775,3578748790,15
3,1283,32314,3578748775,3578748791,16
3,1283,32315,3578748775,3578748791,16
3,1283,32316,3578748775,3578748793,18
3,1283,32317,3578748775,3578748794,19
3,1283,32318,3578748775,3578748794,19
3,1283,32319,3578748775,3578748796,21
3,1283,32320,3578748775,3578748797,22
3,1283,32321,3578748775,3578748799,24
3,1283,32322,3578748775,3578748800,25
3,1283,32323,3578748775,3578748802,27
3,1283,32324,3578748775,3578748803,28
3,1283,32325,3578748775,3578748803,28
3,1283,32326,3578748775,3578748804,29
3,1283,32327,3578748775,3578748804,29
3,1283,32328,3578748775,3578748805,30
3,1283,32329,3578748775,3578748806,31
3,1283,32330,3578748775,3578748807,32
3,1283,32331,3578748775,3578748807,32
3,1283,32332,3578748775,3578748808,33
3,1283,32333,3578748775,3578748808,33
3,1283,32334,3578748775,3578748808,33
3,1283,32335,3578748775,3578748811,36
3,1283,32336,3578748775,3578748813,38
3,1283,32337,3578748775,3578748814,39
3,1283,32338,3578748775,3578748815,40
3,1283,32339,3578748775,3578748815,40
3,1283,32340,3578748775,3578748817,42
3,1283,32341,3578748775,3578748817,42
3,1283,32342,3578748775,3578748820,45
3,1283,32343,3578748775,3578748820,45
3,1283,32344,3578748775,3578748824,49
3,1283,32345,3578748775,3578748824,49
3,1284,32346,3578748837,3578748837,0
3,1284,32347,3578748837,3578748837,0
3,1284,32348,3578748837,3578748837,0
3,1284,32349,3578748837,3578748837,0
3,1284,32350,3578748837,3578748837,0
3,1284,32351,3578748837,3578748837,0
3,1284,32352,3578748837,3578748837,0
3,1284,32353,3578748837,3578748837,0
3,1284,32354,3578748837,3578748838,1
3,1284,32355,3578748837,3578748838,1
3,1284,32356,3578748837,3578748838,1
3,1284,32357,3578748837,3578748838,1
3,1284,32358,3578748837,3578748838,1
3,1284,32359,3578748837,3578748838,1
3,1284,32360,3578748837,3578748838,1
3,1284,32361,3578748837,3578748838,1
3,1284,32362,3578748837,3578748839,2
3,1284,32363,3578748837,3578748839,2
3,1284,32364,3578748837,3578748841,4
3,1284,32365,3578748837,3578748842,5
3,1284,32366,3578748837,3578748843,6
3,1284,32367,3578748837,3578748844,7
3,1284,32368,3578748837,3578748845,8
3,1284,32369,3578748837,3578748846,9
3,1284,32370,3578748837,3578748847,10
3,1284,32371,3578748837,3578748847,10
3,1284,32372,3578748837,3578748851,14
3,1284,32373,3578748837,3578748851,14
3,1284,32374,3578748837,3578748854,17
3,1284,32375,3578748837,3578748854,17
3,1284,32376,3578748837,3578748855,18
3,1284,32377,3578748837,3578748857,20
3,1284,32378,3578748837,3578748858,21
3,1284,32379,3578748837,3578748860,23
3,1284,32380,3578748837,3578748862,25
3,1284,32381,3578748837,3578748863,26
3,1284,32382,3578748837,3578748863,26
3,1284,32383,3578748837,3578748868,31
3,1284,32384,3578748837,3578748873,36
3,1284,32385,3578748837,3578748876,39
3,1284,32386,3578748837,3578748876,39
3,1284,32387,3578748837,3578748879,42
3,1284,32388,3578748837,3578748881,44
3,1284,32389,3578748837,3578748882,45
3,1284,32390,3578748837,3578748883,46
3,1284,32391,3578748837,3578748884,47
3,1284,32392,3578748837,3578748886,49
3,1284,32393,3578748837,3578748886,49
3,1284,32394,3578748837,3578748887,50
3,1285,32395,3578748899,3578748899,0
3,1285,32396,3578748899,3578748899,0
3,1285,32397,3578748899,3578748899,0
3,1285,32398,3578748899,3578748899,0
3,1285,32399,3578748899,3578748899,0
3,1285,32400,3578748899,3578748899,0
3,1285,32401,3578748899,3578748899,0
3,1285,32402,3578748899,3578748899,0
3,1285,32403,3578748899,3578748899,0
3,1285,32404,3578748899,3578748899,0
3,1285,32405,3578748899,3578748899,0
3,1285,32406,3578748899,3578748900,1
3,1285,32407,3578748899,3578748901,2
3,1285,32408,3578748899,3578748902,3
3,1285,32409,3578748899,3578748902,3
3,1285,32410,3578748899,3578748904,5
3,1285,32411,3578748899,3578748904,5
3,1285,32412,3578748899,3578748905,6
3,1285,32413,3578748899,3578748907,8
3,1285,32414,3578748899,3578748907,8
3,1285,32415,3578748899,3578748908,9
3,1285,32416,3578748899,3578748909,10
3,1285,32417,3578748899,3578748910,11
3,1285,32418,3578748899,3578748915,16
3,1285,32419,3578748899,3578748916,17
3,1285,32420,3578748899,3578748917,18
3,1285,32421,3578748899,3578748918,19
3,1285,32422,3578748899,3578748918,19
3,1285,32423,3578748899,3578748918,19
3,1285,32424,3578748899,3578748920,21
3,1285,32425,3578748899,3578748920,21
3,1285,32426,3578748899,3578748921,22
3,1285,32427,3578748899,3578748922,23
3,1285,32428,3578748899,3578748922,23
3,1285,32429,3578748899,3578748928,29
3,1285,32430,3578748899,3578748931,32
3,1285,32431,3578748899,3578748935,36
3,1285,32432,3578748899,3578748936,37
3,1285,32433,3578748899,3578748937,38
3,1285,32434,3578748899,3578748938,39
3,1285,32435,3578748899,3578748938,39
3,1285,32436,3578748899,3578748939,40
3,1285,32437,3578748899,3578748939,40
3,1285,32438,3578748899,3578748939,40
3,1285,32439,3578748899,3578748939,40
3,1285,32440,3578748899,3578748941,42
3,1285,32441,3578748899,3578748943,44
3,1285,32442,3578748899,3578748944,45
3,1285,32443,3578748899,3578748945,46
3,1285,32444,3578748899,3578748947,48
3,1285,32445,3578748899,3578748948,49
3,1286,32446,3578748961,3578748961,0
3,1286,32447,3578748961,3578748961,0
3,1286,32448,3578748961,3578748961,0
3,1286,32449,3578748961,3578748961,0
3,1286,32450,3578748961,3578748961,0
3,1286,32451,3578748961,3578748961,0
3,1286,32452,3578748961,3578748961,0
3,1286,32453,3578748961,3578748961,0
3,1286,32454,3578748961,3578748961,0
3,1286,32455,3578748961,3578748961,0
3,1286,32456,3578748961,3578748961,0
3,1286,32457,3578748961,3578748961,0
3,1286,32458,3578748961,3578748964,3
3,1286,32459,3578748961,3578748964,3
3,1286,32460,3578748961,3578748965,4
3,1286,32461,3578748961,3578748965,4
3,1286,32462,3578748961,3578748966,5
3,1286,32463,3578748961,3578748967,6
3,1286,32464,3578748961,3578748968,7
3,1286,32465,3578748961,3578748968,7
3,1286,32466,3578748961,3578748969,8
3,1286,32467,3578748961,3578748969,8
3,1286,32468,3578748961,3578748970,9
3,1286,32469,3578748961,3578748970,9
3,1286,32470,3578748961,3578748971,10
3,1286,32471,3578748961,3578748971,10
3,1286,32472,3578748961,3578748972,11
3,1286,32473,3578748961,3578748973,12
3,1286,32474,3578748961,3578748974,13
3,1286,32475,3578748961,3578748975,14
3,1286,32476,3578748961,3578748975,14
3,1286,32477,3578748961,3578748980,19
3,1286,32478,3578748961,3578748983,22
3,1286,32479,3578748961,3578748983,22
3,1286,32480,3578748961,3578748985,24
3,1286,32481,3578748961,3578748985,24
3,1286,32482,3578748961,3578748986,25
3,1286,32483,3578748961,3578748986,25
3,1286,32484,3578748961,3578748987,26
3,1286,32485,3578748961,3578748987,26
3,1286,32486,3578748961,3578748987,26
3,1286,32487,3578748961,3578748987,26
3,1286,32488,3578748961,3578748988,27
3,1286,32489,3578748961,3578748988,27
3,1286,32490,3578748961,3578748988,27
3,1286,32491,3578748961,3578748988,27
3,1286,32492,3578748961,3578748991,30
3,1286,32493,3578748961,3578748992,31
3,1286,32494,3578748961,3578748994,33
3,1286,32495,3578748961,3578748995,34
3,1286,32496,3578748961,3578748997,36
3,1286,32497,3578748961,3578748999,38
3,1286,32498,3578748961,3578749001,40
3,1286,32499,3578748961,3578749002,41
3,1286,32500,3578748961,3578749002,41
3,1286,32501,3578748961,3578749003,42
3,1286,32502,3578748961,3578749004,43
3,1286,32503,3578748961,3578749004,43
3,1286,32504,3578748961,3578749005,44
3,1286,32505,3578748961,3578749006,45
3,1286,32506,3578748961,3578749007,46
3,1286,32507,3578748961,3578749007,46
3,1286,32508,3578748961,3578749007,46
3,1286,32509,3578748961,3578749009,48
3,1286,32510,3578748961,3578749009,48
3,1287,32511,3578749024,3578749024,0
3,1287,32512,3578749024,3578749024,0
3,1287,32513,3578749024,3578749024,0
3,1287,32514,3578749024,3578749024,0
3,1287,32515,3578749024,3578749024,0
3,1287,32516,3578749024,3578749024,0
3,1287,32517,3578749024,3578749024,0
3,1287,32518,3578749024,3578749024,0
3,1287,32519,3578749024,3578749024,0
3,1287,32520,3578749024,3578749025,1
3,1287,32521,3578749024,3578749025,1
3,1287,32522,3578749024,3578749026,2
3,1287,32523,3578749024,3578749026,2
3,1287,32524,3578749024,3578749027,3
3,1287,32525,3578749024,3578749027,3
3,1287,32526,3578749024,3578749027,3
3,1287,32527,3578749024,3578749029,5
3,1287,32528,3578749024,3578749029,5
3,1287,32529,3578749024,3578749030,6
3,1287,32530,3578749024,3578749030,6
3,1287,32531,3578749024,3578749031,7
3,1287,32532,3578749024,3578749033,9
3,1287,32533,3578749024,3578749033,9
3,1287,32534,3578749024,3578749033,9
3,1287,32535,3578749024,3578749035,11
3,1287,32536,3578749024,3578749036,12
3,1287,32537,3578749024,3578749037,13
3,1287,32538,3578749024,3578749038,14
3,1287,32539,3578749024,3578749038,14
3,1287,32540,3578749024,3578749040,16
3,1287,32541,3578749024,3578749040,16
3,1287,32542,3578749024,3578749041,17
3,1287,32543,3578749024,3578749043,19
3,1287,32544,3578749024,3578749044,20
3,1287,32545,3578749024,3578749045,21
3,1287,32546,3578749024,3578749045,21
3,1287,32547,3578749024,3578749046,22
3,1287,32548,3578749024,3578749046,22
3,1287,32549,3578749024,3578749049,25
3,1287,32550,3578749024,3578749051,27
3,1287,32551,3578749024,3578749052,28
3,1287,32552,3578749024,3578749053,29
3,1287,32553,3578749024,3578749054,30
3,1287,32554,3578749024,3578749056,32
3,1287,32555,3578749024,3578749057,33
3,1287,32556,3578749024,3578749058,34
3,1287,32557,3578749024,3578749060,36
3,1287,32558,3578749024,3578749061,37
3,1287,32559,3578749024,3578749062,38
3,1287,32560,3578749024,3578749063,39
3,1287,32561,3578749024,3578749064,40
3,1287,32562,3578749024,3578749064,40
3,1287,32563,3578749024,3578749069,45
3,1287,32564,3578749024,3578749073,49
3,1288,32565,3578749087,3578749087,0
3,1288,32566,3578749087,3578749087,0
3,1288,32567,3578749087,3578749087,0
3,1288,32568,3578749087,3578749087,0
3,1288,32569,3578749087,3578749087,0
3,1288,32570,3578749087,3578749087,0
3,1288,32571,3578749087,3578749087,0
3,1288,32572,3578749087,3578749087,0
3,1288,32573,3578749087,3578749087,0
3,1288,32574,3578749087,3578749089,2
3,1288,32575,3578749087,3578749090,3
3,1288,32576,3578749087,3578749091,4
3,1288,32577,3578749087,3578749091,4
3,1288,32578,3578749087,3578749093,6
3,1288,32579,3578749087,3578749094,7
3,1288,32580,3578749087,3578749095,8
3,1288,32581,3578749087,3578749095,8
3,1288,32582,3578749087,3578749095,8
3,1288,32583,3578749087,3578749097,10
3,1288,32584,3578749087,3578749098,11
3,1288,32585,3578749087,3578749100,13
3,1288,32586,3578749087,3578749101,14
3,1288,32587,3578749087,3578749103,16
3,1288,32588,3578749087,3578749104,17
3,1288,32589,3578749087,3578749105,18
3,1288,32590,3578749087,3578749107,20
3,1288,32591,3578749087,3578749107,20
3,1288,32592,3578749087,3578749108,21
3,1288,32593,3578749087,3578749109,22
3,1288,32594,3578749087,3578749110,23
3,1288,32595,3578749087,3578749116,29
3,1288,32596,3578749087,3578749116,29
3,1288,32597,3578749087,3578749118,31
3,1288,32598,3578749087,3578749118,31
3,1288,32599,3578749087,3578749118,31
3,1288,32600,3578749087,3578749118,31
3,1288,32601,3578749087,3578749120,33
3,1288,32602,3578749087,3578749121,34
3,1288,32603,3578749087,3578749121,34
3,1288,32604,3578749087,3578749122,35
3,1288,32605,3578749087,3578749123,36
3,1288,32606,3578749087,3578749126,39
3,1288,32607,3578749087,3578749128,41
3,1288,32608,3578749087,3578749131,44
3,1288,32609,3578749087,3578749135,48
3,1288,32610,3578749087,3578749137,50
3,1289,32611,3578749150,3578749150,0
3,1289,32612,3578749150,3578749150,0
3,1289,32613,3578749150,3578749150,0
3,1289,32614,3578749150,3578749150,0
3,1289,32615,3578749150,3578749150,0
3,1289,32616,3578749150,3578749150,0
3,1289,32617,3578749150,3578749150,0
3,1289,32618,3578749150,3578749150,0
3,1289,32619,3578749150,3578749150,0
3,1289,32620,3578749150,3578749150,0
3,1289,32621,3578749150,3578749150,0
3,1289,32622,3578749150,3578749150,0
3,1289,32623,3578749150,3578749150,0
3,1289,32624,3578749150,3578749151,1
3,1289,32625,3578749150,3578749152,2
3,1289,32626,3578749150,3578749152,2
3,1289,32627,3578749150,3578749153,3
3,1289,32628,3578749150,3578749153,3
3,1289,32629,3578749150,3578749155,5
3,1289,32630,3578749150,3578749156,6
3,1289,32631,3578749150,3578749157,7
3,1289,32632,3578749150,3578749157,7
3,1289,32633,3578749150,3578749157,7
3,1289,32634,3578749150,3578749158,8
3,1289,32635,3578749150,3578749160,10
3,1289,32636,3578749150,3578749164,14
3,1289,32637,3578749150,3578749164,14
3,1289,32638,3578749150,3578749166,16
3,1289,32639,3578749150,3578749166,16
3,1289,32640,3578749150,3578749166,16
3,1289,32641,3578749150,3578749168,18
3,1289,32642,3578749150,3578749168,18
3,1289,32643,3578749150,3578749168,18
3,1289,32644,3578749150,3578749169,19
3,1289,32645,3578749150,3578749169,19
3,1289,32646,3578749150,3578749170,20
3,1289,32647,3578749150,3578749171,21
3,1289,32648,3578749150,3578749172,22
3,1289,32649,3578749150,3578749173,23
3,1289,32650,3578749150,3578749174,24
3,1289,32651,3578749150,3578749174,24
3,1289,32652,3578749150,3578749176,26
3,1289,32653,3578749150,3578749179,29
3,1289,32654,3578749150,3578749183,33
3,1289,32655,3578749150,3578749184,34
3,1289,32656,3578749150,3578749185,35
3,1289,32657,3578749150,3578749186,36
3,1289,32658,3578749150,3578749187,37
3,1289,32659,3578749150,3578749187,37
3,1289,32660,3578749150,3578749187,37
3,1289,32661,3578749150,3578749187,37
3,1289,32662,3578749150,3578749188,38
3,1289,32663,3578749150,3578749188,38
3,1289,32664,3578749150,3578749188,38
3,1289,32665,3578749150,3578749188,38
3,1289,32666,3578749150,3578749189,39
3,1289,32667,3578749150,3578749189,39
3,1289,32668,3578749150,3578749190,40
3,1289,32669,3578749150,3578749191,41
3,1289,32670,3578749150,3578749192,42
3,1289,32671,3578749150,3578749194,44
3,1289,32672,3578749150,3578749194,44
3,1289,32673,3578749150,3578749196,46
3,1289,32674,3578749150,3578749197,47
3,1289,32675,3578749150,3578749199,49
3,1290,32676,3578749212,3578749212,0
3,1290,32677,3578749212,3578749212,0
3,1290,32678,3578749212,3578749212,0
3,1290,32679,3578749212,3578749212,0
3,1290,32680,3578749212,3578749212,0
3,1290,32681,3578749212,3578749212,0
3,1290,32682,3578749212,3578749212,0
3,1290,32683,3578749212,3578749212,0
3,1290,32684,3578749212,3578749212,0
3,1290,32685,3578749212,3578749212,0
3,1290,32686,3578749212,3578749212,0
3,1290,32687,3578749212,3578749212,0
3,1290,32688,3578749212,3578749212,0
3,1290,32689,3578749212,3578749213,1
3,1290,32690,3578749212,3578749214,2
3,1290,32691,3578749212,3578749215,3
3,1290,32692,3578749212,3578749215,3
3,1290,32693,3578749212,3578749215,3
3,1290,32694,3578749212,3578749217,5
3,1290,32695,3578749212,3578749217,5
3,1290,32696,3578749212,3578749220,8
3,1290,32697,3578749212,3578749221,9
3,1290,32698,3578749212,3578749221,9
3,1290,32699,3578749212,3578749224,12
3,1290,32700,3578749212,3578749225,13
3,1290,32701,3578749212,3578749226,14
3,1290,32702,3578749212,3578749227,15
3,1290,32703,3578749212,3578749227,15
3,1290,32704,3578749212,3578749227,15
3,1290,32705,3578749212,3578749228,16
3,1290,32706,3578749212,3578749228,16
3,1290,32707,3578749212,3578749228,16
3,1290,32708,3578749212,3578749229,17
3,1290,32709,3578749212,3578749230,18
3,1290,32710,3578749212,3578749231,19
3,1290,32711,3578749212,3578749232,20
3,1290,32712,3578749212,3578749232,20
3,1290,32713,3578749212,3578749233,21
3,1290,32714,3578749212,3578749233,21
3,1290,32715,3578749212,3578749236,24
3,1290,32716,3578749212,3578749237,25
3,1290,32717,3578749212,3578749237,25
3,1290,32718,3578749212,3578749238,26
3,1290,32719,3578749212,3578749238,26
3,1290,32720,3578749212,3578749239,27
3,1290,32721,3578749212,3578749241,29
3,1290,32722,3578749212,3578749241,29
3,1290,32723,3578749212,3578749242,30
3,1290,32724,3578749212,3578749243,31
3,1290,32725,3578749212,3578749244,32
3,1290,32726,3578749212,3578749245,33
3,1290,32727,3578749212,3578749246,34
3,1290,32728,3578749212,3578749247,35
3,1290,32729,3578749212,3578749250,38
3,1290,32730,3578749212,3578749251,39
3,1290,32731,3578749212,3578749252,40
3,1290,32732,3578749212,3578749253,41
3,1290,32733,3578749212,3578749254,42
3,1290,32734,3578749212,3578749257,45
3,1290,32735,3578749212,3578749257,45
3,1290,32736,3578749212,3578749257,45
3,1290,32737,3578749212,3578749257,45
3,1290,32738,3578749212,3578749261,49
3,1290,32739,3578749212,3578749261,49
3,1290,32740,3578749212,3578749261,49
3,1291,32741,3578749275,3578749275,0
3,1291,32742,3578749275,3578749275,0
3,1291,32743,3578749275,3578749275,0
3,1291,32744,3578749275,3578749275,0
3,1291,32745,3578749275,3578749275,0
3,1291,32746,3578749275,3578749277,2
3,1291,32747,3578749275,3578749278,3
3,1291,32748,3578749275,3578749279,4
3,1291,32749,3578749275,3578749281,6
3,1291,32750,3578749275,3578749282,7
3,1291,32751,3578749275,3578749283,8
3,1291,32752,3578749275,3578749284,9
3,1291,32753,3578749275,3578749286,11
3,1291,32754,3578749275,3578749286,11
3,1291,32755,3578749275,3578749287,12
3,1291,32756,3578749275,3578749289,14
3,1291,32757,3578749275,3578749291,16
3,1291,32758,3578749275,3578749292,17
3,1291,32759,3578749275,3578749293,18
3,1291,32760,3578749275,3578749293,18
3,1291,32761,3578749275,3578749294,19
3,1291,32762,3578749275,3578749295,20
3,1291,32763,3578749275,3578749296,21
3,1291,32764,3578749275,3578749298,23
3,1291,32765,3578749275,3578749298,23
3,1291,32766,3578749275,3578749298,23
3,1291,32767,3578749275,3578749301,26
3,1291,32768,3578749275,3578749301,26
3,1291,32769,3578749275,3578749303,28
3,1291,32770,3578749275,3578749303,28
3,1291,32771,3578749275,3578749304,29
3,1291,32772,3578749275,3578749305,30
3,1291,32773,3578749275,3578749307,32
3,1291,32774,3578749275,3578749308,33
3,1291,32775,3578749275,3578749308,33
3,1291,32776,3578749275,3578749309,34
3,1291,32777,3578749275,3578749310,35
3,1291,32778,3578749275,3578749315,40
3,1291,32779,3578749275,3578749316,41
3,1291,32780,3578749275,3578749317,42
3,1291,32781,3578749275,3578749317,42
3,1291,32782,3578749275,3578749318,43
3,1291,32783,3578749275,3578749318,43
3,1291,32784,3578749275,3578749320,45
3,1291,32785,3578749275,3578749321,46
3,1291,32786,3578749275,3578749322,47
3,1291,32787,3578749275,3578749323,48
3,1292,32788,3578749337,3578749337,0
3,1292,32789,3578749337,3578749337,0
3,1292,32790,3578749337,3578749337,0
3,1292,32791,3578749337,3578749337,0
3,1292,32792,3578749337,3578749337,0
3,1292,32793,3578749337,3578749338,1
3,1292,32794,3578749337,3578749338,1
3,1292,32795,3578749337,3578749338,1
3,1292,32796,3578749337,3578749339,2
3,1292,32797,3578749337,3578749339,2
3,1292,32798,3578749337,3578749339,2
3,1292,32799,3578749337,3578749342,5
3,1292,32800,3578749337,3578749345,8
3,1292,32801,3578749337,3578749345,8
3,1292,32802,3578749337,3578749347,10
3,1292,32803,3578749337,3578749348,11
3,1292,32804,3578749337,3578749350,13
3,1292,32805,3578749337,3578749352,15
3,1292,32806,3578749337,3578749352,15
3,1292,32807,3578749337,3578749353,16
3,1292,32808,3578749337,3578749354,17
3,1292,32809,3578749337,3578749354,17
3,1292,32810,3578749337,3578749355,18
3,1292,32811,3578749337,3578749355,18
3,1292,32812,3578749337,3578749358,21
3,1292,32813,3578749337,3578749358,21
3,1292,32814,3578749337,3578749358,21
3,1292,32815,3578749337,3578749358,21
3,1292,32816,3578749337,3578749360,23
3,1292,32817,3578749337,3578749364,27
3,1292,32818,3578749337,3578749366,29
3,1292,32819,3578749337,3578749366,29
3,1292,32820,3578749337,3578749367,30
3,1292,32821,3578749337,3578749368,31
3,1292,32822,3578749337,3578749369,32
3,1292,32823,3578749337,3578749369,32
3,1292,32824,3578749337,3578749369,32
3,1292,32825,3578749337,3578749369,32
3,1292,32826,3578749337,3578749371,34
3,1292,32827,3578749337,3578749371,34
3,1292,32828,3578749337,3578749372,35
3,1292,32829,3578749337,3578749373,36
3,1292,32830,3578749337,3578749374,37
3,1292,32831,3578749337,3578749376,39
3,1292,32832,3578749337,3578749380,43
3,1292,32833,3578749337,3578749383,46
3,1292,32834,3578749337,3578749384,47
3,1292,32835,3578749337,3578749385,48
3,1292,32836,3578749337,3578749385,48
3,1292,32837,3578749337,3578749387,50
3,1293,32838,3578749400,3578749400,0
3,1293,32839,3578749400,3578749400,0
3,1293,32840,3578749400,3578749400,0
3,1293,32841,3578749400,3578749400,0
3,1293,32842,3578749400,3578749400,0
3,1293,32843,3578749400,3578749400,0
3,1293,32844,3578749400,3578749400,0
3,1293,32845,3578749400,3578749400,0
3,1293,32846,3578749400,3578749400,0
3,1293,32847,3578749400,3578749400,0
3,1293,32848,3578749400,3578749400,0
3,1293,32849,3578749400,3578749400,0
3,1293,32850,3578749400,3578749400,0
3,1293,32851,3578749400,3578749400,0
3,1293,32852,3578749400,3578749400,0
3,1293,32853,3578749400,3578749400,0
3,1293,32854,3578749400,3578749400,0
3,1293,32855,3578749400,3578749402,2
3,1293,32856,3578749400,3578749402,2
3,1293,32857,3578749400,3578749403,3
3,1293,32858,3578749400,3578749403,3
3,1293,32859,3578749400,3578749404,4
3,1293,32860,3578749400,3578749404,4
3,1293,32861,3578749400,3578749405,5
3,1293,32862,3578749400,3578749406,6
3,1293,32863,3578749400,3578749406,6
3,1293,32864,3578749400,3578749407,7
3,1293,32865,3578749400,3578749407,7
3,1293,32866,3578749400,3578749408,8
3,1293,32867,3578749400,3578749408,8
3,1293,32868,3578749400,3578749409,9
3,1293,32869,3578749400,3578749410,10
3,1293,32870,3578749400,3578749413,13
3,1293,32871,3578749400,3578749414,14
3,1293,32872,3578749400,3578749414,14
3,1293,32873,3578749400,3578749415,15
3,1293,32874,3578749400,3578749415,15
3,1293,32875,3578749400,3578749416,16
3,1293,32876,3578749400,3578749417,17
3,1293,32877,3578749400,3578749417,17
3,1293,32878,3578749400,3578749421,21
3,1293,32879,3578749400,3578749421,21
3,1293,32880,3578749400,3578749424,24
3,1293,32881,3578749400,3578749425,25
3,1293,32882,3578749400,3578749426,26
3,1293,32883,3578749400,3578749427,27
3,1293,32884,3578749400,3578749427,27
3,1293,32885,3578749400,3578749427,27
3,1293,32886,3578749400,3578749427,27
3,1293,32887,3578749400,3578749427,27
3,1293,32888,3578749400,3578749428,28
3,1293,32889,3578749400,3578749429,29
3,1293,32890,3578749400,3578749430,30
3,1293,32891,3578749400,3578749431,31
3,1293,32892,3578749400,3578749432,32
3,1293,32893,3578749400,3578749432,32
3,1293,32894,3578749400,3578749432,32
3,1293,32895,3578749400,3578749434,34
3,1293,32896,3578749400,3578749436,36
3,1293,32897,3578749400,3578749436,36
3,1293,32898,3578749400,3578749436,36
3,1293,32899,3578749400,3578749438,38
3,1293,32900,3578749400,3578749438,38
3,1293,32901,3578749400,3578749441,41
3,1293,32902,3578749400,3578749442,42
3,1293,32903,3578749400,3578749443,43
3,1293,32904,3578749400,3578749443,43
3,1293,32905,3578749400,3578749443,43
3,1293,32906,3578749400,3578749445,45
3,1293,32907,3578749400,3578749446,46
3,1293,32908,3578749400,3578749446,46
3,1293,32909,3578749400,3578749446,46
3,1293,32910,3578749400,3578749449,49
3,1293,32911,3578749400,3578749450,50
3,1294,32912,3578749463,3578749463,0
3,1294,32913,3578749463,3578749463,0
3,1294,32914,3578749463,3578749463,0
3,1294,32915,3578749463,3578749463,0
3,1294,32916,3578749463,3578749463,0
3,1294,32917,3578749463,3578749463,0
3,1294,32918,3578749463,3578749463,0
3,1294,32919,3578749463,3578749463,0
3,1294,32920,3578749463,3578749463,0
3,1294,32921,3578749463,3578749463,0
3,1294,32922,3578749463,3578749463,0
3,1294,32923,3578749463,3578749464,1
3,1294,32924,3578749463,3578749465,2
3,1294,32925,3578749463,3578749469,6
3,1294,32926,3578749463,3578749474,11
3,1294,32927,3578749463,3578749477,14
3,1294,32928,3578749463,3578749478,15
3,1294,32929,3578749463,3578749479,16
3,1294,32930,3578749463,3578749481,18
3,1294,32931,3578749463,3578749483,20
3,1294,32932,3578749463,3578749483,20
3,1294,32933,3578749463,3578749484,21
3,1294,32934,3578749463,3578749486,23
3,1294,32935,3578749463,3578749487,24
3,1294,32936,3578749463,3578749487,24
3,1294,32937,3578749463,3578749489,26
3,1294,32938,3578749463,3578749492,29
3,1294,32939,3578749463,3578749494,31
3,1294,32940,3578749463,3578749495,32
3,1294,32941,3578749463,3578749495,32
3,1294,32942,3578749463,3578749496,33
3,1294,32943,3578749463,3578749497,34
3,1294,32944,3578749463,3578749498,35
3,1294,32945,3578749463,3578749498,35
3,1294,32946,3578749463,3578749500,37
3,1294,32947,3578749463,3578749502,39
3,1294,32948,3578749463,3578749503,40
3,1294,32949,3578749463,3578749504,41
3,1294,32950,3578749463,3578749504,41
3,1294,32951,3578749463,3578749505,42
3,1294,32952,3578749463,3578749507,44
3,1294,32953,3578749463,3578749507,44
3,1294,32954,3578749463,3578749508,45
3,1294,32955,3578749463,3578749509,46
3,1295,32956,3578749525,3578749525,0
3,1295,32957,3578749525,3578749525,0
3,1295,32958,3578749525,3578749525,0
3,1295,32959,3578749525,3578749525,0
3,1295,32960,3578749525,3578749525,0
3,1295,32961,3578749525,3578749525,0
3,1295,32962,3578749525,3578749525,0
3,1295,32963,3578749525,3578749525,0
3,1295,32964,3578749525,3578749525,0
3,1295,32965,3578749525,3578749525,0
3,1295,32966,3578749525,3578749525,0
3,1295,32967,3578749525,3578749529,4
3,1295,32968,3578749525,3578749532,7
3,1295,32969,3578749525,3578749533,8
3,1295,32970,3578749525,3578749536,11
3,1295,32971,3578749525,3578749537,12
3,1295,32972,3578749525,3578749538,13
3,1295,32973,3578749525,3578749538,13
3,1295,32974,3578749525,3578749538,13
3,1295,32975,3578749525,3578749538,13
3,1295,32976,3578749525,3578749539,14
3,1295,32977,3578749525,3578749541,16
3,1295,32978,3578749525,3578749544,19
3,1295,32979,3578749525,3578749545,20
3,1295,32980,3578749525,3578749546,21
3,1295,32981,3578749525,3578749549,24
3,1295,32982,3578749525,3578749549,24
3,1295,32983,3578749525,3578749550,25
3,1295,32984,3578749525,3578749551,26
3,1295,32985,3578749525,3578749551,26
3,1295,32986,3578749525,3578749553,28
3,1295,32987,3578749525,3578749553,28
3,1295,32988,3578749525,3578749554,29
3,1295,32989,3578749525,3578749555,30
3,1295,32990,3578749525,3578749556,31
3,1295,32991,3578749525,3578749556,31
3,1295,32992,3578749525,3578749557,32
3,1295,32993,3578749525,3578749557,32
3,1295,32994,3578749525,3578749559,34
3,1295,32995,3578749525,3578749563,38
3,1295,32996,3578749525,3578749564,39
3,1295,32997,3578749525,3578749566,41
3,1295,32998,3578749525,3578749567,42
3,1295,32999,3578749525,3578749568,43
3,1295,33000,3578749525,3578749568,43
3,1295,33001,3578749525,3578749568,43
3,1295,33002,3578749525,3578749570,45
3,1295,33003,3578749525,3578749570,45
3,1295,33004,3578749525,3578749572,47
3,1295,33005,3578749525,3578749572,47
3,1295,33006,3578749525,3578749574,49
3,1296,33007,3578749588,3578749588,0
3,1296,33008,3578749588,3578749588,0
3,1296,33009,3578749588,3578749588,0
3,1296,33010,3578749588,3578749588,0
3,1296,33011,3578749588,3578749588,0
3,1296,33012,3578749588,3578749588,0
3,1296,33013,3578749588,3578749588,0
3,1296,33014,3578749588,3578749588,0
3,1296,33015,3578749588,3578749588,0
3,1296,33016,3578749588,3578749588,0
3,1296,33017,3578749588,3578749588,0
3,1296,33018,3578749588,3578749588,0
3,1296,33019,3578749588,3578749588,0
3,1296,33020,3578749588,3578749588,0
3,1296,33021,3578749588,3578749588,0
3,1296,33022,3578749588,3578749590,2
3,1296,33023,3578749588,3578749590,2
3,1296,33024,3578749588,3578749590,2
3,1296,33025,3578749588,3578749592,4
3,1296,33026,3578749588,3578749593,5
3,1296,33027,3578749588,3578749593,5
3,1296,33028,3578749588,3578749596,8
3,1296,33029,3578749588,3578749596,8
3,1296,33030,3578749588,3578749596,8
3,1296,33031,3578749588,3578749599,11
3,1296,33032,3578749588,3578749601,13
3,1296,33033,3578749588,3578749602,14
3,1296,33034,3578749588,3578749603,15
3,1296,33035,3578749588,3578749604,16
3,1296,33036,3578749588,3578749604,16
3,1296,33037,3578749588,3578749604,16
3,1296,33038,3578749588,3578749604,16
3,1296,33039,3578749588,3578749605,17
3,1296,33040,3578749588,3578749606,18
3,1296,33041,3578749588,3578749607,19
3,1296,33042,3578749588,3578749607,19
3,1296,33043,3578749588,3578749607,19
3,1296,33044,3578749588,3578749608,20
3,1296,33045,3578749588,3578749609,21
3,1296,33046,3578749588,3578749612,24
3,1296,33047,3578749588,3578749614,26
3,1296,33048,3578749588,3578749614,26
3,1296,33049,3578749588,3578749614,26
3,1296,33050,3578749588,3578749616,28
3,1296,33051,3578749588,3578749617,29
3,1296,33052,3578749588,3578749617,29
3,1296,33053,3578749588,3578749620,32
3,1296,33054,3578749588,3578749621,33
3,1296,33055,3578749588,3578749623,35
3,1296,33056,3578749588,3578749623,35
3,1296,33057,3578749588,3578749625,37
3,1296,33058,3578749588,3578749625,37
3,1296,33059,3578749588,3578749626,38
3,1296,33060,3578749588,3578749626,38
3,1296,33061,3578749588,3578749626,38
3,1296,33062,3578749588,3578749627,39
3,1296,33063,3578749588,3578749628,40
3,1296,33064,3578749588,3578749629,41
3,1296,33065,3578749588,3578749629,41
3,1296,33066,3578749588,3578749630,42
3,1296,33067,3578749588,3578749631,43
3,1296,33068,3578749588,3578749632,44
3,1296,33069,3578749588,3578749633,45
3,1296,33070,3578749588,3578749635,47
3,1296,33071,3578749588,3578749635,47
3,1296,33072,3578749588,3578749636,48
3,1296,33073,3578749588,3578749636,48
3,1296,33074,3578749588,3578749637,49
3,1297,33075,3578749651,3578749651,0
3,1297,33076,3578749651,3578749651,0
3,1297,33077,3578749651,3578749651,0
3,1297,33078,3578749651,3578749651,0
3,1297,33079,3578749651,3578749651,0
3,1297,33080,3578749651,3578749651,0
3,1297,33081,3578749651,3578749651,0
3,1297,33082,3578749651,3578749651,0
3,1297,33083,3578749651,3578749651,0
3,1297,33084,3578749651,3578749651,0
3,1297,33085,3578749651,3578749651,0
3,1297,33086,3578749651,3578749651,0
3,1297,33087,3578749651,3578749651,0
3,1297,33088,3578749651,3578749651,0
3,1297,33089,3578749651,3578749651,0
3,1297,33090,3578749651,3578749651,0
3,1297,33091,3578749651,3578749653,2
3,1297,33092,3578749651,3578749653,2
3,1297,33093,3578749651,3578749656,5
3,1297,33094,3578749651,3578749656,5
3,1297,33095,3578749651,3578749657,6
3,1297,33096,3578749651,3578749657,6
3,1297,33097,3578749651,3578749660,9
3,1297,33098,3578749651,3578749660,9
3,1297,33099,3578749651,3578749661,10
3,1297,33100,3578749651,3578749663,12
3,1297,33101,3578749651,3578749663,12
3,1297,33102,3578749651,3578749664,13
3,1297,33103,3578749651,3578749668,17
3,1297,33104,3578749651,3578749673,22
3,1297,33105,3578749651,3578749677,26
3,1297,33106,3578749651,3578749678,27
3,1297,33107,3578749651,3578749679,28
3,1297,33108,3578749651,3578749681,30
3,1297,33109,3578749651,3578749682,31
3,1297,33110,3578749651,3578749683,32
3,1297,33111,3578749651,3578749684,33
3,1297,33112,3578749651,3578749686,35
3,1297,33113,3578749651,3578749687,36
3,1297,33114,3578749651,3578749687,36
3,1297,33115,3578749651,3578749689,38
3,1297,33116,3578749651,3578749691,40
3,1297,33117,3578749651,3578749693,42
3,1297,33118,3578749651,3578749693,42
3,1297,33119,3578749651,3578749694,43
3,1297,33120,3578749651,3578749695,44
3,1297,33121,3578749651,3578749697,46
3,1297,33122,3578749651,3578749697,46
3,1297,33123,3578749651,3578749698,47
3,1297,33124,3578749651,3578749698,47
3,1297,33125,3578749651,3578749698,47
3,1297,33126,3578749651,3578749701,50
3,1298,33127,3578749713,3578749713,0
3,1298,33128,3578749713,3578749713,0
3,1298,33129,3578749713,3578749713,0
3,1298,33130,3578749713,3578749713,0
3,1298,33131,3578749713,3578749713,0
3,1298,33132,3578749713,3578749713,0
3,1298,33133,3578749713,3578749713,0
3,1298,33134,3578749713,3578749713,0
3,1298,33135,3578749713,3578749713,0
3,1298,33136,3578749713,3578749713,0
3,1298,33137,3578749713,3578749714,1
3,1298,33138,3578749713,3578749715,2
3,1298,33139,3578749713,3578749717,4
3,1298,33140,3578749713,3578749718,5
3,1298,33141,3578749713,3578749718,5
3,1298,33142,3578749713,3578749718,5
3,1298,33143,3578749713,3578749720,7
3,1298,33144,3578749713,3578749721,8
3,1298,33145,3578749713,3578749723,10
3,1298,33146,3578749713,3578749725,12
3,1298,33147,3578749713,3578749731,18
3,1298,33148,3578749713,3578749734,21
3,1298,33149,3578749713,3578749736,23
3,1298,33150,3578749713,3578749736,23
3,1298,33151,3578749713,3578749738,25
3,1298,33152,3578749713,3578749738,25
3,1298,33153,3578749713,3578749739,26
3,1298,33154,3578749713,3578749741,28
3,1298,33155,3578749713,3578749746,33
3,1298,33156,3578749713,3578749746,33
3,1298,33157,3578749713,3578749748,35
3,1298,33158,3578749713,3578749748,35
3,1298,33159,3578749713,3578749751,38
3,1298,33160,3578749713,3578749751,38
3,1298,33161,3578749713,3578749752,39
3,1298,33162,3578749713,3578749753,40
3,1298,33163,3578749713,3578749754,41
3,1298,33164,3578749713,3578749756,43
3,1298,33165,3578749713,3578749757,44
3,1298,33166,3578749713,3578749757,44
3,1298,33167,3578749713,3578749757,44
3,1298,33168,3578749713,3578749760,47
3,1298,33169,3578749713,3578749763,50
3,1299,33170,3578749776,3578749776,0
3,1299,33171,3578749776,3578749776,0
3,1299,33172,3578749776,3578749776,0
3,1299,33173,3578749776,3578749776,0
3,1299,33174,3578749776,3578749776,0
3,1299,33175,3578749776,3578749776,0
3,1299,33176,3578749776,3578749776,0
3,1299,33177,3578749776,3578749776,0
3,1299,33178,3578749776,3578749776,0
3,1299,33179,3578749776,3578749776,0
3,1299,33180,3578749776,3578749776,0
3,1299,33181,3578749776,3578749776,0
3,1299,33182,3578749776,3578749776,0
3,1299,33183,3578749776,3578749776,0
3,1299,33184,3578749776,3578749776,0
3,1299,33185,3578749776,3578749779,3
3,1299,33186,3578749776,3578749782,6
3,1299,33187,3578749776,3578749784,8
3,1299,33188,3578749776,3578749784,8
3,1299,33189,3578749776,3578749785,9
3,1299,33190,3578749776,3578749786,10
3,1299,33191,3578749776,3578749786,10
3,1299,33192,3578749776,3578749787,11
3,1299,33193,3578749776,3578749787,11
3,1299,33194,3578749776,3578749788,12
3,1299,33195,3578749776,3578749788,12
3,1299,33196,3578749776,3578749788,12
3,1299,33197,3578749776,3578749789,13
3,1299,33198,3578749776,3578749790,14
3,1299,33199,3578749776,3578749790,14
3,1299,33200,3578749776,3578749790,14
3,1299,33201,3578749776,3578749792,16
3,1299,33202,3578749776,3578749794,18
3,1299,33203,3578749776,3578749795,19
3,1299,33204,3578749776,3578749796,20
3,1299,33205,3578749776,3578749797,21
3,1299,33206,3578749776,3578749799,23
3,1299,33207,3578749776,3578749801,25
3,1299,33208,3578749776,3578749801,25
3,1299,33209,3578749776,3578749802,26
3,1299,33210,3578749776,3578749802,26
3,1299,33211,3578749776,3578749804,28
3,1299,33212,3578749776,3578749804,28
3,1299,33213,3578749776,3578749804,28
3,1299,33214,3578749776,3578749805,29
3,1299,33215,3578749776,3578749805,29
3,1299,33216,3578749776,3578749805,29
3,1299,33217,3578749776,3578749807,31
3,1299,33218,3578749776,3578749807,31
3,1299,33219,3578749776,3578749808,32
3,1299,33220,3578749776,3578749809,33
3,1299,33221,3578749776,3578749812,36
3,1299,33222,3578749776,3578749814,38
3,1299,33223,3578749776,3578749814,38
3,1299,33224,3578749776,3578749815,39
3,1299,33225,3578749776,3578749815,39
3,1299,33226,3578749776,3578749817,41
3,1299,33227,3578749776,3578749817,41
3,1299,33228,3578749776,3578749820,44
3,1299,33229,3578749776,3578749821,45
3,1299,33230,3578749776,3578749823,47
3,1299,33231,3578749776,3578749824,48
3,1299,33232,3578749776,3578749824,48
3,1299,33233,3578749776,3578749825,49
3,1299,33234,3578749776,3578749826,50
3,1300,33235,3578749837,3578749838,1
3,1300,33236,3578749837,3578749838,1
3,1300,33237,3578749837,3578749838,1
3,1300,33238,3578749837,3578749838,1
3,1300,33239,3578749837,3578749838,1
3,1300,33240,3578749837,3578749838,1
3,1300,33241,3578749837,3578749838,1
3,1300,33242,3578749837,3578749838,1
3,1300,33243,3578749837,3578749838,1
3,1300,33244,3578749837,3578749838,1
3,1300,33245,3578749837,3578749838,1
3,1300,33246,3578749837,3578749838,1
3,1300,33247,3578749837,3578749838,1
3,1300,33248,3578749837,3578749838,1
3,1300,33249,3578749837,3578749840,3
3,1300,33250,3578749837,3578749841,4
3,1300,33251,3578749837,3578749841,4
3,1300,33252,3578749837,3578749842,5
3,1300,33253,3578749837,3578749843,6
3,1300,33254,3578749837,3578749843,6
3,1300,33255,3578749837,3578749844,7
3,1300,33256,3578749837,3578749844,7
3,1300,33257,3578749837,3578749845,8
3,1300,33258,3578749837,3578749845,8
3,1300,33259,3578749837,3578749845,8
3,1300,33260,3578749837,3578749846,9
3,1300,33261,3578749837,3578749849,12
3,1300,33262,3578749837,3578749850,13
3,1300,33263,3578749837,3578749851,14
3,1300,33264,3578749837,3578749853,16
3,1300,33265,3578749837,3578749853,16
3,1300,33266,3578749837,3578749856,19
3,1300,33267,3578749837,3578749857,20
3,1300,33268,3578749837,3578749858,21
3,1300,33269,3578749837,3578749858,21
3,1300,33270,3578749837,3578749860,23
3,1300,33271,3578749837,3578749861,24
3,1300,33272,3578749837,3578749863,26
3,1300,33273,3578749837,3578749863,26
3,1300,33274,3578749837,3578749864,27
3,1300,33275,3578749837,3578749874,37
3,1300,33276,3578749837,3578749878,41
3,1300,33277,3578749837,3578749878,41
3,1300,33278,3578749837,3578749879,42
3,1300,33279,3578749837,3578749881,44
3,1300,33280,3578749837,3578749882,45
3,1300,33281,3578749837,3578749883,46
3,1300,33282,3578749837,3578749884,47
3,1300,33283,3578749837,3578749885,48
3,1300,33284,3578749837,3578749886,49
3,1300,33285,3578749837,3578749887,50
3,1301,33286,3578749898,3578749898,0
3,1301,33287,3578749898,3578749898,0
3,1301,33288,3578749898,3578749898,0
3,1301,33289,3578749898,3578749898,0
3,1301,33290,3578749898,3578749898,0
3,1301,33291,3578749898,3578749898,0
3,1301,33292,3578749898,3578749898,0
3,1301,33293,3578749898,3578749898,0
3,1301,33294,3578749898,3578749898,0
3,1301,33295,3578749898,3578749898,0
3,1301,33296,3578749898,3578749898,0
3,1301,33297,3578749898,3578749901,3
3,1301,33298,3578749898,3578749903,5
3,1301,33299,3578749898,3578749904,6
3,1301,33300,3578749898,3578749904,6
3,1301,33301,3578749898,3578749905,7
3,1301,33302,3578749898,3578749905,7
3,1301,33303,3578749898,3578749907,9
3,1301,33304,3578749898,3578749907,9
3,1301,33305,3578749898,3578749907,9
3,1301,33306,3578749898,3578749910,12
3,1301,33307,3578749898,3578749910,12
3,1301,33308,3578749898,3578749914,16
3,1301,33309,3578749898,3578749915,17
3,1301,33310,3578749898,3578749918,20
3,1301,33311,3578749898,3578749918,20
3,1301,33312,3578749898,3578749918,20
3,1301,33313,3578749898,3578749918,20
3,1301,33314,3578749898,3578749920,22
3,1301,33315,3578749898,3578749921,23
3,1301,33316,3578749898,3578749922,24
3,1301,33317,3578749898,3578749923,25
3,1301,33318,3578749898,3578749924,26
3,1301,33319,3578749898,3578749931,33
3,1301,33320,3578749898,3578749934,36
3,1301,33321,3578749898,3578749937,39
3,1301,33322,3578749898,3578749937,39
3,1301,33323,3578749898,3578749938,40
3,1301,33324,3578749898,3578749939,41
3,1301,33325,3578749898,3578749939,41
3,1301,33326,3578749898,3578749939,41
3,1301,33327,3578749898,3578749941,43
3,1301,33328,3578749898,3578749943,45
3,1301,33329,3578749898,3578749946,48
3,1301,33330,3578749898,3578749946,48
3,1302,33331,3578749961,3578749961,0
3,1302,33332,3578749961,3578749961,0
3,1302,33333,3578749961,3578749961,0
3,1302,33334,3578749961,3578749961,0
3,1302,33335,3578749961,3578749961,0
3,1302,33336,3578749961,3578749961,0
3,1302,33337,3578749961,3578749961,0
3,1302,33338,3578749961,3578749961,0
3,1302,33339,3578749961,3578749961,0
3,1302,33340,3578749961,3578749961,0
3,1302,33341,3578749961,3578749961,0
3,1302,33342,3578749961,3578749961,0
3,1302,33343,3578749961,3578749961,0
3,1302,33344,3578749961,3578749964,3
3,1302,33345,3578749961,3578749965,4
3,1302,33346,3578749961,3578749965,4
3,1302,33347,3578749961,3578749966,5
3,1302,33348,3578749961,3578749966,5
3,1302,33349,3578749961,3578749966,5
3,1302,33350,3578749961,3578749968,7
3,1302,33351,3578749961,3578749968,7
3,1302,33352,3578749961,3578749969,8
3,1302,33353,3578749961,3578749969,8
3,1302,33354,3578749961,3578749969,8
3,1302,33355,3578749961,3578749969,8
3,1302,33356,3578749961,3578749971,10
3,1302,33357,3578749961,3578749972,11
3,1302,33358,3578749961,3578749973,12
3,1302,33359,3578749961,3578749974,13
3,1302,33360,3578749961,3578749974,13
3,1302,33361,3578749961,3578749976,15
3,1302,33362,3578749961,3578749979,18
3,1302,33363,3578749961,3578749983,22
3,1302,33364,3578749961,3578749984,23
3,1302,33365,3578749961,3578749984,23
3,1302,33366,3578749961,3578749984,23
3,1302,33367,3578749961,3578749986,25
3,1302,33368,3578749961,3578749986,25
3,1302,33369,3578749961,3578749987,26
3,1302,33370,3578749961,3578749987,26
3,1302,33371,3578749961,3578749988,27
3,1302,33372,3578749961,3578749988,27
3,1302,33373,3578749961,3578749988,27
3,1302,33374,3578749961,3578749988,27
3,1302,33375,3578749961,3578749988,27
3,1302,33376,3578749961,3578749989,28
3,1302,33377,3578749961,3578749990,29
3,1302,33378,3578749961,3578749991,30
3,1302,33379,3578749961,3578749991,30
3,1302,33380,3578749961,3578749995,34
3,1302,33381,3578749961,3578749995,34
3,1302,33382,3578749961,3578749997,36
3,1302,33383,3578749961,3578749999,38
3,1302,33384,3578749961,3578750001,40
3,1302,33385,3578749961,3578750001,40
3,1302,33386,3578749961,3578750002,41
3,1302,33387,3578749961,3578750002,41
3,1302,33388,3578749961,3578750005,44
3,1302,33389,3578749961,3578750005,44
3,1302,33390,3578749961,3578750005,44
3,1302,33391,3578749961,3578750005,44
3,1302,33392,3578749961,3578750006,45
3,1302,33393,3578749961,3578750007,46
3,1302,33394,3578749961,3578750008,47
3,1302,33395,3578749961,3578750008,47
3,1302,33396,3578749961,3578750008,47
3,1303,33397,3578750024,3578750024,0
3,1303,33398,3578750024,3578750024,0
3,1303,33399,3578750024,3578750024,0
3,1303,33400,3578750024,3578750024,0
3,1303,33401,3578750024,3578750024,0
3,1303,33402,3578750024,3578750024,0
3,1303,33403,3578750024,3578750024,0
3,1303,33404,3578750024,3578750024,0
3,1303,33405,3578750024,3578750024,0
3,1303,33406,3578750024,3578750024,0
3,1303,33407,3578750024,3578750024,0
3,1303,33408,3578750024,3578750024,0
3,1303,33409,3578750024,3578750025,1
3,1303,33410,3578750024,3578750026,2
3,1303,33411,3578750024,3578750027,3
3,1303,33412,3578750024,3578750027,3
3,1303,33413,3578750024,3578750027,3
3,1303,33414,3578750024,3578750029,5
3,1303,33415,3578750024,3578750030,6
3,1303,33416,3578750024,3578750031,7
3,1303,33417,3578750024,3578750031,7
3,1303,33418,3578750024,3578750033,9
3,1303,33419,3578750024,3578750033,9
3,1303,33420,3578750024,3578750036,12
3,1303,33421,3578750024,3578750036,12
3,1303,33422,3578750024,3578750036,12
3,1303,33423,3578750024,3578750037,13
3,1303,33424,3578750024,3578750038,14
3,1303,33425,3578750024,3578750040,16
3,1303,33426,3578750024,3578750041,17
3,1303,33427,3578750024,3578750041,17
3,1303,33428,3578750024,3578750042,18
3,1303,33429,3578750024,3578750043,19
3,1303,33430,3578750024,3578750044,20
3,1303,33431,3578750024,3578750044,20
3,1303,33432,3578750024,3578750045,21
3,1303,33433,3578750024,3578750045,21
3,1303,33434,3578750024,3578750045,21
3,1303,33435,3578750024,3578750046,22
3,1303,33436,3578750024,3578750047,23
3,1303,33437,3578750024,3578750050,26
3,1303,33438,3578750024,3578750050,26
3,1303,33439,3578750024,3578750051,27
3,1303,33440,3578750024,3578750053,29
3,1303,33441,3578750024,3578750053,29
3,1303,33442,3578750024,3578750056,32
3,1303,33443,3578750024,3578750057,33
3,1303,33444,3578750024,3578750058,34
3,1303,33445,3578750024,3578750060,36
3,1303,33446,3578750024,3578750062,38
3,1303,33447,3578750024,3578750064,40
3,1303,33448,3578750024,3578750064,40
3,1303,33449,3578750024,3578750064,40
3,1303,33450,3578750024,3578750069,45
3,1304,33451,3578750087,3578750087,0
3,1304,33452,3578750087,3578750087,0
3,1304,33453,3578750087,3578750087,0
3,1304,33454,3578750087,3578750087,0
3,1304,33455,3578750087,3578750087,0
3,1304,33456,3578750087,3578750087,0
3,1304,33457,3578750087,3578750087,0
3,1304,33458,3578750087,3578750087,0
3,1304,33459,3578750087,3578750087,0
3,1304,33460,3578750087,3578750087,0
3,1304,33461,3578750087,3578750087,0
3,1304,33462,3578750087,3578750087,0
3,1304,33463,3578750087,3578750087,0
3,1304,33464,3578750087,3578750092,5
3,1304,33465,3578750087,3578750093,6
3,1304,33466,3578750087,3578750093,6
3,1304,33467,3578750087,3578750094,7
3,1304,33468,3578750087,3578750094,7
3,1304,33469,3578750087,3578750094,7
3,1304,33470,3578750087,3578750097,10
3,1304,33471,3578750087,3578750098,11
3,1304,33472,3578750087,3578750098,11
3,1304,33473,3578750087,3578750099,12
3,1304,33474,3578750087,3578750101,14
3,1304,33475,3578750087,3578750102,15
3,1304,33476,3578750087,3578750105,18
3,1304,33477,3578750087,3578750105,18
3,1304,33478,3578750087,3578750105,18
3,1304,33479,3578750087,3578750107,20
3,1304,33480,3578750087,3578750107,20
3,1304,33481,3578750087,3578750108,21
3,1304,33482,3578750087,3578750110,23
3,1304,33483,3578750087,3578750114,27
3,1304,33484,3578750087,3578750116,29
3,1304,33485,3578750087,3578750117,30
3,1304,33486,3578750087,3578750119,32
3,1304,33487,3578750087,3578750121,34
3,1304,33488,3578750087,3578750121,34
3,1304,33489,3578750087,3578750121,34
3,1304,33490,3578750087,3578750121,34
3,1304,33491,3578750087,3578750122,35
3,1304,33492,3578750087,3578750126,39
3,1304,33493,3578750087,3578750128,41
3,1304,33494,3578750087,3578750131,44
3,1304,33495,3578750087,3578750133,46
3,1304,33496,3578750087,3578750137,50
3,1305,33497,3578750150,3578750150,0
3,1305,33498,3578750150,3578750150,0
3,1305,33499,3578750150,3578750150,0
3,1305,33500,3578750150,3578750150,0
3,1305,33501,3578750150,3578750150,0
3,1305,33502,3578750150,3578750150,0
3,1305,33503,3578750150,3578750150,0
3,1305,33504,3578750150,3578750150,0
3,1305,33505,3578750150,3578750150,0
3,1305,33506,3578750150,3578750150,0
3,1305,33507,3578750150,3578750150,0
3,1305,33508,3578750150,3578750150,0
3,1305,33509,3578750150,3578750152,2
3,1305,33510,3578750150,3578750152,2
3,1305,33511,3578750150,3578750153,3
3,1305,33512,3578750150,3578750154,4
3,1305,33513,3578750150,3578750154,4
3,1305,33514,3578750150,3578750157,7
3,1305,33515,3578750150,3578750157,7
3,1305,33516,3578750150,3578750158,8
3,1305,33517,3578750150,3578750161,11
3,1305,33518,3578750150,3578750164,14
3,1305,33519,3578750150,3578750165,15
3,1305,33520,3578750150,3578750166,16
3,1305,33521,3578750150,3578750167,17
3,1305,33522,3578750150,3578750167,17
3,1305,33523,3578750150,3578750167,17
3,1305,33524,3578750150,3578750168,18
3,1305,33525,3578750150,3578750169,19
3,1305,33526,3578750150,3578750169,19
3,1305,33527,3578750150,3578750169,19
3,1305,33528,3578750150,3578750170,20
3,1305,33529,3578750150,3578750170,20
3,1305,33530,3578750150,3578750171,21
3,1305,33531,3578750150,3578750173,23
3,1305,33532,3578750150,3578750174,24
3,1305,33533,3578750150,3578750175,25
3,1305,33534,3578750150,3578750177,27
3,1305,33535,3578750150,3578750183,33
3,1305,33536,3578750150,3578750184,34
3,1305,33537,3578750150,3578750184,34
3,1305,33538,3578750150,3578750184,34
3,1305,33539,3578750150,3578750186,36
3,1305,33540,3578750150,3578750187,37
3,1305,33541,3578750150,3578750187,37
3,1305,33542,3578750150,3578750188,38
3,1305,33543,3578750150,3578750188,38
3,1305,33544,3578750150,3578750188,38
3,1305,33545,3578750150,3578750188,38
3,1305,33546,3578750150,3578750188,38
3,1305,33547,3578750150,3578750189,39
3,1305,33548,3578750150,3578750189,39
3,1305,33549,3578750150,3578750190,40
3,1305,33550,3578750150,3578750191,41
3,1305,33551,3578750150,3578750192,42
3,1305,33552,3578750150,3578750194,44
3,1305,33553,3578750150,3578750194,44
3,1305,33554,3578750150,3578750196,46
3,1305,33555,3578750150,3578750196,46
3,1305,33556,3578750150,3578750198,48
3,1305,33557,3578750150,3578750199,49
3,1306,33558,3578750212,3578750212,0
3,1306,33559,3578750212,3578750212,0
3,1306,33560,3578750212,3578750212,0
3,1306,33561,3578750212,3578750212,0
3,1306,33562,3578750212,3578750213,1
3,1306,33563,3578750212,3578750213,1
3,1306,33564,3578750212,3578750213,1
3,1306,33565,3578750212,3578750213,1
3,1306,33566,3578750212,3578750213,1
3,1306,33567,3578750212,3578750213,1
3,1306,33568,3578750212,3578750213,1
3,1306,33569,3578750212,3578750213,1
3,1306,33570,3578750212,3578750213,1
3,1306,33571,3578750212,3578750213,1
3,1306,33572,3578750212,3578750213,1
3,1306,33573,3578750212,3578750214,2
3,1306,33574,3578750212,3578750214,2
3,1306,33575,3578750212,3578750215,3
3,1306,33576,3578750212,3578750217,5
3,1306,33577,3578750212,3578750217,5
3,1306,33578,3578750212,3578750217,5
3,1306,33579,3578750212,3578750221,9
3,1306,33580,3578750212,3578750221,9
3,1306,33581,3578750212,3578750222,10
3,1306,33582,3578750212,3578750225,13
3,1306,33583,3578750212,3578750225,13
3,1306,33584,3578750212,3578750225,13
3,1306,33585,3578750212,3578750226,14
3,1306,33586,3578750212,3578750227,15
3,1306,33587,3578750212,3578750227,15
3,1306,33588,3578750212,3578750228,16
3,1306,33589,3578750212,3578750228,16
3,1306,33590,3578750212,3578750229,17
3,1306,33591,3578750212,3578750230,18
3,1306,33592,3578750212,3578750232,20
3,1306,33593,3578750212,3578750232,20
3,1306,33594,3578750212,3578750233,21
3,1306,33595,3578750212,3578750234,22
3,1306,33596,3578750212,3578750236,24
3,1306,33597,3578750212,3578750236,24
3,1306,33598,3578750212,3578750237,25
3,1306,33599,3578750212,3578750237,25
3,1306,33600,3578750212,3578750238,26
3,1306,33601,3578750212,3578750240,28
3,1306,33602,3578750212,3578750240,28
3,1306,33603,3578750212,3578750241,29
3,1306,33604,3578750212,3578750242,30
3,1306,33605,3578750212,3578750243,31
3,1306,33606,3578750212,3578750244,32
3,1306,33607,3578750212,3578750244,32
3,1306,33608,3578750212,3578750245,33
3,1306,33609,3578750212,3578750245,33
3,1306,33610,3578750212,3578750246,34
3,1306,33611,3578750212,3578750246,34
3,1306,33612,3578750212,3578750247,35
3,1306,33613,3578750212,3578750249,37
3,1306,33614,3578750212,3578750251,39
3,1306,33615,3578750212,3578750251,39
3,1306,33616,3578750212,3578750254,42
3,1306,33617,3578750212,3578750254,42
3,1306,33618,3578750212,3578750256,44
3,1306,33619,3578750212,3578750257,45
3,1306,33620,3578750212,3578750258,46
3,1306,33621,3578750212,3578750258,46
3,1307,33622,3578750274,3578750274,0
3,1307,33623,3578750274,3578750274,0
3,1307,33624,3578750274,3578750274,0
3,1307,33625,3578750274,3578750274,0
3,1307,33626,3578750274,3578750274,0
3,1307,33627,3578750274,3578750274,0
3,1307,33628,3578750274,3578750274,0
3,1307,33629,3578750274,3578750278,4
3,1307,33630,3578750274,3578750279,5
3,1307,33631,3578750274,3578750281,7
3,1307,33632,3578750274,3578750282,8
3,1307,33633,3578750274,3578750282,8
3,1307,33634,3578750274,3578750283,9
3,1307,33635,3578750274,3578750284,10
3,1307,33636,3578750274,3578750284,10
3,1307,33637,3578750274,3578750286,12
3,1307,33638,3578750274,3578750287,13
3,1307,33639,3578750274,3578750287,13
3,1307,33640,3578750274,3578750290,16
3,1307,33641,3578750274,3578750291,17
3,1307,33642,3578750274,3578750293,19
3,1307,33643,3578750274,3578750293,19
3,1307,33644,3578750274,3578750294,20
3,1307,33645,3578750274,3578750295,21
3,1307,33646,3578750274,3578750298,24
3,1307,33647,3578750274,3578750298,24
3,1307,33648,3578750274,3578750298,24
3,1307,33649,3578750274,3578750301,27
3,1307,33650,3578750274,3578750302,28
3,1307,33651,3578750274,3578750304,30
3,1307,33652,3578750274,3578750304,30
3,1307,33653,3578750274,3578750305,31
3,1307,33654,3578750274,3578750305,31
3,1307,33655,3578750274,3578750306,32
3,1307,33656,3578750274,3578750307,33
3,1307,33657,3578750274,3578750308,34
3,1307,33658,3578750274,3578750308,34
3,1307,33659,3578750274,3578750310,36
3,1307,33660,3578750274,3578750315,41
3,1307,33661,3578750274,3578750316,42
3,1307,33662,3578750274,3578750318,44
3,1307,33663,3578750274,3578750318,44
3,1307,33664,3578750274,3578750318,44
3,1307,33665,3578750274,3578750321,47
3,1307,33666,3578750274,3578750321,47
3,1307,33667,3578750274,3578750321,47
3,1307,33668,3578750274,3578750322,48
3,1307,33669,3578750274,3578750323,49
3,1308,33670,3578750336,3578750336,0
3,1308,33671,3578750336,3578750336,0
3,1308,33672,3578750336,3578750336,0
3,1308,33673,3578750336,3578750336,0
3,1308,33674,3578750336,3578750337,1
3,1308,33675,3578750336,3578750339,3
3,1308,33676,3578750336,3578750339,3
3,1308,33677,3578750336,3578750339,3
3,1308,33678,3578750336,3578750339,3
3,1308,33679,3578750336,3578750343,7
3,1308,33680,3578750336,3578750346,10
3,1308,33681,3578750336,3578750346,10
3,1308,33682,3578750336,3578750348,12
3,1308,33683,3578750336,3578750349,13
3,1308,33684,3578750336,3578750351,15
3,1308,33685,3578750336,3578750352,16
3,1308,33686,3578750336,3578750352,16
3,1308,33687,3578750336,3578750354,18
3,1308,33688,3578750336,3578750354,18
3,1308,33689,3578750336,3578750354,18
3,1308,33690,3578750336,3578750357,21
3,1308,33691,3578750336,3578750357,21
3,1308,33692,3578750336,3578750357,21
3,1308,33693,3578750336,3578750358,22
3,1308,33694,3578750336,3578750361,25
3,1308,33695,3578750336,3578750364,28
3,1308,33696,3578750336,3578750364,28
3,1308,33697,3578750336,3578750365,29
3,1308,33698,3578750336,3578750367,31
3,1308,33699,3578750336,3578750367,31
3,1308,33700,3578750336,3578750367,31
3,1308,33701,3578750336,3578750368,32
3,1308,33702,3578750336,3578750369,33
3,1308,33703,3578750336,3578750369,33
3,1308,33704,3578750336,3578750369,33
3,1308,33705,3578750336,3578750370,34
3,1308,33706,3578750336,3578750371,35
3,1308,33707,3578750336,3578750371,35
3,1308,33708,3578750336,3578750373,37
3,1308,33709,3578750336,3578750374,38
3,1308,33710,3578750336,3578750374,38
3,1308,33711,3578750336,3578750376,40
3,1308,33712,3578750336,3578750380,44
3,1308,33713,3578750336,3578750384,48
3,1308,33714,3578750336,3578750384,48
3,1308,33715,3578750336,3578750384,48
3,1308,33716,3578750336,3578750384,48
3,1309,33717,3578750398,3578750398,0
3,1309,33718,3578750398,3578750398,0
3,1309,33719,3578750398,3578750398,0
3,1309,33720,3578750398,3578750399,1
3,1309,33721,3578750398,3578750399,1
3,1309,33722,3578750398,3578750399,1
3,1309,33723,3578750398,3578750399,1
3,1309,33724,3578750398,3578750399,1
3,1309,33725,3578750398,3578750399,1
3,1309,33726,3578750398,3578750399,1
3,1309,33727,3578750398,3578750399,1
3,1309,33728,3578750398,3578750399,1
3,1309,33729,3578750398,3578750399,1
3,1309,33730,3578750398,3578750399,1
3,1309,33731,3578750398,3578750399,1
3,1309,33732,3578750398,3578750399,1
3,1309,33733,3578750398,3578750399,1
3,1309,33734,3578750398,3578750401,3
3,1309,33735,3578750398,3578750402,4
3,1309,33736,3578750398,3578750403,5
3,1309,33737,3578750398,3578750405,7
3,1309,33738,3578750398,3578750405,7
3,1309,33739,3578750398,3578750405,7
3,1309,33740,3578750398,3578750405,7
3,1309,33741,3578750398,3578750406,8
3,1309,33742,3578750398,3578750406,8
3,1309,33743,3578750398,3578750408,10
3,1309,33744,3578750398,3578750408,10
3,1309,33745,3578750398,3578750408,10
3,1309,33746,3578750398,3578750408,10
3,1309,33747,3578750398,3578750410,12
3,1309,33748,3578750398,3578750413,15
3,1309,33749,3578750398,3578750413,15
3,1309,33750,3578750398,3578750414,16
3,1309,33751,3578750398,3578750414,16
3,1309,33752,3578750398,3578750415,17
3,1309,33753,3578750398,3578750416,18
3,1309,33754,3578750398,3578750417,19
3,1309,33755,3578750398,3578750417,19
3,1309,33756,3578750398,3578750420,22
3,1309,33757,3578750398,3578750422,24
3,1309,33758,3578750398,3578750422,24
3,1309,33759,3578750398,3578750425,27
3,1309,33760,3578750398,3578750425,27
3,1309,33761,3578750398,3578750425,27
3,1309,33762,3578750398,3578750426,28
3,1309,33763,3578750398,3578750427,29
3,1309,33764,3578750398,3578750428,30
3,1309,33765,3578750398,3578750428,30
3,1309,33766,3578750398,3578750429,31
3,1309,33767,3578750398,3578750429,31
3,1309,33768,3578750398,3578750429,31
3,1309,33769,3578750398,3578750432,34
3,1309,33770,3578750398,3578750432,34
3,1309,33771,3578750398,3578750432,34
3,1309,33772,3578750398,3578750435,37
3,1309,33773,3578750398,3578750437,39
3,1309,33774,3578750398,3578750437,39
3,1309,33775,3578750398,3578750437,39
3,1309,33776,3578750398,3578750437,39
3,1309,33777,3578750398,3578750438,40
3,1309,33778,3578750398,3578750439,41
3,1309,33779,3578750398,3578750440,42
3,1309,33780,3578750398,3578750440,42
3,1309,33781,3578750398,3578750441,43
3,1309,33782,3578750398,3578750443,45
3,1309,33783,3578750398,3578750443,45
3,1309,33784,3578750398,3578750444,46
3,1309,33785,3578750398,3578750444,46
3,1309,33786,3578750398,3578750444,46
3,1309,33787,3578750398,3578750445,47
3,1309,33788,3578750398,3578750446,48
3,1309,33789,3578750398,3578750446,48
3,1309,33790,3578750398,3578750447,49
3,1309,33791,3578750398,3578750448,50
3,1310,33792,3578750461,3578750461,0
3,1310,33793,3578750461,3578750461,0
3,1310,33794,3578750461,3578750461,0
3,1310,33795,3578750461,3578750461,0
3,1310,33796,3578750461,3578750461,0
3,1310,33797,3578750461,3578750461,0
3,1310,33798,3578750461,3578750461,0
3,1310,33799,3578750461,3578750461,0
3,1310,33800,3578750461,3578750461,0
3,1310,33801,3578750461,3578750464,3
3,1310,33802,3578750461,3578750464,3
3,1310,33803,3578750461,3578750470,9
3,1310,33804,3578750461,3578750474,13
3,1310,33805,3578750461,3578750479,18
3,1310,33806,3578750461,3578750480,19
3,1310,33807,3578750461,3578750482,21
3,1310,33808,3578750461,3578750483,22
3,1310,33809,3578750461,3578750483,22
3,1310,33810,3578750461,3578750484,23
3,1310,33811,3578750461,3578750485,24
3,1310,33812,3578750461,3578750486,25
3,1310,33813,3578750461,3578750487,26
3,1310,33814,3578750461,3578750490,29
3,1310,33815,3578750461,3578750491,30
3,1310,33816,3578750461,3578750493,32
3,1310,33817,3578750461,3578750493,32
3,1310,33818,3578750461,3578750495,34
3,1310,33819,3578750461,3578750495,34
3,1310,33820,3578750461,3578750497,36
3,1310,33821,3578750461,3578750498,37
3,1310,33822,3578750461,3578750498,37
3,1310,33823,3578750461,3578750499,38
3,1310,33824,3578750461,3578750502,41
3,1310,33825,3578750461,3578750503,42
3,1310,33826,3578750461,3578750504,43
3,1310,33827,3578750461,3578750504,43
3,1310,33828,3578750461,3578750505,44
3,1310,33829,3578750461,3578750505,44
3,1310,33830,3578750461,3578750505,44
3,1310,33831,3578750461,3578750507,46
3,1310,33832,3578750461,3578750507,46
3,1310,33833,3578750461,3578750508,47
3,1310,33834,3578750461,3578750510,49
3,1311,33835,3578750523,3578750523,0
3,1311,33836,3578750523,3578750523,0
3,1311,33837,3578750523,3578750523,0
3,1311,33838,3578750523,3578750523,0
3,1311,33839,3578750523,3578750523,0
3,1311,33840,3578750523,3578750523,0
3,1311,33841,3578750523,3578750523,0
3,1311,33842,3578750523,3578750523,0
3,1311,33843,3578750523,3578750526,3
3,1311,33844,3578750523,3578750528,5
3,1311,33845,3578750523,3578750532,9
3,1311,33846,3578750523,3578750532,9
3,1311,33847,3578750523,3578750536,13
3,1311,33848,3578750523,3578750538,15
3,1311,33849,3578750523,3578750538,15
3,1311,33850,3578750523,3578750538,15
3,1311,33851,3578750523,3578750539,16
3,1311,33852,3578750523,3578750541,18
3,1311,33853,3578750523,3578750543,20
3,1311,33854,3578750523,3578750545,22
3,1311,33855,3578750523,3578750545,22
3,1311,33856,3578750523,3578750548,25
3,1311,33857,3578750523,3578750549,26
3,1311,33858,3578750523,3578750549,26
3,1311,33859,3578750523,3578750551,28
3,1311,33860,3578750523,3578750551,28
3,1311,33861,3578750523,3578750553,30
3,1311,33862,3578750523,3578750553,30
3,1311,33863,3578750523,3578750553,30
3,1311,33864,3578750523,3578750556,33
3,1311,33865,3578750523,3578750557,34
3,1311,33866,3578750523,3578750557,34
3,1311,33867,3578750523,3578750557,34
3,1311,33868,3578750523,3578750560,37
3,1311,33869,3578750523,3578750563,40
3,1311,33870,3578750523,3578750563,40
3,1311,33871,3578750523,3578750565,42
3,1311,33872,3578750523,3578750565,42
3,1311,33873,3578750523,3578750565,42
3,1311,33874,3578750523,3578750567,44
3,1311,33875,3578750523,3578750568,45
3,1311,33876,3578750523,3578750568,45
3,1311,33877,3578750523,3578750568,45
3,1311,33878,3578750523,3578750568,45
3,1311,33879,3578750523,3578750569,46
3,1311,33880,3578750523,3578750569,46
3,1311,33881,3578750523,3578750570,47
3,1311,33882,3578750523,3578750572,49
3,1311,33883,3578750523,3578750573,50
3,1312,33884,3578750584,3578750584,0
3,1312,33885,3578750584,3578750584,0
3,1312,33886,3578750584,3578750584,0
3,1312,33887,3578750584,3578750584,0
3,1312,33888,3578750584,3578750584,0
3,1312,33889,3578750584,3578750584,0
3,1312,33890,3578750584,3578750584,0
3,1312,33891,3578750584,3578750585,1
3,1312,33892,3578750584,3578750586,2
3,1312,33893,3578750584,3578750586,2
3,1312,33894,3578750584,3578750587,3
3,1312,33895,3578750584,3578750587,3
3,1312,33896,3578750584,3578750587,3
3,1312,33897,3578750584,3578750588,4
3,1312,33898,3578750584,3578750588,4
3,1312,33899,3578750584,3578750588,4
3,1312,33900,3578750584,3578750588,4
3,1312,33901,3578750584,3578750588,4
3,1312,33902,3578750584,3578750590,6
3,1312,33903,3578750584,3578750590,6
3,1312,33904,3578750584,3578750591,7
3,1312,33905,3578750584,3578750592,8
3,1312,33906,3578750584,3578750593,9
3,1312,33907,3578750584,3578750595,11
3,1312,33908,3578750584,3578750596,12
3,1312,33909,3578750584,3578750597,13
3,1312,33910,3578750584,3578750599,15
3,1312,33911,3578750584,3578750600,16
3,1312,33912,3578750584,3578750600,16
3,1312,33913,3578750584,3578750601,17
3,1312,33914,3578750584,3578750603,19
3,1312,33915,3578750584,3578750604,20
3,1312,33916,3578750584,3578750604,20
3,1312,33917,3578750584,3578750605,21
3,1312,33918,3578750584,3578750605,21
3,1312,33919,3578750584,3578750606,22
3,1312,33920,3578750584,3578750607,23
3,1312,33921,3578750584,3578750607,23
3,1312,33922,3578750584,3578750607,23
3,1312,33923,3578750584,3578750608,24
3,1312,33924,3578750584,3578750609,25
3,1312,33925,3578750584,3578750612,28
3,1312,33926,3578750584,3578750612,28
3,1312,33927,3578750584,3578750613,29
3,1312,33928,3578750584,3578750613,29
3,1312,33929,3578750584,3578750613,29
3,1312,33930,3578750584,3578750616,32
3,1312,33931,3578750584,3578750616,32
3,1312,33932,3578750584,3578750616,32
3,1312,33933,3578750584,3578750619,35
3,1312,33934,3578750584,3578750621,37
3,1312,33935,3578750584,3578750622,38
3,1312,33936,3578750584,3578750623,39
3,1312,33937,3578750584,3578750624,40
3,1312,33938,3578750584,3578750624,40
3,1312,33939,3578750584,3578750625,41
3,1312,33940,3578750584,3578750626,42
3,1312,33941,3578750584,3578750626,42
3,1312,33942,3578750584,3578750627,43
3,1312,33943,3578750584,3578750627,43
3,1312,33944,3578750584,3578750628,44
3,1312,33945,3578750584,3578750628,44
3,1312,33946,3578750584,3578750629,45
3,1312,33947,3578750584,3578750631,47
3,1312,33948,3578750584,3578750631,47
3,1312,33949,3578750584,3578750632,48
3,1313,33950,3578750646,3578750646,0
3,1313,33951,3578750646,3578750646,0
3,1313,33952,3578750646,3578750646,0
3,1313,33953,3578750646,3578750646,0
3,1313,33954,3578750646,3578750646,0
3,1313,33955,3578750646,3578750646,0
3,1313,33956,3578750646,3578750646,0
3,1313,33957,3578750646,3578750646,0
3,1313,33958,3578750646,3578750646,0
3,1313,33959,3578750646,3578750646,0
3,1313,33960,3578750646,3578750646,0
3,1313,33961,3578750646,3578750646,0
3,1313,33962,3578750646,3578750646,0
3,1313,33963,3578750646,3578750646,0
3,1313,33964,3578750646,3578750646,0
3,1313,33965,3578750646,3578750646,0
3,1313,33966,3578750646,3578750646,0
3,1313,33967,3578750646,3578750646,0
3,1313,33968,3578750646,3578750646,0
3,1313,33969,3578750646,3578750646,0
3,1313,33970,3578750646,3578750649,3
3,1313,33971,3578750646,3578750649,3
3,1313,33972,3578750646,3578750651,5
3,1313,33973,3578750646,3578750653,7
3,1313,33974,3578750646,3578750658,12
3,1313,33975,3578750646,3578750660,14
3,1313,33976,3578750646,3578750661,15
3,1313,33977,3578750646,3578750662,16
3,1313,33978,3578750646,3578750663,17
3,1313,33979,3578750646,3578750664,18
3,1313,33980,3578750646,3578750669,23
3,1313,33981,3578750646,3578750674,28
3,1313,33982,3578750646,3578750679,33
3,1313,33983,3578750646,3578750680,34
3,1313,33984,3578750646,3578750682,36
3,1313,33985,3578750646,3578750684,38
3,1313,33986,3578750646,3578750684,38
3,1313,33987,3578750646,3578750685,39
3,1313,33988,3578750646,3578750686,40
3,1313,33989,3578750646,3578750687,41
3,1313,33990,3578750646,3578750690,44
3,1313,33991,3578750646,3578750691,45
3,1313,33992,3578750646,3578750693,47
3,1313,33993,3578750646,3578750693,47
3,1313,33994,3578750646,3578750695,49
3,1314,33995,3578750708,3578750708,0
3,1314,33996,3578750708,3578750708,0
3,1314,33997,3578750708,3578750708,0
3,1314,33998,3578750708,3578750708,0
3,1314,33999,3578750708,3578750708,0
3,1314,34000,3578750708,3578750708,0
3,1314,34001,3578750708,3578750708,0
3,1314,34002,3578750708,3578750708,0
3,1314,34003,3578750708,3578750708,0
3,1314,34004,3578750708,3578750708,0
3,1314,34005,3578750708,3578750708,0
3,1314,34006,3578750708,3578750708,0
3,1314,34007,3578750708,3578750708,0
3,1314,34008,3578750708,3578750709,1
3,1314,34009,3578750708,3578750710,2
3,1314,34010,3578750708,3578750711,3
3,1314,34011,3578750708,3578750714,6
3,1314,34012,3578750708,3578750715,7
3,1314,34013,3578750708,3578750717,9
3,1314,34014,3578750708,3578750718,10
3,1314,34015,3578750708,3578750719,11
3,1314,34016,3578750708,3578750719,11
3,1314,34017,3578750708,3578750720,12
3,1314,34018,3578750708,3578750721,13
3,1314,34019,3578750708,3578750726,18
3,1314,34020,3578750708,3578750729,21
3,1314,34021,3578750708,3578750731,23
3,1314,34022,3578750708,3578750733,25
3,1314,34023,3578750708,3578750736,28
3,1314,34024,3578750708,3578750738,30
3,1314,34025,3578750708,3578750739,31
3,1314,34026,3578750708,3578750739,31
3,1314,34027,3578750708,3578750739,31
3,1314,34028,3578750708,3578750739,31
3,1314,34029,3578750708,3578750739,31
3,1314,34030,3578750708,3578750741,33
3,1314,34031,3578750708,3578750742,34
3,1314,34032,3578750708,3578750744,36
3,1314,34033,3578750708,3578750749,41
3,1314,34034,3578750708,3578750749,41
3,1314,34035,3578750708,3578750750,42
3,1314,34036,3578750708,3578750751,43
3,1314,34037,3578750708,3578750752,44
3,1314,34038,3578750708,3578750753,45
3,1314,34039,3578750708,3578750753,45
3,1314,34040,3578750708,3578750756,48
3,1314,34041,3578750708,3578750756,48
3,1314,34042,3578750708,3578750757,49
3,1314,34043,3578750708,3578750757,49
3,1314,34044,3578750708,3578750757,49
3,1315,34045,3578750770,3578750770,0
3,1315,34046,3578750770,3578750770,0
3,1315,34047,3578750770,3578750770,0
3,1315,34048,3578750770,3578750770,0
3,1315,34049,3578750770,3578750770,0
3,1315,34050,3578750770,3578750770,0
3,1315,34051,3578750770,3578750770,0
3,1315,34052,3578750770,3578750770,0
3,1315,34053,3578750770,3578750770,0
3,1315,34054,3578750770,3578750770,0
3,1315,34055,3578750770,3578750770,0
3,1315,34056,3578750770,3578750770,0
3,1315,34057,3578750770,3578750770,0
3,1315,34058,3578750770,3578750772,2
3,1315,34059,3578750770,3578750773,3
3,1315,34060,3578750770,3578750773,3
3,1315,34061,3578750770,3578750773,3
3,1315,34062,3578750770,3578750775,5
3,1315,34063,3578750770,3578750779,9
3,1315,34064,3578750770,3578750782,12
3,1315,34065,3578750770,3578750783,13
3,1315,34066,3578750770,3578750783,13
3,1315,34067,3578750770,3578750785,15
3,1315,34068,3578750770,3578750786,16
3,1315,34069,3578750770,3578750787,17
3,1315,34070,3578750770,3578750787,17
3,1315,34071,3578750770,3578750787,17
3,1315,34072,3578750770,3578750787,17
3,1315,34073,3578750770,3578750787,17
3,1315,34074,3578750770,3578750788,18
3,1315,34075,3578750770,3578750788,18
3,1315,34076,3578750770,3578750789,19
3,1315,34077,3578750770,3578750790,20
3,1315,34078,3578750770,3578750790,20
3,1315,34079,3578750770,3578750791,21
3,1315,34080,3578750770,3578750792,22
3,1315,34081,3578750770,3578750793,23
3,1315,34082,3578750770,3578750794,24
3,1315,34083,3578750770,3578750795,25
3,1315,34084,3578750770,3578750796,26
3,1315,34085,3578750770,3578750799,29
3,1315,34086,3578750770,3578750800,30
3,1315,34087,3578750770,3578750800,30
3,1315,34088,3578750770,3578750801,31
3,1315,34089,3578750770,3578750804,34
3,1315,34090,3578750770,3578750804,34
3,1315,34091,3578750770,3578750804,34
3,1315,34092,3578750770,3578750804,34
3,1315,34093,3578750770,3578750805,35
3,1315,34094,3578750770,3578750805,35
3,1315,34095,3578750770,3578750805,35
3,1315,34096,3578750770,3578750807,37
3,1315,34097,3578750770,3578750807,37
3,1315,34098,3578750770,3578750807,37
3,1315,34099,3578750770,3578750809,39
3,1315,34100,3578750770,3578750809,39
3,1315,34101,3578750770,3578750812,42
3,1315,34102,3578750770,3578750812,42
3,1315,34103,3578750770,3578750813,43
3,1315,34104,3578750770,3578750813,43
3,1315,34105,3578750770,3578750814,44
3,1315,34106,3578750770,3578750816,46
3,1315,34107,3578750770,3578750816,46
3,1315,34108,3578750770,3578750817,47
3,1315,34109,3578750770,3578750820,50
3,1316,34110,3578750832,3578750832,0
3,1316,34111,3578750832,3578750833,1
3,1316,34112,3578750832,3578750833,1
3,1316,34113,3578750832,3578750833,1
3,1316,34114,3578750832,3578750833,1
3,1316,34115,3578750832,3578750833,1
3,1316,34116,3578750832,3578750833,1
3,1316,34117,3578750832,3578750833,1
3,1316,34118,3578750832,3578750833,1
3,1316,34119,3578750832,3578750833,1
3,1316,34120,3578750832,3578750833,1
3,1316,34121,3578750832,3578750833,1
3,1316,34122,3578750832,3578750833,1
3,1316,34123,3578750832,3578750833,1
3,1316,34124,3578750832,3578750833,1
3,1316,34125,3578750832,3578750833,1
3,1316,34126,3578750832,3578750835,3
3,1316,34127,3578750832,3578750836,4
3,1316,34128,3578750832,3578750836,4
3,1316,34129,3578750832,3578750836,4
3,1316,34130,3578750832,3578750836,4
3,1316,34131,3578750832,3578750839,7
3,1316,34132,3578750832,3578750839,7
3,1316,34133,3578750832,3578750839,7
3,1316,34134,3578750832,3578750840,8
3,1316,34135,3578750832,3578750840,8
3,1316,34136,3578750832,3578750842,10
3,1316,34137,3578750832,3578750842,10
3,1316,34138,3578750832,3578750843,11
3,1316,34139,3578750832,3578750843,11
3,1316,34140,3578750832,3578750843,11
3,1316,34141,3578750832,3578750844,12
3,1316,34142,3578750832,3578750845,13
3,1316,34143,3578750832,3578750845,13
3,1316,34144,3578750832,3578750846,14
3,1316,34145,3578750832,3578750847,15
3,1316,34146,3578750832,3578750850,18
3,1316,34147,3578750832,3578750850,18
3,1316,34148,3578750832,3578750851,19
3,1316,34149,3578750832,3578750853,21
3,1316,34150,3578750832,3578750854,22
3,1316,34151,3578750832,3578750856,24
3,1316,34152,3578750832,3578750859,27
3,1316,34153,3578750832,3578750859,27
3,1316,34154,3578750832,3578750860,28
3,1316,34155,3578750832,3578750861,29
3,1316,34156,3578750832,3578750862,30
3,1316,34157,3578750832,3578750862,30
3,1316,34158,3578750832,3578750863,31
3,1316,34159,3578750832,3578750864,32
3,1316,34160,3578750832,3578750868,36
3,1316,34161,3578750832,3578750874,42
3,1316,34162,3578750832,3578750879,47
3,1316,34163,3578750832,3578750880,48
3,1316,34164,3578750832,3578750882,50
3,1317,34165,3578750896,3578750896,0
3,1317,34166,3578750896,3578750896,0
3,1317,34167,3578750896,3578750896,0
3,1317,34168,3578750896,3578750896,0
3,1317,34169,3578750896,3578750896,0
3,1317,34170,3578750896,3578750896,0
3,1317,34171,3578750896,3578750896,0
3,1317,34172,3578750896,3578750896,0
3,1317,34173,3578750896,3578750896,0
3,1317,34174,3578750896,3578750896,0
3,1317,34175,3578750896,3578750896,0
3,1317,34176,3578750896,3578750896,0
3,1317,34177,3578750896,3578750897,1
3,1317,34178,3578750896,3578750898,2
3,1317,34179,3578750896,3578750899,3
3,1317,34180,3578750896,3578750900,4
3,1317,34181,3578750896,3578750902,6
3,1317,34182,3578750896,3578750902,6
3,1317,34183,3578750896,3578750904,8
3,1317,34184,3578750896,3578750905,9
3,1317,34185,3578750896,3578750905,9
3,1317,34186,3578750896,3578750906,10
3,1317,34187,3578750896,3578750908,12
3,1317,34188,3578750896,3578750908,12
3,1317,34189,3578750896,3578750909,13
3,1317,34190,3578750896,3578750910,14
3,1317,34191,3578750896,3578750911,15
3,1317,34192,3578750896,3578750914,18
3,1317,34193,3578750896,3578750915,19
3,1317,34194,3578750896,3578750917,21
3,1317,34195,3578750896,3578750918,22
3,1317,34196,3578750896,3578750918,22
3,1317,34197,3578750896,3578750920,24
3,1317,34198,3578750896,3578750920,24
3,1317,34199,3578750896,3578750921,25
3,1317,34200,3578750896,3578750922,26
3,1317,34201,3578750896,3578750922,26
3,1317,34202,3578750896,3578750926,30
3,1317,34203,3578750896,3578750932,36
3,1317,34204,3578750896,3578750933,37
3,1317,34205,3578750896,3578750936,40
3,1317,34206,3578750896,3578750938,42
3,1317,34207,3578750896,3578750939,43
3,1317,34208,3578750896,3578750939,43
3,1317,34209,3578750896,3578750939,43
3,1317,34210,3578750896,3578750941,45
3,1317,34211,3578750896,3578750942,46
3,1317,34212,3578750896,3578750945,49
3,1318,34213,3578750959,3578750959,0
3,1318,34214,3578750959,3578750959,0
3,1318,34215,3578750959,3578750959,0
3,1318,34216,3578750959,3578750959,0
3,1318,34217,3578750959,3578750959,0
3,1318,34218,3578750959,3578750960,1
3,1318,34219,3578750959,3578750960,1
3,1318,34220,3578750959,3578750960,1
3,1318,34221,3578750959,3578750960,1
3,1318,34222,3578750959,3578750960,1
3,1318,34223,3578750959,3578750960,1
3,1318,34224,3578750959,3578750960,1
3,1318,34225,3578750959,3578750964,5
3,1318,34226,3578750959,3578750965,6
3,1318,34227,3578750959,3578750966,7
3,1318,34228,3578750959,3578750966,7
3,1318,34229,3578750959,3578750967,8
3,1318,34230,3578750959,3578750968,9
3,1318,34231,3578750959,3578750969,10
3,1318,34232,3578750959,3578750969,10
3,1318,34233,3578750959,3578750969,10
3,1318,34234,3578750959,3578750969,10
3,1318,34235,3578750959,3578750970,11
3,1318,34236,3578750959,3578750973,14
3,1318,34237,3578750959,3578750973,14
3,1318,34238,3578750959,3578750974,15
3,1318,34239,3578750959,3578750974,15
3,1318,34240,3578750959,3578750975,16
3,1318,34241,3578750959,3578750979,20
3,1318,34242,3578750959,3578750983,24
3,1318,34243,3578750959,3578750983,24
3,1318,34244,3578750959,3578750983,24
3,1318,34245,3578750959,3578750984,25
3,1318,34246,3578750959,3578750986,27
3,1318,34247,3578750959,3578750986,27
3,1318,34248,3578750959,3578750987,28
3,1318,34249,3578750959,3578750987,28
3,1318,34250,3578750959,3578750987,28
3,1318,34251,3578750959,3578750987,28
3,1318,34252,3578750959,3578750987,28
3,1318,34253,3578750959,3578750987,28
3,1318,34254,3578750959,3578750988,29
3,1318,34255,3578750959,3578750989,30
3,1318,34256,3578750959,3578750990,31
3,1318,34257,3578750959,3578750991,32
3,1318,34258,3578750959,3578750991,32
3,1318,34259,3578750959,3578750993,34
3,1318,34260,3578750959,3578750993,34
3,1318,34261,3578750959,3578750994,35
3,1318,34262,3578750959,3578750995,36
3,1318,34263,3578750959,3578750996,37
3,1318,34264,3578750959,3578751000,41
3,1318,34265,3578750959,3578751001,42
3,1318,34266,3578750959,3578751002,43
3,1318,34267,3578750959,3578751004,45
3,1318,34268,3578750959,3578751004,45
3,1318,34269,3578750959,3578751005,46
3,1318,34270,3578750959,3578751005,46
3,1318,34271,3578750959,3578751007,48
3,1318,34272,3578750959,3578751007,48
3,1318,34273,3578750959,3578751007,48
3,1318,34274,3578750959,3578751009,50
3,1319,34275,3578751021,3578751021,0
3,1319,34276,3578751021,3578751021,0
3,1319,34277,3578751021,3578751021,0
3,1319,34278,3578751021,3578751021,0
3,1319,34279,3578751021,3578751021,0
3,1319,34280,3578751021,3578751021,0
3,1319,34281,3578751021,3578751021,0
3,1319,34282,3578751021,3578751021,0
3,1319,34283,3578751021,3578751021,0
3,1319,34284,3578751021,3578751022,1
3,1319,34285,3578751021,3578751022,1
3,1319,34286,3578751021,3578751024,3
3,1319,34287,3578751021,3578751024,3
3,1319,34288,3578751021,3578751025,4
3,1319,34289,3578751021,3578751026,5
3,1319,34290,3578751021,3578751026,5
3,1319,34291,3578751021,3578751027,6
3,1319,34292,3578751021,3578751027,6
3,1319,34293,3578751021,3578751028,7
3,1319,34294,3578751021,3578751028,7
3,1319,34295,3578751021,3578751029,8
3,1319,34296,3578751021,3578751031,10
3,1319,34297,3578751021,3578751031,10
3,1319,34298,3578751021,3578751032,11
3,1319,34299,3578751021,3578751035,14
3,1319,34300,3578751021,3578751036,15
3,1319,34301,3578751021,3578751036,15
3,1319,34302,3578751021,3578751036,15
3,1319,34303,3578751021,3578751036,15
3,1319,34304,3578751021,3578751038,17
3,1319,34305,3578751021,3578751039,18
3,1319,34306,3578751021,3578751039,18
3,1319,34307,3578751021,3578751040,19
3,1319,34308,3578751021,3578751040,19
3,1319,34309,3578751021,3578751042,21
3,1319,34310,3578751021,3578751042,21
3,1319,34311,3578751021,3578751043,22
3,1319,34312,3578751021,3578751043,22
3,1319,34313,3578751021,3578751044,23
3,1319,34314,3578751021,3578751044,23
3,1319,34315,3578751021,3578751045,24
3,1319,34316,3578751021,3578751045,24
3,1319,34317,3578751021,3578751046,25
3,1319,34318,3578751021,3578751047,26
3,1319,34319,3578751021,3578751050,29
3,1319,34320,3578751021,3578751051,30
3,1319,34321,3578751021,3578751051,30
3,1319,34322,3578751021,3578751053,32
3,1319,34323,3578751021,3578751054,33
3,1319,34324,3578751021,3578751056,35
3,1319,34325,3578751021,3578751059,38
3,1319,34326,3578751021,3578751059,38
3,1319,34327,3578751021,3578751060,39
3,1319,34328,3578751021,3578751061,40
3,1319,34329,3578751021,3578751061,40
3,1319,34330,3578751021,3578751063,42
3,1319,34331,3578751021,3578751063,42
3,1319,34332,3578751021,3578751065,44
3,1319,34333,3578751021,3578751068,47
3,1320,34334,3578751083,3578751083,0
3,1320,34335,3578751083,3578751083,0
3,1320,34336,3578751083,3578751083,0
3,1320,34337,3578751083,3578751083,0
3,1320,34338,3578751083,3578751083,0
3,1320,34339,3578751083,3578751084,1
3,1320,34340,3578751083,3578751084,1
3,1320,34341,3578751083,3578751084,1
3,1320,34342,3578751083,3578751085,2
3,1320,34343,3578751083,3578751086,3
3,1320,34344,3578751083,3578751087,4
3,1320,34345,3578751083,3578751088,5
3,1320,34346,3578751083,3578751089,6
3,1320,34347,3578751083,3578751092,9
3,1320,34348,3578751083,3578751093,10
3,1320,34349,3578751083,3578751093,10
3,1320,34350,3578751083,3578751093,10
3,1320,34351,3578751083,3578751095,12
3,1320,34352,3578751083,3578751096,13
3,1320,34353,3578751083,3578751097,14
3,1320,34354,3578751083,3578751098,15
3,1320,34355,3578751083,3578751099,16
3,1320,34356,3578751083,3578751101,18
3,1320,34357,3578751083,3578751102,19
3,1320,34358,3578751083,3578751104,21
3,1320,34359,3578751083,3578751104,21
3,1320,34360,3578751083,3578751105,22
3,1320,34361,3578751083,3578751105,22
3,1320,34362,3578751083,3578751108,25
3,1320,34363,3578751083,3578751108,25
3,1320,34364,3578751083,3578751109,26
3,1320,34365,3578751083,3578751110,27
3,1320,34366,3578751083,3578751111,28
3,1320,34367,3578751083,3578751114,31
3,1320,34368,3578751083,3578751115,32
3,1320,34369,3578751083,3578751118,35
3,1320,34370,3578751083,3578751119,36
3,1320,34371,3578751083,3578751119,36
3,1320,34372,3578751083,3578751120,37
3,1320,34373,3578751083,3578751120,37
3,1320,34374,3578751083,3578751121,38
3,1320,34375,3578751083,3578751123,40
3,1320,34376,3578751083,3578751127,44
3,1320,34377,3578751083,3578751131,48
3,1320,34378,3578751083,3578751133,50
3,1321,34379,3578751144,3578751144,0
3,1321,34380,3578751144,3578751144,0
3,1321,34381,3578751144,3578751144,0
3,1321,34382,3578751144,3578751144,0
3,1321,34383,3578751144,3578751144,0
3,1321,34384,3578751144,3578751144,0
3,1321,34385,3578751144,3578751144,0
3,1321,34386,3578751144,3578751145,1
3,1321,34387,3578751144,3578751149,5
3,1321,34388,3578751144,3578751150,6
3,1321,34389,3578751144,3578751151,7
3,1321,34390,3578751144,3578751152,8
3,1321,34391,3578751144,3578751152,8
3,1321,34392,3578751144,3578751153,9
3,1321,34393,3578751144,3578751157,13
3,1321,34394,3578751144,3578751158,14
3,1321,34395,3578751144,3578751159,15
3,1321,34396,3578751144,3578751160,16
3,1321,34397,3578751144,3578751164,20
3,1321,34398,3578751144,3578751164,20
3,1321,34399,3578751144,3578751166,22
3,1321,34400,3578751144,3578751166,22
3,1321,34401,3578751144,3578751167,23
3,1321,34402,3578751144,3578751167,23
3,1321,34403,3578751144,3578751168,24
3,1321,34404,3578751144,3578751169,25
3,1321,34405,3578751144,3578751169,25
3,1321,34406,3578751144,3578751171,27
3,1321,34407,3578751144,3578751172,28
3,1321,34408,3578751144,3578751172,28
3,1321,34409,3578751144,3578751172,28
3,1321,34410,3578751144,3578751173,29
3,1321,34411,3578751144,3578751174,30
3,1321,34412,3578751144,3578751174,30
3,1321,34413,3578751144,3578751179,35
3,1321,34414,3578751144,3578751183,39
3,1321,34415,3578751144,3578751183,39
3,1321,34416,3578751144,3578751184,40
3,1321,34417,3578751144,3578751184,40
3,1321,34418,3578751144,3578751186,42
3,1321,34419,3578751144,3578751187,43
3,1321,34420,3578751144,3578751187,43
3,1321,34421,3578751144,3578751187,43
3,1321,34422,3578751144,3578751188,44
3,1321,34423,3578751144,3578751188,44
3,1321,34424,3578751144,3578751188,44
3,1321,34425,3578751144,3578751188,44
3,1321,34426,3578751144,3578751189,45
3,1321,34427,3578751144,3578751189,45
3,1321,34428,3578751144,3578751191,47
3,1321,34429,3578751144,3578751191,47
3,1322,34430,3578751208,3578751208,0
3,1322,34431,3578751208,3578751208,0
3,1322,34432,3578751208,3578751208,0
3,1322,34433,3578751208,3578751208,0
3,1322,34434,3578751208,3578751208,0
3,1322,34435,3578751208,3578751208,0
3,1322,34436,3578751208,3578751208,0
3,1322,34437,3578751208,3578751208,0
3,1322,34438,3578751208,3578751208,0
3,1322,34439,3578751208,3578751208,0
3,1322,34440,3578751208,3578751208,0
3,1322,34441,3578751208,3578751208,0
3,1322,34442,3578751208,3578751208,0
3,1322,34443,3578751208,3578751208,0
3,1322,34444,3578751208,3578751208,0
3,1322,34445,3578751208,3578751208,0
3,1322,34446,3578751208,3578751210,2
3,1322,34447,3578751208,3578751212,4
3,1322,34448,3578751208,3578751213,5
3,1322,34449,3578751208,3578751214,6
3,1322,34450,3578751208,3578751215,7
3,1322,34451,3578751208,3578751216,8
3,1322,34452,3578751208,3578751217,9
3,1322,34453,3578751208,3578751217,9
3,1322,34454,3578751208,3578751221,13
3,1322,34455,3578751208,3578751222,14
3,1322,34456,3578751208,3578751222,14
3,1322,34457,3578751208,3578751224,16
3,1322,34458,3578751208,3578751225,17
3,1322,34459,3578751208,3578751226,18
3,1322,34460,3578751208,3578751227,19
3,1322,34461,3578751208,3578751227,19
3,1322,34462,3578751208,3578751227,19
3,1322,34463,3578751208,3578751227,19
3,1322,34464,3578751208,3578751229,21
3,1322,34465,3578751208,3578751230,22
3,1322,34466,3578751208,3578751232,24
3,1322,34467,3578751208,3578751232,24
3,1322,34468,3578751208,3578751235,27
3,1322,34469,3578751208,3578751236,28
3,1322,34470,3578751208,3578751236,28
3,1322,34471,3578751208,3578751236,28
3,1322,34472,3578751208,3578751237,29
3,1322,34473,3578751208,3578751239,31
3,1322,34474,3578751208,3578751239,31
3,1322,34475,3578751208,3578751240,32
3,1322,34476,3578751208,3578751241,33
3,1322,34477,3578751208,3578751242,34
3,1322,34478,3578751208,3578751243,35
3,1322,34479,3578751208,3578751243,35
3,1322,34480,3578751208,3578751244,36
3,1322,34481,3578751208,3578751244,36
3,1322,34482,3578751208,3578751245,37
3,1322,34483,3578751208,3578751245,37
3,1322,34484,3578751208,3578751246,38
3,1322,34485,3578751208,3578751246,38
3,1322,34486,3578751208,3578751247,39
3,1322,34487,3578751208,3578751250,42
3,1322,34488,3578751208,3578751250,42
3,1322,34489,3578751208,3578751251,43
3,1322,34490,3578751208,3578751253,45
3,1322,34491,3578751208,3578751254,46
3,1322,34492,3578751208,3578751256,48
3,1322,34493,3578751208,3578751257,49
3,1323,34494,3578751271,3578751272,1
3,1323,34495,3578751271,3578751272,1
3,1323,34496,3578751271,3578751272,1
3,1323,34497,3578751271,3578751272,1
3,1323,34498,3578751271,3578751272,1
3,1323,34499,3578751271,3578751272,1
3,1323,34500,3578751271,3578751272,1
3,1323,34501,3578751271,3578751272,1
3,1323,34502,3578751271,3578751274,3
3,1323,34503,3578751271,3578751279,8
3,1323,34504,3578751271,3578751279,8
3,1323,34505,3578751271,3578751280,9
3,1323,34506,3578751271,3578751282,11
3,1323,34507,3578751271,3578751283,12
3,1323,34508,3578751271,3578751284,13
3,1323,34509,3578751271,3578751284,13
3,1323,34510,3578751271,3578751285,14
3,1323,34511,3578751271,3578751287,16
3,1323,34512,3578751271,3578751287,16
3,1323,34513,3578751271,3578751288,17
3,1323,34514,3578751271,3578751289,18
3,1323,34515,3578751271,3578751293,22
3,1323,34516,3578751271,3578751293,22
3,1323,34517,3578751271,3578751294,23
3,1323,34518,3578751271,3578751294,23
3,1323,34519,3578751271,3578751296,25
3,1323,34520,3578751271,3578751296,25
3,1323,34521,3578751271,3578751298,27
3,1323,34522,3578751271,3578751298,27
3,1323,34523,3578751271,3578751298,27
3,1323,34524,3578751271,3578751299,28
3,1323,34525,3578751271,3578751300,29
3,1323,34526,3578751271,3578751301,30
3,1323,34527,3578751271,3578751302,31
3,1323,34528,3578751271,3578751304,33
3,1323,34529,3578751271,3578751304,33
3,1323,34530,3578751271,3578751305,34
3,1323,34531,3578751271,3578751305,34
3,1323,34532,3578751271,3578751308,37
3,1323,34533,3578751271,3578751308,37
3,1323,34534,3578751271,3578751309,38
3,1323,34535,3578751271,3578751310,39
3,1323,34536,3578751271,3578751311,40
3,1323,34537,3578751271,3578751314,43
3,1323,34538,3578751271,3578751316,45
3,1323,34539,3578751271,3578751317,46
3,1323,34540,3578751271,3578751318,47
3,1323,34541,3578751271,3578751318,47
3,1323,34542,3578751271,3578751319,48
3,1323,34543,3578751271,3578751320,49
3,1323,34544,3578751271,3578751320,49
3,1324,34545,3578751333,3578751333,0
3,1324,34546,3578751333,3578751333,0
3,1324,34547,3578751333,3578751333,0
3,1324,34548,3578751333,3578751333,0
3,1324,34549,3578751333,3578751333,0
3,1324,34550,3578751333,3578751336,3
3,1324,34551,3578751333,3578751338,5
3,1324,34552,3578751333,3578751338,5
3,1324,34553,3578751333,3578751339,6
3,1324,34554,3578751333,3578751340,7
3,1324,34555,3578751333,3578751342,9
3,1324,34556,3578751333,3578751344,11
3,1324,34557,3578751333,3578751346,13
3,1324,34558,3578751333,3578751349,16
3,1324,34559,3578751333,3578751350,17
3,1324,34560,3578751333,3578751350,17
3,1324,34561,3578751333,3578751353,20
3,1324,34562,3578751333,3578751354,21
3,1324,34563,3578751333,3578751354,21
3,1324,34564,3578751333,3578751357,24
3,1324,34565,3578751333,3578751358,25
3,1324,34566,3578751333,3578751359,26
3,1324,34567,3578751333,3578751360,27
3,1324,34568,3578751333,3578751364,31
3,1324,34569,3578751333,3578751364,31
3,1324,34570,3578751333,3578751366,33
3,1324,34571,3578751333,3578751366,33
3,1324,34572,3578751333,3578751367,34
3,1324,34573,3578751333,3578751367,34
3,1324,34574,3578751333,3578751369,36
3,1324,34575,3578751333,3578751369,36
3,1324,34576,3578751333,3578751369,36
3,1324,34577,3578751333,3578751369,36
3,1324,34578,3578751333,3578751370,37
3,1324,34579,3578751333,3578751370,37
3,1324,34580,3578751333,3578751372,39
3,1324,34581,3578751333,3578751372,39
3,1324,34582,3578751333,3578751373,40
3,1324,34583,3578751333,3578751373,40
3,1324,34584,3578751333,3578751374,41
3,1324,34585,3578751333,3578751374,41
3,1324,34586,3578751333,3578751376,43
3,1324,34587,3578751333,3578751379,46
3,1324,34588,3578751333,3578751383,50
3,1325,34589,3578751396,3578751396,0
3,1325,34590,3578751396,3578751396,0
3,1325,34591,3578751396,3578751396,0
3,1325,34592,3578751396,3578751396,0
3,1325,34593,3578751396,3578751396,0
3,1325,34594,3578751396,3578751396,0
3,1325,34595,3578751396,3578751396,0
3,1325,34596,3578751396,3578751396,0
3,1325,34597,3578751396,3578751396,0
3,1325,34598,3578751396,3578751396,0
3,1325,34599,3578751396,3578751396,0
3,1325,34600,3578751396,3578751396,0
3,1325,34601,3578751396,3578751396,0
3,1325,34602,3578751396,3578751396,0
3,1325,34603,3578751396,3578751396,0
3,1325,34604,3578751396,3578751396,0
3,1325,34605,3578751396,3578751396,0
3,1325,34606,3578751396,3578751396,0
3,1325,34607,3578751396,3578751396,0
3,1325,34608,3578751396,3578751396,0
3,1325,34609,3578751396,3578751399,3
3,1325,34610,3578751396,3578751401,5
3,1325,34611,3578751396,3578751401,5
3,1325,34612,3578751396,3578751403,7
3,1325,34613,3578751396,3578751404,8
3,1325,34614,3578751396,3578751405,9
3,1325,34615,3578751396,3578751406,10
3,1325,34616,3578751396,3578751406,10
3,1325,34617,3578751396,3578751407,11
3,1325,34618,3578751396,3578751408,12
3,1325,34619,3578751396,3578751409,13
3,1325,34620,3578751396,3578751410,14
3,1325,34621,3578751396,3578751413,17
3,1325,34622,3578751396,3578751413,17
3,1325,34623,3578751396,3578751413,17
3,1325,34624,3578751396,3578751414,18
3,1325,34625,3578751396,3578751415,19
3,1325,34626,3578751396,3578751416,20
3,1325,34627,3578751396,3578751417,21
3,1325,34628,3578751396,3578751417,21
3,1325,34629,3578751396,3578751421,25
3,1325,34630,3578751396,3578751422,26
3,1325,34631,3578751396,3578751422,26
3,1325,34632,3578751396,3578751423,27
3,1325,34633,3578751396,3578751425,29
3,1325,34634,3578751396,3578751425,29
3,1325,34635,3578751396,3578751426,30
3,1325,34636,3578751396,3578751426,30
3,1325,34637,3578751396,3578751427,31
3,1325,34638,3578751396,3578751427,31
3,1325,34639,3578751396,3578751427,31
3,1325,34640,3578751396,3578751429,33
3,1325,34641,3578751396,3578751429,33
3,1325,34642,3578751396,3578751430,34
3,1325,34643,3578751396,3578751431,35
3,1325,34644,3578751396,3578751432,36
3,1325,34645,3578751396,3578751433,37
3,1325,34646,3578751396,3578751433,37
3,1325,34647,3578751396,3578751435,39
3,1325,34648,3578751396,3578751436,40
3,1325,34649,3578751396,3578751436,40
3,1325,34650,3578751396,3578751436,40
3,1325,34651,3578751396,3578751437,41
3,1325,34652,3578751396,3578751441,45
3,1325,34653,3578751396,3578751441,45
3,1325,34654,3578751396,3578751441,45
3,1325,34655,3578751396,3578751443,47
3,1325,34656,3578751396,3578751443,47
3,1325,34657,3578751396,3578751443,47
3,1325,34658,3578751396,3578751444,48
3,1325,34659,3578751396,3578751445,49
3,1325,34660,3578751396,3578751445,49
3,1326,34661,3578751458,3578751458,0
3,1326,34662,3578751458,3578751458,0
3,1326,34663,3578751458,3578751458,0
3,1326,34664,3578751458,3578751458,0
3,1326,34665,3578751458,3578751458,0
3,1326,34666,3578751458,3578751458,0
3,1326,34667,3578751458,3578751458,0
3,1326,34668,3578751458,3578751458,0
3,1326,34669,3578751458,3578751458,0
3,1326,34670,3578751458,3578751458,0
3,1326,34671,3578751458,3578751458,0
3,1326,34672,3578751458,3578751460,2
3,1326,34673,3578751458,3578751461,3
3,1326,34674,3578751458,3578751462,4
3,1326,34675,3578751458,3578751463,5
3,1326,34676,3578751458,3578751464,6
3,1326,34677,3578751458,3578751464,6
3,1326,34678,3578751458,3578751470,12
3,1326,34679,3578751458,3578751474,16
3,1326,34680,3578751458,3578751479,21
3,1326,34681,3578751458,3578751479,21
3,1326,34682,3578751458,3578751480,22
3,1326,34683,3578751458,3578751482,24
3,1326,34684,3578751458,3578751483,25
3,1326,34685,3578751458,3578751484,26
3,1326,34686,3578751458,3578751484,26
3,1326,34687,3578751458,3578751485,27
3,1326,34688,3578751458,3578751487,29
3,1326,34689,3578751458,3578751487,29
3,1326,34690,3578751458,3578751488,30
3,1326,34691,3578751458,3578751490,32
3,1326,34692,3578751458,3578751493,35
3,1326,34693,3578751458,3578751493,35
3,1326,34694,3578751458,3578751493,35
3,1326,34695,3578751458,3578751494,36
3,1326,34696,3578751458,3578751495,37
3,1326,34697,3578751458,3578751496,38
3,1326,34698,3578751458,3578751498,40
3,1326,34699,3578751458,3578751498,40
3,1326,34700,3578751458,3578751498,40
3,1326,34701,3578751458,3578751499,41
3,1326,34702,3578751458,3578751500,42
3,1326,34703,3578751458,3578751502,44
3,1326,34704,3578751458,3578751503,45
3,1326,34705,3578751458,3578751505,47
3,1326,34706,3578751458,3578751505,47
3,1326,34707,3578751458,3578751505,47
3,1326,34708,3578751458,3578751508,50
3,1327,34709,3578751521,3578751521,0
3,1327,34710,3578751521,3578751521,0
3,1327,34711,3578751521,3578751521,0
3,1327,34712,3578751521,3578751521,0
3,1327,34713,3578751521,3578751521,0
3,1327,34714,3578751521,3578751521,0
3,1327,34715,3578751521,3578751521,0
3,1327,34716,3578751521,3578751521,0
3,1327,34717,3578751521,3578751521,0
3,1327,34718,3578751521,3578751521,0
3,1327,34719,3578751521,3578751522,1
3,1327,34720,3578751521,3578751522,1
3,1327,34721,3578751521,3578751526,5
3,1327,34722,3578751521,3578751528,7
3,1327,34723,3578751521,3578751531,10
3,1327,34724,3578751521,3578751533,12
3,1327,34725,3578751521,3578751535,14
3,1327,34726,3578751521,3578751537,16
3,1327,34727,3578751521,3578751538,17
3,1327,34728,3578751521,3578751538,17
3,1327,34729,3578751521,3578751540,19
3,1327,34730,3578751521,3578751541,20
3,1327,34731,3578751521,3578751543,22
3,1327,34732,3578751521,3578751549,28
3,1327,34733,3578751521,3578751549,28
3,1327,34734,3578751521,3578751549,28
3,1327,34735,3578751521,3578751551,30
3,1327,34736,3578751521,3578751552,31
3,1327,34737,3578751521,3578751553,32
3,1327,34738,3578751521,3578751553,32
3,1327,34739,3578751521,3578751556,35
3,1327,34740,3578751521,3578751556,35
3,1327,34741,3578751521,3578751557,36
3,1327,34742,3578751521,3578751558,37
3,1327,34743,3578751521,3578751560,39
3,1327,34744,3578751521,3578751564,43
3,1327,34745,3578751521,3578751565,44
3,1327,34746,3578751521,3578751566,45
3,1327,34747,3578751521,3578751567,46
3,1327,34748,3578751521,3578751568,47
3,1327,34749,3578751521,3578751569,48
3,1327,34750,3578751521,3578751569,48
3,1327,34751,3578751521,3578751569,48
3,1327,34752,3578751521,3578751569,48
3,1327,34753,3578751521,3578751569,48
3,1327,34754,3578751521,3578751571,50
3,1328,34755,3578751583,3578751583,0
3,1328,34756,3578751583,3578751583,0
3,1328,34757,3578751583,3578751583,0
3,1328,34758,3578751583,3578751583,0
3,1328,34759,3578751583,3578751583,0
3,1328,34760,3578751583,3578751583,0
3,1328,34761,3578751583,3578751583,0
3,1328,34762,3578751583,3578751583,0
3,1328,34763,3578751583,3578751583,0
3,1328,34764,3578751583,3578751583,0
3,1328,34765,3578751583,3578751583,0
3,1328,34766,3578751583,3578751583,0
3,1328,34767,3578751583,3578751585,2
3,1328,34768,3578751583,3578751587,4
3,1328,34769,3578751583,3578751587,4
3,1328,34770,3578751583,3578751587,4
3,1328,34771,3578751583,3578751587,4
3,1328,34772,3578751583,3578751587,4
3,1328,34773,3578751583,3578751587,4
3,1328,34774,3578751583,3578751588,5
3,1328,34775,3578751583,3578751588,5
3,1328,34776,3578751583,3578751588,5
3,1328,34777,3578751583,3578751589,6
3,1328,34778,3578751583,3578751591,8
3,1328,34779,3578751583,3578751592,9
3,1328,34780,3578751583,3578751593,10
3,1328,34781,3578751583,3578751593,10
3,1328,34782,3578751583,3578751595,12
3,1328,34783,3578751583,3578751595,12
3,1328,34784,3578751583,3578751599,16
3,1328,34785,3578751583,3578751600,17
3,1328,34786,3578751583,3578751600,17
3,1328,34787,3578751583,3578751602,19
3,1328,34788,3578751583,3578751603,20
3,1328,34789,3578751583,3578751603,20
3,1328,34790,3578751583,3578751604,21
3,1328,34791,3578751583,3578751604,21
3,1328,34792,3578751583,3578751605,22
3,1328,34793,3578751583,3578751605,22
3,1328,34794,3578751583,3578751606,23
3,1328,34795,3578751583,3578751607,24
3,1328,34796,3578751583,3578751607,24
3,1328,34797,3578751583,3578751607,24
3,1328,34798,3578751583,3578751608,25
3,1328,34799,3578751583,3578751609,26
3,1328,34800,3578751583,3578751611,28
3,1328,34801,3578751583,3578751612,29
3,1328,34802,3578751583,3578751613,30
3,1328,34803,3578751583,3578751614,31
3,1328,34804,3578751583,3578751615,32
3,1328,34805,3578751583,3578751616,33
3,1328,34806,3578751583,3578751621,38
3,1328,34807,3578751583,3578751621,38
3,1328,34808,3578751583,3578751621,38
3,1328,34809,3578751583,3578751624,41
3,1328,34810,3578751583,3578751624,41
3,1328,34811,3578751583,3578751625,42
3,1328,34812,3578751583,3578751626,43
3,1328,34813,3578751583,3578751626,43
3,1328,34814,3578751583,3578751627,44
3,1328,34815,3578751583,3578751628,45
3,1328,34816,3578751583,3578751629,46
3,1328,34817,3578751583,3578751629,46
3,1328,34818,3578751583,3578751630,47
3,1328,34819,3578751583,3578751631,48
3,1328,34820,3578751583,3578751632,49
3,1328,34821,3578751583,3578751632,49
3,1329,34822,3578751645,3578751645,0
3,1329,34823,3578751645,3578751645,0
3,1329,34824,3578751645,3578751645,0
3,1329,34825,3578751645,3578751645,0
3,1329,34826,3578751645,3578751645,0
3,1329,34827,3578751645,3578751645,0
3,1329,34828,3578751645,3578751645,0
3,1329,34829,3578751645,3578751645,0
3,1329,34830,3578751645,3578751645,0
3,1329,34831,3578751645,3578751645,0
3,1329,34832,3578751645,3578751645,0
3,1329,34833,3578751645,3578751645,0
3,1329,34834,3578751645,3578751645,0
3,1329,34835,3578751645,3578751645,0
3,1329,34836,3578751645,3578751646,1
3,1329,34837,3578751645,3578751647,2
3,1329,34838,3578751645,3578751647,2
3,1329,34839,3578751645,3578751649,4
3,1329,34840,3578751645,3578751649,4
3,1329,34841,3578751645,3578751651,6
3,1329,34842,3578751645,3578751653,8
3,1329,34843,3578751645,3578751656,11
3,1329,34844,3578751645,3578751658,13
3,1329,34845,3578751645,3578751659,14
3,1329,34846,3578751645,3578751661,16
3,1329,34847,3578751645,3578751661,16
3,1329,34848,3578751645,3578751662,17
3,1329,34849,3578751645,3578751663,18
3,1329,34850,3578751645,3578751669,24
3,1329,34851,3578751645,3578751674,29
3,1329,34852,3578751645,3578751679,34
3,1329,34853,3578751645,3578751679,34
3,1329,34854,3578751645,3578751680,35
3,1329,34855,3578751645,3578751682,37
3,1329,34856,3578751645,3578751684,39
3,1329,34857,3578751645,3578751684,39
3,1329,34858,3578751645,3578751684,39
3,1329,34859,3578751645,3578751686,41
3,1329,34860,3578751645,3578751687,42
3,1329,34861,3578751645,3578751688,43
3,1329,34862,3578751645,3578751688,43
3,1329,34863,3578751645,3578751689,44
3,1329,34864,3578751645,3578751693,48
3,1329,34865,3578751645,3578751693,48
3,1329,34866,3578751645,3578751694,49
3,1329,34867,3578751645,3578751694,49
3,1330,34868,3578751707,3578751707,0
3,1330,34869,3578751707,3578751707,0
3,1330,34870,3578751707,3578751707,0
3,1330,34871,3578751707,3578751707,0
3,1330,34872,3578751707,3578751707,0
3,1330,34873,3578751707,3578751707,0
3,1330,34874,3578751707,3578751707,0
3,1330,34875,3578751707,3578751707,0
3,1330,34876,3578751707,3578751707,0
3,1330,34877,3578751707,3578751707,0
3,1330,34878,3578751707,3578751707,0
3,1330,34879,3578751707,3578751707,0
3,1330,34880,3578751707,3578751707,0
3,1330,34881,3578751707,3578751709,2
3,1330,34882,3578751707,3578751709,2
3,1330,34883,3578751707,3578751710,3
3,1330,34884,3578751707,3578751711,4
3,1330,34885,3578751707,3578751713,6
3,1330,34886,3578751707,3578751715,8
3,1330,34887,3578751707,3578751716,9
3,1330,34888,3578751707,3578751717,10
3,1330,34889,3578751707,3578751717,10
3,1330,34890,3578751707,3578751718,11
3,1330,34891,3578751707,3578751720,13
3,1330,34892,3578751707,3578751721,14
3,1330,34893,3578751707,3578751721,14
3,1330,34894,3578751707,3578751721,14
3,1330,34895,3578751707,3578751722,15
3,1330,34896,3578751707,3578751727,20
3,1330,34897,3578751707,3578751729,22
3,1330,34898,3578751707,3578751732,25
3,1330,34899,3578751707,3578751733,26
3,1330,34900,3578751707,3578751734,27
3,1330,34901,3578751707,3578751738,31
3,1330,34902,3578751707,3578751738,31
3,1330,34903,3578751707,3578751738,31
3,1330,34904,3578751707,3578751740,33
3,1330,34905,3578751707,3578751740,33
3,1330,34906,3578751707,3578751743,36
3,1330,34907,3578751707,3578751749,42
3,1330,34908,3578751707,3578751749,42
3,1330,34909,3578751707,3578751749,42
3,1330,34910,3578751707,3578751751,44
3,1330,34911,3578751707,3578751752,45
3,1330,34912,3578751707,3578751753,46
3,1330,34913,3578751707,3578751753,46
3,1330,34914,3578751707,3578751756,49
3,1330,34915,3578751707,3578751756,49
3,1330,34916,3578751707,3578751757,50
3,1331,34917,3578751770,3578751770,0
3,1331,34918,3578751770,3578751770,0
3,1331,34919,3578751770,3578751770,0
3,1331,34920,3578751770,3578751770,0
3,1331,34921,3578751770,3578751770,0
3,1331,34922,3578751770,3578751770,0
3,1331,34923,3578751770,3578751770,0
3,1331,34924,3578751770,3578751770,0
3,1331,34925,3578751770,3578751770,0
3,1331,34926,3578751770,3578751770,0
3,1331,34927,3578751770,3578751770,0
3,1331,34928,3578751770,3578751770,0
3,1331,34929,3578751770,3578751770,0
3,1331,34930,3578751770,3578751771,1
3,1331,34931,3578751770,3578751772,2
3,1331,34932,3578751770,3578751772,2
3,1331,34933,3578751770,3578751773,3
3,1331,34934,3578751770,3578751774,4
3,1331,34935,3578751770,3578751774,4
3,1331,34936,3578751770,3578751777,7
3,1331,34937,3578751770,3578751777,7
3,1331,34938,3578751770,3578751782,12
3,1331,34939,3578751770,3578751782,12
3,1331,34940,3578751770,3578751783,13
3,1331,34941,3578751770,3578751783,13
3,1331,34942,3578751770,3578751783,13
3,1331,34943,3578751770,3578751787,17
3,1331,34944,3578751770,3578751787,17
3,1331,34945,3578751770,3578751787,17
3,1331,34946,3578751770,3578751787,17
3,1331,34947,3578751770,3578751787,17
3,1331,34948,3578751770,3578751787,17
3,1331,34949,3578751770,3578751788,18
3,1331,34950,3578751770,3578751788,18
3,1331,34951,3578751770,3578751789,19
3,1331,34952,3578751770,3578751789,19
3,1331,34953,3578751770,3578751790,20
3,1331,34954,3578751770,3578751791,21
3,1331,34955,3578751770,3578751792,22
3,1331,34956,3578751770,3578751793,23
3,1331,34957,3578751770,3578751795,25
3,1331,34958,3578751770,3578751799,29
3,1331,34959,3578751770,3578751800,30
3,1331,34960,3578751770,3578751801,31
3,1331,34961,3578751770,3578751802,32
3,1331,34962,3578751770,3578751802,32
3,1331,34963,3578751770,3578751803,33
3,1331,34964,3578751770,3578751804,34
3,1331,34965,3578751770,3578751805,35
3,1331,34966,3578751770,3578751805,35
3,1331,34967,3578751770,3578751805,35
3,1331,34968,3578751770,3578751805,35
3,1331,34969,3578751770,3578751807,37
3,1331,34970,3578751770,3578751807,37
3,1331,34971,3578751770,3578751808,38
3,1331,34972,3578751770,3578751808,38
3,1331,34973,3578751770,3578751809,39
3,1331,34974,3578751770,3578751811,41
3,1331,34975,3578751770,3578751812,42
3,1331,34976,3578751770,3578751812,42
3,1331,34977,3578751770,3578751814,44
3,1331,34978,3578751770,3578751815,45
3,1332,34979,3578751833,3578751833,0
3,1332,34980,3578751833,3578751833,0
3,1332,34981,3578751833,3578751833,0
3,1332,34982,3578751833,3578751833,0
3,1332,34983,3578751833,3578751834,1
3,1332,34984,3578751833,3578751834,1
3,1332,34985,3578751833,3578751834,1
3,1332,34986,3578751833,3578751834,1
3,1332,34987,3578751833,3578751834,1
3,1332,34988,3578751833,3578751834,1
3,1332,34989,3578751833,3578751834,1
3,1332,34990,3578751833,3578751834,1
3,1332,34991,3578751833,3578751834,1
3,1332,34992,3578751833,3578751834,1
3,1332,34993,3578751833,3578751834,1
3,1332,34994,3578751833,3578751835,2
3,1332,34995,3578751833,3578751835,2
3,1332,34996,3578751833,3578751835,2
3,1332,34997,3578751833,3578751836,3
3,1332,34998,3578751833,3578751839,6
3,1332,34999,3578751833,3578751840,7
3,1332,35000,3578751833,3578751843,10
3,1332,35001,3578751833,3578751843,10
3,1332,35002,3578751833,3578751843,10
3,1332,35003,3578751833,3578751844,11
3,1332,35004,3578751833,3578751846,13
3,1332,35005,3578751833,3578751847,14
3,1332,35006,3578751833,3578751847,14
3,1332,35007,3578751833,3578751850,17
3,1332,35008,3578751833,3578751850,17
3,1332,35009,3578751833,3578751851,18
3,1332,35010,3578751833,3578751854,21
3,1332,35011,3578751833,3578751856,23
3,1332,35012,3578751833,3578751856,23
3,1332,35013,3578751833,3578751858,25
3,1332,35014,3578751833,3578751860,27
3,1332,35015,3578751833,3578751861,28
3,1332,35016,3578751833,3578751862,29
3,1332,35017,3578751833,3578751862,29
3,1332,35018,3578751833,3578751863,30
3,1332,35019,3578751833,3578751864,31
3,1332,35020,3578751833,3578751868,35
3,1332,35021,3578751833,3578751874,41
3,1332,35022,3578751833,3578751879,46
3,1332,35023,3578751833,3578751880,47
3,1332,35024,3578751833,3578751880,47
3,1332,35025,3578751833,3578751882,49
3,1333,35026,3578751895,3578751895,0
3,1333,35027,3578751895,3578751895,0
3,1333,35028,3578751895,3578751895,0
3,1333,35029,3578751895,3578751895,0
3,1333,35030,3578751895,3578751895,0
3,1333,35031,3578751895,3578751895,0
3,1333,35032,3578751895,3578751895,0
3,1333,35033,3578751895,3578751895,0
3,1333,35034,3578751895,3578751895,0
3,1333,35035,3578751895,3578751895,0
3,1333,35036,3578751895,3578751895,0
3,1333,35037,3578751895,3578751895,0
3,1333,35038,3578751895,3578751896,1
3,1333,35039,3578751895,3578751898,3
3,1333,35040,3578751895,3578751898,3
3,1333,35041,3578751895,3578751899,4
3,1333,35042,3578751895,3578751900,5
3,1333,35043,3578751895,3578751901,6
3,1333,35044,3578751895,3578751901,6
3,1333,35045,3578751895,3578751904,9
3,1333,35046,3578751895,3578751904,9
3,1333,35047,3578751895,3578751905,10
3,1333,35048,3578751895,3578751905,10
3,1333,35049,3578751895,3578751905,10
3,1333,35050,3578751895,3578751909,14
3,1333,35051,3578751895,3578751909,14
3,1333,35052,3578751895,3578751909,14
3,1333,35053,3578751895,3578751911,16
3,1333,35054,3578751895,3578751911,16
3,1333,35055,3578751895,3578751914,19
3,1333,35056,3578751895,3578751915,20
3,1333,35057,3578751895,3578751917,22
3,1333,35058,3578751895,3578751917,22
3,1333,35059,3578751895,3578751918,23
3,1333,35060,3578751895,3578751920,25
3,1333,35061,3578751895,3578751921,26
3,1333,35062,3578751895,3578751921,26
3,1333,35063,3578751895,3578751922,27
3,1333,35064,3578751895,3578751922,27
3,1333,35065,3578751895,3578751927,32
3,1333,35066,3578751895,3578751928,33
3,1333,35067,3578751895,3578751932,37
3,1333,35068,3578751895,3578751932,37
3,1333,35069,3578751895,3578751935,40
3,1333,35070,3578751895,3578751938,43
3,1333,35071,3578751895,3578751940,45
3,1333,35072,3578751895,3578751941,46
3,1333,35073,3578751895,3578751944,49
3,1334,35074,3578751957,3578751957,0
3,1334,35075,3578751957,3578751957,0
3,1334,35076,3578751957,3578751957,0
3,1334,35077,3578751957,3578751957,0
3,1334,35078,3578751957,3578751957,0
3,1334,35079,3578751957,3578751957,0
3,1334,35080,3578751957,3578751957,0
3,1334,35081,3578751957,3578751957,0
3,1334,35082,3578751957,3578751957,0
3,1334,35083,3578751957,3578751958,1
3,1334,35084,3578751957,3578751958,1
3,1334,35085,3578751957,3578751960,3
3,1334,35086,3578751957,3578751964,7
3,1334,35087,3578751957,3578751964,7
3,1334,35088,3578751957,3578751965,8
3,1334,35089,3578751957,3578751966,9
3,1334,35090,3578751957,3578751967,10
3,1334,35091,3578751957,3578751967,10
3,1334,35092,3578751957,3578751968,11
3,1334,35093,3578751957,3578751968,11
3,1334,35094,3578751957,3578751969,12
3,1334,35095,3578751957,3578751969,12
3,1334,35096,3578751957,3578751969,12
3,1334,35097,3578751957,3578751971,14
3,1334,35098,3578751957,3578751973,16
3,1334,35099,3578751957,3578751974,17
3,1334,35100,3578751957,3578751974,17
3,1334,35101,3578751957,3578751977,20
3,1334,35102,3578751957,3578751978,21
3,1334,35103,3578751957,3578751982,25
3,1334,35104,3578751957,3578751983,26
3,1334,35105,3578751957,3578751983,26
3,1334,35106,3578751957,3578751984,27
3,1334,35107,3578751957,3578751987,30
3,1334,35108,3578751957,3578751987,30
3,1334,35109,3578751957,3578751987,30
3,1334,35110,3578751957,3578751987,30
3,1334,35111,3578751957,3578751987,30
3,1334,35112,3578751957,3578751988,31
3,1334,35113,3578751957,3578751988,31
3,1334,35114,3578751957,3578751989,32
3,1334,35115,3578751957,3578751989,32
3,1334,35116,3578751957,3578751989,32
3,1334,35117,3578751957,3578751990,33
3,1334,35118,3578751957,3578751991,34
3,1334,35119,3578751957,3578751992,35
3,1334,35120,3578751957,3578751993,36
3,1334,35121,3578751957,3578751994,37
3,1334,35122,3578751957,3578751995,38
3,1334,35123,3578751957,3578751999,42
3,1334,35124,3578751957,3578752000,43
3,1334,35125,3578751957,3578752001,44
3,1334,35126,3578751957,3578752002,45
3,1334,35127,3578751957,3578752002,45
3,1334,35128,3578751957,3578752002,45
3,1334,35129,3578751957,3578752004,47
3,1334,35130,3578751957,3578752005,48
3,1334,35131,3578751957,3578752005,48
3,1334,35132,3578751957,3578752005,48
3,1334,35133,3578751957,3578752006,49
3,1335,35134,3578752018,3578752018,0
3,1335,35135,3578752018,3578752018,0
3,1335,35136,3578752018,3578752018,0
3,1335,35137,3578752018,3578752018,0
3,1335,35138,3578752018,3578752018,0
3,1335,35139,3578752018,3578752018,0
3,1335,35140,3578752018,3578752018,0
3,1335,35141,3578752018,3578752018,0
3,1335,35142,3578752018,3578752018,0
3,1335,35143,3578752018,3578752018,0
3,1335,35144,3578752018,3578752018,0
3,1335,35145,3578752018,3578752018,0
3,1335,35146,3578752018,3578752021,3
3,1335,35147,3578752018,3578752021,3
3,1335,35148,3578752018,3578752021,3
3,1335,35149,3578752018,3578752024,6
3,1335,35150,3578752018,3578752025,7
3,1335,35151,3578752018,3578752025,7
3,1335,35152,3578752018,3578752027,9
3,1335,35153,3578752018,3578752027,9
3,1335,35154,3578752018,3578752028,10
3,1335,35155,3578752018,3578752028,10
3,1335,35156,3578752018,3578752028,10
3,1335,35157,3578752018,3578752030,12
3,1335,35158,3578752018,3578752032,14
3,1335,35159,3578752018,3578752032,14
3,1335,35160,3578752018,3578752034,16
3,1335,35161,3578752018,3578752035,17
3,1335,35162,3578752018,3578752036,18
3,1335,35163,3578752018,3578752036,18
3,1335,35164,3578752018,3578752039,21
3,1335,35165,3578752018,3578752039,21
3,1335,35166,3578752018,3578752040,22
3,1335,35167,3578752018,3578752040,22
3,1335,35168,3578752018,3578752042,24
3,1335,35169,3578752018,3578752043,25
3,1335,35170,3578752018,3578752043,25
3,1335,35171,3578752018,3578752044,26
3,1335,35172,3578752018,3578752044,26
3,1335,35173,3578752018,3578752044,26
3,1335,35174,3578752018,3578752045,27
3,1335,35175,3578752018,3578752046,28
3,1335,35176,3578752018,3578752047,29
3,1335,35177,3578752018,3578752047,29
3,1335,35178,3578752018,3578752050,32
3,1335,35179,3578752018,3578752051,33
3,1335,35180,3578752018,3578752054,36
3,1335,35181,3578752018,3578752055,37
3,1335,35182,3578752018,3578752056,38
3,1335,35183,3578752018,3578752056,38
3,1335,35184,3578752018,3578752058,40
3,1335,35185,3578752018,3578752059,41
3,1335,35186,3578752018,3578752061,43
3,1335,35187,3578752018,3578752062,44
3,1335,35188,3578752018,3578752063,45
3,1335,35189,3578752018,3578752064,46
3,1335,35190,3578752018,3578752064,46
3,1335,35191,3578752018,3578752068,50
3,1336,35192,3578752080,3578752080,0
3,1336,35193,3578752080,3578752080,0
3,1336,35194,3578752080,3578752080,0
3,1336,35195,3578752080,3578752084,4
3,1336,35196,3578752080,3578752084,4
3,1336,35197,3578752080,3578752085,5
3,1336,35198,3578752080,3578752087,7
3,1336,35199,3578752080,3578752088,8
3,1336,35200,3578752080,3578752088,8
3,1336,35201,3578752080,3578752089,9
3,1336,35202,3578752080,3578752094,14
3,1336,35203,3578752080,3578752095,15
3,1336,35204,3578752080,3578752096,16
3,1336,35205,3578752080,3578752096,16
3,1336,35206,3578752080,3578752098,18
3,1336,35207,3578752080,3578752098,18
3,1336,35208,3578752080,3578752100,20
3,1336,35209,3578752080,3578752101,21
3,1336,35210,3578752080,3578752101,21
3,1336,35211,3578752080,3578752103,23
3,1336,35212,3578752080,3578752104,24
3,1336,35213,3578752080,3578752104,24
3,1336,35214,3578752080,3578752105,25
3,1336,35215,3578752080,3578752105,25
3,1336,35216,3578752080,3578752109,29
3,1336,35217,3578752080,3578752109,29
3,1336,35218,3578752080,3578752110,30
3,1336,35219,3578752080,3578752111,31
3,1336,35220,3578752080,3578752112,32
3,1336,35221,3578752080,3578752114,34
3,1336,35222,3578752080,3578752115,35
3,1336,35223,3578752080,3578752117,37
3,1336,35224,3578752080,3578752118,38
3,1336,35225,3578752080,3578752118,38
3,1336,35226,3578752080,3578752120,40
3,1336,35227,3578752080,3578752121,41
3,1336,35228,3578752080,3578752121,41
3,1336,35229,3578752080,3578752121,41
3,1336,35230,3578752080,3578752122,42
3,1336,35231,3578752080,3578752127,47
3,1336,35232,3578752080,3578752128,48
3,1337,35233,3578752142,3578752142,0
3,1337,35234,3578752142,3578752142,0
3,1337,35235,3578752142,3578752142,0
3,1337,35236,3578752142,3578752143,1
3,1337,35237,3578752142,3578752143,1
3,1337,35238,3578752142,3578752144,2
3,1337,35239,3578752142,3578752146,4
3,1337,35240,3578752142,3578752149,7
3,1337,35241,3578752142,3578752150,8
3,1337,35242,3578752142,3578752151,9
3,1337,35243,3578752142,3578752152,10
3,1337,35244,3578752142,3578752153,11
3,1337,35245,3578752142,3578752156,14
3,1337,35246,3578752142,3578752157,15
3,1337,35247,3578752142,3578752157,15
3,1337,35248,3578752142,3578752158,16
3,1337,35249,3578752142,3578752158,16
3,1337,35250,3578752142,3578752160,18
3,1337,35251,3578752142,3578752164,22
3,1337,35252,3578752142,3578752164,22
3,1337,35253,3578752142,3578752166,24
3,1337,35254,3578752142,3578752166,24
3,1337,35255,3578752142,3578752166,24
3,1337,35256,3578752142,3578752167,25
3,1337,35257,3578752142,3578752167,25
3,1337,35258,3578752142,3578752168,26
3,1337,35259,3578752142,3578752168,26
3,1337,35260,3578752142,3578752169,27
3,1337,35261,3578752142,3578752169,27
3,1337,35262,3578752142,3578752170,28
3,1337,35263,3578752142,3578752173,31
3,1337,35264,3578752142,3578752173,31
3,1337,35265,3578752142,3578752174,32
3,1337,35266,3578752142,3578752175,33
3,1337,35267,3578752142,3578752178,36
3,1337,35268,3578752142,3578752178,36
3,1337,35269,3578752142,3578752182,40
3,1337,35270,3578752142,3578752182,40
3,1337,35271,3578752142,3578752184,42
3,1337,35272,3578752142,3578752184,42
3,1337,35273,3578752142,3578752184,42
3,1337,35274,3578752142,3578752186,44
3,1337,35275,3578752142,3578752187,45
3,1337,35276,3578752142,3578752187,45
3,1337,35277,3578752142,3578752188,46
3,1337,35278,3578752142,3578752189,47
3,1337,35279,3578752142,3578752189,47
3,1337,35280,3578752142,3578752189,47
3,1337,35281,3578752142,3578752189,47
3,1337,35282,3578752142,3578752189,47
3,1337,35283,3578752142,3578752189,47
3,1337,35284,3578752142,3578752191,49
3,1337,35285,3578752142,3578752191,49
3,1338,35286,3578752204,3578752205,1
3,1338,35287,3578752204,3578752205,1
3,1338,35288,3578752204,3578752205,1
3,1338,35289,3578752204,3578752205,1
3,1338,35290,3578752204,3578752205,1
3,1338,35291,3578752204,3578752205,1
3,1338,35292,3578752204,3578752205,1
3,1338,35293,3578752204,3578752205,1
3,1338,35294,3578752204,3578752205,1
3,1338,35295,3578752204,3578752205,1
3,1338,35296,3578752204,3578752205,1
3,1338,35297,3578752204,3578752205,1
3,1338,35298,3578752204,3578752206,2
3,1338,35299,3578752204,3578752206,2
3,1338,35300,3578752204,3578752207,3
3,1338,35301,3578752204,3578752208,4
3,1338,35302,3578752204,3578752208,4
3,1338,35303,3578752204,3578752208,4
3,1338,35304,3578752204,3578752209,5
3,1338,35305,3578752204,3578752211,7
3,1338,35306,3578752204,3578752212,8
3,1338,35307,3578752204,3578752213,9
3,1338,35308,3578752204,3578752215,11
3,1338,35309,3578752204,3578752215,11
3,1338,35310,3578752204,3578752215,11
3,1338,35311,3578752204,3578752216,12
3,1338,35312,3578752204,3578752220,16
3,1338,35313,3578752204,3578752222,18
3,1338,35314,3578752204,3578752222,18
3,1338,35315,3578752204,3578752224,20
3,1338,35316,3578752204,3578752225,21
3,1338,35317,3578752204,3578752225,21
3,1338,35318,3578752204,3578752226,22
3,1338,35319,3578752204,3578752227,23
3,1338,35320,3578752204,3578752227,23
3,1338,35321,3578752204,3578752227,23
3,1338,35322,3578752204,3578752228,24
3,1338,35323,3578752204,3578752228,24
3,1338,35324,3578752204,3578752229,25
3,1338,35325,3578752204,3578752229,25
3,1338,35326,3578752204,3578752231,27
3,1338,35327,3578752204,3578752231,27
3,1338,35328,3578752204,3578752232,28
3,1338,35329,3578752204,3578752234,30
3,1338,35330,3578752204,3578752236,32
3,1338,35331,3578752204,3578752236,32
3,1338,35332,3578752204,3578752236,32
3,1338,35333,3578752204,3578752239,35
3,1338,35334,3578752204,3578752239,35
3,1338,35335,3578752204,3578752240,36
3,1338,35336,3578752204,3578752241,37
3,1338,35337,3578752204,3578752243,39
3,1338,35338,3578752204,3578752243,39
3,1338,35339,3578752204,3578752243,39
3,1338,35340,3578752204,3578752244,40
3,1338,35341,3578752204,3578752244,40
3,1338,35342,3578752204,3578752244,40
3,1338,35343,3578752204,3578752245,41
3,1338,35344,3578752204,3578752246,42
3,1338,35345,3578752204,3578752247,43
3,1338,35346,3578752204,3578752247,43
3,1338,35347,3578752204,3578752249,45
3,1338,35348,3578752204,3578752250,46
3,1338,35349,3578752204,3578752251,47
3,1338,35350,3578752204,3578752253,49
3,1338,35351,3578752204,3578752254,50
3,1339,35352,3578752268,3578752268,0
3,1339,35353,3578752268,3578752268,0
3,1339,35354,3578752268,3578752268,0
3,1339,35355,3578752268,3578752268,0
3,1339,35356,3578752268,3578752268,0
3,1339,35357,3578752268,3578752268,0
3,1339,35358,3578752268,3578752268,0
3,1339,35359,3578752268,3578752268,0
3,1339,35360,3578752268,3578752268,0
3,1339,35361,3578752268,3578752274,6
3,1339,35362,3578752268,3578752279,11
3,1339,35363,3578752268,3578752280,12
3,1339,35364,3578752268,3578752280,12
3,1339,35365,3578752268,3578752282,14
3,1339,35366,3578752268,3578752284,16
3,1339,35367,3578752268,3578752284,16
3,1339,35368,3578752268,3578752285,17
3,1339,35369,3578752268,3578752287,19
3,1339,35370,3578752268,3578752287,19
3,1339,35371,3578752268,3578752288,20
3,1339,35372,3578752268,3578752289,21
3,1339,35373,3578752268,3578752294,26
3,1339,35374,3578752268,3578752294,26
3,1339,35375,3578752268,3578752295,27
3,1339,35376,3578752268,3578752296,28
3,1339,35377,3578752268,3578752296,28
3,1339,35378,3578752268,3578752298,30
3,1339,35379,3578752268,3578752299,31
3,1339,35380,3578752268,3578752300,32
3,1339,35381,3578752268,3578752301,33
3,1339,35382,3578752268,3578752303,35
3,1339,35383,3578752268,3578752304,36
3,1339,35384,3578752268,3578752305,37
3,1339,35385,3578752268,3578752305,37
3,1339,35386,3578752268,3578752305,37
3,1339,35387,3578752268,3578752309,41
3,1339,35388,3578752268,3578752309,41
3,1339,35389,3578752268,3578752310,42
3,1339,35390,3578752268,3578752311,43
3,1339,35391,3578752268,3578752311,43
3,1339,35392,3578752268,3578752314,46
3,1339,35393,3578752268,3578752315,47
3,1339,35394,3578752268,3578752316,48
3,1339,35395,3578752268,3578752317,49
3,1339,35396,3578752268,3578752317,49
3,1340,35397,3578752330,3578752330,0
3,1340,35398,3578752330,3578752330,0
3,1340,35399,3578752330,3578752330,0
3,1340,35400,3578752330,3578752330,0
3,1340,35401,3578752330,3578752330,0
3,1340,35402,3578752330,3578752330,0
3,1340,35403,3578752330,3578752332,2
3,1340,35404,3578752330,3578752334,4
3,1340,35405,3578752330,3578752336,6
3,1340,35406,3578752330,3578752337,7
3,1340,35407,3578752330,3578752340,10
3,1340,35408,3578752330,3578752342,12
3,1340,35409,3578752330,3578752345,15
3,1340,35410,3578752330,3578752346,16
3,1340,35411,3578752330,3578752350,20
3,1340,35412,3578752330,3578752351,21
3,1340,35413,3578752330,3578752352,22
3,1340,35414,3578752330,3578752353,23
3,1340,35415,3578752330,3578752354,24
3,1340,35416,3578752330,3578752356,26
3,1340,35417,3578752330,3578752357,27
3,1340,35418,3578752330,3578752357,27
3,1340,35419,3578752330,3578752357,27
3,1340,35420,3578752330,3578752358,28
3,1340,35421,3578752330,3578752360,30
3,1340,35422,3578752330,3578752363,33
3,1340,35423,3578752330,3578752364,34
3,1340,35424,3578752330,3578752366,36
3,1340,35425,3578752330,3578752366,36
3,1340,35426,3578752330,3578752366,36
3,1340,35427,3578752330,3578752367,37
3,1340,35428,3578752330,3578752368,38
3,1340,35429,3578752330,3578752368,38
3,1340,35430,3578752330,3578752369,39
3,1340,35431,3578752330,3578752369,39
3,1340,35432,3578752330,3578752371,41
3,1340,35433,3578752330,3578752372,42
3,1340,35434,3578752330,3578752373,43
3,1340,35435,3578752330,3578752374,44
3,1340,35436,3578752330,3578752375,45
3,1340,35437,3578752330,3578752378,48
3,1340,35438,3578752330,3578752378,48
3,1341,35439,3578752393,3578752393,0
3,1341,35440,3578752393,3578752393,0
3,1341,35441,3578752393,3578752393,0
3,1341,35442,3578752393,3578752393,0
3,1341,35443,3578752393,3578752393,0
3,1341,35444,3578752393,3578752393,0
3,1341,35445,3578752393,3578752393,0
3,1341,35446,3578752393,3578752393,0
3,1341,35447,3578752393,3578752393,0
3,1341,35448,3578752393,3578752393,0
3,1341,35449,3578752393,3578752393,0
3,1341,35450,3578752393,3578752393,0
3,1341,35451,3578752393,3578752393,0
3,1341,35452,3578752393,3578752393,0
3,1341,35453,3578752393,3578752393,0
3,1341,35454,3578752393,3578752393,0
3,1341,35455,3578752393,3578752393,0
3,1341,35456,3578752393,3578752393,0
3,1341,35457,3578752393,3578752393,0
3,1341,35458,3578752393,3578752394,1
3,1341,35459,3578752393,3578752394,1
3,1341,35460,3578752393,3578752395,2
3,1341,35461,3578752393,3578752397,4
3,1341,35462,3578752393,3578752399,6
3,1341,35463,3578752393,3578752401,8
3,1341,35464,3578752393,3578752402,9
3,1341,35465,3578752393,3578752402,9
3,1341,35466,3578752393,3578752403,10
3,1341,35467,3578752393,3578752404,11
3,1341,35468,3578752393,3578752404,11
3,1341,35469,3578752393,3578752405,12
3,1341,35470,3578752393,3578752405,12
3,1341,35471,3578752393,3578752406,13
3,1341,35472,3578752393,3578752406,13
3,1341,35473,3578752393,3578752407,14
3,1341,35474,3578752393,3578752408,15
3,1341,35475,3578752393,3578752408,15
3,1341,35476,3578752393,3578752410,17
3,1341,35477,3578752393,3578752410,17
3,1341,35478,3578752393,3578752411,18
3,1341,35479,3578752393,3578752412,19
3,1341,35480,3578752393,3578752413,20
3,1341,35481,3578752393,3578752415,22
3,1341,35482,3578752393,3578752415,22
3,1341,35483,3578752393,3578752415,22
3,1341,35484,3578752393,3578752417,24
3,1341,35485,3578752393,3578752417,24
3,1341,35486,3578752393,3578752420,27
3,1341,35487,3578752393,3578752420,27
3,1341,35488,3578752393,3578752422,29
3,1341,35489,3578752393,3578752423,30
3,1341,35490,3578752393,3578752424,31
3,1341,35491,3578752393,3578752425,32
3,1341,35492,3578752393,3578752425,32
3,1341,35493,3578752393,3578752425,32
3,1341,35494,3578752393,3578752427,34
3,1341,35495,3578752393,3578752427,34
3,1341,35496,3578752393,3578752428,35
3,1341,35497,3578752393,3578752428,35
3,1341,35498,3578752393,3578752428,35
3,1341,35499,3578752393,3578752429,36
3,1341,35500,3578752393,3578752431,38
3,1341,35501,3578752393,3578752432,39
3,1341,35502,3578752393,3578752432,39
3,1341,35503,3578752393,3578752433,40
3,1341,35504,3578752393,3578752435,42
3,1341,35505,3578752393,3578752436,43
3,1341,35506,3578752393,3578752436,43
3,1341,35507,3578752393,3578752437,44
3,1341,35508,3578752393,3578752439,46
3,1341,35509,3578752393,3578752440,47
3,1341,35510,3578752393,3578752440,47
3,1341,35511,3578752393,3578752441,48
3,1341,35512,3578752393,3578752442,49
3,1341,35513,3578752393,3578752443,50
3,1342,35514,3578752455,3578752456,1
3,1342,35515,3578752455,3578752456,1
3,1342,35516,3578752455,3578752456,1
3,1342,35517,3578752455,3578752456,1
3,1342,35518,3578752455,3578752456,1
3,1342,35519,3578752455,3578752456,1
3,1342,35520,3578752455,3578752456,1
3,1342,35521,3578752455,3578752456,1
3,1342,35522,3578752455,3578752456,1
3,1342,35523,3578752455,3578752456,1
3,1342,35524,3578752455,3578752457,2
3,1342,35525,3578752455,3578752457,2
3,1342,35526,3578752455,3578752458,3
3,1342,35527,3578752455,3578752459,4
3,1342,35528,3578752455,3578752459,4
3,1342,35529,3578752455,3578752461,6
3,1342,35530,3578752455,3578752464,9
3,1342,35531,3578752455,3578752464,9
3,1342,35532,3578752455,3578752469,14
3,1342,35533,3578752455,3578752474,19
3,1342,35534,3578752455,3578752479,24
3,1342,35535,3578752455,3578752480,25
3,1342,35536,3578752455,3578752481,26
3,1342,35537,3578752455,3578752482,27
3,1342,35538,3578752455,3578752484,29
3,1342,35539,3578752455,3578752484,29
3,1342,35540,3578752455,3578752484,29
3,1342,35541,3578752455,3578752485,30
3,1342,35542,3578752455,3578752487,32
3,1342,35543,3578752455,3578752487,32
3,1342,35544,3578752455,3578752488,33
3,1342,35545,3578752455,3578752489,34
3,1342,35546,3578752455,3578752494,39
3,1342,35547,3578752455,3578752494,39
3,1342,35548,3578752455,3578752494,39
3,1342,35549,3578752455,3578752496,41
3,1342,35550,3578752455,3578752496,41
3,1342,35551,3578752455,3578752498,43
3,1342,35552,3578752455,3578752499,44
3,1342,35553,3578752455,3578752500,45
3,1342,35554,3578752455,3578752501,46
3,1342,35555,3578752455,3578752502,47
3,1342,35556,3578752455,3578752503,48
3,1342,35557,3578752455,3578752504,49
3,1343,35558,3578752518,3578752518,0
3,1343,35559,3578752518,3578752518,0
3,1343,35560,3578752518,3578752518,0
3,1343,35561,3578752518,3578752518,0
3,1343,35562,3578752518,3578752518,0
3,1343,35563,3578752518,3578752518,0
3,1343,35564,3578752518,3578752518,0
3,1343,35565,3578752518,3578752518,0
3,1343,35566,3578752518,3578752518,0
3,1343,35567,3578752518,3578752518,0
3,1343,35568,3578752518,3578752518,0
3,1343,35569,3578752518,3578752518,0
3,1343,35570,3578752518,3578752520,2
3,1343,35571,3578752518,3578752520,2
3,1343,35572,3578752518,3578752521,3
3,1343,35573,3578752518,3578752527,9
3,1343,35574,3578752518,3578752529,11
3,1343,35575,3578752518,3578752531,13
3,1343,35576,3578752518,3578752534,16
3,1343,35577,3578752518,3578752535,17
3,1343,35578,3578752518,3578752537,19
3,1343,35579,3578752518,3578752538,20
3,1343,35580,3578752518,3578752539,21
3,1343,35581,3578752518,3578752541,23
3,1343,35582,3578752518,3578752543,25
3,1343,35583,3578752518,3578752544,26
3,1343,35584,3578752518,3578752549,31
3,1343,35585,3578752518,3578752549,31
3,1343,35586,3578752518,3578752551,33
3,1343,35587,3578752518,3578752551,33
3,1343,35588,3578752518,3578752553,35
3,1343,35589,3578752518,3578752555,37
3,1343,35590,3578752518,3578752557,39
3,1343,35591,3578752518,3578752557,39
3,1343,35592,3578752518,3578752558,40
3,1343,35593,3578752518,3578752559,41
3,1343,35594,3578752518,3578752563,45
3,1343,35595,3578752518,3578752563,45
3,1343,35596,3578752518,3578752564,46
3,1343,35597,3578752518,3578752565,47
3,1343,35598,3578752518,3578752565,47
3,1343,35599,3578752518,3578752567,49
3,1343,35600,3578752518,3578752567,49
3,1343,35601,3578752518,3578752568,50
3,1344,35602,3578752581,3578752581,0
3,1344,35603,3578752581,3578752581,0
3,1344,35604,3578752581,3578752581,0
3,1344,35605,3578752581,3578752581,0
3,1344,35606,3578752581,3578752581,0
3,1344,35607,3578752581,3578752581,0
3,1344,35608,3578752581,3578752581,0
3,1344,35609,3578752581,3578752581,0
3,1344,35610,3578752581,3578752581,0
3,1344,35611,3578752581,3578752581,0
3,1344,35612,3578752581,3578752581,0
3,1344,35613,3578752581,3578752581,0
3,1344,35614,3578752581,3578752582,1
3,1344,35615,3578752581,3578752582,1
3,1344,35616,3578752581,3578752582,1
3,1344,35617,3578752581,3578752583,2
3,1344,35618,3578752581,3578752584,3
3,1344,35619,3578752581,3578752586,5
3,1344,35620,3578752581,3578752587,6
3,1344,35621,3578752581,3578752587,6
3,1344,35622,3578752581,3578752587,6
3,1344,35623,3578752581,3578752587,6
3,1344,35624,3578752581,3578752587,6
3,1344,35625,3578752581,3578752587,6
3,1344,35626,3578752581,3578752588,7
3,1344,35627,3578752581,3578752589,8
3,1344,35628,3578752581,3578752589,8
3,1344,35629,3578752581,3578752590,9
3,1344,35630,3578752581,3578752590,9
3,1344,35631,3578752581,3578752592,11
3,1344,35632,3578752581,3578752593,12
3,1344,35633,3578752581,3578752593,12
3,1344,35634,3578752581,3578752594,13
3,1344,35635,3578752581,3578752596,15
3,1344,35636,3578752581,3578752599,18
3,1344,35637,3578752581,3578752600,19
3,1344,35638,3578752581,3578752601,20
3,1344,35639,3578752581,3578752602,21
3,1344,35640,3578752581,3578752603,22
3,1344,35641,3578752581,3578752603,22
3,1344,35642,3578752581,3578752604,23
3,1344,35643,3578752581,3578752605,24
3,1344,35644,3578752581,3578752605,24
3,1344,35645,3578752581,3578752606,25
3,1344,35646,3578752581,3578752607,26
3,1344,35647,3578752581,3578752607,26
3,1344,35648,3578752581,3578752608,27
3,1344,35649,3578752581,3578752609,28
3,1344,35650,3578752581,3578752609,28
3,1344,35651,3578752581,3578752611,30
3,1344,35652,3578752581,3578752611,30
3,1344,35653,3578752581,3578752612,31
3,1344,35654,3578752581,3578752614,33
3,1344,35655,3578752581,3578752614,33
3,1344,35656,3578752581,3578752615,34
3,1344,35657,3578752581,3578752617,36
3,1344,35658,3578752581,3578752618,37
3,1344,35659,3578752581,3578752619,38
3,1344,35660,3578752581,3578752621,40
3,1344,35661,3578752581,3578752622,41
3,1344,35662,3578752581,3578752622,41
3,1344,35663,3578752581,3578752624,43
3,1344,35664,3578752581,3578752625,44
3,1344,35665,3578752581,3578752625,44
3,1344,35666,3578752581,3578752626,45
3,1344,35667,3578752581,3578752626,45
3,1344,35668,3578752581,3578752627,46
3,1344,35669,3578752581,3578752628,47
3,1344,35670,3578752581,3578752628,47
3,1344,35671,3578752581,3578752628,47
3,1344,35672,3578752581,3578752630,49
3,1344,35673,3578752581,3578752631,50
3,1345,35674,3578752643,3578752643,0
3,1345,35675,3578752643,3578752643,0
3,1345,35676,3578752643,3578752643,0
3,1345,35677,3578752643,3578752643,0
3,1345,35678,3578752643,3578752643,0
3,1345,35679,3578752643,3578752643,0
3,1345,35680,3578752643,3578752643,0
3,1345,35681,3578752643,3578752643,0
3,1345,35682,3578752643,3578752643,0
3,1345,35683,3578752643,3578752643,0
3,1345,35684,3578752643,3578752643,0
3,1345,35685,3578752643,3578752644,1
3,1345,35686,3578752643,3578752644,1
3,1345,35687,3578752643,3578752645,2
3,1345,35688,3578752643,3578752646,3
3,1345,35689,3578752643,3578752646,3
3,1345,35690,3578752643,3578752649,6
3,1345,35691,3578752643,3578752650,7
3,1345,35692,3578752643,3578752651,8
3,1345,35693,3578752643,3578752653,10
3,1345,35694,3578752643,3578752653,10
3,1345,35695,3578752643,3578752656,13
3,1345,35696,3578752643,3578752657,14
3,1345,35697,3578752643,3578752658,15
3,1345,35698,3578752643,3578752658,15
3,1345,35699,3578752643,3578752661,18
3,1345,35700,3578752643,3578752663,20
3,1345,35701,3578752643,3578752663,20
3,1345,35702,3578752643,3578752665,22
3,1345,35703,3578752643,3578752669,26
3,1345,35704,3578752643,3578752674,31
3,1345,35705,3578752643,3578752679,36
3,1345,35706,3578752643,3578752680,37
3,1345,35707,3578752643,3578752681,38
3,1345,35708,3578752643,3578752682,39
3,1345,35709,3578752643,3578752683,40
3,1345,35710,3578752643,3578752684,41
3,1345,35711,3578752643,3578752685,42
3,1345,35712,3578752643,3578752685,42
3,1345,35713,3578752643,3578752687,44
3,1345,35714,3578752643,3578752688,45
3,1345,35715,3578752643,3578752689,46
3,1345,35716,3578752643,3578752690,47
3,1346,35717,3578752706,3578752706,0
3,1346,35718,3578752706,3578752706,0
3,1346,35719,3578752706,3578752706,0
3,1346,35720,3578752706,3578752706,0
3,1346,35721,3578752706,3578752706,0
3,1346,35722,3578752706,3578752706,0
3,1346,35723,3578752706,3578752706,0
3,1346,35724,3578752706,3578752706,0
3,1346,35725,3578752706,3578752706,0
3,1346,35726,3578752706,3578752706,0
3,1346,35727,3578752706,3578752706,0
3,1346,35728,3578752706,3578752706,0
3,1346,35729,3578752706,3578752706,0
3,1346,35730,3578752706,3578752706,0
3,1346,35731,3578752706,3578752709,3
3,1346,35732,3578752706,3578752710,4
3,1346,35733,3578752706,3578752710,4
3,1346,35734,3578752706,3578752711,5
3,1346,35735,3578752706,3578752711,5
3,1346,35736,3578752706,3578752713,7
3,1346,35737,3578752706,3578752714,8
3,1346,35738,3578752706,3578752715,9
3,1346,35739,3578752706,3578752717,11
3,1346,35740,3578752706,3578752720,14
3,1346,35741,3578752706,3578752720,14
3,1346,35742,3578752706,3578752721,15
3,1346,35743,3578752706,3578752721,15
3,1346,35744,3578752706,3578752728,22
3,1346,35745,3578752706,3578752732,26
3,1346,35746,3578752706,3578752733,27
3,1346,35747,3578752706,3578752735,29
3,1346,35748,3578752706,3578752738,32
3,1346,35749,3578752706,3578752739,33
3,1346,35750,3578752706,3578752741,35
3,1346,35751,3578752706,3578752743,37
3,1346,35752,3578752706,3578752745,39
3,1346,35753,3578752706,3578752749,43
3,1346,35754,3578752706,3578752749,43
3,1346,35755,3578752706,3578752751,45
3,1346,35756,3578752706,3578752752,46
3,1346,35757,3578752706,3578752753,47
3,1346,35758,3578752706,3578752756,50
3,1347,35759,3578752768,3578752768,0
3,1347,35760,3578752768,3578752768,0
3,1347,35761,3578752768,3578752768,0
3,1347,35762,3578752768,3578752768,0
3,1347,35763,3578752768,3578752768,0
3,1347,35764,3578752768,3578752768,0
3,1347,35765,3578752768,3578752768,0
3,1347,35766,3578752768,3578752768,0
3,1347,35767,3578752768,3578752768,0
3,1347,35768,3578752768,3578752768,0
3,1347,35769,3578752768,3578752768,0
3,1347,35770,3578752768,3578752768,0
3,1347,35771,3578752768,3578752768,0
3,1347,35772,3578752768,3578752769,1
3,1347,35773,3578752768,3578752769,1
3,1347,35774,3578752768,3578752770,2
3,1347,35775,3578752768,3578752771,3
3,1347,35776,3578752768,3578752771,3
3,1347,35777,3578752768,3578752772,4
3,1347,35778,3578752768,3578752773,5
3,1347,35779,3578752768,3578752773,5
3,1347,35780,3578752768,3578752774,6
3,1347,35781,3578752768,3578752778,10
3,1347,35782,3578752768,3578752778,10
3,1347,35783,3578752768,3578752782,14
3,1347,35784,3578752768,3578752782,14
3,1347,35785,3578752768,3578752782,14
3,1347,35786,3578752768,3578752783,15
3,1347,35787,3578752768,3578752783,15
3,1347,35788,3578752768,3578752784,16
3,1347,35789,3578752768,3578752786,18
3,1347,35790,3578752768,3578752787,19
3,1347,35791,3578752768,3578752787,19
3,1347,35792,3578752768,3578752787,19
3,1347,35793,3578752768,3578752787,19
3,1347,35794,3578752768,3578752788,20
3,1347,35795,3578752768,3578752789,21
3,1347,35796,3578752768,3578752789,21
3,1347,35797,3578752768,3578752789,21
3,1347,35798,3578752768,3578752789,21
3,1347,35799,3578752768,3578752790,22
3,1347,35800,3578752768,3578752790,22
3,1347,35801,3578752768,3578752792,24
3,1347,35802,3578752768,3578752793,25
3,1347,35803,3578752768,3578752794,26
3,1347,35804,3578752768,3578752795,27
3,1347,35805,3578752768,3578752796,28
3,1347,35806,3578752768,3578752798,30
3,1347,35807,3578752768,3578752800,32
3,1347,35808,3578752768,3578752801,33
3,1347,35809,3578752768,3578752802,34
3,1347,35810,3578752768,3578752803,35
3,1347,35811,3578752768,3578752804,36
3,1347,35812,3578752768,3578752804,36
3,1347,35813,3578752768,3578752804,36
3,1347,35814,3578752768,3578752805,37
3,1347,35815,3578752768,3578752805,37
3,1347,35816,3578752768,3578752807,39
3,1347,35817,3578752768,3578752807,39
3,1347,35818,3578752768,3578752808,40
3,1347,35819,3578752768,3578752809,41
3,1347,35820,3578752768,3578752810,42
3,1347,35821,3578752768,3578752811,43
3,1347,35822,3578752768,3578752812,44
3,1347,35823,3578752768,3578752812,44
3,1347,35824,3578752768,3578752814,46
3,1347,35825,3578752768,3578752815,47
3,1347,35826,3578752768,3578752817,49
3,1348,35827,3578752831,3578752831,0
3,1348,35828,3578752831,3578752831,0
3,1348,35829,3578752831,3578752831,0
3,1348,35830,3578752831,3578752831,0
3,1348,35831,3578752831,3578752831,0
3,1348,35832,3578752831,3578752831,0
3,1348,35833,3578752831,3578752831,0
3,1348,35834,3578752831,3578752831,0
3,1348,35835,3578752831,3578752831,0
3,1348,35836,3578752831,3578752831,0
3,1348,35837,3578752831,3578752831,0
3,1348,35838,3578752831,3578752831,0
3,1348,35839,3578752831,3578752832,1
3,1348,35840,3578752831,3578752834,3
3,1348,35841,3578752831,3578752835,4
3,1348,35842,3578752831,3578752835,4
3,1348,35843,3578752831,3578752837,6
3,1348,35844,3578752831,3578752839,8
3,1348,35845,3578752831,3578752839,8
3,1348,35846,3578752831,3578752840,9
3,1348,35847,3578752831,3578752840,9
3,1348,35848,3578752831,3578752842,11
3,1348,35849,3578752831,3578752843,12
3,1348,35850,3578752831,3578752843,12
3,1348,35851,3578752831,3578752843,12
3,1348,35852,3578752831,3578752844,13
3,1348,35853,3578752831,3578752844,13
3,1348,35854,3578752831,3578752845,14
3,1348,35855,3578752831,3578752847,16
3,1348,35856,3578752831,3578752847,16
3,1348,35857,3578752831,3578752849,18
3,1348,35858,3578752831,3578752850,19
3,1348,35859,3578752831,3578752851,20
3,1348,35860,3578752831,3578752853,22
3,1348,35861,3578752831,3578752853,22
3,1348,35862,3578752831,3578752857,26
3,1348,35863,3578752831,3578752857,26
3,1348,35864,3578752831,3578752857,26
3,1348,35865,3578752831,3578752858,27
3,1348,35866,3578752831,3578752858,27
3,1348,35867,3578752831,3578752862,31
3,1348,35868,3578752831,3578752863,32
3,1348,35869,3578752831,3578752864,33
3,1348,35870,3578752831,3578752869,38
3,1348,35871,3578752831,3578752875,44
3,1348,35872,3578752831,3578752879,48
3,1348,35873,3578752831,3578752880,49
3,1348,35874,3578752831,3578752881,50
3,1349,35875,3578752894,3578752894,0
3,1349,35876,3578752894,3578752894,0
3,1349,35877,3578752894,3578752894,0
3,1349,35878,3578752894,3578752894,0
3,1349,35879,3578752894,3578752894,0
3,1349,35880,3578752894,3578752894,0
3,1349,35881,3578752894,3578752894,0
3,1349,35882,3578752894,3578752894,0
3,1349,35883,3578752894,3578752894,0
3,1349,35884,3578752894,3578752894,0
3,1349,35885,3578752894,3578752895,1
3,1349,35886,3578752894,3578752896,2
3,1349,35887,3578752894,3578752898,4
3,1349,35888,3578752894,3578752900,6
3,1349,35889,3578752894,3578752901,7
3,1349,35890,3578752894,3578752902,8
3,1349,35891,3578752894,3578752903,9
3,1349,35892,3578752894,3578752903,9
3,1349,35893,3578752894,3578752904,10
3,1349,35894,3578752894,3578752905,11
3,1349,35895,3578752894,3578752906,12
3,1349,35896,3578752894,3578752910,16
3,1349,35897,3578752894,3578752910,16
3,1349,35898,3578752894,3578752910,16
3,1349,35899,3578752894,3578752911,17
3,1349,35900,3578752894,3578752911,17
3,1349,35901,3578752894,3578752913,19
3,1349,35902,3578752894,3578752914,20
3,1349,35903,3578752894,3578752916,22
3,1349,35904,3578752894,3578752917,23
3,1349,35905,3578752894,3578752917,23
3,1349,35906,3578752894,3578752918,24
3,1349,35907,3578752894,3578752920,26
3,1349,35908,3578752894,3578752921,27
3,1349,35909,3578752894,3578752922,28
3,1349,35910,3578752894,3578752922,28
3,1349,35911,3578752894,3578752927,33
3,1349,35912,3578752894,3578752928,34
3,1349,35913,3578752894,3578752931,37
3,1349,35914,3578752894,3578752934,40
3,1349,35915,3578752894,3578752935,41
3,1349,35916,3578752894,3578752937,43
3,1349,35917,3578752894,3578752939,45
3,1349,35918,3578752894,3578752939,45
3,1349,35919,3578752894,3578752941,47
3,1349,35920,3578752894,3578752944,50
3,1350,35921,3578752956,3578752956,0
3,1350,35922,3578752956,3578752956,0
3,1350,35923,3578752956,3578752956,0
3,1350,35924,3578752956,3578752956,0
3,1350,35925,3578752956,3578752956,0
3,1350,35926,3578752956,3578752956,0
3,1350,35927,3578752956,3578752956,0
3,1350,35928,3578752956,3578752956,0
3,1350,35929,3578752956,3578752958,2
3,1350,35930,3578752956,3578752958,2
3,1350,35931,3578752956,3578752958,2
3,1350,35932,3578752956,3578752961,5
3,1350,35933,3578752956,3578752963,7
3,1350,35934,3578752956,3578752964,8
3,1350,35935,3578752956,3578752964,8
3,1350,35936,3578752956,3578752965,9
3,1350,35937,3578752956,3578752965,9
3,1350,35938,3578752956,3578752967,11
3,1350,35939,3578752956,3578752967,11
3,1350,35940,3578752956,3578752968,12
3,1350,35941,3578752956,3578752969,13
3,1350,35942,3578752956,3578752969,13
3,1350,35943,3578752956,3578752969,13
3,1350,35944,3578752956,3578752970,14
3,1350,35945,3578752956,3578752972,16
3,1350,35946,3578752956,3578752973,17
3,1350,35947,3578752956,3578752973,17
3,1350,35948,3578752956,3578752974,18
3,1350,35949,3578752956,3578752974,18
3,1350,35950,3578752956,3578752978,22
3,1350,35951,3578752956,3578752979,23
3,1350,35952,3578752956,3578752981,25
3,1350,35953,3578752956,3578752982,26
3,1350,35954,3578752956,3578752983,27
3,1350,35955,3578752956,3578752984,28
3,1350,35956,3578752956,3578752984,28
3,1350,35957,3578752956,3578752985,29
3,1350,35958,3578752956,3578752987,31
3,1350,35959,3578752956,3578752987,31
3,1350,35960,3578752956,3578752988,32
3,1350,35961,3578752956,3578752988,32
3,1350,35962,3578752956,3578752988,32
3,1350,35963,3578752956,3578752988,32
3,1350,35964,3578752956,3578752988,32
3,1350,35965,3578752956,3578752988,32
3,1350,35966,3578752956,3578752990,34
3,1350,35967,3578752956,3578752990,34
3,1350,35968,3578752956,3578752991,35
3,1350,35969,3578752956,3578752993,37
3,1350,35970,3578752956,3578752994,38
3,1350,35971,3578752956,3578752994,38
3,1350,35972,3578752956,3578752994,38
3,1350,35973,3578752956,3578752997,41
3,1350,35974,3578752956,3578752999,43
3,1350,35975,3578752956,3578753001,45
3,1350,35976,3578752956,3578753001,45
3,1350,35977,3578752956,3578753002,46
3,1350,35978,3578752956,3578753003,47
3,1350,35979,3578752956,3578753004,48
3,1350,35980,3578752956,3578753005,49
3,1350,35981,3578752956,3578753005,49
3,1350,35982,3578752956,3578753005,49
3,1350,35983,3578752956,3578753006,50
3,1351,35984,3578753018,3578753018,0
3,1351,35985,3578753018,3578753018,0
3,1351,35986,3578753018,3578753018,0
3,1351,35987,3578753018,3578753018,0
3,1351,35988,3578753018,3578753018,0
3,1351,35989,3578753018,3578753018,0
3,1351,35990,3578753018,3578753018,0
3,1351,35991,3578753018,3578753018,0
3,1351,35992,3578753018,3578753018,0
3,1351,35993,3578753018,3578753018,0
3,1351,35994,3578753018,3578753018,0
3,1351,35995,3578753018,3578753020,2
3,1351,35996,3578753018,3578753021,3
3,1351,35997,3578753018,3578753024,6
3,1351,35998,3578753018,3578753024,6
3,1351,35999,3578753018,3578753027,9
3,1351,36000,3578753018,3578753027,9
3,1351,36001,3578753018,3578753027,9
3,1351,36002,3578753018,3578753027,9
3,1351,36003,3578753018,3578753028,10
3,1351,36004,3578753018,3578753028,10
3,1351,36005,3578753018,3578753029,11
3,1351,36006,3578753018,3578753030,12
3,1351,36007,3578753018,3578753031,13
3,1351,36008,3578753018,3578753034,16
3,1351,36009,3578753018,3578753035,17
3,1351,36010,3578753018,3578753036,18
3,1351,36011,3578753018,3578753036,18
3,1351,36012,3578753018,3578753040,22
3,1351,36013,3578753018,3578753040,22
3,1351,36014,3578753018,3578753040,22
3,1351,36015,3578753018,3578753041,23
3,1351,36016,3578753018,3578753043,25
3,1351,36017,3578753018,3578753043,25
3,1351,36018,3578753018,3578753043,25
3,1351,36019,3578753018,3578753043,25
3,1351,36020,3578753018,3578753043,25
3,1351,36021,3578753018,3578753043,25
3,1351,36022,3578753018,3578753045,27
3,1351,36023,3578753018,3578753046,28
3,1351,36024,3578753018,3578753046,28
3,1351,36025,3578753018,3578753048,30
3,1351,36026,3578753018,3578753050,32
3,1351,36027,3578753018,3578753051,33
3,1351,36028,3578753018,3578753051,33
3,1351,36029,3578753018,3578753053,35
3,1351,36030,3578753018,3578753053,35
3,1351,36031,3578753018,3578753057,39
3,1351,36032,3578753018,3578753058,40
3,1351,36033,3578753018,3578753058,40
3,1351,36034,3578753018,3578753061,43
3,1351,36035,3578753018,3578753061,43
3,1351,36036,3578753018,3578753064,46
3,1351,36037,3578753018,3578753065,47
3,1352,36038,3578753080,3578753080,0
3,1352,36039,3578753080,3578753080,0
3,1352,36040,3578753080,3578753080,0
3,1352,36041,3578753080,3578753080,0
3,1352,36042,3578753080,3578753081,1
3,1352,36043,3578753080,3578753083,3
3,1352,36044,3578753080,3578753084,4
3,1352,36045,3578753080,3578753084,4
3,1352,36046,3578753080,3578753084,4
3,1352,36047,3578753080,3578753087,7
3,1352,36048,3578753080,3578753088,8
3,1352,36049,3578753080,3578753089,9
3,1352,36050,3578753080,3578753093,13
3,1352,36051,3578753080,3578753094,14
3,1352,36052,3578753080,3578753095,15
3,1352,36053,3578753080,3578753096,16
3,1352,36054,3578753080,3578753097,17
3,1352,36055,3578753080,3578753100,20
3,1352,36056,3578753080,3578753101,21
3,1352,36057,3578753080,3578753102,22
3,1352,36058,3578753080,3578753103,23
3,1352,36059,3578753080,3578753103,23
3,1352,36060,3578753080,3578753104,24
3,1352,36061,3578753080,3578753105,25
3,1352,36062,3578753080,3578753105,25
3,1352,36063,3578753080,3578753106,26
3,1352,36064,3578753080,3578753110,30
3,1352,36065,3578753080,3578753110,30
3,1352,36066,3578753080,3578753110,30
3,1352,36067,3578753080,3578753111,31
3,1352,36068,3578753080,3578753112,32
3,1352,36069,3578753080,3578753114,34
3,1352,36070,3578753080,3578753115,35
3,1352,36071,3578753080,3578753116,36
3,1352,36072,3578753080,3578753117,37
3,1352,36073,3578753080,3578753117,37
3,1352,36074,3578753080,3578753118,38
3,1352,36075,3578753080,3578753120,40
3,1352,36076,3578753080,3578753121,41
3,1352,36077,3578753080,3578753122,42
3,1352,36078,3578753080,3578753122,42
3,1352,36079,3578753080,3578753127,47
3,1352,36080,3578753080,3578753129,49
3,1353,36081,3578753142,3578753142,0
3,1353,36082,3578753142,3578753142,0
3,1353,36083,3578753142,3578753142,0
3,1353,36084,3578753142,3578753142,0
3,1353,36085,3578753142,3578753142,0
3,1353,36086,3578753142,3578753142,0
3,1353,36087,3578753142,3578753142,0
3,1353,36088,3578753142,3578753144,2
3,1353,36089,3578753142,3578753148,6
3,1353,36090,3578753142,3578753150,8
3,1353,36091,3578753142,3578753150,8
3,1353,36092,3578753142,3578753151,9
3,1353,36093,3578753142,3578753152,10
3,1353,36094,3578753142,3578753153,11
3,1353,36095,3578753142,3578753155,13
3,1353,36096,3578753142,3578753157,15
3,1353,36097,3578753142,3578753158,16
3,1353,36098,3578753142,3578753158,16
3,1353,36099,3578753142,3578753158,16
3,1353,36100,3578753142,3578753161,19
3,1353,36101,3578753142,3578753163,21
3,1353,36102,3578753142,3578753164,22
3,1353,36103,3578753142,3578753165,23
3,1353,36104,3578753142,3578753166,24
3,1353,36105,3578753142,3578753167,25
3,1353,36106,3578753142,3578753168,26
3,1353,36107,3578753142,3578753168,26
3,1353,36108,3578753142,3578753169,27
3,1353,36109,3578753142,3578753169,27
3,1353,36110,3578753142,3578753170,28
3,1353,36111,3578753142,3578753170,28
3,1353,36112,3578753142,3578753171,29
3,1353,36113,3578753142,3578753172,30
3,1353,36114,3578753142,3578753174,32
3,1353,36115,3578753142,3578753174,32
3,1353,36116,3578753142,3578753175,33
3,1353,36117,3578753142,3578753178,36
3,1353,36118,3578753142,3578753179,37
3,1353,36119,3578753142,3578753182,40
3,1353,36120,3578753142,3578753182,40
3,1353,36121,3578753142,3578753183,41
3,1353,36122,3578753142,3578753184,42
3,1353,36123,3578753142,3578753184,42
3,1353,36124,3578753142,3578753186,44
3,1353,36125,3578753142,3578753187,45
3,1353,36126,3578753142,3578753187,45
3,1353,36127,3578753142,3578753188,46
3,1353,36128,3578753142,3578753188,46
3,1353,36129,3578753142,3578753189,47
3,1353,36130,3578753142,3578753189,47
3,1353,36131,3578753142,3578753189,47
3,1353,36132,3578753142,3578753189,47
3,1353,36133,3578753142,3578753190,48
3,1353,36134,3578753142,3578753191,49
3,1353,36135,3578753142,3578753191,49
3,1354,36136,3578753204,3578753204,0
3,1354,36137,3578753204,3578753204,0
3,1354,36138,3578753204,3578753204,0
3,1354,36139,3578753204,3578753204,0
3,1354,36140,3578753204,3578753204,0
3,1354,36141,3578753204,3578753204,0
3,1354,36142,3578753204,3578753204,0
3,1354,36143,3578753204,3578753204,0
3,1354,36144,3578753204,3578753205,1
3,1354,36145,3578753204,3578753205,1
3,1354,36146,3578753204,3578753205,1
3,1354,36147,3578753204,3578753205,1
3,1354,36148,3578753204,3578753205,1
3,1354,36149,3578753204,3578753208,4
3,1354,36150,3578753204,3578753208,4
3,1354,36151,3578753204,3578753208,4
3,1354,36152,3578753204,3578753209,5
3,1354,36153,3578753204,3578753212,8
3,1354,36154,3578753204,3578753213,9
3,1354,36155,3578753204,3578753213,9
3,1354,36156,3578753204,3578753214,10
3,1354,36157,3578753204,3578753215,11
3,1354,36158,3578753204,3578753217,13
3,1354,36159,3578753204,3578753220,16
3,1354,36160,3578753204,3578753221,17
3,1354,36161,3578753204,3578753221,17
3,1354,36162,3578753204,3578753224,20
3,1354,36163,3578753204,3578753225,21
3,1354,36164,3578753204,3578753226,22
3,1354,36165,3578753204,3578753226,22
3,1354,36166,3578753204,3578753227,23
3,1354,36167,3578753204,3578753228,24
3,1354,36168,3578753204,3578753228,24
3,1354,36169,3578753204,3578753228,24
3,1354,36170,3578753204,3578753229,25
3,1354,36171,3578753204,3578753231,27
3,1354,36172,3578753204,3578753232,28
3,1354,36173,3578753204,3578753232,28
3,1354,36174,3578753204,3578753234,30
3,1354,36175,3578753204,3578753236,32
3,1354,36176,3578753204,3578753236,32
3,1354,36177,3578753204,3578753240,36
3,1354,36178,3578753204,3578753240,36
3,1354,36179,3578753204,3578753241,37
3,1354,36180,3578753204,3578753243,39
3,1354,36181,3578753204,3578753243,39
3,1354,36182,3578753204,3578753243,39
3,1354,36183,3578753204,3578753243,39
3,1354,36184,3578753204,3578753244,40
3,1354,36185,3578753204,3578753245,41
3,1354,36186,3578753204,3578753245,41
3,1354,36187,3578753204,3578753246,42
3,1354,36188,3578753204,3578753247,43
3,1354,36189,3578753204,3578753247,43
3,1354,36190,3578753204,3578753250,46
3,1354,36191,3578753204,3578753251,47
3,1354,36192,3578753204,3578753251,47
3,1354,36193,3578753204,3578753254,50
3,1355,36194,3578753266,3578753266,0
3,1355,36195,3578753266,3578753266,0
3,1355,36196,3578753266,3578753267,1
3,1355,36197,3578753266,3578753267,1
3,1355,36198,3578753266,3578753267,1
3,1355,36199,3578753266,3578753267,1
3,1355,36200,3578753266,3578753269,3
3,1355,36201,3578753266,3578753274,8
3,1355,36202,3578753266,3578753279,13
3,1355,36203,3578753266,3578753280,14
3,1355,36204,3578753266,3578753282,16
3,1355,36205,3578753266,3578753283,17
3,1355,36206,3578753266,3578753284,18
3,1355,36207,3578753266,3578753284,18
3,1355,36208,3578753266,3578753284,18
3,1355,36209,3578753266,3578753287,21
3,1355,36210,3578753266,3578753287,21
3,1355,36211,3578753266,3578753287,21
3,1355,36212,3578753266,3578753290,24
3,1355,36213,3578753266,3578753294,28
3,1355,36214,3578753266,3578753294,28
3,1355,36215,3578753266,3578753294,28
3,1355,36216,3578753266,3578753295,29
3,1355,36217,3578753266,3578753296,30
3,1355,36218,3578753266,3578753297,31
3,1355,36219,3578753266,3578753297,31
3,1355,36220,3578753266,3578753298,32
3,1355,36221,3578753266,3578753300,34
3,1355,36222,3578753266,3578753301,35
3,1355,36223,3578753266,3578753301,35
3,1355,36224,3578753266,3578753302,36
3,1355,36225,3578753266,3578753303,37
3,1355,36226,3578753266,3578753304,38
3,1355,36227,3578753266,3578753305,39
3,1355,36228,3578753266,3578753305,39
3,1355,36229,3578753266,3578753306,40
3,1355,36230,3578753266,3578753310,44
3,1355,36231,3578753266,3578753310,44
3,1355,36232,3578753266,3578753310,44
3,1355,36233,3578753266,3578753310,44
3,1355,36234,3578753266,3578753312,46
3,1355,36235,3578753266,3578753314,48
3,1355,36236,3578753266,3578753315,49
3,1356,36237,3578753330,3578753330,0
3,1356,36238,3578753330,3578753330,0
3,1356,36239,3578753330,3578753330,0
3,1356,36240,3578753330,3578753330,0
3,1356,36241,3578753330,3578753330,0
3,1356,36242,3578753330,3578753330,0
3,1356,36243,3578753330,3578753330,0
3,1356,36244,3578753330,3578753330,0
3,1356,36245,3578753330,3578753331,1
3,1356,36246,3578753330,3578753336,6
3,1356,36247,3578753330,3578753338,8
3,1356,36248,3578753330,3578753338,8
3,1356,36249,3578753330,3578753339,9
3,1356,36250,3578753330,3578753342,12
3,1356,36251,3578753330,3578753344,14
3,1356,36252,3578753330,3578753345,15
3,1356,36253,3578753330,3578753348,18
3,1356,36254,3578753330,3578753350,20
3,1356,36255,3578753330,3578753351,21
3,1356,36256,3578753330,3578753351,21
3,1356,36257,3578753330,3578753354,24
3,1356,36258,3578753330,3578753355,25
3,1356,36259,3578753330,3578753357,27
3,1356,36260,3578753330,3578753358,28
3,1356,36261,3578753330,3578753358,28
3,1356,36262,3578753330,3578753358,28
3,1356,36263,3578753330,3578753361,31
3,1356,36264,3578753330,3578753363,33
3,1356,36265,3578753330,3578753364,34
3,1356,36266,3578753330,3578753365,35
3,1356,36267,3578753330,3578753366,36
3,1356,36268,3578753330,3578753367,37
3,1356,36269,3578753330,3578753368,38
3,1356,36270,3578753330,3578753368,38
3,1356,36271,3578753330,3578753368,38
3,1356,36272,3578753330,3578753369,39
3,1356,36273,3578753330,3578753370,40
3,1356,36274,3578753330,3578753370,40
3,1356,36275,3578753330,3578753371,41
3,1356,36276,3578753330,3578753372,42
3,1356,36277,3578753330,3578753373,43
3,1356,36278,3578753330,3578753374,44
3,1356,36279,3578753330,3578753375,45
3,1356,36280,3578753330,3578753378,48
3,1356,36281,3578753330,3578753379,49
3,1357,36282,3578753393,3578753393,0
3,1357,36283,3578753393,3578753393,0
3,1357,36284,3578753393,3578753393,0
3,1357,36285,3578753393,3578753393,0
3,1357,36286,3578753393,3578753393,0
3,1357,36287,3578753393,3578753393,0
3,1357,36288,3578753393,3578753393,0
3,1357,36289,3578753393,3578753393,0
3,1357,36290,3578753393,3578753393,0
3,1357,36291,3578753393,3578753393,0
3,1357,36292,3578753393,3578753393,0
3,1357,36293,3578753393,3578753393,0
3,1357,36294,3578753393,3578753393,0
3,1357,36295,3578753393,3578753393,0
3,1357,36296,3578753393,3578753393,0
3,1357,36297,3578753393,3578753394,1
3,1357,36298,3578753393,3578753394,1
3,1357,36299,3578753393,3578753395,2
3,1357,36300,3578753393,3578753398,5
3,1357,36301,3578753393,3578753401,8
3,1357,36302,3578753393,3578753403,10
3,1357,36303,3578753393,3578753403,10
3,1357,36304,3578753393,3578753404,11
3,1357,36305,3578753393,3578753404,11
3,1357,36306,3578753393,3578753405,12
3,1357,36307,3578753393,3578753406,13
3,1357,36308,3578753393,3578753406,13
3,1357,36309,3578753393,3578753406,13
3,1357,36310,3578753393,3578753408,15
3,1357,36311,3578753393,3578753408,15
3,1357,36312,3578753393,3578753408,15
3,1357,36313,3578753393,3578753409,16
3,1357,36314,3578753393,3578753410,17
3,1357,36315,3578753393,3578753411,18
3,1357,36316,3578753393,3578753413,20
3,1357,36317,3578753393,3578753413,20
3,1357,36318,3578753393,3578753415,22
3,1357,36319,3578753393,3578753415,22
3,1357,36320,3578753393,3578753417,24
3,1357,36321,3578753393,3578753420,27
3,1357,36322,3578753393,3578753424,31
3,1357,36323,3578753393,3578753425,32
3,1357,36324,3578753393,3578753425,32
3,1357,36325,3578753393,3578753427,34
3,1357,36326,3578753393,3578753427,34
3,1357,36327,3578753393,3578753427,34
3,1357,36328,3578753393,3578753427,34
3,1357,36329,3578753393,3578753428,35
3,1357,36330,3578753393,3578753429,36
3,1357,36331,3578753393,3578753429,36
3,1357,36332,3578753393,3578753430,37
3,1357,36333,3578753393,3578753432,39
3,1357,36334,3578753393,3578753432,39
3,1357,36335,3578753393,3578753434,41
3,1357,36336,3578753393,3578753435,42
3,1357,36337,3578753393,3578753436,43
3,1357,36338,3578753393,3578753437,44
3,1357,36339,3578753393,3578753440,47
3,1357,36340,3578753393,3578753440,47
3,1357,36341,3578753393,3578753441,48
3,1357,36342,3578753393,3578753442,49
3,1357,36343,3578753393,3578753443,50
3,1358,36344,3578753455,3578753455,0
3,1358,36345,3578753455,3578753455,0
3,1358,36346,3578753455,3578753455,0
3,1358,36347,3578753455,3578753455,0
3,1358,36348,3578753455,3578753455,0
3,1358,36349,3578753455,3578753455,0
3,1358,36350,3578753455,3578753455,0
3,1358,36351,3578753455,3578753455,0
3,1358,36352,3578753455,3578753455,0
3,1358,36353,3578753455,3578753455,0
3,1358,36354,3578753455,3578753455,0
3,1358,36355,3578753455,3578753455,0
3,1358,36356,3578753455,3578753455,0
3,1358,36357,3578753455,3578753457,2
3,1358,36358,3578753455,3578753457,2
3,1358,36359,3578753455,3578753457,2
3,1358,36360,3578753455,3578753459,4
3,1358,36361,3578753455,3578753462,7
3,1358,36362,3578753455,3578753463,8
3,1358,36363,3578753455,3578753463,8
3,1358,36364,3578753455,3578753464,9
3,1358,36365,3578753455,3578753464,9
3,1358,36366,3578753455,3578753470,15
3,1358,36367,3578753455,3578753474,19
3,1358,36368,3578753455,3578753479,24
3,1358,36369,3578753455,3578753480,25
3,1358,36370,3578753455,3578753481,26
3,1358,36371,3578753455,3578753483,28
3,1358,36372,3578753455,3578753484,29
3,1358,36373,3578753455,3578753484,29
3,1358,36374,3578753455,3578753484,29
3,1358,36375,3578753455,3578753485,30
3,1358,36376,3578753455,3578753487,32
3,1358,36377,3578753455,3578753487,32
3,1358,36378,3578753455,3578753487,32
3,1358,36379,3578753455,3578753489,34
3,1358,36380,3578753455,3578753490,35
3,1358,36381,3578753455,3578753493,38
3,1358,36382,3578753455,3578753494,39
3,1358,36383,3578753455,3578753494,39
3,1358,36384,3578753455,3578753496,41
3,1358,36385,3578753455,3578753497,42
3,1358,36386,3578753455,3578753498,43
3,1358,36387,3578753455,3578753499,44
3,1358,36388,3578753455,3578753500,45
3,1358,36389,3578753455,3578753501,46
3,1358,36390,3578753455,3578753501,46
3,1358,36391,3578753455,3578753502,47
3,1358,36392,3578753455,3578753504,49
3,1358,36393,3578753455,3578753504,49
3,1359,36394,3578753517,3578753517,0
3,1359,36395,3578753517,3578753517,0
3,1359,36396,3578753517,3578753517,0
3,1359,36397,3578753517,3578753517,0
3,1359,36398,3578753517,3578753517,0
3,1359,36399,3578753517,3578753517,0
3,1359,36400,3578753517,3578753517,0
3,1359,36401,3578753517,3578753517,0
3,1359,36402,3578753517,3578753517,0
3,1359,36403,3578753517,3578753517,0
3,1359,36404,3578753517,3578753517,0
3,1359,36405,3578753517,3578753517,0
3,1359,36406,3578753517,3578753517,0
3,1359,36407,3578753517,3578753519,2
3,1359,36408,3578753517,3578753520,3
3,1359,36409,3578753517,3578753521,4
3,1359,36410,3578753517,3578753522,5
3,1359,36411,3578753517,3578753522,5
3,1359,36412,3578753517,3578753525,8
3,1359,36413,3578753517,3578753530,13
3,1359,36414,3578753517,3578753531,14
3,1359,36415,3578753517,3578753535,18
3,1359,36416,3578753517,3578753537,20
3,1359,36417,3578753517,3578753537,20
3,1359,36418,3578753517,3578753538,21
3,1359,36419,3578753517,3578753541,24
3,1359,36420,3578753517,3578753543,26
3,1359,36421,3578753517,3578753545,28
3,1359,36422,3578753517,3578753548,31
3,1359,36423,3578753517,3578753549,32
3,1359,36424,3578753517,3578753550,33
3,1359,36425,3578753517,3578753553,36
3,1359,36426,3578753517,3578753554,37
3,1359,36427,3578753517,3578753557,40
3,1359,36428,3578753517,3578753557,40
3,1359,36429,3578753517,3578753560,43
3,1359,36430,3578753517,3578753563,46
3,1359,36431,3578753517,3578753563,46
3,1359,36432,3578753517,3578753564,47
3,1359,36433,3578753517,3578753565,48
3,1359,36434,3578753517,3578753566,49
3,1360,36435,3578753580,3578753580,0
3,1360,36436,3578753580,3578753580,0
3,1360,36437,3578753580,3578753580,0
3,1360,36438,3578753580,3578753580,0
3,1360,36439,3578753580,3578753580,0
3,1360,36440,3578753580,3578753580,0
3,1360,36441,3578753580,3578753580,0
3,1360,36442,3578753580,3578753580,0
3,1360,36443,3578753580,3578753580,0
3,1360,36444,3578753580,3578753580,0
3,1360,36445,3578753580,3578753580,0
3,1360,36446,3578753580,3578753580,0
3,1360,36447,3578753580,3578753582,2
3,1360,36448,3578753580,3578753583,3
3,1360,36449,3578753580,3578753583,3
3,1360,36450,3578753580,3578753586,6
3,1360,36451,3578753580,3578753587,7
3,1360,36452,3578753580,3578753587,7
3,1360,36453,3578753580,3578753588,8
3,1360,36454,3578753580,3578753588,8
3,1360,36455,3578753580,3578753588,8
3,1360,36456,3578753580,3578753589,9
3,1360,36457,3578753580,3578753590,10
3,1360,36458,3578753580,3578753590,10
3,1360,36459,3578753580,3578753590,10
3,1360,36460,3578753580,3578753592,12
3,1360,36461,3578753580,3578753593,13
3,1360,36462,3578753580,3578753593,13
3,1360,36463,3578753580,3578753594,14
3,1360,36464,3578753580,3578753597,17
3,1360,36465,3578753580,3578753599,19
3,1360,36466,3578753580,3578753601,21
3,1360,36467,3578753580,3578753601,21
3,1360,36468,3578753580,3578753602,22
3,1360,36469,3578753580,3578753603,23
3,1360,36470,3578753580,3578753603,23
3,1360,36471,3578753580,3578753604,24
3,1360,36472,3578753580,3578753605,25
3,1360,36473,3578753580,3578753605,25
3,1360,36474,3578753580,3578753606,26
3,1360,36475,3578753580,3578753607,27
3,1360,36476,3578753580,3578753607,27
3,1360,36477,3578753580,3578753608,28
3,1360,36478,3578753580,3578753608,28
3,1360,36479,3578753580,3578753609,29
3,1360,36480,3578753580,3578753611,31
3,1360,36481,3578753580,3578753612,32
3,1360,36482,3578753580,3578753612,32
3,1360,36483,3578753580,3578753614,34
3,1360,36484,3578753580,3578753614,34
3,1360,36485,3578753580,3578753615,35
3,1360,36486,3578753580,3578753617,37
3,1360,36487,3578753580,3578753619,39
3,1360,36488,3578753580,3578753621,41
3,1360,36489,3578753580,3578753623,43
3,1360,36490,3578753580,3578753623,43
3,1360,36491,3578753580,3578753623,43
3,1360,36492,3578753580,3578753625,45
3,1360,36493,3578753580,3578753626,46
3,1360,36494,3578753580,3578753626,46
3,1360,36495,3578753580,3578753627,47
3,1360,36496,3578753580,3578753627,47
3,1360,36497,3578753580,3578753627,47
3,1360,36498,3578753580,3578753629,49
3,1360,36499,3578753580,3578753629,49
3,1361,36500,3578753643,3578753643,0
3,1361,36501,3578753643,3578753643,0
3,1361,36502,3578753643,3578753643,0
3,1361,36503,3578753643,3578753643,0
3,1361,36504,3578753643,3578753643,0
3,1361,36505,3578753643,3578753643,0
3,1361,36506,3578753643,3578753643,0
3,1361,36507,3578753643,3578753643,0
3,1361,36508,3578753643,3578753643,0
3,1361,36509,3578753643,3578753643,0
3,1361,36510,3578753643,3578753643,0
3,1361,36511,3578753643,3578753643,0
3,1361,36512,3578753643,3578753643,0
3,1361,36513,3578753643,3578753644,1
3,1361,36514,3578753643,3578753644,1
3,1361,36515,3578753643,3578753644,1
3,1361,36516,3578753643,3578753644,1
3,1361,36517,3578753643,3578753645,2
3,1361,36518,3578753643,3578753647,4
3,1361,36519,3578753643,3578753647,4
3,1361,36520,3578753643,3578753649,6
3,1361,36521,3578753643,3578753650,7
3,1361,36522,3578753643,3578753651,8
3,1361,36523,3578753643,3578753653,10
3,1361,36524,3578753643,3578753653,10
3,1361,36525,3578753643,3578753656,13
3,1361,36526,3578753643,3578753656,13
3,1361,36527,3578753643,3578753658,15
3,1361,36528,3578753643,3578753658,15
3,1361,36529,3578753643,3578753659,16
3,1361,36530,3578753643,3578753660,17
3,1361,36531,3578753643,3578753662,19
3,1361,36532,3578753643,3578753662,19
3,1361,36533,3578753643,3578753663,20
3,1361,36534,3578753643,3578753663,20
3,1361,36535,3578753643,3578753669,26
3,1361,36536,3578753643,3578753675,32
3,1361,36537,3578753643,3578753679,36
3,1361,36538,3578753643,3578753680,37
3,1361,36539,3578753643,3578753681,38
3,1361,36540,3578753643,3578753683,40
3,1361,36541,3578753643,3578753684,41
3,1361,36542,3578753643,3578753684,41
3,1361,36543,3578753643,3578753684,41
3,1361,36544,3578753643,3578753685,42
3,1361,36545,3578753643,3578753687,44
3,1361,36546,3578753643,3578753687,44
3,1361,36547,3578753643,3578753687,44
3,1361,36548,3578753643,3578753689,46
3,1361,36549,3578753643,3578753690,47
3,1362,36550,3578753706,3578753706,0
3,1362,36551,3578753706,3578753706,0
3,1362,36552,3578753706,3578753706,0
3,1362,36553,3578753706,3578753706,0
3,1362,36554,3578753706,3578753706,0
3,1362,36555,3578753706,3578753706,0
3,1362,36556,3578753706,3578753706,0
3,1362,36557,3578753706,3578753706,0
3,1362,36558,3578753706,3578753706,0
3,1362,36559,3578753706,3578753706,0
3,1362,36560,3578753706,3578753706,0
3,1362,36561,3578753706,3578753706,0
3,1362,36562,3578753706,3578753706,0
3,1362,36563,3578753706,3578753706,0
3,1362,36564,3578753706,3578753706,0
3,1362,36565,3578753706,3578753709,3
3,1362,36566,3578753706,3578753710,4
3,1362,36567,3578753706,3578753711,5
3,1362,36568,3578753706,3578753711,5
3,1362,36569,3578753706,3578753712,6
3,1362,36570,3578753706,3578753713,7
3,1362,36571,3578753706,3578753714,8
3,1362,36572,3578753706,3578753715,9
3,1362,36573,3578753706,3578753716,10
3,1362,36574,3578753706,3578753716,10
3,1362,36575,3578753706,3578753717,11
3,1362,36576,3578753706,3578753720,14
3,1362,36577,3578753706,3578753721,15
3,1362,36578,3578753706,3578753721,15
3,1362,36579,3578753706,3578753721,15
3,1362,36580,3578753706,3578753722,16
3,1362,36581,3578753706,3578753725,19
3,1362,36582,3578753706,3578753730,24
3,1362,36583,3578753706,3578753731,25
3,1362,36584,3578753706,3578753735,29
3,1362,36585,3578753706,3578753736,30
3,1362,36586,3578753706,3578753737,31
3,1362,36587,3578753706,3578753738,32
3,1362,36588,3578753706,3578753741,35
3,1362,36589,3578753706,3578753743,37
3,1362,36590,3578753706,3578753744,38
3,1362,36591,3578753706,3578753748,42
3,1362,36592,3578753706,3578753748,42
3,1362,36593,3578753706,3578753749,43
3,1362,36594,3578753706,3578753750,44
3,1362,36595,3578753706,3578753753,47
3,1362,36596,3578753706,3578753754,48
3,1363,36597,3578753769,3578753769,0
3,1363,36598,3578753769,3578753769,0
3,1363,36599,3578753769,3578753769,0
3,1363,36600,3578753769,3578753769,0
3,1363,36601,3578753769,3578753769,0
3,1363,36602,3578753769,3578753769,0
3,1363,36603,3578753769,3578753769,0
3,1363,36604,3578753769,3578753769,0
3,1363,36605,3578753769,3578753769,0
3,1363,36606,3578753769,3578753769,0
3,1363,36607,3578753769,3578753769,0
3,1363,36608,3578753769,3578753769,0
3,1363,36609,3578753769,3578753769,0
3,1363,36610,3578753769,3578753769,0
3,1363,36611,3578753769,3578753770,1
3,1363,36612,3578753769,3578753770,1
3,1363,36613,3578753769,3578753771,2
3,1363,36614,3578753769,3578753772,3
3,1363,36615,3578753769,3578753773,4
3,1363,36616,3578753769,3578753773,4
3,1363,36617,3578753769,3578753778,9
3,1363,36618,3578753769,3578753778,9
3,1363,36619,3578753769,3578753782,13
3,1363,36620,3578753769,3578753783,14
3,1363,36621,3578753769,3578753783,14
3,1363,36622,3578753769,3578753786,17
3,1363,36623,3578753769,3578753786,17
3,1363,36624,3578753769,3578753787,18
3,1363,36625,3578753769,3578753787,18
3,1363,36626,3578753769,3578753788,19
3,1363,36627,3578753769,3578753788,19
3,1363,36628,3578753769,3578753788,19
3,1363,36629,3578753769,3578753788,19
3,1363,36630,3578753769,3578753789,20
3,1363,36631,3578753769,3578753790,21
3,1363,36632,3578753769,3578753790,21
3,1363,36633,3578753769,3578753793,24
3,1363,36634,3578753769,3578753793,24
3,1363,36635,3578753769,3578753793,24
3,1363,36636,3578753769,3578753794,25
3,1363,36637,3578753769,3578753797,28
3,1363,36638,3578753769,3578753799,30
3,1363,36639,3578753769,3578753800,31
3,1363,36640,3578753769,3578753802,33
3,1363,36641,3578753769,3578753802,33
3,1363,36642,3578753769,3578753804,35
3,1363,36643,3578753769,3578753804,35
3,1363,36644,3578753769,3578753805,36
3,1363,36645,3578753769,3578753806,37
3,1363,36646,3578753769,3578753806,37
3,1363,36647,3578753769,3578753807,38
3,1363,36648,3578753769,3578753807,38
3,1363,36649,3578753769,3578753808,39
3,1363,36650,3578753769,3578753809,40
3,1363,36651,3578753769,3578753811,42
3,1363,36652,3578753769,3578753812,43
3,1363,36653,3578753769,3578753812,43
3,1363,36654,3578753769,3578753813,44
3,1363,36655,3578753769,3578753813,44
3,1363,36656,3578753769,3578753816,47
3,1363,36657,3578753769,3578753817,48
3,1364,36658,3578753832,3578753832,0
3,1364,36659,3578753832,3578753832,0
3,1364,36660,3578753832,3578753832,0
3,1364,36661,3578753832,3578753832,0
3,1364,36662,3578753832,3578753832,0
3,1364,36663,3578753832,3578753832,0
3,1364,36664,3578753832,3578753832,0
3,1364,36665,3578753832,3578753832,0
3,1364,36666,3578753832,3578753832,0
3,1364,36667,3578753832,3578753832,0
3,1364,36668,3578753832,3578753832,0
3,1364,36669,3578753832,3578753832,0
3,1364,36670,3578753832,3578753832,0
3,1364,36671,3578753832,3578753832,0
3,1364,36672,3578753832,3578753832,0
3,1364,36673,3578753832,3578753833,1
3,1364,36674,3578753832,3578753834,2
3,1364,36675,3578753832,3578753835,3
3,1364,36676,3578753832,3578753837,5
3,1364,36677,3578753832,3578753839,7
3,1364,36678,3578753832,3578753839,7
3,1364,36679,3578753832,3578753840,8
3,1364,36680,3578753832,3578753841,9
3,1364,36681,3578753832,3578753842,10
3,1364,36682,3578753832,3578753843,11
3,1364,36683,3578753832,3578753843,11
3,1364,36684,3578753832,3578753844,12
3,1364,36685,3578753832,3578753844,12
3,1364,36686,3578753832,3578753844,12
3,1364,36687,3578753832,3578753844,12
3,1364,36688,3578753832,3578753845,13
3,1364,36689,3578753832,3578753847,15
3,1364,36690,3578753832,3578753847,15
3,1364,36691,3578753832,3578753849,17
3,1364,36692,3578753832,3578753849,17
3,1364,36693,3578753832,3578753851,19
3,1364,36694,3578753832,3578753853,21
3,1364,36695,3578753832,3578753853,21
3,1364,36696,3578753832,3578753856,24
3,1364,36697,3578753832,3578753856,24
3,1364,36698,3578753832,3578753858,26
3,1364,36699,3578753832,3578753859,27
3,1364,36700,3578753832,3578753859,27
3,1364,36701,3578753832,3578753862,30
3,1364,36702,3578753832,3578753862,30
3,1364,36703,3578753832,3578753862,30
3,1364,36704,3578753832,3578753864,32
3,1364,36705,3578753832,3578753869,37
3,1364,36706,3578753832,3578753875,43
3,1364,36707,3578753832,3578753879,47
3,1364,36708,3578753832,3578753880,48
3,1364,36709,3578753832,3578753882,50
3,1365,36710,3578753893,3578753893,0
3,1365,36711,3578753893,3578753893,0
3,1365,36712,3578753893,3578753893,0
3,1365,36713,3578753893,3578753893,0
3,1365,36714,3578753893,3578753893,0
3,1365,36715,3578753893,3578753893,0
3,1365,36716,3578753893,3578753893,0
3,1365,36717,3578753893,3578753893,0
3,1365,36718,3578753893,3578753893,0
3,1365,36719,3578753893,3578753893,0
3,1365,36720,3578753893,3578753894,1
3,1365,36721,3578753893,3578753894,1
3,1365,36722,3578753893,3578753896,3
3,1365,36723,3578753893,3578753898,5
3,1365,36724,3578753893,3578753898,5
3,1365,36725,3578753893,3578753900,7
3,1365,36726,3578753893,3578753901,8
3,1365,36727,3578753893,3578753902,9
3,1365,36728,3578753893,3578753902,9
3,1365,36729,3578753893,3578753902,9
3,1365,36730,3578753893,3578753904,11
3,1365,36731,3578753893,3578753905,12
3,1365,36732,3578753893,3578753905,12
3,1365,36733,3578753893,3578753906,13
3,1365,36734,3578753893,3578753906,13
3,1365,36735,3578753893,3578753909,16
3,1365,36736,3578753893,3578753910,17
3,1365,36737,3578753893,3578753911,18
3,1365,36738,3578753893,3578753911,18
3,1365,36739,3578753893,3578753912,19
3,1365,36740,3578753893,3578753913,20
3,1365,36741,3578753893,3578753914,21
3,1365,36742,3578753893,3578753915,22
3,1365,36743,3578753893,3578753915,22
3,1365,36744,3578753893,3578753916,23
3,1365,36745,3578753893,3578753917,24
3,1365,36746,3578753893,3578753920,27
3,1365,36747,3578753893,3578753921,28
3,1365,36748,3578753893,3578753921,28
3,1365,36749,3578753893,3578753921,28
3,1365,36750,3578753893,3578753921,28
3,1365,36751,3578753893,3578753925,32
3,1365,36752,3578753893,3578753931,38
3,1365,36753,3578753893,3578753932,39
3,1365,36754,3578753893,3578753934,41
3,1365,36755,3578753893,3578753935,42
3,1365,36756,3578753893,3578753936,43
3,1365,36757,3578753893,3578753939,46
3,1365,36758,3578753893,3578753939,46
3,1365,36759,3578753893,3578753942,49
3,1365,36760,3578753893,3578753943,50
3,1366,36761,3578754072,3578754072,0
3,1366,36762,3578754072,3578754072,0
3,1366,36763,3578754072,3578754072,0
3,1366,36764,3578754072,3578754072,0
3,1366,36765,3578754072,3578754072,0
3,1366,36766,3578754072,3578754072,0
3,1366,36767,3578754072,3578754072,0
3,1366,36768,3578754072,3578754072,0
3,1366,36769,3578754072,3578754072,0
3,1366,36770,3578754072,3578754072,0
3,1366,36771,3578754072,3578754072,0
3,1366,36772,3578754072,3578754072,0
3,1366,36773,3578754072,3578754072,0
3,1366,36774,3578754072,3578754072,0
3,1366,36775,3578754072,3578754072,0
3,1366,36776,3578754072,3578754072,0
3,1366,36777,3578754072,3578754072,0
3,1366,36778,3578754072,3578754072,0
3,1366,36779,3578754072,3578754072,0
3,1366,36780,3578754072,3578754072,0
3,1366,36781,3578754072,3578754072,0
3,1366,36782,3578754072,3578754072,0
3,1366,36783,3578754072,3578754072,0
3,1366,36784,3578754072,3578754072,0
3,1366,36785,3578754072,3578754072,0
3,1366,36786,3578754072,3578754072,0
3,1366,36787,3578754072,3578754072,0
3,1366,36788,3578754072,3578754072,0
3,1366,36789,3578754072,3578754072,0
3,1366,36790,3578754072,3578754072,0
3,1366,36791,3578754072,3578754072,0
3,1366,36792,3578754072,3578754072,0
3,1366,36793,3578754072,3578754072,0
3,1366,36794,3578754072,3578754072,0
3,1366,36795,3578754072,3578754072,0
3,1366,36796,3578754072,3578754072,0
3,1366,36797,3578754072,3578754072,0
3,1366,36798,3578754072,3578754072,0
3,1366,36799,3578754072,3578754072,0
3,1366,36800,3578754072,3578754072,0
3,1366,36801,3578754072,3578754072,0
3,1366,36802,3578754072,3578754072,0
3,1366,36803,3578754072,3578754072,0
3,1366,36804,3578754072,3578754072,0
3,1366,36805,3578754072,3578754072,0
3,1366,36806,3578754072,3578754072,0
3,1366,36807,3578754072,3578754072,0
3,1366,36808,3578754072,3578754072,0
3,1366,36809,3578754072,3578754072,0
3,1366,36810,3578754072,3578754072,0
3,1366,36811,3578754072,3578754072,0
3,1366,36812,3578754072,3578754072,0
3,1366,36813,3578754072,3578754072,0
3,1366,36814,3578754072,3578754072,0
3,1366,36815,3578754072,3578754113,41
3,1366,36816,3578754072,3578754113,41
3,1366,36817,3578754072,3578754113,41
3,1366,36818,3578754072,3578754113,41
3,1366,36819,3578754072,3578754113,41
3,1366,36820,3578754072,3578754113,41
3,1366,36821,3578754072,3578754113,41
3,1366,36822,3578754072,3578754113,41
3,1366,36823,3578754072,3578754113,41
3,1366,36824,3578754072,3578754113,41
3,1366,36825,3578754072,3578754113,41
3,1366,36826,3578754072,3578754113,41
3,1366,36827,3578754072,3578754113,41
3,1366,36828,3578754072,3578754113,41
3,1366,36829,3578754072,3578754113,41
3,1366,36830,3578754072,3578754114,42
3,1366,36831,3578754072,3578754114,42
3,1366,36832,3578754072,3578754114,42
3,1366,36833,3578754072,3578754114,42
3,1366,36834,3578754072,3578754114,42
3,1366,36835,3578754072,3578754114,42
3,1366,36836,3578754072,3578754114,42
3,1366,36837,3578754072,3578754114,42
3,1366,36838,3578754072,3578754114,42
3,1366,36839,3578754072,3578754114,42
3,1366,36840,3578754072,3578754114,42
3,1366,36841,3578754072,3578754114,42
3,1366,36842,3578754072,3578754114,42
3,1366,36843,3578754072,3578754114,42
3,1366,36844,3578754072,3578754114,42
3,1366,36845,3578754072,3578754114,42
3,1366,36846,3578754072,3578754114,42
3,1366,36847,3578754072,3578754114,42
3,1366,36848,3578754072,3578754114,42
3,1366,36849,3578754072,3578754114,42
3,1366,36850,3578754072,3578754114,42
3,1366,36851,3578754072,3578754114,42
3,1366,36852,3578754072,3578754114,42
3,1366,36853,3578754072,3578754114,42
3,1366,36854,3578754072,3578754114,42
3,1366,36855,3578754072,3578754114,42
3,1366,36856,3578754072,3578754114,42
3,1366,36857,3578754072,3578754114,42
3,1366,36858,3578754072,3578754114,42
3,1366,36859,3578754072,3578754114,42
3,1366,36860,3578754072,3578754114,42
3,1366,36861,3578754072,3578754114,42
3,1366,36862,3578754072,3578754114,42
3,1366,36863,3578754072,3578754114,42
3,1366,36864,3578754072,3578754114,42
3,1366,36865,3578754072,3578754114,42
3,1366,36866,3578754072,3578754114,42
3,1366,36867,3578754072,3578754114,42
3,1366,36868,3578754072,3578754114,42
3,1366,36869,3578754072,3578754114,42
3,1366,36870,3578754072,3578754114,42
3,1366,36871,3578754072,3578754114,42
3,1366,36872,3578754072,3578754114,42
3,1366,36873,3578754072,3578754114,42
3,1366,36874,3578754072,3578754114,42
3,1366,36875,3578754072,3578754114,42
3,1366,36876,3578754072,3578754114,42
3,1366,36877,3578754072,3578754114,42
3,1366,36878,3578754072,3578754114,42
3,1366,36879,3578754072,3578754114,42
3,1366,36880,3578754072,3578754114,42
3,1366,36881,3578754072,3578754114,42
3,1366,36882,3578754072,3578754114,42
3,1366,36883,3578754072,3578754114,42
3,1366,36884,3578754072,3578754114,42
3,1366,36885,3578754072,3578754114,42
3,1366,36886,3578754072,3578754114,42
3,1366,36887,3578754072,3578754114,42
3,1366,36888,3578754072,3578754114,42
3,1366,36889,3578754072,3578754114,42
3,1366,36890,3578754072,3578754114,42
3,1366,36891,3578754072,3578754114,42
3,1366,36892,3578754072,3578754114,42
3,1366,36893,3578754072,3578754114,42
3,1366,36894,3578754072,3578754114,42
3,1366,36895,3578754072,3578754114,42
3,1366,36896,3578754072,3578754114,42
3,1366,36897,3578754072,3578754114,42
3,1366,36898,3578754072,3578754114,42
3,1366,36899,3578754072,3578754114,42
3,1366,36900,3578754072,3578754114,42
3,1366,36901,3578754072,3578754114,42
3,1366,36902,3578754072,3578754114,42
3,1366,36903,3578754072,3578754114,42
3,1366,36904,3578754072,3578754114,42
3,1366,36905,3578754072,3578754114,42
3,1366,36906,3578754072,3578754114,42
3,1366,36907,3578754072,3578754114,42
3,1366,36908,3578754072,3578754114,42
3,1366,36909,3578754072,3578754114,42
3,1366,36910,3578754072,3578754114,42
3,1366,36911,3578754072,3578754115,43
3,1366,36912,3578754072,3578754116,44
3,1366,36913,3578754072,3578754116,44
3,1366,36914,3578754072,3578754118,46
3,1366,36915,3578754072,3578754121,49
3,1366,36916,3578754072,3578754121,49
3,1366,36917,3578754072,3578754122,50
3,1367,36918,3578754147,3578754147,0
3,1367,36919,3578754147,3578754147,0
3,1367,36920,3578754147,3578754147,0
3,1367,36921,3578754147,3578754147,0
3,1367,36922,3578754147,3578754147,0
3,1367,36923,3578754147,3578754147,0
3,1367,36924,3578754147,3578754147,0
3,1367,36925,3578754147,3578754147,0
3,1367,36926,3578754147,3578754147,0
3,1367,36927,3578754147,3578754147,0
3,1367,36928,3578754147,3578754147,0
3,1367,36929,3578754147,3578754147,0
3,1367,36930,3578754147,3578754149,2
3,1367,36931,3578754147,3578754150,3
3,1367,36932,3578754147,3578754151,4
3,1367,36933,3578754147,3578754152,5
3,1367,36934,3578754147,3578754154,7
3,1367,36935,3578754147,3578754154,7
3,1367,36936,3578754147,3578754157,10
3,1367,36937,3578754147,3578754158,11
3,1367,36938,3578754147,3578754158,11
3,1367,36939,3578754147,3578754158,11
3,1367,36940,3578754147,3578754161,14
3,1367,36941,3578754147,3578754164,17
3,1367,36942,3578754147,3578754164,17
3,1367,36943,3578754147,3578754165,18
3,1367,36944,3578754147,3578754166,19
3,1367,36945,3578754147,3578754167,20
3,1367,36946,3578754147,3578754167,20
3,1367,36947,3578754147,3578754168,21
3,1367,36948,3578754147,3578754168,21
3,1367,36949,3578754147,3578754169,22
3,1367,36950,3578754147,3578754170,23
3,1367,36951,3578754147,3578754171,24
3,1367,36952,3578754147,3578754172,25
3,1367,36953,3578754147,3578754172,25
3,1367,36954,3578754147,3578754173,26
3,1367,36955,3578754147,3578754173,26
3,1367,36956,3578754147,3578754177,30
3,1367,36957,3578754147,3578754179,32
3,1367,36958,3578754147,3578754182,35
3,1367,36959,3578754147,3578754183,36
3,1367,36960,3578754147,3578754183,36
3,1367,36961,3578754147,3578754184,37
3,1367,36962,3578754147,3578754186,39
3,1367,36963,3578754147,3578754187,40
3,1367,36964,3578754147,3578754187,40
3,1367,36965,3578754147,3578754187,40
3,1367,36966,3578754147,3578754187,40
3,1367,36967,3578754147,3578754188,41
3,1367,36968,3578754147,3578754188,41
3,1367,36969,3578754147,3578754188,41
3,1367,36970,3578754147,3578754188,41
3,1367,36971,3578754147,3578754190,43
3,1367,36972,3578754147,3578754191,44
3,1367,36973,3578754147,3578754191,44
3,1367,36974,3578754147,3578754192,45
3,1367,36975,3578754147,3578754194,47
3,1367,36976,3578754147,3578754194,47
3,1367,36977,3578754147,3578754194,47
3,1368,36978,3578754210,3578754210,0
3,1368,36979,3578754210,3578754210,0
3,1368,36980,3578754210,3578754210,0
3,1368,36981,3578754210,3578754210,0
3,1368,36982,3578754210,3578754210,0
3,1368,36983,3578754210,3578754210,0
3,1368,36984,3578754210,3578754210,0
3,1368,36985,3578754210,3578754210,0
3,1368,36986,3578754210,3578754210,0
3,1368,36987,3578754210,3578754210,0
3,1368,36988,3578754210,3578754210,0
3,1368,36989,3578754210,3578754210,0
3,1368,36990,3578754210,3578754210,0
3,1368,36991,3578754210,3578754210,0
3,1368,36992,3578754210,3578754212,2
3,1368,36993,3578754210,3578754212,2
3,1368,36994,3578754210,3578754213,3
3,1368,36995,3578754210,3578754214,4
3,1368,36996,3578754210,3578754215,5
3,1368,36997,3578754210,3578754217,7
3,1368,36998,3578754210,3578754217,7
3,1368,36999,3578754210,3578754220,10
3,1368,37000,3578754210,3578754222,12
3,1368,37001,3578754210,3578754223,13
3,1368,37002,3578754210,3578754224,14
3,1368,37003,3578754210,3578754225,15
3,1368,37004,3578754210,3578754225,15
3,1368,37005,3578754210,3578754226,16
3,1368,37006,3578754210,3578754227,17
3,1368,37007,3578754210,3578754227,17
3,1368,37008,3578754210,3578754227,17
3,1368,37009,3578754210,3578754228,18
3,1368,37010,3578754210,3578754230,20
3,1368,37011,3578754210,3578754231,21
3,1368,37012,3578754210,3578754232,22
3,1368,37013,3578754210,3578754233,23
3,1368,37014,3578754210,3578754234,24
3,1368,37015,3578754210,3578754234,24
3,1368,37016,3578754210,3578754237,27
3,1368,37017,3578754210,3578754237,27
3,1368,37018,3578754210,3578754239,29
3,1368,37019,3578754210,3578754239,29
3,1368,37020,3578754210,3578754240,30
3,1368,37021,3578754210,3578754241,31
3,1368,37022,3578754210,3578754242,32
3,1368,37023,3578754210,3578754243,33
3,1368,37024,3578754210,3578754245,35
3,1368,37025,3578754210,3578754245,35
3,1368,37026,3578754210,3578754245,35
3,1368,37027,3578754210,3578754245,35
3,1368,37028,3578754210,3578754245,35
3,1368,37029,3578754210,3578754247,37
3,1368,37030,3578754210,3578754248,38
3,1368,37031,3578754210,3578754251,41
3,1368,37032,3578754210,3578754251,41
3,1368,37033,3578754210,3578754253,43
3,1368,37034,3578754210,3578754254,44
3,1368,37035,3578754210,3578754256,46
3,1368,37036,3578754210,3578754256,46
3,1368,37037,3578754210,3578754257,47
3,1368,37038,3578754210,3578754258,48
3,1369,37039,3578754274,3578754274,0
3,1369,37040,3578754274,3578754274,0
3,1369,37041,3578754274,3578754274,0
3,1369,37042,3578754274,3578754274,0
3,1369,37043,3578754274,3578754274,0
3,1369,37044,3578754274,3578754274,0
3,1369,37045,3578754274,3578754280,6
3,1369,37046,3578754274,3578754281,7
3,1369,37047,3578754274,3578754283,9
3,1369,37048,3578754274,3578754284,10
3,1369,37049,3578754274,3578754284,10
3,1369,37050,3578754274,3578754285,11
3,1369,37051,3578754274,3578754285,11
3,1369,37052,3578754274,3578754287,13
3,1369,37053,3578754274,3578754289,15
3,1369,37054,3578754274,3578754289,15
3,1369,37055,3578754274,3578754294,20
3,1369,37056,3578754274,3578754295,21
3,1369,37057,3578754274,3578754297,23
3,1369,37058,3578754274,3578754297,23
3,1369,37059,3578754274,3578754298,24
3,1369,37060,3578754274,3578754300,26
3,1369,37061,3578754274,3578754302,28
3,1369,37062,3578754274,3578754302,28
3,1369,37063,3578754274,3578754302,28
3,1369,37064,3578754274,3578754303,29
3,1369,37065,3578754274,3578754305,31
3,1369,37066,3578754274,3578754306,32
3,1369,37067,3578754274,3578754306,32
3,1369,37068,3578754274,3578754306,32
3,1369,37069,3578754274,3578754308,34
3,1369,37070,3578754274,3578754309,35
3,1369,37071,3578754274,3578754310,36
3,1369,37072,3578754274,3578754311,37
3,1369,37073,3578754274,3578754311,37
3,1369,37074,3578754274,3578754312,38
3,1369,37075,3578754274,3578754314,40
3,1369,37076,3578754274,3578754315,41
3,1369,37077,3578754274,3578754316,42
3,1369,37078,3578754274,3578754316,42
3,1369,37079,3578754274,3578754318,44
3,1369,37080,3578754274,3578754321,47
3,1369,37081,3578754274,3578754321,47
3,1369,37082,3578754274,3578754322,48
3,1369,37083,3578754274,3578754322,48
3,1370,37084,3578754338,3578754338,0
3,1370,37085,3578754338,3578754338,0
3,1370,37086,3578754338,3578754338,0
3,1370,37087,3578754338,3578754338,0
3,1370,37088,3578754338,3578754338,0
3,1370,37089,3578754338,3578754339,1
3,1370,37090,3578754338,3578754340,2
3,1370,37091,3578754338,3578754343,5
3,1370,37092,3578754338,3578754344,6
3,1370,37093,3578754338,3578754345,7
3,1370,37094,3578754338,3578754350,12
3,1370,37095,3578754338,3578754350,12
3,1370,37096,3578754338,3578754350,12
3,1370,37097,3578754338,3578754352,14
3,1370,37098,3578754338,3578754354,16
3,1370,37099,3578754338,3578754354,16
3,1370,37100,3578754338,3578754358,20
3,1370,37101,3578754338,3578754358,20
3,1370,37102,3578754338,3578754358,20
3,1370,37103,3578754338,3578754358,20
3,1370,37104,3578754338,3578754360,22
3,1370,37105,3578754338,3578754364,26
3,1370,37106,3578754338,3578754365,27
3,1370,37107,3578754338,3578754365,27
3,1370,37108,3578754338,3578754366,28
3,1370,37109,3578754338,3578754367,29
3,1370,37110,3578754338,3578754368,30
3,1370,37111,3578754338,3578754369,31
3,1370,37112,3578754338,3578754369,31
3,1370,37113,3578754338,3578754369,31
3,1370,37114,3578754338,3578754370,32
3,1370,37115,3578754338,3578754372,34
3,1370,37116,3578754338,3578754373,35
3,1370,37117,3578754338,3578754373,35
3,1370,37118,3578754338,3578754373,35
3,1370,37119,3578754338,3578754377,39
3,1370,37120,3578754338,3578754378,40
3,1370,37121,3578754338,3578754383,45
3,1370,37122,3578754338,3578754383,45
3,1370,37123,3578754338,3578754383,45
3,1370,37124,3578754338,3578754384,46
3,1370,37125,3578754338,3578754386,48
3,1370,37126,3578754338,3578754387,49
3,1370,37127,3578754338,3578754387,49
3,1370,37128,3578754338,3578754387,49
3,1370,37129,3578754338,3578754387,49
3,1370,37130,3578754338,3578754388,50
3,1371,37131,3578754401,3578754401,0
3,1371,37132,3578754401,3578754401,0
3,1371,37133,3578754401,3578754401,0
3,1371,37134,3578754401,3578754401,0
3,1371,37135,3578754401,3578754401,0
3,1371,37136,3578754401,3578754401,0
3,1371,37137,3578754401,3578754401,0
3,1371,37138,3578754401,3578754401,0
3,1371,37139,3578754401,3578754401,0
3,1371,37140,3578754401,3578754401,0
3,1371,37141,3578754401,3578754401,0
3,1371,37142,3578754401,3578754401,0
3,1371,37143,3578754401,3578754401,0
3,1371,37144,3578754401,3578754401,0
3,1371,37145,3578754401,3578754402,1
3,1371,37146,3578754401,3578754402,1
3,1371,37147,3578754401,3578754403,2
3,1371,37148,3578754401,3578754403,2
3,1371,37149,3578754401,3578754405,4
3,1371,37150,3578754401,3578754406,5
3,1371,37151,3578754401,3578754406,5
3,1371,37152,3578754401,3578754407,6
3,1371,37153,3578754401,3578754407,6
3,1371,37154,3578754401,3578754408,7
3,1371,37155,3578754401,3578754408,7
3,1371,37156,3578754401,3578754409,8
3,1371,37157,3578754401,3578754409,8
3,1371,37158,3578754401,3578754412,11
3,1371,37159,3578754401,3578754413,12
3,1371,37160,3578754401,3578754413,12
3,1371,37161,3578754401,3578754414,13
3,1371,37162,3578754401,3578754415,14
3,1371,37163,3578754401,3578754415,14
3,1371,37164,3578754401,3578754417,16
3,1371,37165,3578754401,3578754418,17
3,1371,37166,3578754401,3578754421,20
3,1371,37167,3578754401,3578754423,22
3,1371,37168,3578754401,3578754423,22
3,1371,37169,3578754401,3578754424,23
3,1371,37170,3578754401,3578754425,24
3,1371,37171,3578754401,3578754425,24
3,1371,37172,3578754401,3578754426,25
3,1371,37173,3578754401,3578754427,26
3,1371,37174,3578754401,3578754427,26
3,1371,37175,3578754401,3578754428,27
3,1371,37176,3578754401,3578754431,30
3,1371,37177,3578754401,3578754432,31
3,1371,37178,3578754401,3578754433,32
3,1371,37179,3578754401,3578754433,32
3,1371,37180,3578754401,3578754434,33
3,1371,37181,3578754401,3578754437,36
3,1371,37182,3578754401,3578754437,36
3,1371,37183,3578754401,3578754439,38
3,1371,37184,3578754401,3578754440,39
3,1371,37185,3578754401,3578754440,39
3,1371,37186,3578754401,3578754441,40
3,1371,37187,3578754401,3578754442,41
3,1371,37188,3578754401,3578754443,42
3,1371,37189,3578754401,3578754443,42
3,1371,37190,3578754401,3578754444,43
3,1371,37191,3578754401,3578754444,43
3,1371,37192,3578754401,3578754444,43
3,1371,37193,3578754401,3578754445,44
3,1371,37194,3578754401,3578754446,45
3,1371,37195,3578754401,3578754447,46
3,1371,37196,3578754401,3578754447,46
3,1371,37197,3578754401,3578754450,49
3,1371,37198,3578754401,3578754451,50
3,1372,37199,3578754464,3578754464,0
3,1372,37200,3578754464,3578754464,0
3,1372,37201,3578754464,3578754464,0
3,1372,37202,3578754464,3578754464,0
3,1372,37203,3578754464,3578754464,0
3,1372,37204,3578754464,3578754464,0
3,1372,37205,3578754464,3578754464,0
3,1372,37206,3578754464,3578754464,0
3,1372,37207,3578754464,3578754464,0
3,1372,37208,3578754464,3578754464,0
3,1372,37209,3578754464,3578754469,5
3,1372,37210,3578754464,3578754475,11
3,1372,37211,3578754464,3578754480,16
3,1372,37212,3578754464,3578754480,16
3,1372,37213,3578754464,3578754481,17
3,1372,37214,3578754464,3578754483,19
3,1372,37215,3578754464,3578754484,20
3,1372,37216,3578754464,3578754484,20
3,1372,37217,3578754464,3578754484,20
3,1372,37218,3578754464,3578754486,22
3,1372,37219,3578754464,3578754487,23
3,1372,37220,3578754464,3578754488,24
3,1372,37221,3578754464,3578754490,26
3,1372,37222,3578754464,3578754490,26
3,1372,37223,3578754464,3578754494,30
3,1372,37224,3578754464,3578754495,31
3,1372,37225,3578754464,3578754496,32
3,1372,37226,3578754464,3578754497,33
3,1372,37227,3578754464,3578754498,34
3,1372,37228,3578754464,3578754500,36
3,1372,37229,3578754464,3578754501,37
3,1372,37230,3578754464,3578754502,38
3,1372,37231,3578754464,3578754502,38
3,1372,37232,3578754464,3578754502,38
3,1372,37233,3578754464,3578754504,40
3,1372,37234,3578754464,3578754505,41
3,1372,37235,3578754464,3578754506,42
3,1372,37236,3578754464,3578754506,42
3,1372,37237,3578754464,3578754509,45
3,1372,37238,3578754464,3578754510,46
3,1372,37239,3578754464,3578754510,46
3,1372,37240,3578754464,3578754511,47
3,1373,37241,3578754528,3578754528,0
3,1373,37242,3578754528,3578754528,0
3,1373,37243,3578754528,3578754528,0
3,1373,37244,3578754528,3578754528,0
3,1373,37245,3578754528,3578754528,0
3,1373,37246,3578754528,3578754528,0
3,1373,37247,3578754528,3578754528,0
3,1373,37248,3578754528,3578754528,0
3,1373,37249,3578754528,3578754528,0
3,1373,37250,3578754528,3578754528,0
3,1373,37251,3578754528,3578754531,3
3,1373,37252,3578754528,3578754535,7
3,1373,37253,3578754528,3578754537,9
3,1373,37254,3578754528,3578754539,11
3,1373,37255,3578754528,3578754542,14
3,1373,37256,3578754528,3578754542,14
3,1373,37257,3578754528,3578754544,16
3,1373,37258,3578754528,3578754549,21
3,1373,37259,3578754528,3578754549,21
3,1373,37260,3578754528,3578754549,21
3,1373,37261,3578754528,3578754550,22
3,1373,37262,3578754528,3578754551,23
3,1373,37263,3578754528,3578754553,25
3,1373,37264,3578754528,3578754553,25
3,1373,37265,3578754528,3578754556,28
3,1373,37266,3578754528,3578754557,29
3,1373,37267,3578754528,3578754557,29
3,1373,37268,3578754528,3578754558,30
3,1373,37269,3578754528,3578754559,31
3,1373,37270,3578754528,3578754563,35
3,1373,37271,3578754528,3578754564,36
3,1373,37272,3578754528,3578754564,36
3,1373,37273,3578754528,3578754565,37
3,1373,37274,3578754528,3578754566,38
3,1373,37275,3578754528,3578754566,38
3,1373,37276,3578754528,3578754567,39
3,1373,37277,3578754528,3578754567,39
3,1373,37278,3578754528,3578754568,40
3,1373,37279,3578754528,3578754569,41
3,1373,37280,3578754528,3578754569,41
3,1373,37281,3578754528,3578754569,41
3,1373,37282,3578754528,3578754569,41
3,1373,37283,3578754528,3578754570,42
3,1373,37284,3578754528,3578754572,44
3,1373,37285,3578754528,3578754572,44
3,1373,37286,3578754528,3578754574,46
3,1373,37287,3578754528,3578754576,48
3,1373,37288,3578754528,3578754578,50
3,1374,37289,3578754592,3578754592,0
3,1374,37290,3578754592,3578754592,0
3,1374,37291,3578754592,3578754592,0
3,1374,37292,3578754592,3578754592,0
3,1374,37293,3578754592,3578754592,0
3,1374,37294,3578754592,3578754592,0
3,1374,37295,3578754592,3578754592,0
3,1374,37296,3578754592,3578754592,0
3,1374,37297,3578754592,3578754592,0
3,1374,37298,3578754592,3578754592,0
3,1374,37299,3578754592,3578754592,0
3,1374,37300,3578754592,3578754592,0
3,1374,37301,3578754592,3578754592,0
3,1374,37302,3578754592,3578754592,0
3,1374,37303,3578754592,3578754592,0
3,1374,37304,3578754592,3578754592,0
3,1374,37305,3578754592,3578754592,0
3,1374,37306,3578754592,3578754592,0
3,1374,37307,3578754592,3578754592,0
3,1374,37308,3578754592,3578754592,0
3,1374,37309,3578754592,3578754592,0
3,1374,37310,3578754592,3578754593,1
3,1374,37311,3578754592,3578754594,2
3,1374,37312,3578754592,3578754597,5
3,1374,37313,3578754592,3578754599,7
3,1374,37314,3578754592,3578754601,9
3,1374,37315,3578754592,3578754601,9
3,1374,37316,3578754592,3578754601,9
3,1374,37317,3578754592,3578754602,10
3,1374,37318,3578754592,3578754604,12
3,1374,37319,3578754592,3578754605,13
3,1374,37320,3578754592,3578754605,13
3,1374,37321,3578754592,3578754606,14
3,1374,37322,3578754592,3578754607,15
3,1374,37323,3578754592,3578754607,15
3,1374,37324,3578754592,3578754607,15
3,1374,37325,3578754592,3578754608,16
3,1374,37326,3578754592,3578754608,16
3,1374,37327,3578754592,3578754611,19
3,1374,37328,3578754592,3578754611,19
3,1374,37329,3578754592,3578754612,20
3,1374,37330,3578754592,3578754613,21
3,1374,37331,3578754592,3578754614,22
3,1374,37332,3578754592,3578754614,22
3,1374,37333,3578754592,3578754616,24
3,1374,37334,3578754592,3578754616,24
3,1374,37335,3578754592,3578754620,28
3,1374,37336,3578754592,3578754621,29
3,1374,37337,3578754592,3578754622,30
3,1374,37338,3578754592,3578754623,31
3,1374,37339,3578754592,3578754624,32
3,1374,37340,3578754592,3578754625,33
3,1374,37341,3578754592,3578754626,34
3,1374,37342,3578754592,3578754626,34
3,1374,37343,3578754592,3578754627,35
3,1374,37344,3578754592,3578754628,36
3,1374,37345,3578754592,3578754629,37
3,1374,37346,3578754592,3578754631,39
3,1374,37347,3578754592,3578754632,40
3,1374,37348,3578754592,3578754633,41
3,1374,37349,3578754592,3578754633,41
3,1374,37350,3578754592,3578754636,44
3,1374,37351,3578754592,3578754636,44
3,1374,37352,3578754592,3578754638,46
3,1374,37353,3578754592,3578754640,48
3,1374,37354,3578754592,3578754640,48
3,1374,37355,3578754592,3578754640,48
3,1374,37356,3578754592,3578754642,50
3,1375,37357,3578754655,3578754655,0
3,1375,37358,3578754655,3578754655,0
3,1375,37359,3578754655,3578754655,0
3,1375,37360,3578754655,3578754655,0
3,1375,37361,3578754655,3578754655,0
3,1375,37362,3578754655,3578754655,0
3,1375,37363,3578754655,3578754655,0
3,1375,37364,3578754655,3578754655,0
3,1375,37365,3578754655,3578754655,0
3,1375,37366,3578754655,3578754655,0
3,1375,37367,3578754655,3578754655,0
3,1375,37368,3578754655,3578754655,0
3,1375,37369,3578754655,3578754656,1
3,1375,37370,3578754655,3578754656,1
3,1375,37371,3578754655,3578754658,3
3,1375,37372,3578754655,3578754658,3
3,1375,37373,3578754655,3578754660,5
3,1375,37374,3578754655,3578754661,6
3,1375,37375,3578754655,3578754662,7
3,1375,37376,3578754655,3578754669,14
3,1375,37377,3578754655,3578754674,19
3,1375,37378,3578754655,3578754680,25
3,1375,37379,3578754655,3578754680,25
3,1375,37380,3578754655,3578754681,26
3,1375,37381,3578754655,3578754683,28
3,1375,37382,3578754655,3578754684,29
3,1375,37383,3578754655,3578754685,30
3,1375,37384,3578754655,3578754686,31
3,1375,37385,3578754655,3578754687,32
3,1375,37386,3578754655,3578754689,34
3,1375,37387,3578754655,3578754689,34
3,1375,37388,3578754655,3578754691,36
3,1375,37389,3578754655,3578754694,39
3,1375,37390,3578754655,3578754695,40
3,1375,37391,3578754655,3578754696,41
3,1375,37392,3578754655,3578754696,41
3,1375,37393,3578754655,3578754697,42
3,1375,37394,3578754655,3578754698,43
3,1375,37395,3578754655,3578754699,44
3,1375,37396,3578754655,3578754700,45
3,1375,37397,3578754655,3578754702,47
3,1375,37398,3578754655,3578754702,47
3,1375,37399,3578754655,3578754702,47
3,1375,37400,3578754655,3578754703,48
3,1375,37401,3578754655,3578754705,50
3,1376,37402,3578754717,3578754717,0
3,1376,37403,3578754717,3578754717,0
3,1376,37404,3578754717,3578754717,0
3,1376,37405,3578754717,3578754717,0
3,1376,37406,3578754717,3578754717,0
3,1376,37407,3578754717,3578754717,0
3,1376,37408,3578754717,3578754717,0
3,1376,37409,3578754717,3578754717,0
3,1376,37410,3578754717,3578754717,0
3,1376,37411,3578754717,3578754717,0
3,1376,37412,3578754717,3578754717,0
3,1376,37413,3578754717,3578754717,0
3,1376,37414,3578754717,3578754718,1
3,1376,37415,3578754717,3578754720,3
3,1376,37416,3578754717,3578754720,3
3,1376,37417,3578754717,3578754721,4
3,1376,37418,3578754717,3578754721,4
3,1376,37419,3578754717,3578754722,5
3,1376,37420,3578754717,3578754726,9
3,1376,37421,3578754717,3578754730,13
3,1376,37422,3578754717,3578754731,14
3,1376,37423,3578754717,3578754735,18
3,1376,37424,3578754717,3578754735,18
3,1376,37425,3578754717,3578754737,20
3,1376,37426,3578754717,3578754739,22
3,1376,37427,3578754717,3578754742,25
3,1376,37428,3578754717,3578754742,25
3,1376,37429,3578754717,3578754744,27
3,1376,37430,3578754717,3578754748,31
3,1376,37431,3578754717,3578754749,32
3,1376,37432,3578754717,3578754750,33
3,1376,37433,3578754717,3578754751,34
3,1376,37434,3578754717,3578754752,35
3,1376,37435,3578754717,3578754753,36
3,1376,37436,3578754717,3578754753,36
3,1376,37437,3578754717,3578754756,39
3,1376,37438,3578754717,3578754757,40
3,1376,37439,3578754717,3578754757,40
3,1376,37440,3578754717,3578754758,41
3,1376,37441,3578754717,3578754761,44
3,1376,37442,3578754717,3578754763,46
3,1376,37443,3578754717,3578754765,48
3,1376,37444,3578754717,3578754765,48
3,1376,37445,3578754717,3578754765,48
3,1376,37446,3578754717,3578754767,50
3,1377,37447,3578754780,3578754780,0
3,1377,37448,3578754780,3578754780,0
3,1377,37449,3578754780,3578754780,0
3,1377,37450,3578754780,3578754780,0
3,1377,37451,3578754780,3578754780,0
3,1377,37452,3578754780,3578754780,0
3,1377,37453,3578754780,3578754780,0
3,1377,37454,3578754780,3578754780,0
3,1377,37455,3578754780,3578754780,0
3,1377,37456,3578754780,3578754780,0
3,1377,37457,3578754780,3578754780,0
3,1377,37458,3578754780,3578754780,0
3,1377,37459,3578754780,3578754780,0
3,1377,37460,3578754780,3578754782,2
3,1377,37461,3578754780,3578754783,3
3,1377,37462,3578754780,3578754783,3
3,1377,37463,3578754780,3578754783,3
3,1377,37464,3578754780,3578754783,3
3,1377,37465,3578754780,3578754786,6
3,1377,37466,3578754780,3578754786,6
3,1377,37467,3578754780,3578754787,7
3,1377,37468,3578754780,3578754787,7
3,1377,37469,3578754780,3578754787,7
3,1377,37470,3578754780,3578754787,7
3,1377,37471,3578754780,3578754787,7
3,1377,37472,3578754780,3578754787,7
3,1377,37473,3578754780,3578754788,8
3,1377,37474,3578754780,3578754788,8
3,1377,37475,3578754780,3578754789,9
3,1377,37476,3578754780,3578754790,10
3,1377,37477,3578754780,3578754790,10
3,1377,37478,3578754780,3578754792,12
3,1377,37479,3578754780,3578754793,13
3,1377,37480,3578754780,3578754794,14
3,1377,37481,3578754780,3578754794,14
3,1377,37482,3578754780,3578754797,17
3,1377,37483,3578754780,3578754801,21
3,1377,37484,3578754780,3578754802,22
3,1377,37485,3578754780,3578754802,22
3,1377,37486,3578754780,3578754804,24
3,1377,37487,3578754780,3578754805,25
3,1377,37488,3578754780,3578754805,25
3,1377,37489,3578754780,3578754806,26
3,1377,37490,3578754780,3578754807,27
3,1377,37491,3578754780,3578754807,27
3,1377,37492,3578754780,3578754807,27
3,1377,37493,3578754780,3578754808,28
3,1377,37494,3578754780,3578754809,29
3,1377,37495,3578754780,3578754811,31
3,1377,37496,3578754780,3578754811,31
3,1377,37497,3578754780,3578754812,32
3,1377,37498,3578754780,3578754813,33
3,1377,37499,3578754780,3578754813,33
3,1377,37500,3578754780,3578754814,34
3,1377,37501,3578754780,3578754816,36
3,1377,37502,3578754780,3578754816,36
3,1377,37503,3578754780,3578754820,40
3,1377,37504,3578754780,3578754821,41
3,1377,37505,3578754780,3578754823,43
3,1377,37506,3578754780,3578754824,44
3,1377,37507,3578754780,3578754825,45
3,1377,37508,3578754780,3578754826,46
3,1377,37509,3578754780,3578754826,46
3,1377,37510,3578754780,3578754827,47
3,1377,37511,3578754780,3578754828,48
3,1377,37512,3578754780,3578754828,48
3,1378,37513,3578754842,3578754842,0
3,1378,37514,3578754842,3578754842,0
3,1378,37515,3578754842,3578754842,0
3,1378,37516,3578754842,3578754842,0
3,1378,37517,3578754842,3578754843,1
3,1378,37518,3578754842,3578754843,1
3,1378,37519,3578754842,3578754843,1
3,1378,37520,3578754842,3578754843,1
3,1378,37521,3578754842,3578754843,1
3,1378,37522,3578754842,3578754843,1
3,1378,37523,3578754842,3578754843,1
3,1378,37524,3578754842,3578754843,1
3,1378,37525,3578754842,3578754843,1
3,1378,37526,3578754842,3578754844,2
3,1378,37527,3578754842,3578754844,2
3,1378,37528,3578754842,3578754844,2
3,1378,37529,3578754842,3578754844,2
3,1378,37530,3578754842,3578754845,3
3,1378,37531,3578754842,3578754846,4
3,1378,37532,3578754842,3578754847,5
3,1378,37533,3578754842,3578754850,8
3,1378,37534,3578754842,3578754850,8
3,1378,37535,3578754842,3578754853,11
3,1378,37536,3578754842,3578754853,11
3,1378,37537,3578754842,3578754855,13
3,1378,37538,3578754842,3578754856,14
3,1378,37539,3578754842,3578754858,16
3,1378,37540,3578754842,3578754861,19
3,1378,37541,3578754842,3578754861,19
3,1378,37542,3578754842,3578754863,21
3,1378,37543,3578754842,3578754864,22
3,1378,37544,3578754842,3578754864,22
3,1378,37545,3578754842,3578754870,28
3,1378,37546,3578754842,3578754874,32
3,1378,37547,3578754842,3578754880,38
3,1378,37548,3578754842,3578754884,42
3,1378,37549,3578754842,3578754886,44
3,1378,37550,3578754842,3578754887,45
3,1378,37551,3578754842,3578754890,48
3,1378,37552,3578754842,3578754890,48
3,1379,37553,3578754903,3578754904,1
3,1379,37554,3578754903,3578754904,1
3,1379,37555,3578754903,3578754904,1
3,1379,37556,3578754903,3578754904,1
3,1379,37557,3578754903,3578754904,1
3,1379,37558,3578754903,3578754904,1
3,1379,37559,3578754903,3578754904,1
3,1379,37560,3578754903,3578754904,1
3,1379,37561,3578754903,3578754904,1
3,1379,37562,3578754903,3578754904,1
3,1379,37563,3578754903,3578754904,1
3,1379,37564,3578754903,3578754905,2
3,1379,37565,3578754903,3578754905,2
3,1379,37566,3578754903,3578754905,2
3,1379,37567,3578754903,3578754906,3
3,1379,37568,3578754903,3578754910,7
3,1379,37569,3578754903,3578754911,8
3,1379,37570,3578754903,3578754914,11
3,1379,37571,3578754903,3578754914,11
3,1379,37572,3578754903,3578754915,12
3,1379,37573,3578754903,3578754916,13
3,1379,37574,3578754903,3578754916,13
3,1379,37575,3578754903,3578754918,15
3,1379,37576,3578754903,3578754920,17
3,1379,37577,3578754903,3578754921,18
3,1379,37578,3578754903,3578754921,18
3,1379,37579,3578754903,3578754921,18
3,1379,37580,3578754903,3578754923,20
3,1379,37581,3578754903,3578754926,23
3,1379,37582,3578754903,3578754931,28
3,1379,37583,3578754903,3578754931,28
3,1379,37584,3578754903,3578754935,32
3,1379,37585,3578754903,3578754935,32
3,1379,37586,3578754903,3578754936,33
3,1379,37587,3578754903,3578754939,36
3,1379,37588,3578754903,3578754941,38
3,1379,37589,3578754903,3578754942,39
3,1379,37590,3578754903,3578754948,45
3,1379,37591,3578754903,3578754949,46
3,1379,37592,3578754903,3578754949,46
3,1379,37593,3578754903,3578754952,49
3,1380,37594,3578754965,3578754965,0
3,1380,37595,3578754965,3578754965,0
3,1380,37596,3578754965,3578754965,0
3,1380,37597,3578754965,3578754965,0
3,1380,37598,3578754965,3578754965,0
3,1380,37599,3578754965,3578754965,0
3,1380,37600,3578754965,3578754965,0
3,1380,37601,3578754965,3578754965,0
3,1380,37602,3578754965,3578754965,0
3,1380,37603,3578754965,3578754965,0
3,1380,37604,3578754965,3578754965,0
3,1380,37605,3578754965,3578754966,1
3,1380,37606,3578754965,3578754966,1
3,1380,37607,3578754965,3578754967,2
3,1380,37608,3578754965,3578754968,3
3,1380,37609,3578754965,3578754968,3
3,1380,37610,3578754965,3578754969,4
3,1380,37611,3578754965,3578754969,4
3,1380,37612,3578754965,3578754969,4
3,1380,37613,3578754965,3578754970,5
3,1380,37614,3578754965,3578754970,5
3,1380,37615,3578754965,3578754971,6
3,1380,37616,3578754965,3578754974,9
3,1380,37617,3578754965,3578754976,11
3,1380,37618,3578754965,3578754982,17
3,1380,37619,3578754965,3578754983,18
3,1380,37620,3578754965,3578754983,18
3,1380,37621,3578754965,3578754983,18
3,1380,37622,3578754965,3578754984,19
3,1380,37623,3578754965,3578754986,21
3,1380,37624,3578754965,3578754986,21
3,1380,37625,3578754965,3578754987,22
3,1380,37626,3578754965,3578754987,22
3,1380,37627,3578754965,3578754987,22
3,1380,37628,3578754965,3578754987,22
3,1380,37629,3578754965,3578754988,23
3,1380,37630,3578754965,3578754988,23
3,1380,37631,3578754965,3578754988,23
3,1380,37632,3578754965,3578754989,24
3,1380,37633,3578754965,3578754990,25
3,1380,37634,3578754965,3578754991,26
3,1380,37635,3578754965,3578754992,27
3,1380,37636,3578754965,3578754993,28
3,1380,37637,3578754965,3578754994,29
3,1380,37638,3578754965,3578754994,29
3,1380,37639,3578754965,3578754997,32
3,1380,37640,3578754965,3578755001,36
3,1380,37641,3578754965,3578755002,37
3,1380,37642,3578754965,3578755002,37
3,1380,37643,3578754965,3578755003,38
3,1380,37644,3578754965,3578755004,39
3,1380,37645,3578754965,3578755005,40
3,1380,37646,3578754965,3578755005,40
3,1380,37647,3578754965,3578755006,41
3,1380,37648,3578754965,3578755007,42
3,1380,37649,3578754965,3578755007,42
3,1380,37650,3578754965,3578755007,42
3,1380,37651,3578754965,3578755009,44
3,1380,37652,3578754965,3578755009,44
3,1380,37653,3578754965,3578755011,46
3,1380,37654,3578754965,3578755012,47
3,1380,37655,3578754965,3578755013,48
3,1380,37656,3578754965,3578755014,49
3,1380,37657,3578754965,3578755014,49
3,1380,37658,3578754965,3578755015,50
3,1381,37659,3578755028,3578755028,0
3,1381,37660,3578755028,3578755028,0
3,1381,37661,3578755028,3578755028,0
3,1381,37662,3578755028,3578755028,0
3,1381,37663,3578755028,3578755028,0
3,1381,37664,3578755028,3578755028,0
3,1381,37665,3578755028,3578755028,0
3,1381,37666,3578755028,3578755028,0
3,1381,37667,3578755028,3578755028,0
3,1381,37668,3578755028,3578755028,0
3,1381,37669,3578755028,3578755028,0
3,1381,37670,3578755028,3578755028,0
3,1381,37671,3578755028,3578755031,3
3,1381,37672,3578755028,3578755031,3
3,1381,37673,3578755028,3578755032,4
3,1381,37674,3578755028,3578755033,5
3,1381,37675,3578755028,3578755034,6
3,1381,37676,3578755028,3578755036,8
3,1381,37677,3578755028,3578755036,8
3,1381,37678,3578755028,3578755038,10
3,1381,37679,3578755028,3578755039,11
3,1381,37680,3578755028,3578755040,12
3,1381,37681,3578755028,3578755042,14
3,1381,37682,3578755028,3578755043,15
3,1381,37683,3578755028,3578755043,15
3,1381,37684,3578755028,3578755043,15
3,1381,37685,3578755028,3578755044,16
3,1381,37686,3578755028,3578755044,16
3,1381,37687,3578755028,3578755045,17
3,1381,37688,3578755028,3578755045,17
3,1381,37689,3578755028,3578755046,18
3,1381,37690,3578755028,3578755050,22
3,1381,37691,3578755028,3578755050,22
3,1381,37692,3578755028,3578755053,25
3,1381,37693,3578755028,3578755053,25
3,1381,37694,3578755028,3578755055,27
3,1381,37695,3578755028,3578755056,28
3,1381,37696,3578755028,3578755057,29
3,1381,37697,3578755028,3578755058,30
3,1381,37698,3578755028,3578755062,34
3,1381,37699,3578755028,3578755062,34
3,1381,37700,3578755028,3578755064,36
3,1381,37701,3578755028,3578755065,37
3,1381,37702,3578755028,3578755069,41
3,1381,37703,3578755028,3578755075,47
3,1382,37704,3578755091,3578755091,0
3,1382,37705,3578755091,3578755091,0
3,1382,37706,3578755091,3578755091,0
3,1382,37707,3578755091,3578755091,0
3,1382,37708,3578755091,3578755091,0
3,1382,37709,3578755091,3578755091,0
3,1382,37710,3578755091,3578755091,0
3,1382,37711,3578755091,3578755091,0
3,1382,37712,3578755091,3578755091,0
3,1382,37713,3578755091,3578755095,4
3,1382,37714,3578755091,3578755096,5
3,1382,37715,3578755091,3578755096,5
3,1382,37716,3578755091,3578755097,6
3,1382,37717,3578755091,3578755097,6
3,1382,37718,3578755091,3578755098,7
3,1382,37719,3578755091,3578755099,8
3,1382,37720,3578755091,3578755100,9
3,1382,37721,3578755091,3578755102,11
3,1382,37722,3578755091,3578755102,11
3,1382,37723,3578755091,3578755102,11
3,1382,37724,3578755091,3578755103,12
3,1382,37725,3578755091,3578755105,14
3,1382,37726,3578755091,3578755106,15
3,1382,37727,3578755091,3578755106,15
3,1382,37728,3578755091,3578755106,15
3,1382,37729,3578755091,3578755110,19
3,1382,37730,3578755091,3578755111,20
3,1382,37731,3578755091,3578755111,20
3,1382,37732,3578755091,3578755113,22
3,1382,37733,3578755091,3578755116,25
3,1382,37734,3578755091,3578755116,25
3,1382,37735,3578755091,3578755119,28
3,1382,37736,3578755091,3578755120,29
3,1382,37737,3578755091,3578755120,29
3,1382,37738,3578755091,3578755121,30
3,1382,37739,3578755091,3578755121,30
3,1382,37740,3578755091,3578755123,32
3,1382,37741,3578755091,3578755126,35
3,1382,37742,3578755091,3578755131,40
3,1382,37743,3578755091,3578755132,41
3,1382,37744,3578755091,3578755134,43
3,1382,37745,3578755091,3578755136,45
3,1382,37746,3578755091,3578755137,46
3,1382,37747,3578755091,3578755138,47
3,1382,37748,3578755091,3578755140,49
3,1383,37749,3578755154,3578755154,0
3,1383,37750,3578755154,3578755154,0
3,1383,37751,3578755154,3578755154,0
3,1383,37752,3578755154,3578755154,0
3,1383,37753,3578755154,3578755154,0
3,1383,37754,3578755154,3578755154,0
3,1383,37755,3578755154,3578755154,0
3,1383,37756,3578755154,3578755154,0
3,1383,37757,3578755154,3578755157,3
3,1383,37758,3578755154,3578755159,5
3,1383,37759,3578755154,3578755161,7
3,1383,37760,3578755154,3578755164,10
3,1383,37761,3578755154,3578755164,10
3,1383,37762,3578755154,3578755166,12
3,1383,37763,3578755154,3578755166,12
3,1383,37764,3578755154,3578755166,12
3,1383,37765,3578755154,3578755167,13
3,1383,37766,3578755154,3578755167,13
3,1383,37767,3578755154,3578755168,14
3,1383,37768,3578755154,3578755168,14
3,1383,37769,3578755154,3578755168,14
3,1383,37770,3578755154,3578755169,15
3,1383,37771,3578755154,3578755169,15
3,1383,37772,3578755154,3578755171,17
3,1383,37773,3578755154,3578755173,19
3,1383,37774,3578755154,3578755173,19
3,1383,37775,3578755154,3578755174,20
3,1383,37776,3578755154,3578755176,22
3,1383,37777,3578755154,3578755182,28
3,1383,37778,3578755154,3578755184,30
3,1383,37779,3578755154,3578755184,30
3,1383,37780,3578755154,3578755184,30
3,1383,37781,3578755154,3578755185,31
3,1383,37782,3578755154,3578755186,32
3,1383,37783,3578755154,3578755187,33
3,1383,37784,3578755154,3578755187,33
3,1383,37785,3578755154,3578755187,33
3,1383,37786,3578755154,3578755188,34
3,1383,37787,3578755154,3578755188,34
3,1383,37788,3578755154,3578755188,34
3,1383,37789,3578755154,3578755188,34
3,1383,37790,3578755154,3578755189,35
3,1383,37791,3578755154,3578755189,35
3,1383,37792,3578755154,3578755189,35
3,1383,37793,3578755154,3578755191,37
3,1383,37794,3578755154,3578755191,37
3,1383,37795,3578755154,3578755192,38
3,1383,37796,3578755154,3578755193,39
3,1383,37797,3578755154,3578755194,40
3,1383,37798,3578755154,3578755195,41
3,1383,37799,3578755154,3578755198,44
3,1383,37800,3578755154,3578755199,45
3,1383,37801,3578755154,3578755201,47
3,1383,37802,3578755154,3578755202,48
3,1383,37803,3578755154,3578755204,50
3,1383,37804,3578755154,3578755204,50
3,1384,37805,3578755216,3578755216,0
3,1384,37806,3578755216,3578755216,0
3,1384,37807,3578755216,3578755216,0
3,1384,37808,3578755216,3578755216,0
3,1384,37809,3578755216,3578755216,0
3,1384,37810,3578755216,3578755216,0
3,1384,37811,3578755216,3578755216,0
3,1384,37812,3578755216,3578755216,0
3,1384,37813,3578755216,3578755216,0
3,1384,37814,3578755216,3578755216,0
3,1384,37815,3578755216,3578755216,0
3,1384,37816,3578755216,3578755216,0
3,1384,37817,3578755216,3578755216,0
3,1384,37818,3578755216,3578755216,0
3,1384,37819,3578755216,3578755216,0
3,1384,37820,3578755216,3578755220,4
3,1384,37821,3578755216,3578755221,5
3,1384,37822,3578755216,3578755223,7
3,1384,37823,3578755216,3578755223,7
3,1384,37824,3578755216,3578755224,8
3,1384,37825,3578755216,3578755224,8
3,1384,37826,3578755216,3578755225,9
3,1384,37827,3578755216,3578755225,9
3,1384,37828,3578755216,3578755227,11
3,1384,37829,3578755216,3578755227,11
3,1384,37830,3578755216,3578755227,11
3,1384,37831,3578755216,3578755229,13
3,1384,37832,3578755216,3578755232,16
3,1384,37833,3578755216,3578755232,16
3,1384,37834,3578755216,3578755233,17
3,1384,37835,3578755216,3578755233,17
3,1384,37836,3578755216,3578755236,20
3,1384,37837,3578755216,3578755236,20
3,1384,37838,3578755216,3578755238,22
3,1384,37839,3578755216,3578755239,23
3,1384,37840,3578755216,3578755240,24
3,1384,37841,3578755216,3578755242,26
3,1384,37842,3578755216,3578755242,26
3,1384,37843,3578755216,3578755243,27
3,1384,37844,3578755216,3578755243,27
3,1384,37845,3578755216,3578755244,28
3,1384,37846,3578755216,3578755245,29
3,1384,37847,3578755216,3578755246,30
3,1384,37848,3578755216,3578755246,30
3,1384,37849,3578755216,3578755250,34
3,1384,37850,3578755216,3578755251,35
3,1384,37851,3578755216,3578755252,36
3,1384,37852,3578755216,3578755254,38
3,1384,37853,3578755216,3578755254,38
3,1384,37854,3578755216,3578755256,40
3,1384,37855,3578755216,3578755256,40
3,1384,37856,3578755216,3578755258,42
3,1384,37857,3578755216,3578755262,46
3,1384,37858,3578755216,3578755262,46
3,1384,37859,3578755216,3578755264,48
3,1384,37860,3578755216,3578755264,48
3,1385,37861,3578755279,3578755279,0
3,1385,37862,3578755279,3578755279,0
3,1385,37863,3578755279,3578755280,1
3,1385,37864,3578755279,3578755281,2
3,1385,37865,3578755279,3578755283,4
3,1385,37866,3578755279,3578755284,5
3,1385,37867,3578755279,3578755284,5
3,1385,37868,3578755279,3578755284,5
3,1385,37869,3578755279,3578755286,7
3,1385,37870,3578755279,3578755286,7
3,1385,37871,3578755279,3578755289,10
3,1385,37872,3578755279,3578755291,12
3,1385,37873,3578755279,3578755295,16
3,1385,37874,3578755279,3578755295,16
3,1385,37875,3578755279,3578755297,18
3,1385,37876,3578755279,3578755297,18
3,1385,37877,3578755279,3578755297,18
3,1385,37878,3578755279,3578755299,20
3,1385,37879,3578755279,3578755300,21
3,1385,37880,3578755279,3578755300,21
3,1385,37881,3578755279,3578755302,23
3,1385,37882,3578755279,3578755302,23
3,1385,37883,3578755279,3578755303,24
3,1385,37884,3578755279,3578755306,27
3,1385,37885,3578755279,3578755306,27
3,1385,37886,3578755279,3578755306,27
3,1385,37887,3578755279,3578755306,27
3,1385,37888,3578755279,3578755310,31
3,1385,37889,3578755279,3578755310,31
3,1385,37890,3578755279,3578755311,32
3,1385,37891,3578755279,3578755316,37
3,1385,37892,3578755279,3578755317,38
3,1385,37893,3578755279,3578755319,40
3,1385,37894,3578755279,3578755320,41
3,1385,37895,3578755279,3578755320,41
3,1385,37896,3578755279,3578755322,43
3,1385,37897,3578755279,3578755322,43
3,1385,37898,3578755279,3578755326,47
3,1386,37899,3578755342,3578755342,0
3,1386,37900,3578755342,3578755342,0
3,1386,37901,3578755342,3578755342,0
3,1386,37902,3578755342,3578755342,0
3,1386,37903,3578755342,3578755342,0
3,1386,37904,3578755342,3578755342,0
3,1386,37905,3578755342,3578755342,0
3,1386,37906,3578755342,3578755343,1
3,1386,37907,3578755342,3578755346,4
3,1386,37908,3578755342,3578755348,6
3,1386,37909,3578755342,3578755349,7
3,1386,37910,3578755342,3578755351,9
3,1386,37911,3578755342,3578755353,11
3,1386,37912,3578755342,3578755356,14
3,1386,37913,3578755342,3578755360,18
3,1386,37914,3578755342,3578755361,19
3,1386,37915,3578755342,3578755364,22
3,1386,37916,3578755342,3578755366,24
3,1386,37917,3578755342,3578755366,24
3,1386,37918,3578755342,3578755366,24
3,1386,37919,3578755342,3578755366,24
3,1386,37920,3578755342,3578755367,25
3,1386,37921,3578755342,3578755367,25
3,1386,37922,3578755342,3578755368,26
3,1386,37923,3578755342,3578755369,27
3,1386,37924,3578755342,3578755369,27
3,1386,37925,3578755342,3578755373,31
3,1386,37926,3578755342,3578755373,31
3,1386,37927,3578755342,3578755373,31
3,1386,37928,3578755342,3578755376,34
3,1386,37929,3578755342,3578755383,41
3,1386,37930,3578755342,3578755383,41
3,1386,37931,3578755342,3578755384,42
3,1386,37932,3578755342,3578755386,44
3,1386,37933,3578755342,3578755387,45
3,1386,37934,3578755342,3578755387,45
3,1386,37935,3578755342,3578755387,45
3,1386,37936,3578755342,3578755387,45
3,1386,37937,3578755342,3578755388,46
3,1386,37938,3578755342,3578755388,46
3,1386,37939,3578755342,3578755388,46
3,1386,37940,3578755342,3578755389,47
3,1386,37941,3578755342,3578755389,47
3,1386,37942,3578755342,3578755389,47
3,1386,37943,3578755342,3578755391,49
3,1387,37944,3578755404,3578755404,0
3,1387,37945,3578755404,3578755404,0
3,1387,37946,3578755404,3578755404,0
3,1387,37947,3578755404,3578755404,0
3,1387,37948,3578755404,3578755404,0
3,1387,37949,3578755404,3578755404,0
3,1387,37950,3578755404,3578755404,0
3,1387,37951,3578755404,3578755404,0
3,1387,37952,3578755404,3578755404,0
3,1387,37953,3578755404,3578755404,0
3,1387,37954,3578755404,3578755405,1
3,1387,37955,3578755404,3578755406,2
3,1387,37956,3578755404,3578755407,3
3,1387,37957,3578755404,3578755407,3
3,1387,37958,3578755404,3578755408,4
3,1387,37959,3578755404,3578755408,4
3,1387,37960,3578755404,3578755409,5
3,1387,37961,3578755404,3578755411,7
3,1387,37962,3578755404,3578755413,9
3,1387,37963,3578755404,3578755413,9
3,1387,37964,3578755404,3578755413,9
3,1387,37965,3578755404,3578755414,10
3,1387,37966,3578755404,3578755415,11
3,1387,37967,3578755404,3578755416,12
3,1387,37968,3578755404,3578755416,12
3,1387,37969,3578755404,3578755420,16
3,1387,37970,3578755404,3578755423,19
3,1387,37971,3578755404,3578755423,19
3,1387,37972,3578755404,3578755425,21
3,1387,37973,3578755404,3578755425,21
3,1387,37974,3578755404,3578755425,21
3,1387,37975,3578755404,3578755427,23
3,1387,37976,3578755404,3578755427,23
3,1387,37977,3578755404,3578755428,24
3,1387,37978,3578755404,3578755429,25
3,1387,37979,3578755404,3578755431,27
3,1387,37980,3578755404,3578755432,28
3,1387,37981,3578755404,3578755433,29
3,1387,37982,3578755404,3578755433,29
3,1387,37983,3578755404,3578755434,30
3,1387,37984,3578755404,3578755436,32
3,1387,37985,3578755404,3578755438,34
3,1387,37986,3578755404,3578755440,36
3,1387,37987,3578755404,3578755440,36
3,1387,37988,3578755404,3578755442,38
3,1387,37989,3578755404,3578755443,39
3,1387,37990,3578755404,3578755444,40
3,1387,37991,3578755404,3578755444,40
3,1387,37992,3578755404,3578755444,40
3,1387,37993,3578755404,3578755446,42
3,1387,37994,3578755404,3578755447,43
3,1387,37995,3578755404,3578755447,43
3,1387,37996,3578755404,3578755450,46
3,1387,37997,3578755404,3578755451,47
3,1387,37998,3578755404,3578755452,48
3,1387,37999,3578755404,3578755454,50
3,1388,38000,3578755468,3578755468,0
3,1388,38001,3578755468,3578755468,0
3,1388,38002,3578755468,3578755468,0
3,1388,38003,3578755468,3578755468,0
3,1388,38004,3578755468,3578755468,0
3,1388,38005,3578755468,3578755468,0
3,1388,38006,3578755468,3578755468,0
3,1388,38007,3578755468,3578755468,0
3,1388,38008,3578755468,3578755469,1
3,1388,38009,3578755468,3578755475,7
3,1388,38010,3578755468,3578755481,13
3,1388,38011,3578755468,3578755481,13
3,1388,38012,3578755468,3578755483,15
3,1388,38013,3578755468,3578755484,16
3,1388,38014,3578755468,3578755484,16
3,1388,38015,3578755468,3578755485,17
3,1388,38016,3578755468,3578755485,17
3,1388,38017,3578755468,3578755487,19
3,1388,38018,3578755468,3578755488,20
3,1388,38019,3578755468,3578755490,22
3,1388,38020,3578755468,3578755491,23
3,1388,38021,3578755468,3578755495,27
3,1388,38022,3578755468,3578755495,27
3,1388,38023,3578755468,3578755497,29
3,1388,38024,3578755468,3578755497,29
3,1388,38025,3578755468,3578755497,29
3,1388,38026,3578755468,3578755499,31
3,1388,38027,3578755468,3578755500,32
3,1388,38028,3578755468,3578755500,32
3,1388,38029,3578755468,3578755503,35
3,1388,38030,3578755468,3578755503,35
3,1388,38031,3578755468,3578755506,38
3,1388,38032,3578755468,3578755506,38
3,1388,38033,3578755468,3578755506,38
3,1388,38034,3578755468,3578755506,38
3,1388,38035,3578755468,3578755510,42
3,1388,38036,3578755468,3578755510,42
3,1388,38037,3578755468,3578755511,43
3,1388,38038,3578755468,3578755514,46
3,1388,38039,3578755468,3578755514,46
3,1388,38040,3578755468,3578755516,48
3,1388,38041,3578755468,3578755516,48
3,1388,38042,3578755468,3578755516,48
3,1389,38043,3578755532,3578755532,0
3,1389,38044,3578755532,3578755532,0
3,1389,38045,3578755532,3578755532,0
3,1389,38046,3578755532,3578755532,0
3,1389,38047,3578755532,3578755532,0
3,1389,38048,3578755532,3578755532,0
3,1389,38049,3578755532,3578755532,0
3,1389,38050,3578755532,3578755532,0
3,1389,38051,3578755532,3578755535,3
3,1389,38052,3578755532,3578755535,3
3,1389,38053,3578755532,3578755537,5
3,1389,38054,3578755532,3578755538,6
3,1389,38055,3578755532,3578755541,9
3,1389,38056,3578755532,3578755542,10
3,1389,38057,3578755532,3578755545,13
3,1389,38058,3578755532,3578755548,16
3,1389,38059,3578755532,3578755548,16
3,1389,38060,3578755532,3578755549,17
3,1389,38061,3578755532,3578755551,19
3,1389,38062,3578755532,3578755551,19
3,1389,38063,3578755532,3578755552,20
3,1389,38064,3578755532,3578755555,23
3,1389,38065,3578755532,3578755557,25
3,1389,38066,3578755532,3578755559,27
3,1389,38067,3578755532,3578755561,29
3,1389,38068,3578755532,3578755563,31
3,1389,38069,3578755532,3578755565,33
3,1389,38070,3578755532,3578755565,33
3,1389,38071,3578755532,3578755566,34
3,1389,38072,3578755532,3578755566,34
3,1389,38073,3578755532,3578755567,35
3,1389,38074,3578755532,3578755568,36
3,1389,38075,3578755532,3578755569,37
3,1389,38076,3578755532,3578755569,37
3,1389,38077,3578755532,3578755569,37
3,1389,38078,3578755532,3578755571,39
3,1389,38079,3578755532,3578755572,40
3,1389,38080,3578755532,3578755572,40
3,1389,38081,3578755532,3578755574,42
3,1389,38082,3578755532,3578755575,43
3,1389,38083,3578755532,3578755578,46
3,1390,38084,3578755596,3578755596,0
3,1390,38085,3578755596,3578755596,0
3,1390,38086,3578755596,3578755596,0
3,1390,38087,3578755596,3578755597,1
3,1390,38088,3578755596,3578755597,1
3,1390,38089,3578755596,3578755597,1
3,1390,38090,3578755596,3578755597,1
3,1390,38091,3578755596,3578755597,1
3,1390,38092,3578755596,3578755597,1
3,1390,38093,3578755596,3578755597,1
3,1390,38094,3578755596,3578755597,1
3,1390,38095,3578755596,3578755597,1
3,1390,38096,3578755596,3578755597,1
3,1390,38097,3578755596,3578755597,1
3,1390,38098,3578755596,3578755597,1
3,1390,38099,3578755596,3578755597,1
3,1390,38100,3578755596,3578755597,1
3,1390,38101,3578755596,3578755597,1
3,1390,38102,3578755596,3578755597,1
3,1390,38103,3578755596,3578755597,1
3,1390,38104,3578755596,3578755597,1
3,1390,38105,3578755596,3578755597,1
3,1390,38106,3578755596,3578755599,3
3,1390,38107,3578755596,3578755602,6
3,1390,38108,3578755596,3578755603,7
3,1390,38109,3578755596,3578755603,7
3,1390,38110,3578755596,3578755603,7
3,1390,38111,3578755596,3578755604,8
3,1390,38112,3578755596,3578755606,10
3,1390,38113,3578755596,3578755607,11
3,1390,38114,3578755596,3578755607,11
3,1390,38115,3578755596,3578755607,11
3,1390,38116,3578755596,3578755607,11
3,1390,38117,3578755596,3578755607,11
3,1390,38118,3578755596,3578755610,14
3,1390,38119,3578755596,3578755611,15
3,1390,38120,3578755596,3578755612,16
3,1390,38121,3578755596,3578755612,16
3,1390,38122,3578755596,3578755614,18
3,1390,38123,3578755596,3578755614,18
3,1390,38124,3578755596,3578755615,19
3,1390,38125,3578755596,3578755616,20
3,1390,38126,3578755596,3578755620,24
3,1390,38127,3578755596,3578755622,26
3,1390,38128,3578755596,3578755623,27
3,1390,38129,3578755596,3578755624,28
3,1390,38130,3578755596,3578755624,28
3,1390,38131,3578755596,3578755626,30
3,1390,38132,3578755596,3578755626,30
3,1390,38133,3578755596,3578755626,30
3,1390,38134,3578755596,3578755627,31
3,1390,38135,3578755596,3578755629,33
3,1390,38136,3578755596,3578755630,34
3,1390,38137,3578755596,3578755632,36
3,1390,38138,3578755596,3578755632,36
3,1390,38139,3578755596,3578755632,36
3,1390,38140,3578755596,3578755633,37
3,1390,38141,3578755596,3578755635,39
3,1390,38142,3578755596,3578755636,40
3,1390,38143,3578755596,3578755639,43
3,1390,38144,3578755596,3578755639,43
3,1390,38145,3578755596,3578755639,43
3,1390,38146,3578755596,3578755641,45
3,1390,38147,3578755596,3578755642,46
3,1390,38148,3578755596,3578755643,47
3,1390,38149,3578755596,3578755643,47
3,1390,38150,3578755596,3578755644,48
3,1391,38151,3578755659,3578755659,0
3,1391,38152,3578755659,3578755659,0
3,1391,38153,3578755659,3578755659,0
3,1391,38154,3578755659,3578755659,0
3,1391,38155,3578755659,3578755659,0
3,1391,38156,3578755659,3578755659,0
3,1391,38157,3578755659,3578755659,0
3,1391,38158,3578755659,3578755659,0
3,1391,38159,3578755659,3578755660,1
3,1391,38160,3578755659,3578755663,4
3,1391,38161,3578755659,3578755664,5
3,1391,38162,3578755659,3578755664,5
3,1391,38163,3578755659,3578755669,10
3,1391,38164,3578755659,3578755675,16
3,1391,38165,3578755659,3578755680,21
3,1391,38166,3578755659,3578755681,22
3,1391,38167,3578755659,3578755683,24
3,1391,38168,3578755659,3578755684,25
3,1391,38169,3578755659,3578755684,25
3,1391,38170,3578755659,3578755684,25
3,1391,38171,3578755659,3578755686,27
3,1391,38172,3578755659,3578755687,28
3,1391,38173,3578755659,3578755688,29
3,1391,38174,3578755659,3578755690,31
3,1391,38175,3578755659,3578755690,31
3,1391,38176,3578755659,3578755694,35
3,1391,38177,3578755659,3578755695,36
3,1391,38178,3578755659,3578755697,38
3,1391,38179,3578755659,3578755697,38
3,1391,38180,3578755659,3578755697,38
3,1391,38181,3578755659,3578755699,40
3,1391,38182,3578755659,3578755701,42
3,1391,38183,3578755659,3578755703,44
3,1391,38184,3578755659,3578755703,44
3,1391,38185,3578755659,3578755706,47
3,1391,38186,3578755659,3578755706,47
3,1391,38187,3578755659,3578755706,47
3,1391,38188,3578755659,3578755707,48
3,1392,38189,3578755723,3578755723,0
3,1392,38190,3578755723,3578755723,0
3,1392,38191,3578755723,3578755724,1
3,1392,38192,3578755723,3578755724,1
3,1392,38193,3578755723,3578755724,1
3,1392,38194,3578755723,3578755724,1
3,1392,38195,3578755723,3578755724,1
3,1392,38196,3578755723,3578755724,1
3,1392,38197,3578755723,3578755724,1
3,1392,38198,3578755723,3578755724,1
3,1392,38199,3578755723,3578755724,1
3,1392,38200,3578755723,3578755724,1
3,1392,38201,3578755723,3578755725,2
3,1392,38202,3578755723,3578755730,7
3,1392,38203,3578755723,3578755732,9
3,1392,38204,3578755723,3578755735,12
3,1392,38205,3578755723,3578755735,12
3,1392,38206,3578755723,3578755737,14
3,1392,38207,3578755723,3578755738,15
3,1392,38208,3578755723,3578755741,18
3,1392,38209,3578755723,3578755742,19
3,1392,38210,3578755723,3578755746,23
3,1392,38211,3578755723,3578755748,25
3,1392,38212,3578755723,3578755749,26
3,1392,38213,3578755723,3578755750,27
3,1392,38214,3578755723,3578755751,28
3,1392,38215,3578755723,3578755752,29
3,1392,38216,3578755723,3578755752,29
3,1392,38217,3578755723,3578755756,33
3,1392,38218,3578755723,3578755756,33
3,1392,38219,3578755723,3578755758,35
3,1392,38220,3578755723,3578755758,35
3,1392,38221,3578755723,3578755759,36
3,1392,38222,3578755723,3578755760,37
3,1392,38223,3578755723,3578755763,40
3,1392,38224,3578755723,3578755765,42
3,1392,38225,3578755723,3578755766,43
3,1392,38226,3578755723,3578755767,44
3,1392,38227,3578755723,3578755768,45
3,1392,38228,3578755723,3578755769,46
3,1392,38229,3578755723,3578755769,46
3,1392,38230,3578755723,3578755769,46
3,1392,38231,3578755723,3578755771,48
3,1392,38232,3578755723,3578755772,49
3,1393,38233,3578755785,3578755785,0
3,1393,38234,3578755785,3578755785,0
3,1393,38235,3578755785,3578755785,0
3,1393,38236,3578755785,3578755785,0
3,1393,38237,3578755785,3578755785,0
3,1393,38238,3578755785,3578755785,0
3,1393,38239,3578755785,3578755785,0
3,1393,38240,3578755785,3578755785,0
3,1393,38241,3578755785,3578755785,0
3,1393,38242,3578755785,3578755785,0
3,1393,38243,3578755785,3578755786,1
3,1393,38244,3578755785,3578755786,1
3,1393,38245,3578755785,3578755787,2
3,1393,38246,3578755785,3578755787,2
3,1393,38247,3578755785,3578755787,2
3,1393,38248,3578755785,3578755787,2
3,1393,38249,3578755785,3578755787,2
3,1393,38250,3578755785,3578755788,3
3,1393,38251,3578755785,3578755788,3
3,1393,38252,3578755785,3578755789,4
3,1393,38253,3578755785,3578755790,5
3,1393,38254,3578755785,3578755793,8
3,1393,38255,3578755785,3578755793,8
3,1393,38256,3578755785,3578755793,8
3,1393,38257,3578755785,3578755794,9
3,1393,38258,3578755785,3578755797,12
3,1393,38259,3578755785,3578755799,14
3,1393,38260,3578755785,3578755800,15
3,1393,38261,3578755785,3578755802,17
3,1393,38262,3578755785,3578755803,18
3,1393,38263,3578755785,3578755803,18
3,1393,38264,3578755785,3578755804,19
3,1393,38265,3578755785,3578755805,20
3,1393,38266,3578755785,3578755805,20
3,1393,38267,3578755785,3578755807,22
3,1393,38268,3578755785,3578755807,22
3,1393,38269,3578755785,3578755808,23
3,1393,38270,3578755785,3578755808,23
3,1393,38271,3578755785,3578755808,23
3,1393,38272,3578755785,3578755810,25
3,1393,38273,3578755785,3578755812,27
3,1393,38274,3578755785,3578755812,27
3,1393,38275,3578755785,3578755812,27
3,1393,38276,3578755785,3578755814,29
3,1393,38277,3578755785,3578755814,29
3,1393,38278,3578755785,3578755815,30
3,1393,38279,3578755785,3578755816,31
3,1393,38280,3578755785,3578755820,35
3,1393,38281,3578755785,3578755822,37
3,1393,38282,3578755785,3578755823,38
3,1393,38283,3578755785,3578755824,39
3,1393,38284,3578755785,3578755825,40
3,1393,38285,3578755785,3578755826,41
3,1393,38286,3578755785,3578755827,42
3,1393,38287,3578755785,3578755828,43
3,1393,38288,3578755785,3578755828,43
3,1393,38289,3578755785,3578755830,45
3,1393,38290,3578755785,3578755832,47
3,1393,38291,3578755785,3578755832,47
3,1393,38292,3578755785,3578755832,47
3,1393,38293,3578755785,3578755834,49
3,1394,38294,3578755847,3578755847,0
3,1394,38295,3578755847,3578755847,0
3,1394,38296,3578755847,3578755847,0
3,1394,38297,3578755847,3578755847,0
3,1394,38298,3578755847,3578755847,0
3,1394,38299,3578755847,3578755847,0
3,1394,38300,3578755847,3578755847,0
3,1394,38301,3578755847,3578755847,0
3,1394,38302,3578755847,3578755847,0
3,1394,38303,3578755847,3578755847,0
3,1394,38304,3578755847,3578755847,0
3,1394,38305,3578755847,3578755847,0
3,1394,38306,3578755847,3578755847,0
3,1394,38307,3578755847,3578755848,1
3,1394,38308,3578755847,3578755850,3
3,1394,38309,3578755847,3578755850,3
3,1394,38310,3578755847,3578755850,3
3,1394,38311,3578755847,3578755853,6
3,1394,38312,3578755847,3578755854,7
3,1394,38313,3578755847,3578755855,8
3,1394,38314,3578755847,3578755858,11
3,1394,38315,3578755847,3578755858,11
3,1394,38316,3578755847,3578755861,14
3,1394,38317,3578755847,3578755861,14
3,1394,38318,3578755847,3578755862,15
3,1394,38319,3578755847,3578755863,16
3,1394,38320,3578755847,3578755864,17
3,1394,38321,3578755847,3578755868,21
3,1394,38322,3578755847,3578755875,28
3,1394,38323,3578755847,3578755880,33
3,1394,38324,3578755847,3578755881,34
3,1394,38325,3578755847,3578755883,36
3,1394,38326,3578755847,3578755884,37
3,1394,38327,3578755847,3578755884,37
3,1394,38328,3578755847,3578755886,39
3,1394,38329,3578755847,3578755886,39
3,1394,38330,3578755847,3578755888,41
3,1394,38331,3578755847,3578755890,43
3,1394,38332,3578755847,3578755891,44
3,1394,38333,3578755847,3578755894,47
3,1394,38334,3578755847,3578755896,49
3,1394,38335,3578755847,3578755897,50
3,1394,38336,3578755847,3578755897,50
3,1395,38337,3578755908,3578755908,0
3,1395,38338,3578755908,3578755908,0
3,1395,38339,3578755908,3578755908,0
3,1395,38340,3578755908,3578755908,0
3,1395,38341,3578755908,3578755908,0
3,1395,38342,3578755908,3578755908,0
3,1395,38343,3578755908,3578755908,0
3,1395,38344,3578755908,3578755908,0
3,1395,38345,3578755908,3578755909,1
3,1395,38346,3578755908,3578755909,1
3,1395,38347,3578755908,3578755909,1
3,1395,38348,3578755908,3578755910,2
3,1395,38349,3578755908,3578755912,4
3,1395,38350,3578755908,3578755914,6
3,1395,38351,3578755908,3578755914,6
3,1395,38352,3578755908,3578755915,7
3,1395,38353,3578755908,3578755915,7
3,1395,38354,3578755908,3578755916,8
3,1395,38355,3578755908,3578755916,8
3,1395,38356,3578755908,3578755920,12
3,1395,38357,3578755908,3578755921,13
3,1395,38358,3578755908,3578755921,13
3,1395,38359,3578755908,3578755923,15
3,1395,38360,3578755908,3578755923,15
3,1395,38361,3578755908,3578755925,17
3,1395,38362,3578755908,3578755931,23
3,1395,38363,3578755908,3578755932,24
3,1395,38364,3578755908,3578755934,26
3,1395,38365,3578755908,3578755935,27
3,1395,38366,3578755908,3578755936,28
3,1395,38367,3578755908,3578755939,31
3,1395,38368,3578755908,3578755939,31
3,1395,38369,3578755908,3578755940,32
3,1395,38370,3578755908,3578755943,35
3,1395,38371,3578755908,3578755946,38
3,1395,38372,3578755908,3578755948,40
3,1395,38373,3578755908,3578755949,41
3,1395,38374,3578755908,3578755949,41
3,1395,38375,3578755908,3578755951,43
3,1395,38376,3578755908,3578755952,44
3,1395,38377,3578755908,3578755952,44
3,1395,38378,3578755908,3578755953,45
3,1395,38379,3578755908,3578755956,48
3,1395,38380,3578755908,3578755956,48
3,1395,38381,3578755908,3578755958,50
3,1396,38382,3578755971,3578755971,0
3,1396,38383,3578755971,3578755971,0
3,1396,38384,3578755971,3578755971,0
3,1396,38385,3578755971,3578755971,0
3,1396,38386,3578755971,3578755971,0
3,1396,38387,3578755971,3578755971,0
3,1396,38388,3578755971,3578755971,0
3,1396,38389,3578755971,3578755971,0
3,1396,38390,3578755971,3578755971,0
3,1396,38391,3578755971,3578755971,0
3,1396,38392,3578755971,3578755971,0
3,1396,38393,3578755971,3578755972,1
3,1396,38394,3578755971,3578755974,3
3,1396,38395,3578755971,3578755975,4
3,1396,38396,3578755971,3578755975,4
3,1396,38397,3578755971,3578755984,13
3,1396,38398,3578755971,3578755984,13
3,1396,38399,3578755971,3578755985,14
3,1396,38400,3578755971,3578755986,15
3,1396,38401,3578755971,3578755986,15
3,1396,38402,3578755971,3578755986,15
3,1396,38403,3578755971,3578755987,16
3,1396,38404,3578755971,3578755987,16
3,1396,38405,3578755971,3578755987,16
3,1396,38406,3578755971,3578755987,16
3,1396,38407,3578755971,3578755988,17
3,1396,38408,3578755971,3578755988,17
3,1396,38409,3578755971,3578755988,17
3,1396,38410,3578755971,3578755988,17
3,1396,38411,3578755971,3578755990,19
3,1396,38412,3578755971,3578755991,20
3,1396,38413,3578755971,3578755993,22
3,1396,38414,3578755971,3578755993,22
3,1396,38415,3578755971,3578755993,22
3,1396,38416,3578755971,3578755994,23
3,1396,38417,3578755971,3578755998,27
3,1396,38418,3578755971,3578755999,28
3,1396,38419,3578755971,3578756000,29
3,1396,38420,3578755971,3578756002,31
3,1396,38421,3578755971,3578756003,32
3,1396,38422,3578755971,3578756003,32
3,1396,38423,3578755971,3578756005,34
3,1396,38424,3578755971,3578756005,34
3,1396,38425,3578755971,3578756006,35
3,1396,38426,3578755971,3578756007,36
3,1396,38427,3578755971,3578756008,37
3,1396,38428,3578755971,3578756008,37
3,1396,38429,3578755971,3578756008,37
3,1396,38430,3578755971,3578756008,37
3,1396,38431,3578755971,3578756009,38
3,1396,38432,3578755971,3578756011,40
3,1396,38433,3578755971,3578756012,41
3,1396,38434,3578755971,3578756013,42
3,1396,38435,3578755971,3578756013,42
3,1396,38436,3578755971,3578756015,44
3,1396,38437,3578755971,3578756016,45
3,1396,38438,3578755971,3578756016,45
3,1396,38439,3578755971,3578756021,50
3,1397,38440,3578756035,3578756035,0
3,1397,38441,3578756035,3578756035,0
3,1397,38442,3578756035,3578756035,0
3,1397,38443,3578756035,3578756035,0
3,1397,38444,3578756035,3578756035,0
3,1397,38445,3578756035,3578756035,0
3,1397,38446,3578756035,3578756035,0
3,1397,38447,3578756035,3578756035,0
3,1397,38448,3578756035,3578756035,0
3,1397,38449,3578756035,3578756035,0
3,1397,38450,3578756035,3578756035,0
3,1397,38451,3578756035,3578756035,0
3,1397,38452,3578756035,3578756035,0
3,1397,38453,3578756035,3578756036,1
3,1397,38454,3578756035,3578756036,1
3,1397,38455,3578756035,3578756038,3
3,1397,38456,3578756035,3578756039,4
3,1397,38457,3578756035,3578756040,5
3,1397,38458,3578756035,3578756041,6
3,1397,38459,3578756035,3578756043,8
3,1397,38460,3578756035,3578756043,8
3,1397,38461,3578756035,3578756044,9
3,1397,38462,3578756035,3578756045,10
3,1397,38463,3578756035,3578756045,10
3,1397,38464,3578756035,3578756048,13
3,1397,38465,3578756035,3578756048,13
3,1397,38466,3578756035,3578756050,15
3,1397,38467,3578756035,3578756050,15
3,1397,38468,3578756035,3578756051,16
3,1397,38469,3578756035,3578756054,19
3,1397,38470,3578756035,3578756054,19
3,1397,38471,3578756035,3578756055,20
3,1397,38472,3578756035,3578756058,23
3,1397,38473,3578756035,3578756058,23
3,1397,38474,3578756035,3578756061,26
3,1397,38475,3578756035,3578756062,27
3,1397,38476,3578756035,3578756064,29
3,1397,38477,3578756035,3578756064,29
3,1397,38478,3578756035,3578756064,29
3,1397,38479,3578756035,3578756069,34
3,1397,38480,3578756035,3578756075,40
3,1397,38481,3578756035,3578756080,45
3,1397,38482,3578756035,3578756081,46
3,1397,38483,3578756035,3578756083,48
3,1397,38484,3578756035,3578756084,49
3,1397,38485,3578756035,3578756084,49
3,1398,38486,3578756100,3578756100,0
3,1398,38487,3578756100,3578756100,0
3,1398,38488,3578756100,3578756100,0
3,1398,38489,3578756100,3578756100,0
3,1398,38490,3578756100,3578756100,0
3,1398,38491,3578756100,3578756100,0
3,1398,38492,3578756100,3578756100,0
3,1398,38493,3578756100,3578756100,0
3,1398,38494,3578756100,3578756100,0
3,1398,38495,3578756100,3578756100,0
3,1398,38496,3578756100,3578756100,0
3,1398,38497,3578756100,3578756100,0
3,1398,38498,3578756100,3578756101,1
3,1398,38499,3578756100,3578756102,2
3,1398,38500,3578756100,3578756103,3
3,1398,38501,3578756100,3578756104,4
3,1398,38502,3578756100,3578756106,6
3,1398,38503,3578756100,3578756107,7
3,1398,38504,3578756100,3578756107,7
3,1398,38505,3578756100,3578756110,10
3,1398,38506,3578756100,3578756112,12
3,1398,38507,3578756100,3578756114,14
3,1398,38508,3578756100,3578756114,14
3,1398,38509,3578756100,3578756115,15
3,1398,38510,3578756100,3578756115,15
3,1398,38511,3578756100,3578756116,16
3,1398,38512,3578756100,3578756116,16
3,1398,38513,3578756100,3578756120,20
3,1398,38514,3578756100,3578756120,20
3,1398,38515,3578756100,3578756122,22
3,1398,38516,3578756100,3578756122,22
3,1398,38517,3578756100,3578756123,23
3,1398,38518,3578756100,3578756126,26
3,1398,38519,3578756100,3578756132,32
3,1398,38520,3578756100,3578756133,33
3,1398,38521,3578756100,3578756134,34
3,1398,38522,3578756100,3578756136,36
3,1398,38523,3578756100,3578756137,37
3,1398,38524,3578756100,3578756138,38
3,1398,38525,3578756100,3578756139,39
3,1398,38526,3578756100,3578756140,40
3,1398,38527,3578756100,3578756143,43
3,1398,38528,3578756100,3578756146,46
3,1398,38529,3578756100,3578756148,48
3,1398,38530,3578756100,3578756148,48
3,1399,38531,3578756163,3578756163,0
3,1399,38532,3578756163,3578756163,0
3,1399,38533,3578756163,3578756163,0
3,1399,38534,3578756163,3578756163,0
3,1399,38535,3578756163,3578756163,0
3,1399,38536,3578756163,3578756163,0
3,1399,38537,3578756163,3578756163,0
3,1399,38538,3578756163,3578756163,0
3,1399,38539,3578756163,3578756164,1
3,1399,38540,3578756163,3578756165,2
3,1399,38541,3578756163,3578756165,2
3,1399,38542,3578756163,3578756167,4
3,1399,38543,3578756163,3578756167,4
3,1399,38544,3578756163,3578756167,4
3,1399,38545,3578756163,3578756168,5
3,1399,38546,3578756163,3578756168,5
3,1399,38547,3578756163,3578756169,6
3,1399,38548,3578756163,3578756169,6
3,1399,38549,3578756163,3578756171,8
3,1399,38550,3578756163,3578756173,10
3,1399,38551,3578756163,3578756173,10
3,1399,38552,3578756163,3578756176,13
3,1399,38553,3578756163,3578756176,13
3,1399,38554,3578756163,3578756183,20
3,1399,38555,3578756163,3578756183,20
3,1399,38556,3578756163,3578756184,21
3,1399,38557,3578756163,3578756184,21
3,1399,38558,3578756163,3578756185,22
3,1399,38559,3578756163,3578756186,23
3,1399,38560,3578756163,3578756186,23
3,1399,38561,3578756163,3578756187,24
3,1399,38562,3578756163,3578756187,24
3,1399,38563,3578756163,3578756188,25
3,1399,38564,3578756163,3578756188,25
3,1399,38565,3578756163,3578756188,25
3,1399,38566,3578756163,3578756189,26
3,1399,38567,3578756163,3578756189,26
3,1399,38568,3578756163,3578756189,26
3,1399,38569,3578756163,3578756191,28
3,1399,38570,3578756163,3578756191,28
3,1399,38571,3578756163,3578756194,31
3,1399,38572,3578756163,3578756194,31
3,1399,38573,3578756163,3578756195,32
3,1399,38574,3578756163,3578756197,34
3,1399,38575,3578756163,3578756199,36
3,1399,38576,3578756163,3578756201,38
3,1399,38577,3578756163,3578756203,40
3,1399,38578,3578756163,3578756203,40
3,1399,38579,3578756163,3578756203,40
3,1399,38580,3578756163,3578756205,42
3,1399,38581,3578756163,3578756205,42
3,1399,38582,3578756163,3578756206,43
3,1399,38583,3578756163,3578756207,44
3,1399,38584,3578756163,3578756207,44
3,1399,38585,3578756163,3578756208,45
3,1399,38586,3578756163,3578756208,45
3,1399,38587,3578756163,3578756208,45
3,1399,38588,3578756163,3578756209,46
3,1399,38589,3578756163,3578756211,48
3,1399,38590,3578756163,3578756212,49
3,1400,38591,3578756226,3578756226,0
3,1400,38592,3578756226,3578756226,0
3,1400,38593,3578756226,3578756226,0
3,1400,38594,3578756226,3578756226,0
3,1400,38595,3578756226,3578756226,0
3,1400,38596,3578756226,3578756226,0
3,1400,38597,3578756226,3578756226,0
3,1400,38598,3578756226,3578756226,0
3,1400,38599,3578756226,3578756226,0
3,1400,38600,3578756226,3578756226,0
3,1400,38601,3578756226,3578756226,0
3,1400,38602,3578756226,3578756227,1
3,1400,38603,3578756226,3578756227,1
3,1400,38604,3578756226,3578756228,2
3,1400,38605,3578756226,3578756228,2
3,1400,38606,3578756226,3578756229,3
3,1400,38607,3578756226,3578756230,4
3,1400,38608,3578756226,3578756232,6
3,1400,38609,3578756226,3578756232,6
3,1400,38610,3578756226,3578756234,8
3,1400,38611,3578756226,3578756236,10
3,1400,38612,3578756226,3578756236,10
3,1400,38613,3578756226,3578756238,12
3,1400,38614,3578756226,3578756239,13
3,1400,38615,3578756226,3578756240,14
3,1400,38616,3578756226,3578756241,15
3,1400,38617,3578756226,3578756243,17
3,1400,38618,3578756226,3578756243,17
3,1400,38619,3578756226,3578756243,17
3,1400,38620,3578756226,3578756244,18
3,1400,38621,3578756226,3578756245,19
3,1400,38622,3578756226,3578756246,20
3,1400,38623,3578756226,3578756247,21
3,1400,38624,3578756226,3578756248,22
3,1400,38625,3578756226,3578756250,24
3,1400,38626,3578756226,3578756251,25
3,1400,38627,3578756226,3578756253,27
3,1400,38628,3578756226,3578756254,28
3,1400,38629,3578756226,3578756256,30
3,1400,38630,3578756226,3578756257,31
3,1400,38631,3578756226,3578756258,32
3,1400,38632,3578756226,3578756258,32
3,1400,38633,3578756226,3578756261,35
3,1400,38634,3578756226,3578756262,36
3,1400,38635,3578756226,3578756264,38
3,1400,38636,3578756226,3578756264,38
3,1400,38637,3578756226,3578756265,39
3,1400,38638,3578756226,3578756269,43
3,1400,38639,3578756226,3578756275,49
3,1401,38640,3578756289,3578756289,0
3,1401,38641,3578756289,3578756289,0
3,1401,38642,3578756289,3578756289,0
3,1401,38643,3578756289,3578756289,0
3,1401,38644,3578756289,3578756289,0
3,1401,38645,3578756289,3578756289,0
3,1401,38646,3578756289,3578756289,0
3,1401,38647,3578756289,3578756289,0
3,1401,38648,3578756289,3578756289,0
3,1401,38649,3578756289,3578756291,2
3,1401,38650,3578756289,3578756294,5
3,1401,38651,3578756289,3578756296,7
3,1401,38652,3578756289,3578756297,8
3,1401,38653,3578756289,3578756298,9
3,1401,38654,3578756289,3578756298,9
3,1401,38655,3578756289,3578756299,10
3,1401,38656,3578756289,3578756300,11
3,1401,38657,3578756289,3578756301,12
3,1401,38658,3578756289,3578756302,13
3,1401,38659,3578756289,3578756303,14
3,1401,38660,3578756289,3578756306,17
3,1401,38661,3578756289,3578756307,18
3,1401,38662,3578756289,3578756308,19
3,1401,38663,3578756289,3578756311,22
3,1401,38664,3578756289,3578756311,22
3,1401,38665,3578756289,3578756312,23
3,1401,38666,3578756289,3578756314,25
3,1401,38667,3578756289,3578756315,26
3,1401,38668,3578756289,3578756315,26
3,1401,38669,3578756289,3578756316,27
3,1401,38670,3578756289,3578756316,27
3,1401,38671,3578756289,3578756316,27
3,1401,38672,3578756289,3578756320,31
3,1401,38673,3578756289,3578756320,31
3,1401,38674,3578756289,3578756322,33
3,1401,38675,3578756289,3578756322,33
3,1401,38676,3578756289,3578756324,35
3,1401,38677,3578756289,3578756326,37
3,1401,38678,3578756289,3578756331,42
3,1401,38679,3578756289,3578756332,43
3,1401,38680,3578756289,3578756335,46
3,1401,38681,3578756289,3578756336,47
3,1401,38682,3578756289,3578756337,48
3,1402,38683,3578756350,3578756350,0
3,1402,38684,3578756350,3578756350,0
3,1402,38685,3578756350,3578756350,0
3,1402,38686,3578756350,3578756350,0
3,1402,38687,3578756350,3578756350,0
3,1402,38688,3578756350,3578756350,0
3,1402,38689,3578756350,3578756351,1
3,1402,38690,3578756350,3578756352,2
3,1402,38691,3578756350,3578756352,2
3,1402,38692,3578756350,3578756353,3
3,1402,38693,3578756350,3578756354,4
3,1402,38694,3578756350,3578756357,7
3,1402,38695,3578756350,3578756359,9
3,1402,38696,3578756350,3578756360,10
3,1402,38697,3578756350,3578756360,10
3,1402,38698,3578756350,3578756363,13
3,1402,38699,3578756350,3578756365,15
3,1402,38700,3578756350,3578756365,15
3,1402,38701,3578756350,3578756366,16
3,1402,38702,3578756350,3578756367,17
3,1402,38703,3578756350,3578756367,17
3,1402,38704,3578756350,3578756367,17
3,1402,38705,3578756350,3578756368,18
3,1402,38706,3578756350,3578756369,19
3,1402,38707,3578756350,3578756369,19
3,1402,38708,3578756350,3578756371,21
3,1402,38709,3578756350,3578756373,23
3,1402,38710,3578756350,3578756374,24
3,1402,38711,3578756350,3578756374,24
3,1402,38712,3578756350,3578756376,26
3,1402,38713,3578756350,3578756376,26
3,1402,38714,3578756350,3578756382,32
3,1402,38715,3578756350,3578756383,33
3,1402,38716,3578756350,3578756383,33
3,1402,38717,3578756350,3578756384,34
3,1402,38718,3578756350,3578756385,35
3,1402,38719,3578756350,3578756386,36
3,1402,38720,3578756350,3578756387,37
3,1402,38721,3578756350,3578756387,37
3,1402,38722,3578756350,3578756387,37
3,1402,38723,3578756350,3578756388,38
3,1402,38724,3578756350,3578756388,38
3,1402,38725,3578756350,3578756388,38
3,1402,38726,3578756350,3578756389,39
3,1402,38727,3578756350,3578756389,39
3,1402,38728,3578756350,3578756391,41
3,1402,38729,3578756350,3578756391,41
3,1402,38730,3578756350,3578756394,44
3,1402,38731,3578756350,3578756394,44
3,1402,38732,3578756350,3578756395,45
3,1402,38733,3578756350,3578756398,48
3,1402,38734,3578756350,3578756399,49
3,1403,38735,3578756413,3578756413,0
3,1403,38736,3578756413,3578756413,0
3,1403,38737,3578756413,3578756413,0
3,1403,38738,3578756413,3578756413,0
3,1403,38739,3578756413,3578756413,0
3,1403,38740,3578756413,3578756413,0
3,1403,38741,3578756413,3578756413,0
3,1403,38742,3578756413,3578756413,0
3,1403,38743,3578756413,3578756413,0
3,1403,38744,3578756413,3578756413,0
3,1403,38745,3578756413,3578756413,0
3,1403,38746,3578756413,3578756413,0
3,1403,38747,3578756413,3578756413,0
3,1403,38748,3578756413,3578756413,0
3,1403,38749,3578756413,3578756413,0
3,1403,38750,3578756413,3578756413,0
3,1403,38751,3578756413,3578756414,1
3,1403,38752,3578756413,3578756415,2
3,1403,38753,3578756413,3578756416,3
3,1403,38754,3578756413,3578756421,8
3,1403,38755,3578756413,3578756422,9
3,1403,38756,3578756413,3578756422,9
3,1403,38757,3578756413,3578756424,11
3,1403,38758,3578756413,3578756425,12
3,1403,38759,3578756413,3578756426,13
3,1403,38760,3578756413,3578756426,13
3,1403,38761,3578756413,3578756427,14
3,1403,38762,3578756413,3578756427,14
3,1403,38763,3578756413,3578756428,15
3,1403,38764,3578756413,3578756430,17
3,1403,38765,3578756413,3578756432,19
3,1403,38766,3578756413,3578756432,19
3,1403,38767,3578756413,3578756433,20
3,1403,38768,3578756413,3578756434,21
3,1403,38769,3578756413,3578756436,23
3,1403,38770,3578756413,3578756436,23
3,1403,38771,3578756413,3578756438,25
3,1403,38772,3578756413,3578756440,27
3,1403,38773,3578756413,3578756440,27
3,1403,38774,3578756413,3578756441,28
3,1403,38775,3578756413,3578756443,30
3,1403,38776,3578756413,3578756443,30
3,1403,38777,3578756413,3578756443,30
3,1403,38778,3578756413,3578756444,31
3,1403,38779,3578756413,3578756445,32
3,1403,38780,3578756413,3578756446,33
3,1403,38781,3578756413,3578756448,35
3,1403,38782,3578756413,3578756448,35
3,1403,38783,3578756413,3578756450,37
3,1403,38784,3578756413,3578756451,38
3,1403,38785,3578756413,3578756454,41
3,1403,38786,3578756413,3578756454,41
3,1403,38787,3578756413,3578756456,43
3,1403,38788,3578756413,3578756457,44
3,1403,38789,3578756413,3578756459,46
3,1403,38790,3578756413,3578756459,46
3,1403,38791,3578756413,3578756461,48
3,1403,38792,3578756413,3578756462,49
3,1404,38793,3578756475,3578756475,0
3,1404,38794,3578756475,3578756475,0
3,1404,38795,3578756475,3578756476,1
3,1404,38796,3578756475,3578756476,1
3,1404,38797,3578756475,3578756476,1
3,1404,38798,3578756475,3578756481,6
3,1404,38799,3578756475,3578756481,6
3,1404,38800,3578756475,3578756482,7
3,1404,38801,3578756475,3578756484,9
3,1404,38802,3578756475,3578756485,10
3,1404,38803,3578756475,3578756485,10
3,1404,38804,3578756475,3578756486,11
3,1404,38805,3578756475,3578756488,13
3,1404,38806,3578756475,3578756490,15
3,1404,38807,3578756475,3578756491,16
3,1404,38808,3578756475,3578756494,19
3,1404,38809,3578756475,3578756496,21
3,1404,38810,3578756475,3578756497,22
3,1404,38811,3578756475,3578756498,23
3,1404,38812,3578756475,3578756498,23
3,1404,38813,3578756475,3578756499,24
3,1404,38814,3578756475,3578756499,24
3,1404,38815,3578756475,3578756501,26
3,1404,38816,3578756475,3578756502,27
3,1404,38817,3578756475,3578756502,27
3,1404,38818,3578756475,3578756506,31
3,1404,38819,3578756475,3578756507,32
3,1404,38820,3578756475,3578756508,33
3,1404,38821,3578756475,3578756511,36
3,1404,38822,3578756475,3578756512,37
3,1404,38823,3578756475,3578756512,37
3,1404,38824,3578756475,3578756514,39
3,1404,38825,3578756475,3578756515,40
3,1404,38826,3578756475,3578756515,40
3,1404,38827,3578756475,3578756516,41
3,1404,38828,3578756475,3578756516,41
3,1404,38829,3578756475,3578756520,45
3,1404,38830,3578756475,3578756521,46
3,1404,38831,3578756475,3578756522,47
3,1404,38832,3578756475,3578756522,47
3,1404,38833,3578756475,3578756523,48
3,1404,38834,3578756475,3578756523,48
3,1405,38835,3578756539,3578756539,0
3,1405,38836,3578756539,3578756539,0
3,1405,38837,3578756539,3578756539,0
3,1405,38838,3578756539,3578756539,0
3,1405,38839,3578756539,3578756539,0
3,1405,38840,3578756539,3578756539,0
3,1405,38841,3578756539,3578756539,0
3,1405,38842,3578756539,3578756539,0
3,1405,38843,3578756539,3578756542,3
3,1405,38844,3578756539,3578756545,6
3,1405,38845,3578756539,3578756548,9
3,1405,38846,3578756539,3578756550,11
3,1405,38847,3578756539,3578756551,12
3,1405,38848,3578756539,3578756554,15
3,1405,38849,3578756539,3578756556,17
3,1405,38850,3578756539,3578756558,19
3,1405,38851,3578756539,3578756558,19
3,1405,38852,3578756539,3578756559,20
3,1405,38853,3578756539,3578756559,20
3,1405,38854,3578756539,3578756562,23
3,1405,38855,3578756539,3578756564,25
3,1405,38856,3578756539,3578756565,26
3,1405,38857,3578756539,3578756566,27
3,1405,38858,3578756539,3578756567,28
3,1405,38859,3578756539,3578756568,29
3,1405,38860,3578756539,3578756569,30
3,1405,38861,3578756539,3578756569,30
3,1405,38862,3578756539,3578756569,30
3,1405,38863,3578756539,3578756569,30
3,1405,38864,3578756539,3578756570,31
3,1405,38865,3578756539,3578756572,33
3,1405,38866,3578756539,3578756573,34
3,1405,38867,3578756539,3578756573,34
3,1405,38868,3578756539,3578756576,37
3,1405,38869,3578756539,3578756578,39
3,1405,38870,3578756539,3578756582,43
3,1405,38871,3578756539,3578756582,43
3,1405,38872,3578756539,3578756583,44
3,1405,38873,3578756539,3578756584,45
3,1405,38874,3578756539,3578756584,45
3,1405,38875,3578756539,3578756585,46
3,1405,38876,3578756539,3578756586,47
3,1405,38877,3578756539,3578756587,48
3,1405,38878,3578756539,3578756587,48
3,1405,38879,3578756539,3578756587,48
3,1405,38880,3578756539,3578756588,49
3,1405,38881,3578756539,3578756588,49
3,1405,38882,3578756539,3578756589,50
3,1406,38883,3578756601,3578756601,0
3,1406,38884,3578756601,3578756601,0
3,1406,38885,3578756601,3578756601,0
3,1406,38886,3578756601,3578756601,0
3,1406,38887,3578756601,3578756601,0
3,1406,38888,3578756601,3578756601,0
3,1406,38889,3578756601,3578756601,0
3,1406,38890,3578756601,3578756601,0
3,1406,38891,3578756601,3578756602,1
3,1406,38892,3578756601,3578756603,2
3,1406,38893,3578756601,3578756604,3
3,1406,38894,3578756601,3578756605,4
3,1406,38895,3578756601,3578756605,4
3,1406,38896,3578756601,3578756607,6
3,1406,38897,3578756601,3578756607,6
3,1406,38898,3578756601,3578756607,6
3,1406,38899,3578756601,3578756607,6
3,1406,38900,3578756601,3578756608,7
3,1406,38901,3578756601,3578756608,7
3,1406,38902,3578756601,3578756610,9
3,1406,38903,3578756601,3578756611,10
3,1406,38904,3578756601,3578756611,10
3,1406,38905,3578756601,3578756613,12
3,1406,38906,3578756601,3578756613,12
3,1406,38907,3578756601,3578756615,14
3,1406,38908,3578756601,3578756620,19
3,1406,38909,3578756601,3578756621,20
3,1406,38910,3578756601,3578756622,21
3,1406,38911,3578756601,3578756623,22
3,1406,38912,3578756601,3578756623,22
3,1406,38913,3578756601,3578756625,24
3,1406,38914,3578756601,3578756625,24
3,1406,38915,3578756601,3578756625,24
3,1406,38916,3578756601,3578756626,25
3,1406,38917,3578756601,3578756627,26
3,1406,38918,3578756601,3578756627,26
3,1406,38919,3578756601,3578756629,28
3,1406,38920,3578756601,3578756631,30
3,1406,38921,3578756601,3578756632,31
3,1406,38922,3578756601,3578756632,31
3,1406,38923,3578756601,3578756634,33
3,1406,38924,3578756601,3578756635,34
3,1406,38925,3578756601,3578756635,34
3,1406,38926,3578756601,3578756638,37
3,1406,38927,3578756601,3578756639,38
3,1406,38928,3578756601,3578756642,41
3,1406,38929,3578756601,3578756643,42
3,1406,38930,3578756601,3578756643,42
3,1406,38931,3578756601,3578756643,42
3,1406,38932,3578756601,3578756643,42
3,1406,38933,3578756601,3578756644,43
3,1406,38934,3578756601,3578756645,44
3,1406,38935,3578756601,3578756647,46
3,1406,38936,3578756601,3578756649,48
3,1406,38937,3578756601,3578756650,49
3,1407,38938,3578756663,3578756663,0
3,1407,38939,3578756663,3578756663,0
3,1407,38940,3578756663,3578756663,0
3,1407,38941,3578756663,3578756663,0
3,1407,38942,3578756663,3578756663,0
3,1407,38943,3578756663,3578756663,0
3,1407,38944,3578756663,3578756663,0
3,1407,38945,3578756663,3578756663,0
3,1407,38946,3578756663,3578756663,0
3,1407,38947,3578756663,3578756663,0
3,1407,38948,3578756663,3578756670,7
3,1407,38949,3578756663,3578756675,12
3,1407,38950,3578756663,3578756681,18
3,1407,38951,3578756663,3578756681,18
3,1407,38952,3578756663,3578756683,20
3,1407,38953,3578756663,3578756684,21
3,1407,38954,3578756663,3578756684,21
3,1407,38955,3578756663,3578756685,22
3,1407,38956,3578756663,3578756686,23
3,1407,38957,3578756663,3578756689,26
3,1407,38958,3578756663,3578756689,26
3,1407,38959,3578756663,3578756691,28
3,1407,38960,3578756663,3578756694,31
3,1407,38961,3578756663,3578756696,33
3,1407,38962,3578756663,3578756697,34
3,1407,38963,3578756663,3578756698,35
3,1407,38964,3578756663,3578756699,36
3,1407,38965,3578756663,3578756699,36
3,1407,38966,3578756663,3578756700,37
3,1407,38967,3578756663,3578756701,38
3,1407,38968,3578756663,3578756702,39
3,1407,38969,3578756663,3578756703,40
3,1407,38970,3578756663,3578756705,42
3,1407,38971,3578756663,3578756706,43
3,1407,38972,3578756663,3578756706,43
3,1407,38973,3578756663,3578756707,44
3,1407,38974,3578756663,3578756708,45
3,1407,38975,3578756663,3578756711,48
3,1407,38976,3578756663,3578756712,49
3,1408,38977,3578756726,3578756726,0
3,1408,38978,3578756726,3578756726,0
3,1408,38979,3578756726,3578756726,0
3,1408,38980,3578756726,3578756726,0
3,1408,38981,3578756726,3578756726,0
3,1408,38982,3578756726,3578756726,0
3,1408,38983,3578756726,3578756726,0
3,1408,38984,3578756726,3578756726,0
3,1408,38985,3578756726,3578756726,0
3,1408,38986,3578756726,3578756726,0
3,1408,38987,3578756726,3578756731,5
3,1408,38988,3578756726,3578756731,5
3,1408,38989,3578756726,3578756733,7
3,1408,38990,3578756726,3578756737,11
3,1408,38991,3578756726,3578756738,12
3,1408,38992,3578756726,3578756739,13
3,1408,38993,3578756726,3578756742,16
3,1408,38994,3578756726,3578756744,18
3,1408,38995,3578756726,3578756748,22
3,1408,38996,3578756726,3578756748,22
3,1408,38997,3578756726,3578756749,23
3,1408,38998,3578756726,3578756751,25
3,1408,38999,3578756726,3578756752,26
3,1408,39000,3578756726,3578756754,28
3,1408,39001,3578756726,3578756757,31
3,1408,39002,3578756726,3578756757,31
3,1408,39003,3578756726,3578756758,32
3,1408,39004,3578756726,3578756759,33
3,1408,39005,3578756726,3578756760,34
3,1408,39006,3578756726,3578756762,36
3,1408,39007,3578756726,3578756764,38
3,1408,39008,3578756726,3578756766,40
3,1408,39009,3578756726,3578756766,40
3,1408,39010,3578756726,3578756766,40
3,1408,39011,3578756726,3578756767,41
3,1408,39012,3578756726,3578756768,42
3,1408,39013,3578756726,3578756769,43
3,1408,39014,3578756726,3578756769,43
3,1408,39015,3578756726,3578756769,43
3,1408,39016,3578756726,3578756770,44
3,1408,39017,3578756726,3578756771,45
3,1408,39018,3578756726,3578756771,45
3,1408,39019,3578756726,3578756773,47
3,1408,39020,3578756726,3578756773,47
3,1408,39021,3578756726,3578756775,49
3,1408,39022,3578756726,3578756776,50
3,1409,39023,3578756790,3578756790,0
3,1409,39024,3578756790,3578756790,0
3,1409,39025,3578756790,3578756790,0
3,1409,39026,3578756790,3578756790,0
3,1409,39027,3578756790,3578756790,0
3,1409,39028,3578756790,3578756790,0
3,1409,39029,3578756790,3578756790,0
3,1409,39030,3578756790,3578756790,0
3,1409,39031,3578756790,3578756790,0
3,1409,39032,3578756790,3578756790,0
3,1409,39033,3578756790,3578756790,0
3,1409,39034,3578756790,3578756790,0
3,1409,39035,3578756790,3578756790,0
3,1409,39036,3578756790,3578756790,0
3,1409,39037,3578756790,3578756790,0
3,1409,39038,3578756790,3578756790,0
3,1409,39039,3578756790,3578756790,0
3,1409,39040,3578756790,3578756790,0
3,1409,39041,3578756790,3578756792,2
3,1409,39042,3578756790,3578756794,4
3,1409,39043,3578756790,3578756794,4
3,1409,39044,3578756790,3578756794,4
3,1409,39045,3578756790,3578756796,6
3,1409,39046,3578756790,3578756799,9
3,1409,39047,3578756790,3578756800,10
3,1409,39048,3578756790,3578756802,12
3,1409,39049,3578756790,3578756803,13
3,1409,39050,3578756790,3578756804,14
3,1409,39051,3578756790,3578756805,15
3,1409,39052,3578756790,3578756805,15
3,1409,39053,3578756790,3578756806,16
3,1409,39054,3578756790,3578756807,17
3,1409,39055,3578756790,3578756807,17
3,1409,39056,3578756790,3578756808,18
3,1409,39057,3578756790,3578756809,19
3,1409,39058,3578756790,3578756811,21
3,1409,39059,3578756790,3578756811,21
3,1409,39060,3578756790,3578756811,21
3,1409,39061,3578756790,3578756812,22
3,1409,39062,3578756790,3578756813,23
3,1409,39063,3578756790,3578756814,24
3,1409,39064,3578756790,3578756815,25
3,1409,39065,3578756790,3578756819,29
3,1409,39066,3578756790,3578756821,31
3,1409,39067,3578756790,3578756821,31
3,1409,39068,3578756790,3578756823,33
3,1409,39069,3578756790,3578756824,34
3,1409,39070,3578756790,3578756825,35
3,1409,39071,3578756790,3578756826,36
3,1409,39072,3578756790,3578756826,36
3,1409,39073,3578756790,3578756826,36
3,1409,39074,3578756790,3578756827,37
3,1409,39075,3578756790,3578756827,37
3,1409,39076,3578756790,3578756830,40
3,1409,39077,3578756790,3578756831,41
3,1409,39078,3578756790,3578756832,42
3,1409,39079,3578756790,3578756832,42
3,1409,39080,3578756790,3578756835,45
3,1409,39081,3578756790,3578756835,45
3,1409,39082,3578756790,3578756838,48
3,1410,39083,3578756853,3578756853,0
3,1410,39084,3578756853,3578756853,0
3,1410,39085,3578756853,3578756853,0
3,1410,39086,3578756853,3578756853,0
3,1410,39087,3578756853,3578756853,0
3,1410,39088,3578756853,3578756853,0
3,1410,39089,3578756853,3578756853,0
3,1410,39090,3578756853,3578756853,0
3,1410,39091,3578756853,3578756853,0
3,1410,39092,3578756853,3578756853,0
3,1410,39093,3578756853,3578756853,0
3,1410,39094,3578756853,3578756853,0
3,1410,39095,3578756853,3578756853,0
3,1410,39096,3578756853,3578756853,0
3,1410,39097,3578756853,3578756856,3
3,1410,39098,3578756853,3578756857,4
3,1410,39099,3578756853,3578756858,5
3,1410,39100,3578756853,3578756861,8
3,1410,39101,3578756853,3578756862,9
3,1410,39102,3578756853,3578756863,10
3,1410,39103,3578756853,3578756864,11
3,1410,39104,3578756853,3578756870,17
3,1410,39105,3578756853,3578756881,28
3,1410,39106,3578756853,3578756882,29
3,1410,39107,3578756853,3578756884,31
3,1410,39108,3578756853,3578756884,31
3,1410,39109,3578756853,3578756885,32
3,1410,39110,3578756853,3578756885,32
3,1410,39111,3578756853,3578756890,37
3,1410,39112,3578756853,3578756891,38
3,1410,39113,3578756853,3578756895,42
3,1410,39114,3578756853,3578756897,44
3,1410,39115,3578756853,3578756899,46
3,1410,39116,3578756853,3578756899,46
3,1410,39117,3578756853,3578756900,47
3,1410,39118,3578756853,3578756902,49
3,1410,39119,3578756853,3578756903,50
3,1411,39120,3578756916,3578756916,0
3,1411,39121,3578756916,3578756916,0
3,1411,39122,3578756916,3578756916,0
3,1411,39123,3578756916,3578756916,0
3,1411,39124,3578756916,3578756916,0
3,1411,39125,3578756916,3578756916,0
3,1411,39126,3578756916,3578756916,0
3,1411,39127,3578756916,3578756916,0
3,1411,39128,3578756916,3578756916,0
3,1411,39129,3578756916,3578756916,0
3,1411,39130,3578756916,3578756916,0
3,1411,39131,3578756916,3578756916,0
3,1411,39132,3578756916,3578756916,0
3,1411,39133,3578756916,3578756916,0
3,1411,39134,3578756916,3578756920,4
3,1411,39135,3578756916,3578756920,4
3,1411,39136,3578756916,3578756921,5
3,1411,39137,3578756916,3578756922,6
3,1411,39138,3578756916,3578756923,7
3,1411,39139,3578756916,3578756924,8
3,1411,39140,3578756916,3578756931,15
3,1411,39141,3578756916,3578756931,15
3,1411,39142,3578756916,3578756933,17
3,1411,39143,3578756916,3578756935,19
3,1411,39144,3578756916,3578756936,20
3,1411,39145,3578756916,3578756938,22
3,1411,39146,3578756916,3578756939,23
3,1411,39147,3578756916,3578756940,24
3,1411,39148,3578756916,3578756943,27
3,1411,39149,3578756916,3578756948,32
3,1411,39150,3578756916,3578756948,32
3,1411,39151,3578756916,3578756949,33
3,1411,39152,3578756916,3578756950,34
3,1411,39153,3578756916,3578756952,36
3,1411,39154,3578756916,3578756954,38
3,1411,39155,3578756916,3578756955,39
3,1411,39156,3578756916,3578756957,41
3,1411,39157,3578756916,3578756957,41
3,1411,39158,3578756916,3578756958,42
3,1411,39159,3578756916,3578756959,43
3,1411,39160,3578756916,3578756960,44
3,1411,39161,3578756916,3578756964,48
3,1411,39162,3578756916,3578756964,48
3,1411,39163,3578756916,3578756965,49
3,1411,39164,3578756916,3578756965,49
3,1411,39165,3578756916,3578756966,50
3,1412,39166,3578756979,3578756979,0
3,1412,39167,3578756979,3578756979,0
3,1412,39168,3578756979,3578756979,0
3,1412,39169,3578756979,3578756979,0
3,1412,39170,3578756979,3578756979,0
3,1412,39171,3578756979,3578756979,0
3,1412,39172,3578756979,3578756979,0
3,1412,39173,3578756979,3578756979,0
3,1412,39174,3578756979,3578756979,0
3,1412,39175,3578756979,3578756979,0
3,1412,39176,3578756979,3578756979,0
3,1412,39177,3578756979,3578756979,0
3,1412,39178,3578756979,3578756980,1
3,1412,39179,3578756979,3578756982,3
3,1412,39180,3578756979,3578756983,4
3,1412,39181,3578756979,3578756984,5
3,1412,39182,3578756979,3578756984,5
3,1412,39183,3578756979,3578756985,6
3,1412,39184,3578756979,3578756985,6
3,1412,39185,3578756979,3578756986,7
3,1412,39186,3578756979,3578756986,7
3,1412,39187,3578756979,3578756987,8
3,1412,39188,3578756979,3578756987,8
3,1412,39189,3578756979,3578756988,9
3,1412,39190,3578756979,3578756988,9
3,1412,39191,3578756979,3578756988,9
3,1412,39192,3578756979,3578756988,9
3,1412,39193,3578756979,3578756989,10
3,1412,39194,3578756979,3578756990,11
3,1412,39195,3578756979,3578756991,12
3,1412,39196,3578756979,3578756993,14
3,1412,39197,3578756979,3578756994,15
3,1412,39198,3578756979,3578756994,15
3,1412,39199,3578756979,3578756994,15
3,1412,39200,3578756979,3578756999,20
3,1412,39201,3578756979,3578757001,22
3,1412,39202,3578756979,3578757002,23
3,1412,39203,3578756979,3578757002,23
3,1412,39204,3578756979,3578757003,24
3,1412,39205,3578756979,3578757004,25
3,1412,39206,3578756979,3578757005,26
3,1412,39207,3578756979,3578757005,26
3,1412,39208,3578756979,3578757007,28
3,1412,39209,3578756979,3578757007,28
3,1412,39210,3578756979,3578757007,28
3,1412,39211,3578756979,3578757008,29
3,1412,39212,3578756979,3578757009,30
3,1412,39213,3578756979,3578757009,30
3,1412,39214,3578756979,3578757010,31
3,1412,39215,3578756979,3578757012,33
3,1412,39216,3578756979,3578757012,33
3,1412,39217,3578756979,3578757013,34
3,1412,39218,3578756979,3578757014,35
3,1412,39219,3578756979,3578757015,36
3,1412,39220,3578756979,3578757015,36
3,1412,39221,3578756979,3578757016,37
3,1412,39222,3578756979,3578757020,41
3,1412,39223,3578756979,3578757021,42
3,1412,39224,3578756979,3578757022,43
3,1412,39225,3578756979,3578757023,44
3,1412,39226,3578756979,3578757025,46
3,1412,39227,3578756979,3578757026,47
3,1412,39228,3578756979,3578757026,47
3,1412,39229,3578756979,3578757027,48
3,1412,39230,3578756979,3578757027,48
3,1412,39231,3578756979,3578757027,48
3,1412,39232,3578756979,3578757027,48
3,1412,39233,3578756979,3578757027,48
3,1413,39234,3578757043,3578757043,0
3,1413,39235,3578757043,3578757043,0
3,1413,39236,3578757043,3578757043,0
3,1413,39237,3578757043,3578757043,0
3,1413,39238,3578757043,3578757043,0
3,1413,39239,3578757043,3578757043,0
3,1413,39240,3578757043,3578757043,0
3,1413,39241,3578757043,3578757043,0
3,1413,39242,3578757043,3578757043,0
3,1413,39243,3578757043,3578757043,0
3,1413,39244,3578757043,3578757043,0
3,1413,39245,3578757043,3578757043,0
3,1413,39246,3578757043,3578757043,0
3,1413,39247,3578757043,3578757043,0
3,1413,39248,3578757043,3578757043,0
3,1413,39249,3578757043,3578757043,0
3,1413,39250,3578757043,3578757045,2
3,1413,39251,3578757043,3578757045,2
3,1413,39252,3578757043,3578757048,5
3,1413,39253,3578757043,3578757051,8
3,1413,39254,3578757043,3578757052,9
3,1413,39255,3578757043,3578757053,10
3,1413,39256,3578757043,3578757053,10
3,1413,39257,3578757043,3578757056,13
3,1413,39258,3578757043,3578757058,15
3,1413,39259,3578757043,3578757058,15
3,1413,39260,3578757043,3578757063,20
3,1413,39261,3578757043,3578757064,21
3,1413,39262,3578757043,3578757070,27
3,1413,39263,3578757043,3578757075,32
3,1413,39264,3578757043,3578757081,38
3,1413,39265,3578757043,3578757081,38
3,1413,39266,3578757043,3578757084,41
3,1413,39267,3578757043,3578757084,41
3,1413,39268,3578757043,3578757085,42
3,1413,39269,3578757043,3578757086,43
3,1413,39270,3578757043,3578757089,46
3,1413,39271,3578757043,3578757091,48
3,1414,39272,3578757104,3578757104,0
3,1414,39273,3578757104,3578757104,0
3,1414,39274,3578757104,3578757104,0
3,1414,39275,3578757104,3578757104,0
3,1414,39276,3578757104,3578757104,0
3,1414,39277,3578757104,3578757104,0
3,1414,39278,3578757104,3578757104,0
3,1414,39279,3578757104,3578757104,0
3,1414,39280,3578757104,3578757106,2
3,1414,39281,3578757104,3578757107,3
3,1414,39282,3578757104,3578757107,3
3,1414,39283,3578757104,3578757107,3
3,1414,39284,3578757104,3578757108,4
3,1414,39285,3578757104,3578757111,7
3,1414,39286,3578757104,3578757112,8
3,1414,39287,3578757104,3578757114,10
3,1414,39288,3578757104,3578757114,10
3,1414,39289,3578757104,3578757114,10
3,1414,39290,3578757104,3578757116,12
3,1414,39291,3578757104,3578757117,13
3,1414,39292,3578757104,3578757117,13
3,1414,39293,3578757104,3578757121,17
3,1414,39294,3578757104,3578757121,17
3,1414,39295,3578757104,3578757122,18
3,1414,39296,3578757104,3578757122,18
3,1414,39297,3578757104,3578757131,27
3,1414,39298,3578757104,3578757132,28
3,1414,39299,3578757104,3578757136,32
3,1414,39300,3578757104,3578757137,33
3,1414,39301,3578757104,3578757139,35
3,1414,39302,3578757104,3578757139,35
3,1414,39303,3578757104,3578757141,37
3,1414,39304,3578757104,3578757148,44
3,1414,39305,3578757104,3578757148,44
3,1414,39306,3578757104,3578757150,46
3,1414,39307,3578757104,3578757150,46
3,1414,39308,3578757104,3578757151,47
3,1414,39309,3578757104,3578757152,48
3,1414,39310,3578757104,3578757152,48
3,1415,39311,3578757168,3578757168,0
3,1415,39312,3578757168,3578757168,0
3,1415,39313,3578757168,3578757168,0
3,1415,39314,3578757168,3578757168,0
3,1415,39315,3578757168,3578757168,0
3,1415,39316,3578757168,3578757168,0
3,1415,39317,3578757168,3578757168,0
3,1415,39318,3578757168,3578757168,0
3,1415,39319,3578757168,3578757168,0
3,1415,39320,3578757168,3578757168,0
3,1415,39321,3578757168,3578757168,0
3,1415,39322,3578757168,3578757168,0
3,1415,39323,3578757168,3578757168,0
3,1415,39324,3578757168,3578757168,0
3,1415,39325,3578757168,3578757169,1
3,1415,39326,3578757168,3578757170,2
3,1415,39327,3578757168,3578757173,5
3,1415,39328,3578757168,3578757173,5
3,1415,39329,3578757168,3578757174,6
3,1415,39330,3578757168,3578757175,7
3,1415,39331,3578757168,3578757176,8
3,1415,39332,3578757168,3578757179,11
3,1415,39333,3578757168,3578757183,15
3,1415,39334,3578757168,3578757184,16
3,1415,39335,3578757168,3578757184,16
3,1415,39336,3578757168,3578757184,16
3,1415,39337,3578757168,3578757185,17
3,1415,39338,3578757168,3578757186,18
3,1415,39339,3578757168,3578757186,18
3,1415,39340,3578757168,3578757187,19
3,1415,39341,3578757168,3578757187,19
3,1415,39342,3578757168,3578757188,20
3,1415,39343,3578757168,3578757188,20
3,1415,39344,3578757168,3578757188,20
3,1415,39345,3578757168,3578757189,21
3,1415,39346,3578757168,3578757189,21
3,1415,39347,3578757168,3578757191,23
3,1415,39348,3578757168,3578757191,23
3,1415,39349,3578757168,3578757193,25
3,1415,39350,3578757168,3578757194,26
3,1415,39351,3578757168,3578757194,26
3,1415,39352,3578757168,3578757197,29
3,1415,39353,3578757168,3578757199,31
3,1415,39354,3578757168,3578757202,34
3,1415,39355,3578757168,3578757203,35
3,1415,39356,3578757168,3578757203,35
3,1415,39357,3578757168,3578757204,36
3,1415,39358,3578757168,3578757204,36
3,1415,39359,3578757168,3578757205,37
3,1415,39360,3578757168,3578757205,37
3,1415,39361,3578757168,3578757207,39
3,1415,39362,3578757168,3578757208,40
3,1415,39363,3578757168,3578757208,40
3,1415,39364,3578757168,3578757208,40
3,1415,39365,3578757168,3578757208,40
3,1415,39366,3578757168,3578757209,41
3,1415,39367,3578757168,3578757212,44
3,1415,39368,3578757168,3578757212,44
3,1415,39369,3578757168,3578757212,44
3,1415,39370,3578757168,3578757214,46
3,1415,39371,3578757168,3578757215,47
3,1415,39372,3578757168,3578757216,48
3,1416,39373,3578757231,3578757231,0
3,1416,39374,3578757231,3578757231,0
3,1416,39375,3578757231,3578757231,0
3,1416,39376,3578757231,3578757231,0
3,1416,39377,3578757231,3578757231,0
3,1416,39378,3578757231,3578757231,0
3,1416,39379,3578757231,3578757231,0
3,1416,39380,3578757231,3578757231,0
3,1416,39381,3578757231,3578757231,0
3,1416,39382,3578757231,3578757231,0
3,1416,39383,3578757231,3578757231,0
3,1416,39384,3578757231,3578757231,0
3,1416,39385,3578757231,3578757231,0
3,1416,39386,3578757231,3578757231,0
3,1416,39387,3578757231,3578757232,1
3,1416,39388,3578757231,3578757232,1
3,1416,39389,3578757231,3578757233,2
3,1416,39390,3578757231,3578757235,4
3,1416,39391,3578757231,3578757236,5
3,1416,39392,3578757231,3578757238,7
3,1416,39393,3578757231,3578757240,9
3,1416,39394,3578757231,3578757241,10
3,1416,39395,3578757231,3578757243,12
3,1416,39396,3578757231,3578757243,12
3,1416,39397,3578757231,3578757244,13
3,1416,39398,3578757231,3578757244,13
3,1416,39399,3578757231,3578757245,14
3,1416,39400,3578757231,3578757245,14
3,1416,39401,3578757231,3578757245,14
3,1416,39402,3578757231,3578757245,14
3,1416,39403,3578757231,3578757247,16
3,1416,39404,3578757231,3578757248,17
3,1416,39405,3578757231,3578757250,19
3,1416,39406,3578757231,3578757252,21
3,1416,39407,3578757231,3578757253,22
3,1416,39408,3578757231,3578757254,23
3,1416,39409,3578757231,3578757256,25
3,1416,39410,3578757231,3578757256,25
3,1416,39411,3578757231,3578757258,27
3,1416,39412,3578757231,3578757258,27
3,1416,39413,3578757231,3578757262,31
3,1416,39414,3578757231,3578757264,33
3,1416,39415,3578757231,3578757264,33
3,1416,39416,3578757231,3578757269,38
3,1416,39417,3578757231,3578757275,44
3,1416,39418,3578757231,3578757281,50
3,1417,39419,3578757294,3578757294,0
3,1417,39420,3578757294,3578757294,0
3,1417,39421,3578757294,3578757294,0
3,1417,39422,3578757294,3578757294,0
3,1417,39423,3578757294,3578757294,0
3,1417,39424,3578757294,3578757294,0
3,1417,39425,3578757294,3578757294,0
3,1417,39426,3578757294,3578757294,0
3,1417,39427,3578757294,3578757296,2
3,1417,39428,3578757294,3578757298,4
3,1417,39429,3578757294,3578757298,4
3,1417,39430,3578757294,3578757299,5
3,1417,39431,3578757294,3578757301,7
3,1417,39432,3578757294,3578757301,7
3,1417,39433,3578757294,3578757302,8
3,1417,39434,3578757294,3578757306,12
3,1417,39435,3578757294,3578757307,13
3,1417,39436,3578757294,3578757307,13
3,1417,39437,3578757294,3578757307,13
3,1417,39438,3578757294,3578757307,13
3,1417,39439,3578757294,3578757311,17
3,1417,39440,3578757294,3578757312,18
3,1417,39441,3578757294,3578757312,18
3,1417,39442,3578757294,3578757314,20
3,1417,39443,3578757294,3578757315,21
3,1417,39444,3578757294,3578757315,21
3,1417,39445,3578757294,3578757316,22
3,1417,39446,3578757294,3578757316,22
3,1417,39447,3578757294,3578757317,23
3,1417,39448,3578757294,3578757320,26
3,1417,39449,3578757294,3578757321,27
3,1417,39450,3578757294,3578757322,28
3,1417,39451,3578757294,3578757322,28
3,1417,39452,3578757294,3578757323,29
3,1417,39453,3578757294,3578757326,32
3,1417,39454,3578757294,3578757331,37
3,1417,39455,3578757294,3578757332,38
3,1417,39456,3578757294,3578757336,42
3,1417,39457,3578757294,3578757336,42
3,1417,39458,3578757294,3578757338,44
3,1417,39459,3578757294,3578757339,45
3,1417,39460,3578757294,3578757341,47
3,1418,39461,3578757357,3578757357,0
3,1418,39462,3578757357,3578757357,0
3,1418,39463,3578757357,3578757357,0
3,1418,39464,3578757357,3578757357,0
3,1418,39465,3578757357,3578757357,0
3,1418,39466,3578757357,3578757357,0
3,1418,39467,3578757357,3578757357,0
3,1418,39468,3578757357,3578757357,0
3,1418,39469,3578757357,3578757357,0
3,1418,39470,3578757357,3578757357,0
3,1418,39471,3578757357,3578757358,1
3,1418,39472,3578757357,3578757359,2
3,1418,39473,3578757357,3578757360,3
3,1418,39474,3578757357,3578757363,6
3,1418,39475,3578757357,3578757366,9
3,1418,39476,3578757357,3578757366,9
3,1418,39477,3578757357,3578757367,10
3,1418,39478,3578757357,3578757368,11
3,1418,39479,3578757357,3578757368,11
3,1418,39480,3578757357,3578757368,11
3,1418,39481,3578757357,3578757369,12
3,1418,39482,3578757357,3578757371,14
3,1418,39483,3578757357,3578757373,16
3,1418,39484,3578757357,3578757374,17
3,1418,39485,3578757357,3578757374,17
3,1418,39486,3578757357,3578757376,19
3,1418,39487,3578757357,3578757376,19
3,1418,39488,3578757357,3578757380,23
3,1418,39489,3578757357,3578757383,26
3,1418,39490,3578757357,3578757383,26
3,1418,39491,3578757357,3578757384,27
3,1418,39492,3578757357,3578757384,27
3,1418,39493,3578757357,3578757385,28
3,1418,39494,3578757357,3578757385,28
3,1418,39495,3578757357,3578757386,29
3,1418,39496,3578757357,3578757387,30
3,1418,39497,3578757357,3578757387,30
3,1418,39498,3578757357,3578757387,30
3,1418,39499,3578757357,3578757388,31
3,1418,39500,3578757357,3578757388,31
3,1418,39501,3578757357,3578757388,31
3,1418,39502,3578757357,3578757388,31
3,1418,39503,3578757357,3578757389,32
3,1418,39504,3578757357,3578757391,34
3,1418,39505,3578757357,3578757391,34
3,1418,39506,3578757357,3578757394,37
3,1418,39507,3578757357,3578757394,37
3,1418,39508,3578757357,3578757396,39
3,1418,39509,3578757357,3578757397,40
3,1418,39510,3578757357,3578757399,42
3,1418,39511,3578757357,3578757401,44
3,1418,39512,3578757357,3578757403,46
3,1418,39513,3578757357,3578757404,47
3,1418,39514,3578757357,3578757404,47
3,1418,39515,3578757357,3578757405,48
3,1418,39516,3578757357,3578757405,48
3,1418,39517,3578757357,3578757407,50
3,1419,39518,3578757422,3578757422,0
3,1419,39519,3578757422,3578757422,0
3,1419,39520,3578757422,3578757422,0
3,1419,39521,3578757422,3578757422,0
3,1419,39522,3578757422,3578757422,0
3,1419,39523,3578757422,3578757422,0
3,1419,39524,3578757422,3578757422,0
3,1419,39525,3578757422,3578757422,0
3,1419,39526,3578757422,3578757422,0
3,1419,39527,3578757422,3578757422,0
3,1419,39528,3578757422,3578757422,0
3,1419,39529,3578757422,3578757422,0
3,1419,39530,3578757422,3578757422,0
3,1419,39531,3578757422,3578757422,0
3,1419,39532,3578757422,3578757422,0
3,1419,39533,3578757422,3578757424,2
3,1419,39534,3578757422,3578757424,2
3,1419,39535,3578757422,3578757425,3
3,1419,39536,3578757422,3578757426,4
3,1419,39537,3578757422,3578757427,5
3,1419,39538,3578757422,3578757427,5
3,1419,39539,3578757422,3578757427,5
3,1419,39540,3578757422,3578757429,7
3,1419,39541,3578757422,3578757431,9
3,1419,39542,3578757422,3578757433,11
3,1419,39543,3578757422,3578757433,11
3,1419,39544,3578757422,3578757433,11
3,1419,39545,3578757422,3578757436,14
3,1419,39546,3578757422,3578757437,15
3,1419,39547,3578757422,3578757438,16
3,1419,39548,3578757422,3578757440,18
3,1419,39549,3578757422,3578757443,21
3,1419,39550,3578757422,3578757443,21
3,1419,39551,3578757422,3578757444,22
3,1419,39552,3578757422,3578757444,22
3,1419,39553,3578757422,3578757444,22
3,1419,39554,3578757422,3578757445,23
3,1419,39555,3578757422,3578757445,23
3,1419,39556,3578757422,3578757446,24
3,1419,39557,3578757422,3578757447,25
3,1419,39558,3578757422,3578757448,26
3,1419,39559,3578757422,3578757450,28
3,1419,39560,3578757422,3578757450,28
3,1419,39561,3578757422,3578757451,29
3,1419,39562,3578757422,3578757453,31
3,1419,39563,3578757422,3578757454,32
3,1419,39564,3578757422,3578757457,35
3,1419,39565,3578757422,3578757457,35
3,1419,39566,3578757422,3578757458,36
3,1419,39567,3578757422,3578757463,41
3,1419,39568,3578757422,3578757464,42
3,1419,39569,3578757422,3578757464,42
3,1419,39570,3578757422,3578757470,48
3,1420,39571,3578757487,3578757487,0
3,1420,39572,3578757487,3578757487,0
3,1420,39573,3578757487,3578757487,0
3,1420,39574,3578757487,3578757487,0
3,1420,39575,3578757487,3578757487,0
3,1420,39576,3578757487,3578757487,0
3,1420,39577,3578757487,3578757487,0
3,1420,39578,3578757487,3578757487,0
3,1420,39579,3578757487,3578757489,2
3,1420,39580,3578757487,3578757490,3
3,1420,39581,3578757487,3578757490,3
3,1420,39582,3578757487,3578757494,7
3,1420,39583,3578757487,3578757498,11
3,1420,39584,3578757487,3578757500,13
3,1420,39585,3578757487,3578757501,14
3,1420,39586,3578757487,3578757501,14
3,1420,39587,3578757487,3578757506,19
3,1420,39588,3578757487,3578757506,19
3,1420,39589,3578757487,3578757506,19
3,1420,39590,3578757487,3578757506,19
3,1420,39591,3578757487,3578757507,20
3,1420,39592,3578757487,3578757510,23
3,1420,39593,3578757487,3578757511,24
3,1420,39594,3578757487,3578757511,24
3,1420,39595,3578757487,3578757513,26
3,1420,39596,3578757487,3578757513,26
3,1420,39597,3578757487,3578757514,27
3,1420,39598,3578757487,3578757515,28
3,1420,39599,3578757487,3578757515,28
3,1420,39600,3578757487,3578757516,29
3,1420,39601,3578757487,3578757519,32
3,1420,39602,3578757487,3578757519,32
3,1420,39603,3578757487,3578757521,34
3,1420,39604,3578757487,3578757522,35
3,1420,39605,3578757487,3578757522,35
3,1420,39606,3578757487,3578757524,37
3,1420,39607,3578757487,3578757530,43
3,1420,39608,3578757487,3578757535,48
3,1421,39609,3578757551,3578757551,0
3,1421,39610,3578757551,3578757551,0
3,1421,39611,3578757551,3578757551,0
3,1421,39612,3578757551,3578757551,0
3,1421,39613,3578757551,3578757551,0
3,1421,39614,3578757551,3578757551,0
3,1421,39615,3578757551,3578757551,0
3,1421,39616,3578757551,3578757551,0
3,1421,39617,3578757551,3578757551,0
3,1421,39618,3578757551,3578757551,0
3,1421,39619,3578757551,3578757552,1
3,1421,39620,3578757551,3578757554,3
3,1421,39621,3578757551,3578757555,4
3,1421,39622,3578757551,3578757557,6
3,1421,39623,3578757551,3578757557,6
3,1421,39624,3578757551,3578757558,7
3,1421,39625,3578757551,3578757559,8
3,1421,39626,3578757551,3578757559,8
3,1421,39627,3578757551,3578757562,11
3,1421,39628,3578757551,3578757565,14
3,1421,39629,3578757551,3578757566,15
3,1421,39630,3578757551,3578757567,16
3,1421,39631,3578757551,3578757568,17
3,1421,39632,3578757551,3578757568,17
3,1421,39633,3578757551,3578757569,18
3,1421,39634,3578757551,3578757569,18
3,1421,39635,3578757551,3578757570,19
3,1421,39636,3578757551,3578757572,21
3,1421,39637,3578757551,3578757572,21
3,1421,39638,3578757551,3578757573,22
3,1421,39639,3578757551,3578757575,24
3,1421,39640,3578757551,3578757575,24
3,1421,39641,3578757551,3578757579,28
3,1421,39642,3578757551,3578757582,31
3,1421,39643,3578757551,3578757582,31
3,1421,39644,3578757551,3578757583,32
3,1421,39645,3578757551,3578757583,32
3,1421,39646,3578757551,3578757585,34
3,1421,39647,3578757551,3578757585,34
3,1421,39648,3578757551,3578757585,34
3,1421,39649,3578757551,3578757586,35
3,1421,39650,3578757551,3578757587,36
3,1421,39651,3578757551,3578757587,36
3,1421,39652,3578757551,3578757587,36
3,1421,39653,3578757551,3578757587,36
3,1421,39654,3578757551,3578757587,36
3,1421,39655,3578757551,3578757588,37
3,1421,39656,3578757551,3578757588,37
3,1421,39657,3578757551,3578757590,39
3,1421,39658,3578757551,3578757593,42
3,1421,39659,3578757551,3578757593,42
3,1421,39660,3578757551,3578757595,44
3,1421,39661,3578757551,3578757596,45
3,1421,39662,3578757551,3578757599,48
3,1421,39663,3578757551,3578757601,50
3,1422,39664,3578757616,3578757616,0
3,1422,39665,3578757616,3578757616,0
3,1422,39666,3578757616,3578757616,0
3,1422,39667,3578757616,3578757616,0
3,1422,39668,3578757616,3578757616,0
3,1422,39669,3578757616,3578757616,0
3,1422,39670,3578757616,3578757616,0
3,1422,39671,3578757616,3578757616,0
3,1422,39672,3578757616,3578757616,0
3,1422,39673,3578757616,3578757616,0
3,1422,39674,3578757616,3578757616,0
3,1422,39675,3578757616,3578757616,0
3,1422,39676,3578757616,3578757616,0
3,1422,39677,3578757616,3578757616,0
3,1422,39678,3578757616,3578757616,0
3,1422,39679,3578757616,3578757616,0
3,1422,39680,3578757616,3578757616,0
3,1422,39681,3578757616,3578757616,0
3,1422,39682,3578757616,3578757620,4
3,1422,39683,3578757616,3578757620,4
3,1422,39684,3578757616,3578757622,6
3,1422,39685,3578757616,3578757623,7
3,1422,39686,3578757616,3578757624,8
3,1422,39687,3578757616,3578757626,10
3,1422,39688,3578757616,3578757626,10
3,1422,39689,3578757616,3578757626,10
3,1422,39690,3578757616,3578757629,13
3,1422,39691,3578757616,3578757630,14
3,1422,39692,3578757616,3578757631,15
3,1422,39693,3578757616,3578757632,16
3,1422,39694,3578757616,3578757634,18
3,1422,39695,3578757616,3578757635,19
3,1422,39696,3578757616,3578757635,19
3,1422,39697,3578757616,3578757638,22
3,1422,39698,3578757616,3578757639,23
3,1422,39699,3578757616,3578757642,26
3,1422,39700,3578757616,3578757643,27
3,1422,39701,3578757616,3578757643,27
3,1422,39702,3578757616,3578757643,27
3,1422,39703,3578757616,3578757644,28
3,1422,39704,3578757616,3578757645,29
3,1422,39705,3578757616,3578757645,29
3,1422,39706,3578757616,3578757647,31
3,1422,39707,3578757616,3578757647,31
3,1422,39708,3578757616,3578757649,33
3,1422,39709,3578757616,3578757649,33
3,1422,39710,3578757616,3578757651,35
3,1422,39711,3578757616,3578757653,37
3,1422,39712,3578757616,3578757654,38
3,1422,39713,3578757616,3578757656,40
3,1422,39714,3578757616,3578757658,42
3,1422,39715,3578757616,3578757660,44
3,1422,39716,3578757616,3578757662,46
3,1422,39717,3578757616,3578757663,47
3,1423,39718,3578757679,3578757679,0
3,1423,39719,3578757679,3578757679,0
3,1423,39720,3578757679,3578757680,1
3,1423,39721,3578757679,3578757680,1
3,1423,39722,3578757679,3578757682,3
3,1423,39723,3578757679,3578757683,4
3,1423,39724,3578757679,3578757684,5
3,1423,39725,3578757679,3578757684,5
3,1423,39726,3578757679,3578757686,7
3,1423,39727,3578757679,3578757689,10
3,1423,39728,3578757679,3578757690,11
3,1423,39729,3578757679,3578757694,15
3,1423,39730,3578757679,3578757696,17
3,1423,39731,3578757679,3578757698,19
3,1423,39732,3578757679,3578757699,20
3,1423,39733,3578757679,3578757702,23
3,1423,39734,3578757679,3578757702,23
3,1423,39735,3578757679,3578757702,23
3,1423,39736,3578757679,3578757706,27
3,1423,39737,3578757679,3578757706,27
3,1423,39738,3578757679,3578757707,28
3,1423,39739,3578757679,3578757707,28
3,1423,39740,3578757679,3578757707,28
3,1423,39741,3578757679,3578757710,31
3,1423,39742,3578757679,3578757711,32
3,1423,39743,3578757679,3578757711,32
3,1423,39744,3578757679,3578757713,34
3,1423,39745,3578757679,3578757714,35
3,1423,39746,3578757679,3578757715,36
3,1423,39747,3578757679,3578757715,36
3,1423,39748,3578757679,3578757716,37
3,1423,39749,3578757679,3578757719,40
3,1423,39750,3578757679,3578757720,41
3,1423,39751,3578757679,3578757721,42
3,1423,39752,3578757679,3578757722,43
3,1423,39753,3578757679,3578757723,44
3,1423,39754,3578757679,3578757723,44
3,1423,39755,3578757679,3578757725,46
3,1424,39756,3578757743,3578757743,0
3,1424,39757,3578757743,3578757743,0
3,1424,39758,3578757743,3578757743,0
3,1424,39759,3578757743,3578757743,0
3,1424,39760,3578757743,3578757743,0
3,1424,39761,3578757743,3578757743,0
3,1424,39762,3578757743,3578757743,0
3,1424,39763,3578757743,3578757745,2
3,1424,39764,3578757743,3578757748,5
3,1424,39765,3578757743,3578757748,5
3,1424,39766,3578757743,3578757749,6
3,1424,39767,3578757743,3578757750,7
3,1424,39768,3578757743,3578757752,9
3,1424,39769,3578757743,3578757752,9
3,1424,39770,3578757743,3578757754,11
3,1424,39771,3578757743,3578757756,13
3,1424,39772,3578757743,3578757757,14
3,1424,39773,3578757743,3578757757,14
3,1424,39774,3578757743,3578757758,15
3,1424,39775,3578757743,3578757759,16
3,1424,39776,3578757743,3578757760,17
3,1424,39777,3578757743,3578757762,19
3,1424,39778,3578757743,3578757765,22
3,1424,39779,3578757743,3578757765,22
3,1424,39780,3578757743,3578757766,23
3,1424,39781,3578757743,3578757767,24
3,1424,39782,3578757743,3578757768,25
3,1424,39783,3578757743,3578757768,25
3,1424,39784,3578757743,3578757768,25
3,1424,39785,3578757743,3578757769,26
3,1424,39786,3578757743,3578757769,26
3,1424,39787,3578757743,3578757771,28
3,1424,39788,3578757743,3578757771,28
3,1424,39789,3578757743,3578757773,30
3,1424,39790,3578757743,3578757774,31
3,1424,39791,3578757743,3578757775,32
3,1424,39792,3578757743,3578757775,32
3,1424,39793,3578757743,3578757779,36
3,1424,39794,3578757743,3578757782,39
3,1424,39795,3578757743,3578757783,40
3,1424,39796,3578757743,3578757783,40
3,1424,39797,3578757743,3578757785,42
3,1424,39798,3578757743,3578757785,42
3,1424,39799,3578757743,3578757785,42
3,1424,39800,3578757743,3578757787,44
3,1424,39801,3578757743,3578757787,44
3,1424,39802,3578757743,3578757787,44
3,1424,39803,3578757743,3578757788,45
3,1424,39804,3578757743,3578757790,47
3,1424,39805,3578757743,3578757790,47
3,1425,39806,3578757805,3578757805,0
3,1425,39807,3578757805,3578757805,0
3,1425,39808,3578757805,3578757805,0
3,1425,39809,3578757805,3578757805,0
3,1425,39810,3578757805,3578757805,0
3,1425,39811,3578757805,3578757805,0
3,1425,39812,3578757805,3578757805,0
3,1425,39813,3578757805,3578757805,0
3,1425,39814,3578757805,3578757805,0
3,1425,39815,3578757805,3578757805,0
3,1425,39816,3578757805,3578757805,0
3,1425,39817,3578757805,3578757807,2
3,1425,39818,3578757805,3578757808,3
3,1425,39819,3578757805,3578757808,3
3,1425,39820,3578757805,3578757809,4
3,1425,39821,3578757805,3578757810,5
3,1425,39822,3578757805,3578757812,7
3,1425,39823,3578757805,3578757813,8
3,1425,39824,3578757805,3578757813,8
3,1425,39825,3578757805,3578757813,8
3,1425,39826,3578757805,3578757813,8
3,1425,39827,3578757805,3578757816,11
3,1425,39828,3578757805,3578757819,14
3,1425,39829,3578757805,3578757820,15
3,1425,39830,3578757805,3578757821,16
3,1425,39831,3578757805,3578757824,19
3,1425,39832,3578757805,3578757824,19
3,1425,39833,3578757805,3578757825,20
3,1425,39834,3578757805,3578757826,21
3,1425,39835,3578757805,3578757826,21
3,1425,39836,3578757805,3578757826,21
3,1425,39837,3578757805,3578757827,22
3,1425,39838,3578757805,3578757828,23
3,1425,39839,3578757805,3578757828,23
3,1425,39840,3578757805,3578757829,24
3,1425,39841,3578757805,3578757830,25
3,1425,39842,3578757805,3578757831,26
3,1425,39843,3578757805,3578757831,26
3,1425,39844,3578757805,3578757832,27
3,1425,39845,3578757805,3578757832,27
3,1425,39846,3578757805,3578757834,29
3,1425,39847,3578757805,3578757836,31
3,1425,39848,3578757805,3578757836,31
3,1425,39849,3578757805,3578757838,33
3,1425,39850,3578757805,3578757839,34
3,1425,39851,3578757805,3578757842,37
3,1425,39852,3578757805,3578757843,38
3,1425,39853,3578757805,3578757843,38
3,1425,39854,3578757805,3578757843,38
3,1425,39855,3578757805,3578757843,38
3,1425,39856,3578757805,3578757845,40
3,1425,39857,3578757805,3578757845,40
3,1425,39858,3578757805,3578757847,42
3,1425,39859,3578757805,3578757849,44
3,1425,39860,3578757805,3578757850,45
3,1425,39861,3578757805,3578757851,46
3,1425,39862,3578757805,3578757853,48
3,1425,39863,3578757805,3578757854,49
3,1426,39864,3578757868,3578757868,0
3,1426,39865,3578757868,3578757868,0
3,1426,39866,3578757868,3578757868,0
3,1426,39867,3578757868,3578757868,0
3,1426,39868,3578757868,3578757868,0
3,1426,39869,3578757868,3578757868,0
3,1426,39870,3578757868,3578757868,0
3,1426,39871,3578757868,3578757875,7
3,1426,39872,3578757868,3578757880,12
3,1426,39873,3578757868,3578757880,12
3,1426,39874,3578757868,3578757882,14
3,1426,39875,3578757868,3578757883,15
3,1426,39876,3578757868,3578757884,16
3,1426,39877,3578757868,3578757884,16
3,1426,39878,3578757868,3578757886,18
3,1426,39879,3578757868,3578757890,22
3,1426,39880,3578757868,3578757890,22
3,1426,39881,3578757868,3578757894,26
3,1426,39882,3578757868,3578757896,28
3,1426,39883,3578757868,3578757896,28
3,1426,39884,3578757868,3578757897,29
3,1426,39885,3578757868,3578757898,30
3,1426,39886,3578757868,3578757900,32
3,1426,39887,3578757868,3578757901,33
3,1426,39888,3578757868,3578757901,33
3,1426,39889,3578757868,3578757902,34
3,1426,39890,3578757868,3578757906,38
3,1426,39891,3578757868,3578757906,38
3,1426,39892,3578757868,3578757906,38
3,1426,39893,3578757868,3578757907,39
3,1426,39894,3578757868,3578757910,42
3,1426,39895,3578757868,3578757911,43
3,1426,39896,3578757868,3578757911,43
3,1426,39897,3578757868,3578757913,45
3,1426,39898,3578757868,3578757913,45
3,1426,39899,3578757868,3578757915,47
3,1426,39900,3578757868,3578757916,48
3,1426,39901,3578757868,3578757916,48
3,1427,39902,3578757931,3578757931,0
3,1427,39903,3578757931,3578757931,0
3,1427,39904,3578757931,3578757931,0
3,1427,39905,3578757931,3578757931,0
3,1427,39906,3578757931,3578757931,0
3,1427,39907,3578757931,3578757931,0
3,1427,39908,3578757931,3578757931,0
3,1427,39909,3578757931,3578757931,0
3,1427,39910,3578757931,3578757935,4
3,1427,39911,3578757931,3578757938,7
3,1427,39912,3578757931,3578757939,8
3,1427,39913,3578757931,3578757941,10
3,1427,39914,3578757931,3578757942,11
3,1427,39915,3578757931,3578757945,14
3,1427,39916,3578757931,3578757948,17
3,1427,39917,3578757931,3578757949,18
3,1427,39918,3578757931,3578757949,18
3,1427,39919,3578757931,3578757950,19
3,1427,39920,3578757931,3578757950,19
3,1427,39921,3578757931,3578757952,21
3,1427,39922,3578757931,3578757952,21
3,1427,39923,3578757931,3578757954,23
3,1427,39924,3578757931,3578757956,25
3,1427,39925,3578757931,3578757957,26
3,1427,39926,3578757931,3578757957,26
3,1427,39927,3578757931,3578757958,27
3,1427,39928,3578757931,3578757959,28
3,1427,39929,3578757931,3578757960,29
3,1427,39930,3578757931,3578757963,32
3,1427,39931,3578757931,3578757965,34
3,1427,39932,3578757931,3578757966,35
3,1427,39933,3578757931,3578757967,36
3,1427,39934,3578757931,3578757968,37
3,1427,39935,3578757931,3578757968,37
3,1427,39936,3578757931,3578757969,38
3,1427,39937,3578757931,3578757969,38
3,1427,39938,3578757931,3578757970,39
3,1427,39939,3578757931,3578757971,40
3,1427,39940,3578757931,3578757971,40
3,1427,39941,3578757931,3578757972,41
3,1427,39942,3578757931,3578757974,43
3,1427,39943,3578757931,3578757975,44
3,1427,39944,3578757931,3578757976,45
3,1428,39945,3578757995,3578757995,0
3,1428,39946,3578757995,3578757995,0
3,1428,39947,3578757995,3578757995,0
3,1428,39948,3578757995,3578757995,0
3,1428,39949,3578757995,3578757995,0
3,1428,39950,3578757995,3578757995,0
3,1428,39951,3578757995,3578757995,0
3,1428,39952,3578757995,3578757995,0
3,1428,39953,3578757995,3578757995,0
3,1428,39954,3578757995,3578757995,0
3,1428,39955,3578757995,3578757995,0
3,1428,39956,3578757995,3578757995,0
3,1428,39957,3578757995,3578757995,0
3,1428,39958,3578757995,3578757995,0
3,1428,39959,3578757995,3578757995,0
3,1428,39960,3578757995,3578757995,0
3,1428,39961,3578757995,3578757995,0
3,1428,39962,3578757995,3578757995,0
3,1428,39963,3578757995,3578758000,5
3,1428,39964,3578757995,3578758001,6
3,1428,39965,3578757995,3578758002,7
3,1428,39966,3578757995,3578758002,7
3,1428,39967,3578757995,3578758003,8
3,1428,39968,3578757995,3578758004,9
3,1428,39969,3578757995,3578758005,10
3,1428,39970,3578757995,3578758005,10
3,1428,39971,3578757995,3578758005,10
3,1428,39972,3578757995,3578758007,12
3,1428,39973,3578757995,3578758008,13
3,1428,39974,3578757995,3578758009,14
3,1428,39975,3578757995,3578758009,14
3,1428,39976,3578757995,3578758010,15
3,1428,39977,3578757995,3578758012,17
3,1428,39978,3578757995,3578758013,18
3,1428,39979,3578757995,3578758013,18
3,1428,39980,3578757995,3578758014,19
3,1428,39981,3578757995,3578758015,20
3,1428,39982,3578757995,3578758016,21
3,1428,39983,3578757995,3578758020,25
3,1428,39984,3578757995,3578758021,26
3,1428,39985,3578757995,3578758021,26
3,1428,39986,3578757995,3578758024,29
3,1428,39987,3578757995,3578758025,30
3,1428,39988,3578757995,3578758025,30
3,1428,39989,3578757995,3578758026,31
3,1428,39990,3578757995,3578758026,31
3,1428,39991,3578757995,3578758026,31
3,1428,39992,3578757995,3578758027,32
3,1428,39993,3578757995,3578758027,32
3,1428,39994,3578757995,3578758028,33
3,1428,39995,3578757995,3578758029,34
3,1428,39996,3578757995,3578758030,35
3,1428,39997,3578757995,3578758030,35
3,1428,39998,3578757995,3578758032,37
3,1428,39999,3578757995,3578758032,37
3,1428,40000,3578757995,3578758034,39
3,1428,40001,3578757995,3578758036,41
3,1428,40002,3578757995,3578758036,41
3,1428,40003,3578757995,3578758038,43
3,1428,40004,3578757995,3578758039,44
3,1428,40005,3578757995,3578758043,48
3,1428,40006,3578757995,3578758043,48
3,1428,40007,3578757995,3578758043,48
3,1428,40008,3578757995,3578758043,48
3,1428,40009,3578757995,3578758044,49
3,1428,40010,3578757995,3578758045,50
3,1429,40011,3578758059,3578758059,0
3,1429,40012,3578758059,3578758059,0
3,1429,40013,3578758059,3578758059,0
3,1429,40014,3578758059,3578758059,0
3,1429,40015,3578758059,3578758059,0
3,1429,40016,3578758059,3578758059,0
3,1429,40017,3578758059,3578758059,0
3,1429,40018,3578758059,3578758061,2
3,1429,40019,3578758059,3578758063,4
3,1429,40020,3578758059,3578758063,4
3,1429,40021,3578758059,3578758068,9
3,1429,40022,3578758059,3578758075,16
3,1429,40023,3578758059,3578758080,21
3,1429,40024,3578758059,3578758080,21
3,1429,40025,3578758059,3578758082,23
3,1429,40026,3578758059,3578758083,24
3,1429,40027,3578758059,3578758084,25
3,1429,40028,3578758059,3578758085,26
3,1429,40029,3578758059,3578758086,27
3,1429,40030,3578758059,3578758090,31
3,1429,40031,3578758059,3578758091,32
3,1429,40032,3578758059,3578758094,35
3,1429,40033,3578758059,3578758096,37
3,1429,40034,3578758059,3578758096,37
3,1429,40035,3578758059,3578758097,38
3,1429,40036,3578758059,3578758097,38
3,1429,40037,3578758059,3578758098,39
3,1429,40038,3578758059,3578758100,41
3,1429,40039,3578758059,3578758101,42
3,1429,40040,3578758059,3578758102,43
3,1429,40041,3578758059,3578758102,43
3,1429,40042,3578758059,3578758106,47
3,1429,40043,3578758059,3578758106,47
3,1429,40044,3578758059,3578758107,48
3,1430,40045,3578758123,3578758123,0
3,1430,40046,3578758123,3578758123,0
3,1430,40047,3578758123,3578758123,0
3,1430,40048,3578758123,3578758123,0
3,1430,40049,3578758123,3578758123,0
3,1430,40050,3578758123,3578758123,0
3,1430,40051,3578758123,3578758123,0
3,1430,40052,3578758123,3578758123,0
3,1430,40053,3578758123,3578758123,0
3,1430,40054,3578758123,3578758123,0
3,1430,40055,3578758123,3578758123,0
3,1430,40056,3578758123,3578758123,0
3,1430,40057,3578758123,3578758123,0
3,1430,40058,3578758123,3578758131,8
3,1430,40059,3578758123,3578758132,9
3,1430,40060,3578758123,3578758136,13
3,1430,40061,3578758123,3578758138,15
3,1430,40062,3578758123,3578758138,15
3,1430,40063,3578758123,3578758139,16
3,1430,40064,3578758123,3578758141,18
3,1430,40065,3578758123,3578758142,19
3,1430,40066,3578758123,3578758145,22
3,1430,40067,3578758123,3578758148,25
3,1430,40068,3578758123,3578758149,26
3,1430,40069,3578758123,3578758150,27
3,1430,40070,3578758123,3578758150,27
3,1430,40071,3578758123,3578758153,30
3,1430,40072,3578758123,3578758153,30
3,1430,40073,3578758123,3578758154,31
3,1430,40074,3578758123,3578758156,33
3,1430,40075,3578758123,3578758158,35
3,1430,40076,3578758123,3578758158,35
3,1430,40077,3578758123,3578758159,36
3,1430,40078,3578758123,3578758160,37
3,1430,40079,3578758123,3578758163,40
3,1430,40080,3578758123,3578758165,42
3,1430,40081,3578758123,3578758166,43
3,1430,40082,3578758123,3578758167,44
3,1430,40083,3578758123,3578758167,44
3,1430,40084,3578758123,3578758169,46
3,1430,40085,3578758123,3578758169,46
3,1430,40086,3578758123,3578758170,47
3,1430,40087,3578758123,3578758170,47
3,1430,40088,3578758123,3578758170,47
3,1430,40089,3578758123,3578758171,48
3,1430,40090,3578758123,3578758173,50
3,1431,40091,3578758185,3578758185,0
3,1431,40092,3578758185,3578758185,0
3,1431,40093,3578758185,3578758185,0
3,1431,40094,3578758185,3578758185,0
3,1431,40095,3578758185,3578758185,0
3,1431,40096,3578758185,3578758185,0
3,1431,40097,3578758185,3578758185,0
3,1431,40098,3578758185,3578758185,0
3,1431,40099,3578758185,3578758185,0
3,1431,40100,3578758185,3578758185,0
3,1431,40101,3578758185,3578758187,2
3,1431,40102,3578758185,3578758188,3
3,1431,40103,3578758185,3578758189,4
3,1431,40104,3578758185,3578758189,4
3,1431,40105,3578758185,3578758189,4
3,1431,40106,3578758185,3578758191,6
3,1431,40107,3578758185,3578758191,6
3,1431,40108,3578758185,3578758192,7
3,1431,40109,3578758185,3578758195,10
3,1431,40110,3578758185,3578758195,10
3,1431,40111,3578758185,3578758195,10
3,1431,40112,3578758185,3578758196,11
3,1431,40113,3578758185,3578758200,15
3,1431,40114,3578758185,3578758202,17
3,1431,40115,3578758185,3578758202,17
3,1431,40116,3578758185,3578758203,18
3,1431,40117,3578758185,3578758204,19
3,1431,40118,3578758185,3578758205,20
3,1431,40119,3578758185,3578758205,20
3,1431,40120,3578758185,3578758206,21
3,1431,40121,3578758185,3578758208,23
3,1431,40122,3578758185,3578758209,24
3,1431,40123,3578758185,3578758209,24
3,1431,40124,3578758185,3578758209,24
3,1431,40125,3578758185,3578758210,25
3,1431,40126,3578758185,3578758212,27
3,1431,40127,3578758185,3578758213,28
3,1431,40128,3578758185,3578758213,28
3,1431,40129,3578758185,3578758214,29
3,1431,40130,3578758185,3578758215,30
3,1431,40131,3578758185,3578758217,32
3,1431,40132,3578758185,3578758220,35
3,1431,40133,3578758185,3578758221,36
3,1431,40134,3578758185,3578758221,36
3,1431,40135,3578758185,3578758225,40
3,1431,40136,3578758185,3578758225,40
3,1431,40137,3578758185,3578758226,41
3,1431,40138,3578758185,3578758226,41
3,1431,40139,3578758185,3578758227,42
3,1431,40140,3578758185,3578758229,44
3,1431,40141,3578758185,3578758229,44
3,1431,40142,3578758185,3578758230,45
3,1431,40143,3578758185,3578758230,45
3,1431,40144,3578758185,3578758231,46
3,1431,40145,3578758185,3578758232,47
3,1431,40146,3578758185,3578758232,47
3,1431,40147,3578758185,3578758233,48
3,1432,40148,3578758248,3578758248,0
3,1432,40149,3578758248,3578758248,0
3,1432,40150,3578758248,3578758248,0
3,1432,40151,3578758248,3578758248,0
3,1432,40152,3578758248,3578758248,0
3,1432,40153,3578758248,3578758248,0
3,1432,40154,3578758248,3578758248,0
3,1432,40155,3578758248,3578758248,0
3,1432,40156,3578758248,3578758248,0
3,1432,40157,3578758248,3578758248,0
3,1432,40158,3578758248,3578758250,2
3,1432,40159,3578758248,3578758250,2
3,1432,40160,3578758248,3578758251,3
3,1432,40161,3578758248,3578758254,6
3,1432,40162,3578758248,3578758255,7
3,1432,40163,3578758248,3578758256,8
3,1432,40164,3578758248,3578758257,9
3,1432,40165,3578758248,3578758258,10
3,1432,40166,3578758248,3578758262,14
3,1432,40167,3578758248,3578758264,16
3,1432,40168,3578758248,3578758264,16
3,1432,40169,3578758248,3578758264,16
3,1432,40170,3578758248,3578758268,20
3,1432,40171,3578758248,3578758275,27
3,1432,40172,3578758248,3578758280,32
3,1432,40173,3578758248,3578758281,33
3,1432,40174,3578758248,3578758282,34
3,1432,40175,3578758248,3578758284,36
3,1432,40176,3578758248,3578758285,37
3,1432,40177,3578758248,3578758286,38
3,1432,40178,3578758248,3578758289,41
3,1432,40179,3578758248,3578758289,41
3,1432,40180,3578758248,3578758291,43
3,1432,40181,3578758248,3578758294,46
3,1432,40182,3578758248,3578758295,47
3,1432,40183,3578758248,3578758296,48
3,1432,40184,3578758248,3578758298,50
3,1433,40185,3578758311,3578758311,0
3,1433,40186,3578758311,3578758311,0
3,1433,40187,3578758311,3578758311,0
3,1433,40188,3578758311,3578758311,0
3,1433,40189,3578758311,3578758311,0
3,1433,40190,3578758311,3578758311,0
3,1433,40191,3578758311,3578758311,0
3,1433,40192,3578758311,3578758311,0
3,1433,40193,3578758311,3578758311,0
3,1433,40194,3578758311,3578758314,3
3,1433,40195,3578758311,3578758315,4
3,1433,40196,3578758311,3578758315,4
3,1433,40197,3578758311,3578758315,4
3,1433,40198,3578758311,3578758316,5
3,1433,40199,3578758311,3578758316,5
3,1433,40200,3578758311,3578758319,8
3,1433,40201,3578758311,3578758321,10
3,1433,40202,3578758311,3578758322,11
3,1433,40203,3578758311,3578758322,11
3,1433,40204,3578758311,3578758322,11
3,1433,40205,3578758311,3578758323,12
3,1433,40206,3578758311,3578758331,20
3,1433,40207,3578758311,3578758331,20
3,1433,40208,3578758311,3578758336,25
3,1433,40209,3578758311,3578758338,27
3,1433,40210,3578758311,3578758338,27
3,1433,40211,3578758311,3578758339,28
3,1433,40212,3578758311,3578758342,31
3,1433,40213,3578758311,3578758344,33
3,1433,40214,3578758311,3578758346,35
3,1433,40215,3578758311,3578758348,37
3,1433,40216,3578758311,3578758349,38
3,1433,40217,3578758311,3578758350,39
3,1433,40218,3578758311,3578758350,39
3,1433,40219,3578758311,3578758353,42
3,1433,40220,3578758311,3578758354,43
3,1433,40221,3578758311,3578758355,44
3,1433,40222,3578758311,3578758357,46
3,1433,40223,3578758311,3578758358,47
3,1433,40224,3578758311,3578758359,48
3,1433,40225,3578758311,3578758360,49
3,1434,40226,3578758375,3578758375,0
3,1434,40227,3578758375,3578758375,0
3,1434,40228,3578758375,3578758375,0
3,1434,40229,3578758375,3578758375,0
3,1434,40230,3578758375,3578758375,0
3,1434,40231,3578758375,3578758375,0
3,1434,40232,3578758375,3578758375,0
3,1434,40233,3578758375,3578758375,0
3,1434,40234,3578758375,3578758375,0
3,1434,40235,3578758375,3578758375,0
3,1434,40236,3578758375,3578758375,0
3,1434,40237,3578758375,3578758375,0
3,1434,40238,3578758375,3578758375,0
3,1434,40239,3578758375,3578758376,1
3,1434,40240,3578758375,3578758383,8
3,1434,40241,3578758375,3578758383,8
3,1434,40242,3578758375,3578758384,9
3,1434,40243,3578758375,3578758384,9
3,1434,40244,3578758375,3578758385,10
3,1434,40245,3578758375,3578758386,11
3,1434,40246,3578758375,3578758387,12
3,1434,40247,3578758375,3578758387,12
3,1434,40248,3578758375,3578758388,13
3,1434,40249,3578758375,3578758388,13
3,1434,40250,3578758375,3578758388,13
3,1434,40251,3578758375,3578758389,14
3,1434,40252,3578758375,3578758391,16
3,1434,40253,3578758375,3578758391,16
3,1434,40254,3578758375,3578758393,18
3,1434,40255,3578758375,3578758394,19
3,1434,40256,3578758375,3578758395,20
3,1434,40257,3578758375,3578758395,20
3,1434,40258,3578758375,3578758397,22
3,1434,40259,3578758375,3578758399,24
3,1434,40260,3578758375,3578758401,26
3,1434,40261,3578758375,3578758403,28
3,1434,40262,3578758375,3578758404,29
3,1434,40263,3578758375,3578758405,30
3,1434,40264,3578758375,3578758405,30
3,1434,40265,3578758375,3578758406,31
3,1434,40266,3578758375,3578758407,32
3,1434,40267,3578758375,3578758408,33
3,1434,40268,3578758375,3578758408,33
3,1434,40269,3578758375,3578758408,33
3,1434,40270,3578758375,3578758410,35
3,1434,40271,3578758375,3578758410,35
3,1434,40272,3578758375,3578758412,37
3,1434,40273,3578758375,3578758412,37
3,1434,40274,3578758375,3578758413,38
3,1434,40275,3578758375,3578758415,40
3,1434,40276,3578758375,3578758415,40
3,1434,40277,3578758375,3578758416,41
3,1434,40278,3578758375,3578758421,46
3,1434,40279,3578758375,3578758421,46
3,1434,40280,3578758375,3578758422,47
3,1434,40281,3578758375,3578758424,49
3,1434,40282,3578758375,3578758425,50
3,1435,40283,3578758437,3578758437,0
3,1435,40284,3578758437,3578758437,0
3,1435,40285,3578758437,3578758437,0
3,1435,40286,3578758437,3578758437,0
3,1435,40287,3578758437,3578758437,0
3,1435,40288,3578758437,3578758437,0
3,1435,40289,3578758437,3578758437,0
3,1435,40290,3578758437,3578758437,0
3,1435,40291,3578758437,3578758437,0
3,1435,40292,3578758437,3578758437,0
3,1435,40293,3578758437,3578758437,0
3,1435,40294,3578758437,3578758437,0
3,1435,40295,3578758437,3578758440,3
3,1435,40296,3578758437,3578758442,5
3,1435,40297,3578758437,3578758443,6
3,1435,40298,3578758437,3578758443,6
3,1435,40299,3578758437,3578758444,7
3,1435,40300,3578758437,3578758444,7
3,1435,40301,3578758437,3578758446,9
3,1435,40302,3578758437,3578758447,10
3,1435,40303,3578758437,3578758447,10
3,1435,40304,3578758437,3578758450,13
3,1435,40305,3578758437,3578758451,14
3,1435,40306,3578758437,3578758451,14
3,1435,40307,3578758437,3578758454,17
3,1435,40308,3578758437,3578758455,18
3,1435,40309,3578758437,3578758457,20
3,1435,40310,3578758437,3578758458,21
3,1435,40311,3578758437,3578758459,22
3,1435,40312,3578758437,3578758461,24
3,1435,40313,3578758437,3578758464,27
3,1435,40314,3578758437,3578758464,27
3,1435,40315,3578758437,3578758465,28
3,1435,40316,3578758437,3578758470,33
3,1435,40317,3578758437,3578758475,38
3,1435,40318,3578758437,3578758480,43
3,1435,40319,3578758437,3578758481,44
3,1435,40320,3578758437,3578758482,45
3,1435,40321,3578758437,3578758483,46
3,1435,40322,3578758437,3578758484,47
3,1435,40323,3578758437,3578758485,48
3,1435,40324,3578758437,3578758486,49
3,1436,40325,3578758500,3578758500,0
3,1436,40326,3578758500,3578758500,0
3,1436,40327,3578758500,3578758500,0
3,1436,40328,3578758500,3578758500,0
3,1436,40329,3578758500,3578758500,0
3,1436,40330,3578758500,3578758500,0
3,1436,40331,3578758500,3578758500,0
3,1436,40332,3578758500,3578758500,0
3,1436,40333,3578758500,3578758500,0
3,1436,40334,3578758500,3578758500,0
3,1436,40335,3578758500,3578758502,2
3,1436,40336,3578758500,3578758505,5
3,1436,40337,3578758500,3578758505,5
3,1436,40338,3578758500,3578758506,6
3,1436,40339,3578758500,3578758508,8
3,1436,40340,3578758500,3578758510,10
3,1436,40341,3578758500,3578758510,10
3,1436,40342,3578758500,3578758512,12
3,1436,40343,3578758500,3578758514,14
3,1436,40344,3578758500,3578758514,14
3,1436,40345,3578758500,3578758514,14
3,1436,40346,3578758500,3578758515,15
3,1436,40347,3578758500,3578758515,15
3,1436,40348,3578758500,3578758519,19
3,1436,40349,3578758500,3578758520,20
3,1436,40350,3578758500,3578758521,21
3,1436,40351,3578758500,3578758521,21
3,1436,40352,3578758500,3578758522,22
3,1436,40353,3578758500,3578758525,25
3,1436,40354,3578758500,3578758530,30
3,1436,40355,3578758500,3578758532,32
3,1436,40356,3578758500,3578758535,35
3,1436,40357,3578758500,3578758538,38
3,1436,40358,3578758500,3578758538,38
3,1436,40359,3578758500,3578758538,38
3,1436,40360,3578758500,3578758541,41
3,1436,40361,3578758500,3578758544,44
3,1436,40362,3578758500,3578758548,48
3,1436,40363,3578758500,3578758548,48
3,1436,40364,3578758500,3578758550,50
3,1437,40365,3578758565,3578758565,0
3,1437,40366,3578758565,3578758565,0
3,1437,40367,3578758565,3578758565,0
3,1437,40368,3578758565,3578758565,0
3,1437,40369,3578758565,3578758565,0
3,1437,40370,3578758565,3578758565,0
3,1437,40371,3578758565,3578758565,0
3,1437,40372,3578758565,3578758566,1
3,1437,40373,3578758565,3578758567,2
3,1437,40374,3578758565,3578758568,3
3,1437,40375,3578758565,3578758569,4
3,1437,40376,3578758565,3578758569,4
3,1437,40377,3578758565,3578758569,4
3,1437,40378,3578758565,3578758569,4
3,1437,40379,3578758565,3578758571,6
3,1437,40380,3578758565,3578758572,7
3,1437,40381,3578758565,3578758574,9
3,1437,40382,3578758565,3578758575,10
3,1437,40383,3578758565,3578758575,10
3,1437,40384,3578758565,3578758575,10
3,1437,40385,3578758565,3578758579,14
3,1437,40386,3578758565,3578758582,17
3,1437,40387,3578758565,3578758582,17
3,1437,40388,3578758565,3578758583,18
3,1437,40389,3578758565,3578758583,18
3,1437,40390,3578758565,3578758583,18
3,1437,40391,3578758565,3578758583,18
3,1437,40392,3578758565,3578758584,19
3,1437,40393,3578758565,3578758585,20
3,1437,40394,3578758565,3578758587,22
3,1437,40395,3578758565,3578758587,22
3,1437,40396,3578758565,3578758587,22
3,1437,40397,3578758565,3578758588,23
3,1437,40398,3578758565,3578758588,23
3,1437,40399,3578758565,3578758588,23
3,1437,40400,3578758565,3578758590,25
3,1437,40401,3578758565,3578758590,25
3,1437,40402,3578758565,3578758592,27
3,1437,40403,3578758565,3578758593,28
3,1437,40404,3578758565,3578758594,29
3,1437,40405,3578758565,3578758594,29
3,1437,40406,3578758565,3578758596,31
3,1437,40407,3578758565,3578758599,34
3,1437,40408,3578758565,3578758600,35
3,1437,40409,3578758565,3578758601,36
3,1437,40410,3578758565,3578758602,37
3,1437,40411,3578758565,3578758603,38
3,1437,40412,3578758565,3578758604,39
3,1437,40413,3578758565,3578758604,39
3,1437,40414,3578758565,3578758605,40
3,1437,40415,3578758565,3578758605,40
3,1437,40416,3578758565,3578758607,42
3,1437,40417,3578758565,3578758607,42
3,1437,40418,3578758565,3578758607,42
3,1437,40419,3578758565,3578758608,43
3,1437,40420,3578758565,3578758609,44
3,1437,40421,3578758565,3578758609,44
3,1437,40422,3578758565,3578758611,46
3,1437,40423,3578758565,3578758611,46
3,1437,40424,3578758565,3578758613,48
3,1437,40425,3578758565,3578758613,48
3,1437,40426,3578758565,3578758615,50
3,1438,40427,3578758629,3578758629,0
3,1438,40428,3578758629,3578758629,0
3,1438,40429,3578758629,3578758629,0
3,1438,40430,3578758629,3578758629,0
3,1438,40431,3578758629,3578758629,0
3,1438,40432,3578758629,3578758629,0
3,1438,40433,3578758629,3578758629,0
3,1438,40434,3578758629,3578758629,0
3,1438,40435,3578758629,3578758629,0
3,1438,40436,3578758629,3578758629,0
3,1438,40437,3578758629,3578758629,0
3,1438,40438,3578758629,3578758629,0
3,1438,40439,3578758629,3578758630,1
3,1438,40440,3578758629,3578758631,2
3,1438,40441,3578758629,3578758631,2
3,1438,40442,3578758629,3578758631,2
3,1438,40443,3578758629,3578758634,5
3,1438,40444,3578758629,3578758635,6
3,1438,40445,3578758629,3578758635,6
3,1438,40446,3578758629,3578758638,9
3,1438,40447,3578758629,3578758639,10
3,1438,40448,3578758629,3578758641,12
3,1438,40449,3578758629,3578758644,15
3,1438,40450,3578758629,3578758644,15
3,1438,40451,3578758629,3578758645,16
3,1438,40452,3578758629,3578758646,17
3,1438,40453,3578758629,3578758646,17
3,1438,40454,3578758629,3578758649,20
3,1438,40455,3578758629,3578758649,20
3,1438,40456,3578758629,3578758651,22
3,1438,40457,3578758629,3578758653,24
3,1438,40458,3578758629,3578758654,25
3,1438,40459,3578758629,3578758656,27
3,1438,40460,3578758629,3578758658,29
3,1438,40461,3578758629,3578758658,29
3,1438,40462,3578758629,3578758661,32
3,1438,40463,3578758629,3578758663,34
3,1438,40464,3578758629,3578758663,34
3,1438,40465,3578758629,3578758664,35
3,1438,40466,3578758629,3578758668,39
3,1438,40467,3578758629,3578758675,46
3,1439,40468,3578758693,3578758693,0
3,1439,40469,3578758693,3578758693,0
3,1439,40470,3578758693,3578758693,0
3,1439,40471,3578758693,3578758693,0
3,1439,40472,3578758693,3578758693,0
3,1439,40473,3578758693,3578758693,0
3,1439,40474,3578758693,3578758693,0
3,1439,40475,3578758693,3578758693,0
3,1439,40476,3578758693,3578758693,0
3,1439,40477,3578758693,3578758693,0
3,1439,40478,3578758693,3578758694,1
3,1439,40479,3578758693,3578758695,2
3,1439,40480,3578758693,3578758695,2
3,1439,40481,3578758693,3578758696,3
3,1439,40482,3578758693,3578758697,4
3,1439,40483,3578758693,3578758698,5
3,1439,40484,3578758693,3578758700,7
3,1439,40485,3578758693,3578758702,9
3,1439,40486,3578758693,3578758704,11
3,1439,40487,3578758693,3578758706,13
3,1439,40488,3578758693,3578758708,15
3,1439,40489,3578758693,3578758710,17
3,1439,40490,3578758693,3578758713,20
3,1439,40491,3578758693,3578758714,21
3,1439,40492,3578758693,3578758714,21
3,1439,40493,3578758693,3578758714,21
3,1439,40494,3578758693,3578758714,21
3,1439,40495,3578758693,3578758714,21
3,1439,40496,3578758693,3578758718,25
3,1439,40497,3578758693,3578758721,28
3,1439,40498,3578758693,3578758721,28
3,1439,40499,3578758693,3578758722,29
3,1439,40500,3578758693,3578758730,37
3,1439,40501,3578758693,3578758731,38
3,1439,40502,3578758693,3578758735,42
3,1439,40503,3578758693,3578758737,44
3,1439,40504,3578758693,3578758738,45
3,1439,40505,3578758693,3578758738,45
3,1439,40506,3578758693,3578758740,47
3,1440,40507,3578758758,3578758758,0
3,1440,40508,3578758758,3578758758,0
3,1440,40509,3578758758,3578758758,0
3,1440,40510,3578758758,3578758758,0
3,1440,40511,3578758758,3578758758,0
3,1440,40512,3578758758,3578758758,0
3,1440,40513,3578758758,3578758758,0
3,1440,40514,3578758758,3578758758,0
3,1440,40515,3578758758,3578758758,0
3,1440,40516,3578758758,3578758760,2
3,1440,40517,3578758758,3578758763,5
3,1440,40518,3578758758,3578758765,7
3,1440,40519,3578758758,3578758766,8
3,1440,40520,3578758758,3578758767,9
3,1440,40521,3578758758,3578758768,10
3,1440,40522,3578758758,3578758768,10
3,1440,40523,3578758758,3578758768,10
3,1440,40524,3578758758,3578758771,13
3,1440,40525,3578758758,3578758772,14
3,1440,40526,3578758758,3578758772,14
3,1440,40527,3578758758,3578758773,15
3,1440,40528,3578758758,3578758774,16
3,1440,40529,3578758758,3578758775,17
3,1440,40530,3578758758,3578758775,17
3,1440,40531,3578758758,3578758779,21
3,1440,40532,3578758758,3578758782,24
3,1440,40533,3578758758,3578758783,25
3,1440,40534,3578758758,3578758783,25
3,1440,40535,3578758758,3578758784,26
3,1440,40536,3578758758,3578758784,26
3,1440,40537,3578758758,3578758785,27
3,1440,40538,3578758758,3578758786,28
3,1440,40539,3578758758,3578758787,29
3,1440,40540,3578758758,3578758787,29
3,1440,40541,3578758758,3578758788,30
3,1440,40542,3578758758,3578758788,30
3,1440,40543,3578758758,3578758788,30
3,1440,40544,3578758758,3578758789,31
3,1440,40545,3578758758,3578758790,32
3,1440,40546,3578758758,3578758793,35
3,1440,40547,3578758758,3578758793,35
3,1440,40548,3578758758,3578758793,35
3,1440,40549,3578758758,3578758794,36
3,1440,40550,3578758758,3578758797,39
3,1440,40551,3578758758,3578758799,41
3,1440,40552,3578758758,3578758800,42
3,1440,40553,3578758758,3578758801,43
3,1440,40554,3578758758,3578758801,43
3,1440,40555,3578758758,3578758802,44
3,1440,40556,3578758758,3578758804,46
3,1440,40557,3578758758,3578758805,47
3,1440,40558,3578758758,3578758805,47
3,1440,40559,3578758758,3578758806,48
3,1440,40560,3578758758,3578758808,50
3,1441,40561,3578758821,3578758821,0
3,1441,40562,3578758821,3578758821,0
3,1441,40563,3578758821,3578758821,0
3,1441,40564,3578758821,3578758821,0
3,1441,40565,3578758821,3578758821,0
3,1441,40566,3578758821,3578758821,0
3,1441,40567,3578758821,3578758821,0
3,1441,40568,3578758821,3578758821,0
3,1441,40569,3578758821,3578758821,0
3,1441,40570,3578758821,3578758821,0
3,1441,40571,3578758821,3578758821,0
3,1441,40572,3578758821,3578758822,1
3,1441,40573,3578758821,3578758824,3
3,1441,40574,3578758821,3578758824,3
3,1441,40575,3578758821,3578758826,5
3,1441,40576,3578758821,3578758826,5
3,1441,40577,3578758821,3578758826,5
3,1441,40578,3578758821,3578758827,6
3,1441,40579,3578758821,3578758827,6
3,1441,40580,3578758821,3578758829,8
3,1441,40581,3578758821,3578758831,10
3,1441,40582,3578758821,3578758831,10
3,1441,40583,3578758821,3578758832,11
3,1441,40584,3578758821,3578758834,13
3,1441,40585,3578758821,3578758835,14
3,1441,40586,3578758821,3578758835,14
3,1441,40587,3578758821,3578758838,17
3,1441,40588,3578758821,3578758840,19
3,1441,40589,3578758821,3578758843,22
3,1441,40590,3578758821,3578758843,22
3,1441,40591,3578758821,3578758843,22
3,1441,40592,3578758821,3578758843,22
3,1441,40593,3578758821,3578758845,24
3,1441,40594,3578758821,3578758845,24
3,1441,40595,3578758821,3578758847,26
3,1441,40596,3578758821,3578758847,26
3,1441,40597,3578758821,3578758849,28
3,1441,40598,3578758821,3578758850,29
3,1441,40599,3578758821,3578758851,30
3,1441,40600,3578758821,3578758853,32
3,1441,40601,3578758821,3578758855,34
3,1441,40602,3578758821,3578758856,35
3,1441,40603,3578758821,3578758858,37
3,1441,40604,3578758821,3578758858,37
3,1441,40605,3578758821,3578758861,40
3,1441,40606,3578758821,3578758863,42
3,1441,40607,3578758821,3578758863,42
3,1441,40608,3578758821,3578758864,43
3,1441,40609,3578758821,3578758868,47
3,1442,40610,3578758885,3578758885,0
3,1442,40611,3578758885,3578758885,0
3,1442,40612,3578758885,3578758885,0
3,1442,40613,3578758885,3578758885,0
3,1442,40614,3578758885,3578758885,0
3,1442,40615,3578758885,3578758885,0
3,1442,40616,3578758885,3578758886,1
3,1442,40617,3578758885,3578758886,1
3,1442,40618,3578758885,3578758893,8
3,1442,40619,3578758885,3578758894,9
3,1442,40620,3578758885,3578758894,9
3,1442,40621,3578758885,3578758895,10
3,1442,40622,3578758885,3578758896,11
3,1442,40623,3578758885,3578758897,12
3,1442,40624,3578758885,3578758899,14
3,1442,40625,3578758885,3578758900,15
3,1442,40626,3578758885,3578758901,16
3,1442,40627,3578758885,3578758902,17
3,1442,40628,3578758885,3578758905,20
3,1442,40629,3578758885,3578758906,21
3,1442,40630,3578758885,3578758907,22
3,1442,40631,3578758885,3578758907,22
3,1442,40632,3578758885,3578758910,25
3,1442,40633,3578758885,3578758910,25
3,1442,40634,3578758885,3578758914,29
3,1442,40635,3578758885,3578758914,29
3,1442,40636,3578758885,3578758914,29
3,1442,40637,3578758885,3578758914,29
3,1442,40638,3578758885,3578758914,29
3,1442,40639,3578758885,3578758914,29
3,1442,40640,3578758885,3578758919,34
3,1442,40641,3578758885,3578758921,36
3,1442,40642,3578758885,3578758921,36
3,1442,40643,3578758885,3578758921,36
3,1442,40644,3578758885,3578758921,36
3,1442,40645,3578758885,3578758930,45
3,1442,40646,3578758885,3578758932,47
3,1442,40647,3578758885,3578758935,50
3,1443,40648,3578758948,3578758948,0
3,1443,40649,3578758948,3578758948,0
3,1443,40650,3578758948,3578758948,0
3,1443,40651,3578758948,3578758948,0
3,1443,40652,3578758948,3578758948,0
3,1443,40653,3578758948,3578758948,0
3,1443,40654,3578758948,3578758949,1
3,1443,40655,3578758948,3578758949,1
3,1443,40656,3578758948,3578758952,4
3,1443,40657,3578758948,3578758954,6
3,1443,40658,3578758948,3578758956,8
3,1443,40659,3578758948,3578758957,9
3,1443,40660,3578758948,3578758957,9
3,1443,40661,3578758948,3578758958,10
3,1443,40662,3578758948,3578758960,12
3,1443,40663,3578758948,3578758960,12
3,1443,40664,3578758948,3578758963,15
3,1443,40665,3578758948,3578758965,17
3,1443,40666,3578758948,3578758966,18
3,1443,40667,3578758948,3578758968,20
3,1443,40668,3578758948,3578758968,20
3,1443,40669,3578758948,3578758968,20
3,1443,40670,3578758948,3578758968,20
3,1443,40671,3578758948,3578758970,22
3,1443,40672,3578758948,3578758971,23
3,1443,40673,3578758948,3578758972,24
3,1443,40674,3578758948,3578758972,24
3,1443,40675,3578758948,3578758974,26
3,1443,40676,3578758948,3578758975,27
3,1443,40677,3578758948,3578758975,27
3,1443,40678,3578758948,3578758976,28
3,1443,40679,3578758948,3578758980,32
3,1443,40680,3578758948,3578758982,34
3,1443,40681,3578758948,3578758983,35
3,1443,40682,3578758948,3578758983,35
3,1443,40683,3578758948,3578758983,35
3,1443,40684,3578758948,3578758983,35
3,1443,40685,3578758948,3578758984,36
3,1443,40686,3578758948,3578758984,36
3,1443,40687,3578758948,3578758986,38
3,1443,40688,3578758948,3578758987,39
3,1443,40689,3578758948,3578758987,39
3,1443,40690,3578758948,3578758987,39
3,1443,40691,3578758948,3578758987,39
3,1443,40692,3578758948,3578758988,40
3,1443,40693,3578758948,3578758988,40
3,1443,40694,3578758948,3578758990,42
3,1443,40695,3578758948,3578758991,43
3,1443,40696,3578758948,3578758993,45
3,1443,40697,3578758948,3578758993,45
3,1443,40698,3578758948,3578758994,46
3,1443,40699,3578758948,3578758997,49
3,1444,40700,3578759012,3578759012,0
3,1444,40701,3578759012,3578759012,0
3,1444,40702,3578759012,3578759012,0
3,1444,40703,3578759012,3578759012,0
3,1444,40704,3578759012,3578759012,0
3,1444,40705,3578759012,3578759012,0
3,1444,40706,3578759012,3578759012,0
3,1444,40707,3578759012,3578759012,0
3,1444,40708,3578759012,3578759012,0
3,1444,40709,3578759012,3578759012,0
3,1444,40710,3578759012,3578759012,0
3,1444,40711,3578759012,3578759012,0
3,1444,40712,3578759012,3578759012,0
3,1444,40713,3578759012,3578759012,0
3,1444,40714,3578759012,3578759012,0
3,1444,40715,3578759012,3578759013,1
3,1444,40716,3578759012,3578759014,2
3,1444,40717,3578759012,3578759015,3
3,1444,40718,3578759012,3578759017,5
3,1444,40719,3578759012,3578759021,9
3,1444,40720,3578759012,3578759021,9
3,1444,40721,3578759012,3578759022,10
3,1444,40722,3578759012,3578759024,12
3,1444,40723,3578759012,3578759024,12
3,1444,40724,3578759012,3578759025,13
3,1444,40725,3578759012,3578759026,14
3,1444,40726,3578759012,3578759026,14
3,1444,40727,3578759012,3578759026,14
3,1444,40728,3578759012,3578759027,15
3,1444,40729,3578759012,3578759028,16
3,1444,40730,3578759012,3578759031,19
3,1444,40731,3578759012,3578759031,19
3,1444,40732,3578759012,3578759033,21
3,1444,40733,3578759012,3578759034,22
3,1444,40734,3578759012,3578759035,23
3,1444,40735,3578759012,3578759036,24
3,1444,40736,3578759012,3578759039,27
3,1444,40737,3578759012,3578759039,27
3,1444,40738,3578759012,3578759042,30
3,1444,40739,3578759012,3578759043,31
3,1444,40740,3578759012,3578759043,31
3,1444,40741,3578759012,3578759044,32
3,1444,40742,3578759012,3578759045,33
3,1444,40743,3578759012,3578759046,34
3,1444,40744,3578759012,3578759047,35
3,1444,40745,3578759012,3578759050,38
3,1444,40746,3578759012,3578759051,39
3,1444,40747,3578759012,3578759053,41
3,1444,40748,3578759012,3578759055,43
3,1444,40749,3578759012,3578759056,44
3,1444,40750,3578759012,3578759058,46
3,1444,40751,3578759012,3578759058,46
3,1444,40752,3578759012,3578759062,50
3,1445,40753,3578759074,3578759074,0
3,1445,40754,3578759074,3578759074,0
3,1445,40755,3578759074,3578759074,0
3,1445,40756,3578759074,3578759074,0
3,1445,40757,3578759074,3578759075,1
3,1445,40758,3578759074,3578759080,6
3,1445,40759,3578759074,3578759081,7
3,1445,40760,3578759074,3578759083,9
3,1445,40761,3578759074,3578759083,9
3,1445,40762,3578759074,3578759085,11
3,1445,40763,3578759074,3578759085,11
3,1445,40764,3578759074,3578759087,13
3,1445,40765,3578759074,3578759090,16
3,1445,40766,3578759074,3578759092,18
3,1445,40767,3578759074,3578759094,20
3,1445,40768,3578759074,3578759095,21
3,1445,40769,3578759074,3578759095,21
3,1445,40770,3578759074,3578759096,22
3,1445,40771,3578759074,3578759096,22
3,1445,40772,3578759074,3578759098,24
3,1445,40773,3578759074,3578759101,27
3,1445,40774,3578759074,3578759102,28
3,1445,40775,3578759074,3578759105,31
3,1445,40776,3578759074,3578759105,31
3,1445,40777,3578759074,3578759106,32
3,1445,40778,3578759074,3578759106,32
3,1445,40779,3578759074,3578759108,34
3,1445,40780,3578759074,3578759110,36
3,1445,40781,3578759074,3578759110,36
3,1445,40782,3578759074,3578759114,40
3,1445,40783,3578759074,3578759114,40
3,1445,40784,3578759074,3578759115,41
3,1445,40785,3578759074,3578759115,41
3,1445,40786,3578759074,3578759116,42
3,1445,40787,3578759074,3578759118,44
3,1445,40788,3578759074,3578759121,47
3,1445,40789,3578759074,3578759122,48
3,1445,40790,3578759074,3578759122,48
3,1445,40791,3578759074,3578759122,48
3,1445,40792,3578759074,3578759122,48
3,1446,40793,3578759137,3578759137,0
3,1446,40794,3578759137,3578759137,0
3,1446,40795,3578759137,3578759137,0
3,1446,40796,3578759137,3578759137,0
3,1446,40797,3578759137,3578759139,2
3,1446,40798,3578759137,3578759139,2
3,1446,40799,3578759137,3578759141,4
3,1446,40800,3578759137,3578759143,6
3,1446,40801,3578759137,3578759148,11
3,1446,40802,3578759137,3578759148,11
3,1446,40803,3578759137,3578759150,13
3,1446,40804,3578759137,3578759150,13
3,1446,40805,3578759137,3578759152,15
3,1446,40806,3578759137,3578759153,16
3,1446,40807,3578759137,3578759156,19
3,1446,40808,3578759137,3578759158,21
3,1446,40809,3578759137,3578759158,21
3,1446,40810,3578759137,3578759158,21
3,1446,40811,3578759137,3578759160,23
3,1446,40812,3578759137,3578759160,23
3,1446,40813,3578759137,3578759163,26
3,1446,40814,3578759137,3578759167,30
3,1446,40815,3578759137,3578759168,31
3,1446,40816,3578759137,3578759168,31
3,1446,40817,3578759137,3578759168,31
3,1446,40818,3578759137,3578759169,32
3,1446,40819,3578759137,3578759171,34
3,1446,40820,3578759137,3578759171,34
3,1446,40821,3578759137,3578759172,35
3,1446,40822,3578759137,3578759173,36
3,1446,40823,3578759137,3578759175,38
3,1446,40824,3578759137,3578759175,38
3,1446,40825,3578759137,3578759175,38
3,1446,40826,3578759137,3578759176,39
3,1446,40827,3578759137,3578759181,44
3,1446,40828,3578759137,3578759182,45
3,1446,40829,3578759137,3578759183,46
3,1446,40830,3578759137,3578759183,46
3,1446,40831,3578759137,3578759184,47
3,1446,40832,3578759137,3578759184,47
3,1446,40833,3578759137,3578759184,47
3,1446,40834,3578759137,3578759184,47
3,1446,40835,3578759137,3578759186,49
3,1447,40836,3578759199,3578759199,0
3,1447,40837,3578759199,3578759199,0
3,1447,40838,3578759199,3578759199,0
3,1447,40839,3578759199,3578759199,0
3,1447,40840,3578759199,3578759199,0
3,1447,40841,3578759199,3578759199,0
3,1447,40842,3578759199,3578759199,0
3,1447,40843,3578759199,3578759199,0
3,1447,40844,3578759199,3578759199,0
3,1447,40845,3578759199,3578759199,0
3,1447,40846,3578759199,3578759199,0
3,1447,40847,3578759199,3578759199,0
3,1447,40848,3578759199,3578759199,0
3,1447,40849,3578759199,3578759201,2
3,1447,40850,3578759199,3578759203,4
3,1447,40851,3578759199,3578759203,4
3,1447,40852,3578759199,3578759204,5
3,1447,40853,3578759199,3578759204,5
3,1447,40854,3578759199,3578759204,5
3,1447,40855,3578759199,3578759205,6
3,1447,40856,3578759199,3578759206,7
3,1447,40857,3578759199,3578759207,8
3,1447,40858,3578759199,3578759208,9
3,1447,40859,3578759199,3578759208,9
3,1447,40860,3578759199,3578759209,10
3,1447,40861,3578759199,3578759210,11
3,1447,40862,3578759199,3578759211,12
3,1447,40863,3578759199,3578759212,13
3,1447,40864,3578759199,3578759212,13
3,1447,40865,3578759199,3578759215,16
3,1447,40866,3578759199,3578759215,16
3,1447,40867,3578759199,3578759216,17
3,1447,40868,3578759199,3578759220,21
3,1447,40869,3578759199,3578759221,22
3,1447,40870,3578759199,3578759221,22
3,1447,40871,3578759199,3578759225,26
3,1447,40872,3578759199,3578759225,26
3,1447,40873,3578759199,3578759226,27
3,1447,40874,3578759199,3578759227,28
3,1447,40875,3578759199,3578759227,28
3,1447,40876,3578759199,3578759227,28
3,1447,40877,3578759199,3578759230,31
3,1447,40878,3578759199,3578759232,33
3,1447,40879,3578759199,3578759232,33
3,1447,40880,3578759199,3578759233,34
3,1447,40881,3578759199,3578759234,35
3,1447,40882,3578759199,3578759235,36
3,1447,40883,3578759199,3578759236,37
3,1447,40884,3578759199,3578759239,40
3,1447,40885,3578759199,3578759240,41
3,1447,40886,3578759199,3578759242,43
3,1447,40887,3578759199,3578759243,44
3,1447,40888,3578759199,3578759244,45
3,1447,40889,3578759199,3578759245,46
3,1447,40890,3578759199,3578759246,47
3,1447,40891,3578759199,3578759247,48
3,1448,40892,3578759262,3578759262,0
3,1448,40893,3578759262,3578759262,0
3,1448,40894,3578759262,3578759262,0
3,1448,40895,3578759262,3578759262,0
3,1448,40896,3578759262,3578759262,0
3,1448,40897,3578759262,3578759262,0
3,1448,40898,3578759262,3578759262,0
3,1448,40899,3578759262,3578759262,0
3,1448,40900,3578759262,3578759263,1
3,1448,40901,3578759262,3578759264,2
3,1448,40902,3578759262,3578759269,7
3,1448,40903,3578759262,3578759275,13
3,1448,40904,3578759262,3578759280,18
3,1448,40905,3578759262,3578759280,18
3,1448,40906,3578759262,3578759283,21
3,1448,40907,3578759262,3578759283,21
3,1448,40908,3578759262,3578759285,23
3,1448,40909,3578759262,3578759286,24
3,1448,40910,3578759262,3578759286,24
3,1448,40911,3578759262,3578759290,28
3,1448,40912,3578759262,3578759292,30
3,1448,40913,3578759262,3578759294,32
3,1448,40914,3578759262,3578759294,32
3,1448,40915,3578759262,3578759295,33
3,1448,40916,3578759262,3578759296,34
3,1448,40917,3578759262,3578759297,35
3,1448,40918,3578759262,3578759299,37
3,1448,40919,3578759262,3578759301,39
3,1448,40920,3578759262,3578759301,39
3,1448,40921,3578759262,3578759302,40
3,1448,40922,3578759262,3578759305,43
3,1448,40923,3578759262,3578759306,44
3,1448,40924,3578759262,3578759307,45
3,1448,40925,3578759262,3578759309,47
3,1448,40926,3578759262,3578759310,48
3,1448,40927,3578759262,3578759310,48
3,1449,40928,3578759326,3578759326,0
3,1449,40929,3578759326,3578759326,0
3,1449,40930,3578759326,3578759326,0
3,1449,40931,3578759326,3578759326,0
3,1449,40932,3578759326,3578759326,0
3,1449,40933,3578759326,3578759326,0
3,1449,40934,3578759326,3578759326,0
3,1449,40935,3578759326,3578759326,0
3,1449,40936,3578759326,3578759326,0
3,1449,40937,3578759326,3578759331,5
3,1449,40938,3578759326,3578759331,5
3,1449,40939,3578759326,3578759337,11
3,1449,40940,3578759326,3578759337,11
3,1449,40941,3578759326,3578759339,13
3,1449,40942,3578759326,3578759341,15
3,1449,40943,3578759326,3578759343,17
3,1449,40944,3578759326,3578759348,22
3,1449,40945,3578759326,3578759348,22
3,1449,40946,3578759326,3578759350,24
3,1449,40947,3578759326,3578759350,24
3,1449,40948,3578759326,3578759352,26
3,1449,40949,3578759326,3578759354,28
3,1449,40950,3578759326,3578759355,29
3,1449,40951,3578759326,3578759357,31
3,1449,40952,3578759326,3578759358,32
3,1449,40953,3578759326,3578759358,32
3,1449,40954,3578759326,3578759360,34
3,1449,40955,3578759326,3578759360,34
3,1449,40956,3578759326,3578759364,38
3,1449,40957,3578759326,3578759366,40
3,1449,40958,3578759326,3578759367,41
3,1449,40959,3578759326,3578759368,42
3,1449,40960,3578759326,3578759368,42
3,1449,40961,3578759326,3578759369,43
3,1449,40962,3578759326,3578759371,45
3,1449,40963,3578759326,3578759372,46
3,1449,40964,3578759326,3578759374,48
3,1449,40965,3578759326,3578759374,48
3,1449,40966,3578759326,3578759374,48
3,1449,40967,3578759326,3578759376,50
3,1450,40968,3578759389,3578759389,0
3,1450,40969,3578759389,3578759389,0
3,1450,40970,3578759389,3578759389,0
3,1450,40971,3578759389,3578759389,0
3,1450,40972,3578759389,3578759389,0
3,1450,40973,3578759389,3578759389,0
3,1450,40974,3578759389,3578759389,0
3,1450,40975,3578759389,3578759389,0
3,1450,40976,3578759389,3578759389,0
3,1450,40977,3578759389,3578759389,0
3,1450,40978,3578759389,3578759389,0
3,1450,40979,3578759389,3578759389,0
3,1450,40980,3578759389,3578759389,0
3,1450,40981,3578759389,3578759389,0
3,1450,40982,3578759389,3578759390,1
3,1450,40983,3578759389,3578759391,2
3,1450,40984,3578759389,3578759391,2
3,1450,40985,3578759389,3578759394,5
3,1450,40986,3578759389,3578759394,5
3,1450,40987,3578759389,3578759394,5
3,1450,40988,3578759389,3578759395,6
3,1450,40989,3578759389,3578759397,8
3,1450,40990,3578759389,3578759399,10
3,1450,40991,3578759389,3578759402,13
3,1450,40992,3578759389,3578759403,14
3,1450,40993,3578759389,3578759403,14
3,1450,40994,3578759389,3578759403,14
3,1450,40995,3578759389,3578759405,16
3,1450,40996,3578759389,3578759405,16
3,1450,40997,3578759389,3578759406,17
3,1450,40998,3578759389,3578759408,19
3,1450,40999,3578759389,3578759408,19
3,1450,41000,3578759389,3578759408,19
3,1450,41001,3578759389,3578759408,19
3,1450,41002,3578759389,3578759410,21
3,1450,41003,3578759389,3578759411,22
3,1450,41004,3578759389,3578759412,23
3,1450,41005,3578759389,3578759413,24
3,1450,41006,3578759389,3578759413,24
3,1450,41007,3578759389,3578759415,26
3,1450,41008,3578759389,3578759415,26
3,1450,41009,3578759389,3578759416,27
3,1450,41010,3578759389,3578759421,32
3,1450,41011,3578759389,3578759421,32
3,1450,41012,3578759389,3578759424,35
3,1450,41013,3578759389,3578759425,36
3,1450,41014,3578759389,3578759426,37
3,1450,41015,3578759389,3578759427,38
3,1450,41016,3578759389,3578759427,38
3,1450,41017,3578759389,3578759428,39
3,1450,41018,3578759389,3578759430,41
3,1450,41019,3578759389,3578759432,43
3,1450,41020,3578759389,3578759432,43
3,1450,41021,3578759389,3578759433,44
3,1450,41022,3578759389,3578759434,45
3,1450,41023,3578759389,3578759435,46
3,1450,41024,3578759389,3578759436,47
3,1451,41025,3578759452,3578759452,0
3,1451,41026,3578759452,3578759452,0
3,1451,41027,3578759452,3578759452,0
3,1451,41028,3578759452,3578759452,0
3,1451,41029,3578759452,3578759452,0
3,1451,41030,3578759452,3578759452,0
3,1451,41031,3578759452,3578759452,0
3,1451,41032,3578759452,3578759452,0
3,1451,41033,3578759452,3578759452,0
3,1451,41034,3578759452,3578759452,0
3,1451,41035,3578759452,3578759455,3
3,1451,41036,3578759452,3578759455,3
3,1451,41037,3578759452,3578759457,5
3,1451,41038,3578759452,3578759459,7
3,1451,41039,3578759452,3578759464,12
3,1451,41040,3578759452,3578759464,12
3,1451,41041,3578759452,3578759465,13
3,1451,41042,3578759452,3578759470,18
3,1451,41043,3578759452,3578759476,24
3,1451,41044,3578759452,3578759480,28
3,1451,41045,3578759452,3578759481,29
3,1451,41046,3578759452,3578759483,31
3,1451,41047,3578759452,3578759483,31
3,1451,41048,3578759452,3578759485,33
3,1451,41049,3578759452,3578759487,35
3,1451,41050,3578759452,3578759487,35
3,1451,41051,3578759452,3578759490,38
3,1451,41052,3578759452,3578759491,39
3,1451,41053,3578759452,3578759493,41
3,1451,41054,3578759452,3578759494,42
3,1451,41055,3578759452,3578759495,43
3,1451,41056,3578759452,3578759495,43
3,1451,41057,3578759452,3578759496,44
3,1451,41058,3578759452,3578759497,45
3,1451,41059,3578759452,3578759499,47
3,1451,41060,3578759452,3578759500,48
3,1451,41061,3578759452,3578759501,49
3,1451,41062,3578759452,3578759502,50
3,1452,41063,3578759515,3578759515,0
3,1452,41064,3578759515,3578759515,0
3,1452,41065,3578759515,3578759515,0
3,1452,41066,3578759515,3578759515,0
3,1452,41067,3578759515,3578759515,0
3,1452,41068,3578759515,3578759515,0
3,1452,41069,3578759515,3578759515,0
3,1452,41070,3578759515,3578759515,0
3,1452,41071,3578759515,3578759515,0
3,1452,41072,3578759515,3578759515,0
3,1452,41073,3578759515,3578759515,0
3,1452,41074,3578759515,3578759515,0
3,1452,41075,3578759515,3578759517,2
3,1452,41076,3578759515,3578759520,5
3,1452,41077,3578759515,3578759521,6
3,1452,41078,3578759515,3578759522,7
3,1452,41079,3578759515,3578759523,8
3,1452,41080,3578759515,3578759530,15
3,1452,41081,3578759515,3578759532,17
3,1452,41082,3578759515,3578759536,21
3,1452,41083,3578759515,3578759537,22
3,1452,41084,3578759515,3578759538,23
3,1452,41085,3578759515,3578759541,26
3,1452,41086,3578759515,3578759542,27
3,1452,41087,3578759515,3578759547,32
3,1452,41088,3578759515,3578759548,33
3,1452,41089,3578759515,3578759549,34
3,1452,41090,3578759515,3578759549,34
3,1452,41091,3578759515,3578759550,35
3,1452,41092,3578759515,3578759554,39
3,1452,41093,3578759515,3578759556,41
3,1452,41094,3578759515,3578759557,42
3,1452,41095,3578759515,3578759557,42
3,1452,41096,3578759515,3578759558,43
3,1452,41097,3578759515,3578759559,44
3,1452,41098,3578759515,3578759559,44
3,1452,41099,3578759515,3578759563,48
3,1452,41100,3578759515,3578759565,50
3,1453,41101,3578759577,3578759577,0
3,1453,41102,3578759577,3578759578,1
3,1453,41103,3578759577,3578759578,1
3,1453,41104,3578759577,3578759578,1
3,1453,41105,3578759577,3578759578,1
3,1453,41106,3578759577,3578759578,1
3,1453,41107,3578759577,3578759578,1
3,1453,41108,3578759577,3578759578,1
3,1453,41109,3578759577,3578759578,1
3,1453,41110,3578759577,3578759578,1
3,1453,41111,3578759577,3578759580,3
3,1453,41112,3578759577,3578759582,5
3,1453,41113,3578759577,3578759582,5
3,1453,41114,3578759577,3578759582,5
3,1453,41115,3578759577,3578759583,6
3,1453,41116,3578759577,3578759583,6
3,1453,41117,3578759577,3578759583,6
3,1453,41118,3578759577,3578759584,7
3,1453,41119,3578759577,3578759585,8
3,1453,41120,3578759577,3578759585,8
3,1453,41121,3578759577,3578759586,9
3,1453,41122,3578759577,3578759587,10
3,1453,41123,3578759577,3578759587,10
3,1453,41124,3578759577,3578759587,10
3,1453,41125,3578759577,3578759589,12
3,1453,41126,3578759577,3578759590,13
3,1453,41127,3578759577,3578759591,14
3,1453,41128,3578759577,3578759592,15
3,1453,41129,3578759577,3578759593,16
3,1453,41130,3578759577,3578759593,16
3,1453,41131,3578759577,3578759594,17
3,1453,41132,3578759577,3578759596,19
3,1453,41133,3578759577,3578759599,22
3,1453,41134,3578759577,3578759601,24
3,1453,41135,3578759577,3578759602,25
3,1453,41136,3578759577,3578759603,26
3,1453,41137,3578759577,3578759604,27
3,1453,41138,3578759577,3578759604,27
3,1453,41139,3578759577,3578759605,28
3,1453,41140,3578759577,3578759606,29
3,1453,41141,3578759577,3578759606,29
3,1453,41142,3578759577,3578759607,30
3,1453,41143,3578759577,3578759607,30
3,1453,41144,3578759577,3578759608,31
3,1453,41145,3578759577,3578759609,32
3,1453,41146,3578759577,3578759610,33
3,1453,41147,3578759577,3578759611,34
3,1453,41148,3578759577,3578759611,34
3,1453,41149,3578759577,3578759613,36
3,1453,41150,3578759577,3578759615,38
3,1453,41151,3578759577,3578759616,39
3,1453,41152,3578759577,3578759620,43
3,1453,41153,3578759577,3578759620,43
3,1453,41154,3578759577,3578759621,44
3,1453,41155,3578759577,3578759624,47
3,1453,41156,3578759577,3578759624,47
3,1453,41157,3578759577,3578759626,49
3,1453,41158,3578759577,3578759626,49
3,1453,41159,3578759577,3578759626,49
3,1453,41160,3578759577,3578759626,49
3,1454,41161,3578759642,3578759642,0
3,1454,41162,3578759642,3578759642,0
3,1454,41163,3578759642,3578759642,0
3,1454,41164,3578759642,3578759642,0
3,1454,41165,3578759642,3578759642,0
3,1454,41166,3578759642,3578759642,0
3,1454,41167,3578759642,3578759642,0
3,1454,41168,3578759642,3578759642,0
3,1454,41169,3578759642,3578759643,1
3,1454,41170,3578759642,3578759643,1
3,1454,41171,3578759642,3578759644,2
3,1454,41172,3578759642,3578759645,3
3,1454,41173,3578759642,3578759646,4
3,1454,41174,3578759642,3578759650,8
3,1454,41175,3578759642,3578759651,9
3,1454,41176,3578759642,3578759653,11
3,1454,41177,3578759642,3578759654,12
3,1454,41178,3578759642,3578759656,14
3,1454,41179,3578759642,3578759658,16
3,1454,41180,3578759642,3578759658,16
3,1454,41181,3578759642,3578759661,19
3,1454,41182,3578759642,3578759663,21
3,1454,41183,3578759642,3578759663,21
3,1454,41184,3578759642,3578759664,22
3,1454,41185,3578759642,3578759669,27
3,1454,41186,3578759642,3578759676,34
3,1454,41187,3578759642,3578759680,38
3,1454,41188,3578759642,3578759680,38
3,1454,41189,3578759642,3578759683,41
3,1454,41190,3578759642,3578759684,42
3,1454,41191,3578759642,3578759685,43
3,1454,41192,3578759642,3578759687,45
3,1454,41193,3578759642,3578759687,45
3,1454,41194,3578759642,3578759690,48
3,1454,41195,3578759642,3578759691,49
3,1455,41196,3578759706,3578759706,0
3,1455,41197,3578759706,3578759706,0
3,1455,41198,3578759706,3578759706,0
3,1455,41199,3578759706,3578759706,0
3,1455,41200,3578759706,3578759706,0
3,1455,41201,3578759706,3578759706,0
3,1455,41202,3578759706,3578759706,0
3,1455,41203,3578759706,3578759706,0
3,1455,41204,3578759706,3578759706,0
3,1455,41205,3578759706,3578759706,0
3,1455,41206,3578759706,3578759706,0
3,1455,41207,3578759706,3578759706,0
3,1455,41208,3578759706,3578759706,0
3,1455,41209,3578759706,3578759708,2
3,1455,41210,3578759706,3578759709,3
3,1455,41211,3578759706,3578759709,3
3,1455,41212,3578759706,3578759713,7
3,1455,41213,3578759706,3578759714,8
3,1455,41214,3578759706,3578759714,8
3,1455,41215,3578759706,3578759714,8
3,1455,41216,3578759706,3578759715,9
3,1455,41217,3578759706,3578759715,9
3,1455,41218,3578759706,3578759717,11
3,1455,41219,3578759706,3578759720,14
3,1455,41220,3578759706,3578759721,15
3,1455,41221,3578759706,3578759722,16
3,1455,41222,3578759706,3578759723,17
3,1455,41223,3578759706,3578759730,24
3,1455,41224,3578759706,3578759732,26
3,1455,41225,3578759706,3578759736,30
3,1455,41226,3578759706,3578759737,31
3,1455,41227,3578759706,3578759738,32
3,1455,41228,3578759706,3578759741,35
3,1455,41229,3578759706,3578759742,36
3,1455,41230,3578759706,3578759745,39
3,1455,41231,3578759706,3578759747,41
3,1455,41232,3578759706,3578759748,42
3,1455,41233,3578759706,3578759749,43
3,1455,41234,3578759706,3578759749,43
3,1455,41235,3578759706,3578759752,46
3,1455,41236,3578759706,3578759754,48
3,1455,41237,3578759706,3578759755,49
3,1456,41238,3578759770,3578759770,0
3,1456,41239,3578759770,3578759770,0
3,1456,41240,3578759770,3578759770,0
3,1456,41241,3578759770,3578759770,0
3,1456,41242,3578759770,3578759770,0
3,1456,41243,3578759770,3578759770,0
3,1456,41244,3578759770,3578759770,0
3,1456,41245,3578759770,3578759770,0
3,1456,41246,3578759770,3578759770,0
3,1456,41247,3578759770,3578759770,0
3,1456,41248,3578759770,3578759770,0
3,1456,41249,3578759770,3578759770,0
3,1456,41250,3578759770,3578759771,1
3,1456,41251,3578759770,3578759771,1
3,1456,41252,3578759770,3578759773,3
3,1456,41253,3578759770,3578759773,3
3,1456,41254,3578759770,3578759773,3
3,1456,41255,3578759770,3578759776,6
3,1456,41256,3578759770,3578759779,9
3,1456,41257,3578759770,3578759782,12
3,1456,41258,3578759770,3578759782,12
3,1456,41259,3578759770,3578759782,12
3,1456,41260,3578759770,3578759783,13
3,1456,41261,3578759770,3578759783,13
3,1456,41262,3578759770,3578759783,13
3,1456,41263,3578759770,3578759784,14
3,1456,41264,3578759770,3578759785,15
3,1456,41265,3578759770,3578759786,16
3,1456,41266,3578759770,3578759786,16
3,1456,41267,3578759770,3578759787,17
3,1456,41268,3578759770,3578759787,17
3,1456,41269,3578759770,3578759787,17
3,1456,41270,3578759770,3578759789,19
3,1456,41271,3578759770,3578759790,20
3,1456,41272,3578759770,3578759793,23
3,1456,41273,3578759770,3578759793,23
3,1456,41274,3578759770,3578759793,23
3,1456,41275,3578759770,3578759795,25
3,1456,41276,3578759770,3578759795,25
3,1456,41277,3578759770,3578759799,29
3,1456,41278,3578759770,3578759802,32
3,1456,41279,3578759770,3578759802,32
3,1456,41280,3578759770,3578759803,33
3,1456,41281,3578759770,3578759804,34
3,1456,41282,3578759770,3578759804,34
3,1456,41283,3578759770,3578759805,35
3,1456,41284,3578759770,3578759806,36
3,1456,41285,3578759770,3578759808,38
3,1456,41286,3578759770,3578759808,38
3,1456,41287,3578759770,3578759808,38
3,1456,41288,3578759770,3578759809,39
3,1456,41289,3578759770,3578759810,40
3,1456,41290,3578759770,3578759811,41
3,1456,41291,3578759770,3578759814,44
3,1456,41292,3578759770,3578759815,45
3,1456,41293,3578759770,3578759815,45
3,1456,41294,3578759770,3578759819,49
3,1457,41295,3578759833,3578759833,0
3,1457,41296,3578759833,3578759833,0
3,1457,41297,3578759833,3578759833,0
3,1457,41298,3578759833,3578759833,0
3,1457,41299,3578759833,3578759833,0
3,1457,41300,3578759833,3578759833,0
3,1457,41301,3578759833,3578759833,0
3,1457,41302,3578759833,3578759833,0
3,1457,41303,3578759833,3578759834,1
3,1457,41304,3578759833,3578759835,2
3,1457,41305,3578759833,3578759839,6
3,1457,41306,3578759833,3578759840,7
3,1457,41307,3578759833,3578759842,9
3,1457,41308,3578759833,3578759843,10
3,1457,41309,3578759833,3578759843,10
3,1457,41310,3578759833,3578759844,11
3,1457,41311,3578759833,3578759845,12
3,1457,41312,3578759833,3578759846,13
3,1457,41313,3578759833,3578759847,14
3,1457,41314,3578759833,3578759850,17
3,1457,41315,3578759833,3578759851,18
3,1457,41316,3578759833,3578759854,21
3,1457,41317,3578759833,3578759854,21
3,1457,41318,3578759833,3578759857,24
3,1457,41319,3578759833,3578759858,25
3,1457,41320,3578759833,3578759862,29
3,1457,41321,3578759833,3578759863,30
3,1457,41322,3578759833,3578759864,31
3,1457,41323,3578759833,3578759864,31
3,1457,41324,3578759833,3578759876,43
3,1457,41325,3578759833,3578759880,47
3,1457,41326,3578759833,3578759880,47
3,1457,41327,3578759833,3578759883,50
3,1458,41328,3578759897,3578759897,0
3,1458,41329,3578759897,3578759897,0
3,1458,41330,3578759897,3578759897,0
3,1458,41331,3578759897,3578759897,0
3,1458,41332,3578759897,3578759897,0
3,1458,41333,3578759897,3578759897,0
3,1458,41334,3578759897,3578759897,0
3,1458,41335,3578759897,3578759897,0
3,1458,41336,3578759897,3578759897,0
3,1458,41337,3578759897,3578759897,0
3,1458,41338,3578759897,3578759897,0
3,1458,41339,3578759897,3578759900,3
3,1458,41340,3578759897,3578759902,5
3,1458,41341,3578759897,3578759903,6
3,1458,41342,3578759897,3578759905,8
3,1458,41343,3578759897,3578759905,8
3,1458,41344,3578759897,3578759906,9
3,1458,41345,3578759897,3578759906,9
3,1458,41346,3578759897,3578759909,12
3,1458,41347,3578759897,3578759909,12
3,1458,41348,3578759897,3578759909,12
3,1458,41349,3578759897,3578759913,16
3,1458,41350,3578759897,3578759914,17
3,1458,41351,3578759897,3578759914,17
3,1458,41352,3578759897,3578759915,18
3,1458,41353,3578759897,3578759915,18
3,1458,41354,3578759897,3578759915,18
3,1458,41355,3578759897,3578759917,20
3,1458,41356,3578759897,3578759920,23
3,1458,41357,3578759897,3578759922,25
3,1458,41358,3578759897,3578759922,25
3,1458,41359,3578759897,3578759924,27
3,1458,41360,3578759897,3578759929,32
3,1458,41361,3578759897,3578759932,35
3,1458,41362,3578759897,3578759936,39
3,1458,41363,3578759897,3578759937,40
3,1458,41364,3578759897,3578759939,42
3,1458,41365,3578759897,3578759941,44
3,1458,41366,3578759897,3578759943,46
3,1458,41367,3578759897,3578759945,48
3,1459,41368,3578759960,3578759960,0
3,1459,41369,3578759960,3578759960,0
3,1459,41370,3578759960,3578759960,0
3,1459,41371,3578759960,3578759960,0
3,1459,41372,3578759960,3578759960,0
3,1459,41373,3578759960,3578759960,0
3,1459,41374,3578759960,3578759960,0
3,1459,41375,3578759960,3578759960,0
3,1459,41376,3578759960,3578759961,1
3,1459,41377,3578759960,3578759964,4
3,1459,41378,3578759960,3578759965,5
3,1459,41379,3578759960,3578759966,6
3,1459,41380,3578759960,3578759968,8
3,1459,41381,3578759960,3578759968,8
3,1459,41382,3578759960,3578759968,8
3,1459,41383,3578759960,3578759969,9
3,1459,41384,3578759960,3578759970,10
3,1459,41385,3578759960,3578759971,11
3,1459,41386,3578759960,3578759973,13
3,1459,41387,3578759960,3578759973,13
3,1459,41388,3578759960,3578759973,13
3,1459,41389,3578759960,3578759976,16
3,1459,41390,3578759960,3578759980,20
3,1459,41391,3578759960,3578759982,22
3,1459,41392,3578759960,3578759983,23
3,1459,41393,3578759960,3578759983,23
3,1459,41394,3578759960,3578759983,23
3,1459,41395,3578759960,3578759984,24
3,1459,41396,3578759960,3578759984,24
3,1459,41397,3578759960,3578759985,25
3,1459,41398,3578759960,3578759986,26
3,1459,41399,3578759960,3578759986,26
3,1459,41400,3578759960,3578759987,27
3,1459,41401,3578759960,3578759988,28
3,1459,41402,3578759960,3578759988,28
3,1459,41403,3578759960,3578759989,29
3,1459,41404,3578759960,3578759990,30
3,1459,41405,3578759960,3578759992,32
3,1459,41406,3578759960,3578759993,33
3,1459,41407,3578759960,3578759993,33
3,1459,41408,3578759960,3578759995,35
3,1459,41409,3578759960,3578759995,35
3,1459,41410,3578759960,3578759999,39
3,1459,41411,3578759960,3578760002,42
3,1459,41412,3578759960,3578760002,42
3,1459,41413,3578759960,3578760004,44
3,1459,41414,3578759960,3578760004,44
3,1459,41415,3578759960,3578760005,45
3,1459,41416,3578759960,3578760005,45
3,1459,41417,3578759960,3578760007,47
3,1459,41418,3578759960,3578760008,48
3,1459,41419,3578759960,3578760008,48
3,1459,41420,3578759960,3578760010,50
3,1460,41421,3578760026,3578760026,0
3,1460,41422,3578760026,3578760026,0
3,1460,41423,3578760026,3578760026,0
3,1460,41424,3578760026,3578760026,0
3,1460,41425,3578760026,3578760026,0
3,1460,41426,3578760026,3578760026,0
3,1460,41427,3578760026,3578760026,0
3,1460,41428,3578760026,3578760026,0
3,1460,41429,3578760026,3578760026,0
3,1460,41430,3578760026,3578760027,1
3,1460,41431,3578760026,3578760030,4
3,1460,41432,3578760026,3578760031,5
3,1460,41433,3578760026,3578760032,6
3,1460,41434,3578760026,3578760035,9
3,1460,41435,3578760026,3578760036,10
3,1460,41436,3578760026,3578760038,12
3,1460,41437,3578760026,3578760040,14
3,1460,41438,3578760026,3578760043,17
3,1460,41439,3578760026,3578760043,17
3,1460,41440,3578760026,3578760043,17
3,1460,41441,3578760026,3578760045,19
3,1460,41442,3578760026,3578760046,20
3,1460,41443,3578760026,3578760047,21
3,1460,41444,3578760026,3578760049,23
3,1460,41445,3578760026,3578760051,25
3,1460,41446,3578760026,3578760054,28
3,1460,41447,3578760026,3578760056,30
3,1460,41448,3578760026,3578760058,32
3,1460,41449,3578760026,3578760062,36
3,1460,41450,3578760026,3578760063,37
3,1460,41451,3578760026,3578760064,38
3,1460,41452,3578760026,3578760065,39
3,1460,41453,3578760026,3578760070,44
3,1460,41454,3578760026,3578760076,50
3,1461,41455,3578760089,3578760089,0
3,1461,41456,3578760089,3578760089,0
3,1461,41457,3578760089,3578760089,0
3,1461,41458,3578760089,3578760089,0
3,1461,41459,3578760089,3578760089,0
3,1461,41460,3578760089,3578760089,0
3,1461,41461,3578760089,3578760089,0
3,1461,41462,3578760089,3578760090,1
3,1461,41463,3578760089,3578760091,2
3,1461,41464,3578760089,3578760095,6
3,1461,41465,3578760089,3578760095,6
3,1461,41466,3578760089,3578760095,6
3,1461,41467,3578760089,3578760097,8
3,1461,41468,3578760089,3578760098,9
3,1461,41469,3578760089,3578760102,13
3,1461,41470,3578760089,3578760103,14
3,1461,41471,3578760089,3578760105,16
3,1461,41472,3578760089,3578760105,16
3,1461,41473,3578760089,3578760105,16
3,1461,41474,3578760089,3578760106,17
3,1461,41475,3578760089,3578760109,20
3,1461,41476,3578760089,3578760109,20
3,1461,41477,3578760089,3578760109,20
3,1461,41478,3578760089,3578760113,24
3,1461,41479,3578760089,3578760114,25
3,1461,41480,3578760089,3578760114,25
3,1461,41481,3578760089,3578760114,25
3,1461,41482,3578760089,3578760115,26
3,1461,41483,3578760089,3578760117,28
3,1461,41484,3578760089,3578760120,31
3,1461,41485,3578760089,3578760121,32
3,1461,41486,3578760089,3578760122,33
3,1461,41487,3578760089,3578760123,34
3,1461,41488,3578760089,3578760129,40
3,1461,41489,3578760089,3578760132,43
3,1461,41490,3578760089,3578760136,47
3,1461,41491,3578760089,3578760138,49
3,1461,41492,3578760089,3578760139,50
3,1462,41493,3578760153,3578760153,0
3,1462,41494,3578760153,3578760153,0
3,1462,41495,3578760153,3578760153,0
3,1462,41496,3578760153,3578760153,0
3,1462,41497,3578760153,3578760153,0
3,1462,41498,3578760153,3578760153,0
3,1462,41499,3578760153,3578760153,0
3,1462,41500,3578760153,3578760153,0
3,1462,41501,3578760153,3578760155,2
3,1462,41502,3578760153,3578760155,2
3,1462,41503,3578760153,3578760157,4
3,1462,41504,3578760153,3578760158,5
3,1462,41505,3578760153,3578760159,6
3,1462,41506,3578760153,3578760160,7
3,1462,41507,3578760153,3578760163,10
3,1462,41508,3578760153,3578760167,14
3,1462,41509,3578760153,3578760168,15
3,1462,41510,3578760153,3578760168,15
3,1462,41511,3578760153,3578760169,16
3,1462,41512,3578760153,3578760170,17
3,1462,41513,3578760153,3578760170,17
3,1462,41514,3578760153,3578760170,17
3,1462,41515,3578760153,3578760171,18
3,1462,41516,3578760153,3578760173,20
3,1462,41517,3578760153,3578760173,20
3,1462,41518,3578760153,3578760174,21
3,1462,41519,3578760153,3578760177,24
3,1462,41520,3578760153,3578760179,26
3,1462,41521,3578760153,3578760182,29
3,1462,41522,3578760153,3578760183,30
3,1462,41523,3578760153,3578760183,30
3,1462,41524,3578760153,3578760183,30
3,1462,41525,3578760153,3578760185,32
3,1462,41526,3578760153,3578760185,32
3,1462,41527,3578760153,3578760186,33
3,1462,41528,3578760153,3578760187,34
3,1462,41529,3578760153,3578760188,35
3,1462,41530,3578760153,3578760188,35
3,1462,41531,3578760153,3578760189,36
3,1462,41532,3578760153,3578760193,40
3,1462,41533,3578760153,3578760193,40
3,1462,41534,3578760153,3578760194,41
3,1462,41535,3578760153,3578760195,42
3,1462,41536,3578760153,3578760197,44
3,1462,41537,3578760153,3578760199,46
3,1462,41538,3578760153,3578760202,49
3,1462,41539,3578760153,3578760203,50
3,1463,41540,3578760216,3578760216,0
3,1463,41541,3578760216,3578760216,0
3,1463,41542,3578760216,3578760216,0
3,1463,41543,3578760216,3578760216,0
3,1463,41544,3578760216,3578760216,0
3,1463,41545,3578760216,3578760216,0
3,1463,41546,3578760216,3578760216,0
3,1463,41547,3578760216,3578760216,0
3,1463,41548,3578760216,3578760216,0
3,1463,41549,3578760216,3578760216,0
3,1463,41550,3578760216,3578760216,0
3,1463,41551,3578760216,3578760221,5
3,1463,41552,3578760216,3578760221,5
3,1463,41553,3578760216,3578760221,5
3,1463,41554,3578760216,3578760225,9
3,1463,41555,3578760216,3578760226,10
3,1463,41556,3578760216,3578760227,11
3,1463,41557,3578760216,3578760230,14
3,1463,41558,3578760216,3578760231,15
3,1463,41559,3578760216,3578760232,16
3,1463,41560,3578760216,3578760235,19
3,1463,41561,3578760216,3578760236,20
3,1463,41562,3578760216,3578760238,22
3,1463,41563,3578760216,3578760240,24
3,1463,41564,3578760216,3578760243,27
3,1463,41565,3578760216,3578760243,27
3,1463,41566,3578760216,3578760245,29
3,1463,41567,3578760216,3578760245,29
3,1463,41568,3578760216,3578760246,30
3,1463,41569,3578760216,3578760250,34
3,1463,41570,3578760216,3578760250,34
3,1463,41571,3578760216,3578760254,38
3,1463,41572,3578760216,3578760256,40
3,1463,41573,3578760216,3578760259,43
3,1463,41574,3578760216,3578760262,46
3,1463,41575,3578760216,3578760264,48
3,1463,41576,3578760216,3578760264,48
3,1463,41577,3578760216,3578760264,48
3,1464,41578,3578760281,3578760281,0
3,1464,41579,3578760281,3578760281,0
3,1464,41580,3578760281,3578760281,0
3,1464,41581,3578760281,3578760281,0
3,1464,41582,3578760281,3578760283,2
3,1464,41583,3578760281,3578760284,3
3,1464,41584,3578760281,3578760285,4
3,1464,41585,3578760281,3578760287,6
3,1464,41586,3578760281,3578760290,9
3,1464,41587,3578760281,3578760291,10
3,1464,41588,3578760281,3578760294,13
3,1464,41589,3578760281,3578760295,14
3,1464,41590,3578760281,3578760296,15
3,1464,41591,3578760281,3578760297,16
3,1464,41592,3578760281,3578760298,17
3,1464,41593,3578760281,3578760302,21
3,1464,41594,3578760281,3578760303,22
3,1464,41595,3578760281,3578760306,25
3,1464,41596,3578760281,3578760306,25
3,1464,41597,3578760281,3578760306,25
3,1464,41598,3578760281,3578760309,28
3,1464,41599,3578760281,3578760309,28
3,1464,41600,3578760281,3578760313,32
3,1464,41601,3578760281,3578760314,33
3,1464,41602,3578760281,3578760314,33
3,1464,41603,3578760281,3578760315,34
3,1464,41604,3578760281,3578760315,34
3,1464,41605,3578760281,3578760315,34
3,1464,41606,3578760281,3578760320,39
3,1464,41607,3578760281,3578760323,42
3,1464,41608,3578760281,3578760324,43
3,1464,41609,3578760281,3578760329,48
3,1465,41610,3578760345,3578760345,0
3,1465,41611,3578760345,3578760345,0
3,1465,41612,3578760345,3578760345,0
3,1465,41613,3578760345,3578760345,0
3,1465,41614,3578760345,3578760345,0
3,1465,41615,3578760345,3578760345,0
3,1465,41616,3578760345,3578760345,0
3,1465,41617,3578760345,3578760348,3
3,1465,41618,3578760345,3578760348,3
3,1465,41619,3578760345,3578760351,6
3,1465,41620,3578760345,3578760351,6
3,1465,41621,3578760345,3578760353,8
3,1465,41622,3578760345,3578760354,9
3,1465,41623,3578760345,3578760356,11
3,1465,41624,3578760345,3578760358,13
3,1465,41625,3578760345,3578760358,13
3,1465,41626,3578760345,3578760358,13
3,1465,41627,3578760345,3578760360,15
3,1465,41628,3578760345,3578760363,18
3,1465,41629,3578760345,3578760365,20
3,1465,41630,3578760345,3578760366,21
3,1465,41631,3578760345,3578760369,24
3,1465,41632,3578760345,3578760369,24
3,1465,41633,3578760345,3578760370,25
3,1465,41634,3578760345,3578760370,25
3,1465,41635,3578760345,3578760370,25
3,1465,41636,3578760345,3578760371,26
3,1465,41637,3578760345,3578760373,28
3,1465,41638,3578760345,3578760373,28
3,1465,41639,3578760345,3578760374,29
3,1465,41640,3578760345,3578760377,32
3,1465,41641,3578760345,3578760379,34
3,1465,41642,3578760345,3578760382,37
3,1465,41643,3578760345,3578760382,37
3,1465,41644,3578760345,3578760383,38
3,1465,41645,3578760345,3578760383,38
3,1465,41646,3578760345,3578760385,40
3,1465,41647,3578760345,3578760385,40
3,1465,41648,3578760345,3578760387,42
3,1465,41649,3578760345,3578760387,42
3,1465,41650,3578760345,3578760387,42
3,1465,41651,3578760345,3578760388,43
3,1465,41652,3578760345,3578760388,43
3,1465,41653,3578760345,3578760389,44
3,1465,41654,3578760345,3578760391,46
3,1465,41655,3578760345,3578760393,48
3,1465,41656,3578760345,3578760393,48
3,1465,41657,3578760345,3578760394,49
3,1465,41658,3578760345,3578760394,49
3,1465,41659,3578760345,3578760395,50
3,1466,41660,3578760409,3578760409,0
3,1466,41661,3578760409,3578760409,0
3,1466,41662,3578760409,3578760409,0
3,1466,41663,3578760409,3578760409,0
3,1466,41664,3578760409,3578760409,0
3,1466,41665,3578760409,3578760409,0
3,1466,41666,3578760409,3578760409,0
3,1466,41667,3578760409,3578760409,0
3,1466,41668,3578760409,3578760409,0
3,1466,41669,3578760409,3578760410,1
3,1466,41670,3578760409,3578760410,1
3,1466,41671,3578760409,3578760412,3
3,1466,41672,3578760409,3578760415,6
3,1466,41673,3578760409,3578760416,7
3,1466,41674,3578760409,3578760417,8
3,1466,41675,3578760409,3578760420,11
3,1466,41676,3578760409,3578760421,12
3,1466,41677,3578760409,3578760421,12
3,1466,41678,3578760409,3578760424,15
3,1466,41679,3578760409,3578760427,18
3,1466,41680,3578760409,3578760427,18
3,1466,41681,3578760409,3578760427,18
3,1466,41682,3578760409,3578760431,22
3,1466,41683,3578760409,3578760431,22
3,1466,41684,3578760409,3578760432,23
3,1466,41685,3578760409,3578760433,24
3,1466,41686,3578760409,3578760434,25
3,1466,41687,3578760409,3578760435,26
3,1466,41688,3578760409,3578760436,27
3,1466,41689,3578760409,3578760441,32
3,1466,41690,3578760409,3578760442,33
3,1466,41691,3578760409,3578760444,35
3,1466,41692,3578760409,3578760444,35
3,1466,41693,3578760409,3578760444,35
3,1466,41694,3578760409,3578760450,41
3,1466,41695,3578760409,3578760450,41
3,1466,41696,3578760409,3578760454,45
3,1466,41697,3578760409,3578760454,45
3,1466,41698,3578760409,3578760457,48
3,1466,41699,3578760409,3578760458,49
3,1467,41700,3578760473,3578760473,0
3,1467,41701,3578760473,3578760473,0
3,1467,41702,3578760473,3578760473,0
3,1467,41703,3578760473,3578760473,0
3,1467,41704,3578760473,3578760473,0
3,1467,41705,3578760473,3578760477,4
3,1467,41706,3578760473,3578760481,8
3,1467,41707,3578760473,3578760481,8
3,1467,41708,3578760473,3578760483,10
3,1467,41709,3578760473,3578760484,11
3,1467,41710,3578760473,3578760486,13
3,1467,41711,3578760473,3578760487,14
3,1467,41712,3578760473,3578760487,14
3,1467,41713,3578760473,3578760490,17
3,1467,41714,3578760473,3578760490,17
3,1467,41715,3578760473,3578760494,21
3,1467,41716,3578760473,3578760495,22
3,1467,41717,3578760473,3578760495,22
3,1467,41718,3578760473,3578760496,23
3,1467,41719,3578760473,3578760497,24
3,1467,41720,3578760473,3578760502,29
3,1467,41721,3578760473,3578760503,30
3,1467,41722,3578760473,3578760505,32
3,1467,41723,3578760473,3578760506,33
3,1467,41724,3578760473,3578760507,34
3,1467,41725,3578760473,3578760509,36
3,1467,41726,3578760473,3578760509,36
3,1467,41727,3578760473,3578760509,36
3,1467,41728,3578760473,3578760514,41
3,1467,41729,3578760473,3578760515,42
3,1467,41730,3578760473,3578760515,42
3,1467,41731,3578760473,3578760515,42
3,1467,41732,3578760473,3578760515,42
3,1467,41733,3578760473,3578760515,42
3,1467,41734,3578760473,3578760518,45
3,1467,41735,3578760473,3578760520,47
3,1467,41736,3578760473,3578760523,50
3,1468,41737,3578760536,3578760536,0
3,1468,41738,3578760536,3578760536,0
3,1468,41739,3578760536,3578760536,0
3,1468,41740,3578760536,3578760536,0
3,1468,41741,3578760536,3578760537,1
3,1468,41742,3578760536,3578760538,2
3,1468,41743,3578760536,3578760541,5
3,1468,41744,3578760536,3578760543,7
3,1468,41745,3578760536,3578760544,8
3,1468,41746,3578760536,3578760546,10
3,1468,41747,3578760536,3578760549,13
3,1468,41748,3578760536,3578760552,16
3,1468,41749,3578760536,3578760553,17
3,1468,41750,3578760536,3578760555,19
3,1468,41751,3578760536,3578760557,21
3,1468,41752,3578760536,3578760557,21
3,1468,41753,3578760536,3578760558,22
3,1468,41754,3578760536,3578760559,23
3,1468,41755,3578760536,3578760563,27
3,1468,41756,3578760536,3578760565,29
3,1468,41757,3578760536,3578760565,29
3,1468,41758,3578760536,3578760568,32
3,1468,41759,3578760536,3578760568,32
3,1468,41760,3578760536,3578760568,32
3,1468,41761,3578760536,3578760569,33
3,1468,41762,3578760536,3578760569,33
3,1468,41763,3578760536,3578760571,35
3,1468,41764,3578760536,3578760572,36
3,1468,41765,3578760536,3578760572,36
3,1468,41766,3578760536,3578760573,37
3,1468,41767,3578760536,3578760576,40
3,1468,41768,3578760536,3578760581,45
3,1468,41769,3578760536,3578760582,46
3,1468,41770,3578760536,3578760582,46
3,1468,41771,3578760536,3578760584,48
3,1468,41772,3578760536,3578760586,50
3,1469,41773,3578760598,3578760598,0
3,1469,41774,3578760598,3578760598,0
3,1469,41775,3578760598,3578760598,0
3,1469,41776,3578760598,3578760598,0
3,1469,41777,3578760598,3578760598,0
3,1469,41778,3578760598,3578760598,0
3,1469,41779,3578760598,3578760598,0
3,1469,41780,3578760598,3578760598,0
3,1469,41781,3578760598,3578760598,0
3,1469,41782,3578760598,3578760598,0
3,1469,41783,3578760598,3578760599,1
3,1469,41784,3578760598,3578760599,1
3,1469,41785,3578760598,3578760601,3
3,1469,41786,3578760598,3578760603,5
3,1469,41787,3578760598,3578760604,6
3,1469,41788,3578760598,3578760605,7
3,1469,41789,3578760598,3578760605,7
3,1469,41790,3578760598,3578760607,9
3,1469,41791,3578760598,3578760608,10
3,1469,41792,3578760598,3578760609,11
3,1469,41793,3578760598,3578760609,11
3,1469,41794,3578760598,3578760612,14
3,1469,41795,3578760598,3578760614,16
3,1469,41796,3578760598,3578760614,16
3,1469,41797,3578760598,3578760616,18
3,1469,41798,3578760598,3578760620,22
3,1469,41799,3578760598,3578760620,22
3,1469,41800,3578760598,3578760621,23
3,1469,41801,3578760598,3578760624,26
3,1469,41802,3578760598,3578760625,27
3,1469,41803,3578760598,3578760625,27
3,1469,41804,3578760598,3578760626,28
3,1469,41805,3578760598,3578760626,28
3,1469,41806,3578760598,3578760629,31
3,1469,41807,3578760598,3578760629,31
3,1469,41808,3578760598,3578760631,33
3,1469,41809,3578760598,3578760634,36
3,1469,41810,3578760598,3578760634,36
3,1469,41811,3578760598,3578760635,37
3,1469,41812,3578760598,3578760638,40
3,1469,41813,3578760598,3578760640,42
3,1469,41814,3578760598,3578760642,44
3,1469,41815,3578760598,3578760643,45
3,1469,41816,3578760598,3578760643,45
3,1469,41817,3578760598,3578760643,45
3,1469,41818,3578760598,3578760646,48
3,1470,41819,3578760663,3578760663,0
3,1470,41820,3578760663,3578760663,0
3,1470,41821,3578760663,3578760663,0
3,1470,41822,3578760663,3578760663,0
3,1470,41823,3578760663,3578760663,0
3,1470,41824,3578760663,3578760663,0
3,1470,41825,3578760663,3578760663,0
3,1470,41826,3578760663,3578760663,0
3,1470,41827,3578760663,3578760663,0
3,1470,41828,3578760663,3578760663,0
3,1470,41829,3578760663,3578760670,7
3,1470,41830,3578760663,3578760676,13
3,1470,41831,3578760663,3578760681,18
3,1470,41832,3578760663,3578760681,18
3,1470,41833,3578760663,3578760683,20
3,1470,41834,3578760663,3578760683,20
3,1470,41835,3578760663,3578760685,22
3,1470,41836,3578760663,3578760687,24
3,1470,41837,3578760663,3578760687,24
3,1470,41838,3578760663,3578760691,28
3,1470,41839,3578760663,3578760694,31
3,1470,41840,3578760663,3578760695,32
3,1470,41841,3578760663,3578760695,32
3,1470,41842,3578760663,3578760697,34
3,1470,41843,3578760663,3578760698,35
3,1470,41844,3578760663,3578760702,39
3,1470,41845,3578760663,3578760702,39
3,1470,41846,3578760663,3578760706,43
3,1470,41847,3578760663,3578760706,43
3,1470,41848,3578760663,3578760707,44
3,1470,41849,3578760663,3578760709,46
3,1470,41850,3578760663,3578760709,46
3,1470,41851,3578760663,3578760709,46
3,1471,41852,3578760729,3578760729,0
3,1471,41853,3578760729,3578760729,0
3,1471,41854,3578760729,3578760729,0
3,1471,41855,3578760729,3578760729,0
3,1471,41856,3578760729,3578760729,0
3,1471,41857,3578760729,3578760729,0
3,1471,41858,3578760729,3578760729,0
3,1471,41859,3578760729,3578760729,0
3,1471,41860,3578760729,3578760729,0
3,1471,41861,3578760729,3578760729,0
3,1471,41862,3578760729,3578760729,0
3,1471,41863,3578760729,3578760732,3
3,1471,41864,3578760729,3578760735,6
3,1471,41865,3578760729,3578760737,8
3,1471,41866,3578760729,3578760738,9
3,1471,41867,3578760729,3578760741,12
3,1471,41868,3578760729,3578760743,14
3,1471,41869,3578760729,3578760745,16
3,1471,41870,3578760729,3578760749,20
3,1471,41871,3578760729,3578760753,24
3,1471,41872,3578760729,3578760753,24
3,1471,41873,3578760729,3578760757,28
3,1471,41874,3578760729,3578760757,28
3,1471,41875,3578760729,3578760757,28
3,1471,41876,3578760729,3578760760,31
3,1471,41877,3578760729,3578760762,33
3,1471,41878,3578760729,3578760765,36
3,1471,41879,3578760729,3578760766,37
3,1471,41880,3578760729,3578760768,39
3,1471,41881,3578760729,3578760768,39
3,1471,41882,3578760729,3578760768,39
3,1471,41883,3578760729,3578760769,40
3,1471,41884,3578760729,3578760769,40
3,1471,41885,3578760729,3578760771,42
3,1471,41886,3578760729,3578760772,43
3,1471,41887,3578760729,3578760773,44
3,1471,41888,3578760729,3578760775,46
3,1471,41889,3578760729,3578760779,50
3,1472,41890,3578760792,3578760792,0
3,1472,41891,3578760792,3578760792,0
3,1472,41892,3578760792,3578760792,0
3,1472,41893,3578760792,3578760792,0
3,1472,41894,3578760792,3578760792,0
3,1472,41895,3578760792,3578760792,0
3,1472,41896,3578760792,3578760792,0
3,1472,41897,3578760792,3578760792,0
3,1472,41898,3578760792,3578760792,0
3,1472,41899,3578760792,3578760793,1
3,1472,41900,3578760792,3578760793,1
3,1472,41901,3578760792,3578760793,1
3,1472,41902,3578760792,3578760794,2
3,1472,41903,3578760792,3578760796,4
3,1472,41904,3578760792,3578760799,7
3,1472,41905,3578760792,3578760801,9
3,1472,41906,3578760792,3578760803,11
3,1472,41907,3578760792,3578760804,12
3,1472,41908,3578760792,3578760805,13
3,1472,41909,3578760792,3578760805,13
3,1472,41910,3578760792,3578760806,14
3,1472,41911,3578760792,3578760807,15
3,1472,41912,3578760792,3578760809,17
3,1472,41913,3578760792,3578760809,17
3,1472,41914,3578760792,3578760809,17
3,1472,41915,3578760792,3578760812,20
3,1472,41916,3578760792,3578760814,22
3,1472,41917,3578760792,3578760814,22
3,1472,41918,3578760792,3578760815,23
3,1472,41919,3578760792,3578760820,28
3,1472,41920,3578760792,3578760820,28
3,1472,41921,3578760792,3578760821,29
3,1472,41922,3578760792,3578760823,31
3,1472,41923,3578760792,3578760826,34
3,1472,41924,3578760792,3578760826,34
3,1472,41925,3578760792,3578760826,34
3,1472,41926,3578760792,3578760827,35
3,1472,41927,3578760792,3578760830,38
3,1472,41928,3578760792,3578760830,38
3,1472,41929,3578760792,3578760832,40
3,1472,41930,3578760792,3578760833,41
3,1472,41931,3578760792,3578760835,43
3,1472,41932,3578760792,3578760835,43
3,1472,41933,3578760792,3578760838,46
3,1473,41934,3578760855,3578760855,0
3,1473,41935,3578760855,3578760855,0
3,1473,41936,3578760855,3578760855,0
3,1473,41937,3578760855,3578760855,0
3,1473,41938,3578760855,3578760855,0
3,1473,41939,3578760855,3578760855,0
3,1473,41940,3578760855,3578760855,0
3,1473,41941,3578760855,3578760855,0
3,1473,41942,3578760855,3578760855,0
3,1473,41943,3578760855,3578760856,1
3,1473,41944,3578760855,3578760857,2
3,1473,41945,3578760855,3578760857,2
3,1473,41946,3578760855,3578760862,7
3,1473,41947,3578760855,3578760870,15
3,1473,41948,3578760855,3578760876,21
3,1473,41949,3578760855,3578760881,26
3,1473,41950,3578760855,3578760882,27
3,1473,41951,3578760855,3578760883,28
3,1473,41952,3578760855,3578760885,30
3,1473,41953,3578760855,3578760886,31
3,1473,41954,3578760855,3578760887,32
3,1473,41955,3578760855,3578760890,35
3,1473,41956,3578760855,3578760891,36
3,1473,41957,3578760855,3578760895,40
3,1473,41958,3578760855,3578760895,40
3,1473,41959,3578760855,3578760895,40
3,1473,41960,3578760855,3578760897,42
3,1473,41961,3578760855,3578760898,43
3,1473,41962,3578760855,3578760903,48
3,1473,41963,3578760855,3578760903,48
3,1474,41964,3578760919,3578760919,0
3,1474,41965,3578760919,3578760919,0
3,1474,41966,3578760919,3578760919,0
3,1474,41967,3578760919,3578760919,0
3,1474,41968,3578760919,3578760919,0
3,1474,41969,3578760919,3578760919,0
3,1474,41970,3578760919,3578760919,0
3,1474,41971,3578760919,3578760919,0
3,1474,41972,3578760919,3578760919,0
3,1474,41973,3578760919,3578760919,0
3,1474,41974,3578760919,3578760919,0
3,1474,41975,3578760919,3578760921,2
3,1474,41976,3578760919,3578760922,3
3,1474,41977,3578760919,3578760923,4
3,1474,41978,3578760919,3578760929,10
3,1474,41979,3578760919,3578760932,13
3,1474,41980,3578760919,3578760935,16
3,1474,41981,3578760919,3578760937,18
3,1474,41982,3578760919,3578760939,20
3,1474,41983,3578760919,3578760941,22
3,1474,41984,3578760919,3578760945,26
3,1474,41985,3578760919,3578760947,28
3,1474,41986,3578760919,3578760949,30
3,1474,41987,3578760919,3578760953,34
3,1474,41988,3578760919,3578760953,34
3,1474,41989,3578760919,3578760955,36
3,1474,41990,3578760919,3578760957,38
3,1474,41991,3578760919,3578760958,39
3,1474,41992,3578760919,3578760960,41
3,1474,41993,3578760919,3578760963,44
3,1474,41994,3578760919,3578760965,46
3,1474,41995,3578760919,3578760966,47
3,1474,41996,3578760919,3578760968,49
3,1474,41997,3578760919,3578760968,49
3,1474,41998,3578760919,3578760969,50
3,1475,41999,3578760982,3578760982,0
3,1475,42000,3578760982,3578760982,0
3,1475,42001,3578760982,3578760982,0
3,1475,42002,3578760982,3578760982,0
3,1475,42003,3578760982,3578760982,0
3,1475,42004,3578760982,3578760982,0
3,1475,42005,3578760982,3578760982,0
3,1475,42006,3578760982,3578760984,2
3,1475,42007,3578760982,3578760986,4
3,1475,42008,3578760982,3578760987,5
3,1475,42009,3578760982,3578760987,5
3,1475,42010,3578760982,3578760988,6
3,1475,42011,3578760982,3578760989,7
3,1475,42012,3578760982,3578760993,11
3,1475,42013,3578760982,3578760993,11
3,1475,42014,3578760982,3578760993,11
3,1475,42015,3578760982,3578760994,12
3,1475,42016,3578760982,3578760994,12
3,1475,42017,3578760982,3578760996,14
3,1475,42018,3578760982,3578760999,17
3,1475,42019,3578760982,3578761002,20
3,1475,42020,3578760982,3578761003,21
3,1475,42021,3578760982,3578761003,21
3,1475,42022,3578760982,3578761005,23
3,1475,42023,3578760982,3578761005,23
3,1475,42024,3578760982,3578761005,23
3,1475,42025,3578760982,3578761005,23
3,1475,42026,3578760982,3578761007,25
3,1475,42027,3578760982,3578761007,25
3,1475,42028,3578760982,3578761008,26
3,1475,42029,3578760982,3578761009,27
3,1475,42030,3578760982,3578761009,27
3,1475,42031,3578760982,3578761012,30
3,1475,42032,3578760982,3578761014,32
3,1475,42033,3578760982,3578761015,33
3,1475,42034,3578760982,3578761015,33
3,1475,42035,3578760982,3578761021,39
3,1475,42036,3578760982,3578761021,39
3,1475,42037,3578760982,3578761021,39
3,1475,42038,3578760982,3578761023,41
3,1475,42039,3578760982,3578761026,44
3,1475,42040,3578760982,3578761026,44
3,1475,42041,3578760982,3578761026,44
3,1475,42042,3578760982,3578761027,45
3,1475,42043,3578760982,3578761030,48
3,1475,42044,3578760982,3578761031,49
3,1475,42045,3578760982,3578761032,50
3,1476,42046,3578761046,3578761046,0
3,1476,42047,3578761046,3578761046,0
3,1476,42048,3578761046,3578761046,0
3,1476,42049,3578761046,3578761046,0
3,1476,42050,3578761046,3578761046,0
3,1476,42051,3578761046,3578761046,0
3,1476,42052,3578761046,3578761046,0
3,1476,42053,3578761046,3578761046,0
3,1476,42054,3578761046,3578761046,0
3,1476,42055,3578761046,3578761046,0
3,1476,42056,3578761046,3578761049,3
3,1476,42057,3578761046,3578761051,5
3,1476,42058,3578761046,3578761053,7
3,1476,42059,3578761046,3578761056,10
3,1476,42060,3578761046,3578761057,11
3,1476,42061,3578761046,3578761064,18
3,1476,42062,3578761046,3578761064,18
3,1476,42063,3578761046,3578761071,25
3,1476,42064,3578761046,3578761076,30
3,1476,42065,3578761046,3578761080,34
3,1476,42066,3578761046,3578761083,37
3,1476,42067,3578761046,3578761083,37
3,1476,42068,3578761046,3578761083,37
3,1476,42069,3578761046,3578761085,39
3,1476,42070,3578761046,3578761086,40
3,1476,42071,3578761046,3578761087,41
3,1476,42072,3578761046,3578761091,45
3,1476,42073,3578761046,3578761091,45
3,1476,42074,3578761046,3578761095,49
3,1476,42075,3578761046,3578761095,49
3,1476,42076,3578761046,3578761096,50
3,1477,42077,3578761111,3578761111,0
3,1477,42078,3578761111,3578761111,0
3,1477,42079,3578761111,3578761111,0
3,1477,42080,3578761111,3578761111,0
3,1477,42081,3578761111,3578761111,0
3,1477,42082,3578761111,3578761111,0
3,1477,42083,3578761111,3578761111,0
3,1477,42084,3578761111,3578761111,0
3,1477,42085,3578761111,3578761111,0
3,1477,42086,3578761111,3578761111,0
3,1477,42087,3578761111,3578761115,4
3,1477,42088,3578761111,3578761115,4
3,1477,42089,3578761111,3578761116,5
3,1477,42090,3578761111,3578761116,5
3,1477,42091,3578761111,3578761118,7
3,1477,42092,3578761111,3578761121,10
3,1477,42093,3578761111,3578761122,11
3,1477,42094,3578761111,3578761123,12
3,1477,42095,3578761111,3578761129,18
3,1477,42096,3578761111,3578761132,21
3,1477,42097,3578761111,3578761136,25
3,1477,42098,3578761111,3578761137,26
3,1477,42099,3578761111,3578761139,28
3,1477,42100,3578761111,3578761141,30
3,1477,42101,3578761111,3578761145,34
3,1477,42102,3578761111,3578761147,36
3,1477,42103,3578761111,3578761151,40
3,1477,42104,3578761111,3578761153,42
3,1477,42105,3578761111,3578761153,42
3,1477,42106,3578761111,3578761155,44
3,1477,42107,3578761111,3578761157,46
3,1477,42108,3578761111,3578761158,47
3,1477,42109,3578761111,3578761160,49
3,1478,42110,3578761176,3578761176,0
3,1478,42111,3578761176,3578761176,0
3,1478,42112,3578761176,3578761176,0
3,1478,42113,3578761176,3578761176,0
3,1478,42114,3578761176,3578761176,0
3,1478,42115,3578761176,3578761176,0
3,1478,42116,3578761176,3578761176,0
3,1478,42117,3578761176,3578761176,0
3,1478,42118,3578761176,3578761176,0
3,1478,42119,3578761176,3578761177,1
3,1478,42120,3578761176,3578761179,3
3,1478,42121,3578761176,3578761181,5
3,1478,42122,3578761176,3578761181,5
3,1478,42123,3578761176,3578761182,6
3,1478,42124,3578761176,3578761183,7
3,1478,42125,3578761176,3578761185,9
3,1478,42126,3578761176,3578761188,12
3,1478,42127,3578761176,3578761188,12
3,1478,42128,3578761176,3578761189,13
3,1478,42129,3578761176,3578761191,15
3,1478,42130,3578761176,3578761192,16
3,1478,42131,3578761176,3578761193,17
3,1478,42132,3578761176,3578761194,18
3,1478,42133,3578761176,3578761196,20
3,1478,42134,3578761176,3578761199,23
3,1478,42135,3578761176,3578761203,27
3,1478,42136,3578761176,3578761203,27
3,1478,42137,3578761176,3578761205,29
3,1478,42138,3578761176,3578761205,29
3,1478,42139,3578761176,3578761205,29
3,1478,42140,3578761176,3578761205,29
3,1478,42141,3578761176,3578761208,32
3,1478,42142,3578761176,3578761208,32
3,1478,42143,3578761176,3578761209,33
3,1478,42144,3578761176,3578761210,34
3,1478,42145,3578761176,3578761211,35
3,1478,42146,3578761176,3578761214,38
3,1478,42147,3578761176,3578761216,40
3,1478,42148,3578761176,3578761216,40
3,1478,42149,3578761176,3578761221,45
3,1478,42150,3578761176,3578761221,45
3,1478,42151,3578761176,3578761221,45
3,1478,42152,3578761176,3578761224,48
3,1478,42153,3578761176,3578761225,49
3,1478,42154,3578761176,3578761225,49
3,1479,42155,3578761240,3578761240,0
3,1479,42156,3578761240,3578761240,0
3,1479,42157,3578761240,3578761240,0
3,1479,42158,3578761240,3578761240,0
3,1479,42159,3578761240,3578761240,0
3,1479,42160,3578761240,3578761240,0
3,1479,42161,3578761240,3578761240,0
3,1479,42162,3578761240,3578761240,0
3,1479,42163,3578761240,3578761240,0
3,1479,42164,3578761240,3578761240,0
3,1479,42165,3578761240,3578761241,1
3,1479,42166,3578761240,3578761242,2
3,1479,42167,3578761240,3578761243,3
3,1479,42168,3578761240,3578761243,3
3,1479,42169,3578761240,3578761245,5
3,1479,42170,3578761240,3578761247,7
3,1479,42171,3578761240,3578761249,9
3,1479,42172,3578761240,3578761251,11
3,1479,42173,3578761240,3578761253,13
3,1479,42174,3578761240,3578761254,14
3,1479,42175,3578761240,3578761256,16
3,1479,42176,3578761240,3578761258,18
3,1479,42177,3578761240,3578761262,22
3,1479,42178,3578761240,3578761263,23
3,1479,42179,3578761240,3578761264,24
3,1479,42180,3578761240,3578761271,31
3,1479,42181,3578761240,3578761276,36
3,1479,42182,3578761240,3578761281,41
3,1479,42183,3578761240,3578761282,42
3,1479,42184,3578761240,3578761282,42
3,1479,42185,3578761240,3578761284,44
3,1479,42186,3578761240,3578761285,45
3,1479,42187,3578761240,3578761286,46
3,1479,42188,3578761240,3578761287,47
3,1479,42189,3578761240,3578761290,50
3,1480,42190,3578761303,3578761303,0
3,1480,42191,3578761303,3578761303,0
3,1480,42192,3578761303,3578761303,0
3,1480,42193,3578761303,3578761303,0
3,1480,42194,3578761303,3578761303,0
3,1480,42195,3578761303,3578761303,0
3,1480,42196,3578761303,3578761303,0
3,1480,42197,3578761303,3578761303,0
3,1480,42198,3578761303,3578761306,3
3,1480,42199,3578761303,3578761306,3
3,1480,42200,3578761303,3578761307,4
3,1480,42201,3578761303,3578761309,6
3,1480,42202,3578761303,3578761311,8
3,1480,42203,3578761303,3578761314,11
3,1480,42204,3578761303,3578761315,12
3,1480,42205,3578761303,3578761315,12
3,1480,42206,3578761303,3578761317,14
3,1480,42207,3578761303,3578761318,15
3,1480,42208,3578761303,3578761321,18
3,1480,42209,3578761303,3578761322,19
3,1480,42210,3578761303,3578761323,20
3,1480,42211,3578761303,3578761324,21
3,1480,42212,3578761303,3578761330,27
3,1480,42213,3578761303,3578761332,29
3,1480,42214,3578761303,3578761336,33
3,1480,42215,3578761303,3578761337,34
3,1480,42216,3578761303,3578761339,36
3,1480,42217,3578761303,3578761342,39
3,1480,42218,3578761303,3578761344,41
3,1480,42219,3578761303,3578761346,43
3,1480,42220,3578761303,3578761347,44
3,1480,42221,3578761303,3578761348,45
3,1480,42222,3578761303,3578761351,48
3,1480,42223,3578761303,3578761353,50
3,1481,42224,3578761368,3578761368,0
3,1481,42225,3578761368,3578761368,0
3,1481,42226,3578761368,3578761368,0
3,1481,42227,3578761368,3578761368,0
3,1481,42228,3578761368,3578761368,0
3,1481,42229,3578761368,3578761368,0
3,1481,42230,3578761368,3578761368,0
3,1481,42231,3578761368,3578761368,0
3,1481,42232,3578761368,3578761369,1
3,1481,42233,3578761368,3578761369,1
3,1481,42234,3578761368,3578761369,1
3,1481,42235,3578761368,3578761370,2
3,1481,42236,3578761368,3578761371,3
3,1481,42237,3578761368,3578761373,5
3,1481,42238,3578761368,3578761377,9
3,1481,42239,3578761368,3578761378,10
3,1481,42240,3578761368,3578761381,13
3,1481,42241,3578761368,3578761382,14
3,1481,42242,3578761368,3578761382,14
3,1481,42243,3578761368,3578761384,16
3,1481,42244,3578761368,3578761387,19
3,1481,42245,3578761368,3578761388,20
3,1481,42246,3578761368,3578761388,20
3,1481,42247,3578761368,3578761389,21
3,1481,42248,3578761368,3578761389,21
3,1481,42249,3578761368,3578761393,25
3,1481,42250,3578761368,3578761393,25
3,1481,42251,3578761368,3578761394,26
3,1481,42252,3578761368,3578761394,26
3,1481,42253,3578761368,3578761396,28
3,1481,42254,3578761368,3578761399,31
3,1481,42255,3578761368,3578761402,34
3,1481,42256,3578761368,3578761403,35
3,1481,42257,3578761368,3578761406,38
3,1481,42258,3578761368,3578761406,38
3,1481,42259,3578761368,3578761406,38
3,1481,42260,3578761368,3578761406,38
3,1481,42261,3578761368,3578761408,40
3,1481,42262,3578761368,3578761408,40
3,1481,42263,3578761368,3578761410,42
3,1481,42264,3578761368,3578761410,42
3,1481,42265,3578761368,3578761412,44
3,1481,42266,3578761368,3578761414,46
3,1481,42267,3578761368,3578761416,48
3,1481,42268,3578761368,3578761417,49
3,1482,42269,3578761432,3578761432,0
3,1482,42270,3578761432,3578761433,1
3,1482,42271,3578761432,3578761433,1
3,1482,42272,3578761432,3578761433,1
3,1482,42273,3578761432,3578761433,1
3,1482,42274,3578761432,3578761433,1
3,1482,42275,3578761432,3578761433,1
3,1482,42276,3578761432,3578761433,1
3,1482,42277,3578761432,3578761433,1
3,1482,42278,3578761432,3578761433,1
3,1482,42279,3578761432,3578761433,1
3,1482,42280,3578761432,3578761433,1
3,1482,42281,3578761432,3578761434,2
3,1482,42282,3578761432,3578761437,5
3,1482,42283,3578761432,3578761438,6
3,1482,42284,3578761432,3578761441,9
3,1482,42285,3578761432,3578761443,11
3,1482,42286,3578761432,3578761443,11
3,1482,42287,3578761432,3578761443,11
3,1482,42288,3578761432,3578761444,12
3,1482,42289,3578761432,3578761447,15
3,1482,42290,3578761432,3578761450,18
3,1482,42291,3578761432,3578761451,19
3,1482,42292,3578761432,3578761454,22
3,1482,42293,3578761432,3578761457,25
3,1482,42294,3578761432,3578761459,27
3,1482,42295,3578761432,3578761461,29
3,1482,42296,3578761432,3578761464,32
3,1482,42297,3578761432,3578761464,32
3,1482,42298,3578761432,3578761470,38
3,1482,42299,3578761432,3578761477,45
3,1482,42300,3578761432,3578761480,48
3,1482,42301,3578761432,3578761482,50
3,1483,42302,3578761496,3578761496,0
3,1483,42303,3578761496,3578761496,0
3,1483,42304,3578761496,3578761496,0
3,1483,42305,3578761496,3578761496,0
3,1483,42306,3578761496,3578761496,0
3,1483,42307,3578761496,3578761496,0
3,1483,42308,3578761496,3578761496,0
3,1483,42309,3578761496,3578761496,0
3,1483,42310,3578761496,3578761496,0
3,1483,42311,3578761496,3578761496,0
3,1483,42312,3578761496,3578761497,1
3,1483,42313,3578761496,3578761497,1
3,1483,42314,3578761496,3578761502,6
3,1483,42315,3578761496,3578761502,6
3,1483,42316,3578761496,3578761505,9
3,1483,42317,3578761496,3578761506,10
3,1483,42318,3578761496,3578761508,12
3,1483,42319,3578761496,3578761510,14
3,1483,42320,3578761496,3578761513,17
3,1483,42321,3578761496,3578761513,17
3,1483,42322,3578761496,3578761514,18
3,1483,42323,3578761496,3578761514,18
3,1483,42324,3578761496,3578761515,19
3,1483,42325,3578761496,3578761516,20
3,1483,42326,3578761496,3578761517,21
3,1483,42327,3578761496,3578761520,24
3,1483,42328,3578761496,3578761521,25
3,1483,42329,3578761496,3578761522,26
3,1483,42330,3578761496,3578761522,26
3,1483,42331,3578761496,3578761529,33
3,1483,42332,3578761496,3578761535,39
3,1483,42333,3578761496,3578761537,41
3,1483,42334,3578761496,3578761538,42
3,1483,42335,3578761496,3578761541,45
3,1483,42336,3578761496,3578761542,46
3,1483,42337,3578761496,3578761546,50
3,1484,42338,3578761560,3578761560,0
3,1484,42339,3578761560,3578761560,0
3,1484,42340,3578761560,3578761560,0
3,1484,42341,3578761560,3578761560,0
3,1484,42342,3578761560,3578761560,0
3,1484,42343,3578761560,3578761560,0
3,1484,42344,3578761560,3578761560,0
3,1484,42345,3578761560,3578761560,0
3,1484,42346,3578761560,3578761563,3
3,1484,42347,3578761560,3578761564,4
3,1484,42348,3578761560,3578761566,6
3,1484,42349,3578761560,3578761568,8
3,1484,42350,3578761560,3578761568,8
3,1484,42351,3578761560,3578761568,8
3,1484,42352,3578761560,3578761569,9
3,1484,42353,3578761560,3578761569,9
3,1484,42354,3578761560,3578761571,11
3,1484,42355,3578761560,3578761572,12
3,1484,42356,3578761560,3578761572,12
3,1484,42357,3578761560,3578761576,16
3,1484,42358,3578761560,3578761578,18
3,1484,42359,3578761560,3578761581,21
3,1484,42360,3578761560,3578761581,21
3,1484,42361,3578761560,3578761582,22
3,1484,42362,3578761560,3578761582,22
3,1484,42363,3578761560,3578761584,24
3,1484,42364,3578761560,3578761587,27
3,1484,42365,3578761560,3578761587,27
3,1484,42366,3578761560,3578761587,27
3,1484,42367,3578761560,3578761588,28
3,1484,42368,3578761560,3578761592,32
3,1484,42369,3578761560,3578761592,32
3,1484,42370,3578761560,3578761593,33
3,1484,42371,3578761560,3578761593,33
3,1484,42372,3578761560,3578761595,35
3,1484,42373,3578761560,3578761599,39
3,1484,42374,3578761560,3578761602,42
3,1484,42375,3578761560,3578761602,42
3,1484,42376,3578761560,3578761604,44
3,1484,42377,3578761560,3578761604,44
3,1484,42378,3578761560,3578761605,45
3,1484,42379,3578761560,3578761606,46
3,1484,42380,3578761560,3578761607,47
3,1484,42381,3578761560,3578761608,48
3,1484,42382,3578761560,3578761608,48
3,1484,42383,3578761560,3578761611,51
3,1485,42384,3578761625,3578761625,0
3,1485,42385,3578761625,3578761625,0
3,1485,42386,3578761625,3578761625,0
3,1485,42387,3578761625,3578761625,0
3,1485,42388,3578761625,3578761625,0
3,1485,42389,3578761625,3578761625,0
3,1485,42390,3578761625,3578761625,0
3,1485,42391,3578761625,3578761625,0
3,1485,42392,3578761625,3578761626,1
3,1485,42393,3578761625,3578761627,2
3,1485,42394,3578761625,3578761630,5
3,1485,42395,3578761625,3578761630,5
3,1485,42396,3578761625,3578761631,6
3,1485,42397,3578761625,3578761632,7
3,1485,42398,3578761625,3578761636,11
3,1485,42399,3578761625,3578761638,13
3,1485,42400,3578761625,3578761640,15
3,1485,42401,3578761625,3578761642,17
3,1485,42402,3578761625,3578761643,18
3,1485,42403,3578761625,3578761643,18
3,1485,42404,3578761625,3578761644,19
3,1485,42405,3578761625,3578761646,21
3,1485,42406,3578761625,3578761650,25
3,1485,42407,3578761625,3578761651,26
3,1485,42408,3578761625,3578761653,28
3,1485,42409,3578761625,3578761656,31
3,1485,42410,3578761625,3578761658,33
3,1485,42411,3578761625,3578761658,33
3,1485,42412,3578761625,3578761661,36
3,1485,42413,3578761625,3578761662,37
3,1485,42414,3578761625,3578761663,38
3,1485,42415,3578761625,3578761670,45
3,1486,42416,3578761688,3578761688,0
3,1486,42417,3578761688,3578761688,0
3,1486,42418,3578761688,3578761688,0
3,1486,42419,3578761688,3578761688,0
3,1486,42420,3578761688,3578761688,0
3,1486,42421,3578761688,3578761688,0
3,1486,42422,3578761688,3578761688,0
3,1486,42423,3578761688,3578761688,0
3,1486,42424,3578761688,3578761690,2
3,1486,42425,3578761688,3578761690,2
3,1486,42426,3578761688,3578761694,6
3,1486,42427,3578761688,3578761694,6
3,1486,42428,3578761688,3578761697,9
3,1486,42429,3578761688,3578761697,9
3,1486,42430,3578761688,3578761702,14
3,1486,42431,3578761688,3578761702,14
3,1486,42432,3578761688,3578761705,17
3,1486,42433,3578761688,3578761707,19
3,1486,42434,3578761688,3578761709,21
3,1486,42435,3578761688,3578761710,22
3,1486,42436,3578761688,3578761713,25
3,1486,42437,3578761688,3578761714,26
3,1486,42438,3578761688,3578761714,26
3,1486,42439,3578761688,3578761715,27
3,1486,42440,3578761688,3578761716,28
3,1486,42441,3578761688,3578761716,28
3,1486,42442,3578761688,3578761717,29
3,1486,42443,3578761688,3578761720,32
3,1486,42444,3578761688,3578761721,33
3,1486,42445,3578761688,3578761722,34
3,1486,42446,3578761688,3578761722,34
3,1486,42447,3578761688,3578761728,40
3,1486,42448,3578761688,3578761732,44
3,1486,42449,3578761688,3578761734,46
3,1486,42450,3578761688,3578761737,49
3,1486,42451,3578761688,3578761738,50
3,1487,42452,3578761753,3578761753,0
3,1487,42453,3578761753,3578761753,0
3,1487,42454,3578761753,3578761753,0
3,1487,42455,3578761753,3578761753,0
3,1487,42456,3578761753,3578761753,0
3,1487,42457,3578761753,3578761753,0
3,1487,42458,3578761753,3578761753,0
3,1487,42459,3578761753,3578761754,1
3,1487,42460,3578761753,3578761756,3
3,1487,42461,3578761753,3578761758,5
3,1487,42462,3578761753,3578761762,9
3,1487,42463,3578761753,3578761766,13
3,1487,42464,3578761753,3578761766,13
3,1487,42465,3578761753,3578761767,14
3,1487,42466,3578761753,3578761768,15
3,1487,42467,3578761753,3578761768,15
3,1487,42468,3578761753,3578761768,15
3,1487,42469,3578761753,3578761769,16
3,1487,42470,3578761753,3578761770,17
3,1487,42471,3578761753,3578761771,18
3,1487,42472,3578761753,3578761772,19
3,1487,42473,3578761753,3578761773,20
3,1487,42474,3578761753,3578761776,23
3,1487,42475,3578761753,3578761778,25
3,1487,42476,3578761753,3578761780,27
3,1487,42477,3578761753,3578761782,29
3,1487,42478,3578761753,3578761782,29
3,1487,42479,3578761753,3578761782,29
3,1487,42480,3578761753,3578761785,32
3,1487,42481,3578761753,3578761787,34
3,1487,42482,3578761753,3578761787,34
3,1487,42483,3578761753,3578761788,35
3,1487,42484,3578761753,3578761788,35
3,1487,42485,3578761753,3578761791,38
3,1487,42486,3578761753,3578761792,39
3,1487,42487,3578761753,3578761793,40
3,1487,42488,3578761753,3578761794,41
3,1487,42489,3578761753,3578761795,42
3,1487,42490,3578761753,3578761799,46
3,1487,42491,3578761753,3578761802,49
3,1487,42492,3578761753,3578761802,49
3,1488,42493,3578761817,3578761817,0
3,1488,42494,3578761817,3578761817,0
3,1488,42495,3578761817,3578761817,0
3,1488,42496,3578761817,3578761817,0
3,1488,42497,3578761817,3578761817,0
3,1488,42498,3578761817,3578761817,0
3,1488,42499,3578761817,3578761817,0
3,1488,42500,3578761817,3578761817,0
3,1488,42501,3578761817,3578761817,0
3,1488,42502,3578761817,3578761817,0
3,1488,42503,3578761817,3578761817,0
3,1488,42504,3578761817,3578761820,3
3,1488,42505,3578761817,3578761821,4
3,1488,42506,3578761817,3578761823,6
3,1488,42507,3578761817,3578761825,8
3,1488,42508,3578761817,3578761826,9
3,1488,42509,3578761817,3578761826,9
3,1488,42510,3578761817,3578761827,10
3,1488,42511,3578761817,3578761830,13
3,1488,42512,3578761817,3578761831,14
3,1488,42513,3578761817,3578761832,15
3,1488,42514,3578761817,3578761832,15
3,1488,42515,3578761817,3578761837,20
3,1488,42516,3578761817,3578761838,21
3,1488,42517,3578761817,3578761839,22
3,1488,42518,3578761817,3578761843,26
3,1488,42519,3578761817,3578761843,26
3,1488,42520,3578761817,3578761843,26
3,1488,42521,3578761817,3578761847,30
3,1488,42522,3578761817,3578761849,32
3,1488,42523,3578761817,3578761851,34
3,1488,42524,3578761817,3578761853,36
3,1488,42525,3578761817,3578761856,39
3,1488,42526,3578761817,3578761858,41
3,1488,42527,3578761817,3578761862,45
3,1488,42528,3578761817,3578761862,45
3,1488,42529,3578761817,3578761863,46
3,1489,42530,3578761881,3578761881,0
3,1489,42531,3578761881,3578761881,0
3,1489,42532,3578761881,3578761881,0
3,1489,42533,3578761881,3578761882,1
3,1489,42534,3578761881,3578761884,3
3,1489,42535,3578761881,3578761885,4
3,1489,42536,3578761881,3578761887,6
3,1489,42537,3578761881,3578761888,7
3,1489,42538,3578761881,3578761890,9
3,1489,42539,3578761881,3578761891,10
3,1489,42540,3578761881,3578761894,13
3,1489,42541,3578761881,3578761895,14
3,1489,42542,3578761881,3578761895,14
3,1489,42543,3578761881,3578761897,16
3,1489,42544,3578761881,3578761897,16
3,1489,42545,3578761881,3578761902,21
3,1489,42546,3578761881,3578761906,25
3,1489,42547,3578761881,3578761906,25
3,1489,42548,3578761881,3578761908,27
3,1489,42549,3578761881,3578761911,30
3,1489,42550,3578761881,3578761913,32
3,1489,42551,3578761881,3578761914,33
3,1489,42552,3578761881,3578761915,34
3,1489,42553,3578761881,3578761915,34
3,1489,42554,3578761881,3578761915,34
3,1489,42555,3578761881,3578761917,36
3,1489,42556,3578761881,3578761918,37
3,1489,42557,3578761881,3578761920,39
3,1489,42558,3578761881,3578761921,40
3,1489,42559,3578761881,3578761923,42
3,1489,42560,3578761881,3578761923,42
3,1489,42561,3578761881,3578761929,48
3,1490,42562,3578761946,3578761946,0
3,1490,42563,3578761946,3578761946,0
3,1490,42564,3578761946,3578761946,0
3,1490,42565,3578761946,3578761946,0
3,1490,42566,3578761946,3578761946,0
3,1490,42567,3578761946,3578761946,0
3,1490,42568,3578761946,3578761946,0
3,1490,42569,3578761946,3578761946,0
3,1490,42570,3578761946,3578761948,2
3,1490,42571,3578761946,3578761950,4
3,1490,42572,3578761946,3578761952,6
3,1490,42573,3578761946,3578761954,8
3,1490,42574,3578761946,3578761956,10
3,1490,42575,3578761946,3578761957,11
3,1490,42576,3578761946,3578761960,14
3,1490,42577,3578761946,3578761963,17
3,1490,42578,3578761946,3578761966,20
3,1490,42579,3578761946,3578761966,20
3,1490,42580,3578761946,3578761968,22
3,1490,42581,3578761946,3578761968,22
3,1490,42582,3578761946,3578761968,22
3,1490,42583,3578761946,3578761969,23
3,1490,42584,3578761946,3578761969,23
3,1490,42585,3578761946,3578761969,23
3,1490,42586,3578761946,3578761971,25
3,1490,42587,3578761946,3578761973,27
3,1490,42588,3578761946,3578761976,30
3,1490,42589,3578761946,3578761982,36
3,1490,42590,3578761946,3578761984,38
3,1490,42591,3578761946,3578761986,40
3,1490,42592,3578761946,3578761987,41
3,1490,42593,3578761946,3578761988,42
3,1490,42594,3578761946,3578761991,45
3,1490,42595,3578761946,3578761992,46
3,1490,42596,3578761946,3578761993,47
3,1490,42597,3578761946,3578761994,48
3,1490,42598,3578761946,3578761995,49
3,1491,42599,3578762011,3578762011,0
3,1491,42600,3578762011,3578762011,0
3,1491,42601,3578762011,3578762011,0
3,1491,42602,3578762011,3578762011,0
3,1491,42603,3578762011,3578762011,0
3,1491,42604,3578762011,3578762011,0
3,1491,42605,3578762011,3578762011,0
3,1491,42606,3578762011,3578762011,0
3,1491,42607,3578762011,3578762011,0
3,1491,42608,3578762011,3578762011,0
3,1491,42609,3578762011,3578762011,0
3,1491,42610,3578762011,3578762011,0
3,1491,42611,3578762011,3578762014,3
3,1491,42612,3578762011,3578762016,5
3,1491,42613,3578762011,3578762020,9
3,1491,42614,3578762011,3578762021,10
3,1491,42615,3578762011,3578762024,13
3,1491,42616,3578762011,3578762024,13
3,1491,42617,3578762011,3578762025,14
3,1491,42618,3578762011,3578762026,15
3,1491,42619,3578762011,3578762027,16
3,1491,42620,3578762011,3578762029,18
3,1491,42621,3578762011,3578762031,20
3,1491,42622,3578762011,3578762032,21
3,1491,42623,3578762011,3578762032,21
3,1491,42624,3578762011,3578762034,23
3,1491,42625,3578762011,3578762036,25
3,1491,42626,3578762011,3578762038,27
3,1491,42627,3578762011,3578762044,33
3,1491,42628,3578762011,3578762044,33
3,1491,42629,3578762011,3578762047,36
3,1491,42630,3578762011,3578762050,39
3,1491,42631,3578762011,3578762051,40
3,1491,42632,3578762011,3578762053,42
3,1491,42633,3578762011,3578762056,45
3,1491,42634,3578762011,3578762058,47
3,1492,42635,3578762073,3578762073,0
3,1492,42636,3578762073,3578762074,1
3,1492,42637,3578762073,3578762074,1
3,1492,42638,3578762073,3578762077,4
3,1492,42639,3578762073,3578762081,8
3,1492,42640,3578762073,3578762082,9
3,1492,42641,3578762073,3578762084,11
3,1492,42642,3578762073,3578762084,11
3,1492,42643,3578762073,3578762085,12
3,1492,42644,3578762073,3578762087,14
3,1492,42645,3578762073,3578762087,14
3,1492,42646,3578762073,3578762091,18
3,1492,42647,3578762073,3578762091,18
3,1492,42648,3578762073,3578762094,21
3,1492,42649,3578762073,3578762094,21
3,1492,42650,3578762073,3578762095,22
3,1492,42651,3578762073,3578762097,24
3,1492,42652,3578762073,3578762098,25
3,1492,42653,3578762073,3578762102,29
3,1492,42654,3578762073,3578762105,32
3,1492,42655,3578762073,3578762106,33
3,1492,42656,3578762073,3578762110,37
3,1492,42657,3578762073,3578762114,41
3,1492,42658,3578762073,3578762115,42
3,1492,42659,3578762073,3578762116,43
3,1492,42660,3578762073,3578762116,43
3,1492,42661,3578762073,3578762116,43
3,1492,42662,3578762073,3578762118,45
3,1492,42663,3578762073,3578762120,47
3,1492,42664,3578762073,3578762122,49
3,1492,42665,3578762073,3578762122,49
3,1492,42666,3578762073,3578762122,49
3,1493,42667,3578762137,3578762137,0
3,1493,42668,3578762137,3578762137,0
3,1493,42669,3578762137,3578762137,0
3,1493,42670,3578762137,3578762138,1
3,1493,42671,3578762137,3578762139,2
3,1493,42672,3578762137,3578762141,4
3,1493,42673,3578762137,3578762143,6
3,1493,42674,3578762137,3578762146,9
3,1493,42675,3578762137,3578762146,9
3,1493,42676,3578762137,3578762149,12
3,1493,42677,3578762137,3578762151,14
3,1493,42678,3578762137,3578762152,15
3,1493,42679,3578762137,3578762154,17
3,1493,42680,3578762137,3578762157,20
3,1493,42681,3578762137,3578762158,21
3,1493,42682,3578762137,3578762161,24
3,1493,42683,3578762137,3578762164,27
3,1493,42684,3578762137,3578762166,29
3,1493,42685,3578762137,3578762167,30
3,1493,42686,3578762137,3578762168,31
3,1493,42687,3578762137,3578762168,31
3,1493,42688,3578762137,3578762168,31
3,1493,42689,3578762137,3578762169,32
3,1493,42690,3578762137,3578762169,32
3,1493,42691,3578762137,3578762169,32
3,1493,42692,3578762137,3578762173,36
3,1493,42693,3578762137,3578762174,37
3,1493,42694,3578762137,3578762177,40
3,1493,42695,3578762137,3578762181,44
3,1493,42696,3578762137,3578762182,45
3,1493,42697,3578762137,3578762182,45
3,1493,42698,3578762137,3578762184,47
3,1493,42699,3578762137,3578762185,48
3,1493,42700,3578762137,3578762187,50
3,1494,42701,3578762200,3578762200,0
3,1494,42702,3578762200,3578762200,0
3,1494,42703,3578762200,3578762200,0
3,1494,42704,3578762200,3578762200,0
3,1494,42705,3578762200,3578762200,0
3,1494,42706,3578762200,3578762200,0
3,1494,42707,3578762200,3578762200,0
3,1494,42708,3578762200,3578762200,0
3,1494,42709,3578762200,3578762200,0
3,1494,42710,3578762200,3578762200,0
3,1494,42711,3578762200,3578762202,2
3,1494,42712,3578762200,3578762204,4
3,1494,42713,3578762200,3578762204,4
3,1494,42714,3578762200,3578762205,5
3,1494,42715,3578762200,3578762206,6
3,1494,42716,3578762200,3578762206,6
3,1494,42717,3578762200,3578762207,7
3,1494,42718,3578762200,3578762208,8
3,1494,42719,3578762200,3578762208,8
3,1494,42720,3578762200,3578762208,8
3,1494,42721,3578762200,3578762211,11
3,1494,42722,3578762200,3578762214,14
3,1494,42723,3578762200,3578762217,17
3,1494,42724,3578762200,3578762221,21
3,1494,42725,3578762200,3578762221,21
3,1494,42726,3578762200,3578762224,24
3,1494,42727,3578762200,3578762225,25
3,1494,42728,3578762200,3578762225,25
3,1494,42729,3578762200,3578762227,27
3,1494,42730,3578762200,3578762227,27
3,1494,42731,3578762200,3578762229,29
3,1494,42732,3578762200,3578762231,31
3,1494,42733,3578762200,3578762232,32
3,1494,42734,3578762200,3578762233,33
3,1494,42735,3578762200,3578762235,35
3,1494,42736,3578762200,3578762236,36
3,1494,42737,3578762200,3578762239,39
3,1494,42738,3578762200,3578762243,43
3,1494,42739,3578762200,3578762244,44
3,1494,42740,3578762200,3578762247,47
3,1495,42741,3578762263,3578762263,0
3,1495,42742,3578762263,3578762263,0
3,1495,42743,3578762263,3578762263,0
3,1495,42744,3578762263,3578762263,0
3,1495,42745,3578762263,3578762264,1
3,1495,42746,3578762263,3578762270,7
3,1495,42747,3578762263,3578762277,14
3,1495,42748,3578762263,3578762284,21
3,1495,42749,3578762263,3578762285,22
3,1495,42750,3578762263,3578762285,22
3,1495,42751,3578762263,3578762287,24
3,1495,42752,3578762263,3578762288,25
3,1495,42753,3578762263,3578762291,28
3,1495,42754,3578762263,3578762291,28
3,1495,42755,3578762263,3578762294,31
3,1495,42756,3578762263,3578762295,32
3,1495,42757,3578762263,3578762295,32
3,1495,42758,3578762263,3578762297,34
3,1495,42759,3578762263,3578762298,35
3,1495,42760,3578762263,3578762302,39
3,1495,42761,3578762263,3578762306,43
3,1495,42762,3578762263,3578762306,43
3,1495,42763,3578762263,3578762308,45
3,1495,42764,3578762263,3578762310,47
3,1496,42765,3578762326,3578762326,0
3,1496,42766,3578762326,3578762326,0
3,1496,42767,3578762326,3578762326,0
3,1496,42768,3578762326,3578762326,0
3,1496,42769,3578762326,3578762326,0
3,1496,42770,3578762326,3578762326,0
3,1496,42771,3578762326,3578762326,0
3,1496,42772,3578762326,3578762326,0
3,1496,42773,3578762326,3578762326,0
3,1496,42774,3578762326,3578762330,4
3,1496,42775,3578762326,3578762331,5
3,1496,42776,3578762326,3578762336,10
3,1496,42777,3578762326,3578762338,12
3,1496,42778,3578762326,3578762340,14
3,1496,42779,3578762326,3578762342,16
3,1496,42780,3578762326,3578762343,17
3,1496,42781,3578762326,3578762346,20
3,1496,42782,3578762326,3578762346,20
3,1496,42783,3578762326,3578762348,22
3,1496,42784,3578762326,3578762350,24
3,1496,42785,3578762326,3578762352,26
3,1496,42786,3578762326,3578762354,28
3,1496,42787,3578762326,3578762358,32
3,1496,42788,3578762326,3578762360,34
3,1496,42789,3578762326,3578762363,37
3,1496,42790,3578762326,3578762367,41
3,1496,42791,3578762326,3578762367,41
3,1496,42792,3578762326,3578762369,43
3,1496,42793,3578762326,3578762369,43
3,1496,42794,3578762326,3578762369,43
3,1496,42795,3578762326,3578762369,43
3,1496,42796,3578762326,3578762370,44
3,1496,42797,3578762326,3578762373,47
3,1496,42798,3578762326,3578762373,47
3,1496,42799,3578762326,3578762376,50
3,1497,42800,3578762390,3578762390,0
3,1497,42801,3578762390,3578762390,0
3,1497,42802,3578762390,3578762390,0
3,1497,42803,3578762390,3578762390,0
3,1497,42804,3578762390,3578762390,0
3,1497,42805,3578762390,3578762390,0
3,1497,42806,3578762390,3578762390,0
3,1497,42807,3578762390,3578762391,1
3,1497,42808,3578762390,3578762393,3
3,1497,42809,3578762390,3578762394,4
3,1497,42810,3578762390,3578762395,5
3,1497,42811,3578762390,3578762396,6
3,1497,42812,3578762390,3578762399,9
3,1497,42813,3578762390,3578762403,13
3,1497,42814,3578762390,3578762404,14
3,1497,42815,3578762390,3578762405,15
3,1497,42816,3578762390,3578762406,16
3,1497,42817,3578762390,3578762406,16
3,1497,42818,3578762390,3578762407,17
3,1497,42819,3578762390,3578762407,17
3,1497,42820,3578762390,3578762408,18
3,1497,42821,3578762390,3578762408,18
3,1497,42822,3578762390,3578762408,18
3,1497,42823,3578762390,3578762412,22
3,1497,42824,3578762390,3578762414,24
3,1497,42825,3578762390,3578762415,25
3,1497,42826,3578762390,3578762416,26
3,1497,42827,3578762390,3578762420,30
3,1497,42828,3578762390,3578762421,31
3,1497,42829,3578762390,3578762424,34
3,1497,42830,3578762390,3578762424,34
3,1497,42831,3578762390,3578762425,35
3,1497,42832,3578762390,3578762427,37
3,1497,42833,3578762390,3578762428,38
3,1497,42834,3578762390,3578762432,42
3,1497,42835,3578762390,3578762432,42
3,1497,42836,3578762390,3578762433,43
3,1497,42837,3578762390,3578762435,45
3,1497,42838,3578762390,3578762437,47
3,1497,42839,3578762390,3578762438,48
3,1498,42840,3578762455,3578762455,0
3,1498,42841,3578762455,3578762455,0
3,1498,42842,3578762455,3578762455,0
3,1498,42843,3578762455,3578762455,0
3,1498,42844,3578762455,3578762457,2
3,1498,42845,3578762455,3578762458,3
3,1498,42846,3578762455,3578762459,4
3,1498,42847,3578762455,3578762463,8
3,1498,42848,3578762455,3578762464,9
3,1498,42849,3578762455,3578762470,15
3,1498,42850,3578762455,3578762478,23
3,1498,42851,3578762455,3578762481,26
3,1498,42852,3578762455,3578762483,28
3,1498,42853,3578762455,3578762484,29
3,1498,42854,3578762455,3578762485,30
3,1498,42855,3578762455,3578762485,30
3,1498,42856,3578762455,3578762487,32
3,1498,42857,3578762455,3578762488,33
3,1498,42858,3578762455,3578762490,35
3,1498,42859,3578762455,3578762491,36
3,1498,42860,3578762455,3578762495,40
3,1498,42861,3578762455,3578762495,40
3,1498,42862,3578762455,3578762496,41
3,1498,42863,3578762455,3578762497,42
3,1498,42864,3578762455,3578762497,42
3,1498,42865,3578762455,3578762502,47
3,1498,42866,3578762455,3578762505,50
3,1499,42867,3578762519,3578762519,0
3,1499,42868,3578762519,3578762519,0
3,1499,42869,3578762519,3578762519,0
3,1499,42870,3578762519,3578762519,0
3,1499,42871,3578762519,3578762519,0
3,1499,42872,3578762519,3578762519,0
3,1499,42873,3578762519,3578762519,0
3,1499,42874,3578762519,3578762519,0
3,1499,42875,3578762519,3578762519,0
3,1499,42876,3578762519,3578762520,1
3,1499,42877,3578762519,3578762522,3
3,1499,42878,3578762519,3578762522,3
3,1499,42879,3578762519,3578762528,9
3,1499,42880,3578762519,3578762531,12
3,1499,42881,3578762519,3578762535,16
3,1499,42882,3578762519,3578762537,18
3,1499,42883,3578762519,3578762539,20
3,1499,42884,3578762519,3578762540,21
3,1499,42885,3578762519,3578762543,24
3,1499,42886,3578762519,3578762545,26
3,1499,42887,3578762519,3578762545,26
3,1499,42888,3578762519,3578762549,30
3,1499,42889,3578762519,3578762549,30
3,1499,42890,3578762519,3578762551,32
3,1499,42891,3578762519,3578762553,34
3,1499,42892,3578762519,3578762556,37
3,1499,42893,3578762519,3578762556,37
3,1499,42894,3578762519,3578762559,40
3,1499,42895,3578762519,3578762562,43
3,1499,42896,3578762519,3578762565,46
3,1499,42897,3578762519,3578762566,47
3,1499,42898,3578762519,3578762568,49
3,1499,42899,3578762519,3578762568,49
3,1499,42900,3578762519,3578762568,49
3,1499,42901,3578762519,3578762569,50
3,1499,42902,3578762519,3578762569,50
3,1500,42903,3578762583,3578762583,0
3,1500,42904,3578762583,3578762583,0
3,1500,42905,3578762583,3578762583,0
3,1500,42906,3578762583,3578762583,0
3,1500,42907,3578762583,3578762583,0
3,1500,42908,3578762583,3578762583,0
3,1500,42909,3578762583,3578762583,0
3,1500,42910,3578762583,3578762583,0
3,1500,42911,3578762583,3578762583,0
3,1500,42912,3578762583,3578762585,2
3,1500,42913,3578762583,3578762587,4
3,1500,42914,3578762583,3578762587,4
3,1500,42915,3578762583,3578762588,5
3,1500,42916,3578762583,3578762591,8
3,1500,42917,3578762583,3578762593,10
3,1500,42918,3578762583,3578762593,10
3,1500,42919,3578762583,3578762594,11
3,1500,42920,3578762583,3578762596,13
3,1500,42921,3578762583,3578762602,19
3,1500,42922,3578762583,3578762602,19
3,1500,42923,3578762583,3578762604,21
3,1500,42924,3578762583,3578762605,22
3,1500,42925,3578762583,3578762605,22
3,1500,42926,3578762583,3578762605,22
3,1500,42927,3578762583,3578762607,24
3,1500,42928,3578762583,3578762607,24
3,1500,42929,3578762583,3578762607,24
3,1500,42930,3578762583,3578762608,25
3,1500,42931,3578762583,3578762610,27
3,1500,42932,3578762583,3578762615,32
3,1500,42933,3578762583,3578762615,32
3,1500,42934,3578762583,3578762620,37
3,1500,42935,3578762583,3578762621,38
3,1500,42936,3578762583,3578762623,40
3,1500,42937,3578762583,3578762624,41
3,1500,42938,3578762583,3578762625,42
3,1500,42939,3578762583,3578762626,43
3,1500,42940,3578762583,3578762627,44
3,1500,42941,3578762583,3578762629,46
3,1500,42942,3578762583,3578762631,48
3,1500,42943,3578762583,3578762632,49
3,1500,42944,3578762583,3578762632,49
3,1501,42945,3578762649,3578762649,0
3,1501,42946,3578762649,3578762649,0
3,1501,42947,3578762649,3578762649,0
3,1501,42948,3578762649,3578762649,0
3,1501,42949,3578762649,3578762649,0
3,1501,42950,3578762649,3578762649,0
3,1501,42951,3578762649,3578762649,0
3,1501,42952,3578762649,3578762649,0
3,1501,42953,3578762649,3578762651,2
3,1501,42954,3578762649,3578762656,7
3,1501,42955,3578762649,3578762658,9
3,1501,42956,3578762649,3578762658,9
3,1501,42957,3578762649,3578762662,13
3,1501,42958,3578762649,3578762662,13
3,1501,42959,3578762649,3578762670,21
3,1501,42960,3578762649,3578762679,30
3,1501,42961,3578762649,3578762681,32
3,1501,42962,3578762649,3578762683,34
3,1501,42963,3578762649,3578762684,35
3,1501,42964,3578762649,3578762684,35
3,1501,42965,3578762649,3578762685,36
3,1501,42966,3578762649,3578762687,38
3,1501,42967,3578762649,3578762688,39
3,1501,42968,3578762649,3578762690,41
3,1501,42969,3578762649,3578762691,42
3,1501,42970,3578762649,3578762695,46
3,1501,42971,3578762649,3578762695,46
3,1501,42972,3578762649,3578762696,47
3,1501,42973,3578762649,3578762697,48
3,1501,42974,3578762649,3578762697,48
3,1502,42975,3578762714,3578762714,0
3,1502,42976,3578762714,3578762714,0
3,1502,42977,3578762714,3578762714,0
3,1502,42978,3578762714,3578762714,0
3,1502,42979,3578762714,3578762714,0
3,1502,42980,3578762714,3578762714,0
3,1502,42981,3578762714,3578762714,0
3,1502,42982,3578762714,3578762714,0
3,1502,42983,3578762714,3578762714,0
3,1502,42984,3578762714,3578762715,1
3,1502,42985,3578762714,3578762717,3
3,1502,42986,3578762714,3578762717,3
3,1502,42987,3578762714,3578762719,5
3,1502,42988,3578762714,3578762722,8
3,1502,42989,3578762714,3578762722,8
3,1502,42990,3578762714,3578762729,15
3,1502,42991,3578762714,3578762732,18
3,1502,42992,3578762714,3578762735,21
3,1502,42993,3578762714,3578762736,22
3,1502,42994,3578762714,3578762739,25
3,1502,42995,3578762714,3578762741,27
3,1502,42996,3578762714,3578762742,28
3,1502,42997,3578762714,3578762745,31
3,1502,42998,3578762714,3578762746,32
3,1502,42999,3578762714,3578762749,35
3,1502,43000,3578762714,3578762749,35
3,1502,43001,3578762714,3578762752,38
3,1502,43002,3578762714,3578762753,39
3,1502,43003,3578762714,3578762755,41
3,1502,43004,3578762714,3578762756,42
3,1502,43005,3578762714,3578762760,46
3,1503,43006,3578762778,3578762778,0
3,1503,43007,3578762778,3578762778,0
3,1503,43008,3578762778,3578762778,0
3,1503,43009,3578762778,3578762778,0
3,1503,43010,3578762778,3578762778,0
3,1503,43011,3578762778,3578762778,0
3,1503,43012,3578762778,3578762778,0
3,1503,43013,3578762778,3578762778,0
3,1503,43014,3578762778,3578762778,0
3,1503,43015,3578762778,3578762778,0
3,1503,43016,3578762778,3578762778,0
3,1503,43017,3578762778,3578762778,0
3,1503,43018,3578762778,3578762778,0
3,1503,43019,3578762778,3578762780,2
3,1503,43020,3578762778,3578762782,4
3,1503,43021,3578762778,3578762783,5
3,1503,43022,3578762778,3578762785,7
3,1503,43023,3578762778,3578762787,9
3,1503,43024,3578762778,3578762787,9
3,1503,43025,3578762778,3578762791,13
3,1503,43026,3578762778,3578762793,15
3,1503,43027,3578762778,3578762793,15
3,1503,43028,3578762778,3578762794,16
3,1503,43029,3578762778,3578762796,18
3,1503,43030,3578762778,3578762799,21
3,1503,43031,3578762778,3578762802,24
3,1503,43032,3578762778,3578762803,25
3,1503,43033,3578762778,3578762804,26
3,1503,43034,3578762778,3578762805,27
3,1503,43035,3578762778,3578762805,27
3,1503,43036,3578762778,3578762805,27
3,1503,43037,3578762778,3578762806,28
3,1503,43038,3578762778,3578762807,29
3,1503,43039,3578762778,3578762807,29
3,1503,43040,3578762778,3578762810,32
3,1503,43041,3578762778,3578762815,37
3,1503,43042,3578762778,3578762815,37
3,1503,43043,3578762778,3578762820,42
3,1503,43044,3578762778,3578762821,43
3,1503,43045,3578762778,3578762824,46
3,1503,43046,3578762778,3578762824,46
3,1503,43047,3578762778,3578762826,48
3,1503,43048,3578762778,3578762827,49
3,1503,43049,3578762778,3578762827,49
3,1504,43050,3578762844,3578762845,1
3,1504,43051,3578762844,3578762845,1
3,1504,43052,3578762844,3578762845,1
3,1504,43053,3578762844,3578762845,1
3,1504,43054,3578762844,3578762845,1
3,1504,43055,3578762844,3578762845,1
3,1504,43056,3578762844,3578762845,1
3,1504,43057,3578762844,3578762845,1
3,1504,43058,3578762844,3578762845,1
3,1504,43059,3578762844,3578762845,1
3,1504,43060,3578762844,3578762845,1
3,1504,43061,3578762844,3578762847,3
3,1504,43062,3578762844,3578762851,7
3,1504,43063,3578762844,3578762853,9
3,1504,43064,3578762844,3578762856,12
3,1504,43065,3578762844,3578762858,14
3,1504,43066,3578762844,3578762858,14
3,1504,43067,3578762844,3578762861,17
3,1504,43068,3578762844,3578762863,19
3,1504,43069,3578762844,3578762869,25
3,1504,43070,3578762844,3578762878,34
3,1504,43071,3578762844,3578762881,37
3,1504,43072,3578762844,3578762883,39
3,1504,43073,3578762844,3578762884,40
3,1504,43074,3578762844,3578762885,41
3,1504,43075,3578762844,3578762886,42
3,1504,43076,3578762844,3578762887,43
3,1504,43077,3578762844,3578762890,46
3,1504,43078,3578762844,3578762892,48
3,1505,43079,3578762909,3578762909,0
3,1505,43080,3578762909,3578762909,0
3,1505,43081,3578762909,3578762909,0
3,1505,43082,3578762909,3578762909,0
3,1505,43083,3578762909,3578762909,0
3,1505,43084,3578762909,3578762909,0
3,1505,43085,3578762909,3578762909,0
3,1505,43086,3578762909,3578762909,0
3,1505,43087,3578762909,3578762909,0
3,1505,43088,3578762909,3578762910,1
3,1505,43089,3578762909,3578762914,5
3,1505,43090,3578762909,3578762914,5
3,1505,43091,3578762909,3578762914,5
3,1505,43092,3578762909,3578762914,5
3,1505,43093,3578762909,3578762918,9
3,1505,43094,3578762909,3578762918,9
3,1505,43095,3578762909,3578762920,11
3,1505,43096,3578762909,3578762922,13
3,1505,43097,3578762909,3578762922,13
3,1505,43098,3578762909,3578762929,20
3,1505,43099,3578762909,3578762931,22
3,1505,43100,3578762909,3578762937,28
3,1505,43101,3578762909,3578762939,30
3,1505,43102,3578762909,3578762940,31
3,1505,43103,3578762909,3578762942,33
3,1505,43104,3578762909,3578762945,36
3,1505,43105,3578762909,3578762946,37
3,1505,43106,3578762909,3578762949,40
3,1505,43107,3578762909,3578762952,43
3,1505,43108,3578762909,3578762953,44
3,1505,43109,3578762909,3578762955,46
3,1505,43110,3578762909,3578762956,47
3,1506,43111,3578762974,3578762974,0
3,1506,43112,3578762974,3578762974,0
3,1506,43113,3578762974,3578762974,0
3,1506,43114,3578762974,3578762974,0
3,1506,43115,3578762974,3578762974,0
3,1506,43116,3578762974,3578762974,0
3,1506,43117,3578762974,3578762974,0
3,1506,43118,3578762974,3578762974,0
3,1506,43119,3578762974,3578762974,0
3,1506,43120,3578762974,3578762974,0
3,1506,43121,3578762974,3578762976,2
3,1506,43122,3578762974,3578762979,5
3,1506,43123,3578762974,3578762979,5
3,1506,43124,3578762974,3578762982,8
3,1506,43125,3578762974,3578762982,8
3,1506,43126,3578762974,3578762983,9
3,1506,43127,3578762974,3578762986,12
3,1506,43128,3578762974,3578762987,13
3,1506,43129,3578762974,3578762987,13
3,1506,43130,3578762974,3578762991,17
3,1506,43131,3578762974,3578762993,19
3,1506,43132,3578762974,3578762993,19
3,1506,43133,3578762974,3578762994,20
3,1506,43134,3578762974,3578762995,21
3,1506,43135,3578762974,3578762999,25
3,1506,43136,3578762974,3578763003,29
3,1506,43137,3578762974,3578763003,29
3,1506,43138,3578762974,3578763005,31
3,1506,43139,3578762974,3578763005,31
3,1506,43140,3578762974,3578763006,32
3,1506,43141,3578762974,3578763006,32
3,1506,43142,3578762974,3578763007,33
3,1506,43143,3578762974,3578763008,34
3,1506,43144,3578762974,3578763009,35
3,1506,43145,3578762974,3578763010,36
3,1506,43146,3578762974,3578763015,41
3,1506,43147,3578762974,3578763016,42
3,1506,43148,3578762974,3578763020,46
3,1506,43149,3578762974,3578763022,48
3,1506,43150,3578762974,3578763024,50
3,1507,43151,3578763038,3578763038,0
3,1507,43152,3578763038,3578763038,0
3,1507,43153,3578763038,3578763038,0
3,1507,43154,3578763038,3578763038,0
3,1507,43155,3578763038,3578763038,0
3,1507,43156,3578763038,3578763038,0
3,1507,43157,3578763038,3578763038,0
3,1507,43158,3578763038,3578763038,0
3,1507,43159,3578763038,3578763038,0
3,1507,43160,3578763038,3578763038,0
3,1507,43161,3578763038,3578763040,2
3,1507,43162,3578763038,3578763043,5
3,1507,43163,3578763038,3578763044,6
3,1507,43164,3578763038,3578763044,6
3,1507,43165,3578763038,3578763047,9
3,1507,43166,3578763038,3578763051,13
3,1507,43167,3578763038,3578763053,15
3,1507,43168,3578763038,3578763058,20
3,1507,43169,3578763038,3578763058,20
3,1507,43170,3578763038,3578763061,23
3,1507,43171,3578763038,3578763064,26
3,1507,43172,3578763038,3578763069,31
3,1507,43173,3578763038,3578763078,40
3,1507,43174,3578763038,3578763081,43
3,1507,43175,3578763038,3578763083,45
3,1507,43176,3578763038,3578763084,46
3,1507,43177,3578763038,3578763085,47
3,1507,43178,3578763038,3578763087,49
3,1508,43179,3578763103,3578763103,0
3,1508,43180,3578763103,3578763103,0
3,1508,43181,3578763103,3578763103,0
3,1508,43182,3578763103,3578763103,0
3,1508,43183,3578763103,3578763103,0
3,1508,43184,3578763103,3578763103,0
3,1508,43185,3578763103,3578763103,0
3,1508,43186,3578763103,3578763103,0
3,1508,43187,3578763103,3578763103,0
3,1508,43188,3578763103,3578763106,3
3,1508,43189,3578763103,3578763109,6
3,1508,43190,3578763103,3578763110,7
3,1508,43191,3578763103,3578763113,10
3,1508,43192,3578763103,3578763114,11
3,1508,43193,3578763103,3578763115,12
3,1508,43194,3578763103,3578763116,13
3,1508,43195,3578763103,3578763117,14
3,1508,43196,3578763103,3578763118,15
3,1508,43197,3578763103,3578763120,17
3,1508,43198,3578763103,3578763121,18
3,1508,43199,3578763103,3578763122,19
3,1508,43200,3578763103,3578763122,19
3,1508,43201,3578763103,3578763129,26
3,1508,43202,3578763103,3578763132,29
3,1508,43203,3578763103,3578763136,33
3,1508,43204,3578763103,3578763136,33
3,1508,43205,3578763103,3578763139,36
3,1508,43206,3578763103,3578763141,38
3,1508,43207,3578763103,3578763142,39
3,1508,43208,3578763103,3578763144,41
3,1508,43209,3578763103,3578763146,43
3,1508,43210,3578763103,3578763149,46
3,1508,43211,3578763103,3578763152,49
3,1509,43212,3578763168,3578763168,0
3,1509,43213,3578763168,3578763168,0
3,1509,43214,3578763168,3578763168,0
3,1509,43215,3578763168,3578763168,0
3,1509,43216,3578763168,3578763168,0
3,1509,43217,3578763168,3578763168,0
3,1509,43218,3578763168,3578763168,0
3,1509,43219,3578763168,3578763168,0
3,1509,43220,3578763168,3578763168,0
3,1509,43221,3578763168,3578763168,0
3,1509,43222,3578763168,3578763168,0
3,1509,43223,3578763168,3578763170,2
3,1509,43224,3578763168,3578763171,3
3,1509,43225,3578763168,3578763173,5
3,1509,43226,3578763168,3578763173,5
3,1509,43227,3578763168,3578763176,8
3,1509,43228,3578763168,3578763179,11
3,1509,43229,3578763168,3578763180,12
3,1509,43230,3578763168,3578763182,14
3,1509,43231,3578763168,3578763183,15
3,1509,43232,3578763168,3578763184,16
3,1509,43233,3578763168,3578763187,19
3,1509,43234,3578763168,3578763187,19
3,1509,43235,3578763168,3578763187,19
3,1509,43236,3578763168,3578763189,21
3,1509,43237,3578763168,3578763190,22
3,1509,43238,3578763168,3578763194,26
3,1509,43239,3578763168,3578763194,26
3,1509,43240,3578763168,3578763194,26
3,1509,43241,3578763168,3578763196,28
3,1509,43242,3578763168,3578763199,31
3,1509,43243,3578763168,3578763202,34
3,1509,43244,3578763168,3578763204,36
3,1509,43245,3578763168,3578763207,39
3,1509,43246,3578763168,3578763207,39
3,1509,43247,3578763168,3578763208,40
3,1509,43248,3578763168,3578763208,40
3,1509,43249,3578763168,3578763209,41
3,1509,43250,3578763168,3578763211,43
3,1509,43251,3578763168,3578763214,46
3,1509,43252,3578763168,3578763216,48
3,1510,43253,3578763234,3578763234,0
3,1510,43254,3578763234,3578763234,0
3,1510,43255,3578763234,3578763234,0
3,1510,43256,3578763234,3578763234,0
3,1510,43257,3578763234,3578763234,0
3,1510,43258,3578763234,3578763234,0
3,1510,43259,3578763234,3578763234,0
3,1510,43260,3578763234,3578763234,0
3,1510,43261,3578763234,3578763234,0
3,1510,43262,3578763234,3578763234,0
3,1510,43263,3578763234,3578763235,1
3,1510,43264,3578763234,3578763236,2
3,1510,43265,3578763234,3578763238,4
3,1510,43266,3578763234,3578763240,6
3,1510,43267,3578763234,3578763243,9
3,1510,43268,3578763234,3578763244,10
3,1510,43269,3578763234,3578763245,11
3,1510,43270,3578763234,3578763247,13
3,1510,43271,3578763234,3578763251,17
3,1510,43272,3578763234,3578763253,19
3,1510,43273,3578763234,3578763256,22
3,1510,43274,3578763234,3578763257,23
3,1510,43275,3578763234,3578763257,23
3,1510,43276,3578763234,3578763261,27
3,1510,43277,3578763234,3578763264,30
3,1510,43278,3578763234,3578763269,35
3,1510,43279,3578763234,3578763282,48
3,1510,43280,3578763234,3578763284,50
3,1511,43281,3578763298,3578763298,0
3,1511,43282,3578763298,3578763298,0
3,1511,43283,3578763298,3578763298,0
3,1511,43284,3578763298,3578763298,0
3,1511,43285,3578763298,3578763298,0
3,1511,43286,3578763298,3578763298,0
3,1511,43287,3578763298,3578763298,0
3,1511,43288,3578763298,3578763298,0
3,1511,43289,3578763298,3578763298,0
3,1511,43290,3578763298,3578763298,0
3,1511,43291,3578763298,3578763299,1
3,1511,43292,3578763298,3578763303,5
3,1511,43293,3578763298,3578763307,9
3,1511,43294,3578763298,3578763307,9
3,1511,43295,3578763298,3578763308,10
3,1511,43296,3578763298,3578763310,12
3,1511,43297,3578763298,3578763313,15
3,1511,43298,3578763298,3578763314,16
3,1511,43299,3578763298,3578763314,16
3,1511,43300,3578763298,3578763315,17
3,1511,43301,3578763298,3578763317,19
3,1511,43302,3578763298,3578763317,19
3,1511,43303,3578763298,3578763318,20
3,1511,43304,3578763298,3578763321,23
3,1511,43305,3578763298,3578763321,23
3,1511,43306,3578763298,3578763322,24
3,1511,43307,3578763298,3578763323,25
3,1511,43308,3578763298,3578763332,34
3,1511,43309,3578763298,3578763336,38
3,1511,43310,3578763298,3578763336,38
3,1511,43311,3578763298,3578763339,41
3,1511,43312,3578763298,3578763342,44
3,1511,43313,3578763298,3578763343,45
3,1511,43314,3578763298,3578763346,48
3,1511,43315,3578763298,3578763346,48
3,1512,43316,3578763362,3578763362,0
3,1512,43317,3578763362,3578763362,0
3,1512,43318,3578763362,3578763362,0
3,1512,43319,3578763362,3578763362,0
3,1512,43320,3578763362,3578763362,0
3,1512,43321,3578763362,3578763365,3
3,1512,43322,3578763362,3578763367,5
3,1512,43323,3578763362,3578763368,6
3,1512,43324,3578763362,3578763368,6
3,1512,43325,3578763362,3578763369,7
3,1512,43326,3578763362,3578763369,7
3,1512,43327,3578763362,3578763369,7
3,1512,43328,3578763362,3578763371,9
3,1512,43329,3578763362,3578763373,11
3,1512,43330,3578763362,3578763373,11
3,1512,43331,3578763362,3578763377,15
3,1512,43332,3578763362,3578763379,17
3,1512,43333,3578763362,3578763379,17
3,1512,43334,3578763362,3578763382,20
3,1512,43335,3578763362,3578763382,20
3,1512,43336,3578763362,3578763386,24
3,1512,43337,3578763362,3578763387,25
3,1512,43338,3578763362,3578763387,25
3,1512,43339,3578763362,3578763389,27
3,1512,43340,3578763362,3578763391,29
3,1512,43341,3578763362,3578763393,31
3,1512,43342,3578763362,3578763394,32
3,1512,43343,3578763362,3578763394,32
3,1512,43344,3578763362,3578763396,34
3,1512,43345,3578763362,3578763399,37
3,1512,43346,3578763362,3578763402,40
3,1512,43347,3578763362,3578763405,43
3,1512,43348,3578763362,3578763406,44
3,1512,43349,3578763362,3578763406,44
3,1512,43350,3578763362,3578763406,44
3,1512,43351,3578763362,3578763407,45
3,1512,43352,3578763362,3578763408,46
3,1512,43353,3578763362,3578763408,46
3,1512,43354,3578763362,3578763410,48
3,1512,43355,3578763362,3578763410,48
3,1513,43356,3578763425,3578763425,0
3,1513,43357,3578763425,3578763425,0
3,1513,43358,3578763425,3578763425,0
3,1513,43359,3578763425,3578763425,0
3,1513,43360,3578763425,3578763425,0
3,1513,43361,3578763425,3578763426,1
3,1513,43362,3578763425,3578763427,2
3,1513,43363,3578763425,3578763428,3
3,1513,43364,3578763425,3578763432,7
3,1513,43365,3578763425,3578763433,8
3,1513,43366,3578763425,3578763434,9
3,1513,43367,3578763425,3578763435,10
3,1513,43368,3578763425,3578763436,11
3,1513,43369,3578763425,3578763438,13
3,1513,43370,3578763425,3578763441,16
3,1513,43371,3578763425,3578763443,18
3,1513,43372,3578763425,3578763444,19
3,1513,43373,3578763425,3578763445,20
3,1513,43374,3578763425,3578763446,21
3,1513,43375,3578763425,3578763451,26
3,1513,43376,3578763425,3578763453,28
3,1513,43377,3578763425,3578763457,32
3,1513,43378,3578763425,3578763458,33
3,1513,43379,3578763425,3578763459,34
3,1513,43380,3578763425,3578763461,36
3,1513,43381,3578763425,3578763469,44
3,1514,43382,3578763490,3578763490,0
3,1514,43383,3578763490,3578763490,0
3,1514,43384,3578763490,3578763490,0
3,1514,43385,3578763490,3578763490,0
3,1514,43386,3578763490,3578763490,0
3,1514,43387,3578763490,3578763490,0
3,1514,43388,3578763490,3578763490,0
3,1514,43389,3578763490,3578763490,0
3,1514,43390,3578763490,3578763491,1
3,1514,43391,3578763490,3578763491,1
3,1514,43392,3578763490,3578763494,4
3,1514,43393,3578763490,3578763495,5
3,1514,43394,3578763490,3578763496,6
3,1514,43395,3578763490,3578763498,8
3,1514,43396,3578763490,3578763502,12
3,1514,43397,3578763490,3578763505,15
3,1514,43398,3578763490,3578763506,16
3,1514,43399,3578763490,3578763507,17
3,1514,43400,3578763490,3578763509,19
3,1514,43401,3578763490,3578763513,23
3,1514,43402,3578763490,3578763513,23
3,1514,43403,3578763490,3578763514,24
3,1514,43404,3578763490,3578763514,24
3,1514,43405,3578763490,3578763515,25
3,1514,43406,3578763490,3578763517,27
3,1514,43407,3578763490,3578763518,28
3,1514,43408,3578763490,3578763520,30
3,1514,43409,3578763490,3578763521,31
3,1514,43410,3578763490,3578763521,31
3,1514,43411,3578763490,3578763522,32
3,1514,43412,3578763490,3578763531,41
3,1514,43413,3578763490,3578763535,45
3,1514,43414,3578763490,3578763537,47
3,1515,43415,3578763555,3578763555,0
3,1515,43416,3578763555,3578763555,0
3,1515,43417,3578763555,3578763555,0
3,1515,43418,3578763555,3578763555,0
3,1515,43419,3578763555,3578763555,0
3,1515,43420,3578763555,3578763555,0
3,1515,43421,3578763555,3578763556,1
3,1515,43422,3578763555,3578763559,4
3,1515,43423,3578763555,3578763565,10
3,1515,43424,3578763555,3578763567,12
3,1515,43425,3578763555,3578763568,13
3,1515,43426,3578763555,3578763568,13
3,1515,43427,3578763555,3578763569,14
3,1515,43428,3578763555,3578763569,14
3,1515,43429,3578763555,3578763569,14
3,1515,43430,3578763555,3578763570,15
3,1515,43431,3578763555,3578763572,17
3,1515,43432,3578763555,3578763573,18
3,1515,43433,3578763555,3578763575,20
3,1515,43434,3578763555,3578763578,23
3,1515,43435,3578763555,3578763578,23
3,1515,43436,3578763555,3578763581,26
3,1515,43437,3578763555,3578763582,27
3,1515,43438,3578763555,3578763582,27
3,1515,43439,3578763555,3578763585,30
3,1515,43440,3578763555,3578763586,31
3,1515,43441,3578763555,3578763587,32
3,1515,43442,3578763555,3578763587,32
3,1515,43443,3578763555,3578763590,35
3,1515,43444,3578763555,3578763592,37
3,1515,43445,3578763555,3578763593,38
3,1515,43446,3578763555,3578763593,38
3,1515,43447,3578763555,3578763595,40
3,1515,43448,3578763555,3578763599,44
3,1515,43449,3578763555,3578763602,47
3,1515,43450,3578763555,3578763604,49
3,1515,43451,3578763555,3578763605,50
3,1516,43452,3578763619,3578763619,0
3,1516,43453,3578763619,3578763619,0
3,1516,43454,3578763619,3578763619,0
3,1516,43455,3578763619,3578763619,0
3,1516,43456,3578763619,3578763619,0
3,1516,43457,3578763619,3578763619,0
3,1516,43458,3578763619,3578763619,0
3,1516,43459,3578763619,3578763619,0
3,1516,43460,3578763619,3578763619,0
3,1516,43461,3578763619,3578763620,1
3,1516,43462,3578763619,3578763623,4
3,1516,43463,3578763619,3578763624,5
3,1516,43464,3578763619,3578763626,7
3,1516,43465,3578763619,3578763626,7
3,1516,43466,3578763619,3578763626,7
3,1516,43467,3578763619,3578763628,9
3,1516,43468,3578763619,3578763631,12
3,1516,43469,3578763619,3578763632,13
3,1516,43470,3578763619,3578763633,14
3,1516,43471,3578763619,3578763634,15
3,1516,43472,3578763619,3578763635,16
3,1516,43473,3578763619,3578763638,19
3,1516,43474,3578763619,3578763639,20
3,1516,43475,3578763619,3578763643,24
3,1516,43476,3578763619,3578763644,25
3,1516,43477,3578763619,3578763646,27
3,1516,43478,3578763619,3578763650,31
3,1516,43479,3578763619,3578763654,35
3,1516,43480,3578763619,3578763656,37
3,1516,43481,3578763619,3578763658,39
3,1516,43482,3578763619,3578763661,42
3,1516,43483,3578763619,3578763663,44
3,1516,43484,3578763619,3578763668,49
3,1517,43485,3578763683,3578763683,0
3,1517,43486,3578763683,3578763683,0
3,1517,43487,3578763683,3578763683,0
3,1517,43488,3578763683,3578763684,1
3,1517,43489,3578763683,3578763684,1
3,1517,43490,3578763683,3578763685,2
3,1517,43491,3578763683,3578763686,3
3,1517,43492,3578763683,3578763688,5
3,1517,43493,3578763683,3578763691,8
3,1517,43494,3578763683,3578763691,8
3,1517,43495,3578763683,3578763694,11
3,1517,43496,3578763683,3578763695,12
3,1517,43497,3578763683,3578763695,12
3,1517,43498,3578763683,3578763696,13
3,1517,43499,3578763683,3578763698,15
3,1517,43500,3578763683,3578763703,20
3,1517,43501,3578763683,3578763705,22
3,1517,43502,3578763683,3578763706,23
3,1517,43503,3578763683,3578763707,24
3,1517,43504,3578763683,3578763710,27
3,1517,43505,3578763683,3578763712,29
3,1517,43506,3578763683,3578763714,31
3,1517,43507,3578763683,3578763715,32
3,1517,43508,3578763683,3578763715,32
3,1517,43509,3578763683,3578763716,33
3,1517,43510,3578763683,3578763717,34
3,1517,43511,3578763683,3578763718,35
3,1517,43512,3578763683,3578763720,37
3,1517,43513,3578763683,3578763720,37
3,1517,43514,3578763683,3578763721,38
3,1517,43515,3578763683,3578763723,40
3,1517,43516,3578763683,3578763731,48
3,1518,43517,3578763747,3578763747,0
3,1518,43518,3578763747,3578763747,0
3,1518,43519,3578763747,3578763747,0
3,1518,43520,3578763747,3578763747,0
3,1518,43521,3578763747,3578763747,0
3,1518,43522,3578763747,3578763747,0
3,1518,43523,3578763747,3578763750,3
3,1518,43524,3578763747,3578763752,5
3,1518,43525,3578763747,3578763753,6
3,1518,43526,3578763747,3578763756,9
3,1518,43527,3578763747,3578763757,10
3,1518,43528,3578763747,3578763761,14
3,1518,43529,3578763747,3578763765,18
3,1518,43530,3578763747,3578763766,19
3,1518,43531,3578763747,3578763768,21
3,1518,43532,3578763747,3578763768,21
3,1518,43533,3578763747,3578763768,21
3,1518,43534,3578763747,3578763768,21
3,1518,43535,3578763747,3578763769,22
3,1518,43536,3578763747,3578763771,24
3,1518,43537,3578763747,3578763772,25
3,1518,43538,3578763747,3578763773,26
3,1518,43539,3578763747,3578763776,29
3,1518,43540,3578763747,3578763778,31
3,1518,43541,3578763747,3578763782,35
3,1518,43542,3578763747,3578763783,36
3,1518,43543,3578763747,3578763786,39
3,1518,43544,3578763747,3578763786,39
3,1518,43545,3578763747,3578763787,40
3,1518,43546,3578763747,3578763788,41
3,1518,43547,3578763747,3578763790,43
3,1518,43548,3578763747,3578763792,45
3,1518,43549,3578763747,3578763793,46
3,1518,43550,3578763747,3578763794,47
3,1518,43551,3578763747,3578763796,49
3,1519,43552,3578763812,3578763812,0
3,1519,43553,3578763812,3578763812,0
3,1519,43554,3578763812,3578763812,0
3,1519,43555,3578763812,3578763812,0
3,1519,43556,3578763812,3578763812,0
3,1519,43557,3578763812,3578763812,0
3,1519,43558,3578763812,3578763812,0
3,1519,43559,3578763812,3578763812,0
3,1519,43560,3578763812,3578763812,0
3,1519,43561,3578763812,3578763812,0
3,1519,43562,3578763812,3578763812,0
3,1519,43563,3578763812,3578763815,3
3,1519,43564,3578763812,3578763816,4
3,1519,43565,3578763812,3578763820,8
3,1519,43566,3578763812,3578763823,11
3,1519,43567,3578763812,3578763824,12
3,1519,43568,3578763812,3578763826,14
3,1519,43569,3578763812,3578763826,14
3,1519,43570,3578763812,3578763827,15
3,1519,43571,3578763812,3578763828,16
3,1519,43572,3578763812,3578763831,19
3,1519,43573,3578763812,3578763832,20
3,1519,43574,3578763812,3578763833,21
3,1519,43575,3578763812,3578763834,22
3,1519,43576,3578763812,3578763835,23
3,1519,43577,3578763812,3578763838,26
3,1519,43578,3578763812,3578763839,27
3,1519,43579,3578763812,3578763843,31
3,1519,43580,3578763812,3578763843,31
3,1519,43581,3578763812,3578763844,32
3,1519,43582,3578763812,3578763847,35
3,1519,43583,3578763812,3578763850,38
3,1519,43584,3578763812,3578763854,42
3,1519,43585,3578763812,3578763856,44
3,1519,43586,3578763812,3578763858,46
3,1519,43587,3578763812,3578763858,46
3,1519,43588,3578763812,3578763861,49
3,1520,43589,3578763876,3578763876,0
3,1520,43590,3578763876,3578763876,0
3,1520,43591,3578763876,3578763879,3
3,1520,43592,3578763876,3578763881,5
3,1520,43593,3578763876,3578763883,7
3,1520,43594,3578763876,3578763884,8
3,1520,43595,3578763876,3578763884,8
3,1520,43596,3578763876,3578763885,9
3,1520,43597,3578763876,3578763886,10
3,1520,43598,3578763876,3578763888,12
3,1520,43599,3578763876,3578763891,15
3,1520,43600,3578763876,3578763892,16
3,1520,43601,3578763876,3578763895,19
3,1520,43602,3578763876,3578763895,19
3,1520,43603,3578763876,3578763895,19
3,1520,43604,3578763876,3578763896,20
3,1520,43605,3578763876,3578763898,22
3,1520,43606,3578763876,3578763902,26
3,1520,43607,3578763876,3578763905,29
3,1520,43608,3578763876,3578763907,31
3,1520,43609,3578763876,3578763907,31
3,1520,43610,3578763876,3578763912,36
3,1520,43611,3578763876,3578763914,38
3,1520,43612,3578763876,3578763914,38
3,1520,43613,3578763876,3578763915,39
3,1520,43614,3578763876,3578763917,41
3,1520,43615,3578763876,3578763919,43
3,1520,43616,3578763876,3578763920,44
3,1520,43617,3578763876,3578763921,45
3,1520,43618,3578763876,3578763921,45
3,1520,43619,3578763876,3578763922,46
3,1521,43620,3578763940,3578763940,0
3,1521,43621,3578763940,3578763940,0
3,1521,43622,3578763940,3578763940,0
3,1521,43623,3578763940,3578763940,0
3,1521,43624,3578763940,3578763940,0
3,1521,43625,3578763940,3578763942,2
3,1521,43626,3578763940,3578763945,5
3,1521,43627,3578763940,3578763946,6
3,1521,43628,3578763940,3578763949,9
3,1521,43629,3578763940,3578763952,12
3,1521,43630,3578763940,3578763953,13
3,1521,43631,3578763940,3578763956,16
3,1521,43632,3578763940,3578763957,17
3,1521,43633,3578763940,3578763960,20
3,1521,43634,3578763940,3578763965,25
3,1521,43635,3578763940,3578763967,27
3,1521,43636,3578763940,3578763968,28
3,1521,43637,3578763940,3578763968,28
3,1521,43638,3578763940,3578763968,28
3,1521,43639,3578763940,3578763968,28
3,1521,43640,3578763940,3578763969,29
3,1521,43641,3578763940,3578763971,31
3,1521,43642,3578763940,3578763971,31
3,1521,43643,3578763940,3578763974,34
3,1521,43644,3578763940,3578763975,35
3,1521,43645,3578763940,3578763979,39
3,1521,43646,3578763940,3578763979,39
3,1521,43647,3578763940,3578763982,42
3,1521,43648,3578763940,3578763984,44
3,1521,43649,3578763940,3578763986,46
3,1521,43650,3578763940,3578763987,47
3,1521,43651,3578763940,3578763988,48
3,1521,43652,3578763940,3578763990,50
3,1522,43653,3578764019,3578764019,0
3,1522,43654,3578764019,3578764019,0
3,1522,43655,3578764019,3578764019,0
3,1522,43656,3578764019,3578764019,0
3,1522,43657,3578764019,3578764019,0
3,1522,43658,3578764019,3578764019,0
3,1522,43659,3578764019,3578764019,0
3,1522,43660,3578764019,3578764019,0
3,1522,43661,3578764019,3578764019,0
3,1522,43662,3578764019,3578764019,0
3,1522,43663,3578764019,3578764019,0
3,1522,43664,3578764019,3578764019,0
3,1522,43665,3578764019,3578764019,0
3,1522,43666,3578764019,3578764019,0
3,1522,43667,3578764019,3578764019,0
3,1522,43668,3578764019,3578764019,0
3,1522,43669,3578764019,3578764019,0
3,1522,43670,3578764019,3578764021,2
3,1522,43671,3578764019,3578764024,5
3,1522,43672,3578764019,3578764026,7
3,1522,43673,3578764019,3578764026,7
3,1522,43674,3578764019,3578764027,8
3,1522,43675,3578764019,3578764028,9
3,1522,43676,3578764019,3578764032,13
3,1522,43677,3578764019,3578764032,13
3,1522,43678,3578764019,3578764033,14
3,1522,43679,3578764019,3578764034,15
3,1522,43680,3578764019,3578764036,17
3,1522,43681,3578764019,3578764038,19
3,1522,43682,3578764019,3578764039,20
3,1522,43683,3578764019,3578764043,24
3,1522,43684,3578764019,3578764043,24
3,1522,43685,3578764019,3578764043,24
3,1522,43686,3578764019,3578764047,28
3,1522,43687,3578764019,3578764053,34
3,1522,43688,3578764019,3578764057,38
3,1522,43689,3578764019,3578764058,39
3,1522,43690,3578764019,3578764058,39
3,1522,43691,3578764019,3578764061,42
3,1522,43692,3578764019,3578764064,45
3,1522,43693,3578764019,3578764068,49
3,1523,43694,3578764083,3578764083,0
3,1523,43695,3578764083,3578764083,0
3,1523,43696,3578764083,3578764083,0
3,1523,43697,3578764083,3578764083,0
3,1523,43698,3578764083,3578764085,2
3,1523,43699,3578764083,3578764085,2
3,1523,43700,3578764083,3578764086,3
3,1523,43701,3578764083,3578764088,5
3,1523,43702,3578764083,3578764091,8
3,1523,43703,3578764083,3578764092,9
3,1523,43704,3578764083,3578764095,12
3,1523,43705,3578764083,3578764095,12
3,1523,43706,3578764083,3578764095,12
3,1523,43707,3578764083,3578764096,13
3,1523,43708,3578764083,3578764097,14
3,1523,43709,3578764083,3578764102,19
3,1523,43710,3578764083,3578764105,22
3,1523,43711,3578764083,3578764108,25
3,1523,43712,3578764083,3578764109,26
3,1523,43713,3578764083,3578764113,30
3,1523,43714,3578764083,3578764113,30
3,1523,43715,3578764083,3578764114,31
3,1523,43716,3578764083,3578764116,33
3,1523,43717,3578764083,3578764117,34
3,1523,43718,3578764083,3578764120,37
3,1523,43719,3578764083,3578764120,37
3,1523,43720,3578764083,3578764121,38
3,1523,43721,3578764083,3578764121,38
3,1523,43722,3578764083,3578764122,39
3,1523,43723,3578764083,3578764130,47
3,1523,43724,3578764083,3578764132,49
3,1524,43725,3578764147,3578764147,0
3,1524,43726,3578764147,3578764147,0
3,1524,43727,3578764147,3578764147,0
3,1524,43728,3578764147,3578764147,0
3,1524,43729,3578764147,3578764147,0
3,1524,43730,3578764147,3578764147,0
3,1524,43731,3578764147,3578764149,2
3,1524,43732,3578764147,3578764152,5
3,1524,43733,3578764147,3578764153,6
3,1524,43734,3578764147,3578764156,9
3,1524,43735,3578764147,3578764158,11
3,1524,43736,3578764147,3578764160,13
3,1524,43737,3578764147,3578764167,20
3,1524,43738,3578764147,3578764167,20
3,1524,43739,3578764147,3578764168,21
3,1524,43740,3578764147,3578764168,21
3,1524,43741,3578764147,3578764168,21
3,1524,43742,3578764147,3578764168,21
3,1524,43743,3578764147,3578764170,23
3,1524,43744,3578764147,3578764171,24
3,1524,43745,3578764147,3578764173,26
3,1524,43746,3578764147,3578764173,26
3,1524,43747,3578764147,3578764176,29
3,1524,43748,3578764147,3578764178,31
3,1524,43749,3578764147,3578764180,33
3,1524,43750,3578764147,3578764182,35
3,1524,43751,3578764147,3578764183,36
3,1524,43752,3578764147,3578764186,39
3,1524,43753,3578764147,3578764187,40
3,1524,43754,3578764147,3578764188,41
3,1524,43755,3578764147,3578764189,42
3,1524,43756,3578764147,3578764192,45
3,1524,43757,3578764147,3578764194,47
3,1524,43758,3578764147,3578764194,47
3,1524,43759,3578764147,3578764196,49
3,1525,43760,3578764211,3578764211,0
3,1525,43761,3578764211,3578764211,0
3,1525,43762,3578764211,3578764211,0
3,1525,43763,3578764211,3578764211,0
3,1525,43764,3578764211,3578764211,0
3,1525,43765,3578764211,3578764211,0
3,1525,43766,3578764211,3578764211,0
3,1525,43767,3578764211,3578764211,0
3,1525,43768,3578764211,3578764211,0
3,1525,43769,3578764211,3578764211,0
3,1525,43770,3578764211,3578764215,4
3,1525,43771,3578764211,3578764217,6
3,1525,43772,3578764211,3578764221,10
3,1525,43773,3578764211,3578764224,13
3,1525,43774,3578764211,3578764225,14
3,1525,43775,3578764211,3578764226,15
3,1525,43776,3578764211,3578764227,16
3,1525,43777,3578764211,3578764227,16
3,1525,43778,3578764211,3578764228,17
3,1525,43779,3578764211,3578764232,21
3,1525,43780,3578764211,3578764233,22
3,1525,43781,3578764211,3578764233,22
3,1525,43782,3578764211,3578764235,24
3,1525,43783,3578764211,3578764236,25
3,1525,43784,3578764211,3578764238,27
3,1525,43785,3578764211,3578764239,28
3,1525,43786,3578764211,3578764243,32
3,1525,43787,3578764211,3578764244,33
3,1525,43788,3578764211,3578764245,34
3,1525,43789,3578764211,3578764247,36
3,1525,43790,3578764211,3578764254,43
3,1525,43791,3578764211,3578764257,46
3,1525,43792,3578764211,3578764258,47
3,1525,43793,3578764211,3578764258,47
3,1526,43794,3578764274,3578764274,0
3,1526,43795,3578764274,3578764274,0
3,1526,43796,3578764274,3578764274,0
3,1526,43797,3578764274,3578764279,5
3,1526,43798,3578764274,3578764281,7
3,1526,43799,3578764274,3578764283,9
3,1526,43800,3578764274,3578764284,10
3,1526,43801,3578764274,3578764284,10
3,1526,43802,3578764274,3578764285,11
3,1526,43803,3578764274,3578764286,12
3,1526,43804,3578764274,3578764288,14
3,1526,43805,3578764274,3578764291,17
3,1526,43806,3578764274,3578764294,20
3,1526,43807,3578764274,3578764295,21
3,1526,43808,3578764274,3578764295,21
3,1526,43809,3578764274,3578764297,23
3,1526,43810,3578764274,3578764298,24
3,1526,43811,3578764274,3578764303,29
3,1526,43812,3578764274,3578764305,31
3,1526,43813,3578764274,3578764307,33
3,1526,43814,3578764274,3578764309,35
3,1526,43815,3578764274,3578764313,39
3,1526,43816,3578764274,3578764314,40
3,1526,43817,3578764274,3578764315,41
3,1526,43818,3578764274,3578764317,43
3,1526,43819,3578764274,3578764317,43
3,1526,43820,3578764274,3578764317,43
3,1526,43821,3578764274,3578764320,46
3,1526,43822,3578764274,3578764320,46
3,1526,43823,3578764274,3578764320,46
3,1526,43824,3578764274,3578764322,48
3,1527,43825,3578764340,3578764340,0
3,1527,43826,3578764340,3578764340,0
3,1527,43827,3578764340,3578764340,0
3,1527,43828,3578764340,3578764340,0
3,1527,43829,3578764340,3578764342,2
3,1527,43830,3578764340,3578764343,3
3,1527,43831,3578764340,3578764346,6
3,1527,43832,3578764340,3578764346,6
3,1527,43833,3578764340,3578764349,9
3,1527,43834,3578764340,3578764352,12
3,1527,43835,3578764340,3578764354,14
3,1527,43836,3578764340,3578764357,17
3,1527,43837,3578764340,3578764360,20
3,1527,43838,3578764340,3578764367,27
3,1527,43839,3578764340,3578764368,28
3,1527,43840,3578764340,3578764368,28
3,1527,43841,3578764340,3578764368,28
3,1527,43842,3578764340,3578764368,28
3,1527,43843,3578764340,3578764369,29
3,1527,43844,3578764340,3578764370,30
3,1527,43845,3578764340,3578764371,31
3,1527,43846,3578764340,3578764373,33
3,1527,43847,3578764340,3578764373,33
3,1527,43848,3578764340,3578764377,37
3,1527,43849,3578764340,3578764378,38
3,1527,43850,3578764340,3578764380,40
3,1527,43851,3578764340,3578764382,42
3,1527,43852,3578764340,3578764383,43
3,1527,43853,3578764340,3578764383,43
3,1527,43854,3578764340,3578764387,47
3,1527,43855,3578764340,3578764387,47
3,1527,43856,3578764340,3578764387,47
3,1527,43857,3578764340,3578764389,49
3,1528,43858,3578764404,3578764404,0
3,1528,43859,3578764404,3578764404,0
3,1528,43860,3578764404,3578764404,0
3,1528,43861,3578764404,3578764404,0
3,1528,43862,3578764404,3578764404,0
3,1528,43863,3578764404,3578764404,0
3,1528,43864,3578764404,3578764404,0
3,1528,43865,3578764404,3578764404,0
3,1528,43866,3578764404,3578764405,1
3,1528,43867,3578764404,3578764406,2
3,1528,43868,3578764404,3578764406,2
3,1528,43869,3578764404,3578764406,2
3,1528,43870,3578764404,3578764408,4
3,1528,43871,3578764404,3578764409,5
3,1528,43872,3578764404,3578764410,6
3,1528,43873,3578764404,3578764415,11
3,1528,43874,3578764404,3578764417,13
3,1528,43875,3578764404,3578764423,19
3,1528,43876,3578764404,3578764425,21
3,1528,43877,3578764404,3578764427,23
3,1528,43878,3578764404,3578764428,24
3,1528,43879,3578764404,3578764428,24
3,1528,43880,3578764404,3578764432,28
3,1528,43881,3578764404,3578764432,28
3,1528,43882,3578764404,3578764432,28
3,1528,43883,3578764404,3578764436,32
3,1528,43884,3578764404,3578764438,34
3,1528,43885,3578764404,3578764441,37
3,1528,43886,3578764404,3578764443,39
3,1528,43887,3578764404,3578764443,39
3,1528,43888,3578764404,3578764445,41
3,1528,43889,3578764404,3578764447,43
3,1528,43890,3578764404,3578764451,47
3,1528,43891,3578764404,3578764453,49
3,1529,43892,3578764468,3578764468,0
3,1529,43893,3578764468,3578764468,0
3,1529,43894,3578764468,3578764468,0
3,1529,43895,3578764468,3578764468,0
3,1529,43896,3578764468,3578764468,0
3,1529,43897,3578764468,3578764469,1
3,1529,43898,3578764468,3578764479,11
3,1529,43899,3578764468,3578764481,13
3,1529,43900,3578764468,3578764483,15
3,1529,43901,3578764468,3578764484,16
3,1529,43902,3578764468,3578764485,17
3,1529,43903,3578764468,3578764486,18
3,1529,43904,3578764468,3578764486,18
3,1529,43905,3578764468,3578764488,20
3,1529,43906,3578764468,3578764491,23
3,1529,43907,3578764468,3578764493,25
3,1529,43908,3578764468,3578764494,26
3,1529,43909,3578764468,3578764494,26
3,1529,43910,3578764468,3578764495,27
3,1529,43911,3578764468,3578764497,29
3,1529,43912,3578764468,3578764498,30
3,1529,43913,3578764468,3578764503,35
3,1529,43914,3578764468,3578764506,38
3,1529,43915,3578764468,3578764507,39
3,1529,43916,3578764468,3578764507,39
3,1529,43917,3578764468,3578764509,41
3,1529,43918,3578764468,3578764512,44
3,1529,43919,3578764468,3578764513,45
3,1529,43920,3578764468,3578764515,47
3,1529,43921,3578764468,3578764516,48
3,1529,43922,3578764468,3578764517,49
3,1529,43923,3578764468,3578764517,49
3,1530,43924,3578764532,3578764532,0
3,1530,43925,3578764532,3578764532,0
3,1530,43926,3578764532,3578764532,0
3,1530,43927,3578764532,3578764532,0
3,1530,43928,3578764532,3578764532,0
3,1530,43929,3578764532,3578764532,0
3,1530,43930,3578764532,3578764535,3
3,1530,43931,3578764532,3578764536,4
3,1530,43932,3578764532,3578764541,9
3,1530,43933,3578764532,3578764542,10
3,1530,43934,3578764532,3578764545,13
3,1530,43935,3578764532,3578764545,13
3,1530,43936,3578764532,3578764549,17
3,1530,43937,3578764532,3578764550,18
3,1530,43938,3578764532,3578764554,22
3,1530,43939,3578764532,3578764556,24
3,1530,43940,3578764532,3578764561,29
3,1530,43941,3578764532,3578764565,33
3,1530,43942,3578764532,3578764567,35
3,1530,43943,3578764532,3578764567,35
3,1530,43944,3578764532,3578764568,36
3,1530,43945,3578764532,3578764568,36
3,1530,43946,3578764532,3578764569,37
3,1530,43947,3578764532,3578764570,38
3,1530,43948,3578764532,3578764571,39
3,1530,43949,3578764532,3578764572,40
3,1530,43950,3578764532,3578764573,41
3,1530,43951,3578764532,3578764576,44
3,1530,43952,3578764532,3578764578,46
3,1530,43953,3578764532,3578764579,47
3,1531,43954,3578764598,3578764598,0
3,1531,43955,3578764598,3578764598,0
3,1531,43956,3578764598,3578764598,0
3,1531,43957,3578764598,3578764598,0
3,1531,43958,3578764598,3578764598,0
3,1531,43959,3578764598,3578764598,0
3,1531,43960,3578764598,3578764598,0
3,1531,43961,3578764598,3578764598,0
3,1531,43962,3578764598,3578764598,0
3,1531,43963,3578764598,3578764598,0
3,1531,43964,3578764598,3578764598,0
3,1531,43965,3578764598,3578764598,0
3,1531,43966,3578764598,3578764599,1
3,1531,43967,3578764598,3578764602,4
3,1531,43968,3578764598,3578764604,6
3,1531,43969,3578764598,3578764604,6
3,1531,43970,3578764598,3578764605,7
3,1531,43971,3578764598,3578764605,7
3,1531,43972,3578764598,3578764606,8
3,1531,43973,3578764598,3578764607,9
3,1531,43974,3578764598,3578764607,9
3,1531,43975,3578764598,3578764609,11
3,1531,43976,3578764598,3578764613,15
3,1531,43977,3578764598,3578764617,19
3,1531,43978,3578764598,3578764620,22
3,1531,43979,3578764598,3578764623,25
3,1531,43980,3578764598,3578764626,28
3,1531,43981,3578764598,3578764626,28
3,1531,43982,3578764598,3578764627,29
3,1531,43983,3578764598,3578764631,33
3,1531,43984,3578764598,3578764632,34
3,1531,43985,3578764598,3578764632,34
3,1531,43986,3578764598,3578764634,36
3,1531,43987,3578764598,3578764635,37
3,1531,43988,3578764598,3578764638,40
3,1531,43989,3578764598,3578764639,41
3,1531,43990,3578764598,3578764643,45
3,1531,43991,3578764598,3578764643,45
3,1531,43992,3578764598,3578764644,46
3,1531,43993,3578764598,3578764645,47
3,1531,43994,3578764598,3578764646,48
3,1532,43995,3578764663,3578764663,0
3,1532,43996,3578764663,3578764663,0
3,1532,43997,3578764663,3578764663,0
3,1532,43998,3578764663,3578764663,0
3,1532,43999,3578764663,3578764663,0
3,1532,44000,3578764663,3578764663,0
3,1532,44001,3578764663,3578764668,5
3,1532,44002,3578764663,3578764679,16
3,1532,44003,3578764663,3578764681,18
3,1532,44004,3578764663,3578764683,20
3,1532,44005,3578764663,3578764684,21
3,1532,44006,3578764663,3578764684,21
3,1532,44007,3578764663,3578764686,23
3,1532,44008,3578764663,3578764686,23
3,1532,44009,3578764663,3578764688,25
3,1532,44010,3578764663,3578764691,28
3,1532,44011,3578764663,3578764692,29
3,1532,44012,3578764663,3578764694,31
3,1532,44013,3578764663,3578764694,31
3,1532,44014,3578764663,3578764695,32
3,1532,44015,3578764663,3578764695,32
3,1532,44016,3578764663,3578764697,34
3,1532,44017,3578764663,3578764698,35
3,1532,44018,3578764663,3578764702,39
3,1532,44019,3578764663,3578764705,42
3,1532,44020,3578764663,3578764707,44
3,1532,44021,3578764663,3578764707,44
3,1532,44022,3578764663,3578764709,46
3,1533,44023,3578764727,3578764727,0
3,1533,44024,3578764727,3578764727,0
3,1533,44025,3578764727,3578764727,0
3,1533,44026,3578764727,3578764727,0
3,1533,44027,3578764727,3578764727,0
3,1533,44028,3578764727,3578764727,0
3,1533,44029,3578764727,3578764727,0
3,1533,44030,3578764727,3578764727,0
3,1533,44031,3578764727,3578764727,0
3,1533,44032,3578764727,3578764729,2
3,1533,44033,3578764727,3578764735,8
3,1533,44034,3578764727,3578764737,10
3,1533,44035,3578764727,3578764741,14
3,1533,44036,3578764727,3578764744,17
3,1533,44037,3578764727,3578764749,22
3,1533,44038,3578764727,3578764752,25
3,1533,44039,3578764727,3578764754,27
3,1533,44040,3578764727,3578764755,28
3,1533,44041,3578764727,3578764760,33
3,1533,44042,3578764727,3578764767,40
3,1533,44043,3578764727,3578764767,40
3,1533,44044,3578764727,3578764768,41
3,1533,44045,3578764727,3578764768,41
3,1533,44046,3578764727,3578764769,42
3,1533,44047,3578764727,3578764769,42
3,1533,44048,3578764727,3578764771,44
3,1533,44049,3578764727,3578764771,44
3,1533,44050,3578764727,3578764775,48
3,1534,44051,3578764791,3578764791,0
3,1534,44052,3578764791,3578764791,0
3,1534,44053,3578764791,3578764791,0
3,1534,44054,3578764791,3578764791,0
3,1534,44055,3578764791,3578764791,0
3,1534,44056,3578764791,3578764791,0
3,1534,44057,3578764791,3578764791,0
3,1534,44058,3578764791,3578764791,0
3,1534,44059,3578764791,3578764791,0
3,1534,44060,3578764791,3578764791,0
3,1534,44061,3578764791,3578764792,1
3,1534,44062,3578764791,3578764794,3
3,1534,44063,3578764791,3578764799,8
3,1534,44064,3578764791,3578764802,11
3,1534,44065,3578764791,3578764803,12
3,1534,44066,3578764791,3578764804,13
3,1534,44067,3578764791,3578764805,14
3,1534,44068,3578764791,3578764805,14
3,1534,44069,3578764791,3578764805,14
3,1534,44070,3578764791,3578764805,14
3,1534,44071,3578764791,3578764807,16
3,1534,44072,3578764791,3578764808,17
3,1534,44073,3578764791,3578764810,19
3,1534,44074,3578764791,3578764814,23
3,1534,44075,3578764791,3578764816,25
3,1534,44076,3578764791,3578764824,33
3,1534,44077,3578764791,3578764827,36
3,1534,44078,3578764791,3578764827,36
3,1534,44079,3578764791,3578764831,40
3,1534,44080,3578764791,3578764831,40
3,1534,44081,3578764791,3578764831,40
3,1534,44082,3578764791,3578764834,43
3,1534,44083,3578764791,3578764835,44
3,1534,44084,3578764791,3578764838,47
3,1534,44085,3578764791,3578764839,48
3,1535,44086,3578764855,3578764855,0
3,1535,44087,3578764855,3578764855,0
3,1535,44088,3578764855,3578764855,0
3,1535,44089,3578764855,3578764855,0
3,1535,44090,3578764855,3578764855,0
3,1535,44091,3578764855,3578764855,0
3,1535,44092,3578764855,3578764856,1
3,1535,44093,3578764855,3578764858,3
3,1535,44094,3578764855,3578764859,4
3,1535,44095,3578764855,3578764861,6
3,1535,44096,3578764855,3578764862,7
3,1535,44097,3578764855,3578764869,14
3,1535,44098,3578764855,3578764879,24
3,1535,44099,3578764855,3578764882,27
3,1535,44100,3578764855,3578764884,29
3,1535,44101,3578764855,3578764885,30
3,1535,44102,3578764855,3578764886,31
3,1535,44103,3578764855,3578764886,31
3,1535,44104,3578764855,3578764889,34
3,1535,44105,3578764855,3578764891,36
3,1535,44106,3578764855,3578764892,37
3,1535,44107,3578764855,3578764894,39
3,1535,44108,3578764855,3578764894,39
3,1535,44109,3578764855,3578764895,40
3,1535,44110,3578764855,3578764895,40
3,1535,44111,3578764855,3578764897,42
3,1535,44112,3578764855,3578764898,43
3,1535,44113,3578764855,3578764902,47
3,1536,44114,3578764919,3578764919,0
3,1536,44115,3578764919,3578764919,0
3,1536,44116,3578764919,3578764919,0
3,1536,44117,3578764919,3578764919,0
3,1536,44118,3578764919,3578764919,0
3,1536,44119,3578764919,3578764919,0
3,1536,44120,3578764919,3578764919,0
3,1536,44121,3578764919,3578764919,0
3,1536,44122,3578764919,3578764919,0
3,1536,44123,3578764919,3578764920,1
3,1536,44124,3578764919,3578764920,1
3,1536,44125,3578764919,3578764923,4
3,1536,44126,3578764919,3578764929,10
3,1536,44127,3578764919,3578764937,18
3,1536,44128,3578764919,3578764941,22
3,1536,44129,3578764919,3578764948,29
3,1536,44130,3578764919,3578764952,33
3,1536,44131,3578764919,3578764955,36
3,1536,44132,3578764919,3578764957,38
3,1536,44133,3578764919,3578764960,41
3,1536,44134,3578764919,3578764967,48
3,1536,44135,3578764919,3578764968,49
3,1536,44136,3578764919,3578764968,49
3,1536,44137,3578764919,3578764968,49
3,1536,44138,3578764919,3578764969,50
3,1537,44139,3578764983,3578764983,0
3,1537,44140,3578764983,3578764983,0
3,1537,44141,3578764983,3578764983,0
3,1537,44142,3578764983,3578764983,0
3,1537,44143,3578764983,3578764983,0
3,1537,44144,3578764983,3578764983,0
3,1537,44145,3578764983,3578764983,0
3,1537,44146,3578764983,3578764983,0
3,1537,44147,3578764983,3578764983,0
3,1537,44148,3578764983,3578764986,3
3,1537,44149,3578764983,3578764986,3
3,1537,44150,3578764983,3578764987,4
3,1537,44151,3578764983,3578764988,5
3,1537,44152,3578764983,3578764991,8
3,1537,44153,3578764983,3578764992,9
3,1537,44154,3578764983,3578764993,10
3,1537,44155,3578764983,3578764994,11
3,1537,44156,3578764983,3578764996,13
3,1537,44157,3578764983,3578764999,16
3,1537,44158,3578764983,3578765003,20
3,1537,44159,3578764983,3578765003,20
3,1537,44160,3578764983,3578765004,21
3,1537,44161,3578764983,3578765004,21
3,1537,44162,3578764983,3578765005,22
3,1537,44163,3578764983,3578765005,22
3,1537,44164,3578764983,3578765006,23
3,1537,44165,3578764983,3578765007,24
3,1537,44166,3578764983,3578765009,26
3,1537,44167,3578764983,3578765009,26
3,1537,44168,3578764983,3578765015,32
3,1537,44169,3578764983,3578765016,33
3,1537,44170,3578764983,3578765020,37
3,1537,44171,3578764983,3578765027,44
3,1537,44172,3578764983,3578765028,45
3,1537,44173,3578764983,3578765031,48
3,1537,44174,3578764983,3578765031,48
3,1537,44175,3578764983,3578765033,50
3,1538,44176,3578765046,3578765046,0
3,1538,44177,3578765046,3578765046,0
3,1538,44178,3578765046,3578765046,0
3,1538,44179,3578765046,3578765046,0
3,1538,44180,3578765046,3578765046,0
3,1538,44181,3578765046,3578765046,0
3,1538,44182,3578765046,3578765047,1
3,1538,44183,3578765046,3578765051,5
3,1538,44184,3578765046,3578765053,7
3,1538,44185,3578765046,3578765055,9
3,1538,44186,3578765046,3578765056,10
3,1538,44187,3578765046,3578765057,11
3,1538,44188,3578765046,3578765059,13
3,1538,44189,3578765046,3578765061,15
3,1538,44190,3578765046,3578765064,18
3,1538,44191,3578765046,3578765069,23
3,1538,44192,3578765046,3578765079,33
3,1538,44193,3578765046,3578765082,36
3,1538,44194,3578765046,3578765083,37
3,1538,44195,3578765046,3578765084,38
3,1538,44196,3578765046,3578765086,40
3,1538,44197,3578765046,3578765086,40
3,1538,44198,3578765046,3578765089,43
3,1538,44199,3578765046,3578765091,45
3,1538,44200,3578765046,3578765092,46
3,1538,44201,3578765046,3578765094,48
3,1538,44202,3578765046,3578765094,48
3,1538,44203,3578765046,3578765095,49
3,1538,44204,3578765046,3578765095,49
3,1539,44205,3578765111,3578765111,0
3,1539,44206,3578765111,3578765111,0
3,1539,44207,3578765111,3578765111,0
3,1539,44208,3578765111,3578765111,0
3,1539,44209,3578765111,3578765111,0
3,1539,44210,3578765111,3578765112,1
3,1539,44211,3578765111,3578765114,3
3,1539,44212,3578765111,3578765115,4
3,1539,44213,3578765111,3578765117,6
3,1539,44214,3578765111,3578765117,6
3,1539,44215,3578765111,3578765118,7
3,1539,44216,3578765111,3578765120,9
3,1539,44217,3578765111,3578765121,10
3,1539,44218,3578765111,3578765124,13
3,1539,44219,3578765111,3578765129,18
3,1539,44220,3578765111,3578765132,21
3,1539,44221,3578765111,3578765137,26
3,1539,44222,3578765111,3578765141,30
3,1539,44223,3578765111,3578765145,34
3,1539,44224,3578765111,3578765149,38
3,1539,44225,3578765111,3578765152,41
3,1539,44226,3578765111,3578765155,44
3,1539,44227,3578765111,3578765156,45
3,1539,44228,3578765111,3578765157,46
3,1539,44229,3578765111,3578765160,49
3,1540,44230,3578765176,3578765176,0
3,1540,44231,3578765176,3578765176,0
3,1540,44232,3578765176,3578765176,0
3,1540,44233,3578765176,3578765176,0
3,1540,44234,3578765176,3578765176,0
3,1540,44235,3578765176,3578765176,0
3,1540,44236,3578765176,3578765176,0
3,1540,44237,3578765176,3578765176,0
3,1540,44238,3578765176,3578765176,0
3,1540,44239,3578765176,3578765176,0
3,1540,44240,3578765176,3578765178,2
3,1540,44241,3578765176,3578765178,2
3,1540,44242,3578765176,3578765183,7
3,1540,44243,3578765176,3578765183,7
3,1540,44244,3578765176,3578765186,10
3,1540,44245,3578765176,3578765187,11
3,1540,44246,3578765176,3578765187,11
3,1540,44247,3578765176,3578765191,15
3,1540,44248,3578765176,3578765194,18
3,1540,44249,3578765176,3578765194,18
3,1540,44250,3578765176,3578765196,20
3,1540,44251,3578765176,3578765199,23
3,1540,44252,3578765176,3578765203,27
3,1540,44253,3578765176,3578765204,28
3,1540,44254,3578765176,3578765204,28
3,1540,44255,3578765176,3578765205,29
3,1540,44256,3578765176,3578765205,29
3,1540,44257,3578765176,3578765205,29
3,1540,44258,3578765176,3578765206,30
3,1540,44259,3578765176,3578765208,32
3,1540,44260,3578765176,3578765209,33
3,1540,44261,3578765176,3578765210,34
3,1540,44262,3578765176,3578765215,39
3,1540,44263,3578765176,3578765216,40
3,1540,44264,3578765176,3578765220,44
3,1540,44265,3578765176,3578765223,47
3,1541,44266,3578765241,3578765241,0
3,1541,44267,3578765241,3578765241,0
3,1541,44268,3578765241,3578765241,0
3,1541,44269,3578765241,3578765241,0
3,1541,44270,3578765241,3578765241,0
3,1541,44271,3578765241,3578765241,0
3,1541,44272,3578765241,3578765241,0
3,1541,44273,3578765241,3578765241,0
3,1541,44274,3578765241,3578765241,0
3,1541,44275,3578765241,3578765241,0
3,1541,44276,3578765241,3578765243,2
3,1541,44277,3578765241,3578765245,4
3,1541,44278,3578765241,3578765247,6
3,1541,44279,3578765241,3578765251,10
3,1541,44280,3578765241,3578765253,12
3,1541,44281,3578765241,3578765256,15
3,1541,44282,3578765241,3578765256,15
3,1541,44283,3578765241,3578765258,17
3,1541,44284,3578765241,3578765259,18
3,1541,44285,3578765241,3578765262,21
3,1541,44286,3578765241,3578765264,23
3,1541,44287,3578765241,3578765268,27
3,1541,44288,3578765241,3578765280,39
3,1541,44289,3578765241,3578765281,40
3,1541,44290,3578765241,3578765285,44
3,1541,44291,3578765241,3578765286,45
3,1541,44292,3578765241,3578765286,45
3,1541,44293,3578765241,3578765289,48
3,1542,44294,3578765305,3578765305,0
3,1542,44295,3578765305,3578765305,0
3,1542,44296,3578765305,3578765305,0
3,1542,44297,3578765305,3578765305,0
3,1542,44298,3578765305,3578765305,0
3,1542,44299,3578765305,3578765305,0
3,1542,44300,3578765305,3578765305,0
3,1542,44301,3578765305,3578765305,0
3,1542,44302,3578765305,3578765305,0
3,1542,44303,3578765305,3578765307,2
3,1542,44304,3578765305,3578765307,2
3,1542,44305,3578765305,3578765310,5
3,1542,44306,3578765305,3578765313,8
3,1542,44307,3578765305,3578765313,8
3,1542,44308,3578765305,3578765315,10
3,1542,44309,3578765305,3578765317,12
3,1542,44310,3578765305,3578765317,12
3,1542,44311,3578765305,3578765319,14
3,1542,44312,3578765305,3578765320,15
3,1542,44313,3578765305,3578765320,15
3,1542,44314,3578765305,3578765321,16
3,1542,44315,3578765305,3578765323,18
3,1542,44316,3578765305,3578765324,19
3,1542,44317,3578765305,3578765330,25
3,1542,44318,3578765305,3578765331,26
3,1542,44319,3578765305,3578765337,32
3,1542,44320,3578765305,3578765342,37
3,1542,44321,3578765305,3578765344,39
3,1542,44322,3578765305,3578765346,41
3,1542,44323,3578765305,3578765348,43
3,1542,44324,3578765305,3578765352,47
3,1543,44325,3578765369,3578765369,0
3,1543,44326,3578765369,3578765369,0
3,1543,44327,3578765369,3578765369,0
3,1543,44328,3578765369,3578765369,0
3,1543,44329,3578765369,3578765369,0
3,1543,44330,3578765369,3578765369,0
3,1543,44331,3578765369,3578765369,0
3,1543,44332,3578765369,3578765370,1
3,1543,44333,3578765369,3578765370,1
3,1543,44334,3578765369,3578765371,2
3,1543,44335,3578765369,3578765373,4
3,1543,44336,3578765369,3578765375,6
3,1543,44337,3578765369,3578765376,7
3,1543,44338,3578765369,3578765379,10
3,1543,44339,3578765369,3578765379,10
3,1543,44340,3578765369,3578765383,14
3,1543,44341,3578765369,3578765384,15
3,1543,44342,3578765369,3578765387,18
3,1543,44343,3578765369,3578765387,18
3,1543,44344,3578765369,3578765388,19
3,1543,44345,3578765369,3578765389,20
3,1543,44346,3578765369,3578765393,24
3,1543,44347,3578765369,3578765394,25
3,1543,44348,3578765369,3578765394,25
3,1543,44349,3578765369,3578765396,27
3,1543,44350,3578765369,3578765399,30
3,1543,44351,3578765369,3578765403,34
3,1543,44352,3578765369,3578765404,35
3,1543,44353,3578765369,3578765405,36
3,1543,44354,3578765369,3578765405,36
3,1543,44355,3578765369,3578765405,36
3,1543,44356,3578765369,3578765406,37
3,1543,44357,3578765369,3578765408,39
3,1543,44358,3578765369,3578765409,40
3,1543,44359,3578765369,3578765410,41
3,1543,44360,3578765369,3578765415,46
3,1543,44361,3578765369,3578765416,47
3,1544,44362,3578765434,3578765434,0
3,1544,44363,3578765434,3578765434,0
3,1544,44364,3578765434,3578765434,0
3,1544,44365,3578765434,3578765434,0
3,1544,44366,3578765434,3578765434,0
3,1544,44367,3578765434,3578765434,0
3,1544,44368,3578765434,3578765434,0
3,1544,44369,3578765434,3578765435,1
3,1544,44370,3578765434,3578765436,2
3,1544,44371,3578765434,3578765438,4
3,1544,44372,3578765434,3578765440,6
3,1544,44373,3578765434,3578765444,10
3,1544,44374,3578765434,3578765444,10
3,1544,44375,3578765434,3578765447,13
3,1544,44376,3578765434,3578765451,17
3,1544,44377,3578765434,3578765456,22
3,1544,44378,3578765434,3578765458,24
3,1544,44379,3578765434,3578765458,24
3,1544,44380,3578765434,3578765459,25
3,1544,44381,3578765434,3578765461,27
3,1544,44382,3578765434,3578765463,29
3,1544,44383,3578765434,3578765470,36
3,1544,44384,3578765434,3578765480,46
3,1544,44385,3578765434,3578765482,48
3,1544,44386,3578765434,3578765483,49
3,1545,44387,3578765499,3578765499,0
3,1545,44388,3578765499,3578765499,0
3,1545,44389,3578765499,3578765499,0
3,1545,44390,3578765499,3578765499,0
3,1545,44391,3578765499,3578765499,0
3,1545,44392,3578765499,3578765499,0
3,1545,44393,3578765499,3578765499,0
3,1545,44394,3578765499,3578765499,0
3,1545,44395,3578765499,3578765499,0
3,1545,44396,3578765499,3578765499,0
3,1545,44397,3578765499,3578765499,0
3,1545,44398,3578765499,3578765502,3
3,1545,44399,3578765499,3578765506,7
3,1545,44400,3578765499,3578765506,7
3,1545,44401,3578765499,3578765509,10
3,1545,44402,3578765499,3578765512,13
3,1545,44403,3578765499,3578765513,14
3,1545,44404,3578765499,3578765514,15
3,1545,44405,3578765499,3578765516,17
3,1545,44406,3578765499,3578765516,17
3,1545,44407,3578765499,3578765517,18
3,1545,44408,3578765499,3578765520,21
3,1545,44409,3578765499,3578765520,21
3,1545,44410,3578765499,3578765523,24
3,1545,44411,3578765499,3578765524,25
3,1545,44412,3578765499,3578765532,33
3,1545,44413,3578765499,3578765541,42
3,1545,44414,3578765499,3578765542,43
3,1545,44415,3578765499,3578765545,46
3,1545,44416,3578765499,3578765548,49
3,1546,44417,3578765564,3578765564,0
3,1546,44418,3578765564,3578765564,0
3,1546,44419,3578765564,3578765564,0
3,1546,44420,3578765564,3578765565,1
3,1546,44421,3578765564,3578765567,3
3,1546,44422,3578765564,3578765568,4
3,1546,44423,3578765564,3578765568,4
3,1546,44424,3578765564,3578765569,5
3,1546,44425,3578765564,3578765569,5
3,1546,44426,3578765564,3578765569,5
3,1546,44427,3578765564,3578765570,6
3,1546,44428,3578765564,3578765572,8
3,1546,44429,3578765564,3578765574,10
3,1546,44430,3578765564,3578765576,12
3,1546,44431,3578765564,3578765577,13
3,1546,44432,3578765564,3578765578,14
3,1546,44433,3578765564,3578765582,18
3,1546,44434,3578765564,3578765582,18
3,1546,44435,3578765564,3578765586,22
3,1546,44436,3578765564,3578765586,22
3,1546,44437,3578765564,3578765587,23
3,1546,44438,3578765564,3578765589,25
3,1546,44439,3578765564,3578765592,28
3,1546,44440,3578765564,3578765593,29
3,1546,44441,3578765564,3578765593,29
3,1546,44442,3578765564,3578765595,31
3,1546,44443,3578765564,3578765599,35
3,1546,44444,3578765564,3578765602,38
3,1546,44445,3578765564,3578765603,39
3,1546,44446,3578765564,3578765604,40
3,1546,44447,3578765564,3578765605,41
3,1546,44448,3578765564,3578765605,41
3,1546,44449,3578765564,3578765606,42
3,1546,44450,3578765564,3578765607,43
3,1546,44451,3578765564,3578765608,44
3,1546,44452,3578765564,3578765610,46
3,1547,44453,3578765627,3578765627,0
3,1547,44454,3578765627,3578765627,0
3,1547,44455,3578765627,3578765627,0
3,1547,44456,3578765627,3578765627,0
3,1547,44457,3578765627,3578765627,0
3,1547,44458,3578765627,3578765627,0
3,1547,44459,3578765627,3578765627,0
3,1547,44460,3578765627,3578765630,3
3,1547,44461,3578765627,3578765631,4
3,1547,44462,3578765627,3578765633,6
3,1547,44463,3578765627,3578765634,7
3,1547,44464,3578765627,3578765635,8
3,1547,44465,3578765627,3578765638,11
3,1547,44466,3578765627,3578765639,12
3,1547,44467,3578765627,3578765643,16
3,1547,44468,3578765627,3578765644,17
3,1547,44469,3578765627,3578765644,17
3,1547,44470,3578765627,3578765646,19
3,1547,44471,3578765627,3578765650,23
3,1547,44472,3578765627,3578765655,28
3,1547,44473,3578765627,3578765657,30
3,1547,44474,3578765627,3578765658,31
3,1547,44475,3578765627,3578765658,31
3,1547,44476,3578765627,3578765661,34
3,1547,44477,3578765627,3578765664,37
3,1547,44478,3578765627,3578765668,41
3,1548,44479,3578765691,3578765691,0
3,1548,44480,3578765691,3578765691,0
3,1548,44481,3578765691,3578765691,0
3,1548,44482,3578765691,3578765691,0
3,1548,44483,3578765691,3578765691,0
3,1548,44484,3578765691,3578765691,0
3,1548,44485,3578765691,3578765692,1
3,1548,44486,3578765691,3578765692,1
3,1548,44487,3578765691,3578765693,2
3,1548,44488,3578765691,3578765694,3
3,1548,44489,3578765691,3578765694,3
3,1548,44490,3578765691,3578765695,4
3,1548,44491,3578765691,3578765696,5
3,1548,44492,3578765691,3578765697,6
3,1548,44493,3578765691,3578765702,11
3,1548,44494,3578765691,3578765706,15
3,1548,44495,3578765691,3578765707,16
3,1548,44496,3578765691,3578765709,18
3,1548,44497,3578765691,3578765712,21
3,1548,44498,3578765691,3578765714,23
3,1548,44499,3578765691,3578765715,24
3,1548,44500,3578765691,3578765715,24
3,1548,44501,3578765691,3578765716,25
3,1548,44502,3578765691,3578765719,28
3,1548,44503,3578765691,3578765720,29
3,1548,44504,3578765691,3578765721,30
3,1548,44505,3578765691,3578765724,33
3,1548,44506,3578765691,3578765724,33
3,1548,44507,3578765691,3578765728,37
3,1548,44508,3578765691,3578765732,41
3,1549,44509,3578765754,3578765754,0
3,1549,44510,3578765754,3578765754,0
3,1549,44511,3578765754,3578765754,0
3,1549,44512,3578765754,3578765754,0
3,1549,44513,3578765754,3578765754,0
3,1549,44514,3578765754,3578765756,2
3,1549,44515,3578765754,3578765757,3
3,1549,44516,3578765754,3578765760,6
3,1549,44517,3578765754,3578765765,11
3,1549,44518,3578765754,3578765767,13
3,1549,44519,3578765754,3578765767,13
3,1549,44520,3578765754,3578765768,14
3,1549,44521,3578765754,3578765768,14
3,1549,44522,3578765754,3578765768,14
3,1549,44523,3578765754,3578765770,16
3,1549,44524,3578765754,3578765771,17
3,1549,44525,3578765754,3578765772,18
3,1549,44526,3578765754,3578765773,19
3,1549,44527,3578765754,3578765775,21
3,1549,44528,3578765754,3578765778,24
3,1549,44529,3578765754,3578765778,24
3,1549,44530,3578765754,3578765782,28
3,1549,44531,3578765754,3578765783,29
3,1549,44532,3578765754,3578765786,32
3,1549,44533,3578765754,3578765787,33
3,1549,44534,3578765754,3578765787,33
3,1549,44535,3578765754,3578765789,35
3,1549,44536,3578765754,3578765793,39
3,1549,44537,3578765754,3578765793,39
3,1549,44538,3578765754,3578765794,40
3,1549,44539,3578765754,3578765795,41
3,1549,44540,3578765754,3578765801,47
3,1549,44541,3578765754,3578765803,49
3,1550,44542,3578765819,3578765819,0
3,1550,44543,3578765819,3578765819,0
3,1550,44544,3578765819,3578765819,0
3,1550,44545,3578765819,3578765819,0
3,1550,44546,3578765819,3578765819,0
3,1550,44547,3578765819,3578765819,0
3,1550,44548,3578765819,3578765819,0
3,1550,44549,3578765819,3578765819,0
3,1550,44550,3578765819,3578765819,0
3,1550,44551,3578765819,3578765819,0
3,1550,44552,3578765819,3578765820,1
3,1550,44553,3578765819,3578765823,4
3,1550,44554,3578765819,3578765824,5
3,1550,44555,3578765819,3578765826,7
3,1550,44556,3578765819,3578765827,8
3,1550,44557,3578765819,3578765831,12
3,1550,44558,3578765819,3578765832,13
3,1550,44559,3578765819,3578765832,13
3,1550,44560,3578765819,3578765834,15
3,1550,44561,3578765819,3578765838,19
3,1550,44562,3578765819,3578765839,20
3,1550,44563,3578765819,3578765843,24
3,1550,44564,3578765819,3578765844,25
3,1550,44565,3578765819,3578765844,25
3,1550,44566,3578765819,3578765847,28
3,1550,44567,3578765819,3578765851,32
3,1550,44568,3578765819,3578765854,35
3,1550,44569,3578765819,3578765855,36
3,1550,44570,3578765819,3578765857,38
3,1550,44571,3578765819,3578765857,38
3,1550,44572,3578765819,3578765857,38
3,1550,44573,3578765819,3578765862,43
3,1550,44574,3578765819,3578765863,44
3,1550,44575,3578765819,3578765863,44
3,1550,44576,3578765819,3578765868,49
3,1551,44577,3578765883,3578765883,0
3,1551,44578,3578765883,3578765883,0
3,1551,44579,3578765883,3578765883,0
3,1551,44580,3578765883,3578765885,2
3,1551,44581,3578765883,3578765886,3
3,1551,44582,3578765883,3578765886,3
3,1551,44583,3578765883,3578765888,5
3,1551,44584,3578765883,3578765892,9
3,1551,44585,3578765883,3578765893,10
3,1551,44586,3578765883,3578765893,10
3,1551,44587,3578765883,3578765894,11
3,1551,44588,3578765883,3578765894,11
3,1551,44589,3578765883,3578765895,12
3,1551,44590,3578765883,3578765897,14
3,1551,44591,3578765883,3578765897,14
3,1551,44592,3578765883,3578765902,19
3,1551,44593,3578765883,3578765906,23
3,1551,44594,3578765883,3578765910,27
3,1551,44595,3578765883,3578765913,30
3,1551,44596,3578765883,3578765915,32
3,1551,44597,3578765883,3578765916,33
3,1551,44598,3578765883,3578765916,33
3,1551,44599,3578765883,3578765918,35
3,1551,44600,3578765883,3578765920,37
3,1551,44601,3578765883,3578765921,38
3,1551,44602,3578765883,3578765921,38
3,1551,44603,3578765883,3578765923,40
3,1551,44604,3578765883,3578765924,41
3,1551,44605,3578765883,3578765929,46
3,1551,44606,3578765883,3578765931,48
3,1552,44607,3578765947,3578765947,0
3,1552,44608,3578765947,3578765947,0
3,1552,44609,3578765947,3578765947,0
3,1552,44610,3578765947,3578765950,3
3,1552,44611,3578765947,3578765952,5
3,1552,44612,3578765947,3578765956,9
3,1552,44613,3578765947,3578765956,9
3,1552,44614,3578765947,3578765960,13
3,1552,44615,3578765947,3578765966,19
3,1552,44616,3578765947,3578765968,21
3,1552,44617,3578765947,3578765968,21
3,1552,44618,3578765947,3578765969,22
3,1552,44619,3578765947,3578765969,22
3,1552,44620,3578765947,3578765969,22
3,1552,44621,3578765947,3578765969,22
3,1552,44622,3578765947,3578765970,23
3,1552,44623,3578765947,3578765970,23
3,1552,44624,3578765947,3578765972,25
3,1552,44625,3578765947,3578765974,27
3,1552,44626,3578765947,3578765975,28
3,1552,44627,3578765947,3578765977,30
3,1552,44628,3578765947,3578765979,32
3,1552,44629,3578765947,3578765982,35
3,1552,44630,3578765947,3578765983,36
3,1552,44631,3578765947,3578765986,39
3,1552,44632,3578765947,3578765986,39
3,1552,44633,3578765947,3578765987,40
3,1552,44634,3578765947,3578765989,42
3,1552,44635,3578765947,3578765993,46
3,1552,44636,3578765947,3578765993,46
3,1552,44637,3578765947,3578765994,47
3,1552,44638,3578765947,3578765996,49
3,1553,44639,3578766010,3578766010,0
3,1553,44640,3578766010,3578766011,1
3,1553,44641,3578766010,3578766011,1
3,1553,44642,3578766010,3578766011,1
3,1553,44643,3578766010,3578766011,1
3,1553,44644,3578766010,3578766011,1
3,1553,44645,3578766010,3578766011,1
3,1553,44646,3578766010,3578766011,1
3,1553,44647,3578766010,3578766011,1
3,1553,44648,3578766010,3578766011,1
3,1553,44649,3578766010,3578766011,1
3,1553,44650,3578766010,3578766015,5
3,1553,44651,3578766010,3578766021,11
3,1553,44652,3578766010,3578766022,12
3,1553,44653,3578766010,3578766025,15
3,1553,44654,3578766010,3578766028,18
3,1553,44655,3578766010,3578766028,18
3,1553,44656,3578766010,3578766030,20
3,1553,44657,3578766010,3578766031,21
3,1553,44658,3578766010,3578766032,22
3,1553,44659,3578766010,3578766034,24
3,1553,44660,3578766010,3578766036,26
3,1553,44661,3578766010,3578766038,28
3,1553,44662,3578766010,3578766039,29
3,1553,44663,3578766010,3578766043,33
3,1553,44664,3578766010,3578766043,33
3,1553,44665,3578766010,3578766044,34
3,1553,44666,3578766010,3578766047,37
3,1553,44667,3578766010,3578766050,40
3,1553,44668,3578766010,3578766053,43
3,1553,44669,3578766010,3578766055,45
3,1553,44670,3578766010,3578766057,47
3,1553,44671,3578766010,3578766058,48
3,1553,44672,3578766010,3578766058,48
3,1554,44673,3578766074,3578766074,0
3,1554,44674,3578766074,3578766074,0
3,1554,44675,3578766074,3578766074,0
3,1554,44676,3578766074,3578766081,7
3,1554,44677,3578766074,3578766083,9
3,1554,44678,3578766074,3578766083,9
3,1554,44679,3578766074,3578766085,11
3,1554,44680,3578766074,3578766086,12
3,1554,44681,3578766074,3578766087,13
3,1554,44682,3578766074,3578766089,15
3,1554,44683,3578766074,3578766092,18
3,1554,44684,3578766074,3578766094,20
3,1554,44685,3578766074,3578766095,21
3,1554,44686,3578766074,3578766095,21
3,1554,44687,3578766074,3578766097,23
3,1554,44688,3578766074,3578766097,23
3,1554,44689,3578766074,3578766102,28
3,1554,44690,3578766074,3578766106,32
3,1554,44691,3578766074,3578766106,32
3,1554,44692,3578766074,3578766110,36
3,1554,44693,3578766074,3578766114,40
3,1554,44694,3578766074,3578766116,42
3,1554,44695,3578766074,3578766117,43
3,1554,44696,3578766074,3578766118,44
3,1554,44697,3578766074,3578766120,46
3,1554,44698,3578766074,3578766121,47
3,1554,44699,3578766074,3578766121,47
3,1554,44700,3578766074,3578766124,50
3,1555,44701,3578766140,3578766140,0
3,1555,44702,3578766140,3578766140,0
3,1555,44703,3578766140,3578766140,0
3,1555,44704,3578766140,3578766141,1
3,1555,44705,3578766140,3578766143,3
3,1555,44706,3578766140,3578766145,5
3,1555,44707,3578766140,3578766149,9
3,1555,44708,3578766140,3578766152,12
3,1555,44709,3578766140,3578766156,16
3,1555,44710,3578766140,3578766158,18
3,1555,44711,3578766140,3578766160,20
3,1555,44712,3578766140,3578766165,25
3,1555,44713,3578766140,3578766168,28
3,1555,44714,3578766140,3578766168,28
3,1555,44715,3578766140,3578766168,28
3,1555,44716,3578766140,3578766168,28
3,1555,44717,3578766140,3578766169,29
3,1555,44718,3578766140,3578766170,30
3,1555,44719,3578766140,3578766170,30
3,1555,44720,3578766140,3578766171,31
3,1555,44721,3578766140,3578766172,32
3,1555,44722,3578766140,3578766176,36
3,1555,44723,3578766140,3578766180,40
3,1555,44724,3578766140,3578766183,43
3,1555,44725,3578766140,3578766183,43
3,1555,44726,3578766140,3578766187,47
3,1555,44727,3578766140,3578766187,47
3,1555,44728,3578766140,3578766188,48
3,1556,44729,3578766204,3578766204,0
3,1556,44730,3578766204,3578766204,0
3,1556,44731,3578766204,3578766204,0
3,1556,44732,3578766204,3578766204,0
3,1556,44733,3578766204,3578766204,0
3,1556,44734,3578766204,3578766204,0
3,1556,44735,3578766204,3578766204,0
3,1556,44736,3578766204,3578766205,1
3,1556,44737,3578766204,3578766205,1
3,1556,44738,3578766204,3578766206,2
3,1556,44739,3578766204,3578766208,4
3,1556,44740,3578766204,3578766208,4
3,1556,44741,3578766204,3578766209,5
3,1556,44742,3578766204,3578766209,5
3,1556,44743,3578766204,3578766210,6
3,1556,44744,3578766204,3578766216,12
3,1556,44745,3578766204,3578766220,16
3,1556,44746,3578766204,3578766223,19
3,1556,44747,3578766204,3578766224,20
3,1556,44748,3578766204,3578766227,23
3,1556,44749,3578766204,3578766228,24
3,1556,44750,3578766204,3578766229,25
3,1556,44751,3578766204,3578766230,26
3,1556,44752,3578766204,3578766232,28
3,1556,44753,3578766204,3578766233,29
3,1556,44754,3578766204,3578766235,31
3,1556,44755,3578766204,3578766236,32
3,1556,44756,3578766204,3578766238,34
3,1556,44757,3578766204,3578766239,35
3,1556,44758,3578766204,3578766243,39
3,1556,44759,3578766204,3578766244,40
3,1556,44760,3578766204,3578766244,40
3,1556,44761,3578766204,3578766247,43
3,1556,44762,3578766204,3578766251,47
3,1556,44763,3578766204,3578766253,49
3,1557,44764,3578766269,3578766269,0
3,1557,44765,3578766269,3578766269,0
3,1557,44766,3578766269,3578766269,0
3,1557,44767,3578766269,3578766269,0
3,1557,44768,3578766269,3578766269,0
3,1557,44769,3578766269,3578766269,0
3,1557,44770,3578766269,3578766269,0
3,1557,44771,3578766269,3578766269,0
3,1557,44772,3578766269,3578766282,13
3,1557,44773,3578766269,3578766283,14
3,1557,44774,3578766269,3578766283,14
3,1557,44775,3578766269,3578766285,16
3,1557,44776,3578766269,3578766286,17
3,1557,44777,3578766269,3578766286,17
3,1557,44778,3578766269,3578766289,20
3,1557,44779,3578766269,3578766292,23
3,1557,44780,3578766269,3578766293,24
3,1557,44781,3578766269,3578766294,25
3,1557,44782,3578766269,3578766294,25
3,1557,44783,3578766269,3578766296,27
3,1557,44784,3578766269,3578766296,27
3,1557,44785,3578766269,3578766298,29
3,1557,44786,3578766269,3578766303,34
3,1557,44787,3578766269,3578766306,37
3,1557,44788,3578766269,3578766306,37
3,1557,44789,3578766269,3578766310,41
3,1557,44790,3578766269,3578766312,43
3,1557,44791,3578766269,3578766314,45
3,1557,44792,3578766269,3578766315,46
3,1557,44793,3578766269,3578766315,46
3,1557,44794,3578766269,3578766317,48
3,1557,44795,3578766269,3578766318,49
3,1558,44796,3578766333,3578766333,0
3,1558,44797,3578766333,3578766333,0
3,1558,44798,3578766333,3578766333,0
3,1558,44799,3578766333,3578766333,0
3,1558,44800,3578766333,3578766333,0
3,1558,44801,3578766333,3578766333,0
3,1558,44802,3578766333,3578766342,9
3,1558,44803,3578766333,3578766343,10
3,1558,44804,3578766333,3578766345,12
3,1558,44805,3578766333,3578766350,17
3,1558,44806,3578766333,3578766352,19
3,1558,44807,3578766333,3578766355,22
3,1558,44808,3578766333,3578766357,24
3,1558,44809,3578766333,3578766360,27
3,1558,44810,3578766333,3578766365,32
3,1558,44811,3578766333,3578766368,35
3,1558,44812,3578766333,3578766368,35
3,1558,44813,3578766333,3578766368,35
3,1558,44814,3578766333,3578766368,35
3,1558,44815,3578766333,3578766369,36
3,1558,44816,3578766333,3578766369,36
3,1558,44817,3578766333,3578766370,37
3,1558,44818,3578766333,3578766373,40
3,1558,44819,3578766333,3578766380,47
3,1558,44820,3578766333,3578766382,49
3,1558,44821,3578766333,3578766383,50
3,1559,44822,3578766397,3578766397,0
3,1559,44823,3578766397,3578766397,0
3,1559,44824,3578766397,3578766397,0
3,1559,44825,3578766397,3578766398,1
3,1559,44826,3578766397,3578766398,1
3,1559,44827,3578766397,3578766398,1
3,1559,44828,3578766397,3578766398,1
3,1559,44829,3578766397,3578766399,2
3,1559,44830,3578766397,3578766403,6
3,1559,44831,3578766397,3578766405,8
3,1559,44832,3578766397,3578766405,8
3,1559,44833,3578766397,3578766406,9
3,1559,44834,3578766397,3578766407,10
3,1559,44835,3578766397,3578766407,10
3,1559,44836,3578766397,3578766408,11
3,1559,44837,3578766397,3578766409,12
3,1559,44838,3578766397,3578766409,12
3,1559,44839,3578766397,3578766410,13
3,1559,44840,3578766397,3578766415,18
3,1559,44841,3578766397,3578766416,19
3,1559,44842,3578766397,3578766420,23
3,1559,44843,3578766397,3578766424,27
3,1559,44844,3578766397,3578766425,28
3,1559,44845,3578766397,3578766427,30
3,1559,44846,3578766397,3578766428,31
3,1559,44847,3578766397,3578766428,31
3,1559,44848,3578766397,3578766431,34
3,1559,44849,3578766397,3578766432,35
3,1559,44850,3578766397,3578766432,35
3,1559,44851,3578766397,3578766435,38
3,1559,44852,3578766397,3578766436,39
3,1559,44853,3578766397,3578766438,41
3,1559,44854,3578766397,3578766440,43
3,1559,44855,3578766397,3578766443,46
3,1559,44856,3578766397,3578766444,47
3,1559,44857,3578766397,3578766445,48
3,1559,44858,3578766397,3578766446,49
3,1559,44859,3578766397,3578766447,50
3,1560,44860,3578766461,3578766461,0
3,1560,44861,3578766461,3578766461,0
3,1560,44862,3578766461,3578766461,0
3,1560,44863,3578766461,3578766461,0
3,1560,44864,3578766461,3578766461,0
3,1560,44865,3578766461,3578766462,1
3,1560,44866,3578766461,3578766464,3
3,1560,44867,3578766461,3578766464,3
3,1560,44868,3578766461,3578766470,9
3,1560,44869,3578766461,3578766482,21
3,1560,44870,3578766461,3578766483,22
3,1560,44871,3578766461,3578766483,22
3,1560,44872,3578766461,3578766485,24
3,1560,44873,3578766461,3578766485,24
3,1560,44874,3578766461,3578766486,25
3,1560,44875,3578766461,3578766489,28
3,1560,44876,3578766461,3578766492,31
3,1560,44877,3578766461,3578766493,32
3,1560,44878,3578766461,3578766493,32
3,1560,44879,3578766461,3578766495,34
3,1560,44880,3578766461,3578766497,36
3,1560,44881,3578766461,3578766497,36
3,1560,44882,3578766461,3578766498,37
3,1560,44883,3578766461,3578766502,41
3,1560,44884,3578766461,3578766506,45
3,1560,44885,3578766461,3578766507,46
3,1560,44886,3578766461,3578766510,49
3,1561,44887,3578766526,3578766526,0
3,1561,44888,3578766526,3578766526,0
3,1561,44889,3578766526,3578766526,0
3,1561,44890,3578766526,3578766526,0
3,1561,44891,3578766526,3578766526,0
3,1561,44892,3578766526,3578766526,0
3,1561,44893,3578766526,3578766526,0
3,1561,44894,3578766526,3578766526,0
3,1561,44895,3578766526,3578766526,0
3,1561,44896,3578766526,3578766526,0
3,1561,44897,3578766526,3578766526,0
3,1561,44898,3578766526,3578766528,2
3,1561,44899,3578766526,3578766531,5
3,1561,44900,3578766526,3578766541,15
3,1561,44901,3578766526,3578766543,17
3,1561,44902,3578766526,3578766544,18
3,1561,44903,3578766526,3578766549,23
3,1561,44904,3578766526,3578766551,25
3,1561,44905,3578766526,3578766556,30
3,1561,44906,3578766526,3578766557,31
3,1561,44907,3578766526,3578766559,33
3,1561,44908,3578766526,3578766564,38
3,1561,44909,3578766526,3578766567,41
3,1561,44910,3578766526,3578766567,41
3,1561,44911,3578766526,3578766568,42
3,1561,44912,3578766526,3578766568,42
3,1561,44913,3578766526,3578766568,42
3,1561,44914,3578766526,3578766569,43
3,1561,44915,3578766526,3578766570,44
3,1561,44916,3578766526,3578766572,46
3,1561,44917,3578766526,3578766575,49
3,1562,44918,3578766591,3578766591,0
3,1562,44919,3578766591,3578766591,0
3,1562,44920,3578766591,3578766591,0
3,1562,44921,3578766591,3578766591,0
3,1562,44922,3578766591,3578766591,0
3,1562,44923,3578766591,3578766591,0
3,1562,44924,3578766591,3578766591,0
3,1562,44925,3578766591,3578766592,1
3,1562,44926,3578766591,3578766593,2
3,1562,44927,3578766591,3578766594,3
3,1562,44928,3578766591,3578766599,8
3,1562,44929,3578766591,3578766602,11
3,1562,44930,3578766591,3578766604,13
3,1562,44931,3578766591,3578766604,13
3,1562,44932,3578766591,3578766605,14
3,1562,44933,3578766591,3578766605,14
3,1562,44934,3578766591,3578766606,15
3,1562,44935,3578766591,3578766608,17
3,1562,44936,3578766591,3578766608,17
3,1562,44937,3578766591,3578766608,17
3,1562,44938,3578766591,3578766608,17
3,1562,44939,3578766591,3578766609,18
3,1562,44940,3578766591,3578766615,24
3,1562,44941,3578766591,3578766615,24
3,1562,44942,3578766591,3578766619,28
3,1562,44943,3578766591,3578766622,31
3,1562,44944,3578766591,3578766623,32
3,1562,44945,3578766591,3578766626,35
3,1562,44946,3578766591,3578766627,36
3,1562,44947,3578766591,3578766628,37
3,1562,44948,3578766591,3578766629,38
3,1562,44949,3578766591,3578766631,40
3,1562,44950,3578766591,3578766632,41
3,1562,44951,3578766591,3578766634,43
3,1562,44952,3578766591,3578766635,44
3,1562,44953,3578766591,3578766638,47
3,1562,44954,3578766591,3578766640,49
3,1563,44955,3578766656,3578766656,0
3,1563,44956,3578766656,3578766656,0
3,1563,44957,3578766656,3578766656,0
3,1563,44958,3578766656,3578766656,0
3,1563,44959,3578766656,3578766656,0
3,1563,44960,3578766656,3578766656,0
3,1563,44961,3578766656,3578766656,0
3,1563,44962,3578766656,3578766658,2
3,1563,44963,3578766656,3578766658,2
3,1563,44964,3578766656,3578766661,5
3,1563,44965,3578766656,3578766664,8
3,1563,44966,3578766656,3578766668,12
3,1563,44967,3578766656,3578766682,26
3,1563,44968,3578766656,3578766683,27
3,1563,44969,3578766656,3578766683,27
3,1563,44970,3578766656,3578766685,29
3,1563,44971,3578766656,3578766686,30
3,1563,44972,3578766656,3578766689,33
3,1563,44973,3578766656,3578766692,36
3,1563,44974,3578766656,3578766693,37
3,1563,44975,3578766656,3578766693,37
3,1563,44976,3578766656,3578766694,38
3,1563,44977,3578766656,3578766695,39
3,1563,44978,3578766656,3578766697,41
3,1563,44979,3578766656,3578766697,41
3,1563,44980,3578766656,3578766702,46
3,1563,44981,3578766656,3578766706,50
3,1564,44982,3578766722,3578766722,0
3,1564,44983,3578766722,3578766722,0
3,1564,44984,3578766722,3578766722,0
3,1564,44985,3578766722,3578766722,0
3,1564,44986,3578766722,3578766722,0
3,1564,44987,3578766722,3578766722,0
3,1564,44988,3578766722,3578766722,0
3,1564,44989,3578766722,3578766722,0
3,1564,44990,3578766722,3578766722,0
3,1564,44991,3578766722,3578766722,0
3,1564,44992,3578766722,3578766722,0
3,1564,44993,3578766722,3578766723,1
3,1564,44994,3578766722,3578766723,1
3,1564,44995,3578766722,3578766729,7
3,1564,44996,3578766722,3578766731,9
3,1564,44997,3578766722,3578766742,20
3,1564,44998,3578766722,3578766745,23
3,1564,44999,3578766722,3578766748,26
3,1564,45000,3578766722,3578766752,30
3,1564,45001,3578766722,3578766757,35
3,1564,45002,3578766722,3578766757,35
3,1564,45003,3578766722,3578766761,39
3,1564,45004,3578766722,3578766766,44
3,1564,45005,3578766722,3578766767,45
3,1564,45006,3578766722,3578766767,45
3,1564,45007,3578766722,3578766768,46
3,1564,45008,3578766722,3578766768,46
3,1564,45009,3578766722,3578766769,47
3,1564,45010,3578766722,3578766769,47
3,1564,45011,3578766722,3578766770,48
3,1565,45012,3578766787,3578766787,0
3,1565,45013,3578766787,3578766787,0
3,1565,45014,3578766787,3578766787,0
3,1565,45015,3578766787,3578766787,0
3,1565,45016,3578766787,3578766787,0
3,1565,45017,3578766787,3578766787,0
3,1565,45018,3578766787,3578766787,0
3,1565,45019,3578766787,3578766787,0
3,1565,45020,3578766787,3578766787,0
3,1565,45021,3578766787,3578766789,2
3,1565,45022,3578766787,3578766792,5
3,1565,45023,3578766787,3578766793,6
3,1565,45024,3578766787,3578766794,7
3,1565,45025,3578766787,3578766795,8
3,1565,45026,3578766787,3578766799,12
3,1565,45027,3578766787,3578766801,14
3,1565,45028,3578766787,3578766804,17
3,1565,45029,3578766787,3578766805,18
3,1565,45030,3578766787,3578766805,18
3,1565,45031,3578766787,3578766805,18
3,1565,45032,3578766787,3578766805,18
3,1565,45033,3578766787,3578766807,20
3,1565,45034,3578766787,3578766808,21
3,1565,45035,3578766787,3578766808,21
3,1565,45036,3578766787,3578766809,22
3,1565,45037,3578766787,3578766810,23
3,1565,45038,3578766787,3578766815,28
3,1565,45039,3578766787,3578766816,29
3,1565,45040,3578766787,3578766822,35
3,1565,45041,3578766787,3578766823,36
3,1565,45042,3578766787,3578766826,39
3,1565,45043,3578766787,3578766827,40
3,1565,45044,3578766787,3578766827,40
3,1565,45045,3578766787,3578766829,42
3,1565,45046,3578766787,3578766832,45
3,1565,45047,3578766787,3578766832,45
3,1565,45048,3578766787,3578766834,47
3,1565,45049,3578766787,3578766835,48
3,1566,45050,3578766852,3578766852,0
3,1566,45051,3578766852,3578766852,0
3,1566,45052,3578766852,3578766852,0
3,1566,45053,3578766852,3578766852,0
3,1566,45054,3578766852,3578766852,0
3,1566,45055,3578766852,3578766855,3
3,1566,45056,3578766852,3578766857,5
3,1566,45057,3578766852,3578766857,5
3,1566,45058,3578766852,3578766861,9
3,1566,45059,3578766852,3578766862,10
3,1566,45060,3578766852,3578766868,16
3,1566,45061,3578766852,3578766883,31
3,1566,45062,3578766852,3578766883,31
3,1566,45063,3578766852,3578766884,32
3,1566,45064,3578766852,3578766886,34
3,1566,45065,3578766852,3578766886,34
3,1566,45066,3578766852,3578766886,34
3,1566,45067,3578766852,3578766889,37
3,1566,45068,3578766852,3578766892,40
3,1566,45069,3578766852,3578766893,41
3,1566,45070,3578766852,3578766895,43
3,1566,45071,3578766852,3578766895,43
3,1566,45072,3578766852,3578766897,45
3,1566,45073,3578766852,3578766898,46
3,1567,45074,3578766916,3578766916,0
3,1567,45075,3578766916,3578766916,0
3,1567,45076,3578766916,3578766916,0
3,1567,45077,3578766916,3578766916,0
3,1567,45078,3578766916,3578766916,0
3,1567,45079,3578766916,3578766916,0
3,1567,45080,3578766916,3578766916,0
3,1567,45081,3578766916,3578766916,0
3,1567,45082,3578766916,3578766916,0
3,1567,45083,3578766916,3578766917,1
3,1567,45084,3578766916,3578766920,4
3,1567,45085,3578766916,3578766920,4
3,1567,45086,3578766916,3578766921,5
3,1567,45087,3578766916,3578766923,7
3,1567,45088,3578766916,3578766924,8
3,1567,45089,3578766916,3578766928,12
3,1567,45090,3578766916,3578766931,15
3,1567,45091,3578766916,3578766942,26
3,1567,45092,3578766916,3578766942,26
3,1567,45093,3578766916,3578766945,29
3,1567,45094,3578766916,3578766952,36
3,1567,45095,3578766916,3578766956,40
3,1567,45096,3578766916,3578766957,41
3,1567,45097,3578766916,3578766961,45
3,1567,45098,3578766916,3578766965,49
3,1568,45099,3578766981,3578766981,0
3,1568,45100,3578766981,3578766981,0
3,1568,45101,3578766981,3578766981,0
3,1568,45102,3578766981,3578766981,0
3,1568,45103,3578766981,3578766981,0
3,1568,45104,3578766981,3578766981,0
3,1568,45105,3578766981,3578766981,0
3,1568,45106,3578766981,3578766981,0
3,1568,45107,3578766981,3578766981,0
3,1568,45108,3578766981,3578766981,0
3,1568,45109,3578766981,3578766981,0
3,1568,45110,3578766981,3578766982,1
3,1568,45111,3578766981,3578766983,2
3,1568,45112,3578766981,3578766987,6
3,1568,45113,3578766981,3578766987,6
3,1568,45114,3578766981,3578766987,6
3,1568,45115,3578766981,3578766988,7
3,1568,45116,3578766981,3578766992,11
3,1568,45117,3578766981,3578766993,12
3,1568,45118,3578766981,3578766994,13
3,1568,45119,3578766981,3578766995,14
3,1568,45120,3578766981,3578766999,18
3,1568,45121,3578766981,3578767002,21
3,1568,45122,3578766981,3578767005,24
3,1568,45123,3578766981,3578767005,24
3,1568,45124,3578766981,3578767005,24
3,1568,45125,3578766981,3578767005,24
3,1568,45126,3578766981,3578767005,24
3,1568,45127,3578766981,3578767008,27
3,1568,45128,3578766981,3578767008,27
3,1568,45129,3578766981,3578767009,28
3,1568,45130,3578766981,3578767009,28
3,1568,45131,3578766981,3578767009,28
3,1568,45132,3578766981,3578767015,34
3,1568,45133,3578766981,3578767015,34
3,1568,45134,3578766981,3578767021,40
3,1568,45135,3578766981,3578767022,41
3,1568,45136,3578766981,3578767024,43
3,1568,45137,3578766981,3578767026,45
3,1568,45138,3578766981,3578767028,47
3,1568,45139,3578766981,3578767028,47
3,1568,45140,3578766981,3578767029,48
3,1568,45141,3578766981,3578767031,50
3,1569,45142,3578767045,3578767045,0
3,1569,45143,3578767045,3578767045,0
3,1569,45144,3578767045,3578767045,0
3,1569,45145,3578767045,3578767045,0
3,1569,45146,3578767045,3578767045,0
3,1569,45147,3578767045,3578767045,0
3,1569,45148,3578767045,3578767045,0
3,1569,45149,3578767045,3578767045,0
3,1569,45150,3578767045,3578767045,0
3,1569,45151,3578767045,3578767047,2
3,1569,45152,3578767045,3578767051,6
3,1569,45153,3578767045,3578767054,9
3,1569,45154,3578767045,3578767055,10
3,1569,45155,3578767045,3578767058,13
3,1569,45156,3578767045,3578767058,13
3,1569,45157,3578767045,3578767062,17
3,1569,45158,3578767045,3578767064,19
3,1569,45159,3578767045,3578767068,23
3,1569,45160,3578767045,3578767083,38
3,1569,45161,3578767045,3578767083,38
3,1569,45162,3578767045,3578767084,39
3,1569,45163,3578767045,3578767085,40
3,1569,45164,3578767045,3578767086,41
3,1569,45165,3578767045,3578767087,42
3,1569,45166,3578767045,3578767089,44
3,1569,45167,3578767045,3578767092,47
3,1569,45168,3578767045,3578767093,48
3,1569,45169,3578767045,3578767094,49
3,1570,45170,3578767109,3578767109,0
3,1570,45171,3578767109,3578767109,0
3,1570,45172,3578767109,3578767109,0
3,1570,45173,3578767109,3578767109,0
3,1570,45174,3578767109,3578767109,0
3,1570,45175,3578767109,3578767109,0
3,1570,45176,3578767109,3578767112,3
3,1570,45177,3578767109,3578767114,5
3,1570,45178,3578767109,3578767114,5
3,1570,45179,3578767109,3578767116,7
3,1570,45180,3578767109,3578767117,8
3,1570,45181,3578767109,3578767120,11
3,1570,45182,3578767109,3578767120,11
3,1570,45183,3578767109,3578767121,12
3,1570,45184,3578767109,3578767123,14
3,1570,45185,3578767109,3578767123,14
3,1570,45186,3578767109,3578767128,19
3,1570,45187,3578767109,3578767132,23
3,1570,45188,3578767109,3578767142,33
3,1570,45189,3578767109,3578767145,36
3,1570,45190,3578767109,3578767148,39
3,1570,45191,3578767109,3578767152,43
3,1570,45192,3578767109,3578767157,48
3,1570,45193,3578767109,3578767158,49
3,1571,45194,3578767173,3578767173,0
3,1571,45195,3578767173,3578767173,0
3,1571,45196,3578767173,3578767173,0
3,1571,45197,3578767173,3578767173,0
3,1571,45198,3578767173,3578767173,0
3,1571,45199,3578767173,3578767173,0
3,1571,45200,3578767173,3578767173,0
3,1571,45201,3578767173,3578767173,0
3,1571,45202,3578767173,3578767173,0
3,1571,45203,3578767173,3578767173,0
3,1571,45204,3578767173,3578767173,0
3,1571,45205,3578767173,3578767176,3
3,1571,45206,3578767173,3578767178,5
3,1571,45207,3578767173,3578767182,9
3,1571,45208,3578767173,3578767183,10
3,1571,45209,3578767173,3578767186,13
3,1571,45210,3578767173,3578767187,14
3,1571,45211,3578767173,3578767188,15
3,1571,45212,3578767173,3578767189,16
3,1571,45213,3578767173,3578767193,20
3,1571,45214,3578767173,3578767194,21
3,1571,45215,3578767173,3578767194,21
3,1571,45216,3578767173,3578767197,24
3,1571,45217,3578767173,3578767199,26
3,1571,45218,3578767173,3578767203,30
3,1571,45219,3578767173,3578767204,31
3,1571,45220,3578767173,3578767205,32
3,1571,45221,3578767173,3578767205,32
3,1571,45222,3578767173,3578767206,33
3,1571,45223,3578767173,3578767208,35
3,1571,45224,3578767173,3578767209,36
3,1571,45225,3578767173,3578767209,36
3,1571,45226,3578767173,3578767209,36
3,1571,45227,3578767173,3578767210,37
3,1571,45228,3578767173,3578767216,43
3,1571,45229,3578767173,3578767217,44
3,1572,45230,3578767239,3578767239,0
3,1572,45231,3578767239,3578767239,0
3,1572,45232,3578767239,3578767239,0
3,1572,45233,3578767239,3578767239,0
3,1572,45234,3578767239,3578767239,0
3,1572,45235,3578767239,3578767239,0
3,1572,45236,3578767239,3578767239,0
3,1572,45237,3578767239,3578767239,0
3,1572,45238,3578767239,3578767239,0
3,1572,45239,3578767239,3578767239,0
3,1572,45240,3578767239,3578767239,0
3,1572,45241,3578767239,3578767240,1
3,1572,45242,3578767239,3578767243,4
3,1572,45243,3578767239,3578767246,7
3,1572,45244,3578767239,3578767246,7
3,1572,45245,3578767239,3578767246,7
3,1572,45246,3578767239,3578767252,13
3,1572,45247,3578767239,3578767253,14
3,1572,45248,3578767239,3578767256,17
3,1572,45249,3578767239,3578767258,19
3,1572,45250,3578767239,3578767258,19
3,1572,45251,3578767239,3578767262,23
3,1572,45252,3578767239,3578767264,25
3,1572,45253,3578767239,3578767268,29
3,1572,45254,3578767239,3578767283,44
3,1572,45255,3578767239,3578767284,45
3,1572,45256,3578767239,3578767286,47
3,1572,45257,3578767239,3578767286,47
3,1572,45258,3578767239,3578767286,47
3,1572,45259,3578767239,3578767289,50
3,1573,45260,3578767304,3578767304,0
3,1573,45261,3578767304,3578767304,0
3,1573,45262,3578767304,3578767304,0
3,1573,45263,3578767304,3578767304,0
3,1573,45264,3578767304,3578767304,0
3,1573,45265,3578767304,3578767304,0
3,1573,45266,3578767304,3578767304,0
3,1573,45267,3578767304,3578767304,0
3,1573,45268,3578767304,3578767306,2
3,1573,45269,3578767304,3578767309,5
3,1573,45270,3578767304,3578767311,7
3,1573,45271,3578767304,3578767312,8
3,1573,45272,3578767304,3578767314,10
3,1573,45273,3578767304,3578767315,11
3,1573,45274,3578767304,3578767316,12
3,1573,45275,3578767304,3578767316,12
3,1573,45276,3578767304,3578767317,13
3,1573,45277,3578767304,3578767320,16
3,1573,45278,3578767304,3578767320,16
3,1573,45279,3578767304,3578767320,16
3,1573,45280,3578767304,3578767323,19
3,1573,45281,3578767304,3578767324,20
3,1573,45282,3578767304,3578767330,26
3,1573,45283,3578767304,3578767332,28
3,1573,45284,3578767304,3578767342,38
3,1573,45285,3578767304,3578767346,42
3,1573,45286,3578767304,3578767348,44
3,1574,45287,3578767368,3578767369,1
3,1574,45288,3578767368,3578767369,1
3,1574,45289,3578767368,3578767369,1
3,1574,45290,3578767368,3578767369,1
3,1574,45291,3578767368,3578767369,1
3,1574,45292,3578767368,3578767369,1
3,1574,45293,3578767368,3578767369,1
3,1574,45294,3578767368,3578767369,1
3,1574,45295,3578767368,3578767369,1
3,1574,45296,3578767368,3578767369,1
3,1574,45297,3578767368,3578767371,3
3,1574,45298,3578767368,3578767371,3
3,1574,45299,3578767368,3578767373,5
3,1574,45300,3578767368,3578767376,8
3,1574,45301,3578767368,3578767379,11
3,1574,45302,3578767368,3578767383,15
3,1574,45303,3578767368,3578767383,15
3,1574,45304,3578767368,3578767387,19
3,1574,45305,3578767368,3578767387,19
3,1574,45306,3578767368,3578767388,20
3,1574,45307,3578767368,3578767389,21
3,1574,45308,3578767368,3578767394,26
3,1574,45309,3578767368,3578767394,26
3,1574,45310,3578767368,3578767397,29
3,1574,45311,3578767368,3578767399,31
3,1574,45312,3578767368,3578767402,34
3,1574,45313,3578767368,3578767404,36
3,1574,45314,3578767368,3578767405,37
3,1574,45315,3578767368,3578767405,37
3,1574,45316,3578767368,3578767406,38
3,1574,45317,3578767368,3578767407,39
3,1574,45318,3578767368,3578767409,41
3,1574,45319,3578767368,3578767409,41
3,1574,45320,3578767368,3578767410,42
3,1574,45321,3578767368,3578767416,48
3,1574,45322,3578767368,3578767416,48
3,1575,45323,3578767435,3578767435,0
3,1575,45324,3578767435,3578767435,0
3,1575,45325,3578767435,3578767435,0
3,1575,45326,3578767435,3578767435,0
3,1575,45327,3578767435,3578767435,0
3,1575,45328,3578767435,3578767435,0
3,1575,45329,3578767435,3578767435,0
3,1575,45330,3578767435,3578767435,0
3,1575,45331,3578767435,3578767435,0
3,1575,45332,3578767435,3578767436,1
3,1575,45333,3578767435,3578767439,4
3,1575,45334,3578767435,3578767440,5
3,1575,45335,3578767435,3578767443,8
3,1575,45336,3578767435,3578767443,8
3,1575,45337,3578767435,3578767445,10
3,1575,45338,3578767435,3578767447,12
3,1575,45339,3578767435,3578767452,17
3,1575,45340,3578767435,3578767454,19
3,1575,45341,3578767435,3578767456,21
3,1575,45342,3578767435,3578767457,22
3,1575,45343,3578767435,3578767459,24
3,1575,45344,3578767435,3578767459,24
3,1575,45345,3578767435,3578767462,27
3,1575,45346,3578767435,3578767463,28
3,1575,45347,3578767435,3578767465,30
3,1575,45348,3578767435,3578767469,34
3,1575,45349,3578767435,3578767483,48
3,1575,45350,3578767435,3578767484,49
3,1575,45351,3578767435,3578767485,50
3,1576,45352,3578767499,3578767499,0
3,1576,45353,3578767499,3578767499,0
3,1576,45354,3578767499,3578767499,0
3,1576,45355,3578767499,3578767499,0
3,1576,45356,3578767499,3578767499,0
3,1576,45357,3578767499,3578767499,0
3,1576,45358,3578767499,3578767499,0
3,1576,45359,3578767499,3578767499,0
3,1576,45360,3578767499,3578767499,0
3,1576,45361,3578767499,3578767499,0
3,1576,45362,3578767499,3578767503,4
3,1576,45363,3578767499,3578767505,6
3,1576,45364,3578767499,3578767507,8
3,1576,45365,3578767499,3578767509,10
3,1576,45366,3578767499,3578767511,12
3,1576,45367,3578767499,3578767513,14
3,1576,45368,3578767499,3578767514,15
3,1576,45369,3578767499,3578767515,16
3,1576,45370,3578767499,3578767515,16
3,1576,45371,3578767499,3578767516,17
3,1576,45372,3578767499,3578767519,20
3,1576,45373,3578767499,3578767519,20
3,1576,45374,3578767499,3578767522,23
3,1576,45375,3578767499,3578767524,25
3,1576,45376,3578767499,3578767528,29
3,1576,45377,3578767499,3578767532,33
3,1576,45378,3578767499,3578767541,42
3,1576,45379,3578767499,3578767545,46
3,1576,45380,3578767499,3578767548,49
3,1577,45381,3578767564,3578767564,0
3,1577,45382,3578767564,3578767564,0
3,1577,45383,3578767564,3578767564,0
3,1577,45384,3578767564,3578767564,0
3,1577,45385,3578767564,3578767564,0
3,1577,45386,3578767564,3578767566,2
3,1577,45387,3578767564,3578767568,4
3,1577,45388,3578767564,3578767568,4
3,1577,45389,3578767564,3578767568,4
3,1577,45390,3578767564,3578767569,5
3,1577,45391,3578767564,3578767569,5
3,1577,45392,3578767564,3578767571,7
3,1577,45393,3578767564,3578767572,8
3,1577,45394,3578767564,3578767574,10
3,1577,45395,3578767564,3578767576,12
3,1577,45396,3578767564,3578767579,15
3,1577,45397,3578767564,3578767582,18
3,1577,45398,3578767564,3578767585,21
3,1577,45399,3578767564,3578767586,22
3,1577,45400,3578767564,3578767587,23
3,1577,45401,3578767564,3578767588,24
3,1577,45402,3578767564,3578767592,28
3,1577,45403,3578767564,3578767593,29
3,1577,45404,3578767564,3578767594,30
3,1577,45405,3578767564,3578767595,31
3,1577,45406,3578767564,3578767599,35
3,1577,45407,3578767564,3578767601,37
3,1577,45408,3578767564,3578767604,40
3,1577,45409,3578767564,3578767604,40
3,1577,45410,3578767564,3578767605,41
3,1577,45411,3578767564,3578767606,42
3,1577,45412,3578767564,3578767608,44
3,1577,45413,3578767564,3578767608,44
3,1577,45414,3578767564,3578767608,44
3,1577,45415,3578767564,3578767609,45
3,1578,45416,3578767629,3578767629,0
3,1578,45417,3578767629,3578767629,0
3,1578,45418,3578767629,3578767629,0
3,1578,45419,3578767629,3578767629,0
3,1578,45420,3578767629,3578767629,0
3,1578,45421,3578767629,3578767629,0
3,1578,45422,3578767629,3578767629,0
3,1578,45423,3578767629,3578767629,0
3,1578,45424,3578767629,3578767629,0
3,1578,45425,3578767629,3578767635,6
3,1578,45426,3578767629,3578767635,6
3,1578,45427,3578767629,3578767638,9
3,1578,45428,3578767629,3578767640,11
3,1578,45429,3578767629,3578767643,14
3,1578,45430,3578767629,3578767644,15
3,1578,45431,3578767629,3578767645,16
3,1578,45432,3578767629,3578767646,17
3,1578,45433,3578767629,3578767650,21
3,1578,45434,3578767629,3578767654,25
3,1578,45435,3578767629,3578767656,27
3,1578,45436,3578767629,3578767657,28
3,1578,45437,3578767629,3578767658,29
3,1578,45438,3578767629,3578767658,29
3,1578,45439,3578767629,3578767661,32
3,1578,45440,3578767629,3578767664,35
3,1578,45441,3578767629,3578767669,40
3,1579,45442,3578767695,3578767695,0
3,1579,45443,3578767695,3578767695,0
3,1579,45444,3578767695,3578767695,0
3,1579,45445,3578767695,3578767695,0
3,1579,45446,3578767695,3578767695,0
3,1579,45447,3578767695,3578767695,0
3,1579,45448,3578767695,3578767695,0
3,1579,45449,3578767695,3578767695,0
3,1579,45450,3578767695,3578767695,0
3,1579,45451,3578767695,3578767695,0
3,1579,45452,3578767695,3578767696,1
3,1579,45453,3578767695,3578767696,1
3,1579,45454,3578767695,3578767697,2
3,1579,45455,3578767695,3578767702,7
3,1579,45456,3578767695,3578767705,10
3,1579,45457,3578767695,3578767707,12
3,1579,45458,3578767695,3578767710,15
3,1579,45459,3578767695,3578767711,16
3,1579,45460,3578767695,3578767713,18
3,1579,45461,3578767695,3578767714,19
3,1579,45462,3578767695,3578767714,19
3,1579,45463,3578767695,3578767715,20
3,1579,45464,3578767695,3578767716,21
3,1579,45465,3578767695,3578767719,24
3,1579,45466,3578767695,3578767721,26
3,1579,45467,3578767695,3578767721,26
3,1579,45468,3578767695,3578767724,29
3,1579,45469,3578767695,3578767728,33
3,1579,45470,3578767695,3578767731,36
3,1579,45471,3578767695,3578767740,45
3,1579,45472,3578767695,3578767743,48
3,1580,45473,3578767762,3578767762,0
3,1580,45474,3578767762,3578767762,0
3,1580,45475,3578767762,3578767762,0
3,1580,45476,3578767762,3578767762,0
3,1580,45477,3578767762,3578767765,3
3,1580,45478,3578767762,3578767765,3
3,1580,45479,3578767762,3578767768,6
3,1580,45480,3578767762,3578767768,6
3,1580,45481,3578767762,3578767768,6
3,1580,45482,3578767762,3578767769,7
3,1580,45483,3578767762,3578767769,7
3,1580,45484,3578767762,3578767769,7
3,1580,45485,3578767762,3578767771,9
3,1580,45486,3578767762,3578767772,10
3,1580,45487,3578767762,3578767774,12
3,1580,45488,3578767762,3578767775,13
3,1580,45489,3578767762,3578767778,16
3,1580,45490,3578767762,3578767782,20
3,1580,45491,3578767762,3578767782,20
3,1580,45492,3578767762,3578767785,23
3,1580,45493,3578767762,3578767786,24
3,1580,45494,3578767762,3578767787,25
3,1580,45495,3578767762,3578767788,26
3,1580,45496,3578767762,3578767792,30
3,1580,45497,3578767762,3578767794,32
3,1580,45498,3578767762,3578767794,32
3,1580,45499,3578767762,3578767795,33
3,1580,45500,3578767762,3578767799,37
3,1580,45501,3578767762,3578767802,40
3,1580,45502,3578767762,3578767804,42
3,1580,45503,3578767762,3578767804,42
3,1580,45504,3578767762,3578767805,43
3,1580,45505,3578767762,3578767806,44
3,1580,45506,3578767762,3578767808,46
3,1580,45507,3578767762,3578767808,46
3,1580,45508,3578767762,3578767808,46
3,1580,45509,3578767762,3578767810,48
3,1581,45510,3578767825,3578767826,1
3,1581,45511,3578767825,3578767826,1
3,1581,45512,3578767825,3578767826,1
3,1581,45513,3578767825,3578767826,1
3,1581,45514,3578767825,3578767826,1
3,1581,45515,3578767825,3578767826,1
3,1581,45516,3578767825,3578767827,2
3,1581,45517,3578767825,3578767827,2
3,1581,45518,3578767825,3578767828,3
3,1581,45519,3578767825,3578767834,9
3,1581,45520,3578767825,3578767838,13
3,1581,45521,3578767825,3578767839,14
3,1581,45522,3578767825,3578767843,18
3,1581,45523,3578767825,3578767843,18
3,1581,45524,3578767825,3578767845,20
3,1581,45525,3578767825,3578767847,22
3,1581,45526,3578767825,3578767851,26
3,1581,45527,3578767825,3578767853,28
3,1581,45528,3578767825,3578767856,31
3,1581,45529,3578767825,3578767857,32
3,1581,45530,3578767825,3578767857,32
3,1581,45531,3578767825,3578767857,32
3,1581,45532,3578767825,3578767861,36
3,1581,45533,3578767825,3578767863,38
3,1581,45534,3578767825,3578767864,39
3,1581,45535,3578767825,3578767868,43
3,1582,45536,3578767892,3578767892,0
3,1582,45537,3578767892,3578767892,0
3,1582,45538,3578767892,3578767892,0
3,1582,45539,3578767892,3578767892,0
3,1582,45540,3578767892,3578767892,0
3,1582,45541,3578767892,3578767892,0
3,1582,45542,3578767892,3578767892,0
3,1582,45543,3578767892,3578767892,0
3,1582,45544,3578767892,3578767893,1
3,1582,45545,3578767892,3578767893,1
3,1582,45546,3578767892,3578767894,2
3,1582,45547,3578767892,3578767895,3
3,1582,45548,3578767892,3578767895,3
3,1582,45549,3578767892,3578767896,4
3,1582,45550,3578767892,3578767902,10
3,1582,45551,3578767892,3578767905,13
3,1582,45552,3578767892,3578767907,15
3,1582,45553,3578767892,3578767910,18
3,1582,45554,3578767892,3578767912,20
3,1582,45555,3578767892,3578767913,21
3,1582,45556,3578767892,3578767914,22
3,1582,45557,3578767892,3578767915,23
3,1582,45558,3578767892,3578767915,23
3,1582,45559,3578767892,3578767916,24
3,1582,45560,3578767892,3578767919,27
3,1582,45561,3578767892,3578767920,28
3,1582,45562,3578767892,3578767920,28
3,1582,45563,3578767892,3578767922,30
3,1582,45564,3578767892,3578767925,33
3,1582,45565,3578767892,3578767928,36
3,1582,45566,3578767892,3578767932,40
3,1582,45567,3578767892,3578767941,49
3,1583,45568,3578767958,3578767958,0
3,1583,45569,3578767958,3578767958,0
3,1583,45570,3578767958,3578767958,0
3,1583,45571,3578767958,3578767958,0
3,1583,45572,3578767958,3578767958,0
3,1583,45573,3578767958,3578767961,3
3,1583,45574,3578767958,3578767965,7
3,1583,45575,3578767958,3578767966,8
3,1583,45576,3578767958,3578767968,10
3,1583,45577,3578767958,3578767968,10
3,1583,45578,3578767958,3578767969,11
3,1583,45579,3578767958,3578767969,11
3,1583,45580,3578767958,3578767969,11
3,1583,45581,3578767958,3578767970,12
3,1583,45582,3578767958,3578767972,14
3,1583,45583,3578767958,3578767972,14
3,1583,45584,3578767958,3578767974,16
3,1583,45585,3578767958,3578767975,17
3,1583,45586,3578767958,3578767979,21
3,1583,45587,3578767958,3578767982,24
3,1583,45588,3578767958,3578767982,24
3,1583,45589,3578767958,3578767985,27
3,1583,45590,3578767958,3578767986,28
3,1583,45591,3578767958,3578767987,29
3,1583,45592,3578767958,3578767992,34
3,1583,45593,3578767958,3578767993,35
3,1583,45594,3578767958,3578767994,36
3,1583,45595,3578767958,3578767995,37
3,1583,45596,3578767958,3578767999,41
3,1583,45597,3578767958,3578768003,45
3,1583,45598,3578767958,3578768003,45
3,1583,45599,3578767958,3578768004,46
3,1583,45600,3578767958,3578768004,46
3,1583,45601,3578767958,3578768005,47
3,1583,45602,3578767958,3578768006,48
3,1583,45603,3578767958,3578768008,50
3,1584,45604,3578768021,3578768021,0
3,1584,45605,3578768021,3578768021,0
3,1584,45606,3578768021,3578768021,0
3,1584,45607,3578768021,3578768021,0
3,1584,45608,3578768021,3578768021,0
3,1584,45609,3578768021,3578768021,0
3,1584,45610,3578768021,3578768022,1
3,1584,45611,3578768021,3578768023,2
3,1584,45612,3578768021,3578768024,3
3,1584,45613,3578768021,3578768026,5
3,1584,45614,3578768021,3578768027,6
3,1584,45615,3578768021,3578768028,7
3,1584,45616,3578768021,3578768028,7
3,1584,45617,3578768021,3578768032,11
3,1584,45618,3578768021,3578768032,11
3,1584,45619,3578768021,3578768035,14
3,1584,45620,3578768021,3578768037,16
3,1584,45621,3578768021,3578768038,17
3,1584,45622,3578768021,3578768039,18
3,1584,45623,3578768021,3578768043,22
3,1584,45624,3578768021,3578768044,23
3,1584,45625,3578768021,3578768045,24
3,1584,45626,3578768021,3578768047,26
3,1584,45627,3578768021,3578768051,30
3,1584,45628,3578768021,3578768054,33
3,1584,45629,3578768021,3578768057,36
3,1584,45630,3578768021,3578768057,36
3,1584,45631,3578768021,3578768058,37
3,1584,45632,3578768021,3578768058,37
3,1584,45633,3578768021,3578768061,40
3,1584,45634,3578768021,3578768063,42
3,1584,45635,3578768021,3578768065,44
3,1584,45636,3578768021,3578768069,48
3,1585,45637,3578768084,3578768084,0
3,1585,45638,3578768084,3578768084,0
3,1585,45639,3578768084,3578768085,1
3,1585,45640,3578768084,3578768085,1
3,1585,45641,3578768084,3578768086,2
3,1585,45642,3578768084,3578768087,3
3,1585,45643,3578768084,3578768089,5
3,1585,45644,3578768084,3578768092,8
3,1585,45645,3578768084,3578768093,9
3,1585,45646,3578768084,3578768093,9
3,1585,45647,3578768084,3578768094,10
3,1585,45648,3578768084,3578768095,11
3,1585,45649,3578768084,3578768096,12
3,1585,45650,3578768084,3578768097,13
3,1585,45651,3578768084,3578768102,18
3,1585,45652,3578768084,3578768105,21
3,1585,45653,3578768084,3578768107,23
3,1585,45654,3578768084,3578768111,27
3,1585,45655,3578768084,3578768111,27
3,1585,45656,3578768084,3578768113,29
3,1585,45657,3578768084,3578768115,31
3,1585,45658,3578768084,3578768115,31
3,1585,45659,3578768084,3578768115,31
3,1585,45660,3578768084,3578768117,33
3,1585,45661,3578768084,3578768119,35
3,1585,45662,3578768084,3578768120,36
3,1585,45663,3578768084,3578768121,37
3,1585,45664,3578768084,3578768124,40
3,1585,45665,3578768084,3578768128,44
3,1585,45666,3578768084,3578768131,47
3,1586,45667,3578768149,3578768149,0
3,1586,45668,3578768149,3578768149,0
3,1586,45669,3578768149,3578768149,0
3,1586,45670,3578768149,3578768149,0
3,1586,45671,3578768149,3578768155,6
3,1586,45672,3578768149,3578768158,9
3,1586,45673,3578768149,3578768162,13
3,1586,45674,3578768149,3578768166,17
3,1586,45675,3578768149,3578768168,19
3,1586,45676,3578768149,3578768168,19
3,1586,45677,3578768149,3578768168,19
3,1586,45678,3578768149,3578768169,20
3,1586,45679,3578768149,3578768170,21
3,1586,45680,3578768149,3578768170,21
3,1586,45681,3578768149,3578768171,22
3,1586,45682,3578768149,3578768173,24
3,1586,45683,3578768149,3578768174,25
3,1586,45684,3578768149,3578768177,28
3,1586,45685,3578768149,3578768179,30
3,1586,45686,3578768149,3578768181,32
3,1586,45687,3578768149,3578768182,33
3,1586,45688,3578768149,3578768185,36
3,1586,45689,3578768149,3578768186,37
3,1586,45690,3578768149,3578768187,38
3,1586,45691,3578768149,3578768189,40
3,1586,45692,3578768149,3578768192,43
3,1586,45693,3578768149,3578768194,45
3,1586,45694,3578768149,3578768194,45
3,1586,45695,3578768149,3578768196,47
3,1587,45696,3578768215,3578768215,0
3,1587,45697,3578768215,3578768215,0
3,1587,45698,3578768215,3578768215,0
3,1587,45699,3578768215,3578768215,0
3,1587,45700,3578768215,3578768215,0
3,1587,45701,3578768215,3578768215,0
3,1587,45702,3578768215,3578768215,0
3,1587,45703,3578768215,3578768215,0
3,1587,45704,3578768215,3578768215,0
3,1587,45705,3578768215,3578768215,0
3,1587,45706,3578768215,3578768215,0
3,1587,45707,3578768215,3578768215,0
3,1587,45708,3578768215,3578768215,0
3,1587,45709,3578768215,3578768217,2
3,1587,45710,3578768215,3578768222,7
3,1587,45711,3578768215,3578768224,9
3,1587,45712,3578768215,3578768225,10
3,1587,45713,3578768215,3578768226,11
3,1587,45714,3578768215,3578768227,12
3,1587,45715,3578768215,3578768227,12
3,1587,45716,3578768215,3578768230,15
3,1587,45717,3578768215,3578768232,17
3,1587,45718,3578768215,3578768233,18
3,1587,45719,3578768215,3578768235,20
3,1587,45720,3578768215,3578768238,23
3,1587,45721,3578768215,3578768238,23
3,1587,45722,3578768215,3578768239,24
3,1587,45723,3578768215,3578768243,28
3,1587,45724,3578768215,3578768244,29
3,1587,45725,3578768215,3578768245,30
3,1587,45726,3578768215,3578768247,32
3,1587,45727,3578768215,3578768252,37
3,1587,45728,3578768215,3578768253,38
3,1587,45729,3578768215,3578768256,41
3,1587,45730,3578768215,3578768257,42
3,1587,45731,3578768215,3578768257,42
3,1587,45732,3578768215,3578768257,42
3,1587,45733,3578768215,3578768261,46
3,1587,45734,3578768215,3578768263,48
3,1587,45735,3578768215,3578768265,50
3,1588,45736,3578768280,3578768280,0
3,1588,45737,3578768280,3578768285,5
3,1588,45738,3578768280,3578768285,5
3,1588,45739,3578768280,3578768285,5
3,1588,45740,3578768280,3578768285,5
3,1588,45741,3578768280,3578768286,6
3,1588,45742,3578768280,3578768287,7
3,1588,45743,3578768280,3578768289,9
3,1588,45744,3578768280,3578768292,12
3,1588,45745,3578768280,3578768293,13
3,1588,45746,3578768280,3578768293,13
3,1588,45747,3578768280,3578768294,14
3,1588,45748,3578768280,3578768295,15
3,1588,45749,3578768280,3578768297,17
3,1588,45750,3578768280,3578768298,18
3,1588,45751,3578768280,3578768302,22
3,1588,45752,3578768280,3578768305,25
3,1588,45753,3578768280,3578768307,27
3,1588,45754,3578768280,3578768311,31
3,1588,45755,3578768280,3578768312,32
3,1588,45756,3578768280,3578768312,32
3,1588,45757,3578768280,3578768314,34
3,1588,45758,3578768280,3578768315,35
3,1588,45759,3578768280,3578768315,35
3,1588,45760,3578768280,3578768316,36
3,1588,45761,3578768280,3578768319,39
3,1588,45762,3578768280,3578768320,40
3,1588,45763,3578768280,3578768321,41
3,1588,45764,3578768280,3578768324,44
3,1588,45765,3578768280,3578768329,49
3,1589,45766,3578768347,3578768347,0
3,1589,45767,3578768347,3578768347,0
3,1589,45768,3578768347,3578768347,0
3,1589,45769,3578768347,3578768347,0
3,1589,45770,3578768347,3578768348,1
3,1589,45771,3578768347,3578768355,8
3,1589,45772,3578768347,3578768358,11
3,1589,45773,3578768347,3578768361,14
3,1589,45774,3578768347,3578768365,18
3,1589,45775,3578768347,3578768367,20
3,1589,45776,3578768347,3578768368,21
3,1589,45777,3578768347,3578768368,21
3,1589,45778,3578768347,3578768369,22
3,1589,45779,3578768347,3578768370,23
3,1589,45780,3578768347,3578768370,23
3,1589,45781,3578768347,3578768373,26
3,1589,45782,3578768347,3578768374,27
3,1589,45783,3578768347,3578768376,29
3,1589,45784,3578768347,3578768379,32
3,1589,45785,3578768347,3578768383,36
3,1589,45786,3578768347,3578768383,36
3,1589,45787,3578768347,3578768386,39
3,1589,45788,3578768347,3578768387,40
3,1589,45789,3578768347,3578768388,41
3,1589,45790,3578768347,3578768388,41
3,1589,45791,3578768347,3578768393,46
3,1589,45792,3578768347,3578768394,47
3,1589,45793,3578768347,3578768394,47
3,1589,45794,3578768347,3578768397,50
3,1590,45795,3578768412,3578768412,0
3,1590,45796,3578768412,3578768412,0
3,1590,45797,3578768412,3578768412,0
3,1590,45798,3578768412,3578768412,0
3,1590,45799,3578768412,3578768412,0
3,1590,45800,3578768412,3578768412,0
3,1590,45801,3578768412,3578768412,0
3,1590,45802,3578768412,3578768412,0
3,1590,45803,3578768412,3578768412,0
3,1590,45804,3578768412,3578768412,0
3,1590,45805,3578768412,3578768412,0
3,1590,45806,3578768412,3578768412,0
3,1590,45807,3578768412,3578768415,3
3,1590,45808,3578768412,3578768417,5
3,1590,45809,3578768412,3578768421,9
3,1590,45810,3578768412,3578768423,11
3,1590,45811,3578768412,3578768425,13
3,1590,45812,3578768412,3578768426,14
3,1590,45813,3578768412,3578768428,16
3,1590,45814,3578768412,3578768429,17
3,1590,45815,3578768412,3578768433,21
3,1590,45816,3578768412,3578768435,23
3,1590,45817,3578768412,3578768437,25
3,1590,45818,3578768412,3578768438,26
3,1590,45819,3578768412,3578768441,29
3,1590,45820,3578768412,3578768443,31
3,1590,45821,3578768412,3578768445,33
3,1590,45822,3578768412,3578768445,33
3,1590,45823,3578768412,3578768447,35
3,1590,45824,3578768412,3578768451,39
3,1590,45825,3578768412,3578768454,42
3,1590,45826,3578768412,3578768457,45
3,1590,45827,3578768412,3578768458,46
3,1590,45828,3578768412,3578768459,47
3,1590,45829,3578768412,3578768461,49
3,1591,45830,3578768477,3578768477,0
3,1591,45831,3578768477,3578768477,0
3,1591,45832,3578768477,3578768477,0
3,1591,45833,3578768477,3578768485,8
3,1591,45834,3578768477,3578768485,8
3,1591,45835,3578768477,3578768486,9
3,1591,45836,3578768477,3578768486,9
3,1591,45837,3578768477,3578768487,10
3,1591,45838,3578768477,3578768489,12
3,1591,45839,3578768477,3578768492,15
3,1591,45840,3578768477,3578768492,15
3,1591,45841,3578768477,3578768493,16
3,1591,45842,3578768477,3578768494,17
3,1591,45843,3578768477,3578768495,18
3,1591,45844,3578768477,3578768497,20
3,1591,45845,3578768477,3578768497,20
3,1591,45846,3578768477,3578768502,25
3,1591,45847,3578768477,3578768505,28
3,1591,45848,3578768477,3578768508,31
3,1591,45849,3578768477,3578768511,34
3,1591,45850,3578768477,3578768512,35
3,1591,45851,3578768477,3578768512,35
3,1591,45852,3578768477,3578768515,38
3,1591,45853,3578768477,3578768515,38
3,1591,45854,3578768477,3578768516,39
3,1591,45855,3578768477,3578768517,40
3,1591,45856,3578768477,3578768521,44
3,1591,45857,3578768477,3578768522,45
3,1592,45858,3578768542,3578768542,0
3,1592,45859,3578768542,3578768542,0
3,1592,45860,3578768542,3578768542,0
3,1592,45861,3578768542,3578768543,1
3,1592,45862,3578768542,3578768545,3
3,1592,45863,3578768542,3578768548,6
3,1592,45864,3578768542,3578768556,14
3,1592,45865,3578768542,3578768560,18
3,1592,45866,3578768542,3578768565,23
3,1592,45867,3578768542,3578768567,25
3,1592,45868,3578768542,3578768568,26
3,1592,45869,3578768542,3578768568,26
3,1592,45870,3578768542,3578768569,27
3,1592,45871,3578768542,3578768569,27
3,1592,45872,3578768542,3578768569,27
3,1592,45873,3578768542,3578768569,27
3,1592,45874,3578768542,3578768571,29
3,1592,45875,3578768542,3578768573,31
3,1592,45876,3578768542,3578768575,33
3,1592,45877,3578768542,3578768578,36
3,1592,45878,3578768542,3578768582,40
3,1592,45879,3578768542,3578768582,40
3,1592,45880,3578768542,3578768584,42
3,1592,45881,3578768542,3578768586,44
3,1592,45882,3578768542,3578768587,45
3,1592,45883,3578768542,3578768587,45
3,1593,45884,3578768606,3578768606,0
3,1593,45885,3578768606,3578768606,0
3,1593,45886,3578768606,3578768606,0
3,1593,45887,3578768606,3578768606,0
3,1593,45888,3578768606,3578768606,0
3,1593,45889,3578768606,3578768606,0
3,1593,45890,3578768606,3578768606,0
3,1593,45891,3578768606,3578768606,0
3,1593,45892,3578768606,3578768606,0
3,1593,45893,3578768606,3578768606,0
3,1593,45894,3578768606,3578768607,1
3,1593,45895,3578768606,3578768607,1
3,1593,45896,3578768606,3578768607,1
3,1593,45897,3578768606,3578768608,2
3,1593,45898,3578768606,3578768609,3
3,1593,45899,3578768606,3578768613,7
3,1593,45900,3578768606,3578768617,11
3,1593,45901,3578768606,3578768621,15
3,1593,45902,3578768606,3578768623,17
3,1593,45903,3578768606,3578768624,18
3,1593,45904,3578768606,3578768625,19
3,1593,45905,3578768606,3578768626,20
3,1593,45906,3578768606,3578768626,20
3,1593,45907,3578768606,3578768629,23
3,1593,45908,3578768606,3578768631,25
3,1593,45909,3578768606,3578768634,28
3,1593,45910,3578768606,3578768636,30
3,1593,45911,3578768606,3578768639,33
3,1593,45912,3578768606,3578768639,33
3,1593,45913,3578768606,3578768643,37
3,1593,45914,3578768606,3578768645,39
3,1593,45915,3578768606,3578768645,39
3,1593,45916,3578768606,3578768646,40
3,1593,45917,3578768606,3578768651,45
3,1593,45918,3578768606,3578768653,47
3,1594,45919,3578768671,3578768671,0
3,1594,45920,3578768671,3578768671,0
3,1594,45921,3578768671,3578768671,0
3,1594,45922,3578768671,3578768671,0
3,1594,45923,3578768671,3578768671,0
3,1594,45924,3578768671,3578768671,0
3,1594,45925,3578768671,3578768671,0
3,1594,45926,3578768671,3578768685,14
3,1594,45927,3578768671,3578768685,14
3,1594,45928,3578768671,3578768686,15
3,1594,45929,3578768671,3578768686,15
3,1594,45930,3578768671,3578768688,17
3,1594,45931,3578768671,3578768689,18
3,1594,45932,3578768671,3578768692,21
3,1594,45933,3578768671,3578768692,21
3,1594,45934,3578768671,3578768693,22
3,1594,45935,3578768671,3578768694,23
3,1594,45936,3578768671,3578768695,24
3,1594,45937,3578768671,3578768697,26
3,1594,45938,3578768671,3578768697,26
3,1594,45939,3578768671,3578768703,32
3,1594,45940,3578768671,3578768705,34
3,1594,45941,3578768671,3578768707,36
3,1594,45942,3578768671,3578768711,40
3,1594,45943,3578768671,3578768712,41
3,1594,45944,3578768671,3578768713,42
3,1594,45945,3578768671,3578768715,44
3,1594,45946,3578768671,3578768716,45
3,1594,45947,3578768671,3578768716,45
3,1594,45948,3578768671,3578768718,47
3,1594,45949,3578768671,3578768720,49
3,1594,45950,3578768671,3578768721,50
3,1595,45951,3578768736,3578768736,0
3,1595,45952,3578768736,3578768736,0
3,1595,45953,3578768736,3578768736,0
3,1595,45954,3578768736,3578768736,0
3,1595,45955,3578768736,3578768736,0
3,1595,45956,3578768736,3578768740,4
3,1595,45957,3578768736,3578768742,6
3,1595,45958,3578768736,3578768746,10
3,1595,45959,3578768736,3578768748,12
3,1595,45960,3578768736,3578768756,20
3,1595,45961,3578768736,3578768757,21
3,1595,45962,3578768736,3578768760,24
3,1595,45963,3578768736,3578768765,29
3,1595,45964,3578768736,3578768766,30
3,1595,45965,3578768736,3578768768,32
3,1595,45966,3578768736,3578768768,32
3,1595,45967,3578768736,3578768769,33
3,1595,45968,3578768736,3578768769,33
3,1595,45969,3578768736,3578768769,33
3,1595,45970,3578768736,3578768769,33
3,1595,45971,3578768736,3578768772,36
3,1595,45972,3578768736,3578768774,38
3,1595,45973,3578768736,3578768775,39
3,1595,45974,3578768736,3578768778,42
3,1595,45975,3578768736,3578768781,45
3,1595,45976,3578768736,3578768782,46
3,1595,45977,3578768736,3578768784,48
3,1595,45978,3578768736,3578768786,50
3,1596,45979,3578768801,3578768801,0
3,1596,45980,3578768801,3578768801,0
3,1596,45981,3578768801,3578768801,0
3,1596,45982,3578768801,3578768801,0
3,1596,45983,3578768801,3578768801,0
3,1596,45984,3578768801,3578768801,0
3,1596,45985,3578768801,3578768801,0
3,1596,45986,3578768801,3578768801,0
3,1596,45987,3578768801,3578768803,2
3,1596,45988,3578768801,3578768805,4
3,1596,45989,3578768801,3578768805,4
3,1596,45990,3578768801,3578768806,5
3,1596,45991,3578768801,3578768807,6
3,1596,45992,3578768801,3578768808,7
3,1596,45993,3578768801,3578768808,7
3,1596,45994,3578768801,3578768808,7
3,1596,45995,3578768801,3578768810,9
3,1596,45996,3578768801,3578768814,13
3,1596,45997,3578768801,3578768816,15
3,1596,45998,3578768801,3578768820,19
3,1596,45999,3578768801,3578768823,22
3,1596,46000,3578768801,3578768824,23
3,1596,46001,3578768801,3578768825,24
3,1596,46002,3578768801,3578768826,25
3,1596,46003,3578768801,3578768828,27
3,1596,46004,3578768801,3578768828,27
3,1596,46005,3578768801,3578768832,31
3,1596,46006,3578768801,3578768834,33
3,1596,46007,3578768801,3578768836,35
3,1596,46008,3578768801,3578768839,38
3,1596,46009,3578768801,3578768843,42
3,1596,46010,3578768801,3578768844,43
3,1596,46011,3578768801,3578768844,43
3,1596,46012,3578768801,3578768847,46
3,1596,46013,3578768801,3578768850,49
3,1597,46014,3578768866,3578768866,0
3,1597,46015,3578768866,3578768866,0
3,1597,46016,3578768866,3578768866,0
3,1597,46017,3578768866,3578768866,0
3,1597,46018,3578768866,3578768866,0
3,1597,46019,3578768866,3578768866,0
3,1597,46020,3578768866,3578768866,0
3,1597,46021,3578768866,3578768869,3
3,1597,46022,3578768866,3578768885,19
3,1597,46023,3578768866,3578768885,19
3,1597,46024,3578768866,3578768886,20
3,1597,46025,3578768866,3578768886,20
3,1597,46026,3578768866,3578768886,20
3,1597,46027,3578768866,3578768888,22
3,1597,46028,3578768866,3578768889,23
3,1597,46029,3578768866,3578768892,26
3,1597,46030,3578768866,3578768893,27
3,1597,46031,3578768866,3578768893,27
3,1597,46032,3578768866,3578768897,31
3,1597,46033,3578768866,3578768898,32
3,1597,46034,3578768866,3578768902,36
3,1597,46035,3578768866,3578768905,39
3,1597,46036,3578768866,3578768907,41
3,1597,46037,3578768866,3578768911,45
3,1597,46038,3578768866,3578768911,45
3,1597,46039,3578768866,3578768914,48
3,1597,46040,3578768866,3578768914,48
3,1597,46041,3578768866,3578768916,50
3,1598,46042,3578768932,3578768932,0
3,1598,46043,3578768932,3578768932,0
3,1598,46044,3578768932,3578768932,0
3,1598,46045,3578768932,3578768932,0
3,1598,46046,3578768932,3578768932,0
3,1598,46047,3578768932,3578768932,0
3,1598,46048,3578768932,3578768932,0
3,1598,46049,3578768932,3578768932,0
3,1598,46050,3578768932,3578768932,0
3,1598,46051,3578768932,3578768940,8
3,1598,46052,3578768932,3578768942,10
3,1598,46053,3578768932,3578768946,14
3,1598,46054,3578768932,3578768948,16
3,1598,46055,3578768932,3578768955,23
3,1598,46056,3578768932,3578768957,25
3,1598,46057,3578768932,3578768960,28
3,1598,46058,3578768932,3578768965,33
3,1598,46059,3578768932,3578768967,35
3,1598,46060,3578768932,3578768968,36
3,1598,46061,3578768932,3578768968,36
3,1598,46062,3578768932,3578768969,37
3,1598,46063,3578768932,3578768969,37
3,1598,46064,3578768932,3578768970,38
3,1598,46065,3578768932,3578768972,40
3,1598,46066,3578768932,3578768972,40
3,1598,46067,3578768932,3578768973,41
3,1598,46068,3578768932,3578768975,43
3,1598,46069,3578768932,3578768979,47
3,1598,46070,3578768932,3578768982,50
3,1599,46071,3578768997,3578768997,0
3,1599,46072,3578768997,3578768997,0
3,1599,46073,3578768997,3578768997,0
3,1599,46074,3578768997,3578768997,0
3,1599,46075,3578768997,3578768997,0
3,1599,46076,3578768997,3578768997,0
3,1599,46077,3578768997,3578768997,0
3,1599,46078,3578768997,3578768997,0
3,1599,46079,3578768997,3578768997,0
3,1599,46080,3578768997,3578768999,2
3,1599,46081,3578768997,3578769002,5
3,1599,46082,3578768997,3578769002,5
3,1599,46083,3578768997,3578769005,8
3,1599,46084,3578768997,3578769005,8
3,1599,46085,3578768997,3578769005,8
3,1599,46086,3578768997,3578769007,10
3,1599,46087,3578768997,3578769008,11
3,1599,46088,3578768997,3578769009,12
3,1599,46089,3578768997,3578769010,13
3,1599,46090,3578768997,3578769015,18
3,1599,46091,3578768997,3578769016,19
3,1599,46092,3578768997,3578769021,24
3,1599,46093,3578768997,3578769023,26
3,1599,46094,3578768997,3578769025,28
3,1599,46095,3578768997,3578769025,28
3,1599,46096,3578768997,3578769026,29
3,1599,46097,3578768997,3578769027,30
3,1599,46098,3578768997,3578769029,32
3,1599,46099,3578768997,3578769032,35
3,1599,46100,3578768997,3578769032,35
3,1599,46101,3578768997,3578769034,37
3,1599,46102,3578768997,3578769037,40
3,1599,46103,3578768997,3578769039,42
3,1599,46104,3578768997,3578769040,43
3,1599,46105,3578768997,3578769043,46
3,1599,46106,3578768997,3578769044,47
3,1599,46107,3578768997,3578769045,48
3,1600,46108,3578769062,3578769062,0
3,1600,46109,3578769062,3578769062,0
3,1600,46110,3578769062,3578769062,0
3,1600,46111,3578769062,3578769062,0
3,1600,46112,3578769062,3578769062,0
3,1600,46113,3578769062,3578769062,0
3,1600,46114,3578769062,3578769062,0
3,1600,46115,3578769062,3578769062,0
3,1600,46116,3578769062,3578769063,1
3,1600,46117,3578769062,3578769065,3
3,1600,46118,3578769062,3578769068,6
3,1600,46119,3578769062,3578769085,23
3,1600,46120,3578769062,3578769085,23
3,1600,46121,3578769062,3578769086,24
3,1600,46122,3578769062,3578769086,24
3,1600,46123,3578769062,3578769088,26
3,1600,46124,3578769062,3578769092,30
3,1600,46125,3578769062,3578769092,30
3,1600,46126,3578769062,3578769095,33
3,1600,46127,3578769062,3578769097,35
3,1600,46128,3578769062,3578769098,36
3,1600,46129,3578769062,3578769102,40
3,1600,46130,3578769062,3578769105,43
3,1600,46131,3578769062,3578769111,49
3,1600,46132,3578769062,3578769111,49
3,1601,46133,3578769128,3578769128,0
3,1601,46134,3578769128,3578769128,0
3,1601,46135,3578769128,3578769128,0
3,1601,46136,3578769128,3578769128,0
3,1601,46137,3578769128,3578769128,0
3,1601,46138,3578769128,3578769128,0
3,1601,46139,3578769128,3578769128,0
3,1601,46140,3578769128,3578769128,0
3,1601,46141,3578769128,3578769128,0
3,1601,46142,3578769128,3578769128,0
3,1601,46143,3578769128,3578769129,1
3,1601,46144,3578769128,3578769131,3
3,1601,46145,3578769128,3578769141,13
3,1601,46146,3578769128,3578769142,14
3,1601,46147,3578769128,3578769146,18
3,1601,46148,3578769128,3578769148,20
3,1601,46149,3578769128,3578769155,27
3,1601,46150,3578769128,3578769158,30
3,1601,46151,3578769128,3578769160,32
3,1601,46152,3578769128,3578769165,37
3,1601,46153,3578769128,3578769167,39
3,1601,46154,3578769128,3578769168,40
3,1601,46155,3578769128,3578769169,41
3,1601,46156,3578769128,3578769169,41
3,1601,46157,3578769128,3578769170,42
3,1601,46158,3578769128,3578769170,42
3,1601,46159,3578769128,3578769172,44
3,1601,46160,3578769128,3578769173,45
3,1601,46161,3578769128,3578769173,45
3,1601,46162,3578769128,3578769177,49
3,1602,46163,3578769193,3578769193,0
3,1602,46164,3578769193,3578769193,0
3,1602,46165,3578769193,3578769193,0
3,1602,46166,3578769193,3578769193,0
3,1602,46167,3578769193,3578769193,0
3,1602,46168,3578769193,3578769193,0
3,1602,46169,3578769193,3578769193,0
3,1602,46170,3578769193,3578769194,1
3,1602,46171,3578769193,3578769194,1
3,1602,46172,3578769193,3578769196,3
3,1602,46173,3578769193,3578769198,5
3,1602,46174,3578769193,3578769203,10
3,1602,46175,3578769193,3578769203,10
3,1602,46176,3578769193,3578769205,12
3,1602,46177,3578769193,3578769205,12
3,1602,46178,3578769193,3578769208,15
3,1602,46179,3578769193,3578769209,16
3,1602,46180,3578769193,3578769209,16
3,1602,46181,3578769193,3578769209,16
3,1602,46182,3578769193,3578769217,24
3,1602,46183,3578769193,3578769221,28
3,1602,46184,3578769193,3578769224,31
3,1602,46185,3578769193,3578769225,32
3,1602,46186,3578769193,3578769227,34
3,1602,46187,3578769193,3578769227,34
3,1602,46188,3578769193,3578769230,37
3,1602,46189,3578769193,3578769232,39
3,1602,46190,3578769193,3578769235,42
3,1602,46191,3578769193,3578769237,44
3,1602,46192,3578769193,3578769239,46
3,1602,46193,3578769193,3578769239,46
3,1602,46194,3578769193,3578769243,50
3,1603,46195,3578769257,3578769257,0
3,1603,46196,3578769257,3578769257,0
3,1603,46197,3578769257,3578769258,1
3,1603,46198,3578769257,3578769258,1
3,1603,46199,3578769257,3578769258,1
3,1603,46200,3578769257,3578769258,1
3,1603,46201,3578769257,3578769258,1
3,1603,46202,3578769257,3578769259,2
3,1603,46203,3578769257,3578769261,4
3,1603,46204,3578769257,3578769264,7
3,1603,46205,3578769257,3578769264,7
3,1603,46206,3578769257,3578769269,12
3,1603,46207,3578769257,3578769285,28
3,1603,46208,3578769257,3578769285,28
3,1603,46209,3578769257,3578769286,29
3,1603,46210,3578769257,3578769287,30
3,1603,46211,3578769257,3578769289,32
3,1603,46212,3578769257,3578769292,35
3,1603,46213,3578769257,3578769293,36
3,1603,46214,3578769257,3578769293,36
3,1603,46215,3578769257,3578769295,38
3,1603,46216,3578769257,3578769297,40
3,1603,46217,3578769257,3578769302,45
3,1603,46218,3578769257,3578769306,49
3,1604,46219,3578769322,3578769322,0
3,1604,46220,3578769322,3578769322,0
3,1604,46221,3578769322,3578769322,0
3,1604,46222,3578769322,3578769322,0
3,1604,46223,3578769322,3578769322,0
3,1604,46224,3578769322,3578769322,0
3,1604,46225,3578769322,3578769322,0
3,1604,46226,3578769322,3578769322,0
3,1604,46227,3578769322,3578769322,0
3,1604,46228,3578769322,3578769322,0
3,1604,46229,3578769322,3578769324,2
3,1604,46230,3578769322,3578769330,8
3,1604,46231,3578769322,3578769331,9
3,1604,46232,3578769322,3578769342,20
3,1604,46233,3578769322,3578769344,22
3,1604,46234,3578769322,3578769347,25
3,1604,46235,3578769322,3578769348,26
3,1604,46236,3578769322,3578769358,36
3,1604,46237,3578769322,3578769360,38
3,1604,46238,3578769322,3578769366,44
3,1604,46239,3578769322,3578769369,47
3,1604,46240,3578769322,3578769369,47
3,1604,46241,3578769322,3578769370,48
3,1604,46242,3578769322,3578769370,48
3,1604,46243,3578769322,3578769372,50
3,1605,46244,3578769388,3578769388,0
3,1605,46245,3578769388,3578769388,0
3,1605,46246,3578769388,3578769388,0
3,1605,46247,3578769388,3578769388,0
3,1605,46248,3578769388,3578769388,0
3,1605,46249,3578769388,3578769388,0
3,1605,46250,3578769388,3578769388,0
3,1605,46251,3578769388,3578769388,0
3,1605,46252,3578769388,3578769388,0
3,1605,46253,3578769388,3578769392,4
3,1605,46254,3578769388,3578769394,6
3,1605,46255,3578769388,3578769394,6
3,1605,46256,3578769388,3578769399,11
3,1605,46257,3578769388,3578769403,15
3,1605,46258,3578769388,3578769404,16
3,1605,46259,3578769388,3578769405,17
3,1605,46260,3578769388,3578769405,17
3,1605,46261,3578769388,3578769406,18
3,1605,46262,3578769388,3578769407,19
3,1605,46263,3578769388,3578769408,20
3,1605,46264,3578769388,3578769408,20
3,1605,46265,3578769388,3578769409,21
3,1605,46266,3578769388,3578769409,21
3,1605,46267,3578769388,3578769415,27
3,1605,46268,3578769388,3578769418,30
3,1605,46269,3578769388,3578769421,33
3,1605,46270,3578769388,3578769424,36
3,1605,46271,3578769388,3578769425,37
3,1605,46272,3578769388,3578769427,39
3,1605,46273,3578769388,3578769427,39
3,1605,46274,3578769388,3578769430,42
3,1605,46275,3578769388,3578769435,47
3,1605,46276,3578769388,3578769437,49
3,1606,46277,3578769453,3578769453,0
3,1606,46278,3578769453,3578769453,0
3,1606,46279,3578769453,3578769453,0
3,1606,46280,3578769453,3578769453,0
3,1606,46281,3578769453,3578769453,0
3,1606,46282,3578769453,3578769453,0
3,1606,46283,3578769453,3578769453,0
3,1606,46284,3578769453,3578769453,0
3,1606,46285,3578769453,3578769456,3
3,1606,46286,3578769453,3578769457,4
3,1606,46287,3578769453,3578769459,6
3,1606,46288,3578769453,3578769459,6
3,1606,46289,3578769453,3578769462,9
3,1606,46290,3578769453,3578769464,11
3,1606,46291,3578769453,3578769464,11
3,1606,46292,3578769453,3578769469,16
3,1606,46293,3578769453,3578769485,32
3,1606,46294,3578769453,3578769485,32
3,1606,46295,3578769453,3578769486,33
3,1606,46296,3578769453,3578769486,33
3,1606,46297,3578769453,3578769489,36
3,1606,46298,3578769453,3578769492,39
3,1606,46299,3578769453,3578769493,40
3,1606,46300,3578769453,3578769494,41
3,1606,46301,3578769453,3578769495,42
3,1606,46302,3578769453,3578769495,42
3,1606,46303,3578769453,3578769497,44
3,1606,46304,3578769453,3578769499,46
3,1606,46305,3578769453,3578769502,49
3,1607,46306,3578769520,3578769520,0
3,1607,46307,3578769520,3578769520,0
3,1607,46308,3578769520,3578769520,0
3,1607,46309,3578769520,3578769520,0
3,1607,46310,3578769520,3578769520,0
3,1607,46311,3578769520,3578769520,0
3,1607,46312,3578769520,3578769520,0
3,1607,46313,3578769520,3578769521,1
3,1607,46314,3578769520,3578769522,2
3,1607,46315,3578769520,3578769522,2
3,1607,46316,3578769520,3578769528,8
3,1607,46317,3578769520,3578769531,11
3,1607,46318,3578769520,3578769541,21
3,1607,46319,3578769520,3578769543,23
3,1607,46320,3578769520,3578769546,26
3,1607,46321,3578769520,3578769549,29
3,1607,46322,3578769520,3578769557,37
3,1607,46323,3578769520,3578769559,39
3,1607,46324,3578769520,3578769564,44
3,1607,46325,3578769520,3578769568,48
3,1607,46326,3578769520,3578769569,49
3,1607,46327,3578769520,3578769569,49
3,1607,46328,3578769520,3578769570,50
3,1608,46329,3578769586,3578769586,0
3,1608,46330,3578769586,3578769586,0
3,1608,46331,3578769586,3578769586,0
3,1608,46332,3578769586,3578769586,0
3,1608,46333,3578769586,3578769586,0
3,1608,46334,3578769586,3578769586,0
3,1608,46335,3578769586,3578769586,0
3,1608,46336,3578769586,3578769586,0
3,1608,46337,3578769586,3578769586,0
3,1608,46338,3578769586,3578769588,2
3,1608,46339,3578769586,3578769588,2
3,1608,46340,3578769586,3578769592,6
3,1608,46341,3578769586,3578769593,7
3,1608,46342,3578769586,3578769594,8
3,1608,46343,3578769586,3578769595,9
3,1608,46344,3578769586,3578769599,13
3,1608,46345,3578769586,3578769602,16
3,1608,46346,3578769586,3578769603,17
3,1608,46347,3578769586,3578769604,18
3,1608,46348,3578769586,3578769604,18
3,1608,46349,3578769586,3578769605,19
3,1608,46350,3578769586,3578769605,19
3,1608,46351,3578769586,3578769607,21
3,1608,46352,3578769586,3578769608,22
3,1608,46353,3578769586,3578769608,22
3,1608,46354,3578769586,3578769609,23
3,1608,46355,3578769586,3578769613,27
3,1608,46356,3578769586,3578769616,30
3,1608,46357,3578769586,3578769620,34
3,1608,46358,3578769586,3578769623,37
3,1608,46359,3578769586,3578769624,38
3,1608,46360,3578769586,3578769626,40
3,1608,46361,3578769586,3578769627,41
3,1608,46362,3578769586,3578769628,42
3,1608,46363,3578769586,3578769632,46
3,1608,46364,3578769586,3578769634,48
3,1609,46365,3578769650,3578769650,0
3,1609,46366,3578769650,3578769650,0
3,1609,46367,3578769650,3578769650,0
3,1609,46368,3578769650,3578769650,0
3,1609,46369,3578769650,3578769650,0
3,1609,46370,3578769650,3578769650,0
3,1609,46371,3578769650,3578769650,0
3,1609,46372,3578769650,3578769651,1
3,1609,46373,3578769650,3578769653,3
3,1609,46374,3578769650,3578769655,5
3,1609,46375,3578769650,3578769656,6
3,1609,46376,3578769650,3578769658,8
3,1609,46377,3578769650,3578769658,8
3,1609,46378,3578769650,3578769662,12
3,1609,46379,3578769650,3578769662,12
3,1609,46380,3578769650,3578769663,13
3,1609,46381,3578769650,3578769668,18
3,1609,46382,3578769650,3578769685,35
3,1609,46383,3578769650,3578769685,35
3,1609,46384,3578769650,3578769686,36
3,1609,46385,3578769650,3578769686,36
3,1609,46386,3578769650,3578769687,37
3,1609,46387,3578769650,3578769689,39
3,1609,46388,3578769650,3578769689,39
3,1609,46389,3578769650,3578769692,42
3,1609,46390,3578769650,3578769692,42
3,1609,46391,3578769650,3578769693,43
3,1609,46392,3578769650,3578769695,45
3,1609,46393,3578769650,3578769695,45
3,1609,46394,3578769650,3578769697,47
3,1609,46395,3578769650,3578769700,50
3,1610,46396,3578769716,3578769716,0
3,1610,46397,3578769716,3578769716,0
3,1610,46398,3578769716,3578769716,0
3,1610,46399,3578769716,3578769716,0
3,1610,46400,3578769716,3578769716,0
3,1610,46401,3578769716,3578769716,0
3,1610,46402,3578769716,3578769716,0
3,1610,46403,3578769716,3578769716,0
3,1610,46404,3578769716,3578769716,0
3,1610,46405,3578769716,3578769717,1
3,1610,46406,3578769716,3578769719,3
3,1610,46407,3578769716,3578769721,5
3,1610,46408,3578769716,3578769721,5
3,1610,46409,3578769716,3578769722,6
3,1610,46410,3578769716,3578769723,7
3,1610,46411,3578769716,3578769729,13
3,1610,46412,3578769716,3578769731,15
3,1610,46413,3578769716,3578769741,25
3,1610,46414,3578769716,3578769744,28
3,1610,46415,3578769716,3578769745,29
3,1610,46416,3578769716,3578769748,32
3,1610,46417,3578769716,3578769756,40
3,1610,46418,3578769716,3578769760,44
3,1610,46419,3578769716,3578769766,50
3,1611,46420,3578769781,3578769781,0
3,1611,46421,3578769781,3578769781,0
3,1611,46422,3578769781,3578769781,0
3,1611,46423,3578769781,3578769781,0
3,1611,46424,3578769781,3578769781,0
3,1611,46425,3578769781,3578769781,0
3,1611,46426,3578769781,3578769781,0
3,1611,46427,3578769781,3578769781,0
3,1611,46428,3578769781,3578769781,0
3,1611,46429,3578769781,3578769782,1
3,1611,46430,3578769781,3578769783,2
3,1611,46431,3578769781,3578769785,4
3,1611,46432,3578769781,3578769786,5
3,1611,46433,3578769781,3578769788,7
3,1611,46434,3578769781,3578769788,7
3,1611,46435,3578769781,3578769793,12
3,1611,46436,3578769781,3578769793,12
3,1611,46437,3578769781,3578769794,13
3,1611,46438,3578769781,3578769796,15
3,1611,46439,3578769781,3578769799,18
3,1611,46440,3578769781,3578769803,22
3,1611,46441,3578769781,3578769803,22
3,1611,46442,3578769781,3578769804,23
3,1611,46443,3578769781,3578769804,23
3,1611,46444,3578769781,3578769805,24
3,1611,46445,3578769781,3578769806,25
3,1611,46446,3578769781,3578769807,26
3,1611,46447,3578769781,3578769808,27
3,1611,46448,3578769781,3578769808,27
3,1611,46449,3578769781,3578769810,29
3,1611,46450,3578769781,3578769814,33
3,1611,46451,3578769781,3578769816,35
3,1611,46452,3578769781,3578769820,39
3,1611,46453,3578769781,3578769823,42
3,1611,46454,3578769781,3578769824,43
3,1611,46455,3578769781,3578769827,46
3,1611,46456,3578769781,3578769827,46
3,1611,46457,3578769781,3578769829,48
3,1612,46458,3578769847,3578769847,0
3,1612,46459,3578769847,3578769847,0
3,1612,46460,3578769847,3578769847,0
3,1612,46461,3578769847,3578769847,0
3,1612,46462,3578769847,3578769847,0
3,1612,46463,3578769847,3578769848,1
3,1612,46464,3578769847,3578769848,1
3,1612,46465,3578769847,3578769848,1
3,1612,46466,3578769847,3578769851,4
3,1612,46467,3578769847,3578769853,6
3,1612,46468,3578769847,3578769855,8
3,1612,46469,3578769847,3578769856,9
3,1612,46470,3578769847,3578769857,10
3,1612,46471,3578769847,3578769858,11
3,1612,46472,3578769847,3578769861,14
3,1612,46473,3578769847,3578769862,15
3,1612,46474,3578769847,3578769864,17
3,1612,46475,3578769847,3578769869,22
3,1612,46476,3578769847,3578769885,38
3,1612,46477,3578769847,3578769885,38
3,1612,46478,3578769847,3578769886,39
3,1612,46479,3578769847,3578769886,39
3,1612,46480,3578769847,3578769887,40
3,1612,46481,3578769847,3578769889,42
3,1612,46482,3578769847,3578769889,42
3,1612,46483,3578769847,3578769893,46
3,1612,46484,3578769847,3578769893,46
3,1612,46485,3578769847,3578769893,46
3,1612,46486,3578769847,3578769895,48
3,1612,46487,3578769847,3578769895,48
3,1612,46488,3578769847,3578769897,50
3,1613,46489,3578769913,3578769913,0
3,1613,46490,3578769913,3578769913,0
3,1613,46491,3578769913,3578769913,0
3,1613,46492,3578769913,3578769913,0
3,1613,46493,3578769913,3578769913,0
3,1613,46494,3578769913,3578769913,0
3,1613,46495,3578769913,3578769916,3
3,1613,46496,3578769913,3578769916,3
3,1613,46497,3578769913,3578769918,5
3,1613,46498,3578769913,3578769919,6
3,1613,46499,3578769913,3578769921,8
3,1613,46500,3578769913,3578769922,9
3,1613,46501,3578769913,3578769922,9
3,1613,46502,3578769913,3578769928,15
3,1613,46503,3578769913,3578769932,19
3,1613,46504,3578769913,3578769941,28
3,1613,46505,3578769913,3578769943,30
3,1613,46506,3578769913,3578769946,33
3,1613,46507,3578769913,3578769949,36
3,1613,46508,3578769913,3578769956,43
3,1613,46509,3578769913,3578769957,44
3,1613,46510,3578769913,3578769960,47
3,1614,46511,3578769979,3578769979,0
3,1614,46512,3578769979,3578769979,0
3,1614,46513,3578769979,3578769979,0
3,1614,46514,3578769979,3578769979,0
3,1614,46515,3578769979,3578769979,0
3,1614,46516,3578769979,3578769979,0
3,1614,46517,3578769979,3578769979,0
3,1614,46518,3578769979,3578769979,0
3,1614,46519,3578769979,3578769979,0
3,1614,46520,3578769979,3578769979,0
3,1614,46521,3578769979,3578769979,0
3,1614,46522,3578769979,3578769979,0
3,1614,46523,3578769979,3578769981,2
3,1614,46524,3578769979,3578769983,4
3,1614,46525,3578769979,3578769985,6
3,1614,46526,3578769979,3578769986,7
3,1614,46527,3578769979,3578769988,9
3,1614,46528,3578769979,3578769992,13
3,1614,46529,3578769979,3578769993,14
3,1614,46530,3578769979,3578769994,15
3,1614,46531,3578769979,3578769996,17
3,1614,46532,3578769979,3578769998,19
3,1614,46533,3578769979,3578770003,24
3,1614,46534,3578769979,3578770003,24
3,1614,46535,3578769979,3578770004,25
3,1614,46536,3578769979,3578770004,25
3,1614,46537,3578769979,3578770005,26
3,1614,46538,3578769979,3578770005,26
3,1614,46539,3578769979,3578770007,28
3,1614,46540,3578769979,3578770008,29
3,1614,46541,3578769979,3578770009,30
3,1614,46542,3578769979,3578770010,31
3,1614,46543,3578769979,3578770014,35
3,1614,46544,3578769979,3578770017,38
3,1614,46545,3578769979,3578770021,42
3,1614,46546,3578769979,3578770023,44
3,1614,46547,3578769979,3578770023,44
3,1614,46548,3578769979,3578770027,48
3,1614,46549,3578769979,3578770027,48
3,1614,46550,3578769979,3578770029,50
3,1615,46551,3578770044,3578770044,0
3,1615,46552,3578770044,3578770044,0
3,1615,46553,3578770044,3578770044,0
3,1615,46554,3578770044,3578770044,0
3,1615,46555,3578770044,3578770045,1
3,1615,46556,3578770044,3578770047,3
3,1615,46557,3578770044,3578770050,6
3,1615,46558,3578770044,3578770053,9
3,1615,46559,3578770044,3578770055,11
3,1615,46560,3578770044,3578770056,12
3,1615,46561,3578770044,3578770057,13
3,1615,46562,3578770044,3578770057,13
3,1615,46563,3578770044,3578770062,18
3,1615,46564,3578770044,3578770064,20
3,1615,46565,3578770044,3578770064,20
3,1615,46566,3578770044,3578770069,25
3,1615,46567,3578770044,3578770085,41
3,1615,46568,3578770044,3578770085,41
3,1615,46569,3578770044,3578770086,42
3,1615,46570,3578770044,3578770087,43
3,1615,46571,3578770044,3578770087,43
3,1615,46572,3578770044,3578770089,45
3,1615,46573,3578770044,3578770089,45
3,1615,46574,3578770044,3578770093,49
3,1615,46575,3578770044,3578770093,49
3,1615,46576,3578770044,3578770093,49
3,1616,46577,3578770109,3578770109,0
3,1616,46578,3578770109,3578770109,0
3,1616,46579,3578770109,3578770109,0
3,1616,46580,3578770109,3578770109,0
3,1616,46581,3578770109,3578770109,0
3,1616,46582,3578770109,3578770109,0
3,1616,46583,3578770109,3578770109,0
3,1616,46584,3578770109,3578770111,2
3,1616,46585,3578770109,3578770114,5
3,1616,46586,3578770109,3578770115,6
3,1616,46587,3578770109,3578770116,7
3,1616,46588,3578770109,3578770116,7
3,1616,46589,3578770109,3578770117,8
3,1616,46590,3578770109,3578770119,10
3,1616,46591,3578770109,3578770120,11
3,1616,46592,3578770109,3578770121,12
3,1616,46593,3578770109,3578770122,13
3,1616,46594,3578770109,3578770129,20
3,1616,46595,3578770109,3578770132,23
3,1616,46596,3578770109,3578770141,32
3,1616,46597,3578770109,3578770146,37
3,1616,46598,3578770109,3578770149,40
3,1616,46599,3578770109,3578770156,47
3,1616,46600,3578770109,3578770158,49
3,1617,46601,3578770173,3578770173,0
3,1617,46602,3578770173,3578770173,0
3,1617,46603,3578770173,3578770173,0
3,1617,46604,3578770173,3578770173,0
3,1617,46605,3578770173,3578770173,0
3,1617,46606,3578770173,3578770173,0
3,1617,46607,3578770173,3578770173,0
3,1617,46608,3578770173,3578770173,0
3,1617,46609,3578770173,3578770173,0
3,1617,46610,3578770173,3578770173,0
3,1617,46611,3578770173,3578770173,0
3,1617,46612,3578770173,3578770177,4
3,1617,46613,3578770173,3578770179,6
3,1617,46614,3578770173,3578770182,9
3,1617,46615,3578770173,3578770183,10
3,1617,46616,3578770173,3578770186,13
3,1617,46617,3578770173,3578770187,14
3,1617,46618,3578770173,3578770188,15
3,1617,46619,3578770173,3578770189,16
3,1617,46620,3578770173,3578770194,21
3,1617,46621,3578770173,3578770195,22
3,1617,46622,3578770173,3578770196,23
3,1617,46623,3578770173,3578770199,26
3,1617,46624,3578770173,3578770202,29
3,1617,46625,3578770173,3578770204,31
3,1617,46626,3578770173,3578770204,31
3,1617,46627,3578770173,3578770205,32
3,1617,46628,3578770173,3578770205,32
3,1617,46629,3578770173,3578770208,35
3,1617,46630,3578770173,3578770208,35
3,1617,46631,3578770173,3578770209,36
3,1617,46632,3578770173,3578770211,38
3,1617,46633,3578770173,3578770215,42
3,1617,46634,3578770173,3578770217,44
3,1617,46635,3578770173,3578770220,47
3,1618,46636,3578770239,3578770239,0
3,1618,46637,3578770239,3578770239,0
3,1618,46638,3578770239,3578770239,0
3,1618,46639,3578770239,3578770239,0
3,1618,46640,3578770239,3578770239,0
3,1618,46641,3578770239,3578770239,0
3,1618,46642,3578770239,3578770239,0
3,1618,46643,3578770239,3578770239,0
3,1618,46644,3578770239,3578770239,0
3,1618,46645,3578770239,3578770245,6
3,1618,46646,3578770239,3578770247,8
3,1618,46647,3578770239,3578770251,12
3,1618,46648,3578770239,3578770254,15
3,1618,46649,3578770239,3578770256,17
3,1618,46650,3578770239,3578770256,17
3,1618,46651,3578770239,3578770258,19
3,1618,46652,3578770239,3578770258,19
3,1618,46653,3578770239,3578770262,23
3,1618,46654,3578770239,3578770263,24
3,1618,46655,3578770239,3578770264,25
3,1618,46656,3578770239,3578770268,29
3,1618,46657,3578770239,3578770285,46
3,1618,46658,3578770239,3578770285,46
3,1618,46659,3578770239,3578770286,47
3,1618,46660,3578770239,3578770286,47
3,1618,46661,3578770239,3578770288,49
3,1618,46662,3578770239,3578770289,50
3,1619,46663,3578770305,3578770305,0
3,1619,46664,3578770305,3578770305,0
3,1619,46665,3578770305,3578770305,0
3,1619,46666,3578770305,3578770305,0
3,1619,46667,3578770305,3578770305,0
3,1619,46668,3578770305,3578770305,0
3,1619,46669,3578770305,3578770305,0
3,1619,46670,3578770305,3578770305,0
3,1619,46671,3578770305,3578770305,0
3,1619,46672,3578770305,3578770307,2
3,1619,46673,3578770305,3578770307,2
3,1619,46674,3578770305,3578770311,6
3,1619,46675,3578770305,3578770312,7
3,1619,46676,3578770305,3578770314,9
3,1619,46677,3578770305,3578770315,10
3,1619,46678,3578770305,3578770316,11
3,1619,46679,3578770305,3578770317,12
3,1619,46680,3578770305,3578770317,12
3,1619,46681,3578770305,3578770319,14
3,1619,46682,3578770305,3578770320,15
3,1619,46683,3578770305,3578770322,17
3,1619,46684,3578770305,3578770322,17
3,1619,46685,3578770305,3578770329,24
3,1619,46686,3578770305,3578770331,26
3,1619,46687,3578770305,3578770342,37
3,1619,46688,3578770305,3578770343,38
3,1619,46689,3578770305,3578770345,40
3,1619,46690,3578770305,3578770350,45
3,1620,46691,3578770369,3578770369,0
3,1620,46692,3578770369,3578770369,0
3,1620,46693,3578770369,3578770369,0
3,1620,46694,3578770369,3578770369,0
3,1620,46695,3578770369,3578770369,0
3,1620,46696,3578770369,3578770369,0
3,1620,46697,3578770369,3578770369,0
3,1620,46698,3578770369,3578770369,0
3,1620,46699,3578770369,3578770369,0
3,1620,46700,3578770369,3578770371,2
3,1620,46701,3578770369,3578770372,3
3,1620,46702,3578770369,3578770373,4
3,1620,46703,3578770369,3578770373,4
3,1620,46704,3578770369,3578770377,8
3,1620,46705,3578770369,3578770379,10
3,1620,46706,3578770369,3578770383,14
3,1620,46707,3578770369,3578770386,17
3,1620,46708,3578770369,3578770388,19
3,1620,46709,3578770369,3578770388,19
3,1620,46710,3578770369,3578770390,21
3,1620,46711,3578770369,3578770393,24
3,1620,46712,3578770369,3578770394,25
3,1620,46713,3578770369,3578770395,26
3,1620,46714,3578770369,3578770396,27
3,1620,46715,3578770369,3578770399,30
3,1620,46716,3578770369,3578770403,34
3,1620,46717,3578770369,3578770403,34
3,1620,46718,3578770369,3578770404,35
3,1620,46719,3578770369,3578770406,37
3,1620,46720,3578770369,3578770408,39
3,1620,46721,3578770369,3578770409,40
3,1620,46722,3578770369,3578770409,40
3,1620,46723,3578770369,3578770411,42
3,1620,46724,3578770369,3578770415,46
3,1620,46725,3578770369,3578770417,48
3,1621,46726,3578770434,3578770434,0
3,1621,46727,3578770434,3578770434,0
3,1621,46728,3578770434,3578770434,0
3,1621,46729,3578770434,3578770434,0
3,1621,46730,3578770434,3578770434,0
3,1621,46731,3578770434,3578770434,0
3,1621,46732,3578770434,3578770434,0
3,1621,46733,3578770434,3578770435,1
3,1621,46734,3578770434,3578770438,4
3,1621,46735,3578770434,3578770439,5
3,1621,46736,3578770434,3578770440,6
3,1621,46737,3578770434,3578770445,11
3,1621,46738,3578770434,3578770445,11
3,1621,46739,3578770434,3578770453,19
3,1621,46740,3578770434,3578770456,22
3,1621,46741,3578770434,3578770457,23
3,1621,46742,3578770434,3578770457,23
3,1621,46743,3578770434,3578770458,24
3,1621,46744,3578770434,3578770463,29
3,1621,46745,3578770434,3578770463,29
3,1621,46746,3578770434,3578770464,30
3,1621,46747,3578770434,3578770470,36
3,1622,46748,3578770500,3578770500,0
3,1622,46749,3578770500,3578770500,0
3,1622,46750,3578770500,3578770500,0
3,1622,46751,3578770500,3578770500,0
3,1622,46752,3578770500,3578770500,0
3,1622,46753,3578770500,3578770500,0
3,1622,46754,3578770500,3578770500,0
3,1622,46755,3578770500,3578770500,0
3,1622,46756,3578770500,3578770500,0
3,1622,46757,3578770500,3578770500,0
3,1622,46758,3578770500,3578770500,0
3,1622,46759,3578770500,3578770503,3
3,1622,46760,3578770500,3578770506,6
3,1622,46761,3578770500,3578770507,7
3,1622,46762,3578770500,3578770510,10
3,1622,46763,3578770500,3578770511,11
3,1622,46764,3578770500,3578770513,13
3,1622,46765,3578770500,3578770514,14
3,1622,46766,3578770500,3578770515,15
3,1622,46767,3578770500,3578770516,16
3,1622,46768,3578770500,3578770516,16
3,1622,46769,3578770500,3578770519,19
3,1622,46770,3578770500,3578770520,20
3,1622,46771,3578770500,3578770521,21
3,1622,46772,3578770500,3578770521,21
3,1622,46773,3578770500,3578770522,22
3,1622,46774,3578770500,3578770528,28
3,1622,46775,3578770500,3578770531,31
3,1622,46776,3578770500,3578770541,41
3,1622,46777,3578770500,3578770543,43
3,1622,46778,3578770500,3578770545,45
3,1622,46779,3578770500,3578770549,49
3,1623,46780,3578770565,3578770565,0
3,1623,46781,3578770565,3578770565,0
3,1623,46782,3578770565,3578770565,0
3,1623,46783,3578770565,3578770565,0
3,1623,46784,3578770565,3578770567,2
3,1623,46785,3578770565,3578770568,3
3,1623,46786,3578770565,3578770568,3
3,1623,46787,3578770565,3578770568,3
3,1623,46788,3578770565,3578770569,4
3,1623,46789,3578770565,3578770571,6
3,1623,46790,3578770565,3578770571,6
3,1623,46791,3578770565,3578770573,8
3,1623,46792,3578770565,3578770573,8
3,1623,46793,3578770565,3578770576,11
3,1623,46794,3578770565,3578770582,17
3,1623,46795,3578770565,3578770583,18
3,1623,46796,3578770565,3578770585,20
3,1623,46797,3578770565,3578770586,21
3,1623,46798,3578770565,3578770587,22
3,1623,46799,3578770565,3578770588,23
3,1623,46800,3578770565,3578770593,28
3,1623,46801,3578770565,3578770594,29
3,1623,46802,3578770565,3578770594,29
3,1623,46803,3578770565,3578770596,31
3,1623,46804,3578770565,3578770599,34
3,1623,46805,3578770565,3578770602,37
3,1623,46806,3578770565,3578770603,38
3,1623,46807,3578770565,3578770605,40
3,1623,46808,3578770565,3578770606,41
3,1623,46809,3578770565,3578770607,42
3,1623,46810,3578770565,3578770608,43
3,1623,46811,3578770565,3578770608,43
3,1623,46812,3578770565,3578770609,44
3,1623,46813,3578770565,3578770614,49
3,1624,46814,3578770631,3578770631,0
3,1624,46815,3578770631,3578770631,0
3,1624,46816,3578770631,3578770631,0
3,1624,46817,3578770631,3578770631,0
3,1624,46818,3578770631,3578770631,0
3,1624,46819,3578770631,3578770631,0
3,1624,46820,3578770631,3578770632,1
3,1624,46821,3578770631,3578770632,1
3,1624,46822,3578770631,3578770634,3
3,1624,46823,3578770631,3578770637,6
3,1624,46824,3578770631,3578770638,7
3,1624,46825,3578770631,3578770639,8
3,1624,46826,3578770631,3578770643,12
3,1624,46827,3578770631,3578770644,13
3,1624,46828,3578770631,3578770654,23
3,1624,46829,3578770631,3578770655,24
3,1624,46830,3578770631,3578770656,25
3,1624,46831,3578770631,3578770658,27
3,1624,46832,3578770631,3578770658,27
3,1624,46833,3578770631,3578770662,31
3,1624,46834,3578770631,3578770663,32
3,1624,46835,3578770631,3578770668,37
3,1625,46836,3578770697,3578770697,0
3,1625,46837,3578770697,3578770697,0
3,1625,46838,3578770697,3578770697,0
3,1625,46839,3578770697,3578770697,0
3,1625,46840,3578770697,3578770697,0
3,1625,46841,3578770697,3578770697,0
3,1625,46842,3578770697,3578770697,0
3,1625,46843,3578770697,3578770697,0
3,1625,46844,3578770697,3578770697,0
3,1625,46845,3578770697,3578770697,0
3,1625,46846,3578770697,3578770697,0
3,1625,46847,3578770697,3578770697,0
3,1625,46848,3578770697,3578770699,2
3,1625,46849,3578770697,3578770703,6
3,1625,46850,3578770697,3578770706,9
3,1625,46851,3578770697,3578770706,9
3,1625,46852,3578770697,3578770710,13
3,1625,46853,3578770697,3578770711,14
3,1625,46854,3578770697,3578770712,15
3,1625,46855,3578770697,3578770715,18
3,1625,46856,3578770697,3578770715,18
3,1625,46857,3578770697,3578770716,19
3,1625,46858,3578770697,3578770716,19
3,1625,46859,3578770697,3578770719,22
3,1625,46860,3578770697,3578770720,23
3,1625,46861,3578770697,3578770721,24
3,1625,46862,3578770697,3578770721,24
3,1625,46863,3578770697,3578770722,25
3,1625,46864,3578770697,3578770728,31
3,1625,46865,3578770697,3578770731,34
3,1625,46866,3578770697,3578770741,44
3,1625,46867,3578770697,3578770742,45
3,1625,46868,3578770697,3578770745,48
3,1626,46869,3578770762,3578770762,0
3,1626,46870,3578770762,3578770762,0
3,1626,46871,3578770762,3578770762,0
3,1626,46872,3578770762,3578770762,0
3,1626,46873,3578770762,3578770767,5
3,1626,46874,3578770762,3578770768,6
3,1626,46875,3578770762,3578770768,6
3,1626,46876,3578770762,3578770768,6
3,1626,46877,3578770762,3578770770,8
3,1626,46878,3578770762,3578770771,9
3,1626,46879,3578770762,3578770771,9
3,1626,46880,3578770762,3578770773,11
3,1626,46881,3578770762,3578770773,11
3,1626,46882,3578770762,3578770777,15
3,1626,46883,3578770762,3578770778,16
3,1626,46884,3578770762,3578770781,19
3,1626,46885,3578770762,3578770783,21
3,1626,46886,3578770762,3578770784,22
3,1626,46887,3578770762,3578770786,24
3,1626,46888,3578770762,3578770787,25
3,1626,46889,3578770762,3578770788,26
3,1626,46890,3578770762,3578770792,30
3,1626,46891,3578770762,3578770794,32
3,1626,46892,3578770762,3578770794,32
3,1626,46893,3578770762,3578770795,33
3,1626,46894,3578770762,3578770799,37
3,1626,46895,3578770762,3578770803,41
3,1626,46896,3578770762,3578770804,42
3,1626,46897,3578770762,3578770805,43
3,1626,46898,3578770762,3578770805,43
3,1626,46899,3578770762,3578770806,44
3,1626,46900,3578770762,3578770807,45
3,1626,46901,3578770762,3578770808,46
3,1626,46902,3578770762,3578770808,46
3,1627,46903,3578770827,3578770828,1
3,1627,46904,3578770827,3578770828,1
3,1627,46905,3578770827,3578770828,1
3,1627,46906,3578770827,3578770828,1
3,1627,46907,3578770827,3578770828,1
3,1627,46908,3578770827,3578770828,1
3,1627,46909,3578770827,3578770828,1
3,1627,46910,3578770827,3578770829,2
3,1627,46911,3578770827,3578770832,5
3,1627,46912,3578770827,3578770833,6
3,1627,46913,3578770827,3578770835,8
3,1627,46914,3578770827,3578770837,10
3,1627,46915,3578770827,3578770838,11
3,1627,46916,3578770827,3578770840,13
3,1627,46917,3578770827,3578770843,16
3,1627,46918,3578770827,3578770844,17
3,1627,46919,3578770827,3578770853,26
3,1627,46920,3578770827,3578770856,29
3,1627,46921,3578770827,3578770858,31
3,1627,46922,3578770827,3578770858,31
3,1627,46923,3578770827,3578770863,36
3,1627,46924,3578770827,3578770863,36
3,1627,46925,3578770827,3578770869,42
3,1628,46926,3578770896,3578770896,0
3,1628,46927,3578770896,3578770896,0
3,1628,46928,3578770896,3578770896,0
3,1628,46929,3578770896,3578770896,0
3,1628,46930,3578770896,3578770896,0
3,1628,46931,3578770896,3578770896,0
3,1628,46932,3578770896,3578770896,0
3,1628,46933,3578770896,3578770896,0
3,1628,46934,3578770896,3578770896,0
3,1628,46935,3578770896,3578770896,0
3,1628,46936,3578770896,3578770896,0
3,1628,46937,3578770896,3578770899,3
3,1628,46938,3578770896,3578770903,7
3,1628,46939,3578770896,3578770906,10
3,1628,46940,3578770896,3578770907,11
3,1628,46941,3578770896,3578770910,14
3,1628,46942,3578770896,3578770911,15
3,1628,46943,3578770896,3578770913,17
3,1628,46944,3578770896,3578770914,18
3,1628,46945,3578770896,3578770915,19
3,1628,46946,3578770896,3578770916,20
3,1628,46947,3578770896,3578770919,23
3,1628,46948,3578770896,3578770921,25
3,1628,46949,3578770896,3578770921,25
3,1628,46950,3578770896,3578770922,26
3,1628,46951,3578770896,3578770929,33
3,1628,46952,3578770896,3578770940,44
3,1628,46953,3578770896,3578770943,47
3,1628,46954,3578770896,3578770945,49
3,1629,46955,3578770963,3578770963,0
3,1629,46956,3578770963,3578770963,0
3,1629,46957,3578770963,3578770963,0
3,1629,46958,3578770963,3578770963,0
3,1629,46959,3578770963,3578770968,5
3,1629,46960,3578770963,3578770968,5
3,1629,46961,3578770963,3578770968,5
3,1629,46962,3578770963,3578770969,6
3,1629,46963,3578770963,3578770969,6
3,1629,46964,3578770963,3578770971,8
3,1629,46965,3578770963,3578770972,9
3,1629,46966,3578770963,3578770973,10
3,1629,46967,3578770963,3578770973,10
3,1629,46968,3578770963,3578770976,13
3,1629,46969,3578770963,3578770979,16
3,1629,46970,3578770963,3578770981,18
3,1629,46971,3578770963,3578770983,20
3,1629,46972,3578770963,3578770985,22
3,1629,46973,3578770963,3578770986,23
3,1629,46974,3578770963,3578770988,25
3,1629,46975,3578770963,3578770992,29
3,1629,46976,3578770963,3578770994,31
3,1629,46977,3578770963,3578770994,31
3,1629,46978,3578770963,3578770995,32
3,1629,46979,3578770963,3578770999,36
3,1629,46980,3578770963,3578771003,40
3,1629,46981,3578770963,3578771004,41
3,1629,46982,3578770963,3578771005,42
3,1629,46983,3578770963,3578771005,42
3,1629,46984,3578770963,3578771005,42
3,1629,46985,3578770963,3578771008,45
3,1629,46986,3578770963,3578771009,46
3,1629,46987,3578770963,3578771009,46
3,1629,46988,3578770963,3578771010,47
3,1630,46989,3578771030,3578771030,0
3,1630,46990,3578771030,3578771030,0
3,1630,46991,3578771030,3578771030,0
3,1630,46992,3578771030,3578771030,0
3,1630,46993,3578771030,3578771030,0
3,1630,46994,3578771030,3578771030,0
3,1630,46995,3578771030,3578771030,0
3,1630,46996,3578771030,3578771032,2
3,1630,46997,3578771030,3578771032,2
3,1630,46998,3578771030,3578771035,5
3,1630,46999,3578771030,3578771037,7
3,1630,47000,3578771030,3578771038,8
3,1630,47001,3578771030,3578771040,10
3,1630,47002,3578771030,3578771043,13
3,1630,47003,3578771030,3578771043,13
3,1630,47004,3578771030,3578771048,18
3,1630,47005,3578771030,3578771051,21
3,1630,47006,3578771030,3578771054,24
3,1630,47007,3578771030,3578771056,26
3,1630,47008,3578771030,3578771057,27
3,1630,47009,3578771030,3578771063,33
3,1630,47010,3578771030,3578771065,35
3,1630,47011,3578771030,3578771069,39
3,1631,47012,3578771096,3578771096,0
3,1631,47013,3578771096,3578771096,0
3,1631,47014,3578771096,3578771096,0
3,1631,47015,3578771096,3578771096,0
3,1631,47016,3578771096,3578771096,0
3,1631,47017,3578771096,3578771096,0
3,1631,47018,3578771096,3578771096,0
3,1631,47019,3578771096,3578771096,0
3,1631,47020,3578771096,3578771096,0
3,1631,47021,3578771096,3578771096,0
3,1631,47022,3578771096,3578771096,0
3,1631,47023,3578771096,3578771098,2
3,1631,47024,3578771096,3578771099,3
3,1631,47025,3578771096,3578771103,7
3,1631,47026,3578771096,3578771106,10
3,1631,47027,3578771096,3578771106,10
3,1631,47028,3578771096,3578771110,14
3,1631,47029,3578771096,3578771111,15
3,1631,47030,3578771096,3578771112,16
3,1631,47031,3578771096,3578771115,19
3,1631,47032,3578771096,3578771115,19
3,1631,47033,3578771096,3578771117,21
3,1631,47034,3578771096,3578771119,23
3,1631,47035,3578771096,3578771121,25
3,1631,47036,3578771096,3578771121,25
3,1631,47037,3578771096,3578771122,26
3,1631,47038,3578771096,3578771124,28
3,1631,47039,3578771096,3578771129,33
3,1631,47040,3578771096,3578771131,35
3,1631,47041,3578771096,3578771141,45
3,1631,47042,3578771096,3578771142,46
3,1631,47043,3578771096,3578771145,49
3,1632,47044,3578771160,3578771160,0
3,1632,47045,3578771160,3578771160,0
3,1632,47046,3578771160,3578771160,0
3,1632,47047,3578771160,3578771160,0
3,1632,47048,3578771160,3578771167,7
3,1632,47049,3578771160,3578771168,8
3,1632,47050,3578771160,3578771168,8
3,1632,47051,3578771160,3578771169,9
3,1632,47052,3578771160,3578771170,10
3,1632,47053,3578771160,3578771172,12
3,1632,47054,3578771160,3578771172,12
3,1632,47055,3578771160,3578771173,13
3,1632,47056,3578771160,3578771174,14
3,1632,47057,3578771160,3578771176,16
3,1632,47058,3578771160,3578771178,18
3,1632,47059,3578771160,3578771181,21
3,1632,47060,3578771160,3578771183,23
3,1632,47061,3578771160,3578771185,25
3,1632,47062,3578771160,3578771186,26
3,1632,47063,3578771160,3578771188,28
3,1632,47064,3578771160,3578771193,33
3,1632,47065,3578771160,3578771194,34
3,1632,47066,3578771160,3578771194,34
3,1632,47067,3578771160,3578771197,37
3,1632,47068,3578771160,3578771199,39
3,1632,47069,3578771160,3578771203,43
3,1632,47070,3578771160,3578771204,44
3,1632,47071,3578771160,3578771204,44
3,1632,47072,3578771160,3578771205,45
3,1632,47073,3578771160,3578771205,45
3,1632,47074,3578771160,3578771208,48
3,1632,47075,3578771160,3578771209,49
3,1632,47076,3578771160,3578771209,49
3,1633,47077,3578771226,3578771226,0
3,1633,47078,3578771226,3578771226,0
3,1633,47079,3578771226,3578771226,0
3,1633,47080,3578771226,3578771226,0
3,1633,47081,3578771226,3578771226,0
3,1633,47082,3578771226,3578771227,1
3,1633,47083,3578771226,3578771227,1
3,1633,47084,3578771226,3578771229,3
3,1633,47085,3578771226,3578771232,6
3,1633,47086,3578771226,3578771233,7
3,1633,47087,3578771226,3578771235,9
3,1633,47088,3578771226,3578771237,11
3,1633,47089,3578771226,3578771238,12
3,1633,47090,3578771226,3578771239,13
3,1633,47091,3578771226,3578771243,17
3,1633,47092,3578771226,3578771244,18
3,1633,47093,3578771226,3578771247,21
3,1633,47094,3578771226,3578771251,25
3,1633,47095,3578771226,3578771253,27
3,1633,47096,3578771226,3578771256,30
3,1633,47097,3578771226,3578771256,30
3,1633,47098,3578771226,3578771263,37
3,1633,47099,3578771226,3578771265,39
3,1633,47100,3578771226,3578771268,42
3,1634,47101,3578771292,3578771292,0
3,1634,47102,3578771292,3578771292,0
3,1634,47103,3578771292,3578771292,0
3,1634,47104,3578771292,3578771292,0
3,1634,47105,3578771292,3578771292,0
3,1634,47106,3578771292,3578771292,0
3,1634,47107,3578771292,3578771292,0
3,1634,47108,3578771292,3578771292,0
3,1634,47109,3578771292,3578771294,2
3,1634,47110,3578771292,3578771294,2
3,1634,47111,3578771292,3578771297,5
3,1634,47112,3578771292,3578771298,6
3,1634,47113,3578771292,3578771300,8
3,1634,47114,3578771292,3578771303,11
3,1634,47115,3578771292,3578771306,14
3,1634,47116,3578771292,3578771306,14
3,1634,47117,3578771292,3578771310,18
3,1634,47118,3578771292,3578771313,21
3,1634,47119,3578771292,3578771315,23
3,1634,47120,3578771292,3578771315,23
3,1634,47121,3578771292,3578771316,24
3,1634,47122,3578771292,3578771318,26
3,1634,47123,3578771292,3578771319,27
3,1634,47124,3578771292,3578771320,28
3,1634,47125,3578771292,3578771321,29
3,1634,47126,3578771292,3578771322,30
3,1634,47127,3578771292,3578771323,31
3,1634,47128,3578771292,3578771329,37
3,1634,47129,3578771292,3578771332,40
3,1635,47130,3578771359,3578771359,0
3,1635,47131,3578771359,3578771359,0
3,1635,47132,3578771359,3578771359,0
3,1635,47133,3578771359,3578771359,0
3,1635,47134,3578771359,3578771359,0
3,1635,47135,3578771359,3578771359,0
3,1635,47136,3578771359,3578771360,1
3,1635,47137,3578771359,3578771365,6
3,1635,47138,3578771359,3578771367,8
3,1635,47139,3578771359,3578771367,8
3,1635,47140,3578771359,3578771368,9
3,1635,47141,3578771359,3578771369,10
3,1635,47142,3578771359,3578771370,11
3,1635,47143,3578771359,3578771372,13
3,1635,47144,3578771359,3578771372,13
3,1635,47145,3578771359,3578771373,14
3,1635,47146,3578771359,3578771374,15
3,1635,47147,3578771359,3578771376,17
3,1635,47148,3578771359,3578771378,19
3,1635,47149,3578771359,3578771383,24
3,1635,47150,3578771359,3578771384,25
3,1635,47151,3578771359,3578771386,27
3,1635,47152,3578771359,3578771387,28
3,1635,47153,3578771359,3578771389,30
3,1635,47154,3578771359,3578771393,34
3,1635,47155,3578771359,3578771394,35
3,1635,47156,3578771359,3578771394,35
3,1635,47157,3578771359,3578771397,38
3,1635,47158,3578771359,3578771399,40
3,1635,47159,3578771359,3578771404,45
3,1635,47160,3578771359,3578771404,45
3,1635,47161,3578771359,3578771404,45
3,1635,47162,3578771359,3578771405,46
3,1635,47163,3578771359,3578771406,47
3,1635,47164,3578771359,3578771408,49
3,1635,47165,3578771359,3578771409,50
3,1636,47166,3578771425,3578771425,0
3,1636,47167,3578771425,3578771425,0
3,1636,47168,3578771425,3578771425,0
3,1636,47169,3578771425,3578771425,0
3,1636,47170,3578771425,3578771425,0
3,1636,47171,3578771425,3578771425,0
3,1636,47172,3578771425,3578771427,2
3,1636,47173,3578771425,3578771428,3
3,1636,47174,3578771425,3578771429,4
3,1636,47175,3578771425,3578771432,7
3,1636,47176,3578771425,3578771433,8
3,1636,47177,3578771425,3578771435,10
3,1636,47178,3578771425,3578771437,12
3,1636,47179,3578771425,3578771440,15
3,1636,47180,3578771425,3578771443,18
3,1636,47181,3578771425,3578771444,19
3,1636,47182,3578771425,3578771448,23
3,1636,47183,3578771425,3578771451,26
3,1636,47184,3578771425,3578771454,29
3,1636,47185,3578771425,3578771456,31
3,1636,47186,3578771425,3578771457,32
3,1636,47187,3578771425,3578771459,34
3,1636,47188,3578771425,3578771463,38
3,1636,47189,3578771425,3578771465,40
3,1636,47190,3578771425,3578771470,45
3,1637,47191,3578771489,3578771489,0
3,1637,47192,3578771489,3578771490,1
3,1637,47193,3578771489,3578771490,1
3,1637,47194,3578771489,3578771490,1
3,1637,47195,3578771489,3578771490,1
3,1637,47196,3578771489,3578771490,1
3,1637,47197,3578771489,3578771490,1
3,1637,47198,3578771489,3578771490,1
3,1637,47199,3578771489,3578771493,4
3,1637,47200,3578771489,3578771493,4
3,1637,47201,3578771489,3578771494,5
3,1637,47202,3578771489,3578771496,7
3,1637,47203,3578771489,3578771497,8
3,1637,47204,3578771489,3578771498,9
3,1637,47205,3578771489,3578771503,14
3,1637,47206,3578771489,3578771505,16
3,1637,47207,3578771489,3578771506,17
3,1637,47208,3578771489,3578771510,21
3,1637,47209,3578771489,3578771512,23
3,1637,47210,3578771489,3578771514,25
3,1637,47211,3578771489,3578771514,25
3,1637,47212,3578771489,3578771515,26
3,1637,47213,3578771489,3578771517,28
3,1637,47214,3578771489,3578771520,31
3,1637,47215,3578771489,3578771520,31
3,1637,47216,3578771489,3578771521,32
3,1637,47217,3578771489,3578771522,33
3,1637,47218,3578771489,3578771528,39
3,1638,47219,3578771556,3578771556,0
3,1638,47220,3578771556,3578771556,0
3,1638,47221,3578771556,3578771556,0
3,1638,47222,3578771556,3578771556,0
3,1638,47223,3578771556,3578771556,0
3,1638,47224,3578771556,3578771556,0
3,1638,47225,3578771556,3578771559,3
3,1638,47226,3578771556,3578771564,8
3,1638,47227,3578771556,3578771567,11
3,1638,47228,3578771556,3578771568,12
3,1638,47229,3578771556,3578771568,12
3,1638,47230,3578771556,3578771569,13
3,1638,47231,3578771556,3578771571,15
3,1638,47232,3578771556,3578771571,15
3,1638,47233,3578771556,3578771572,16
3,1638,47234,3578771556,3578771573,17
3,1638,47235,3578771556,3578771575,19
3,1638,47236,3578771556,3578771578,22
3,1638,47237,3578771556,3578771582,26
3,1638,47238,3578771556,3578771583,27
3,1638,47239,3578771556,3578771585,29
3,1638,47240,3578771556,3578771586,30
3,1638,47241,3578771556,3578771588,32
3,1638,47242,3578771556,3578771592,36
3,1638,47243,3578771556,3578771593,37
3,1638,47244,3578771556,3578771595,39
3,1638,47245,3578771556,3578771599,43
3,1638,47246,3578771556,3578771602,46
3,1638,47247,3578771556,3578771602,46
3,1638,47248,3578771556,3578771603,47
3,1638,47249,3578771556,3578771604,48
3,1638,47250,3578771556,3578771605,49
3,1639,47251,3578771621,3578771621,0
3,1639,47252,3578771621,3578771621,0
3,1639,47253,3578771621,3578771621,0
3,1639,47254,3578771621,3578771621,0
3,1639,47255,3578771621,3578771621,0
3,1639,47256,3578771621,3578771621,0
3,1639,47257,3578771621,3578771621,0
3,1639,47258,3578771621,3578771622,1
3,1639,47259,3578771621,3578771623,2
3,1639,47260,3578771621,3578771626,5
3,1639,47261,3578771621,3578771626,5
3,1639,47262,3578771621,3578771628,7
3,1639,47263,3578771621,3578771631,10
3,1639,47264,3578771621,3578771632,11
3,1639,47265,3578771621,3578771634,13
3,1639,47266,3578771621,3578771636,15
3,1639,47267,3578771621,3578771640,19
3,1639,47268,3578771621,3578771643,22
3,1639,47269,3578771621,3578771644,23
3,1639,47270,3578771621,3578771647,26
3,1639,47271,3578771621,3578771651,30
3,1639,47272,3578771621,3578771654,33
3,1639,47273,3578771621,3578771655,34
3,1639,47274,3578771621,3578771656,35
3,1639,47275,3578771621,3578771658,37
3,1639,47276,3578771621,3578771663,42
3,1639,47277,3578771621,3578771664,43
3,1639,47278,3578771621,3578771669,48
3,1640,47279,3578771686,3578771686,0
3,1640,47280,3578771686,3578771686,0
3,1640,47281,3578771686,3578771686,0
3,1640,47282,3578771686,3578771686,0
3,1640,47283,3578771686,3578771686,0
3,1640,47284,3578771686,3578771689,3
3,1640,47285,3578771686,3578771690,4
3,1640,47286,3578771686,3578771691,5
3,1640,47287,3578771686,3578771693,7
3,1640,47288,3578771686,3578771694,8
3,1640,47289,3578771686,3578771694,8
3,1640,47290,3578771686,3578771696,10
3,1640,47291,3578771686,3578771697,11
3,1640,47292,3578771686,3578771698,12
3,1640,47293,3578771686,3578771703,17
3,1640,47294,3578771686,3578771705,19
3,1640,47295,3578771686,3578771706,20
3,1640,47296,3578771686,3578771710,24
3,1640,47297,3578771686,3578771712,26
3,1640,47298,3578771686,3578771714,28
3,1640,47299,3578771686,3578771715,29
3,1640,47300,3578771686,3578771715,29
3,1640,47301,3578771686,3578771717,31
3,1640,47302,3578771686,3578771720,34
3,1640,47303,3578771686,3578771720,34
3,1640,47304,3578771686,3578771721,35
3,1640,47305,3578771686,3578771722,36
3,1640,47306,3578771686,3578771729,43
3,1641,47307,3578771752,3578771752,0
3,1641,47308,3578771752,3578771752,0
3,1641,47309,3578771752,3578771752,0
3,1641,47310,3578771752,3578771752,0
3,1641,47311,3578771752,3578771757,5
3,1641,47312,3578771752,3578771760,8
3,1641,47313,3578771752,3578771767,15
3,1641,47314,3578771752,3578771769,17
3,1641,47315,3578771752,3578771770,18
3,1641,47316,3578771752,3578771771,19
3,1641,47317,3578771752,3578771772,20
3,1641,47318,3578771752,3578771773,21
3,1641,47319,3578771752,3578771776,24
3,1641,47320,3578771752,3578771778,26
3,1641,47321,3578771752,3578771782,30
3,1641,47322,3578771752,3578771782,30
3,1641,47323,3578771752,3578771784,32
3,1641,47324,3578771752,3578771786,34
3,1641,47325,3578771752,3578771788,36
3,1641,47326,3578771752,3578771792,40
3,1641,47327,3578771752,3578771794,42
3,1641,47328,3578771752,3578771795,43
3,1641,47329,3578771752,3578771799,47
3,1642,47330,3578771819,3578771820,1
3,1642,47331,3578771819,3578771820,1
3,1642,47332,3578771819,3578771820,1
3,1642,47333,3578771819,3578771820,1
3,1642,47334,3578771819,3578771820,1
3,1642,47335,3578771819,3578771820,1
3,1642,47336,3578771819,3578771820,1
3,1642,47337,3578771819,3578771820,1
3,1642,47338,3578771819,3578771820,1
3,1642,47339,3578771819,3578771820,1
3,1642,47340,3578771819,3578771820,1
3,1642,47341,3578771819,3578771820,1
3,1642,47342,3578771819,3578771822,3
3,1642,47343,3578771819,3578771823,4
3,1642,47344,3578771819,3578771826,7
3,1642,47345,3578771819,3578771827,8
3,1642,47346,3578771819,3578771828,9
3,1642,47347,3578771819,3578771831,12
3,1642,47348,3578771819,3578771831,12
3,1642,47349,3578771819,3578771834,15
3,1642,47350,3578771819,3578771836,17
3,1642,47351,3578771819,3578771839,20
3,1642,47352,3578771819,3578771843,24
3,1642,47353,3578771819,3578771844,25
3,1642,47354,3578771819,3578771847,28
3,1642,47355,3578771819,3578771851,32
3,1642,47356,3578771819,3578771854,35
3,1642,47357,3578771819,3578771855,36
3,1642,47358,3578771819,3578771856,37
3,1642,47359,3578771819,3578771858,39
3,1642,47360,3578771819,3578771858,39
3,1642,47361,3578771819,3578771862,43
3,1642,47362,3578771819,3578771865,46
3,1643,47363,3578771884,3578771884,0
3,1643,47364,3578771884,3578771885,1
3,1643,47365,3578771884,3578771885,1
3,1643,47366,3578771884,3578771886,2
3,1643,47367,3578771884,3578771887,3
3,1643,47368,3578771884,3578771888,4
3,1643,47369,3578771884,3578771890,6
3,1643,47370,3578771884,3578771891,7
3,1643,47371,3578771884,3578771893,9
3,1643,47372,3578771884,3578771894,10
3,1643,47373,3578771884,3578771894,10
3,1643,47374,3578771884,3578771896,12
3,1643,47375,3578771884,3578771897,13
3,1643,47376,3578771884,3578771899,15
3,1643,47377,3578771884,3578771904,20
3,1643,47378,3578771884,3578771905,21
3,1643,47379,3578771884,3578771905,21
3,1643,47380,3578771884,3578771910,26
3,1643,47381,3578771884,3578771910,26
3,1643,47382,3578771884,3578771915,31
3,1643,47383,3578771884,3578771916,32
3,1643,47384,3578771884,3578771916,32
3,1643,47385,3578771884,3578771917,33
3,1643,47386,3578771884,3578771920,36
3,1643,47387,3578771884,3578771921,37
3,1643,47388,3578771884,3578771921,37
3,1643,47389,3578771884,3578771923,39
3,1643,47390,3578771884,3578771929,45
3,1644,47391,3578771950,3578771950,0
3,1644,47392,3578771950,3578771950,0
3,1644,47393,3578771950,3578771950,0
3,1644,47394,3578771950,3578771950,0
3,1644,47395,3578771950,3578771956,6
3,1644,47396,3578771950,3578771956,6
3,1644,47397,3578771950,3578771960,10
3,1644,47398,3578771950,3578771965,15
3,1644,47399,3578771950,3578771967,17
3,1644,47400,3578771950,3578771968,18
3,1644,47401,3578771950,3578771969,19
3,1644,47402,3578771950,3578771971,21
3,1644,47403,3578771950,3578771971,21
3,1644,47404,3578771950,3578771975,25
3,1644,47405,3578771950,3578771979,29
3,1644,47406,3578771950,3578771982,32
3,1644,47407,3578771950,3578771986,36
3,1644,47408,3578771950,3578771987,37
3,1644,47409,3578771950,3578771989,39
3,1644,47410,3578771950,3578771992,42
3,1644,47411,3578771950,3578771995,45
3,1644,47412,3578771950,3578771995,45
3,1644,47413,3578771950,3578771999,49
3,1645,47414,3578772014,3578772014,0
3,1645,47415,3578772014,3578772014,0
3,1645,47416,3578772014,3578772014,0
3,1645,47417,3578772014,3578772014,0
3,1645,47418,3578772014,3578772014,0
3,1645,47419,3578772014,3578772015,1
3,1645,47420,3578772014,3578772015,1
3,1645,47421,3578772014,3578772015,1
3,1645,47422,3578772014,3578772015,1
3,1645,47423,3578772014,3578772015,1
3,1645,47424,3578772014,3578772015,1
3,1645,47425,3578772014,3578772021,7
3,1645,47426,3578772014,3578772022,8
3,1645,47427,3578772014,3578772023,9
3,1645,47428,3578772014,3578772026,12
3,1645,47429,3578772014,3578772028,14
3,1645,47430,3578772014,3578772028,14
3,1645,47431,3578772014,3578772032,18
3,1645,47432,3578772014,3578772033,19
3,1645,47433,3578772014,3578772035,21
3,1645,47434,3578772014,3578772036,22
3,1645,47435,3578772014,3578772038,24
3,1645,47436,3578772014,3578772040,26
3,1645,47437,3578772014,3578772043,29
3,1645,47438,3578772014,3578772044,30
3,1645,47439,3578772014,3578772047,33
3,1645,47440,3578772014,3578772051,37
3,1645,47441,3578772014,3578772053,39
3,1645,47442,3578772014,3578772056,42
3,1645,47443,3578772014,3578772058,44
3,1645,47444,3578772014,3578772058,44
3,1645,47445,3578772014,3578772063,49
3,1646,47446,3578772080,3578772080,0
3,1646,47447,3578772080,3578772080,0
3,1646,47448,3578772080,3578772085,5
3,1646,47449,3578772080,3578772086,6
3,1646,47450,3578772080,3578772086,6
3,1646,47451,3578772080,3578772086,6
3,1646,47452,3578772080,3578772090,10
3,1646,47453,3578772080,3578772091,11
3,1646,47454,3578772080,3578772093,13
3,1646,47455,3578772080,3578772094,14
3,1646,47456,3578772080,3578772094,14
3,1646,47457,3578772080,3578772096,16
3,1646,47458,3578772080,3578772099,19
3,1646,47459,3578772080,3578772103,23
3,1646,47460,3578772080,3578772105,25
3,1646,47461,3578772080,3578772105,25
3,1646,47462,3578772080,3578772109,29
3,1646,47463,3578772080,3578772110,30
3,1646,47464,3578772080,3578772112,32
3,1646,47465,3578772080,3578772114,34
3,1646,47466,3578772080,3578772115,35
3,1646,47467,3578772080,3578772117,37
3,1646,47468,3578772080,3578772118,38
3,1646,47469,3578772080,3578772120,40
3,1646,47470,3578772080,3578772121,41
3,1646,47471,3578772080,3578772122,42
3,1646,47472,3578772080,3578772122,42
3,1646,47473,3578772080,3578772128,48
3,1647,47474,3578772144,3578772144,0
3,1647,47475,3578772144,3578772144,0
3,1647,47476,3578772144,3578772145,1
3,1647,47477,3578772144,3578772148,4
3,1647,47478,3578772144,3578772156,12
3,1647,47479,3578772144,3578772157,13
3,1647,47480,3578772144,3578772160,16
3,1647,47481,3578772144,3578772168,24
3,1647,47482,3578772144,3578772168,24
3,1647,47483,3578772144,3578772169,25
3,1647,47484,3578772144,3578772170,26
3,1647,47485,3578772144,3578772171,27
3,1647,47486,3578772144,3578772173,29
3,1647,47487,3578772144,3578772174,30
3,1647,47488,3578772144,3578772176,32
3,1647,47489,3578772144,3578772179,35
3,1647,47490,3578772144,3578772182,38
3,1647,47491,3578772144,3578772182,38
3,1647,47492,3578772144,3578772185,41
3,1647,47493,3578772144,3578772186,42
3,1647,47494,3578772144,3578772188,44
3,1647,47495,3578772144,3578772192,48
3,1648,47496,3578772208,3578772208,0
3,1648,47497,3578772208,3578772208,0
3,1648,47498,3578772208,3578772208,0
3,1648,47499,3578772208,3578772208,0
3,1648,47500,3578772208,3578772208,0
3,1648,47501,3578772208,3578772208,0
3,1648,47502,3578772208,3578772208,0
3,1648,47503,3578772208,3578772208,0
3,1648,47504,3578772208,3578772208,0
3,1648,47505,3578772208,3578772209,1
3,1648,47506,3578772208,3578772209,1
3,1648,47507,3578772208,3578772209,1
3,1648,47508,3578772208,3578772215,7
3,1648,47509,3578772208,3578772217,9
3,1648,47510,3578772208,3578772223,15
3,1648,47511,3578772208,3578772224,16
3,1648,47512,3578772208,3578772227,19
3,1648,47513,3578772208,3578772230,22
3,1648,47514,3578772208,3578772232,24
3,1648,47515,3578772208,3578772235,27
3,1648,47516,3578772208,3578772236,28
3,1648,47517,3578772208,3578772238,30
3,1648,47518,3578772208,3578772245,37
3,1648,47519,3578772208,3578772245,37
3,1648,47520,3578772208,3578772247,39
3,1648,47521,3578772208,3578772251,43
3,1648,47522,3578772208,3578772253,45
3,1648,47523,3578772208,3578772256,48
3,1648,47524,3578772208,3578772257,49
3,1649,47525,3578772274,3578772274,0
3,1649,47526,3578772274,3578772274,0
3,1649,47527,3578772274,3578772274,0
3,1649,47528,3578772274,3578772274,0
3,1649,47529,3578772274,3578772274,0
3,1649,47530,3578772274,3578772285,11
3,1649,47531,3578772274,3578772286,12
3,1649,47532,3578772274,3578772287,13
3,1649,47533,3578772274,3578772291,17
3,1649,47534,3578772274,3578772291,17
3,1649,47535,3578772274,3578772293,19
3,1649,47536,3578772274,3578772294,20
3,1649,47537,3578772274,3578772297,23
3,1649,47538,3578772274,3578772298,24
3,1649,47539,3578772274,3578772304,30
3,1649,47540,3578772274,3578772305,31
3,1649,47541,3578772274,3578772305,31
3,1649,47542,3578772274,3578772310,36
3,1649,47543,3578772274,3578772310,36
3,1649,47544,3578772274,3578772312,38
3,1649,47545,3578772274,3578772315,41
3,1649,47546,3578772274,3578772315,41
3,1649,47547,3578772274,3578772316,42
3,1649,47548,3578772274,3578772317,43
3,1649,47549,3578772274,3578772318,44
3,1649,47550,3578772274,3578772320,46
3,1649,47551,3578772274,3578772321,47
3,1649,47552,3578772274,3578772322,48
3,1649,47553,3578772274,3578772323,49
3,1650,47554,3578772340,3578772340,0
3,1650,47555,3578772340,3578772341,1
3,1650,47556,3578772340,3578772344,4
3,1650,47557,3578772340,3578772345,5
3,1650,47558,3578772340,3578772348,8
3,1650,47559,3578772340,3578772355,15
3,1650,47560,3578772340,3578772357,17
3,1650,47561,3578772340,3578772360,20
3,1650,47562,3578772340,3578772366,26
3,1650,47563,3578772340,3578772368,28
3,1650,47564,3578772340,3578772368,28
3,1650,47565,3578772340,3578772369,29
3,1650,47566,3578772340,3578772369,29
3,1650,47567,3578772340,3578772371,31
3,1650,47568,3578772340,3578772372,32
3,1650,47569,3578772340,3578772373,33
3,1650,47570,3578772340,3578772374,34
3,1650,47571,3578772340,3578772377,37
3,1650,47572,3578772340,3578772379,39
3,1650,47573,3578772340,3578772382,42
3,1650,47574,3578772340,3578772383,43
3,1650,47575,3578772340,3578772386,46
3,1650,47576,3578772340,3578772388,48
3,1651,47577,3578772405,3578772405,0
3,1651,47578,3578772405,3578772405,0
3,1651,47579,3578772405,3578772405,0
3,1651,47580,3578772405,3578772405,0
3,1651,47581,3578772405,3578772405,0
3,1651,47582,3578772405,3578772405,0
3,1651,47583,3578772405,3578772405,0
3,1651,47584,3578772405,3578772405,0
3,1651,47585,3578772405,3578772406,1
3,1651,47586,3578772405,3578772406,1
3,1651,47587,3578772405,3578772408,3
3,1651,47588,3578772405,3578772408,3
3,1651,47589,3578772405,3578772409,4
3,1651,47590,3578772405,3578772415,10
3,1651,47591,3578772405,3578772422,17
3,1651,47592,3578772405,3578772423,18
3,1651,47593,3578772405,3578772424,19
3,1651,47594,3578772405,3578772427,22
3,1651,47595,3578772405,3578772427,22
3,1651,47596,3578772405,3578772430,25
3,1651,47597,3578772405,3578772432,27
3,1651,47598,3578772405,3578772433,28
3,1651,47599,3578772405,3578772435,30
3,1651,47600,3578772405,3578772437,32
3,1651,47601,3578772405,3578772441,36
3,1651,47602,3578772405,3578772445,40
3,1651,47603,3578772405,3578772446,41
3,1651,47604,3578772405,3578772447,42
3,1651,47605,3578772405,3578772453,48
3,1652,47606,3578772471,3578772471,0
3,1652,47607,3578772471,3578772471,0
3,1652,47608,3578772471,3578772471,0
3,1652,47609,3578772471,3578772471,0
3,1652,47610,3578772471,3578772471,0
3,1652,47611,3578772471,3578772471,0
3,1652,47612,3578772471,3578772471,0
3,1652,47613,3578772471,3578772486,15
3,1652,47614,3578772471,3578772486,15
3,1652,47615,3578772471,3578772487,16
3,1652,47616,3578772471,3578772487,16
3,1652,47617,3578772471,3578772491,20
3,1652,47618,3578772471,3578772492,21
3,1652,47619,3578772471,3578772493,22
3,1652,47620,3578772471,3578772494,23
3,1652,47621,3578772471,3578772496,25
3,1652,47622,3578772471,3578772497,26
3,1652,47623,3578772471,3578772498,27
3,1652,47624,3578772471,3578772503,32
3,1652,47625,3578772471,3578772505,34
3,1652,47626,3578772471,3578772505,34
3,1652,47627,3578772471,3578772509,38
3,1652,47628,3578772471,3578772510,39
3,1652,47629,3578772471,3578772512,41
3,1652,47630,3578772471,3578772514,43
3,1652,47631,3578772471,3578772515,44
3,1652,47632,3578772471,3578772515,44
3,1652,47633,3578772471,3578772518,47
3,1652,47634,3578772471,3578772518,47
3,1652,47635,3578772471,3578772521,50
3,1653,47636,3578772538,3578772538,0
3,1653,47637,3578772538,3578772538,0
3,1653,47638,3578772538,3578772538,0
3,1653,47639,3578772538,3578772538,0
3,1653,47640,3578772538,3578772540,2
3,1653,47641,3578772538,3578772543,5
3,1653,47642,3578772538,3578772545,7
3,1653,47643,3578772538,3578772556,18
3,1653,47644,3578772538,3578772556,18
3,1653,47645,3578772538,3578772559,21
3,1653,47646,3578772538,3578772567,29
3,1653,47647,3578772538,3578772568,30
3,1653,47648,3578772538,3578772568,30
3,1653,47649,3578772538,3578772568,30
3,1653,47650,3578772538,3578772569,31
3,1653,47651,3578772538,3578772571,33
3,1653,47652,3578772538,3578772572,34
3,1653,47653,3578772538,3578772573,35
3,1653,47654,3578772538,3578772573,35
3,1653,47655,3578772538,3578772575,37
3,1653,47656,3578772538,3578772578,40
3,1653,47657,3578772538,3578772582,44
3,1653,47658,3578772538,3578772583,45
3,1653,47659,3578772538,3578772585,47
3,1653,47660,3578772538,3578772586,48
3,1653,47661,3578772538,3578772587,49
3,1654,47662,3578772605,3578772605,0
3,1654,47663,3578772605,3578772605,0
3,1654,47664,3578772605,3578772605,0
3,1654,47665,3578772605,3578772605,0
3,1654,47666,3578772605,3578772605,0
3,1654,47667,3578772605,3578772605,0
3,1654,47668,3578772605,3578772605,0
3,1654,47669,3578772605,3578772605,0
3,1654,47670,3578772605,3578772605,0
3,1654,47671,3578772605,3578772607,2
3,1654,47672,3578772605,3578772607,2
3,1654,47673,3578772605,3578772608,3
3,1654,47674,3578772605,3578772614,9
3,1654,47675,3578772605,3578772616,11
3,1654,47676,3578772605,3578772622,17
3,1654,47677,3578772605,3578772623,18
3,1654,47678,3578772605,3578772626,21
3,1654,47679,3578772605,3578772626,21
3,1654,47680,3578772605,3578772629,24
3,1654,47681,3578772605,3578772632,27
3,1654,47682,3578772605,3578772632,27
3,1654,47683,3578772605,3578772634,29
3,1654,47684,3578772605,3578772636,31
3,1654,47685,3578772605,3578772639,34
3,1654,47686,3578772605,3578772643,38
3,1654,47687,3578772605,3578772646,41
3,1654,47688,3578772605,3578772646,41
3,1654,47689,3578772605,3578772653,48
3,1655,47690,3578772672,3578772672,0
3,1655,47691,3578772672,3578772672,0
3,1655,47692,3578772672,3578772672,0
3,1655,47693,3578772672,3578772672,0
3,1655,47694,3578772672,3578772672,0
3,1655,47695,3578772672,3578772685,13
3,1655,47696,3578772672,3578772686,14
3,1655,47697,3578772672,3578772686,14
3,1655,47698,3578772672,3578772687,15
3,1655,47699,3578772672,3578772689,17
3,1655,47700,3578772672,3578772690,18
3,1655,47701,3578772672,3578772692,20
3,1655,47702,3578772672,3578772693,21
3,1655,47703,3578772672,3578772694,22
3,1655,47704,3578772672,3578772697,25
3,1655,47705,3578772672,3578772697,25
3,1655,47706,3578772672,3578772703,31
3,1655,47707,3578772672,3578772705,33
3,1655,47708,3578772672,3578772705,33
3,1655,47709,3578772672,3578772709,37
3,1655,47710,3578772672,3578772710,38
3,1655,47711,3578772672,3578772713,41
3,1655,47712,3578772672,3578772714,42
3,1655,47713,3578772672,3578772715,43
3,1655,47714,3578772672,3578772715,43
3,1655,47715,3578772672,3578772718,46
3,1655,47716,3578772672,3578772718,46
3,1655,47717,3578772672,3578772721,49
3,1655,47718,3578772672,3578772722,50
3,1656,47719,3578772738,3578772738,0
3,1656,47720,3578772738,3578772738,0
3,1656,47721,3578772738,3578772738,0
3,1656,47722,3578772738,3578772741,3
3,1656,47723,3578772738,3578772743,5
3,1656,47724,3578772738,3578772748,10
3,1656,47725,3578772738,3578772755,17
3,1656,47726,3578772738,3578772760,22
3,1656,47727,3578772738,3578772766,28
3,1656,47728,3578772738,3578772768,30
3,1656,47729,3578772738,3578772768,30
3,1656,47730,3578772738,3578772768,30
3,1656,47731,3578772738,3578772769,31
3,1656,47732,3578772738,3578772770,32
3,1656,47733,3578772738,3578772770,32
3,1656,47734,3578772738,3578772773,35
3,1656,47735,3578772738,3578772773,35
3,1656,47736,3578772738,3578772773,35
3,1656,47737,3578772738,3578772776,38
3,1656,47738,3578772738,3578772779,41
3,1656,47739,3578772738,3578772781,43
3,1656,47740,3578772738,3578772783,45
3,1656,47741,3578772738,3578772785,47
3,1656,47742,3578772738,3578772786,48
3,1656,47743,3578772738,3578772788,50
3,1657,47744,3578772803,3578772803,0
3,1657,47745,3578772803,3578772803,0
3,1657,47746,3578772803,3578772803,0
3,1657,47747,3578772803,3578772803,0
3,1657,47748,3578772803,3578772803,0
3,1657,47749,3578772803,3578772804,1
3,1657,47750,3578772803,3578772804,1
3,1657,47751,3578772803,3578772805,2
3,1657,47752,3578772803,3578772806,3
3,1657,47753,3578772803,3578772807,4
3,1657,47754,3578772803,3578772809,6
3,1657,47755,3578772803,3578772809,6
3,1657,47756,3578772803,3578772814,11
3,1657,47757,3578772803,3578772816,13
3,1657,47758,3578772803,3578772822,19
3,1657,47759,3578772803,3578772822,19
3,1657,47760,3578772803,3578772822,19
3,1657,47761,3578772803,3578772826,23
3,1657,47762,3578772803,3578772827,24
3,1657,47763,3578772803,3578772828,25
3,1657,47764,3578772803,3578772831,28
3,1657,47765,3578772803,3578772831,28
3,1657,47766,3578772803,3578772835,32
3,1657,47767,3578772803,3578772836,33
3,1657,47768,3578772803,3578772840,37
3,1657,47769,3578772803,3578772844,41
3,1657,47770,3578772803,3578772845,42
3,1657,47771,3578772803,3578772847,44
3,1658,47772,3578772869,3578772869,0
3,1658,47773,3578772869,3578772869,0
3,1658,47774,3578772869,3578772869,0
3,1658,47775,3578772869,3578772869,0
3,1658,47776,3578772869,3578772869,0
3,1658,47777,3578772869,3578772869,0
3,1658,47778,3578772869,3578772869,0
3,1658,47779,3578772869,3578772869,0
3,1658,47780,3578772869,3578772885,16
3,1658,47781,3578772869,3578772885,16
3,1658,47782,3578772869,3578772887,18
3,1658,47783,3578772869,3578772887,18
3,1658,47784,3578772869,3578772889,20
3,1658,47785,3578772869,3578772890,21
3,1658,47786,3578772869,3578772892,23
3,1658,47787,3578772869,3578772893,24
3,1658,47788,3578772869,3578772893,24
3,1658,47789,3578772869,3578772897,28
3,1658,47790,3578772869,3578772897,28
3,1658,47791,3578772869,3578772903,34
3,1658,47792,3578772869,3578772905,36
3,1658,47793,3578772869,3578772905,36
3,1658,47794,3578772869,3578772909,40
3,1658,47795,3578772869,3578772910,41
3,1658,47796,3578772869,3578772913,44
3,1658,47797,3578772869,3578772915,46
3,1658,47798,3578772869,3578772915,46
3,1658,47799,3578772869,3578772915,46
3,1658,47800,3578772869,3578772919,50
3,1659,47801,3578772936,3578772936,0
3,1659,47802,3578772936,3578772936,0
3,1659,47803,3578772936,3578772936,0
3,1659,47804,3578772936,3578772936,0
3,1659,47805,3578772936,3578772943,7
3,1659,47806,3578772936,3578772945,9
3,1659,47807,3578772936,3578772948,12
3,1659,47808,3578772936,3578772957,21
3,1659,47809,3578772936,3578772960,24
3,1659,47810,3578772936,3578772967,31
3,1659,47811,3578772936,3578772968,32
3,1659,47812,3578772936,3578772968,32
3,1659,47813,3578772936,3578772968,32
3,1659,47814,3578772936,3578772970,34
3,1659,47815,3578772936,3578772970,34
3,1659,47816,3578772936,3578772973,37
3,1659,47817,3578772936,3578772973,37
3,1659,47818,3578772936,3578772973,37
3,1659,47819,3578772936,3578772976,40
3,1659,47820,3578772936,3578772979,43
3,1659,47821,3578772936,3578772981,45
3,1659,47822,3578772936,3578772983,47
3,1659,47823,3578772936,3578772985,49
3,1660,47824,3578773002,3578773002,0
3,1660,47825,3578773002,3578773002,0
3,1660,47826,3578773002,3578773002,0
3,1660,47827,3578773002,3578773002,0
3,1660,47828,3578773002,3578773002,0
3,1660,47829,3578773002,3578773003,1
3,1660,47830,3578773002,3578773004,2
3,1660,47831,3578773002,3578773004,2
3,1660,47832,3578773002,3578773005,3
3,1660,47833,3578773002,3578773005,3
3,1660,47834,3578773002,3578773007,5
3,1660,47835,3578773002,3578773009,7
3,1660,47836,3578773002,3578773010,8
3,1660,47837,3578773002,3578773015,13
3,1660,47838,3578773002,3578773015,13
3,1660,47839,3578773002,3578773022,20
3,1660,47840,3578773002,3578773022,20
3,1660,47841,3578773002,3578773026,24
3,1660,47842,3578773002,3578773027,25
3,1660,47843,3578773002,3578773028,26
3,1660,47844,3578773002,3578773031,29
3,1660,47845,3578773002,3578773033,31
3,1660,47846,3578773002,3578773034,32
3,1660,47847,3578773002,3578773036,34
3,1660,47848,3578773002,3578773038,36
3,1660,47849,3578773002,3578773040,38
3,1660,47850,3578773002,3578773044,42
3,1660,47851,3578773002,3578773045,43
3,1660,47852,3578773002,3578773047,45
3,1660,47853,3578773002,3578773050,48
3,1661,47854,3578773069,3578773069,0
3,1661,47855,3578773069,3578773069,0
3,1661,47856,3578773069,3578773069,0
3,1661,47857,3578773069,3578773069,0
3,1661,47858,3578773069,3578773069,0
3,1661,47859,3578773069,3578773069,0
3,1661,47860,3578773069,3578773069,0
3,1661,47861,3578773069,3578773069,0
3,1661,47862,3578773069,3578773085,16
3,1661,47863,3578773069,3578773086,17
3,1661,47864,3578773069,3578773086,17
3,1661,47865,3578773069,3578773087,18
3,1661,47866,3578773069,3578773088,19
3,1661,47867,3578773069,3578773090,21
3,1661,47868,3578773069,3578773092,23
3,1661,47869,3578773069,3578773093,24
3,1661,47870,3578773069,3578773094,25
3,1661,47871,3578773069,3578773097,28
3,1661,47872,3578773069,3578773097,28
3,1661,47873,3578773069,3578773099,30
3,1661,47874,3578773069,3578773103,34
3,1661,47875,3578773069,3578773105,36
3,1661,47876,3578773069,3578773105,36
3,1661,47877,3578773069,3578773109,40
3,1661,47878,3578773069,3578773110,41
3,1661,47879,3578773069,3578773113,44
3,1661,47880,3578773069,3578773115,46
3,1661,47881,3578773069,3578773115,46
3,1661,47882,3578773069,3578773115,46
3,1661,47883,3578773069,3578773119,50
3,1662,47884,3578773135,3578773135,0
3,1662,47885,3578773135,3578773135,0
3,1662,47886,3578773135,3578773135,0
3,1662,47887,3578773135,3578773135,0
3,1662,47888,3578773135,3578773135,0
3,1662,47889,3578773135,3578773141,6
3,1662,47890,3578773135,3578773143,8
3,1662,47891,3578773135,3578773145,10
3,1662,47892,3578773135,3578773149,14
3,1662,47893,3578773135,3578773157,22
3,1662,47894,3578773135,3578773165,30
3,1662,47895,3578773135,3578773167,32
3,1662,47896,3578773135,3578773168,33
3,1662,47897,3578773135,3578773168,33
3,1662,47898,3578773135,3578773168,33
3,1662,47899,3578773135,3578773169,34
3,1662,47900,3578773135,3578773171,36
3,1662,47901,3578773135,3578773173,38
3,1662,47902,3578773135,3578773173,38
3,1662,47903,3578773135,3578773173,38
3,1662,47904,3578773135,3578773178,43
3,1662,47905,3578773135,3578773182,47
3,1662,47906,3578773135,3578773184,49
3,1663,47907,3578773200,3578773200,0
3,1663,47908,3578773200,3578773200,0
3,1663,47909,3578773200,3578773200,0
3,1663,47910,3578773200,3578773200,0
3,1663,47911,3578773200,3578773200,0
3,1663,47912,3578773200,3578773200,0
3,1663,47913,3578773200,3578773203,3
3,1663,47914,3578773200,3578773204,4
3,1663,47915,3578773200,3578773204,4
3,1663,47916,3578773200,3578773204,4
3,1663,47917,3578773200,3578773205,5
3,1663,47918,3578773200,3578773206,6
3,1663,47919,3578773200,3578773208,8
3,1663,47920,3578773200,3578773209,9
3,1663,47921,3578773200,3578773210,10
3,1663,47922,3578773200,3578773215,15
3,1663,47923,3578773200,3578773216,16
3,1663,47924,3578773200,3578773222,22
3,1663,47925,3578773200,3578773223,23
3,1663,47926,3578773200,3578773223,23
3,1663,47927,3578773200,3578773227,27
3,1663,47928,3578773200,3578773228,28
3,1663,47929,3578773200,3578773229,29
3,1663,47930,3578773200,3578773232,32
3,1663,47931,3578773200,3578773233,33
3,1663,47932,3578773200,3578773235,35
3,1663,47933,3578773200,3578773236,36
3,1663,47934,3578773200,3578773238,38
3,1663,47935,3578773200,3578773240,40
3,1663,47936,3578773200,3578773244,44
3,1663,47937,3578773200,3578773245,45
3,1663,47938,3578773200,3578773247,47
3,1664,47939,3578773266,3578773266,0
3,1664,47940,3578773266,3578773266,0
3,1664,47941,3578773266,3578773266,0
3,1664,47942,3578773266,3578773266,0
3,1664,47943,3578773266,3578773266,0
3,1664,47944,3578773266,3578773266,0
3,1664,47945,3578773266,3578773266,0
3,1664,47946,3578773266,3578773266,0
3,1664,47947,3578773266,3578773269,3
3,1664,47948,3578773266,3578773285,19
3,1664,47949,3578773266,3578773286,20
3,1664,47950,3578773266,3578773287,21
3,1664,47951,3578773266,3578773288,22
3,1664,47952,3578773266,3578773290,24
3,1664,47953,3578773266,3578773293,27
3,1664,47954,3578773266,3578773294,28
3,1664,47955,3578773266,3578773297,31
3,1664,47956,3578773266,3578773297,31
3,1664,47957,3578773266,3578773298,32
3,1664,47958,3578773266,3578773304,38
3,1664,47959,3578773266,3578773305,39
3,1664,47960,3578773266,3578773305,39
3,1664,47961,3578773266,3578773310,44
3,1664,47962,3578773266,3578773310,44
3,1664,47963,3578773266,3578773313,47
3,1664,47964,3578773266,3578773315,49
3,1664,47965,3578773266,3578773315,49
3,1664,47966,3578773266,3578773316,50
3,1665,47967,3578773334,3578773334,0
3,1665,47968,3578773334,3578773334,0
3,1665,47969,3578773334,3578773334,0
3,1665,47970,3578773334,3578773334,0
3,1665,47971,3578773334,3578773334,0
3,1665,47972,3578773334,3578773334,0
3,1665,47973,3578773334,3578773342,8
3,1665,47974,3578773334,3578773343,9
3,1665,47975,3578773334,3578773346,12
3,1665,47976,3578773334,3578773358,24
3,1665,47977,3578773334,3578773360,26
3,1665,47978,3578773334,3578773368,34
3,1665,47979,3578773334,3578773368,34
3,1665,47980,3578773334,3578773368,34
3,1665,47981,3578773334,3578773369,35
3,1665,47982,3578773334,3578773369,35
3,1665,47983,3578773334,3578773371,37
3,1665,47984,3578773334,3578773373,39
3,1665,47985,3578773334,3578773373,39
3,1665,47986,3578773334,3578773373,39
3,1665,47987,3578773334,3578773376,42
3,1665,47988,3578773334,3578773383,49
3,1666,47989,3578773400,3578773400,0
3,1666,47990,3578773400,3578773400,0
3,1666,47991,3578773400,3578773400,0
3,1666,47992,3578773400,3578773400,0
3,1666,47993,3578773400,3578773400,0
3,1666,47994,3578773400,3578773400,0
3,1666,47995,3578773400,3578773400,0
3,1666,47996,3578773400,3578773400,0
3,1666,47997,3578773400,3578773404,4
3,1666,47998,3578773400,3578773404,4
3,1666,47999,3578773400,3578773404,4
3,1666,48000,3578773400,3578773405,5
3,1666,48001,3578773400,3578773406,6
3,1666,48002,3578773400,3578773406,6
3,1666,48003,3578773400,3578773408,8
3,1666,48004,3578773400,3578773410,10
3,1666,48005,3578773400,3578773415,15
3,1666,48006,3578773400,3578773416,16
3,1666,48007,3578773400,3578773422,22
3,1666,48008,3578773400,3578773424,24
3,1666,48009,3578773400,3578773424,24
3,1666,48010,3578773400,3578773427,27
3,1666,48011,3578773400,3578773428,28
3,1666,48012,3578773400,3578773430,30
3,1666,48013,3578773400,3578773433,33
3,1666,48014,3578773400,3578773433,33
3,1666,48015,3578773400,3578773438,38
3,1666,48016,3578773400,3578773444,44
3,1666,48017,3578773400,3578773446,46
3,1666,48018,3578773400,3578773446,46
3,1667,48019,3578773466,3578773466,0
3,1667,48020,3578773466,3578773466,0
3,1667,48021,3578773466,3578773466,0
3,1667,48022,3578773466,3578773466,0
3,1667,48023,3578773466,3578773466,0
3,1667,48024,3578773466,3578773466,0
3,1667,48025,3578773466,3578773485,19
3,1667,48026,3578773466,3578773486,20
3,1667,48027,3578773466,3578773487,21
3,1667,48028,3578773466,3578773490,24
3,1667,48029,3578773466,3578773492,26
3,1667,48030,3578773466,3578773493,27
3,1667,48031,3578773466,3578773494,28
3,1667,48032,3578773466,3578773498,32
3,1667,48033,3578773466,3578773503,37
3,1667,48034,3578773466,3578773505,39
3,1667,48035,3578773466,3578773506,40
3,1667,48036,3578773466,3578773510,44
3,1667,48037,3578773466,3578773510,44
3,1667,48038,3578773466,3578773514,48
3,1667,48039,3578773466,3578773516,50
3,1668,48040,3578773531,3578773531,0
3,1668,48041,3578773531,3578773531,0
3,1668,48042,3578773531,3578773531,0
3,1668,48043,3578773531,3578773531,0
3,1668,48044,3578773531,3578773531,0
3,1668,48045,3578773531,3578773531,0
3,1668,48046,3578773531,3578773541,10
3,1668,48047,3578773531,3578773543,12
3,1668,48048,3578773531,3578773545,14
3,1668,48049,3578773531,3578773556,25
3,1668,48050,3578773531,3578773557,26
3,1668,48051,3578773531,3578773559,28
3,1668,48052,3578773531,3578773567,36
3,1668,48053,3578773531,3578773568,37
3,1668,48054,3578773531,3578773568,37
3,1668,48055,3578773531,3578773568,37
3,1668,48056,3578773531,3578773570,39
3,1668,48057,3578773531,3578773570,39
3,1668,48058,3578773531,3578773572,41
3,1668,48059,3578773531,3578773572,41
3,1668,48060,3578773531,3578773573,42
3,1668,48061,3578773531,3578773575,44
3,1669,48062,3578773598,3578773598,0
3,1669,48063,3578773598,3578773598,0
3,1669,48064,3578773598,3578773598,0
3,1669,48065,3578773598,3578773598,0
3,1669,48066,3578773598,3578773598,0
3,1669,48067,3578773598,3578773598,0
3,1669,48068,3578773598,3578773598,0
3,1669,48069,3578773598,3578773599,1
3,1669,48070,3578773598,3578773603,5
3,1669,48071,3578773598,3578773603,5
3,1669,48072,3578773598,3578773603,5
3,1669,48073,3578773598,3578773605,7
3,1669,48074,3578773598,3578773605,7
3,1669,48075,3578773598,3578773605,7
3,1669,48076,3578773598,3578773608,10
3,1669,48077,3578773598,3578773608,10
3,1669,48078,3578773598,3578773608,10
3,1669,48079,3578773598,3578773615,17
3,1669,48080,3578773598,3578773615,17
3,1669,48081,3578773598,3578773622,24
3,1669,48082,3578773598,3578773622,24
3,1669,48083,3578773598,3578773623,25
3,1669,48084,3578773598,3578773626,28
3,1669,48085,3578773598,3578773627,29
3,1669,48086,3578773598,3578773628,30
3,1669,48087,3578773598,3578773631,33
3,1669,48088,3578773598,3578773631,33
3,1669,48089,3578773598,3578773634,36
3,1669,48090,3578773598,3578773635,37
3,1669,48091,3578773598,3578773638,40
3,1669,48092,3578773598,3578773643,45
3,1669,48093,3578773598,3578773646,48
3,1670,48094,3578773665,3578773665,0
3,1670,48095,3578773665,3578773665,0
3,1670,48096,3578773665,3578773665,0
3,1670,48097,3578773665,3578773665,0
3,1670,48098,3578773665,3578773665,0
3,1670,48099,3578773665,3578773669,4
3,1670,48100,3578773665,3578773687,22
3,1670,48101,3578773665,3578773687,22
3,1670,48102,3578773665,3578773688,23
3,1670,48103,3578773665,3578773690,25
3,1670,48104,3578773665,3578773691,26
3,1670,48105,3578773665,3578773693,28
3,1670,48106,3578773665,3578773698,33
3,1670,48107,3578773665,3578773698,33
3,1670,48108,3578773665,3578773705,40
3,1670,48109,3578773665,3578773706,41
3,1670,48110,3578773665,3578773709,44
3,1670,48111,3578773665,3578773710,45
3,1670,48112,3578773665,3578773715,50
3,1671,48113,3578773731,3578773731,0
3,1671,48114,3578773731,3578773731,0
3,1671,48115,3578773731,3578773731,0
3,1671,48116,3578773731,3578773731,0
3,1671,48117,3578773731,3578773731,0
3,1671,48118,3578773731,3578773731,0
3,1671,48119,3578773731,3578773731,0
3,1671,48120,3578773731,3578773741,10
3,1671,48121,3578773731,3578773743,12
3,1671,48122,3578773731,3578773745,14
3,1671,48123,3578773731,3578773756,25
3,1671,48124,3578773731,3578773756,25
3,1671,48125,3578773731,3578773760,29
3,1671,48126,3578773731,3578773768,37
3,1671,48127,3578773731,3578773769,38
3,1671,48128,3578773731,3578773771,40
3,1671,48129,3578773731,3578773772,41
3,1671,48130,3578773731,3578773773,42
3,1671,48131,3578773731,3578773773,42
3,1671,48132,3578773731,3578773775,44
3,1672,48133,3578773798,3578773798,0
3,1672,48134,3578773798,3578773798