t_id, iteration_count, request_count, request_start_time, request_end_time, request_processing_time
3,124,1,-721657544,-721657544,0
3,127,2,-721657393,-721657344,49
3,131,3,-721657192,-721657145,47
3,135,4,-721656991,-721656945,46
3,139,5,-721656789,-721656745,44
3,143,6,-721656588,-721656545,43
3,147,7,-721656387,-721656345,42
3,151,8,-721656186,-721656145,41
3,155,9,-721655985,-721655945,40
3,159,10,-721655784,-721655746,38
3,163,11,-721655583,-721655546,37
3,167,12,-721655382,-721655345,37
3,171,13,-721655181,-721655146,35
3,175,14,-721654980,-721654946,34
3,179,15,-721654778,-721654746,32
3,183,16,-721654577,-721654546,31
3,187,17,-721654377,-721654346,31
3,191,18,-721654175,-721654146,29
3,195,19,-721653975,-721653946,29
3,199,20,-721653774,-721653747,27
3,203,21,-721653573,-721653547,26
3,207,22,-721653372,-721653347,25
3,211,23,-721653171,-721653147,24
3,215,24,-721652969,-721652946,23
3,219,25,-721652768,-721652746,22
3,223,26,-721652567,-721652546,21
3,227,27,-721652366,-721652346,20
3,231,28,-721652165,-721652146,19
3,235,29,-721651964,-721651946,18
3,239,30,-721651763,-721651747,16
3,243,31,-721651562,-721651547,15
3,247,32,-721651361,-721651347,14
3,251,33,-721651159,-721651146,13
3,255,34,-721650958,-721650946,12
3,259,35,-721650758,-721650747,11
3,263,36,-721650557,-721650547,10
3,267,37,-721650356,-721650347,9
3,271,38,-721650155,-721650147,8
3,275,39,-721649954,-721649947,7
3,279,40,-721649753,-721649746,7
3,283,41,-721649552,-721649545,7
3,287,42,-721649351,-721649345,6
3,291,43,-721649151,-721649145,6
3,295,44,-721648950,-721648946,4
3,299,45,-721648749,-721648747,2
3,303,46,-721648548,-721648547,1
3,307,47,-721648347,-721648347,0
3,311,48,-721648146,-721648146,0
3,314,49,-721647996,-721647946,50
3,409,50,-721643221,-721643201,20
3,413,51,-721643020,-721643001,19
3,417,52,-721642819,-721642802,17
3,421,53,-721642617,-721642601,16
3,425,54,-721642416,-721642401,15
3,429,55,-721642215,-721642201,14
3,433,56,-721642013,-721642001,12
3,437,57,-721641812,-721641802,10
3,441,58,-721641611,-721641602,9
3,445,59,-721641410,-721641402,8
3,449,60,-721641208,-721641201,7
3,453,61,-721641007,-721641001,6
3,457,62,-721640806,-721640802,4
3,461,63,-721640605,-721640602,3
3,465,64,-721640404,-721640402,2
3,469,65,-721640202,-721640201,1
3,473,66,-721640001,-721640001,0
3,476,67,-721639850,-721639801,49
3,480,68,-721639649,-721639601,48
3,484,69,-721639448,-721639401,47
3,488,70,-721639247,-721639201,46
3,492,71,-721639046,-721639001,45
3,496,72,-721638844,-721638800,44
3,500,73,-721638643,-721638600,43
3,504,74,-721638442,-721638400,42
3,508,75,-721638240,-721638200,40
3,512,76,-721638039,-721638000,39
3,516,77,-721637838,-721637800,38
3,520,78,-721637636,-721637600,36
3,524,79,-721637435,-721637400,35
3,528,80,-721637234,-721637200,34
3,532,81,-721637032,-721637000,32
3,536,82,-721636831,-721636800,31
3,540,83,-721636630,-721636600,30
3,544,84,-721636428,-721636400,28
3,548,85,-721636226,-721636200,26
3,552,86,-721636025,-721636000,25
3,556,87,-721635823,-721635801,22
3,560,88,-721635620,-721635601,19
3,564,89,-721635419,-721635401,18
3,568,90,-721635218,-721635201,17
3,572,91,-721635017,-721635001,16
3,576,92,-721634816,-721634802,14
3,580,93,-721634614,-721634602,12
3,584,94,-721634413,-721634402,11
3,588,95,-721634212,-721634202,10
3,592,96,-721634010,-721634002,8
3,596,97,-721633809,-721633803,6
3,600,98,-721633607,-721633602,5
3,604,99,-721633406,-721633402,4
3,608,100,-721633205,-721633202,3
3,612,101,-721633004,-721633002,2
3,616,102,-721632802,-721632802,0
3,619,103,-721632651,-721632602,49
3,623,104,-721632450,-721632402,48
3,627,105,-721632249,-721632202,47
3,631,106,-721632047,-721632002,45
3,635,107,-721631846,-721631802,44
3,639,108,-721631645,-721631602,43
3,643,109,-721631444,-721631401,43
3,647,110,-721631242,-721631202,40
3,651,111,-721631041,-721631002,39
3,654,112,-721630890,-721630854,36
3,655,113,-721630839,-721630801,38
3,658,114,-721630689,-721630654,35
3,659,115,-721630638,-721630601,37
3,662,116,-721630487,-721630453,34
3,663,117,-721630437,-721630401,36
3,666,118,-721630286,-721630254,32
3,667,119,-721630235,-721630201,34
3,670,120,-721630084,-721630053,31
3,671,121,-721630034,-721630001,33
3,674,122,-721629883,-721629854,29
3,675,123,-721629833,-721629801,32
3,678,124,-721629682,-721629655,27
3,679,125,-721629632,-721629600,32
3,682,126,-721629481,-721629454,27
3,683,127,-721629430,-721629401,29
3,686,128,-721629279,-721629253,26
3,687,129,-721629229,-721629201,28
3,690,130,-721629078,-721629053,25
3,691,131,-721629028,-721629001,27
3,694,132,-721628877,-721628853,24
3,695,133,-721628826,-721628801,25
3,698,134,-721628675,-721628653,22
3,699,135,-721628625,-721628601,24
3,702,136,-721628474,-721628453,21
3,703,137,-721628424,-721628400,24
3,706,138,-721628273,-721628253,20
3,707,139,-721628222,-721628201,21
3,710,140,-721628071,-721628052,19
3,711,141,-721628021,-721628001,20
3,714,142,-721627870,-721627852,18
3,715,143,-721627819,-721627801,18
3,718,144,-721627668,-721627653,15
3,719,145,-721627618,-721627600,18
3,722,146,-721627467,-721627452,15
3,723,147,-721627416,-721627401,15
3,726,148,-721627265,-721627253,12
3,727,149,-721627215,-721627201,14
3,730,150,-721627064,-721627053,11
3,731,151,-721627013,-721627000,13
3,734,152,-721626863,-721626852,11
3,735,153,-721626812,-721626801,11
3,738,154,-721626661,-721626653,8
3,739,155,-721626611,-721626601,10
3,742,156,-721626460,-721626453,7
3,743,157,-721626410,-721626401,9
3,746,158,-721626259,-721626253,6
3,747,159,-721626208,-721626201,7
3,750,160,-721626057,-721626052,5
3,751,161,-721626007,-721626001,6
3,754,162,-721625856,-721625853,3
3,755,163,-721625806,-721625802,4
3,758,164,-721625655,-721625654,1
3,759,165,-721625605,-721625602,3
3,761,166,-721625504,-721625454,50
3,763,167,-721625404,-721625402,2
3,765,168,-721625303,-721625254,49
3,767,169,-721625202,-721625202,0
3,769,170,-721625102,-721625054,48
3,770,171,-721625051,-721625002,49
3,773,172,-721624900,-721624853,47
3,774,173,-721624850,-721624802,48
3,777,174,-721624699,-721624654,45
3,778,175,-721624649,-721624601,48
3,781,176,-721624497,-721624453,44
3,782,177,-721624447,-721624402,45
3,785,178,-721624296,-721624254,42
3,786,179,-721624246,-721624202,44
3,789,180,-721624095,-721624054,41
3,790,181,-721624044,-721624002,42
3,793,182,-721623893,-721623853,40
3,794,183,-721623843,-721623802,41
3,797,184,-721623692,-721623654,38
3,798,185,-721623642,-721623602,40
3,801,186,-721623491,-721623454,37
3,802,187,-721623440,-721623402,38
3,805,188,-721623289,-721623253,36
3,806,189,-721623239,-721623202,37
3,809,190,-721623088,-721623053,35
3,810,191,-721623038,-721623002,36
3,813,192,-721622887,-721622853,34
3,814,193,-721622837,-721622802,35
3,817,194,-721622686,-721622654,32
3,818,195,-721622635,-721622601,34
3,821,196,-721622485,-721622453,32
3,822,197,-721622434,-721622401,33
3,825,198,-721622283,-721622254,29
3,826,199,-721622233,-721622201,32
3,829,200,-721622081,-721622053,28
3,830,201,-721622031,-721622001,30
3,833,202,-721621880,-721621853,27
3,834,203,-721621830,-721621801,29
3,837,204,-721621679,-721621654,25
3,838,205,-721621629,-721621601,28
3,841,206,-721621478,-721621454,24
3,842,207,-721621427,-721621401,26
3,845,208,-721621276,-721621253,23
3,846,209,-721621226,-721621201,25
3,849,210,-721621075,-721621054,21
3,850,211,-721621024,-721621001,23
3,853,212,-721620873,-721620854,19
3,854,213,-721620822,-721620801,21
3,857,214,-721620671,-721620655,16
3,858,215,-721620620,-721620600,20
3,861,216,-721620470,-721620453,17
3,862,217,-721620419,-721620400,19
3,865,218,-721620268,-721620254,14
3,866,219,-721620218,-721620199,19
3,869,220,-721620067,-721620054,13
3,870,221,-721620016,-721620000,16
3,873,222,-721619865,-721619853,12
3,874,223,-721619815,-721619801,14
3,877,224,-721619664,-721619655,9
3,878,225,-721619614,-721619601,13
3,881,226,-721619463,-721619453,10
3,882,227,-721619412,-721619401,11
3,885,228,-721619261,-721619253,8
3,886,229,-721619211,-721619201,10
3,889,230,-721619060,-721619053,7
3,890,231,-721619010,-721619001,9
3,893,232,-721618859,-721618853,6
3,894,233,-721618808,-721618802,6
3,897,234,-721618657,-721618653,4
3,898,235,-721618607,-721618602,5
3,902,236,-721618406,-721618402,4
3,905,237,-721618255,-721618253,2
3,906,238,-721618205,-721618202,3
3,909,239,-721618054,-721618054